Rk,Player,Season,Pos,G,GS,MP,FG,FGA,FG%,2P,2PA,2P%,3P,3PA,3P%,FT,FTA,FT%,ORB,DRB,TRB,AST,STL,BLK,TOV,PF,PTS,GmSc
1,Karl-Anthony Towns\townska01,2016-17,C-F,82,82,3030,802,1480,.542,701,1205,.582,101,275,.367,356,428,.832,296,711,1007,220,56,103,212,241,2061,20.9
2,DeMarcus Cousins\couside01,2016-17,C-F,72,72,2465,647,1432,.452,516,1069,.483,131,363,.361,517,670,.772,152,642,794,332,100,93,269,278,1942,20.2
3,Karl-Anthony Towns\townska01,2018-19,C-F,77,77,2545,681,1314,.518,539,959,.562,142,355,.400,376,450,.836,263,691,954,259,67,125,240,292,1880,20.4
4,Joel Embiid\embiijo01,2018-19,C,64,64,2154,580,1199,.484,501,936,.535,79,263,.300,522,649,.804,160,711,871,234,46,122,226,211,1761,22.1
5,DeMarcus Cousins\couside01,2015-16,C-F,65,65,2246,601,1332,.451,531,1122,.473,70,210,.333,476,663,.718,158,589,747,214,101,92,249,236,1748,19.1
6,Karl-Anthony Towns\townska01,2017-18,C-F,82,82,2918,639,1172,.545,519,887,.585,120,285,.421,345,402,.858,238,774,1012,199,64,115,159,285,1743,19.1
7,Nikola Vučević\vucevni01,2018-19,C,80,80,2510,701,1354,.518,617,1123,.549,84,231,.364,179,227,.789,224,736,960,307,81,89,159,157,1665,18.7
8,Nikola Jokić\jokicni01,2018-19,C-F,80,80,2504,616,1206,.511,533,936,.569,83,270,.307,289,352,.821,228,637,865,580,108,55,248,228,1604,19.3
9,Brook Lopez\lopezbr01,2016-17,C,75,75,2222,555,1172,.474,421,785,.536,134,387,.346,295,364,.810,121,282,403,176,38,124,184,192,1539,14.3
10,Karl-Anthony Towns\townska01,2015-16,C-F,82,82,2626,625,1153,.542,595,1065,.559,30,88,.341,223,275,.811,229,629,858,161,58,138,183,245,1503,15.4
11,Brook Lopez\lopezbr01,2015-16,C,73,73,2457,591,1157,.511,589,1143,.515,2,14,.143,317,403,.787,204,369,573,147,58,124,175,215,1501,15.5
12,Marc Gasol\gasolma01,2016-17,C,74,74,2531,532,1160,.459,428,892,.480,104,268,.388,278,332,.837,60,404,464,338,67,99,166,171,1446,15.2
13,Joel Embiid\embiijo01,2017-18,C,63,63,1912,510,1056,.483,444,842,.527,66,214,.308,359,467,.769,143,547,690,199,40,111,234,209,1445,17.0
14,Nikola Vučević\vucevni01,2014-15,C,74,74,2529,631,1206,.523,629,1200,.524,2,6,.333,164,218,.752,238,572,810,147,54,54,148,220,1428,15.0
15,DeMarcus Cousins\couside01,2014-15,C-F,59,59,2013,498,1066,.467,496,1058,.469,2,8,.250,423,541,.782,185,562,747,210,90,103,254,241,1421,18.4
16,Marc Gasol\gasolma01,2014-15,C,81,81,2687,530,1072,.494,527,1055,.500,3,17,.176,350,440,.795,115,515,630,307,70,131,176,208,1413,14.7
17,Nikola Jokić\jokicni01,2017-18,C-F,75,73,2443,504,1010,.499,393,730,.538,111,280,.396,266,313,.850,195,608,803,458,90,61,210,212,1385,17.8
18,Andre Drummond\drumman01,2018-19,C,79,79,2647,561,1052,.533,556,1014,.548,5,38,.132,243,412,.590,423,809,1232,112,136,138,175,272,1370,17.2
19,Dwight Howard\howardw01,2017-18,C,81,81,2463,506,911,.555,505,904,.559,1,7,.143,334,582,.574,255,757,1012,105,48,131,208,249,1347,13.9
20,Andre Drummond\drumman01,2015-16,C,81,81,2665,552,1060,.521,550,1054,.522,2,6,.333,208,586,.355,395,803,1198,67,119,112,155,245,1314,14.2
21,Hassan Whiteside\whiteha01,2016-17,C,77,77,2513,542,973,.557,542,973,.557,0,0,,225,358,.628,293,795,1088,57,57,161,154,226,1309,15.6
22,Rudy Gobert\goberru01,2018-19,C,81,80,2577,476,712,.669,476,712,.669,0,0,,332,522,.636,309,732,1041,161,66,187,130,231,1284,17.6
23,Marc Gasol\gasolma01,2017-18,C,73,73,2408,434,1033,.420,325,713,.456,109,320,.341,281,337,.834,78,514,592,305,54,101,194,185,1258,13.2
24,Al Horford\horfoal01,2015-16,C-F,82,82,2631,529,1048,.505,441,792,.557,88,256,.344,103,129,.798,148,448,596,263,68,121,107,163,1249,13.6
25,Brook Lopez\lopezbr01,2014-15,C,72,44,2100,506,987,.513,505,977,.517,1,10,.100,223,274,.814,214,321,535,50,43,126,104,206,1236,13.2
26,Nikola Jokić\jokicni01,2016-17,C-F,73,59,2038,494,854,.578,449,715,.628,45,139,.324,188,228,.825,212,506,718,359,61,55,171,214,1221,16.4
27,DeMarcus Cousins\couside01,2017-18,C-F,48,48,1737,406,864,.470,302,570,.530,104,294,.354,294,394,.746,105,512,617,257,79,76,242,183,1210,19.8
28,Greg Monroe\monrogr01,2015-16,C-F,79,67,2314,491,941,.522,491,940,.522,0,1,.000,228,308,.740,218,478,696,178,72,67,129,163,1210,13.4
29,Nikola Vučević\vucevni01,2015-16,C,65,60,2037,533,1046,.510,531,1037,.512,2,9,.222,113,150,.753,174,402,576,179,53,70,123,173,1181,14.2
30,Myles Turner\turnemy01,2016-17,C-F,81,81,2541,444,869,.511,404,754,.536,40,115,.348,245,303,.809,139,450,589,106,74,172,105,262,1173,12.5
31,Andre Drummond\drumman01,2017-18,C,78,78,2625,466,881,.529,466,870,.536,0,11,.000,239,395,.605,399,848,1247,237,114,127,200,250,1171,16.4
32,Enes Kanter\kanteen01,2014-15,C,75,74,2136,482,928,.519,466,883,.528,16,45,.356,183,234,.782,277,394,671,55,36,29,145,189,1163,11.6
33,Deandre Ayton\aytonde01,2018-19,C,71,70,2183,509,870,.585,509,866,.588,0,4,.000,141,189,.746,223,506,729,125,61,67,126,209,1159,14.5
34,Al Horford\horfoal01,2014-15,C-F,76,76,2318,519,965,.538,508,929,.547,11,36,.306,107,141,.759,131,413,544,244,68,98,100,121,1156,13.8
35,Rudy Gobert\goberru01,2016-17,C,81,81,2744,413,625,.661,413,624,.662,0,1,.000,311,476,.653,314,721,1035,97,49,214,147,246,1137,15.5
36,Jusuf Nurkić\nurkiju01,2017-18,C,79,79,2088,480,951,.505,480,944,.508,0,7,.000,172,273,.630,189,519,708,143,64,111,183,247,1132,11.0
37,Andre Drummond\drumman01,2014-15,C,82,82,2502,494,961,.514,494,959,.515,0,2,.000,142,365,.389,437,667,1104,55,73,153,120,285,1130,12.9
38,Jusuf Nurkić\nurkiju01,2018-19,C,72,72,1974,420,826,.508,417,797,.523,3,29,.103,282,365,.773,243,505,748,233,71,103,168,250,1125,14.5
39,Clint Capela\capelca01,2018-19,C,67,67,2249,474,732,.648,474,732,.648,0,0,,166,261,.636,298,550,848,96,44,102,94,168,1114,17.1
40,Steven Adams\adamsst01,2018-19,C,80,80,2669,481,809,.595,481,807,.596,0,2,.000,146,292,.500,391,369,760,124,117,76,135,204,1108,13.8
41,Andre Drummond\drumman01,2016-17,C,81,81,2409,483,911,.530,481,904,.532,2,7,.286,137,355,.386,345,770,1115,90,124,89,152,237,1105,12.9
42,Greg Monroe\monrogr01,2014-15,C-F,69,57,2137,423,853,.496,423,853,.496,0,0,,252,336,.750,229,475,704,142,78,34,149,148,1098,13.5
43,Nikola Vučević\vucevni01,2016-17,C,75,55,2163,483,1031,.468,460,956,.481,23,75,.307,107,160,.669,176,603,779,208,76,74,117,180,1096,12.5
44,Al Jefferson\jeffeal01,2014-15,C-F,65,61,1992,486,1010,.481,484,1005,.482,2,5,.400,108,165,.655,99,449,548,113,47,84,68,139,1082,12.5
45,Marc Gasol\gasolma01,2018-19,C,79,72,2436,390,870,.448,291,597,.487,99,273,.363,192,253,.759,80,547,627,349,84,86,155,217,1071,12.2
46,Steven Adams\adamsst01,2017-18,C,76,76,2487,448,712,.629,448,710,.631,0,2,.000,160,286,.559,384,301,685,88,92,78,128,215,1056,13.7
47,Hassan Whiteside\whiteha01,2015-16,C,73,43,2125,413,682,.606,413,682,.606,0,0,,214,329,.650,238,627,865,30,44,269,137,201,1040,14.7
48,Enes Kanter\kanteen01,2015-16,C,82,1,1721,414,719,.576,404,698,.579,10,21,.476,200,251,.797,249,415,664,33,26,33,115,166,1038,10.6
49,Enes Kanter\kanteen01,2016-17,C,72,0,1533,402,737,.545,397,699,.568,5,38,.132,224,285,.786,195,287,482,67,32,38,123,154,1033,11.1
50,DeAndre Jordan\jordade01,2016-17,C,81,81,2570,412,577,.714,412,575,.717,0,2,.000,205,425,.482,298,816,1114,96,51,134,115,212,1029,14.4
51,Clint Capela\capelca01,2017-18,C,74,74,2034,441,676,.652,441,675,.653,0,1,.000,144,257,.560,241,561,802,68,58,137,103,185,1026,14.1
52,Marcin Gortat\gortama01,2015-16,C-F,75,74,2256,433,764,.567,433,763,.567,0,1,.000,146,207,.705,222,519,741,106,47,96,121,193,1012,12.4
53,Brook Lopez\lopezbr01,2018-19,C,81,81,2322,355,786,.452,168,274,.613,187,512,.365,112,133,.842,33,363,396,98,51,179,82,189,1009,10.0
54,Dwight Howard\howardw01,2016-17,C,74,74,2199,388,613,.633,388,611,.635,0,2,.000,226,424,.533,296,644,940,104,64,92,170,203,1002,13.5
55,Marcin Gortat\gortama01,2014-15,C-F,82,82,2453,439,775,.566,439,772,.569,0,3,.000,123,175,.703,180,537,717,97,49,110,100,191,1001,11.2
56,Enes Kanter\kanteen01,2017-18,C,71,71,1830,422,713,.592,422,711,.594,0,2,.000,156,184,.848,273,507,780,105,36,37,122,187,1000,13.2
57,Myles Turner\turnemy01,2018-19,C-F,74,74,2119,380,780,.487,304,584,.521,76,196,.388,148,201,.736,101,430,531,115,60,199,100,195,984,11.8
58,DeAndre Jordan\jordade01,2015-16,C,77,77,2598,357,508,.703,357,507,.704,0,1,.000,266,619,.430,267,792,1059,90,51,177,107,207,980,14.3
59,Jonas Valančiūnas\valanjo01,2017-18,C,77,77,1727,390,687,.568,360,613,.587,30,74,.405,170,211,.806,183,477,660,81,29,69,115,192,980,11.1
60,Dwight Howard\howardw01,2015-16,C,71,71,2280,372,600,.620,372,594,.626,0,6,.000,232,474,.489,238,597,835,98,69,113,166,219,976,12.9
61,Jonas Valančiūnas\valanjo01,2014-15,C,80,80,2096,373,652,.572,373,651,.573,0,1,.000,217,276,.786,215,478,693,39,33,95,109,222,963,10.7
62,Brook Lopez\lopezbr01,2017-18,C,74,72,1735,369,793,.465,257,468,.549,112,325,.345,111,158,.703,74,220,294,126,30,98,98,195,961,9.0
63,Jonas Valančiūnas\valanjo01,2016-17,C,80,80,2066,391,702,.557,390,700,.557,1,2,.500,176,217,.811,226,533,759,57,37,63,106,216,959,10.7
64,Al Horford\horfoal01,2016-17,C-F,68,68,2193,379,801,.473,293,559,.524,86,242,.355,108,135,.800,95,370,465,337,52,86,115,138,952,13.1
65,Greg Monroe\monrogr01,2016-17,C-F,81,0,1823,387,726,.533,387,722,.536,0,4,.000,177,239,.741,167,365,532,187,92,38,140,168,951,10.4
66,DeAndre Jordan\jordade01,2014-15,C,82,82,2820,379,534,.710,378,530,.713,1,4,.250,187,471,.397,397,829,1226,61,81,183,109,245,946,14.4
67,Nikola Vučević\vucevni01,2017-18,C,57,57,1683,399,840,.475,335,636,.527,64,204,.314,77,94,.819,101,422,523,191,56,62,109,144,939,13.5
68,Jahlil Okafor\okafoja01,2015-16,C-F,53,48,1591,397,781,.508,396,775,.511,1,6,.167,133,194,.686,122,251,373,65,22,61,124,140,928,11.4
69,Al Horford\horfoal01,2017-18,C-F,72,72,2277,368,753,.489,271,527,.514,97,226,.429,94,120,.783,103,427,530,339,43,78,132,138,927,12.3
70,DeAndre Jordan\jordade01,2017-18,C,77,77,2424,373,578,.645,373,578,.645,0,0,,181,312,.580,329,842,1171,117,39,71,137,203,927,13.7
71,Al Horford\horfoal01,2018-19,C-F,68,68,1973,387,723,.535,314,520,.604,73,203,.360,78,95,.821,120,338,458,283,59,86,102,126,925,13.5
72,Enes Kanter\kanteen01,2018-19,C,67,31,1640,375,683,.549,365,649,.562,10,34,.294,155,197,.787,257,402,659,116,32,26,118,167,915,12.2
73,Steven Adams\adamsst01,2016-17,C,80,80,2389,374,655,.571,374,654,.572,0,1,.000,157,257,.611,281,332,613,86,89,78,146,195,905,10.4
74,JaVale McGee\mcgeeja01,2018-19,C,75,62,1671,400,641,.624,399,629,.634,1,12,.083,96,152,.632,195,371,566,52,47,148,108,208,897,11.1
75,Hassan Whiteside\whiteha01,2018-19,C,72,53,1674,388,680,.571,386,664,.581,2,16,.125,109,243,.449,257,560,817,56,46,136,97,192,887,12.0
76,Marcin Gortat\gortama01,2016-17,C-F,82,82,2556,390,674,.579,390,672,.580,0,2,.000,103,159,.648,238,611,849,121,40,61,119,213,883,10.5
77,Jarrett Allen\allenja01,2018-19,C-F,80,80,2096,335,568,.590,329,523,.629,6,45,.133,197,278,.709,191,481,672,110,43,120,103,184,873,11.0
78,Kelly Olynyk\olynyke01,2017-18,C-F,76,22,1779,316,636,.497,210,356,.590,106,280,.379,134,174,.770,89,342,431,207,62,35,147,222,872,9.2
79,Marc Gasol\gasolma01,2015-16,C,52,52,1791,328,707,.464,326,704,.463,2,3,.667,203,245,.829,58,304,362,196,50,70,118,141,861,13.0
80,Alex Len\lenal01,2018-19,C,77,31,1544,320,648,.494,246,444,.554,74,204,.363,140,216,.648,158,266,424,86,27,69,97,200,854,8.4
81,Robin Lopez\lopezro01,2015-16,C,82,82,2219,357,662,.539,357,661,.540,0,1,.000,128,161,.795,268,334,602,114,16,129,133,182,842,9.5
82,Mason Plumlee\plumlma01,2016-17,C-F,81,64,2147,334,623,.536,334,617,.541,0,6,.000,174,300,.580,170,435,605,284,69,92,134,226,842,10.4
83,Jordan Hill\hilljo01,2014-15,C-F,70,57,1874,357,777,.459,354,766,.462,3,11,.273,124,168,.738,174,382,556,103,34,52,106,164,841,9.0
84,Robin Lopez\lopezro01,2016-17,C,81,81,2271,382,775,.493,382,773,.494,0,2,.000,75,104,.721,244,276,520,80,18,117,91,151,839,8.6
85,Myles Turner\turnemy01,2017-18,C-F,65,62,1836,306,639,.479,250,482,.519,56,157,.357,160,206,.777,93,324,417,87,38,118,96,186,828,10.1
86,Gorgui Dieng\dienggo01,2015-16,C,82,39,2220,308,579,.532,302,559,.540,6,20,.300,205,248,.827,157,428,585,143,94,96,140,219,827,9.8
87,Clint Capela\capelca01,2016-17,C,65,59,1551,362,563,.643,362,563,.643,0,0,,94,177,.531,178,348,526,63,34,79,87,179,818,11.4
88,Gorgui Dieng\dienggo01,2016-17,C,82,82,2653,332,661,.502,316,618,.511,16,43,.372,136,167,.814,188,459,647,158,88,95,107,254,816,9.8
89,Roy Hibbert\hibbero01,2014-15,C,76,76,1926,317,710,.446,317,708,.448,0,2,.000,168,204,.824,156,384,540,84,18,125,107,216,802,8.1
90,Nikola Jokić\jokicni01,2015-16,C-F,80,55,1733,307,600,.512,279,516,.541,28,84,.333,154,190,.811,181,379,560,189,79,50,104,208,796,9.8
91,Marreese Speights\speigma01,2014-15,C-F,76,9,1207,318,646,.492,313,628,.498,5,18,.278,150,178,.843,109,216,325,72,20,34,82,189,791,7.0
92,Kelly Olynyk\olynyke01,2018-19,C-F,79,36,1812,261,564,.463,148,245,.604,113,319,.354,152,185,.822,72,303,375,140,53,37,114,183,787,7.8
93,Timofey Mozgov\mozgoti01,2014-15,C,81,80,2046,314,566,.555,312,560,.557,2,6,.333,155,216,.718,203,388,591,55,33,97,116,227,785,8.4
94,Tyson Chandler\chandty01,2014-15,C,75,75,2286,293,440,.666,293,440,.666,0,0,,185,257,.720,294,570,864,84,42,91,105,169,771,12.3
95,Jonas Valančiūnas\valanjo01,2015-16,C,60,59,1557,303,536,.565,303,536,.565,0,0,,162,213,.761,184,363,547,42,25,80,85,158,768,11.6
96,Jonas Valančiūnas\valanjo01,2018-19,C,49,27,1091,301,538,.559,287,490,.586,14,48,.292,147,185,.795,106,313,419,70,19,53,90,146,763,12.6
97,Thomas Bryant\bryanth01,2018-19,C,72,53,1496,309,502,.616,276,403,.685,33,99,.333,107,137,.781,113,341,454,92,25,67,60,126,758,10.1
98,DeAndre Jordan\jordade01,2018-19,C,69,69,2047,286,446,.641,286,446,.641,0,0,,186,264,.705,225,677,902,156,42,73,153,167,758,12.6
99,Rudy Gobert\goberru01,2017-18,C,56,56,1816,276,444,.622,276,444,.622,0,0,,204,299,.682,165,436,601,80,44,129,107,153,756,14.0
100,Robin Lopez\lopezro01,2017-18,C,64,64,1690,342,645,.530,338,631,.536,4,14,.286,68,90,.756,134,156,290,124,14,53,107,109,756,8.8
101,Hassan Whiteside\whiteha01,2017-18,C,54,54,1364,312,578,.540,310,576,.538,2,2,1.000,128,182,.703,174,444,618,54,37,94,92,131,754,13.0
102,Mason Plumlee\plumlma01,2015-16,C-F,82,82,2084,267,517,.516,267,513,.520,0,4,.000,215,335,.642,201,427,628,226,68,85,154,253,749,9.1
103,Nerlens Noel\noelne01,2015-16,C-F,67,62,1965,306,587,.521,305,585,.521,1,2,.500,134,227,.590,154,388,542,122,118,100,158,192,747,10.2
104,Nerlens Noel\noelne01,2014-15,C-F,75,71,2311,302,653,.462,302,653,.462,0,0,,140,230,.609,185,426,611,128,133,142,146,208,744,9.6
105,Bam Adebayo\adebaba01,2018-19,C-F,82,28,1913,280,486,.576,277,471,.588,3,15,.200,166,226,.735,165,432,597,184,71,65,121,203,729,9.3
106,Mason Plumlee\plumlma01,2014-15,C-F,82,45,1743,280,489,.573,280,486,.576,0,3,.000,157,317,.495,175,337,512,74,65,63,106,207,717,7.5
107,Marreese Speights\speigma01,2016-17,C-F,82,2,1286,244,548,.445,141,271,.520,103,277,.372,120,137,.876,88,285,373,65,23,41,69,229,711,6.1
108,Gorgui Dieng\dienggo01,2014-15,C,73,49,2193,259,512,.506,258,506,.510,1,6,.167,191,244,.783,223,386,609,146,71,126,126,188,710,10.5
109,Robin Lopez\lopezro01,2018-19,C,74,36,1606,304,535,.568,297,504,.589,7,31,.226,89,123,.724,140,146,286,89,11,78,96,124,704,7.6
110,Alex Len\lenal01,2015-16,C,78,46,1821,264,624,.423,263,617,.426,1,7,.143,174,239,.728,178,416,594,97,38,62,145,230,703,6.5
111,Dewayne Dedmon\dedmode01,2018-19,C,64,52,1609,259,526,.492,176,309,.570,83,217,.382,92,113,.814,105,375,480,90,69,71,84,214,693,9.7
112,Marcin Gortat\gortama01,2017-18,C-F,82,82,2075,290,560,.518,290,560,.518,0,0,,110,163,.675,181,442,623,151,40,61,99,175,690,8.2
113,Kelly Olynyk\olynyke01,2015-16,C-F,69,8,1395,253,556,.455,168,346,.486,85,210,.405,96,128,.750,72,209,281,105,52,33,74,163,687,7.4
114,Rudy Gobert\goberru01,2014-15,C,82,37,2158,258,427,.604,258,425,.607,0,2,.000,170,273,.623,265,510,775,109,64,189,111,175,686,10.7
115,Kelly Olynyk\olynyke01,2016-17,C-F,75,6,1538,260,508,.512,192,316,.608,68,192,.354,90,123,.732,73,288,361,148,43,29,96,207,678,7.2
116,Channing Frye\fryech01,2016-17,C-F,74,15,1398,238,520,.458,101,185,.546,137,335,.409,63,74,.851,37,253,290,45,33,37,53,138,676,6.6
117,John Henson\hensojo01,2017-18,C-F,76,69,1970,287,502,.572,286,495,.578,1,7,.143,90,158,.570,150,363,513,114,45,109,84,202,665,8.6
118,Jusuf Nurkić\nurkiju01,2016-17,C,65,48,1391,271,534,.507,271,533,.508,0,1,.000,120,210,.571,154,313,467,123,50,74,143,161,662,8.4
119,Ian Mahinmi\mahinia01,2015-16,C,71,71,1816,264,448,.589,264,448,.589,0,0,,132,225,.587,138,369,507,104,65,75,100,220,660,8.8
120,Kelly Olynyk\olynyke01,2014-15,C-F,64,13,1423,251,528,.475,190,353,.538,61,175,.349,93,136,.684,92,211,303,109,64,39,98,213,656,7.5
121,Zaza Pachulia\pachuza01,2015-16,C,76,69,2004,219,470,.466,219,467,.469,0,3,.000,212,276,.768,249,469,718,128,64,22,119,181,650,8.9
122,Dwight Howard\howardw01,2014-15,C,41,41,1223,251,423,.593,250,421,.594,1,2,.500,143,271,.528,110,321,431,50,28,53,115,137,646,12.3
123,Jordan Hill\hilljo01,2015-16,C-F,73,11,1513,278,549,.506,278,548,.507,0,1,.000,89,125,.712,156,295,451,87,36,37,92,155,645,7.2
124,Cody Zeller\zelleco01,2016-17,C-F,62,58,1725,253,443,.571,253,442,.572,0,1,.000,133,196,.679,135,270,405,99,62,58,65,189,639,9.9
125,Chris Kaman\kamanch01,2014-15,C,74,13,1398,283,549,.515,283,549,.515,0,0,,72,102,.706,149,335,484,65,18,54,108,140,638,6.7
126,Cody Zeller\zelleco01,2015-16,C-F,73,60,1774,231,437,.529,230,427,.539,1,10,.100,175,232,.754,138,317,455,71,57,63,68,204,638,8.1
127,Mason Plumlee\plumlma01,2018-19,C-F,82,17,1731,262,442,.593,260,432,.602,2,10,.200,111,198,.561,165,359,524,243,66,76,126,252,637,8.3
128,Steven Adams\adamsst01,2015-16,C,80,80,2014,261,426,.613,261,426,.613,0,0,,114,196,.582,219,314,533,62,42,89,84,223,636,7.9
129,Joel Embiid\embiijo01,2016-17,C,31,31,786,200,429,.466,164,331,.495,36,98,.367,191,244,.783,61,182,243,66,27,76,117,112,627,14.4
130,Myles Turner\turnemy01,2015-16,C-F,60,30,1367,264,530,.498,261,516,.506,3,14,.214,88,121,.727,68,264,332,41,25,86,67,158,619,7.5
131,Dewayne Dedmon\dedmode01,2017-18,C,62,46,1542,250,477,.524,200,336,.595,50,141,.355,67,86,.779,100,389,489,90,40,51,86,162,617,8.9
132,Alex Len\lenal01,2016-17,C,77,34,1560,230,463,.497,227,451,.503,3,12,.250,150,208,.721,156,354,510,44,38,98,102,242,613,6.6
133,Zaza Pachulia\pachuza01,2014-15,C,73,45,1730,240,529,.454,240,526,.456,0,3,.000,126,160,.788,197,303,500,178,80,21,133,170,606,7.7
134,Jahlil Okafor\okafoja01,2016-17,C-F,50,33,1134,242,471,.514,242,471,.514,0,0,,106,158,.671,81,159,240,58,20,49,91,122,590,7.9
135,Jarrett Allen\allenja01,2017-18,C-F,72,31,1441,234,397,.589,229,382,.599,5,15,.333,114,147,.776,144,244,388,49,28,88,82,147,587,7.6
136,Willy Hernangómez\hernawi01,2016-17,C,72,22,1324,246,465,.529,242,450,.538,4,15,.267,91,125,.728,170,332,502,96,41,36,100,150,587,7.5
137,Alex Len\lenal01,2017-18,C,69,13,1395,214,378,.566,213,375,.568,1,3,.333,158,231,.684,175,343,518,82,27,61,78,158,587,8.6
138,Henry Sims\simshe01,2014-15,C,73,32,1399,238,502,.474,234,480,.488,4,22,.182,106,137,.774,121,238,359,79,39,30,99,135,586,6.0
139,Jakob Pöltl\poeltja01,2017-18,C,82,0,1524,253,384,.659,252,382,.660,1,2,.500,60,101,.594,165,228,393,57,39,100,85,212,567,6.7
140,Robin Lopez\lopezro01,2014-15,C,59,59,1638,234,437,.535,234,436,.537,0,1,.000,98,127,.772,190,204,394,55,16,84,73,122,566,8.9
141,Hassan Whiteside\whiteha01,2014-15,C,48,32,1142,243,387,.628,243,387,.628,0,0,,78,156,.500,145,337,482,6,27,123,58,129,564,11.9
142,Al Jefferson\jeffeal01,2015-16,C-F,47,18,1096,245,505,.485,245,505,.485,0,0,,72,111,.649,57,244,301,70,30,41,34,117,562,9.2
143,Ömer Aşık\asikom01,2014-15,C,76,76,1982,213,412,.517,213,412,.517,0,0,,131,225,.582,244,504,748,72,29,54,95,144,557,7.9
144,Rudy Gobert\goberru01,2015-16,C,61,60,1932,198,354,.559,198,354,.559,0,0,,161,283,.569,208,460,668,91,45,135,114,163,557,10.6
145,Channing Frye\fryech01,2014-15,C-F,75,51,1870,191,487,.392,55,141,.390,136,346,.393,31,35,.886,27,266,293,94,47,39,78,191,549,4.9
146,Clint Capela\capelca01,2015-16,C,77,35,1471,231,397,.582,231,396,.583,0,1,.000,80,211,.379,194,300,494,47,59,92,60,190,542,7.1
147,Steven Adams\adamsst01,2014-15,C,70,67,1771,217,399,.544,217,397,.547,0,2,.000,103,205,.502,199,324,523,66,38,86,99,222,537,7.1
148,Al Jefferson\jeffeal01,2016-17,C-F,66,1,931,235,471,.499,235,470,.500,0,1,.000,65,85,.765,75,203,278,57,19,16,33,125,535,5.9
149,Kosta Koufos\koufoko01,2015-16,C,78,14,1482,236,444,.532,236,444,.532,0,0,,57,104,.548,169,254,423,33,40,70,48,185,529,6.1
150,Ivica Zubac\zubaciv01,2018-19,C,59,37,1039,212,379,.559,212,379,.559,0,0,,101,126,.802,115,247,362,63,14,51,70,137,525,7.8
151,Greg Monroe\monrogr01,2017-18,C-F,51,14,1041,218,386,.565,218,386,.565,0,0,,88,119,.739,109,241,350,114,44,23,94,95,524,9.5
152,Mason Plumlee\plumlma01,2017-18,C-F,74,26,1439,221,368,.601,221,367,.602,0,1,.000,82,179,.458,132,268,400,142,49,81,103,184,524,7.0
153,Aron Baynes\baynear01,2015-16,C,81,1,1233,194,384,.505,194,382,.508,0,2,.000,126,165,.764,140,244,384,51,21,52,67,151,514,5.5
154,Zach Collins\colliza01,2018-19,C-F,77,0,1356,189,400,.473,149,279,.534,40,121,.331,94,126,.746,109,215,324,71,25,66,77,174,512,5.3
155,Marreese Speights\speigma01,2015-16,C-F,72,0,832,197,456,.432,173,394,.439,24,62,.387,94,114,.825,77,162,239,61,19,34,66,117,512,4.7
156,Meyers Leonard\leoname01,2015-16,C-F,61,10,1333,195,435,.448,109,207,.527,86,228,.377,35,46,.761,51,263,314,92,8,18,77,183,511,5.4
157,Cody Zeller\zelleco01,2018-19,C-F,49,47,1243,190,345,.551,184,323,.570,6,22,.273,111,141,.787,110,223,333,102,38,41,62,164,497,9.7
158,DeMarcus Cousins\couside01,2018-19,C-F,30,30,771,178,371,.480,152,276,.551,26,95,.274,106,144,.736,43,204,247,107,40,44,72,109,488,13.5
159,Gorgui Dieng\dienggo01,2018-19,C,76,2,1031,189,377,.501,170,321,.530,19,56,.339,88,106,.830,81,230,311,72,48,41,57,134,485,5.7
160,Joakim Noah\noahjo01,2014-15,C,67,67,2049,190,427,.445,190,425,.447,0,2,.000,105,174,.603,219,427,646,312,48,74,123,203,485,9.4
161,Mitchell Robinson\robinmi01,2018-19,C,66,19,1360,202,291,.694,202,291,.694,0,0,,81,135,.600,177,246,423,37,52,161,35,217,485,9.2
162,Jahlil Okafor\okafoja01,2018-19,C-F,59,24,935,212,362,.586,211,357,.591,1,5,.200,59,89,.663,82,196,278,40,15,40,52,96,484,6.8
163,Bismack Biyombo\biyombi01,2016-17,C-F,81,27,1793,179,339,.528,179,339,.528,0,0,,125,234,.534,157,410,567,74,25,91,95,202,483,5.8
164,Aron Baynes\baynear01,2017-18,C,81,67,1485,210,446,.471,207,425,.487,3,21,.143,59,78,.756,130,304,434,93,22,51,80,200,482,4.8
165,Roy Hibbert\hibbero01,2015-16,C,81,81,1878,182,411,.443,182,409,.445,0,2,.000,117,145,.807,132,266,398,95,32,110,76,252,481,5.3
166,Bam Adebayo\adebaba01,2017-18,C-F,69,19,1368,174,340,.512,174,333,.523,0,7,.000,129,179,.721,118,263,381,101,32,41,66,138,477,6.7
167,Kosta Koufos\koufoko01,2017-18,C,71,12,1391,222,389,.571,222,389,.571,0,0,,33,74,.446,149,323,472,87,47,32,49,146,477,7.1
168,Timofey Mozgov\mozgoti01,2015-16,C,76,48,1326,203,359,.565,202,352,.574,1,7,.143,68,95,.716,110,227,337,33,22,57,71,159,475,5.1
169,Tyson Chandler\chandty01,2015-16,C,66,60,1618,183,314,.583,183,313,.585,0,1,.000,106,171,.620,175,401,576,64,36,44,93,145,472,7.6
170,JaVale McGee\mcgeeja01,2016-17,C,77,10,739,208,319,.652,208,316,.658,0,3,.000,56,111,.505,100,144,244,17,19,67,40,109,472,5.4
171,Cody Zeller\zelleco01,2014-15,C-F,62,45,1487,172,373,.461,171,372,.460,1,1,1.000,127,164,.774,97,265,362,100,34,49,62,156,472,6.9
172,Gorgui Dieng\dienggo01,2017-18,C,79,0,1333,186,388,.479,167,327,.511,19,61,.311,79,102,.775,106,254,360,71,45,39,59,147,470,5.3
173,John Henson\hensojo01,2014-15,C-F,67,11,1228,196,346,.566,196,346,.566,0,0,,78,137,.569,124,188,312,59,28,135,87,152,470,6.6
174,Kosta Koufos\koufoko01,2016-17,C,71,62,1419,216,392,.551,216,391,.552,0,1,.000,38,62,.613,118,285,403,47,36,48,61,172,470,5.8
175,Bismack Biyombo\biyombi01,2017-18,C-F,82,25,1495,183,352,.520,183,351,.521,0,1,.000,102,157,.650,144,324,468,66,21,95,84,158,468,5.6
176,Joffrey Lauvergne\lauvejo01,2015-16,C-F,59,15,1041,195,380,.513,182,327,.557,13,53,.245,62,69,.899,77,213,290,56,13,15,54,115,465,6.0
177,Aron Baynes\baynear01,2014-15,C,70,17,1122,185,327,.566,184,323,.570,1,4,.250,90,104,.865,109,209,318,35,16,22,65,162,461,5.2
178,Wendell Carter\cartewe01,2018-19,C,44,44,1110,180,371,.485,174,339,.513,6,32,.188,89,112,.795,87,220,307,78,26,58,65,152,455,8.6
179,Bismack Biyombo\biyombi01,2015-16,C-F,82,22,1808,156,288,.542,156,287,.544,0,1,.000,142,226,.628,182,473,655,29,19,133,71,225,454,6.4
180,Nerlens Noel\noelne01,2016-17,C-F,51,19,1047,184,309,.595,184,308,.597,0,1,.000,77,111,.694,93,201,294,50,65,50,51,126,445,8.8
181,Alexis Ajinça\ajincal01,2014-15,C-F,68,8,957,181,329,.550,181,329,.550,0,0,,81,99,.818,104,211,315,47,21,51,69,151,443,5.5
182,Justin Hamilton\hamilju01,2016-17,C,64,7,1177,174,379,.459,119,199,.598,55,180,.306,39,52,.750,71,191,262,55,29,43,43,91,442,5.7
183,Alex Len\lenal01,2014-15,C,69,44,1518,179,353,.507,178,350,.509,1,3,.333,73,104,.702,142,312,454,32,34,105,74,213,432,5.9
184,Jusuf Nurkić\nurkiju01,2014-15,C,62,27,1103,171,383,.446,171,381,.449,0,2,.000,84,132,.636,125,257,382,50,52,68,86,207,426,5.4
185,Zaza Pachulia\pachuza01,2016-17,C,70,70,1268,164,307,.534,164,305,.538,0,2,.000,98,126,.778,140,270,410,132,59,33,87,166,426,6.7
186,Channing Frye\fryech01,2015-16,C-F,70,32,1199,152,347,.438,61,112,.545,91,235,.387,30,35,.857,35,199,234,71,29,28,43,127,425,4.7
187,Spencer Hawes\hawessp01,2014-15,C-F,73,15,1274,163,415,.393,108,239,.452,55,176,.313,44,68,.647,30,228,258,88,24,53,61,173,425,3.7
188,Jakob Pöltl\poeltja01,2018-19,C,77,24,1273,187,290,.645,187,290,.645,0,0,,49,92,.533,178,232,410,93,29,68,48,124,423,6.7
189,Andrew Bogut\bogutan01,2014-15,C,67,65,1583,200,355,.563,200,355,.563,0,0,,22,42,.524,141,402,543,180,39,113,106,188,422,7.9
190,Boban Marjanović\marjabo01,2018-19,C,58,12,681,160,260,.615,156,250,.624,4,10,.400,98,131,.748,87,178,265,54,16,27,59,90,422,6.6
191,Willy Hernangómez\hernawi01,2018-19,C,58,3,812,153,295,.519,138,256,.539,15,39,.385,100,144,.694,117,194,311,60,16,20,58,98,421,6.4
192,Kosta Koufos\koufoko01,2014-15,C,81,3,1348,182,358,.508,182,358,.508,0,0,,55,85,.647,121,305,426,37,29,63,69,148,419,4.6
193,Marreese Speights\speigma01,2017-18,C-F,52,3,675,138,349,.395,52,116,.448,86,233,.369,40,55,.727,21,112,133,40,8,22,40,106,402,4.3
194,Meyers Leonard\leoname01,2016-17,C-F,74,12,1222,146,378,.386,72,165,.436,74,213,.347,35,40,.875,27,210,237,71,13,28,35,172,401,3.4
195,Timofey Mozgov\mozgoti01,2016-17,C,54,52,1104,169,328,.515,169,327,.517,0,1,.000,63,78,.808,104,160,264,43,16,31,72,133,401,5.5
196,Tyson Chandler\chandty01,2016-17,C,47,46,1298,153,228,.671,153,228,.671,0,0,,91,124,.734,153,386,539,30,33,24,65,126,397,9.9
197,John Henson\hensojo01,2015-16,C-F,57,1,959,164,291,.564,164,290,.566,0,1,.000,69,117,.590,87,134,221,54,18,109,64,131,397,6.3
198,John Henson\hensojo01,2016-17,C-F,58,39,1123,159,309,.515,159,308,.516,0,1,.000,74,107,.692,92,203,295,57,29,78,52,151,392,6.3
199,Dewayne Dedmon\dedmode01,2016-17,C,76,37,1330,161,259,.622,161,259,.622,0,0,,65,93,.699,129,367,496,44,37,61,61,180,387,5.7
200,Nikola Peković\pekovni01,2014-15,C,31,29,815,139,328,.424,139,328,.424,0,0,,108,129,.837,89,145,234,27,19,12,42,59,386,9.4
201,Tarik Black\blackta01,2016-17,C-F,67,16,1091,150,294,.510,149,292,.510,1,2,.500,82,109,.752,144,199,343,39,29,44,58,173,383,5.2
202,Tarik Black\blackta01,2014-15,C-F,63,39,1195,157,273,.575,157,272,.577,0,1,.000,65,118,.551,142,226,368,42,19,24,48,158,379,5.6
203,Nerlens Noel\noelne01,2018-19,C-F,77,2,1055,162,276,.587,162,276,.587,0,0,,54,79,.684,127,198,325,45,66,96,48,166,378,5.7
204,Andrew Bogut\bogutan01,2015-16,C,70,66,1451,175,279,.627,174,278,.626,1,1,1.000,24,50,.480,121,371,492,162,33,114,83,221,375,7.0
205,Joffrey Lauvergne\lauvejo01,2016-17,C-F,70,1,980,148,336,.440,115,238,.483,33,98,.337,46,73,.630,72,179,251,70,25,6,56,83,375,4.0
206,Daniel Theis\theisda01,2018-19,C,66,2,908,146,266,.549,120,199,.603,26,67,.388,56,76,.737,87,138,225,68,21,42,33,161,374,5.2
207,Zaza Pachulia\pachuza01,2017-18,C,69,57,972,149,264,.564,149,263,.567,0,1,.000,75,93,.806,89,232,321,109,38,17,72,122,373,5.5
208,Ian Mahinmi\mahinia01,2017-18,C,77,0,1145,138,248,.556,138,246,.561,0,2,.000,90,128,.703,135,177,312,53,38,42,100,230,366,3.8
209,Aron Baynes\baynear01,2016-17,C,75,2,1163,143,279,.513,143,279,.513,0,0,,79,94,.840,111,222,333,32,17,39,50,166,365,4.2
210,Deyonta Davis\davisde01,2017-18,C-F,62,6,943,161,265,.608,161,265,.608,0,0,,38,57,.667,75,175,250,40,15,39,32,125,360,5.2
211,Meyers Leonard\leoname01,2018-19,C-F,61,2,878,132,242,.545,82,131,.626,50,111,.450,43,51,.843,49,184,233,75,13,9,43,105,357,5.1
212,Pero Antić\anticpe01,2014-15,C-F,63,3,1037,108,296,.365,56,123,.455,52,173,.301,88,123,.715,58,131,189,49,18,14,49,132,356,3.5
213,Alexis Ajinça\ajincal01,2015-16,C-F,59,17,861,150,315,.476,150,314,.478,0,1,.000,52,62,.839,75,194,269,31,19,36,54,134,352,4.3
214,Spencer Hawes\hawessp01,2015-16,C-F,57,6,1035,124,306,.405,86,204,.422,38,102,.373,54,65,.831,51,193,244,109,22,27,58,111,340,4.9
215,Cole Aldrich\aldrico01,2014-15,C,61,16,976,144,301,.478,144,301,.478,0,0,,50,64,.781,101,237,338,75,37,65,59,122,338,5.7
216,Spencer Hawes\hawessp01,2016-17,C-F,54,1,797,134,277,.484,109,196,.556,25,81,.309,44,52,.846,38,153,191,81,15,30,49,77,337,5.2
217,Daniel Theis\theisda01,2017-18,C,63,3,936,126,233,.541,108,175,.617,18,58,.310,61,81,.753,90,184,274,56,30,48,56,157,331,5.0
218,Cole Aldrich\aldrico01,2015-16,C,60,5,800,134,225,.596,134,225,.596,0,0,,60,84,.714,86,202,288,50,47,68,64,139,328,5.8
219,Meyers Leonard\leoname01,2014-15,C-F,55,7,847,125,245,.510,78,133,.586,47,112,.420,30,32,.938,46,204,250,32,10,14,39,113,327,4.7
220,Chris Andersen\anderch01,2014-15,C-F,60,20,1132,120,207,.580,116,194,.598,4,13,.308,76,114,.667,76,223,299,43,26,61,40,88,320,5.9
221,Festus Ezeli\ezelife01,2015-16,C,46,13,770,125,228,.548,125,228,.548,0,0,,70,132,.530,91,166,257,32,18,50,38,94,320,6.5
222,Miles Plumlee\plumlmi01,2015-16,C-F,61,14,870,140,233,.601,140,233,.601,0,0,,34,59,.576,94,138,232,16,21,50,40,73,314,5.0
223,JaVale McGee\mcgeeja01,2017-18,C,65,17,615,136,219,.621,136,213,.638,0,6,.000,38,52,.731,59,110,169,33,21,57,27,91,310,4.6
224,Robert Sacre\sacrero01,2014-15,C,67,18,1133,126,306,.412,126,305,.413,0,1,.000,55,82,.671,89,144,233,55,28,43,36,121,307,3.7
225,Bismack Biyombo\biyombi01,2014-15,C-F,64,21,1243,101,186,.543,101,186,.543,0,0,,102,175,.583,159,248,407,16,18,99,52,140,304,5.6
226,Tyson Chandler\chandty01,2017-18,C,46,46,1151,121,187,.647,121,187,.647,0,0,,58,93,.624,134,284,418,53,16,27,59,106,300,7.7
227,Joakim Noah\noahjo01,2018-19,C,42,1,693,110,213,.516,110,212,.519,0,1,.000,78,109,.716,58,180,238,89,20,31,50,96,298,6.9
228,Boban Marjanović\marjabo01,2015-16,C,54,4,508,105,174,.603,105,174,.603,0,0,,87,114,.763,73,121,194,21,12,23,29,54,297,5.3
229,Miles Plumlee\plumlmi01,2014-15,C-F,73,28,1194,136,254,.535,136,254,.535,0,0,,22,46,.478,112,208,320,34,41,66,51,111,294,4.3
230,Mo Bamba\bambamo01,2018-19,C,47,1,766,117,243,.481,96,173,.555,21,70,.300,37,63,.587,64,169,233,39,13,64,43,102,292,5.4
231,Zach Collins\colliza01,2017-18,C-F,66,1,1045,115,289,.398,80,176,.455,35,113,.310,27,42,.643,45,176,221,52,17,31,58,133,292,2.7
232,Aron Baynes\baynear01,2018-19,C,51,18,821,105,223,.471,84,162,.519,21,61,.344,53,62,.855,88,152,240,57,12,34,40,125,284,5.1
233,Ivica Zubac\zubaciv01,2016-17,C,38,11,609,126,238,.529,126,235,.536,0,3,.000,32,49,.653,41,118,159,30,14,33,30,66,284,6.0
234,Ömer Aşık\asikom01,2015-16,C,68,64,1178,104,195,.533,104,195,.533,0,0,,61,112,.545,120,294,414,26,21,23,60,124,269,4.0
235,Zaza Pachulia\pachuza01,2018-19,C,68,3,878,85,193,.440,85,189,.450,0,4,.000,97,124,.782,99,166,265,91,31,17,57,151,267,3.9
236,Ian Mahinmi\mahinia01,2014-15,C,61,6,1146,117,212,.552,117,212,.552,0,0,,31,102,.304,105,251,356,33,30,46,59,172,265,4.0
237,Channing Frye\fryech01,2017-18,C-F,53,1,695,104,212,.491,65,97,.670,39,115,.339,17,19,.895,12,123,135,38,18,13,21,69,264,3.9
238,Jusuf Nurkić\nurkiju01,2015-16,C,32,3,547,101,242,.417,101,239,.423,0,3,.000,61,99,.616,65,110,175,40,24,44,55,91,263,5.9
239,Dewayne Dedmon\dedmode01,2015-16,C,58,20,705,99,177,.559,99,177,.559,0,0,,57,76,.750,67,161,228,13,22,46,32,109,255,4.2
240,Lucas Nogueira\noguelu01,2016-17,C,57,6,1088,103,156,.660,100,144,.694,3,12,.250,44,67,.657,82,162,244,42,52,89,46,137,253,5.7
241,Al Jefferson\jeffeal01,2017-18,C-F,36,1,484,111,208,.534,111,205,.541,0,3,.000,30,36,.833,30,113,143,30,16,23,21,66,252,5.8
242,Willy Hernangómez\hernawi01,2017-18,C,48,1,494,91,164,.555,86,152,.566,5,12,.417,59,90,.656,61,122,183,33,18,16,35,64,246,4.7
243,Kendrick Perkins\perkike01,2014-15,C,68,3,1148,102,227,.449,102,226,.451,0,1,.000,42,83,.506,91,229,320,51,16,42,95,162,246,2.4
244,Khem Birch\birchkh01,2018-19,C-F,50,1,643,91,151,.603,91,150,.607,0,1,.000,58,83,.699,79,111,190,38,18,29,20,72,240,5.3
245,Miles Plumlee\plumlmi01,2017-18,C-F,55,35,918,105,180,.583,105,180,.583,0,0,,27,60,.450,77,151,228,45,17,30,63,79,237,3.9
246,Bismack Biyombo\biyombi01,2018-19,C-F,54,32,783,89,156,.571,89,156,.571,0,0,,58,91,.637,81,166,247,33,11,41,34,103,236,4.5
247,Boban Marjanović\marjabo01,2017-18,C,39,1,338,79,148,.534,79,148,.534,0,0,,77,97,.794,48,96,144,22,10,11,36,51,235,5.0
248,Marcin Gortat\gortama01,2018-19,C-F,47,43,751,99,186,.532,99,186,.532,0,0,,35,48,.729,67,194,261,65,6,24,50,92,233,4.8
249,Cody Zeller\zelleco01,2017-18,C-F,33,0,627,85,156,.545,83,153,.542,2,3,.667,61,85,.718,67,110,177,31,14,21,33,81,233,6.5
250,Joakim Noah\noahjo01,2016-17,C,46,46,1015,99,202,.490,99,201,.493,0,1,.000,34,78,.436,162,241,403,103,30,37,58,127,232,6.9
251,Greg Monroe\monrogr01,2018-19,C-F,43,2,480,92,189,.487,91,184,.495,1,5,.200,45,72,.625,67,105,172,24,14,8,32,66,230,4.2
252,Joffrey Lauvergne\lauvejo01,2017-18,C-F,55,1,534,98,190,.516,98,185,.530,0,5,.000,30,47,.638,63,108,171,41,9,3,33,45,226,3.5
253,Roy Hibbert\hibbero01,2016-17,C,48,13,682,80,147,.544,80,147,.544,0,0,,61,75,.813,54,98,152,21,8,46,32,100,221,4.1
254,Justin Hamilton\hamilju01,2014-15,C,41,14,713,85,178,.478,75,147,.510,10,31,.323,39,47,.830,57,77,134,36,27,30,26,70,219,5.1
255,Jeff Withey\witheje01,2015-16,C,51,10,658,87,162,.537,87,160,.544,0,2,.000,43,59,.729,56,117,173,20,21,53,28,75,217,4.3
256,Dewayne Dedmon\dedmode01,2014-15,C,59,15,845,91,162,.562,91,161,.565,0,1,.000,34,64,.531,118,177,295,9,16,50,51,141,216,3.6
257,Salah Mejri\mejrisa01,2017-18,C,61,1,729,88,137,.642,88,134,.657,0,3,.000,38,66,.576,85,161,246,35,22,67,39,121,214,4.2
258,Salah Mejri\mejrisa01,2016-17,C,73,11,905,88,137,.642,87,134,.649,1,3,.333,36,61,.590,97,211,308,14,32,61,40,152,213,3.5
259,Alexis Ajinça\ajincal01,2016-17,C-F,39,15,584,89,178,.500,89,174,.511,0,4,.000,29,40,.725,46,131,177,12,20,22,31,77,207,4.3
260,Festus Ezeli\ezelife01,2014-15,C,46,7,504,76,139,.547,76,139,.547,0,0,,49,78,.628,60,95,155,9,7,42,32,77,201,3.8
261,Larry Sanders\sandela01,2014-15,C-F,27,26,586,86,172,.500,86,172,.500,0,0,,24,48,.500,67,99,166,23,26,39,28,104,196,6.5
262,Boban Marjanović\marjabo01,2016-17,C,35,0,293,72,132,.545,72,132,.545,0,0,,47,58,.810,46,84,130,9,6,12,10,25,191,5.2
263,Tarik Black\blackta01,2017-18,C-F,51,2,536,75,127,.591,74,116,.638,1,11,.091,29,63,.460,63,100,163,13,21,30,35,107,180,3.0
264,Khem Birch\birchkh01,2017-18,C-F,42,0,578,68,126,.540,68,126,.540,0,0,,42,61,.689,70,110,180,34,15,21,21,56,178,4.8
265,Jahlil Okafor\okafoja01,2017-18,C-F,28,0,353,77,138,.558,76,134,.567,1,4,.250,21,29,.724,21,64,85,12,3,18,21,51,176,4.4
266,Tyson Chandler\chandty01,2018-19,C,55,6,875,61,99,.616,61,98,.622,0,1,.000,51,87,.586,92,215,307,37,21,23,42,110,173,4.0
267,Ian Mahinmi\mahinia01,2016-17,C,31,0,555,65,111,.586,65,111,.586,0,0,,43,75,.573,47,103,150,19,33,24,34,90,173,5.3
268,JaVale McGee\mcgeeja01,2015-16,C,34,2,370,77,134,.575,77,133,.579,0,1,.000,18,36,.500,53,80,133,3,5,26,21,49,172,4.3
269,Jakob Pöltl\poeltja01,2016-17,C,54,4,626,67,115,.583,67,115,.583,0,0,,31,57,.544,78,87,165,12,17,20,29,113,165,2.7
270,Ekpe Udoh\udohek01,2017-18,C-F,63,3,810,60,120,.500,60,119,.504,0,1,.000,42,56,.750,68,82,150,53,43,74,20,105,162,3.8
271,Ivica Zubac\zubaciv01,2017-18,C,43,0,410,61,122,.500,61,121,.504,0,1,.000,39,51,.765,45,78,123,25,8,15,26,47,161,3.3
272,Kosta Koufos\koufoko01,2018-19,C,42,1,502,73,153,.477,73,153,.477,0,0,,10,24,.417,52,125,177,36,15,18,27,68,156,3.5
273,Shawn Long\longsh01,2016-17,C-F,18,0,234,61,109,.560,54,90,.600,7,19,.368,19,35,.543,41,44,85,13,9,9,13,49,148,6.9
274,Jeff Withey\witheje01,2016-17,C,51,1,432,55,103,.534,55,102,.539,0,1,.000,36,48,.750,52,69,121,7,16,32,14,52,146,3.1
275,Salah Mejri\mejrisa01,2018-19,C,36,4,399,55,112,.491,44,78,.564,11,34,.324,20,32,.625,36,95,131,35,10,26,21,55,141,4.0
276,Ian Mahinmi\mahinia01,2018-19,C,34,6,498,47,104,.452,44,88,.500,3,16,.188,42,61,.689,48,80,128,25,25,16,21,84,139,3.9
277,Jerome Jordan\jordaje01,2014-15,C,44,0,383,50,94,.532,50,94,.532,0,0,,38,44,.864,52,53,105,13,8,15,22,58,138,2.8
278,Ryan Hollins\holliry01,2014-15,C,46,9,441,53,82,.646,53,82,.646,0,0,,31,54,.574,36,67,103,14,6,19,25,65,137,2.5
279,Tarik Black\blackta01,2015-16,C-F,39,0,496,57,104,.548,57,104,.548,0,0,,19,45,.422,44,113,157,16,14,18,22,78,133,3.1
280,Timofey Mozgov\mozgoti01,2017-18,C,31,13,359,52,93,.559,48,75,.640,4,18,.222,23,30,.767,32,66,98,11,5,13,33,39,131,3.2
281,Nerlens Noel\noelne01,2017-18,C-F,30,6,472,55,105,.524,55,104,.529,0,1,.000,21,28,.750,48,120,168,20,31,22,26,59,131,5.2
282,Channing Frye\fryech01,2018-19,C-F,36,6,341,43,117,.368,11,38,.289,32,79,.405,11,14,.786,4,48,52,20,6,5,13,44,129,2.0
283,Samuel Dalembert\dalemsa01,2014-15,C,32,21,544,57,130,.438,57,130,.438,0,0,,14,20,.700,53,115,168,29,14,41,39,70,128,3.9
284,Salah Mejri\mejrisa01,2015-16,C,34,6,397,49,78,.628,49,77,.636,0,1,.000,27,46,.587,41,82,123,10,8,36,23,54,125,3.9
285,Ryan Hollins\holliry01,2015-16,C,37,12,460,49,79,.620,49,79,.620,0,0,,26,42,.619,47,51,98,10,6,21,24,62,124,2.9
286,Joakim Noah\noahjo01,2015-16,C,29,2,635,51,133,.383,51,132,.386,0,1,.000,22,45,.489,87,168,255,110,18,29,52,77,124,6.4
287,Georgios Papagiannis\papagge01,2016-17,C,22,0,355,56,102,.549,56,100,.560,0,2,.000,12,14,.857,24,62,86,20,3,17,24,44,124,4.4
288,Lucas Nogueira\noguelu01,2017-18,C,49,3,418,49,80,.613,44,61,.721,5,19,.263,19,28,.679,18,69,87,22,23,43,16,49,122,3.0
289,Ekpe Udoh\udohek01,2018-19,C-F,51,1,320,50,72,.694,50,72,.694,0,0,,19,30,.633,27,63,90,28,10,31,13,36,119,2.9
290,Dwight Howard\howardw01,2018-19,C,9,9,230,43,69,.623,43,69,.623,0,0,,29,48,.604,24,59,83,4,7,4,16,34,115,10.4
291,Emeka Okafor\okafoem01,2017-18,C-F,26,19,353,48,95,.505,48,95,.505,0,0,,18,22,.818,47,73,120,8,8,25,13,30,114,4.8
292,Miles Plumlee\plumlmi01,2016-17,C-F,45,12,485,44,92,.478,44,92,.478,0,0,,25,39,.641,38,57,95,21,18,13,30,73,113,1.9
293,Meyers Leonard\leoname01,2017-18,C-F,33,2,254,46,78,.590,35,52,.673,11,26,.423,9,11,.818,12,58,70,17,7,0,10,36,112,2.9
294,JaVale McGee\mcgeeja01,2014-15,C,23,0,256,42,79,.532,42,79,.532,0,0,,22,33,.667,18,43,61,3,2,20,18,30,106,3.3
295,Cole Aldrich\aldrico01,2016-17,C,62,0,531,45,86,.523,45,86,.523,0,0,,15,22,.682,51,107,158,25,25,23,17,85,105,2.2
296,Chris Andersen\anderch01,2015-16,C-F,27,15,403,38,72,.528,34,58,.586,4,14,.286,25,36,.694,36,62,98,12,15,13,9,29,105,4.5
297,Jeff Withey\witheje01,2014-15,C,37,0,259,32,64,.500,32,64,.500,0,0,,34,50,.680,23,41,64,11,4,18,12,26,98,2.4
298,Joffrey Lauvergne\lauvejo01,2014-15,C-F,24,1,268,36,89,.404,33,73,.452,3,16,.188,18,28,.643,27,50,77,13,8,10,22,43,93,2.5
299,Kendrick Perkins\perkike01,2015-16,C,37,5,542,40,75,.533,40,75,.533,0,0,,11,25,.440,25,103,128,31,11,11,41,64,91,1.9
300,Henry Sims\simshe01,2015-16,C,14,4,263,33,77,.429,33,77,.429,0,0,,25,30,.833,21,51,72,9,9,14,12,37,91,5.5
301,Joel Anthony\anthojo01,2014-15,C,49,0,406,36,62,.581,36,62,.581,0,0,,15,22,.682,32,61,93,5,12,49,12,55,87,2.3
302,Robert Sacre\sacrero01,2015-16,C,25,1,320,31,75,.413,31,75,.413,0,0,,25,38,.658,32,40,72,14,4,10,12,43,87,2.7
303,Ömer Aşık\asikom01,2016-17,C,31,19,482,31,65,.477,31,65,.477,0,0,,23,39,.590,48,115,163,15,5,10,14,51,85,3.3
304,Miles Plumlee\plumlmi01,2018-19,C-F,18,0,173,32,48,.667,32,48,.667,0,0,,16,30,.533,16,23,39,17,6,4,10,14,80,4.3
305,Greg Smith\smithgr02,2014-15,C,42,2,363,30,49,.612,30,49,.612,0,0,,20,39,.513,26,53,79,9,7,11,11,53,80,1.7
306,Andrew Bogut\bogutan01,2016-17,C,27,21,583,38,81,.469,38,80,.475,0,1,.000,3,11,.273,56,162,218,49,13,25,43,86,79,4.1
307,John Henson\hensojo01,2018-19,C-F,14,0,188,31,67,.463,20,36,.556,11,31,.355,6,10,.600,16,55,71,14,7,11,12,16,79,5.5
308,Lucas Nogueira\noguelu01,2015-16,C,29,1,225,28,44,.636,27,41,.659,1,3,.333,8,15,.533,18,28,46,7,12,12,11,29,65,2.3
309,Deyonta Davis\davisde01,2016-17,C-F,36,0,238,24,47,.511,24,47,.511,0,0,,10,18,.556,20,40,60,2,3,17,8,40,58,1.4
310,Dakari Johnson\johnsda04,2017-18,C,31,6,161,22,39,.564,22,39,.564,0,0,,11,20,.550,16,18,34,8,6,8,3,27,55,1.7
311,Nikola Peković\pekovni01,2015-16,C,12,3,156,19,50,.380,19,50,.380,0,0,,16,20,.800,7,14,21,11,1,0,9,22,54,2.1
312,A.J. Hammons\hammoaj01,2016-17,C,22,0,163,17,42,.405,12,32,.375,5,10,.500,9,20,.450,8,28,36,4,1,13,10,21,48,1.3
313,Bernard James\jamesbe01,2014-15,C,16,2,158,12,27,.444,12,27,.444,0,0,,20,23,.870,18,21,39,4,2,15,6,17,44,3.1
314,Chris Kaman\kamanch01,2015-16,C,16,2,112,20,43,.465,19,39,.487,1,4,.250,3,3,1.000,7,17,24,11,1,1,8,15,44,1.7
315,Greg Smith\smithgr02,2015-16,C,18,0,192,18,32,.563,18,32,.563,0,0,,7,17,.412,12,30,42,6,4,1,7,28,43,1.8
316,Marshall Plumlee\plumlma02,2016-17,C,21,1,170,16,30,.533,16,30,.533,0,0,,8,19,.421,23,28,51,10,4,4,12,23,40,1.8
317,Andrew Bogut\bogutan01,2018-19,C,11,5,134,18,36,.500,18,36,.500,0,0,,3,3,1.000,12,43,55,11,3,8,8,22,39,3.8
318,Andrew Bogut\bogutan01,2017-18,C,24,5,216,17,25,.680,17,25,.680,0,0,,2,2,1.000,26,52,78,15,4,13,19,40,36,2.0
319,Deyonta Davis\davisde01,2018-19,C-F,9,0,118,15,22,.682,15,21,.714,0,1,.000,6,10,.600,10,26,36,5,3,5,3,12,36,4.7
320,Georgios Papagiannis\papagge01,2017-18,C,17,0,122,18,42,.429,18,42,.429,0,0,,0,0,,13,24,37,9,4,6,8,12,36,1.9
321,Brendan Haywood\haywobr01,2014-15,C,22,1,119,14,30,.467,14,30,.467,0,0,,7,13,.538,6,23,29,2,2,10,10,17,35,1.0
322,Earl Barron\barroea01,2014-15,C,16,1,143,12,39,.308,10,35,.286,2,4,.500,6,12,.500,14,14,28,5,4,2,5,26,32,0.9
323,Clint Capela\capelca01,2014-15,C,12,0,90,14,29,.483,14,29,.483,0,0,,4,23,.174,10,26,36,2,1,9,5,14,32,1.9
324,Ekpe Udoh\udohek01,2014-15,C-F,33,0,128,11,24,.458,11,24,.458,0,0,,7,9,.778,7,19,26,8,8,7,7,20,29,0.9
325,Chris Andersen\anderch01,2016-17,C-F,12,0,114,9,22,.409,9,19,.474,0,3,.000,10,14,.714,9,22,31,5,5,7,5,20,28,2.3
326,Nazr Mohammed\mohamna01,2014-15,C,23,0,128,13,30,.433,13,30,.433,0,0,,1,3,.333,11,27,38,3,4,5,7,16,27,1.0
327,Arinze Onuaku\onuakar01,2014-15,C,6,1,68,12,14,.857,12,14,.857,0,0,,3,8,.375,7,14,21,4,1,3,2,6,27,5.1
328,Joel Anthony\anthojo01,2016-17,C,19,0,122,10,16,.625,10,16,.625,0,0,,5,8,.625,8,23,31,3,2,6,4,11,25,1.5
329,Edy Tavares\tavarwa01,2015-16,C,11,0,73,11,19,.579,11,19,.579,0,0,,3,8,.375,7,14,21,3,1,6,5,8,25,2.0
330,Daniel Ochefu\ochefda01,2016-17,C,19,0,75,12,27,.444,12,27,.444,0,0,,0,2,.000,5,17,22,3,2,0,3,17,24,0.6
331,Tibor Pleiß\pleisti01,2015-16,C,12,0,82,11,25,.440,11,23,.478,0,2,.000,2,2,1.000,6,9,15,2,1,2,8,19,24,0.5
332,Sasha Kaun\kaunsa01,2015-16,C,25,0,95,9,17,.529,9,17,.529,0,0,,5,11,.455,12,14,26,3,4,5,7,11,23,0.9
333,Stephen Zimmerman\zimmest01,2016-17,C,19,0,108,10,31,.323,10,31,.323,0,0,,3,5,.600,11,24,35,4,2,5,3,17,23,0.9
334,Ömer Aşık\asikom01,2017-18,C,18,0,182,9,22,.409,9,22,.409,0,0,,4,13,.308,9,38,47,3,2,4,9,20,22,0.8
335,Thomas Bryant\bryanth01,2017-18,C,15,0,72,8,21,.381,7,11,.636,1,10,.100,5,9,.556,3,14,17,6,1,2,2,6,22,1.2
336,Ognjen Kuzmić\kuzmiog01,2014-15,C,16,0,72,8,12,.667,8,12,.667,0,0,,4,4,1.000,7,10,17,6,2,1,5,13,20,1.2
337,Joel Anthony\anthojo01,2015-16,C,19,0,96,6,10,.600,6,10,.600,0,0,,6,8,.750,8,13,21,1,2,12,2,15,18,1.3
338,Thomas Welsh\welshth01,2018-19,C,11,0,36,7,13,.538,4,6,.667,3,7,.429,1,2,.500,0,4,4,5,0,0,1,3,18,1.3
339,Isaac Humphries\humphis01,2018-19,C,5,1,56,6,21,.286,3,10,.300,3,11,.273,0,0,,4,7,11,0,1,0,0,7,15,1.2
340,Jeff Withey\witheje01,2017-18,C,9,0,39,6,16,.375,4,6,.667,2,10,.200,1,2,.500,1,9,10,0,0,3,2,3,15,0.9
341,Marshall Plumlee\plumlma02,2017-18,C,8,0,52,1,3,.333,1,3,.333,0,0,,12,16,.750,4,13,17,2,0,1,3,10,14,1.6
342,Greg Stiemsma\stiemgr01,2014-15,C,17,0,66,6,8,.750,6,8,.750,0,0,,2,4,.500,9,6,15,3,2,0,7,15,14,0.5
343,Cole Aldrich\aldrico01,2017-18,C,21,0,49,5,15,.333,5,15,.333,0,0,,2,6,.333,3,12,15,3,2,1,1,11,12,0.3
344,Jordan Hill\hilljo01,2016-17,C-F,7,0,47,5,13,.385,5,13,.385,0,0,,2,2,1.000,8,6,14,0,1,0,4,9,12,0.8
345,Joakim Noah\noahjo01,2017-18,C,7,0,40,5,10,.500,5,10,.500,0,0,,2,4,.500,6,8,14,4,2,2,4,5,12,1.9
346,Diamond Stone\stonedi01,2016-17,C,7,0,24,3,13,.231,3,13,.231,0,0,,4,4,1.000,1,5,6,0,0,1,2,5,10,0.1
347,Mangok Mathiang\mathima01,2017-18,C-F,4,0,20,4,7,.571,4,7,.571,0,0,,0,1,.000,3,7,10,0,1,0,0,5,8,1.9
348,Nazr Mohammed\mohamna01,2015-16,C,5,0,19,3,5,.600,3,5,.600,0,0,,2,2,1.000,1,3,4,0,0,0,3,4,8,0.5
349,Miroslav Raduljica\radulmi01,2014-15,C,5,0,23,3,8,.375,3,8,.375,0,0,,2,2,1.000,2,3,5,0,1,0,2,8,8,0.3
350,Edy Tavares\tavarwa01,2016-17,C,2,0,28,4,5,.800,4,5,.800,0,0,,0,3,.000,4,7,11,1,0,6,2,3,8,5.8
351,Lucas Nogueira\noguelu01,2014-15,C,6,0,23,2,8,.250,2,8,.250,0,0,,2,4,.500,2,9,11,1,2,0,2,6,6,0.5
352,Justin Patton\pattoju01,2018-19,C,3,0,21,2,7,.286,2,5,.400,0,2,.000,1,2,.500,2,4,6,3,2,0,0,5,5,1.7
353,Alex Kirk\kirkal01,2014-15,C,5,0,14,1,4,.250,1,4,.250,0,0,,2,2,1.000,1,0,1,1,0,0,0,1,4,0.5
354,Arinze Onuaku\onuakar01,2016-17,C,8,0,28,2,4,.500,2,4,.500,0,0,,0,0,,2,4,6,2,0,1,2,3,4,0.4
355,Larry Sanders\sandela01,2016-17,C-F,5,0,13,1,4,.250,1,4,.250,0,0,,2,2,1.000,3,1,4,0,1,1,2,5,4,0.3
356,Ángel Delgado\delgaan01,2018-19,C,2,0,15,1,5,.200,1,5,.200,0,0,,1,2,.500,2,2,4,0,1,0,0,2,3,0.9
357,Kendrick Perkins\perkike01,2017-18,C,1,0,15,1,2,.500,1,2,.500,0,0,,1,2,.500,0,1,1,2,1,0,1,1,3,2.9
358,Sim Bhullar\bhullsi01,2014-15,C,3,0,3,1,2,.500,1,2,.500,0,0,,0,0,,0,1,1,1,0,1,0,0,2,0.9
359,Justin Patton\pattoju01,2017-18,C,1,0,4,1,2,.500,1,2,.500,0,0,,0,0,,0,0,0,0,1,0,0,1,2,1.6
360,Mike Tobey\tobeymi01,2016-17,C,2,0,25,1,4,.250,1,4,.250,0,0,,0,0,,2,1,3,1,0,0,1,2,2,0.1
361,Tyler Davis\davisty01,2018-19,C,1,0,1,0,1,.000,0,1,.000,0,0,,0,0,,1,0,1,0,0,0,0,0,0,0.0
