Rk,Player,Season,School,Pos,G,GS,MP,FG,FGA,FG%,2P,2PA,2P%,3P,3PA,3P%,FT,FTA,FT%,ORB,DRB,TRB,AST,STL,BLK,TOV,PF,PTS,GmSc
1,Jock Landale\jock-landale-1,2017-18,Saint Mary's (CA),C,36,36,1200,301,470,.640,298,460,.648,3,10,.300,156,209,.746,106,260,366,72,14,36,84,109,761,17.9
2,Aaric Murray\aaric-murray-1,2013-14,Texas Southern,C,34,32,1088,241,491,.491,210,399,.526,31,92,.337,223,301,.741,74,181,255,41,29,86,89,88,736,16.4
3,Frank Kaminsky\frank-kaminsky-1,2014-15,Wisconsin,C,39,39,1311,267,488,.547,225,387,.581,42,101,.416,156,200,.780,58,262,320,103,33,57,63,65,732,16.8
4,Chris Horton\chris-horton-1,2015-16,Austin Peay,C,36,36,1213,248,414,.599,248,414,.599,0,0,,180,290,.621,177,254,431,54,49,63,98,76,676,17.9
5,Jahlil Okafor\jahlil-okafor-1,2014-15,Duke,C,38,38,1143,279,420,.664,279,420,.664,0,0,,99,194,.510,134,188,322,49,29,54,95,81,657,14.8
6,Tim Kempton\tim-kempton-2,2016-17,Lehigh,C,32,32,1012,231,422,.547,208,366,.568,23,56,.411,168,221,.760,62,267,329,36,29,41,99,99,653,15.5
7,Nathan Boothe\nathan-boothe-1,2015-16,Toledo,C,32,32,1007,241,486,.496,208,398,.523,33,88,.375,103,125,.824,60,227,287,105,21,33,71,83,618,15.3
8,Isaiah Johnson\isaiah-johnson-1,2016-17,Akron,C,36,36,1076,223,357,.625,223,355,.628,0,2,.000,152,259,.587,103,154,257,103,17,33,84,95,598,14.0
9,Alan Williams\alan-williams-2,2013-14,UC-Santa Barbara,C,28,28,872,224,420,.533,224,420,.533,0,0,,148,216,.685,106,216,322,33,33,67,59,84,596,18.4
10,Jock Landale\jock-landale-1,2016-17,Saint Mary's (CA),C,34,34,962,229,375,.611,225,357,.630,4,18,.222,114,158,.722,103,219,322,58,10,41,72,87,576,14.6
11,Drew McDonald\drew-mcdonald-1,2016-17,Northern Kentucky,C,35,35,1052,201,425,.473,148,287,.516,53,138,.384,118,160,.738,71,197,268,61,15,19,77,82,573,11.7
12,Drew McDonald\drew-mcdonald-1,2017-18,Northern Kentucky,C,32,32,979,196,422,.464,141,259,.544,55,163,.337,97,121,.802,62,246,308,72,16,16,70,74,544,12.9
13,Adam Smith\adam-smith-1,2015-16,Georgia Tech,C,36,35,1098,185,455,.407,76,192,.396,109,263,.414,61,76,.803,12,70,82,69,15,1,44,57,540,8.8
14,Jessie Govan\jessie-govan-1,2017-18,Georgetown,C,30,30,980,201,396,.508,185,350,.529,16,46,.348,118,155,.761,74,227,301,59,18,34,52,87,536,14.7
15,Egidijus Mockevicius\egidijus-mockevicius-1,2015-16,Evansville,C,34,34,1082,195,306,.637,195,306,.637,0,0,,145,212,.684,85,389,474,9,27,94,55,110,535,16.1
16,Nana Foulland\nana-fouland-1,2017-18,Bucknell,C,35,35,1001,210,358,.587,210,356,.590,0,2,.000,112,201,.557,76,169,245,46,18,61,63,92,532,12.2
17,Frank Kaminsky\frank-kaminsky-1,2013-14,Wisconsin,C,38,38,1032,196,371,.528,159,273,.582,37,98,.378,101,132,.765,81,159,240,49,26,66,39,96,530,12.4
18,Ben Lammers\ben-lammers-1,2016-17,Georgia Tech,C,37,37,1309,214,415,.516,213,413,.516,1,2,.500,98,133,.737,111,231,342,78,43,125,64,85,527,14.7
19,Albert Owens\albert-owens-1,2016-17,Oral Roberts,C,30,27,934,206,419,.492,203,407,.499,3,12,.250,107,147,.728,68,99,167,29,13,37,61,67,522,11.5
20,Tyler Davis\tyler-davis-5,2017-18,Texas A&M,C,35,35,1018,206,352,.585,199,327,.609,7,25,.280,101,162,.623,123,190,313,44,12,47,70,90,520,12.7
21,Killian Larson\killian-larson-1,2013-14,Grand Canyon,C,30,30,980,180,333,.541,179,330,.542,1,3,.333,155,210,.738,115,233,348,24,14,6,76,96,516,13.5
22,Michael Buchanan\michael-buchanan-1,2016-17,South Carolina Upstate,C,32,19,744,207,330,.627,207,330,.627,0,0,,102,193,.528,115,187,302,37,17,20,71,86,516,13.1
23,Tim Kempton\tim-kempton-2,2015-16,Lehigh,C,29,29,864,182,328,.555,177,312,.567,5,16,.313,145,192,.755,69,207,276,41,20,13,84,90,514,13.3
24,Isaac Haas\isaac-haas-1,2017-18,Purdue,C,35,35,818,185,300,.617,185,300,.617,0,0,,144,190,.758,60,141,201,26,5,46,58,85,514,11.6
25,Nana Foulland\nana-fouland-1,2016-17,Bucknell,C,34,34,938,203,322,.630,203,322,.630,0,0,,105,187,.561,77,187,264,41,26,72,71,95,511,12.9
26,Adreian Payne\adreian-payne-1,2013-14,Michigan State,C,31,28,870,178,354,.503,134,250,.536,44,104,.423,109,138,.790,48,177,225,41,15,28,63,80,509,12.1
27,Moses Kingsley\moses-kingsley-1,2015-16,Arkansas,C,32,31,945,183,334,.548,183,334,.548,0,0,,142,223,.637,103,196,299,39,36,76,65,94,508,14.4
28,James Thompson IV\james-thompsoniv-1,2017-18,Eastern Michigan,C,35,35,1195,201,299,.672,201,299,.672,0,0,,105,173,.607,144,249,393,11,27,67,66,115,507,14.2
29,Damian Jones\damian-jones-1,2014-15,Vanderbilt,C,35,34,1020,186,331,.562,185,326,.567,1,5,.200,133,222,.599,76,151,227,26,20,70,76,89,506,11.1
30,Shayne Whittington\shayne-whittington-1,2013-14,Western Michigan,C,31,31,987,188,357,.527,182,324,.562,6,33,.182,117,152,.770,74,201,275,34,24,47,58,74,499,13.4
31,Stefan Nastic\stefan-nastic-1,2014-15,Stanford,C,37,37,1098,179,379,.472,179,379,.472,0,0,,138,183,.754,90,149,239,53,13,38,75,137,496,9.2
32,A.J. Hammons\aj-hammons-1,2015-16,Purdue,C,33,20,813,199,336,.592,193,325,.594,6,11,.545,90,127,.709,77,193,270,37,9,84,65,78,494,13.1
33,James Thompson IV\james-thompsoniv-1,2015-16,Eastern Michigan,C,33,33,1058,182,281,.648,182,280,.650,0,1,.000,126,184,.685,148,203,351,20,25,47,48,117,490,14.7
34,Sam Dower\sam-dower-1,2013-14,Gonzaga,C,34,31,898,185,324,.571,179,305,.587,6,19,.316,113,137,.825,64,181,245,37,15,24,53,81,489,11.7
35,Tyrell Nelson\tyrell-nelson-1,2014-15,Gardner-Webb,C,35,34,966,195,320,.609,195,318,.613,0,2,.000,96,152,.632,101,128,229,29,22,29,56,107,486,11.2
36,Ian Chiles\ian-chiles-1,2013-14,Morgan State,C,31,31,882,185,337,.549,185,337,.549,0,0,,115,173,.665,77,126,203,28,14,92,48,93,485,13.0
37,Isaiah Johnson\isaiah-johnson-1,2015-16,Akron,C,35,10,889,174,303,.574,173,298,.581,1,5,.200,127,212,.599,93,173,266,57,16,45,54,83,476,11.9
38,Przemek Karnowski\przemek-karnowski-1,2016-17,Gonzaga,C,39,39,902,198,338,.586,198,337,.588,0,1,.000,79,133,.594,56,172,228,75,17,37,70,83,475,9.7
39,James Thompson IV\james-thompsoniv-1,2016-17,Eastern Michigan,C,32,32,988,178,310,.574,177,309,.573,1,1,1.000,117,164,.713,152,206,358,32,24,29,64,101,474,13.7
40,Corey Petros\corey-petros-1,2014-15,Oakland,C,33,32,1190,201,334,.602,201,333,.604,0,1,.000,69,149,.463,108,164,272,66,17,10,50,87,471,12.0
41,Tyrell Nelson\tyrell-nelson-1,2015-16,Gardner-Webb,C,33,31,898,181,324,.559,176,307,.573,5,17,.294,100,163,.613,102,150,252,53,21,26,86,87,467,10.9
42,Udoka Azubuike\udoka-azubuike-1,2017-18,Kansas,C,36,34,848,211,274,.770,211,274,.770,0,0,,45,109,.413,87,165,252,24,20,60,63,108,467,11.6
43,Daniel Amigo\daniel-amigo-1,2016-17,Denver,C,30,29,748,182,340,.535,173,324,.534,9,16,.563,91,139,.655,50,163,213,41,8,18,80,107,464,9.7
44,Luke Kornet\luke-kornet-1,2016-17,Vanderbilt,C,35,35,1101,145,357,.406,92,195,.472,53,162,.327,120,140,.857,53,164,217,43,19,71,45,81,463,10.6
45,Tim Kempton\tim-kempton-2,2014-15,Lehigh,C,30,29,866,172,345,.499,171,344,.497,1,1,1.000,114,160,.713,56,204,260,31,15,11,76,79,459,10.2
46,Marin Maric\marin-maric-1,2016-17,Northern Illinois,C,32,32,911,171,302,.566,166,280,.593,5,22,.227,112,168,.667,101,167,268,25,23,17,73,89,459,11.2
47,Daniel Amigo\daniel-amigo-1,2017-18,Denver,C,30,26,774,189,363,.521,171,319,.536,18,44,.409,63,106,.594,67,133,200,47,9,22,89,96,459,9.3
48,Damian Jones\damian-jones-1,2015-16,Vanderbilt,C,33,33,866,184,312,.590,184,309,.595,0,3,.000,90,168,.536,74,153,227,38,8,54,65,108,458,10.4
49,Dylan Osetkowski\dylan-osetkowski-1,2017-18,Texas,C,34,34,1196,161,402,.400,119,256,.465,42,146,.288,93,129,.721,78,166,244,42,35,7,76,63,457,8.8
50,Ronald Delph\ronald-delph-1,2017-18,Florida Atlantic,C,31,31,910,201,405,.496,201,403,.499,0,2,.000,53,76,.697,84,186,270,23,13,63,52,82,455,11.2
51,Matt Stainbrook\matt-stainbrook-1,2014-15,Xavier,C,37,37,987,173,282,.613,172,277,.621,1,5,.200,107,140,.764,73,184,257,89,22,24,73,93,454,11.1
52,Justin Patton\justin-patton-1,2016-17,Creighton,C,35,34,885,200,296,.676,192,281,.683,8,15,.533,45,87,.517,59,158,217,41,31,50,60,96,453,11.3
53,RJ White\rj-white-1,2016-17,North Carolina-Greensboro,C,35,35,889,181,329,.550,165,278,.594,16,51,.314,73,120,.608,74,159,233,43,30,39,70,114,451,9.9
54,Alan Williams\alan-williams-2,2014-15,UC-Santa Barbara,C,26,26,847,160,349,.458,160,346,.462,0,3,.000,129,168,.768,86,222,308,45,31,47,51,70,449,15.2
55,Mamadou Ndiaye\mamadou-ndiaye-2,2015-16,UC-Irvine,C,37,36,857,169,251,.673,169,251,.673,0,0,,111,176,.631,74,193,267,24,6,87,83,92,449,10.5
56,Omer Yurtseven\omer-yurtseven-1,2017-18,North Carolina State,C,33,22,786,187,327,.572,165,283,.583,22,44,.500,49,80,.613,91,131,222,15,16,60,38,99,445,11.3
57,Adam Smith\adam-smith-1,2014-15,Virginia Tech,C,33,21,986,158,361,.438,77,170,.453,81,191,.424,46,62,.742,14,71,85,30,12,4,26,54,443,8.1
58,Chris Anderson\chris-anderson-2,2013-14,Louisiana Tech,C,37,36,874,160,367,.436,128,261,.490,32,106,.302,90,138,.652,81,127,208,36,42,12,70,122,442,7.6
59,Isaac Haas\isaac-haas-1,2016-17,Purdue,C,35,15,682,159,271,.587,159,271,.587,0,0,,123,173,.711,62,112,174,20,9,27,78,73,441,8.8
60,Wyatt Walker\wyatt-walker-1,2016-17,Samford,C,34,34,991,157,268,.586,155,262,.592,2,6,.333,124,163,.761,99,230,329,51,21,29,67,88,440,12.1
61,Tyler Davis\tyler-davis-5,2016-17,Texas A&M,C,31,31,812,167,270,.619,167,269,.621,0,1,.000,106,153,.693,95,121,216,44,15,30,83,82,440,11.4
62,Corey Petros\corey-petros-1,2013-14,Oakland,C,33,33,1171,182,316,.576,182,316,.576,0,0,,74,145,.510,102,170,272,50,16,14,48,72,438,11.1
63,Diamond Stone\diamond-stone-1,2015-16,Maryland,C,35,22,807,167,294,.568,167,294,.568,0,0,,102,134,.761,77,111,188,15,18,55,53,80,436,10.1
64,Joseph Uchebo\joseph-uchebo-1,2015-16,Charlotte,C,33,28,922,181,310,.584,181,310,.584,0,0,,72,130,.554,126,254,380,31,33,22,44,59,434,13.1
65,Moses Kingsley\moses-kingsley-1,2016-17,Arkansas,C,36,36,999,149,319,.467,142,303,.469,7,16,.438,128,169,.757,79,199,278,48,23,93,70,99,433,10.6
66,Aly Ahmed\aly-ahmed-1,2014-15,Cal State Bakersfield,C,31,28,914,159,323,.492,158,318,.497,1,5,.200,113,154,.734,70,153,223,48,9,23,72,80,432,9.8
67,Quadir Welton\quadir-welton-1,2016-17,Saint Peter's,C,36,35,1032,155,330,.470,155,330,.470,0,0,,121,207,.585,76,218,294,74,28,35,92,85,431,9.0
68,Aly Ahmed\aly-ahmed-1,2015-16,Cal State Bakersfield,C,33,33,930,169,360,.469,167,356,.469,2,4,.500,90,133,.677,58,148,206,34,22,36,81,93,430,8.1
69,Patric Young\patric-young-1,2013-14,Florida,C,39,37,1019,171,316,.541,171,316,.541,0,0,,87,146,.596,101,140,241,30,25,41,49,101,429,9.0
70,Isaiah Austin\isaiah-austin-1,2013-14,Baylor,C,38,37,1065,157,350,.449,139,285,.488,18,65,.277,95,140,.679,81,128,209,52,17,118,70,92,427,9.2
71,Jalone Friday\jalone-friday-1,2017-18,Abilene Christian,C,32,28,714,161,353,.456,115,218,.528,46,135,.341,59,84,.702,38,124,162,16,10,50,53,112,427,8.0
72,Thomas Bryant\thomas-bryant-1,2016-17,Indiana,C,34,34,954,148,285,.519,125,225,.556,23,60,.383,108,148,.730,76,150,226,50,26,52,78,104,427,10.2
73,Dusan Ristic\dusan-ristic-1,2017-18,Arizona,C,35,35,949,178,313,.569,172,298,.577,6,15,.400,64,81,.790,72,171,243,32,13,18,47,83,426,9.7
74,Tyrell Nelson\tyrell-nelson-1,2016-17,Gardner-Webb,C,33,33,896,164,311,.527,156,292,.534,8,19,.421,89,142,.627,64,168,232,42,23,17,68,99,425,9.2
75,Egidijus Mockevicius\egidijus-mockevicius-1,2014-15,Evansville,C,34,34,948,154,266,.579,154,266,.579,0,0,,117,142,.824,75,262,337,17,21,74,48,99,425,12.3
76,Alex Kirk\alex-kirk-2,2013-14,New Mexico,C,32,32,1025,165,337,.490,153,281,.544,12,56,.214,82,123,.667,73,204,277,35,12,85,57,82,424,11.1
77,John Karhoff\john-karhoff-1,2013-14,Omaha,C,32,32,831,157,319,.492,153,301,.508,4,18,.222,103,125,.824,44,83,127,60,18,17,46,106,421,9.1
78,Dwight Coleby\dwight-coleby-1,2017-18,Western Kentucky,C,38,37,1050,162,271,.598,162,270,.600,0,1,.000,96,128,.750,96,209,305,22,23,66,61,103,420,10.4
79,Garrick Sherman\garrick-sherman-1,2013-14,Notre Dame,C,31,31,888,173,342,.506,173,342,.506,0,0,,73,106,.689,83,142,225,28,24,21,82,88,419,8.9
80,Tim Kempton\tim-kempton-2,2013-14,Lehigh,C,32,31,844,159,309,.515,159,309,.515,0,0,,99,146,.678,74,152,226,23,22,11,90,104,417,8.0
81,Thomas van der Mars\thomas-van-der-mars-1,2013-14,Portland,C,31,30,834,165,274,.602,165,274,.602,0,0,,87,123,.707,76,147,223,28,20,23,44,73,417,11.5
82,Thomas Welsh\thomas-welsh-1,2017-18,UCLA,C,33,33,1096,162,334,.485,117,222,.527,45,112,.402,48,58,.828,87,271,358,46,22,29,34,79,417,12.0
83,Przemek Karnowski\przemek-karnowski-1,2014-15,Gonzaga,C,38,37,932,179,288,.622,178,287,.620,1,1,1.000,57,112,.509,70,150,220,51,20,39,68,85,416,8.9
84,Thomas Bryant\thomas-bryant-1,2015-16,Indiana,C,35,35,791,157,230,.683,152,215,.707,5,15,.333,96,136,.706,70,132,202,34,17,32,58,99,415,10.1
85,Ethan Jacobs\ethan-jacobs-1,2014-15,Colgate,C,33,33,921,159,322,.494,119,205,.580,40,117,.342,56,74,.757,32,117,149,35,11,37,52,88,414,8.4
86,Akolda Manyang\akolda-manyang-1,2017-18,Utah Valley,C,31,25,667,150,238,.630,150,238,.630,0,0,,106,152,.697,85,166,251,25,12,71,74,87,406,11.6
87,A.J. Hammons\aj-hammons-1,2014-15,Purdue,C,34,23,827,157,291,.540,157,284,.553,0,7,.000,91,136,.669,82,144,226,31,17,96,73,87,405,10.1
88,Tyler Davis\tyler-davis-5,2015-16,Texas A&M,C,36,34,820,150,229,.655,150,229,.655,0,0,,105,168,.625,106,118,224,26,20,41,58,95,405,10.0
89,Tony Wroblicky\tony-wroblicky-1,2013-14,American,C,33,33,1055,156,266,.586,156,266,.586,0,0,,90,124,.726,60,178,238,99,34,61,99,115,402,10.9
90,Adonis De La Rosa\adonis-de-la-rosa-1,2017-18,Kent State,C,34,32,874,137,243,.564,137,243,.564,0,0,,128,163,.785,102,155,257,35,21,22,112,122,402,8.6
91,RJ White\rj-white-1,2015-16,North Carolina-Greensboro,C,33,31,898,167,271,.616,159,244,.652,8,27,.296,60,94,.638,69,160,229,36,23,33,58,111,402,10.0
92,Tshilidzi Nephawe\tshilidzi-nephawe-1,2013-14,New Mexico State,C,36,36,1003,136,252,.540,136,252,.540,0,0,,129,207,.623,93,189,282,22,15,52,73,107,401,8.9
93,Kavion Pippen\kavion-pippen-1,2017-18,Southern Illinois,C,33,33,901,179,325,.551,179,325,.551,0,0,,41,63,.651,58,138,196,31,22,45,54,92,399,9.1
94,Cameron Krutwig\cameron-krutwig-1,2017-18,Loyola (IL),C,38,34,899,158,264,.598,158,264,.598,0,0,,83,113,.735,71,162,233,66,20,27,56,48,399,9.8
95,Luke Fischer\luke-fischer-1,2015-16,Marquette,C,33,33,932,158,260,.608,158,260,.608,0,0,,83,122,.680,100,103,203,32,14,47,58,97,399,10.2
96,Kendall Gray\kendall-gray-1,2014-15,Delaware State,C,34,34,1149,150,272,.551,150,271,.554,0,1,.000,97,153,.634,111,290,401,35,15,95,70,92,397,12.0
97,Chris Horton\chris-horton-1,2013-14,Austin Peay,C,30,29,918,163,274,.595,163,274,.595,0,0,,71,122,.582,100,185,285,21,26,92,36,73,397,13.8
98,Percy Gibson\percy-gibson-1,2015-16,Oakland,C,35,23,788,158,295,.536,157,292,.538,1,3,.333,78,108,.722,70,146,216,23,20,34,47,103,395,8.7
99,Quinterian McConico\quinterian-mcconico-1,2016-17,Alabama A&M,C,28,27,853,172,291,.591,172,289,.595,0,2,.000,51,87,.586,60,146,206,19,10,12,47,65,395,10.4
100,Geoffrey Groselle\geoff-groselle-1,2015-16,Creighton,C,35,34,742,146,208,.702,146,208,.702,0,0,,101,145,.697,87,128,215,15,17,45,51,102,393,10.1
101,Cameron Ridley\cameron-ridley-1,2013-14,Texas,C,35,35,896,134,246,.545,134,246,.545,0,0,,124,198,.626,115,172,287,14,18,76,56,102,392,10.3
102,Chris Horton\chris-horton-1,2014-15,Austin Peay,C,30,30,1034,142,310,.458,142,309,.460,0,1,.000,108,156,.692,135,198,333,43,35,70,75,62,392,12.7
103,Tacko Fall\tacko-fall-1,2016-17,Central Florida,C,36,36,947,168,235,.715,168,234,.718,0,1,.000,55,119,.462,129,214,343,20,9,94,90,90,391,10.7
104,Dusan Ristic\dusan-ristic-1,2016-17,Arizona,C,36,34,822,164,295,.556,163,293,.556,1,2,.500,62,81,.765,63,134,197,16,11,16,39,76,391,8.1
105,John Egbunu\john-egbunu-1,2015-16,Florida,C,34,30,857,149,252,.591,149,252,.591,0,0,,92,173,.532,92,128,220,12,15,47,60,110,390,8.7
106,Charles Jackson\charles-jackson-3,2014-15,Tennessee Tech,C,30,30,816,157,275,.571,157,275,.571,0,0,,76,133,.571,111,175,286,14,33,40,47,100,390,11.7
107,RJ White\rj-white-1,2014-15,North Carolina-Greensboro,C,33,21,784,155,278,.558,137,234,.585,18,44,.409,60,104,.577,64,165,229,38,43,50,48,125,388,10.3
108,Shevon Thompson\shevon-thompson-1,2014-15,George Mason,C,31,31,936,151,272,.555,151,272,.555,0,0,,86,139,.619,144,207,351,6,17,34,76,69,388,11.0
109,Aaron Menzies\aaron-menzies-1,2017-18,Seattle,C,34,33,915,151,248,.609,151,248,.609,0,0,,83,128,.648,118,184,302,19,9,79,41,106,385,11.3
110,Dylan Osetkowski\dylan-osetkowski-1,2015-16,Tulane,C,34,34,1100,141,322,.438,129,277,.466,12,45,.267,89,131,.679,90,192,282,53,41,18,76,76,383,8.9
111,Marin Maric\marin-maric-1,2017-18,DePaul,C,28,27,768,138,249,.554,128,219,.584,10,30,.333,96,114,.842,57,129,186,34,21,13,68,73,382,10.4
112,Marin Maric\marin-maric-1,2015-16,Northern Illinois,C,32,31,841,135,279,.484,128,263,.487,7,16,.438,105,156,.673,94,174,268,29,23,38,61,76,382,9.9
113,Kevin Ferguson\kevin-ferguson-1,2015-16,Army,C,29,27,798,154,249,.618,154,249,.618,0,0,,73,105,.695,114,166,280,35,14,46,54,86,381,12.7
114,John Bohannon\john-bohannon-1,2013-14,Texas-El Paso,C,32,29,916,138,240,.575,137,229,.598,1,11,.091,103,153,.673,59,206,265,76,14,53,74,77,380,10.9
115,Johnny Hamilton\johnny-hamilton-1,2017-18,Texas-Arlington,C,34,29,794,146,232,.629,146,231,.632,0,1,.000,87,131,.664,99,175,274,19,17,77,64,98,379,10.6
116,Ben Aird\ben-aird-1,2013-14,Utah Valley,C,32,32,946,136,299,.455,126,268,.470,10,31,.323,97,135,.719,57,210,267,51,25,38,45,97,379,9.9
117,Jordan Bachynski\jordan-bachynski-1,2013-14,Arizona State,C,33,33,1020,133,244,.545,133,244,.545,0,0,,113,163,.693,71,201,272,17,12,133,48,99,379,11.5
118,Brandon Goode\brandon-goode-1,2013-14,Norfolk State,C,34,32,951,160,261,.613,160,261,.613,0,0,,58,92,.630,89,144,233,20,15,80,56,114,378,9.8
119,Yanick Moreira\yanick-moreira-1,2014-15,Southern Methodist,C,34,34,828,144,262,.550,144,262,.550,0,0,,89,139,.640,80,139,219,33,24,40,60,61,377,9.4
120,Angus Brandt\angus-brandt-1,2013-14,Oregon State,C,30,30,762,138,265,.521,120,216,.556,18,49,.367,83,109,.761,34,84,118,46,11,22,46,93,377,8.7
121,Przemek Karnowski\przemek-karnowski-1,2013-14,Gonzaga,C,36,36,889,143,241,.593,143,240,.596,0,1,.000,90,180,.500,71,183,254,26,10,62,68,103,376,8.2
122,Ben Lammers\ben-lammers-1,2017-18,Georgia Tech,C,32,32,1151,151,327,.462,149,317,.470,2,10,.200,71,95,.747,77,182,259,54,39,78,47,67,375,11.3
123,Alex Olah\alex-olah-1,2014-15,Northwestern,C,32,32,941,135,278,.486,126,240,.525,9,38,.237,95,127,.748,62,158,220,49,19,59,55,83,374,9.9
124,Cady Lalanne\cady-lalanne-1,2013-14,Massachusetts,C,33,33,956,145,262,.553,143,254,.563,2,8,.250,82,122,.672,103,159,262,6,17,71,59,85,374,10.0
125,Mitchell Patton\mitchell-patton-1,2013-14,IUPUI,C,30,30,911,149,300,.497,149,298,.500,0,2,.000,75,105,.714,61,107,168,17,22,35,40,96,373,8.8
126,Josh Ibarra\josh-ibarra-1,2016-17,Houston Baptist,C,31,30,749,154,259,.595,154,259,.595,0,0,,65,105,.619,86,138,224,29,12,29,48,99,373,9.8
127,Quadir Welton\quadir-welton-1,2015-16,Saint Peter's,C,30,30,949,133,279,.477,133,279,.477,0,0,,106,187,.567,94,151,245,52,24,33,67,87,372,9.7
128,Cady Lalanne\cady-lalanne-1,2014-15,Massachusetts,C,32,32,929,138,250,.552,135,232,.582,3,18,.167,91,143,.636,110,194,304,10,19,61,80,87,370,10.0
129,Nana Foulland\nana-fouland-1,2015-16,Bucknell,C,31,30,818,142,265,.536,142,265,.536,0,0,,81,163,.497,70,143,213,24,16,42,65,81,365,8.4
130,Matt Willms\matt-willms-1,2016-17,Texas-El Paso,C,32,31,857,150,254,.591,150,253,.593,0,1,.000,65,113,.575,44,131,175,33,8,40,74,90,365,7.7
131,AJ West\aj-west-1,2014-15,Nevada,C,30,29,873,125,254,.492,125,254,.492,0,0,,113,174,.649,178,153,331,17,15,79,72,84,363,11.9
132,Norbertas Giga\norbertas-giga-1,2016-17,Jacksonville State,C,33,33,973,142,279,.509,129,242,.533,13,37,.351,65,89,.730,57,210,267,52,24,33,92,96,362,8.2
133,Dererk Pardon\dererk-pardon-1,2017-18,Northwestern,C,32,32,992,143,231,.619,143,230,.622,0,1,.000,75,122,.615,106,121,227,38,18,56,45,93,361,10.9
134,Eric Stuteville\eric-stuteville-1,2016-17,Sacramento State,C,31,30,832,141,223,.632,141,223,.632,0,0,,78,150,.520,90,105,195,13,6,47,53,86,360,9.2
135,Daniel Miller\daniel-miller-1,2013-14,Georgia Tech,C,33,33,1016,149,258,.578,149,258,.578,0,0,,61,99,.616,83,175,258,51,38,80,49,82,359,11.6
136,Michael Buchanan\michael-buchanan-1,2015-16,South Carolina Upstate,C,31,24,672,153,269,.569,153,269,.569,0,0,,53,92,.576,74,113,187,42,17,31,62,88,359,8.8
137,Kaleb Tarczewski\kaleb-tarczewski-1,2013-14,Arizona,C,36,35,1020,128,219,.584,128,219,.584,0,0,,102,135,.756,75,151,226,19,5,36,63,92,358,7.9
138,Albert Owens\albert-owens-1,2017-18,Oral Roberts,C,31,17,763,149,307,.485,148,305,.485,1,2,.500,59,85,.694,57,73,130,21,14,49,41,45,358,8.3
139,Jalone Friday\jalone-friday-1,2016-17,Abilene Christian,C,26,11,563,123,235,.523,87,156,.558,36,79,.456,75,91,.824,41,101,142,9,12,34,41,95,357,9.9
140,Ethan Jacobs\ethan-jacobs-1,2013-14,Colgate,C,31,30,704,131,262,.500,80,139,.576,51,123,.415,43,54,.796,22,110,132,21,7,22,41,73,356,7.6
141,Kyle Tresnak\kyle-tresnak-1,2013-14,Weber State,C,31,31,845,145,244,.594,145,244,.594,0,0,,66,94,.702,40,105,145,23,17,55,46,87,356,9.1
142,Joshua Smith\joshua-smith-1,2014-15,Georgetown,C,33,32,677,131,211,.621,131,211,.621,0,0,,93,144,.646,84,106,190,39,34,22,67,115,355,8.9
143,Youssou Ndoye\youssou-ndoye-1,2014-15,St. Bonaventure,C,30,30,957,111,236,.470,111,235,.472,0,1,.000,133,187,.711,99,203,302,27,20,78,85,88,355,10.5
144,Dwan Caldwell\dwan-caldwell-1,2013-14,Tennessee Tech,C,33,27,819,137,254,.539,137,253,.542,0,1,.000,80,127,.630,88,95,183,14,22,33,58,102,354,7.8
145,Frank Toohey\frank-toohey-1,2016-17,Air Force,C,33,32,819,117,225,.520,96,173,.555,21,52,.404,98,123,.797,62,87,149,52,14,10,58,111,353,7.8
146,Kaleb Tarczewski\kaleb-tarczewski-1,2014-15,Arizona,C,38,37,988,123,215,.572,123,215,.572,0,0,,107,153,.699,62,137,199,13,17,22,53,116,353,6.8
147,Matt Stainbrook\matt-stainbrook-1,2013-14,Xavier,C,33,31,807,145,261,.556,144,258,.558,1,3,.333,60,87,.690,79,165,244,71,24,31,61,89,351,9.7
148,Luke Fischer\luke-fischer-1,2016-17,Marquette,C,32,25,767,150,232,.647,150,232,.647,0,0,,50,85,.588,82,107,189,38,19,53,38,108,350,10.1
149,William Truss\william-truss-1,2013-14,Presbyterian,C,32,32,1067,142,221,.643,141,219,.644,1,2,.500,65,112,.580,81,207,288,17,19,51,60,93,350,10.0
150,Damian Jones\damian-jones-1,2013-14,Vanderbilt,C,31,28,798,138,254,.543,138,254,.543,0,0,,73,134,.545,57,119,176,7,9,43,56,104,349,7.2
151,Dwan Caldwell\dwan-caldwell-1,2014-15,Tennessee Tech,C,30,24,792,138,287,.481,131,269,.487,7,18,.389,66,90,.733,60,98,158,19,17,15,57,83,349,7.2
152,Kaj-Bjorn Sherman\kaj-bjorn-sherman-1,2014-15,Texas-San Antonio,C,29,29,870,114,201,.567,114,201,.567,0,0,,120,156,.769,81,122,203,32,23,15,49,73,348,10.7
153,Thomas Welsh\thomas-welsh-1,2015-16,UCLA,C,31,26,832,157,266,.590,157,266,.590,0,0,,34,45,.756,100,163,263,17,8,32,25,86,348,10.4
154,Maverick Morgan\maverick-morgan-1,2016-17,Illinois,C,35,25,895,143,265,.540,143,265,.540,0,0,,61,93,.656,61,97,158,30,10,28,59,77,347,6.8
155,Justin Gant\justin-gant-1,2013-14,Indiana State,C,34,34,843,124,259,.479,95,190,.500,29,69,.420,70,98,.714,43,87,130,31,11,27,47,83,347,6.8
156,Kendall Gray\kendall-gray-1,2013-14,Delaware State,C,30,30,963,125,216,.579,125,216,.579,0,0,,96,150,.640,82,154,236,24,11,81,48,99,346,10.8
157,Nana Foulland\nana-fouland-1,2014-15,Bucknell,C,34,34,829,141,257,.549,141,257,.549,0,0,,64,115,.557,73,112,185,23,15,37,48,89,346,7.7
158,Thomas Welsh\thomas-welsh-1,2016-17,UCLA,C,32,32,802,151,258,.585,150,257,.584,1,1,1.000,42,47,.894,70,207,277,32,11,43,14,81,345,11.0
159,Doral Moore\doral-moore-1,2017-18,Wake Forest,C,31,30,790,153,222,.689,153,222,.689,0,0,,38,83,.458,98,193,291,9,11,61,39,90,344,11.1
160,Darien Nelson-Henry\darien-nelson-henry-1,2015-16,Pennsylvania,C,27,26,755,141,247,.571,139,241,.577,2,6,.333,59,83,.711,68,151,219,48,12,32,69,63,343,10.5
161,Thomas van der Mars\thomas-van-der-mars-1,2014-15,Portland,C,33,32,866,138,260,.531,138,260,.531,0,0,,66,108,.611,90,175,265,18,17,48,47,87,342,8.9
162,Isaac Haas\isaac-haas-1,2015-16,Purdue,C,35,15,500,126,212,.594,126,212,.594,0,0,,90,126,.714,41,88,129,16,4,27,39,58,342,7.3
163,Reggie Smith\reggie-smith-2,2013-14,Eastern Illinois,C,26,24,765,99,249,.398,70,153,.458,29,96,.302,113,155,.729,9,53,62,85,33,2,74,50,340,8.1
164,Wyatt Walker\wyatt-walker-1,2015-16,Samford,C,32,29,705,133,229,.581,133,225,.591,0,4,.000,74,105,.705,64,128,192,25,20,26,52,87,340,8.5
165,Trevor Gruis\trevor-gruis-1,2013-14,South Dakota,C,30,30,833,127,231,.550,127,231,.550,0,0,,85,118,.720,54,119,173,54,15,37,61,88,339,9.0
166,Michael Karena\michael-karena-1,2015-16,Wright State,C,34,28,657,132,251,.526,132,251,.526,0,0,,74,110,.673,50,77,127,11,11,9,48,108,338,5.7
167,Youssou Ndoye\youssou-ndoye-1,2013-14,St. Bonaventure,C,33,33,866,118,227,.520,118,227,.520,0,0,,101,153,.660,59,129,188,13,26,73,64,101,337,8.1
168,Egidijus Mockevicius\egidijus-mockevicius-1,2013-14,Evansville,C,32,32,806,121,193,.627,121,193,.627,0,0,,94,129,.729,68,198,266,9,25,65,37,113,336,10.5
169,A.J. Hammons\aj-hammons-1,2013-14,Purdue,C,31,25,775,117,228,.513,117,223,.525,0,5,.000,101,144,.701,73,157,230,15,13,96,78,91,335,9.0
170,Matt Lopez\matt-lopez-1,2014-15,Rider,C,27,27,723,135,231,.584,135,231,.584,0,0,,63,116,.543,63,145,208,16,6,11,56,76,333,8.5
171,Nathan Boothe\nathan-boothe-1,2014-15,Toledo,C,33,33,897,131,263,.498,119,230,.517,12,33,.364,56,63,.889,51,137,188,71,24,42,51,106,330,8.5
172,Tyere Marshall\tyere-marshall-1,2017-18,Rider,C,32,31,726,133,261,.510,133,260,.512,0,1,.000,64,118,.542,79,133,212,32,16,16,40,87,330,7.8
173,Pat Forsythe\pat-forsythe-1,2014-15,Akron,C,33,29,732,132,236,.559,131,231,.567,1,5,.200,64,108,.593,71,91,162,32,20,42,51,80,329,8.0
174,Isaac Neilson\isaac-neilson-1,2016-17,Utah Valley,C,34,28,743,128,224,.571,119,198,.601,9,26,.346,63,92,.685,114,196,310,29,19,54,52,89,328,10.0
175,Chad Posthumus\chad-posthumus-1,2013-14,Morehead State,C,34,10,868,114,225,.507,114,225,.507,0,0,,97,161,.602,145,225,370,7,17,26,66,105,325,8.5
176,Deion Bute\deion-bute-1,2017-18,Central Connecticut State,C,32,30,802,123,205,.600,123,205,.600,0,0,,78,109,.716,75,91,166,19,14,35,83,117,324,6.8
177,Jessie Govan\jessie-govan-1,2016-17,Georgetown,C,32,21,671,128,250,.512,114,215,.530,14,35,.400,54,81,.667,38,121,159,45,16,32,55,89,324,7.2
178,Gene Teague\gene-teague-1,2013-14,Seton Hall,C,29,26,759,121,195,.621,121,195,.621,0,0,,82,124,.661,82,146,228,25,17,17,55,92,324,9.5
179,Jack Crook\jack-crook-1,2015-16,Seattle,C,32,32,945,128,266,.481,128,265,.483,0,1,.000,67,113,.593,63,129,192,60,18,21,87,105,323,6.2
180,Justin Raffington\justin-raffington-1,2013-14,Florida Atlantic,C,32,27,946,124,246,.504,124,243,.510,0,3,.000,75,144,.521,99,172,271,35,10,30,74,88,323,7.5
181,Mike Thorne\mike-thorne-1,2014-15,Charlotte,C,32,30,836,134,251,.534,134,250,.536,0,1,.000,54,101,.535,85,150,235,25,4,29,42,75,322,8.0
182,Novak Topalovic\novak-topalovic-1,2017-18,Idaho State,C,30,30,814,131,248,.528,131,246,.533,0,2,.000,59,107,.551,53,150,203,36,8,32,89,92,321,6.4
183,Ryan Edwards\ryan-edwards-1,2017-18,Portland State,C,33,30,583,128,269,.476,117,235,.498,11,34,.324,54,79,.684,61,71,132,17,11,57,48,110,321,6.3
184,Evan Maxwell\evan-maxwell-1,2015-16,Liberty,C,32,30,687,128,201,.637,128,201,.637,0,0,,63,99,.636,58,96,154,17,10,6,68,66,319,6.8
185,Amida Brimah\amida-brimah-1,2014-15,Connecticut,C,35,35,920,126,187,.674,126,187,.674,0,0,,67,103,.650,69,86,155,7,7,121,36,99,319,9.1
186,Tonye Jekiri\tonye-jekiri-1,2014-15,Miami (FL),C,37,37,1120,123,246,.500,122,245,.498,1,1,1.000,70,96,.729,118,248,366,42,21,51,51,114,317,8.9
187,Novak Topalovic\novak-topalovic-1,2016-17,Idaho State,C,31,31,876,133,217,.613,133,216,.616,0,1,.000,50,120,.417,57,139,196,32,9,33,54,77,316,7.8
188,D.J. Cunningham\dj-cunningham-1,2013-14,North Carolina-Asheville,C,27,27,694,125,222,.563,125,222,.563,0,0,,64,91,.703,86,180,266,30,24,98,56,81,314,12.5
189,Drew McDonald\drew-mcdonald-1,2015-16,Northern Kentucky,C,30,2,581,109,226,.482,102,201,.507,7,25,.280,89,122,.730,64,122,186,34,8,11,43,56,314,8.1
190,Reggie Lynch\reggie-lynch-1,2014-15,Illinois State,C,33,30,731,116,228,.509,116,228,.509,0,0,,82,120,.683,91,87,178,8,23,93,53,122,314,8.1
191,Nathan Boothe\nathan-boothe-1,2013-14,Toledo,C,34,32,930,129,271,.476,127,262,.485,2,9,.222,54,62,.871,62,93,155,54,28,38,31,116,314,7.6
192,Joel Embiid\joel-embiid-1,2013-14,Kansas,C,28,20,647,107,171,.626,106,166,.639,1,5,.200,98,143,.685,65,162,227,38,25,72,66,94,313,11.1
193,Sim Bhullar\sim-bhullar-1,2013-14,New Mexico State,C,30,24,790,125,193,.648,125,193,.648,0,0,,63,117,.538,80,155,235,42,3,101,63,83,313,10.5
194,Norbertas Giga\norbertas-giga-1,2017-18,Jacksonville State,C,36,35,910,116,278,.417,98,213,.460,18,65,.277,61,82,.744,71,157,228,56,15,26,66,72,311,6.4
195,Albert Owens\albert-owens-1,2015-16,Oral Roberts,C,31,26,739,119,266,.447,118,257,.459,1,9,.111,69,108,.639,41,114,155,22,11,47,38,53,308,7.0
196,Dennis Clifford\dennis-clifford-1,2015-16,Boston College,C,31,31,853,119,241,.494,118,231,.511,1,10,.100,69,112,.616,60,165,225,39,16,34,66,89,308,7.3
197,Chris Brady\chris-brady-1,2016-17,Monmouth,C,34,34,722,129,222,.581,127,213,.596,2,9,.222,47,68,.691,72,148,220,13,13,58,36,90,307,8.2
198,Shevon Thompson\shevon-thompson-1,2015-16,George Mason,C,31,29,699,120,208,.577,120,207,.580,0,1,.000,67,120,.558,113,216,329,17,4,31,81,74,307,8.4
199,Luke Kornet\luke-kornet-1,2014-15,Vanderbilt,C,35,14,756,106,214,.495,56,89,.629,50,125,.400,42,55,.764,32,88,120,37,7,38,41,67,304,6.6
200,Evan Fitzner\evan-fitzner-1,2015-16,Saint Mary's (CA),C,35,35,821,109,233,.468,54,99,.545,55,134,.410,31,41,.756,36,119,155,29,10,16,29,65,304,6.5
201,Brandon Gilbeck\brandon-gilbeck-1,2017-18,Western Illinois,C,28,28,743,132,201,.657,132,201,.657,0,0,,39,85,.459,62,137,199,20,18,72,59,93,303,9.6
202,Tommy Hamilton\tommy-hamilton-1,2014-15,DePaul,C,30,16,773,103,201,.512,80,152,.526,23,49,.469,72,107,.673,42,117,159,30,16,24,65,65,301,7.2
203,William Truss\william-truss-1,2014-15,Presbyterian,C,30,30,846,118,194,.608,116,191,.607,2,3,.667,62,90,.689,57,164,221,15,13,42,52,87,300,8.5
204,Alex Olah\alex-olah-1,2013-14,Northwestern,C,33,32,974,112,220,.509,102,187,.545,10,33,.303,66,97,.680,48,124,172,26,14,58,50,100,300,7.0
205,Marshall Plumlee\marshall-plumlee-1,2015-16,Duke,C,36,36,1099,106,154,.688,106,154,.688,0,0,,88,153,.575,119,189,308,38,27,58,39,100,300,10.1
206,Alex Olah\alex-olah-1,2015-16,Northwestern,C,26,21,623,116,220,.527,108,193,.560,8,27,.296,57,83,.687,36,109,145,35,5,36,31,58,297,9.1
207,Hayden Koval\hayden-koval-1,2017-18,Central Arkansas,C,34,30,857,108,238,.454,74,135,.548,34,103,.330,47,75,.627,47,134,181,29,13,105,53,105,297,7.3
208,Marvin Jones\marvin-jones-1,2016-17,Texas Southern,C,35,33,849,102,170,.600,98,151,.649,4,19,.211,88,113,.779,69,168,237,18,20,55,33,115,296,8.5
209,Rafael Maia\rafael-maia-1,2014-15,Brown,C,30,30,903,100,186,.538,95,167,.569,5,19,.263,91,167,.545,98,162,260,54,26,18,53,86,296,9.4
210,Michael Holyfield\michael-holyfield-1,2014-15,Sam Houston State,C,35,34,628,109,181,.602,109,180,.606,0,1,.000,78,126,.619,112,171,283,9,13,86,54,111,296,8.7
211,Jordan Threloff\jordan-threloff-1,2013-14,Northern Illinois,C,32,26,793,97,193,.503,97,193,.503,0,0,,100,137,.730,87,136,223,20,17,33,54,76,294,7.9
212,Trayvon Reed\trayvon-reed-1,2017-18,Texas Southern,C,30,22,834,112,164,.683,111,155,.716,1,9,.111,67,102,.657,75,185,260,11,13,92,37,93,292,10.9
213,Hooper Vint\hooper-vint-1,2015-16,Texas-El Paso,C,33,22,715,119,214,.556,114,192,.594,5,22,.227,49,66,.742,43,117,160,22,7,36,54,91,292,6.2
214,Conor Clifford\conor-clifford-1,2016-17,Washington State,C,31,30,610,126,214,.589,126,213,.592,0,1,.000,40,47,.851,18,67,85,27,1,20,53,85,292,5.5
215,Marcel Boyd\marcel-boyd-1,2015-16,Howard,C,28,28,877,100,189,.529,100,189,.529,0,0,,90,158,.570,85,192,277,18,12,42,66,87,290,8.6
216,Michael Buchanan\michael-buchanan-1,2014-15,South Carolina Upstate,C,36,20,682,119,215,.553,118,214,.551,1,1,1.000,51,88,.580,93,117,210,23,18,33,50,82,290,6.9
217,Wendell Lewis\wendell-lewis-1,2014-15,Alabama State,C,29,27,655,118,235,.502,118,234,.504,0,1,.000,53,80,.663,53,92,145,29,17,27,57,74,289,6.7
218,Jorden Kaufman\jorden-kaufman-1,2016-17,Youngstown State,C,34,31,704,131,231,.567,131,231,.567,0,0,,26,56,.464,79,140,219,34,12,10,43,86,288,6.7
219,Justin Gant\justin-gant-1,2014-15,Indiana State,C,30,29,848,109,254,.429,86,183,.470,23,71,.324,46,69,.667,34,91,125,23,17,26,41,59,287,6.0
220,Kevin Ferguson\kevin-ferguson-1,2014-15,Army,C,30,30,779,116,182,.637,116,182,.637,0,0,,55,87,.632,61,109,170,37,14,45,51,85,287,8.5
221,Tyrell Nelson\tyrell-nelson-1,2013-14,Gardner-Webb,C,32,4,652,113,212,.533,113,211,.536,0,1,.000,60,93,.645,65,96,161,15,23,13,43,94,286,6.4
222,Steve Zack\steve-zack-1,2014-15,La Salle,C,33,33,1029,115,258,.446,114,252,.452,1,6,.167,54,79,.684,89,214,303,61,24,58,61,91,285,8.4
223,Paul Egwuonwu\paul-egwuonwu-1,2013-14,Montana State,C,30,28,815,107,213,.502,107,213,.502,0,0,,70,99,.707,42,158,200,30,23,12,54,77,284,7.0
224,Reggie Lynch\reggie-lynch-1,2013-14,Illinois State,C,34,20,690,110,189,.582,110,189,.582,0,0,,63,114,.553,63,101,164,8,20,96,56,126,283,6.9
225,Kevin Ferguson\kevin-ferguson-1,2013-14,Army,C,31,31,841,119,185,.643,119,185,.643,0,0,,44,66,.667,66,114,180,52,7,78,61,92,282,8.8
226,Maverick Morgan\maverick-morgan-1,2015-16,Illinois,C,34,15,716,124,220,.564,124,220,.564,0,0,,34,46,.739,33,85,118,19,13,16,39,64,282,5.7
227,Mike Thorne\mike-thorne-1,2013-14,Charlotte,C,31,30,759,120,236,.508,120,235,.511,0,1,.000,41,80,.513,78,130,208,12,9,23,51,78,281,6.2
228,Jaleel Cousins\jaleel-cousins-1,2015-16,South Florida,C,33,24,825,95,210,.452,95,209,.455,0,1,.000,90,155,.581,101,161,262,15,23,54,68,105,280,6.8
229,Reggie Lynch\reggie-lynch-1,2016-17,Minnesota,C,33,32,763,108,199,.543,108,199,.543,0,0,,62,97,.639,69,132,201,15,15,114,49,112,278,8.1
230,Michael Karena\michael-karena-1,2014-15,Wright State,C,31,30,699,121,224,.540,121,224,.540,0,0,,36,71,.507,49,64,113,16,15,10,60,113,278,4.4
231,Karviar Shepherd\karviar-shepherd-1,2013-14,Texas Christian,C,30,30,925,91,222,.410,90,220,.409,1,2,.500,91,128,.711,54,150,204,24,20,49,41,103,274,7.1
232,Gabriel Olaseni\abodunrin-gabriel-olaseni-1,2014-15,Iowa,C,34,1,634,92,177,.520,92,177,.520,0,0,,90,120,.750,74,90,164,15,10,54,38,92,274,7.0
233,Amir Williams\amir-williams-1,2013-14,Ohio State,C,35,35,809,101,169,.598,101,169,.598,0,0,,71,109,.651,82,121,203,10,14,62,51,90,273,7.2
234,Jock Landale\jock-landale-1,2015-16,Saint Mary's (CA),C,35,1,509,102,167,.611,101,166,.608,1,1,1.000,68,88,.773,38,97,135,21,9,12,35,77,273,6.0
235,Demarco Cox\demarco-cox-1,2014-15,Georgia Tech,C,31,30,826,116,229,.507,116,229,.507,0,0,,40,81,.494,76,112,188,19,14,28,44,69,272,6.6
236,Steve Zack\steve-zack-1,2013-14,La Salle,C,31,29,940,100,211,.474,100,209,.478,0,2,.000,72,104,.692,88,208,296,29,12,58,57,88,272,8.3
237,Fahro Alihodzic\fahro-alihodzic-1,2013-14,Alabama-Birmingham,C,31,31,767,115,252,.456,115,252,.456,0,0,,42,71,.592,69,125,194,16,18,30,45,81,272,6.1
238,Mamadou Ndiaye\mamadou-ndiaye-2,2013-14,UC-Irvine,C,34,34,714,111,157,.707,111,157,.707,0,0,,49,115,.426,61,149,210,7,5,106,57,96,271,7.5
239,Cameron Ridley\cameron-ridley-1,2014-15,Texas,C,34,31,727,97,174,.557,97,174,.557,0,0,,77,126,.611,79,101,180,13,9,60,50,65,271,7.0
240,Jajuan Starks\jajuan-starks-1,2017-18,Eastern Illinois,C,31,22,665,102,244,.418,88,194,.454,14,50,.280,52,85,.612,53,72,125,26,16,14,52,46,270,5.1
241,Mattias Markusson\mattias-markusson-1,2017-18,Loyola Marymount,C,31,29,772,118,190,.621,118,190,.621,0,0,,32,51,.627,68,128,196,18,20,34,29,85,268,8.2
242,Stefan Nastic\stefan-nastic-1,2013-14,Stanford,C,36,35,709,98,169,.580,98,168,.583,0,1,.000,71,111,.640,32,70,102,41,7,33,45,119,267,5.0
243,Michael Ochereobia\michael-ochereobia-1,2013-14,Western Illinois,C,30,24,754,108,184,.587,108,184,.587,0,0,,50,84,.595,54,109,163,23,13,45,51,113,266,6.7
244,Tonye Jekiri\tonye-jekiri-1,2015-16,Miami (FL),C,35,35,993,114,217,.525,114,213,.535,0,4,.000,38,66,.576,93,207,300,29,15,35,49,107,266,7.0
245,Luke Fischer\luke-fischer-1,2014-15,Marquette,C,24,19,704,106,174,.609,106,173,.613,0,1,.000,53,91,.582,39,76,115,22,13,53,43,81,265,8.8
246,Shaquille Cleare\shaquille-cleare-1,2016-17,Texas,C,33,33,710,111,200,.555,111,199,.558,0,1,.000,43,60,.717,50,102,152,17,8,19,40,80,265,5.7
247,JD Wallace\jd-wallace-1,2017-18,Prairie View,C,34,32,1054,108,157,.688,108,155,.697,0,2,.000,48,86,.558,104,186,290,10,31,39,34,90,264,9.0
248,Ronald Delph\ronald-delph-1,2015-16,Florida Atlantic,C,25,25,644,108,199,.543,108,199,.543,0,0,,47,69,.681,71,100,171,10,6,61,36,90,263,8.9
249,Jacob Enevold\jacob-jensen-1,2014-15,Drake,C,31,28,852,96,169,.568,96,169,.568,0,0,,70,102,.686,56,123,179,12,13,29,76,62,262,6.0
250,Omar Oraby\omar-oraby-1,2013-14,Southern California,C,32,30,725,94,163,.577,94,163,.577,0,0,,73,111,.658,58,135,193,12,6,72,47,105,261,7.1
251,Neal Monson\neal-monson-1,2015-16,UC-Davis,C,29,28,841,101,205,.493,101,202,.500,0,3,.000,59,87,.678,63,183,246,24,13,12,42,63,261,7.5
252,Tonny Trocha-Morelos\tonny-trocha-morelos-1,2015-16,Texas A&M,C,37,11,644,103,223,.462,73,142,.514,30,81,.370,24,48,.500,62,96,158,37,15,23,27,67,260,5.7
253,Isaac Haas\isaac-haas-1,2014-15,Purdue,C,34,11,496,91,170,.535,91,170,.535,0,0,,76,139,.547,53,86,139,9,4,25,54,73,258,4.6
254,Tommy Hamilton\tommy-hamilton-1,2015-16,DePaul,C,30,16,720,91,193,.472,65,135,.481,26,58,.448,49,67,.731,34,131,165,25,9,9,52,59,257,5.7
255,Reggie Smith\reggie-smith-2,2014-15,Eastern Illinois,C,31,11,705,79,203,.389,49,110,.445,30,93,.323,67,87,.770,7,81,88,39,20,3,51,55,255,4.6
256,C.J. Gettys\cj-gettys-1,2016-17,Rutgers,C,33,33,725,106,195,.544,106,195,.544,0,0,,42,63,.667,66,107,173,38,13,26,52,80,254,6.2
257,Darien Nelson-Henry\darien-nelson-henry-1,2013-14,Pennsylvania,C,24,21,504,92,156,.590,92,156,.590,0,0,,70,104,.673,39,88,127,21,9,22,49,57,254,7.9
258,Makol Mawien\makol-mawien-1,2017-18,Kansas State,C,37,37,742,104,174,.598,101,163,.620,3,11,.273,42,54,.778,42,85,127,10,17,42,39,114,253,5.2
259,Lucas O'Brien\lucas-obrien-1,2016-17,Texas-San Antonio,C,33,13,655,87,194,.448,52,91,.571,35,103,.340,44,59,.746,56,102,158,15,1,11,19,75,253,5.6
260,Tonny Trocha-Morelos\tonny-trocha-morelos-1,2016-17,Texas A&M,C,31,27,835,97,239,.406,74,153,.484,23,86,.267,35,52,.673,50,111,161,66,26,30,48,60,252,6.7
261,Adam Woodbury\adam-woodbury-1,2015-16,Iowa,C,33,33,836,94,171,.550,94,171,.550,0,0,,63,90,.700,102,171,273,29,15,10,44,83,251,7.5
262,Landry Nnoko\landry-nnoko-1,2015-16,Clemson,C,31,26,691,101,183,.552,101,183,.552,0,0,,49,77,.636,67,111,178,26,6,71,48,93,251,7.1
263,Amida Brimah\amida-brimah-1,2016-17,Connecticut,C,33,33,814,90,157,.573,90,157,.573,0,0,,71,114,.623,67,135,202,8,7,87,50,105,251,6.9
264,Jordan Threloff\jordan-threloff-1,2014-15,Northern Illinois,C,30,27,741,77,146,.527,77,146,.527,0,0,,96,138,.696,86,134,220,11,11,21,44,63,250,7.5
265,Zach Moer\zach-moer-1,2015-16,Air Force,C,29,22,575,91,198,.460,81,164,.494,10,34,.294,58,77,.753,31,84,115,30,11,24,51,85,250,5.2
266,Drake LaMont\drake-lamont-1,2015-16,Western Michigan,C,32,20,751,103,193,.534,103,192,.536,0,1,.000,44,65,.677,61,85,146,36,16,20,34,83,250,6.4
267,Luke Kornet\luke-kornet-1,2015-16,Vanderbilt,C,28,25,767,87,216,.403,61,123,.496,26,93,.280,49,71,.690,50,154,204,41,14,84,31,68,249,8.9
268,Cory Osetkowski\cory-osetkowski-1,2013-14,Columbia,C,33,30,788,93,180,.517,78,146,.534,15,34,.441,48,74,.649,45,85,130,58,14,34,46,90,249,6.2
269,Romelo Banks\romelo-banks-1,2016-17,North Florida,C,33,33,714,96,170,.565,96,170,.565,0,0,,57,125,.456,72,126,198,9,9,42,45,120,249,5.5
270,Eric Stuteville\eric-stuteville-1,2015-16,Sacramento State,C,31,25,628,100,177,.565,100,177,.565,0,0,,48,90,.533,53,93,146,9,4,58,44,86,248,6.0
271,Stefan Jovanovic\stefan-jovanovic-1,2016-17,Loyola Marymount,C,30,12,608,106,203,.522,106,194,.546,0,9,.000,36,51,.706,63,74,137,27,12,27,37,86,248,6.2
272,Dakari Johnson\dakari-johnson-1,2014-15,Kentucky,C,39,0,635,79,156,.506,79,156,.506,0,0,,90,144,.625,67,112,179,29,14,36,42,69,248,5.6
273,Tommy Hamilton\tommy-hamilton-1,2013-14,DePaul,C,32,26,786,85,215,.395,66,162,.407,19,53,.358,58,80,.725,47,108,155,25,16,20,60,77,247,4.5
274,Peter Jurkin\peter-jurkin-1,2017-18,East Tennessee State,C,33,29,569,89,157,.567,82,140,.586,7,17,.412,62,74,.838,40,114,154,6,15,36,35,63,247,6.5
275,Hassan Attia\hassan-attia-1,2017-18,Hartford,C,33,33,691,102,147,.694,102,147,.694,0,0,,42,89,.472,58,106,164,20,14,59,47,131,246,6.3
276,Ryan Smith\ryan-smith-2,2016-17,Tulane,C,31,31,749,99,202,.490,99,202,.490,0,0,,47,67,.701,66,69,135,22,12,43,47,107,245,5.5
277,Randy Phillips\randy-phillips-1,2017-18,Radford,C,36,34,821,93,171,.544,93,171,.544,0,0,,59,97,.608,105,96,201,26,17,35,60,92,245,5.9
278,Ronald Delph\ronald-delph-1,2016-17,Florida Atlantic,C,30,18,659,109,189,.577,109,189,.577,0,0,,26,46,.565,50,145,195,11,6,44,40,91,244,6.5
279,Kaleb Tarczewski\kaleb-tarczewski-1,2015-16,Arizona,C,26,24,712,80,150,.533,80,150,.533,0,0,,84,118,.712,67,175,242,17,7,36,34,77,244,9.1
280,Dusan Ristic\dusan-ristic-1,2015-16,Arizona,C,34,9,561,94,171,.550,91,163,.558,3,8,.375,52,82,.634,48,80,128,27,5,23,42,67,243,5.2
281,Quadir Welton\quadir-welton-1,2014-15,Saint Peter's,C,34,30,807,95,200,.475,95,200,.475,0,0,,52,110,.473,91,93,184,21,19,27,58,110,242,4.7
282,Dererk Pardon\dererk-pardon-1,2016-17,Northwestern,C,28,28,862,102,167,.611,102,167,.611,0,0,,37,68,.544,92,134,226,32,23,51,30,75,241,9.9
283,Amadou Sidibe\amadou-sidibe-1,2016-17,Fairfield,C,29,26,660,99,171,.579,99,171,.579,0,0,,42,73,.575,78,191,269,38,14,12,49,88,240,7.7
284,George Brammeier\george-brammeier-1,2015-16,Lipscomb,C,33,20,574,92,161,.571,92,161,.571,0,0,,56,92,.609,59,77,136,23,5,15,40,90,240,5.1
285,Derrik Smits\derrik-smits-1,2017-18,Valparaiso,C,32,19,570,91,160,.569,91,160,.569,0,0,,57,87,.655,43,71,114,23,6,21,62,76,239,4.6
286,Branden Johnson\branden-johnson-2,2017-18,Alabama State,C,31,31,753,99,154,.643,99,153,.647,0,1,.000,40,108,.370,79,133,212,8,18,48,37,74,238,7.4
287,Chris Brady\chris-brady-1,2015-16,Monmouth,C,36,29,655,101,185,.546,99,177,.559,2,8,.250,34,48,.708,71,141,212,9,22,45,37,96,238,6.1
288,John Egbunu\john-egbunu-1,2013-14,South Florida,C,32,31,793,89,151,.589,89,150,.593,0,1,.000,60,110,.545,80,118,198,12,10,43,55,92,238,6.1
289,Darien Nelson-Henry\darien-nelson-henry-1,2014-15,Pennsylvania,C,28,24,671,93,180,.517,93,180,.517,0,0,,52,84,.619,52,91,143,25,10,21,60,73,238,5.5
290,Nate Watson\nate-watson-1,2017-18,Providence,C,35,9,483,91,153,.595,91,153,.595,0,0,,55,79,.696,29,39,68,4,7,26,29,71,237,4.6
291,Andrew Drone\andrew-drone-1,2015-16,Rice,C,32,31,623,97,154,.630,97,154,.630,0,0,,43,62,.694,48,83,131,15,8,23,35,76,237,5.9
292,Tonny Trocha-Morelos\tonny-trocha-morelos-1,2017-18,Texas A&M,C,35,12,773,84,206,.408,58,123,.472,26,83,.313,42,70,.600,53,99,152,40,15,33,34,77,236,5.2
293,Bradley Hayes\bradley-hayes-1,2015-16,Georgetown,C,27,27,592,98,181,.541,98,181,.541,0,0,,40,67,.597,48,133,181,32,9,28,43,86,236,6.8
294,Landry Nnoko\landry-nnoko-1,2014-15,Clemson,C,31,30,753,95,187,.508,95,187,.508,0,0,,46,70,.657,71,96,167,21,6,63,47,100,236,6.1
295,Moataz Aly\moataz-aly-1,2017-18,Cal State Bakersfield,C,30,20,596,101,148,.682,101,148,.682,0,0,,34,88,.386,39,58,97,6,4,53,66,103,236,4.5
296,Eric Stuteville\eric-stuteville-1,2014-15,Sacramento State,C,33,31,679,96,183,.525,96,181,.530,0,2,.000,43,75,.573,49,69,118,7,8,34,33,82,235,4.8
297,Billy Reader\billy-reader-1,2014-15,Morehead State,C,31,31,719,100,209,.478,100,209,.478,0,0,,34,59,.576,73,77,150,31,14,28,36,76,234,5.8
298,Vashil Fernandez\vashil-fernandez-1,2014-15,Valparaiso,C,34,32,841,93,165,.564,93,165,.564,0,0,,48,94,.511,78,123,201,11,15,97,32,94,234,7.3
299,Taylor Danaher\taylor-danaher-1,2013-14,Mount St. Mary's,C,33,26,787,84,139,.604,83,135,.615,1,4,.250,65,77,.844,57,108,165,13,15,44,41,93,234,6.5
300,Chance Comanche\chance-comanche-1,2016-17,Arizona,C,37,2,671,89,156,.571,89,156,.571,0,0,,54,74,.730,40,93,133,13,5,14,38,80,232,4.3
301,Dana Batt\dana-batt-1,2017-18,Colgate,C,33,33,720,97,159,.610,97,158,.614,0,1,.000,37,51,.725,48,99,147,29,19,38,29,84,231,6.7
302,Michael Holyfield\michael-holyfield-1,2013-14,Sam Houston State,C,35,35,615,95,149,.638,95,149,.638,0,0,,39,72,.542,100,135,235,9,13,61,46,100,229,6.7
303,Josh Ibarra\josh-ibarra-1,2015-16,Houston Baptist,C,22,19,486,102,160,.638,102,160,.638,0,0,,25,50,.500,41,104,145,21,4,30,36,68,229,8.4
304,Tshilidzi Nephawe\tshilidzi-nephawe-1,2014-15,New Mexico State,C,22,20,584,80,153,.523,80,153,.523,0,0,,68,109,.624,60,107,167,23,6,14,52,54,228,7.7
305,Andre Washington\andre-washington-1,2016-17,East Carolina,C,33,33,821,87,154,.565,87,153,.569,0,1,.000,54,115,.470,85,150,235,28,13,95,49,91,228,7.5
306,Jack Crook\jack-crook-1,2014-15,Seattle,C,34,33,847,90,176,.511,90,176,.511,0,0,,48,73,.658,57,132,189,55,14,7,63,116,228,4.7
307,Taylor Danaher\taylor-danaher-1,2015-16,Mount St. Mary's,C,33,6,615,92,180,.511,92,176,.523,0,4,.000,43,62,.694,69,70,139,12,12,37,34,108,227,5.1
308,Kevin Bleeker\kevin-bleeker-1,2015-16,Canisius,C,33,33,715,86,190,.453,69,139,.496,17,51,.333,37,49,.755,59,106,165,33,13,30,31,93,226,5.6
309,Landry Nnoko\landry-nnoko-1,2013-14,Clemson,C,35,34,982,92,168,.548,92,168,.548,0,0,,42,72,.583,77,140,217,17,12,69,36,95,226,6.5
310,Lucas O'Brien\lucas-obrien-1,2015-16,Texas-San Antonio,C,31,31,700,89,200,.445,75,145,.517,14,55,.255,33,43,.767,37,75,112,20,20,15,27,95,225,4.7
311,Martin Seiferth\martin-seiferth-1,2013-14,Eastern Washington,C,31,27,667,102,153,.667,102,153,.667,0,0,,21,60,.350,71,100,171,6,7,44,30,81,225,6.5
312,Jessie Govan\jessie-govan-1,2015-16,Georgetown,C,33,6,583,71,148,.480,57,120,.475,14,28,.500,69,83,.831,28,108,136,26,13,33,58,102,225,4.6
313,Adam Woodbury\adam-woodbury-1,2014-15,Iowa,C,34,33,697,87,178,.489,87,178,.489,0,0,,49,85,.576,68,108,176,30,19,13,47,92,223,4.8
314,Tacko Fall\tacko-fall-1,2015-16,Central Florida,C,30,26,529,96,128,.750,96,128,.750,0,0,,29,52,.558,54,122,176,10,3,70,49,75,221,7.2
315,Nate Sestina\nate-sestina-1,2017-18,Bucknell,C,34,0,508,89,159,.560,75,118,.636,14,41,.341,29,39,.744,37,97,134,31,11,20,35,71,221,5.3
316,Drake LaMont\drake-lamont-1,2016-17,Western Michigan,C,32,14,621,91,173,.526,91,173,.526,0,0,,38,67,.567,65,84,149,11,11,18,19,61,220,5.7
317,Mawdo Sallah\mawdo-sallah-1,2016-17,Mount St. Mary's,C,36,35,727,99,188,.527,99,188,.527,0,0,,22,45,.489,55,134,189,10,13,41,40,115,220,4.5
318,Drake LaMont\drake-lamont-1,2017-18,Western Michigan,C,32,27,778,93,184,.505,91,179,.508,2,5,.400,31,46,.674,48,77,125,37,12,26,20,76,219,5.7
319,Jamuni McNeace\jamuni-mcneace-1,2017-18,Oklahoma,C,32,5,576,94,140,.671,94,140,.671,0,0,,29,51,.569,45,128,173,11,19,46,49,78,217,6.1
320,John Puk\john-puk-1,2013-14,Albany (NY),C,34,34,982,89,201,.443,89,201,.443,0,0,,39,51,.765,52,99,151,20,12,44,38,111,217,4.3
321,Darius Lewis\darius-lewis-1,2015-16,Duquesne,C,34,34,692,84,143,.587,84,143,.587,0,0,,49,89,.551,51,147,198,21,8,44,54,113,217,5.0
322,Anthony Green\anthony-green-2,2017-18,Northeastern,C,33,33,562,96,134,.716,96,134,.716,0,0,,24,60,.400,52,73,125,25,5,21,45,70,216,5.1
323,Dennis Clifford\dennis-clifford-1,2014-15,Boston College,C,31,28,783,75,151,.497,72,145,.497,3,6,.500,62,85,.729,49,123,172,28,11,37,38,81,215,6.0
324,Matt Husek\matt-husek-1,2016-17,Holy Cross,C,32,29,600,82,170,.482,43,71,.606,39,99,.394,12,17,.706,8,69,77,26,16,22,18,66,215,4.9
325,Marvin Williams\marvin-williams-3,2013-14,Louisiana-Monroe,C,25,21,605,90,184,.489,89,179,.497,1,5,.200,34,57,.596,52,69,121,11,13,23,38,76,215,5.5
326,Cannen Cunningham\cannen-cunningham-1,2014-15,Southern Methodist,C,34,5,546,86,157,.548,85,150,.567,1,7,.143,41,55,.745,35,85,120,18,19,21,38,65,214,4.9
327,Michael Bradley\michael-bradley-2,2014-15,Samford,C,32,23,628,82,138,.594,82,138,.594,0,0,,49,65,.754,58,114,172,14,12,24,42,85,213,5.6
328,Andrew Drone\andrew-drone-1,2014-15,Rice,C,32,29,726,82,143,.573,82,143,.573,0,0,,49,73,.671,56,116,172,14,10,21,52,67,213,5.2
329,Aly Ahmed\aly-ahmed-1,2013-14,Cal State Bakersfield,C,24,20,567,81,169,.479,81,169,.479,0,0,,51,77,.662,58,101,159,12,12,20,40,81,213,6.2
330,Gabriel Olaseni\abodunrin-gabriel-olaseni-1,2013-14,Iowa,C,33,0,552,70,140,.500,70,140,.500,0,0,,73,100,.730,82,81,163,14,9,43,24,77,213,6.3
331,James Karnik\james-karnik-1,2017-18,Lehigh,C,30,29,695,85,183,.464,85,183,.464,0,0,,43,68,.632,71,125,196,15,14,9,42,102,213,4.8
332,Obij Aget\obij-aget-1,2015-16,New Mexico,C,32,32,723,89,139,.640,89,139,.640,0,0,,34,48,.708,67,115,182,11,7,38,44,98,212,5.8
333,Obij Aget\obij-aget-1,2014-15,New Mexico,C,31,31,765,81,145,.559,81,145,.559,0,0,,50,77,.649,60,108,168,8,16,42,43,80,212,5.9
334,Isaiah Manderson\isaiah-manderson-1,2017-18,South Florida,C,26,3,547,89,175,.509,89,171,.520,0,4,.000,33,50,.660,44,71,115,18,7,5,34,40,211,5.5
335,Conor Clifford\conor-clifford-1,2015-16,Washington State,C,31,7,436,89,137,.650,89,137,.650,0,0,,33,40,.825,23,42,65,9,1,11,41,73,211,3.9
336,Boris Bojanovsky\boris-bojanovsky-1,2013-14,Florida State,C,36,21,740,77,131,.588,77,131,.588,0,0,,57,84,.679,59,85,144,19,15,67,40,90,211,5.7
337,Jaleel Roberts\jaleel-roberts-1,2014-15,North Carolina-Asheville,C,30,2,578,94,153,.614,94,153,.614,0,0,,22,36,.611,54,97,151,12,8,78,38,86,210,6.7
338,Reggis Onwukamuche\reggis-onwukamuche-1,2014-15,Prairie View,C,33,33,817,78,148,.527,78,148,.527,0,0,,54,92,.587,79,95,174,8,18,57,49,123,210,5.2
339,Amir Williams\amir-williams-1,2014-15,Ohio State,C,33,28,644,76,115,.661,76,115,.661,0,0,,58,92,.630,53,101,154,11,22,52,34,72,210,6.6
340,Boris Bojanovsky\boris-bojanovsky-1,2015-16,Florida State,C,34,34,612,75,129,.581,75,125,.600,0,4,.000,59,85,.694,62,87,149,14,21,59,39,92,209,6.0
341,Zac Tillman\zac-tillman-1,2017-18,Monmouth,C,31,4,517,79,139,.568,79,139,.568,0,0,,51,70,.729,32,62,94,22,14,10,42,73,209,4.6
342,Sidy Djitte\sidy-djitte-1,2016-17,Clemson,C,32,24,752,72,136,.529,71,134,.530,1,2,.500,64,94,.681,116,131,247,23,23,27,49,96,209,6.9
343,RJ White\rj-white-1,2013-14,North Carolina-Greensboro,C,32,0,503,85,164,.518,84,160,.525,1,4,.250,38,61,.623,43,128,171,11,16,16,42,107,209,4.3
344,Rafael Maia\rafael-maia-1,2013-14,Brown,C,22,22,599,77,161,.478,72,152,.474,5,9,.556,49,85,.576,75,103,178,26,19,6,46,62,208,7.5
345,Robert Upshaw\robert-upshaw-1,2014-15,Washington,C,19,4,474,86,145,.593,86,144,.597,0,1,.000,36,83,.434,48,107,155,9,7,85,24,39,208,11.6
346,Billy Reader\billy-reader-1,2013-14,Morehead State,C,34,25,496,84,149,.564,83,147,.565,1,2,.500,38,47,.809,39,75,114,14,5,12,33,87,207,4.1
347,Karviar Shepherd\karviar-shepherd-1,2015-16,Texas Christian,C,29,23,594,77,196,.393,72,180,.400,5,16,.313,48,71,.676,46,106,152,24,14,21,46,73,207,4.3
348,Coreontae DeBerry\coreontae-deberry-1,2015-16,Cincinnati,C,33,2,485,75,133,.564,75,133,.564,0,0,,56,82,.683,41,81,122,7,12,33,18,63,206,5.5
349,Nate Fowler\nate-fowler-1,2017-18,Butler,C,35,2,608,91,150,.607,83,126,.659,8,24,.333,16,19,.842,45,64,109,20,16,17,24,81,206,4.9
350,Corbin Kaufusi\corbin-kaufasi-1,2015-16,Brigham Young,C,36,23,579,79,129,.612,79,129,.612,0,0,,47,79,.595,62,99,161,10,13,42,37,98,205,5.0
351,Nouhoum Bocoum\nouhoum-bocoum-1,2015-16,Arkansas State,C,29,5,431,76,158,.481,76,156,.487,0,2,.000,53,76,.697,45,74,119,11,2,20,29,40,205,5.1
352,Chris Pelcher\chris-pelcher-1,2013-14,New Hampshire,C,19,17,525,87,181,.481,87,181,.481,0,0,,31,48,.646,42,118,160,12,12,41,41,52,205,8.3
353,Jordan Railey\jordan-railey-1,2014-15,Washington State,C,31,22,508,88,166,.530,88,166,.530,0,0,,28,66,.424,34,66,100,26,15,32,37,70,204,4.6
354,Dallin Bachynski\dallin-bachynski-1,2013-14,Utah,C,30,9,539,73,118,.619,73,118,.619,0,0,,58,74,.784,54,92,146,18,18,26,27,82,204,6.6
355,Brandon Holcomb\brandon-holcomb-1,2014-15,Radford,C,34,33,722,83,147,.565,83,147,.565,0,0,,38,55,.691,60,94,154,28,13,49,53,74,204,5.4
356,Vashil Fernandez\vashil-fernandez-1,2015-16,Valparaiso,C,36,36,903,84,165,.509,84,165,.509,0,0,,35,70,.500,99,162,261,17,16,119,45,112,203,6.8
357,Dakari Johnson\dakari-johnson-1,2013-14,Kentucky,C,39,18,550,82,144,.569,82,144,.569,0,0,,38,85,.447,79,75,154,11,9,23,25,79,202,4.3
358,Ricmonds Vilde\ricmonds-vilde-1,2013-14,Houston Baptist,C,31,22,491,82,152,.539,77,142,.542,5,10,.500,33,48,.688,40,107,147,12,8,15,51,79,202,4.1
359,Austin Wiley\austin-wiley-1,2016-17,Auburn,C,23,22,414,73,125,.584,73,125,.584,0,0,,56,114,.491,52,56,108,5,5,31,41,59,202,6.1
360,Karviar Shepherd\karviar-shepherd-1,2014-15,Texas Christian,C,33,31,784,80,187,.428,80,184,.435,0,3,.000,42,74,.568,60,127,187,28,17,27,41,101,202,4.4
361,Will Artino\will-artino-1,2014-15,Creighton,C,33,16,534,86,155,.555,86,155,.555,0,0,,29,60,.483,54,100,154,12,20,15,24,73,201,5.1
362,Jon Horford\jon-horford-1,2014-15,Florida,C,31,28,621,78,161,.484,65,110,.591,13,51,.255,32,41,.780,48,101,149,10,10,27,18,67,201,5.5
363,Tommy Hamilton\tommy-hamilton-1,2017-18,Texas Tech,C,37,8,520,76,182,.418,46,104,.442,30,78,.385,18,32,.563,28,80,108,30,13,8,48,62,200,2.9
364,Koch Bar\koch-bar-1,2016-17,Bradley,C,33,26,702,76,146,.521,76,146,.521,0,0,,47,79,.595,62,111,173,10,18,38,42,60,199,5.4
365,Paschal Chukwu\paschal-chukwu-1,2017-18,Syracuse,C,37,37,1008,72,110,.655,72,110,.655,0,0,,55,87,.632,103,149,252,15,26,91,40,116,199,7.3
366,Aaron Scales\aaron-scales-1,2016-17,North Carolina A&T,C,31,28,740,78,135,.578,78,135,.578,0,0,,42,84,.500,77,97,174,15,5,22,56,111,198,4.2
367,Matt Husek\matt-husek-1,2015-16,Holy Cross,C,35,18,616,75,171,.439,54,113,.478,21,58,.362,27,39,.692,19,83,102,40,10,29,39,75,198,3.7
368,Marquis Cunningham\marquis-cunningham-1,2015-16,Arkansas-Pine Bluff,C,33,16,507,74,156,.474,74,154,.481,0,2,.000,49,76,.645,33,71,104,19,15,34,36,95,197,3.9
369,Steve McElvene\steve-mcelvene-1,2015-16,Dayton,C,32,17,588,86,141,.610,86,141,.610,0,0,,24,38,.632,59,120,179,15,5,55,43,92,196,5.6
370,Brandon Gilbeck\brandon-gilbeck-1,2016-17,Western Illinois,C,28,28,647,77,134,.575,77,134,.575,0,0,,42,73,.575,51,127,178,17,8,83,46,110,196,6.5
371,Marvin Frazier\marvin-fraizer-1,2014-15,Northwestern State,C,24,20,557,73,154,.474,58,116,.500,15,38,.395,35,56,.625,43,82,125,27,21,51,33,64,196,7.5
372,Dominik Olejniczak\dominik-olejniczak-1,2015-16,Drake,C,30,8,491,83,115,.722,83,115,.722,0,0,,30,44,.682,36,88,124,10,6,21,36,61,196,5.4
373,Stefan Jovanovic\stefan-jovanovic-1,2014-15,Hawaii,C,34,10,590,71,147,.483,71,147,.483,0,0,,54,71,.761,48,78,126,10,11,28,31,90,196,4.2
374,Seth Dugan\seth-dugan-1,2016-17,Western Michigan,C,32,18,631,84,158,.532,84,158,.532,0,0,,28,49,.571,74,98,172,19,15,19,50,84,196,4.7
375,Zach Price\zach-price-1,2015-16,Winthrop,C,32,32,601,74,143,.517,74,143,.517,0,0,,47,78,.603,55,97,152,5,10,19,38,98,195,4.0
376,Dylan Osetkowski\dylan-osetkowski-1,2014-15,Tulane,C,31,4,687,77,152,.507,71,140,.507,6,12,.500,34,71,.479,68,81,149,26,18,10,40,76,194,4.8
377,Will Artino\will-artino-1,2013-14,Creighton,C,35,7,457,79,118,.669,79,118,.669,0,0,,35,63,.556,37,77,114,8,9,12,23,65,193,4.4
378,Emmanuel Okoroba\emmanuel-okoroba-1,2013-14,Hampton,C,31,13,550,59,137,.431,59,137,.431,0,0,,75,125,.600,34,76,110,14,14,24,57,94,193,3.0
379,Brandon Holcomb\brandon-holcomb-1,2015-16,Radford,C,31,27,651,79,137,.577,79,137,.577,0,0,,35,60,.583,45,109,154,27,21,34,55,79,193,5.2
380,Brandon Holcomb\brandon-holcomb-1,2013-14,Radford,C,35,31,680,74,145,.510,74,145,.510,0,0,,45,66,.682,62,97,159,18,14,34,38,78,193,4.8
381,Matt Willms\matt-willms-1,2017-18,Texas-El Paso,C,23,16,517,74,126,.587,74,124,.597,0,2,.000,45,72,.625,44,81,125,18,6,27,38,58,193,6.7
382,Drake LaMont\drake-lamont-1,2014-15,Western Michigan,C,34,34,727,78,163,.479,78,163,.479,0,0,,37,54,.685,59,87,146,12,14,25,22,87,193,4.5
383,J.P. Kambola\jp-kambola-1,2014-15,Marshall,C,29,15,478,78,142,.549,67,97,.691,11,45,.244,25,36,.694,50,75,125,5,8,28,30,54,192,5.4
384,Tanveer Bhullar\tanveer-bhullar-1,2015-16,New Mexico State,C,34,7,619,72,122,.590,72,121,.595,0,1,.000,48,85,.565,70,107,177,21,5,14,33,60,192,5.1
385,Zach Garber\zach-garber-1,2015-16,Toledo,C,32,23,586,59,95,.621,59,94,.628,0,1,.000,73,104,.702,55,100,155,18,9,6,26,69,191,5.5
386,Pat Forsythe\pat-forsythe-1,2015-16,Akron,C,22,19,433,76,157,.484,76,156,.487,0,1,.000,38,57,.667,36,71,107,13,16,31,33,51,190,6.5
387,Matthew Atewe\matthew-atewe-1,2017-18,Pepperdine,C,28,24,561,77,146,.527,77,146,.527,0,0,,35,67,.522,61,106,167,10,8,26,38,76,189,5.1
388,Cannen Cunningham\cannen-cunningham-1,2013-14,Southern Methodist,C,37,1,477,74,126,.587,74,121,.612,0,5,.000,41,52,.788,40,62,102,24,18,33,38,58,189,4.6
389,Adam Woodbury\adam-woodbury-1,2013-14,Iowa,C,33,33,558,70,136,.515,70,136,.515,0,0,,49,69,.710,57,73,130,27,18,19,34,84,189,4.8
390,Peter Jurkin\peter-jurkin-1,2015-16,East Tennessee State,C,36,6,434,72,128,.563,72,127,.567,0,1,.000,45,59,.763,38,74,112,0,10,32,36,59,189,4.0
391,Cory Osetkowski\cory-osetkowski-1,2014-15,Columbia,C,27,24,643,67,160,.419,62,128,.484,5,32,.156,49,78,.628,61,88,149,54,8,20,56,63,188,5.1
392,Matt Kavanaugh\matt-kavanaugh-1,2013-14,Dayton,C,33,26,559,72,137,.526,72,137,.526,0,0,,44,65,.677,47,68,115,25,12,12,33,85,188,4.1
393,John Egbunu\john-egbunu-1,2016-17,Florida,C,24,19,534,64,129,.496,63,128,.492,1,1,1.000,59,104,.567,59,99,158,7,8,35,42,59,188,6.2
394,Romelo Banks\romelo-banks-1,2014-15,North Florida,C,35,35,590,71,149,.477,71,149,.477,0,0,,45,82,.549,39,60,99,7,2,18,31,87,187,2.7
395,Evan Fitzner\evan-fitzner-1,2016-17,Saint Mary's (CA),C,34,34,515,67,148,.453,22,43,.512,45,105,.429,7,10,.700,20,89,109,12,3,4,13,32,186,4.0
396,Dwight Coleby\dwight-coleby-1,2014-15,Mississippi,C,34,3,560,67,126,.532,67,126,.532,0,0,,51,64,.797,66,98,164,2,6,29,25,76,185,4.9
397,Elliott Eliason\eliott-eliason-1,2013-14,Minnesota,C,37,35,810,73,144,.507,73,144,.507,0,0,,39,69,.565,78,166,244,33,20,72,38,102,185,6.0
398,Collin Smith\collin-smith-1,2016-17,George Washington,C,35,17,595,71,152,.467,61,126,.484,10,26,.385,33,62,.532,44,111,155,16,16,29,43,95,185,3.6
399,Chris Otule\chris-otule-1,2013-14,Marquette,C,32,31,574,65,110,.591,65,110,.591,0,0,,55,100,.550,66,70,136,5,4,31,37,63,185,4.7
400,Terrell Carter\terrell-carter-1,2016-17,Fresno State,C,33,2,485,78,139,.561,78,139,.561,0,0,,28,61,.459,29,60,89,13,13,24,41,94,184,3.1
401,Obij Aget\obij-aget-1,2016-17,New Mexico,C,31,29,604,78,128,.609,78,128,.609,0,0,,28,40,.700,46,81,127,12,14,44,19,64,184,6.0
402,James Hunter\james-hunter-1,2014-15,South Dakota,C,32,32,434,77,156,.494,77,156,.494,0,0,,30,43,.698,53,58,111,9,6,18,26,48,184,4.2
403,Emmanuel Ndumanya\emmanuel-ndumanya-1,2017-18,Santa Clara,C,31,28,705,64,125,.512,64,125,.512,0,0,,56,92,.609,56,97,153,21,26,15,46,106,184,4.5
404,Justin McBride\justin-mcbride-1,2015-16,Central Florida,C,28,3,344,72,121,.595,72,121,.595,0,0,,39,71,.549,35,74,109,7,5,18,43,61,183,4.1
405,Larry Owens\larry-owens-2,2017-18,Northwestern State,C,29,7,490,75,155,.484,75,154,.487,0,1,.000,33,68,.485,30,88,118,10,11,16,46,41,183,3.6
406,Jorden Kaufman\jorden-kaufman-1,2015-16,Youngstown State,C,29,11,490,79,148,.534,79,148,.534,0,0,,25,48,.521,52,97,149,24,8,16,29,78,183,4.9
407,Justin McBride\justin-mcbride-1,2014-15,Central Florida,C,29,11,398,72,142,.507,72,142,.507,0,0,,38,52,.731,40,86,126,3,11,27,42,68,182,4.2
408,Matt Willms\matt-willms-1,2013-14,Texas-El Paso,C,34,23,577,68,124,.548,68,124,.548,0,0,,46,70,.657,39,79,118,33,19,28,46,78,182,4.4
409,Yankuba Sima\yankuba-sima-1,2015-16,St. John's (NY),C,25,18,585,77,157,.490,76,155,.490,1,2,.500,27,70,.386,59,84,143,30,16,59,30,76,182,6.8
410,Terrell Carter\terrell-carter-1,2017-18,Fresno State,C,32,6,446,72,130,.554,72,130,.554,0,0,,38,51,.745,31,56,87,9,10,17,42,83,182,3.3
411,Isaiah Johnson\isaiah-johnson-1,2014-15,Akron,C,34,9,625,65,135,.481,65,135,.481,0,0,,52,93,.559,50,89,139,31,14,36,45,63,182,4.4
412,Kingsley Okoroh\kingsley-okorah-1,2017-18,University of California,C,32,17,804,68,168,.405,68,168,.405,0,0,,45,66,.682,65,108,173,26,8,66,40,95,181,4.8
413,Yemi Makanjuola\yemi-makanjuola-1,2015-16,Southern Illinois-Edwardsville,C,28,28,491,63,132,.477,63,130,.485,0,2,.000,55,90,.611,56,99,155,17,9,11,54,95,181,3.8
414,Evan Fitzner\evan-fitzner-1,2017-18,Saint Mary's (CA),C,36,7,563,68,141,.482,42,76,.553,26,65,.400,19,22,.864,23,79,102,11,8,8,23,59,181,3.4
415,Tacko Fall\tacko-fall-1,2017-18,Central Florida,C,16,15,351,79,103,.767,79,103,.767,0,0,,23,50,.460,40,77,117,5,5,31,42,41,181,9.5
416,Asauhn Dixon-Tatum\asauhn-dixon-tatum-1,2013-14,Auburn,C,30,29,675,69,120,.575,69,120,.575,0,0,,42,63,.667,83,97,180,12,9,64,42,104,180,6.0
417,Rauno Nurger\rauno-nurger-1,2016-17,Wichita State,C,36,6,508,64,122,.525,51,94,.543,13,28,.464,39,54,.722,22,78,100,23,3,15,29,64,180,3.6
418,Amadou Sidibe\amadou-sidibe-1,2013-14,Fairfield,C,32,27,757,70,155,.452,70,155,.452,0,0,,40,57,.702,75,137,212,26,15,10,36,107,180,4.6
419,Javan Mitchell\javan-mitchell-2,2013-14,Southern,C,32,24,622,69,148,.466,69,148,.466,0,0,,41,72,.569,57,67,124,14,9,21,43,101,179,3.1
420,Hassan Attia\hassan-attia-1,2016-17,Hartford,C,26,25,556,78,135,.578,78,135,.578,0,0,,23,63,.365,68,104,172,13,25,59,60,105,179,5.8
421,Menno Dijkstra\menno-dijkstra-1,2016-17,UC-Riverside,C,29,2,471,73,132,.553,58,99,.586,15,33,.455,18,24,.750,36,45,81,11,16,19,19,55,179,5.1
422,Matthew Pegram\matthew-pegram-1,2017-18,Wofford,C,34,14,508,69,155,.445,63,140,.450,6,15,.400,35,43,.814,34,70,104,25,15,11,30,72,179,3.6
423,Marvin Williams\marvin-williams-3,2014-15,Louisiana-Monroe,C,21,16,474,73,129,.566,72,126,.571,1,3,.333,32,51,.627,36,62,98,10,9,19,35,49,179,6.1
424,Nate Fowler\nate-fowler-1,2016-17,Butler,C,34,1,405,66,99,.667,56,78,.718,10,21,.476,37,47,.787,38,32,70,14,7,4,21,57,179,4.2
425,Earl Watson\earl-watson-2,2015-16,Rhode Island,C,32,8,615,67,111,.604,67,111,.604,0,0,,44,72,.611,57,108,165,7,10,31,26,92,178,5.1
426,George Brammeier\george-brammeier-1,2016-17,Lipscomb,C,26,0,383,62,90,.689,62,90,.689,0,0,,54,84,.643,41,43,84,15,12,11,33,58,178,5.5
427,Deivydas Kuzavas\deivydas-kuzavas-1,2017-18,Saint Francis (PA),C,31,21,617,75,126,.595,75,125,.600,0,1,.000,28,43,.651,50,78,128,12,4,15,16,82,178,4.7
428,Evan Wieck\evan-wieck-1,2017-18,Navy,C,32,32,625,79,123,.642,79,123,.642,0,0,,19,27,.704,48,54,102,21,13,9,23,76,177,4.7
429,Justin Raffington\justin-raffington-1,2014-15,Florida Atlantic,C,19,19,564,67,155,.432,62,132,.470,5,23,.217,35,61,.574,46,99,145,18,7,17,46,46,174,5.8
430,Benas Griciunas\benas-griciunas-1,2017-18,Eastern Washington,C,34,10,453,76,163,.466,73,140,.521,3,23,.130,19,36,.528,21,81,102,11,7,23,20,63,174,3.2
431,Chris Obekpa\chris-obekpa-1,2014-15,St. John's (NY),C,30,24,819,66,143,.462,66,142,.465,0,1,.000,42,81,.519,72,137,209,16,30,94,34,97,174,7.0
432,Michael Ojo\michael-ojo-2,2016-17,Florida State,C,35,34,426,57,101,.564,57,101,.564,0,0,,58,72,.806,55,57,112,7,10,30,27,71,172,4.4
433,Aaron Menzies\aaron-menzies-1,2016-17,Seattle,C,14,14,305,69,131,.527,69,131,.527,0,0,,34,56,.607,25,61,86,9,3,15,17,30,172,9.0
434,Karviar Shepherd\karviar-shepherd-1,2016-17,Texas Christian,C,39,9,440,65,113,.575,64,112,.571,1,1,1.000,41,53,.774,39,53,92,20,11,6,38,83,172,3.0
435,Kyle Caudill\kc-caudill-1,2015-16,Nicholls State,C,34,0,381,60,123,.488,59,114,.518,1,9,.111,51,68,.750,27,36,63,19,3,7,41,81,172,2.4
436,Menno Dijkstra\menno-dijkstra-1,2017-18,UC-Riverside,C,30,8,440,66,141,.468,44,86,.512,22,55,.400,16,18,.889,28,53,81,16,8,13,16,45,170,4.2
437,Eric Stuteville\eric-stuteville-1,2013-14,Sacramento State,C,30,3,456,66,134,.493,65,132,.492,1,2,.500,37,53,.698,35,64,99,5,4,10,20,61,170,3.7
438,Carson Shanks\carson-shanks-1,2015-16,North Dakota,C,31,24,488,67,136,.493,67,132,.508,0,4,.000,35,65,.538,23,80,103,16,5,27,57,105,169,2.1
439,Philipp Hartwich\philipp-hartwich-1,2017-18,Portland,C,32,32,826,71,112,.634,71,112,.634,0,0,,27,89,.303,60,193,253,40,15,73,44,112,169,6.2
440,Pat Forsythe\pat-forsythe-1,2013-14,Akron,C,34,17,595,70,123,.569,70,123,.569,0,0,,28,47,.596,47,66,113,17,14,33,47,91,168,3.5
441,Matthew Pegram\matthew-pegram-1,2016-17,Wofford,C,33,3,549,72,129,.558,71,127,.559,1,2,.500,23,31,.742,35,66,101,21,11,11,31,103,168,3.3
442,Geoffrey Groselle\geoff-groselle-1,2014-15,Creighton,C,31,9,382,72,111,.649,72,111,.649,0,0,,24,36,.667,33,43,76,9,5,18,28,52,168,4.0
443,Ricmonds Vilde\ricmonds-vilde-1,2014-15,Houston Baptist,C,28,19,441,68,122,.557,64,111,.577,4,11,.364,28,46,.609,46,102,148,16,8,19,53,61,168,4.3
444,Boris Bojanovsky\boris-bojanovsky-1,2014-15,Florida State,C,33,0,540,57,99,.576,57,99,.576,0,0,,54,80,.675,36,77,113,18,22,44,27,62,168,5.2
445,C.J. Turman\cj-turman-1,2014-15,Florida Atlantic,C,29,10,526,68,118,.576,68,118,.576,0,0,,31,56,.554,24,71,95,6,6,18,40,87,167,3.0
446,Nouhoum Bocoum\nouhoum-bocoum-1,2014-15,Arkansas State,C,28,15,434,63,142,.444,62,139,.446,1,3,.333,40,59,.678,47,75,122,3,5,12,29,48,167,3.9
447,Isaac Neilson\isaac-neilson-1,2017-18,Utah Valley,C,34,6,498,68,107,.636,64,99,.646,4,8,.500,27,33,.818,60,91,151,21,16,22,34,66,167,5.1
448,Stefan Jovanovic\stefan-jovanovic-1,2015-16,Hawaii,C,34,0,529,66,130,.508,66,130,.508,0,0,,34,47,.723,29,107,136,9,8,35,38,60,166,3.7
449,Jeremy Olsen\jeremy-olsen-1,2013-14,Utah,C,32,10,443,71,126,.563,71,126,.563,0,0,,24,34,.706,27,59,86,8,7,19,36,65,166,3.2
450,Jaume Sorolla\jaume-sorolla-1,2016-17,Valparaiso,C,32,9,611,65,136,.478,65,135,.481,0,1,.000,35,50,.700,51,89,140,21,5,30,26,63,165,4.4
451,Ruben Guerrero\ruben-guerrero-1,2015-16,South Florida,C,32,19,761,71,118,.602,71,118,.602,0,0,,23,36,.639,71,109,180,11,12,41,27,73,165,5.6
452,Josh Ibarra\josh-ibarra-1,2014-15,Houston Baptist,C,27,9,448,73,115,.635,73,115,.635,0,0,,19,35,.543,60,115,175,16,11,55,32,80,165,6.7
453,Steven Burrough\steven-burrough-1,2014-15,North Carolina A&T,C,32,30,615,59,99,.596,59,99,.596,0,0,,47,70,.671,37,62,99,11,9,54,33,91,165,4.4
454,Carson Shanks\carson-shanks-1,2016-17,North Dakota,C,31,3,390,58,107,.542,58,105,.552,0,2,.000,48,76,.632,23,45,68,18,1,23,41,90,164,2.7
455,Sidy Djitte\sidy-djitte-1,2015-16,Clemson,C,31,5,467,62,100,.620,62,100,.620,0,0,,40,63,.635,60,102,162,9,19,20,29,88,164,5.1
456,Namdi Okonkwo\namdi-okonkwo-1,2017-18,Pacific,C,32,17,627,68,103,.660,68,103,.660,0,0,,28,42,.667,52,96,148,11,5,80,22,77,164,6.1
457,Jamal Hunter\jamal-hunter-2,2014-15,Jacksonville State,C,30,29,681,68,133,.511,68,133,.511,0,0,,27,40,.675,61,100,161,18,17,63,37,100,163,5.4
458,Schnider Herard\schnider-herard-1,2016-17,Mississippi State,C,32,18,595,56,102,.549,56,102,.549,0,0,,51,103,.495,58,101,159,7,3,8,48,68,163,3.2
459,J.J. Davenport\jj-davenport-1,2013-14,Louisiana,C,35,7,423,56,117,.479,56,117,.479,0,0,,51,69,.739,51,73,124,14,4,1,24,63,163,3.4
460,Eric Truog\eric-truog-1,2014-15,Marist,C,31,31,772,69,136,.507,60,108,.556,9,28,.321,16,38,.421,53,120,173,47,24,21,41,98,163,4.9
461,Amida Brimah\amida-brimah-1,2013-14,Connecticut,C,40,17,649,64,100,.640,64,100,.640,0,0,,35,61,.574,53,67,120,11,4,92,28,116,163,4.2
462,Kiel Turpin\kiel-turpin-1,2014-15,Florida State,C,33,12,411,71,127,.559,71,127,.559,0,0,,21,35,.600,36,40,76,3,7,23,31,89,163,2.8
463,Marcel Boyd\marcel-boyd-1,2016-17,Howard,C,31,30,772,54,133,.406,54,132,.409,0,1,.000,55,97,.567,80,124,204,20,11,26,68,104,163,3.3
464,Brad Greene\brad-greene-1,2017-18,UC-Irvine,C,35,1,427,63,132,.477,63,132,.477,0,0,,36,48,.750,53,85,138,11,4,27,26,75,162,3.6
465,Chad Lang\chad-lang-1,2014-15,Lipscomb,C,31,16,372,66,117,.564,66,117,.564,0,0,,30,55,.545,42,65,107,1,5,22,28,79,162,3.4
466,Alex Gavrilovic\alex-gavrilovic-1,2014-15,Towson,C,30,5,520,55,140,.393,33,74,.446,22,66,.333,30,37,.811,44,76,120,11,7,6,28,55,162,3.5
467,Amida Brimah\amida-brimah-1,2015-16,Connecticut,C,25,17,526,67,101,.663,67,101,.663,0,0,,28,34,.824,46,69,115,2,7,67,20,64,162,7.1
468,Ruben Guerrero\ruben-guerrero-1,2016-17,South Florida,C,30,25,687,65,128,.508,65,128,.508,0,0,,31,52,.596,54,99,153,22,11,37,48,65,161,4.5
469,Reggie Lynch\reggie-lynch-1,2017-18,Minnesota,C,16,16,422,59,101,.584,59,101,.584,0,0,,43,60,.717,50,78,128,21,11,66,23,43,161,12.3
470,Frank Snow\frank-snow-1,2014-15,Southern,C,31,17,504,57,121,.471,57,121,.471,0,0,,47,82,.573,49,62,111,5,7,39,28,69,161,3.9
471,Ebuka Izundu\ebuka-izundu-1,2017-18,Miami (FL),C,32,2,467,72,104,.692,72,104,.692,0,0,,16,34,.471,56,64,120,8,15,20,27,76,160,4.5
472,Kingsley Okoroh\kingsley-okorah-1,2016-17,University of California,C,34,24,722,64,127,.504,64,127,.504,0,0,,30,56,.536,72,116,188,31,12,74,42,88,158,5.2
473,Mamadou Ndiaye\mamadou-ndiaye-2,2014-15,UC-Irvine,C,15,11,298,64,101,.634,64,100,.640,0,1,.000,30,57,.526,23,54,77,2,4,25,23,46,158,7.7
474,Neal Monson\neal-monson-1,2014-15,UC-Davis,C,32,1,460,62,101,.614,62,101,.614,0,0,,32,41,.780,27,81,108,15,11,7,29,50,156,4.0
475,Edward Hardt\edward-hardt-1,2017-18,Houston Baptist,C,30,17,470,63,123,.512,62,120,.517,1,3,.333,29,54,.537,35,65,100,12,11,7,42,66,156,2.8
476,Christ Koumadje\jeanmarc-koumadje-1,2017-18,Florida State,C,24,21,385,67,107,.626,67,107,.626,0,0,,21,36,.583,39,59,98,3,2,35,18,62,155,5.5
477,DaShonte Riley\dashonte-riley-1,2013-14,Eastern Michigan,C,37,35,950,62,126,.492,62,125,.496,0,1,.000,31,49,.633,77,145,222,25,28,95,60,124,155,5.0
478,Adam Smith\adam-smith-1,2013-14,Virginia Tech,C,14,9,361,56,146,.384,32,79,.405,24,67,.358,18,22,.818,3,29,32,30,2,0,20,17,154,5.7
479,Seth Dugan\seth-dugan-1,2015-16,Western Michigan,C,32,12,514,61,128,.477,61,128,.477,0,0,,32,60,.533,47,85,132,29,3,20,43,72,154,3.2
480,Jordy Tshimanga\jordy-tshimanga-1,2016-17,Nebraska,C,31,9,389,57,127,.449,57,127,.449,0,0,,40,64,.625,54,69,123,8,14,15,46,69,154,3.0
481,Jacob Enevold\jacob-jensen-1,2013-14,Drake,C,31,0,574,62,115,.539,62,115,.539,0,0,,30,50,.600,38,115,153,11,3,22,38,65,154,3.7
482,Jack Crook\jack-crook-1,2013-14,Seattle,C,30,28,669,62,138,.449,62,137,.453,0,1,.000,28,45,.622,58,122,180,31,11,11,35,90,152,4.0
483,Monty Brown\monty-brown-1,2013-14,Mercer,C,34,1,328,55,82,.671,55,82,.671,0,0,,42,54,.778,31,50,81,4,2,13,25,54,152,3.4
484,Moussa Gueye\moussa-gueye-1,2013-14,Valparaiso,C,34,17,557,55,98,.561,55,98,.561,0,0,,42,53,.792,62,106,168,12,15,71,75,112,152,3.8
485,Darius Bolstad\darius-bolstad-1,2016-17,Radford,C,28,2,404,65,98,.663,65,98,.663,0,0,,21,29,.724,37,67,104,13,8,46,21,73,151,5.4
486,Seth VanDeest\seth-vandeest-1,2013-14,Drake,C,31,31,585,59,102,.578,59,102,.578,0,0,,33,67,.493,49,105,154,29,7,22,27,76,151,4.5
487,John Ryan\john-ryan-2,2013-14,UC-Irvine,C,35,2,501,63,113,.558,63,113,.558,0,0,,25,44,.568,39,95,134,35,9,31,35,71,151,3.9
488,Kevin Bleeker\kevin-bleeker-1,2014-15,Canisius,C,33,10,581,54,122,.443,41,76,.539,13,46,.283,30,40,.750,45,86,131,32,14,30,41,75,151,3.8
489,Ruben Guerrero\ruben-guerrero-1,2014-15,South Florida,C,28,22,678,63,133,.474,63,133,.474,0,0,,25,49,.510,68,61,129,7,8,43,34,49,151,4.6
490,Frank Toohey\frank-toohey-1,2017-18,Air Force,C,31,14,426,45,107,.421,30,70,.429,15,37,.405,46,55,.836,38,43,81,26,12,8,30,65,151,3.5
491,Bakary Konate\bakary-konate-1,2015-16,Minnesota,C,31,26,665,56,110,.509,56,108,.519,0,2,.000,38,56,.679,49,109,158,13,6,32,36,85,150,4.0
492,Anthony Green\anthony-green-2,2016-17,Northeastern,C,31,19,556,60,105,.571,60,105,.571,0,0,,30,55,.545,46,80,126,6,10,41,25,60,150,4.5
493,Joshua Smith\joshua-smith-1,2013-14,Georgetown,C,13,13,259,55,84,.655,55,83,.663,0,1,.000,40,63,.635,22,22,44,9,13,8,21,46,150,8.6
494,Ernest Aflakpui\ernest-aflakpui-1,2017-18,Temple,C,33,32,637,64,102,.627,64,102,.627,0,0,,21,41,.512,49,90,139,19,14,10,33,107,149,3.5
495,Nate Sestina\nate-sestina-1,2016-17,Bucknell,C,31,1,371,63,124,.508,56,100,.560,7,24,.292,16,23,.696,35,79,114,12,7,17,27,57,149,3.6
496,Tobias Sjoberg\tobias-sjoberg-1,2017-18,Marist,C,29,28,673,63,100,.630,63,100,.630,0,0,,23,36,.639,61,104,165,43,8,25,52,97,149,4.7
497,Emmanuel Ejeh\emmanuel-ejeh-1,2017-18,Mississippi Valley State,C,32,13,516,60,118,.508,60,116,.517,0,2,.000,28,41,.683,69,111,180,12,10,15,27,71,148,4.4
498,Terrence Parker\terrence-parker-1,2017-18,Tennessee-Martin,C,31,16,524,60,108,.556,60,108,.556,0,0,,28,46,.609,48,102,150,18,14,15,46,79,148,3.6
499,Randy Phillips\randy-phillips-1,2016-17,Radford,C,32,30,582,61,129,.473,61,129,.473,0,0,,26,62,.419,84,73,157,11,13,16,67,88,148,2.4
500,Jordan Vandenberg\jordan-vandenberg-1,2013-14,North Carolina State,C,32,32,714,68,100,.680,68,100,.680,0,0,,12,23,.522,56,93,149,31,9,45,19,103,148,5.3
501,Selvedin Planincic\selvedin-planincic-1,2017-18,Canisius,C,32,21,477,57,105,.543,47,62,.758,10,43,.233,23,35,.657,22,68,90,24,11,28,37,83,147,3.3
502,Rickey Brice Jr.\rickey-bricejr-1,2015-16,North Texas,C,29,2,395,60,120,.500,60,120,.500,0,0,,27,58,.466,20,83,103,2,5,36,33,72,147,2.9
503,Jaume Sorolla\jaume-sorolla-1,2017-18,Valparaiso,C,30,16,488,55,101,.545,55,100,.550,0,1,.000,37,48,.771,44,59,103,7,11,32,25,74,147,4.2
504,Rauno Nurger\rauno-nurger-1,2017-18,Wichita State,C,33,2,443,57,111,.514,49,84,.583,8,27,.296,24,34,.706,31,60,91,15,5,13,15,54,146,3.5
505,Arkeem Joseph\arkeem-joseph-1,2014-15,Tennessee-Martin,C,30,8,466,69,132,.523,69,132,.523,0,0,,8,27,.296,42,42,84,6,1,4,31,52,146,2.4
506,Quadir Welton\quadir-welton-1,2013-14,Saint Peter's,C,31,31,694,52,115,.452,52,115,.452,0,0,,42,71,.592,68,87,155,18,13,41,29,88,146,4.5
507,Menno Dijkstra\menno-dijkstra-1,2015-16,UC-Riverside,C,33,1,469,67,111,.604,67,111,.604,0,0,,12,13,.923,41,61,102,12,5,18,15,49,146,4.0
508,Jorden Kaufman\jorden-kaufman-1,2013-14,Oral Roberts,C,33,5,345,61,115,.530,61,115,.530,0,0,,24,33,.727,28,43,71,9,1,4,11,56,146,2.9
509,Gligorije Rakocevic\gligorije-rakocevic-1,2016-17,Oregon State,C,32,14,598,54,119,.454,46,100,.460,8,19,.421,30,57,.526,47,72,119,6,7,9,39,77,146,2.4
510,Imoh Silas\imoh-silas-1,2013-14,Siena,C,38,32,640,64,130,.492,64,130,.492,0,0,,18,40,.450,78,101,179,25,17,63,47,125,146,3.6
511,Vashil Fernandez\vashil-fernandez-1,2013-14,Valparaiso,C,34,17,655,52,90,.578,52,90,.578,0,0,,41,86,.477,53,120,173,6,13,58,36,101,145,4.1
512,Ian Markolf\ian-markolf-2,2013-14,Incarnate Word,C,21,20,490,60,134,.448,60,134,.448,0,0,,24,59,.407,49,106,155,39,7,29,50,61,144,5.1
513,Josh Ibarra\josh-ibarra-1,2017-18,Houston Baptist,C,9,9,239,58,105,.552,58,105,.552,0,0,,28,46,.609,43,47,90,23,3,15,20,23,144,14.6
514,Jacob Enevold\jacob-jensen-1,2015-16,Drake,C,29,24,494,51,90,.567,51,90,.567,0,0,,42,51,.824,43,99,142,10,3,13,32,52,144,4.3
515,Cameron Ridley\cameron-ridley-1,2015-16,Texas,C,13,11,293,61,97,.629,61,97,.629,0,0,,22,54,.407,44,66,110,6,6,37,28,39,144,10.1
516,Darnell Tillman\darnell-tillman-1,2016-17,Missouri-Kansas City,C,35,34,630,59,91,.648,59,91,.648,0,0,,26,50,.520,93,107,200,12,22,20,23,83,144,5.1
517,Frank Toohey\frank-toohey-1,2015-16,Air Force,C,26,9,366,42,81,.519,35,62,.565,7,19,.368,53,73,.726,38,38,76,14,5,6,24,63,144,4.0
518,Daniel Giddens\daniel-giddens-1,2017-18,Alabama,C,34,18,451,58,99,.586,58,99,.586,0,0,,28,48,.583,28,58,86,8,14,35,34,95,144,2.9
519,Travis Elliott\travis-elliott-1,2013-14,Bethune-Cookman,C,32,28,635,48,115,.417,48,115,.417,0,0,,47,71,.662,70,88,158,11,9,16,31,86,143,3.4
520,Marvin Frazier\marvin-fraizer-1,2013-14,Northwestern State,C,27,17,470,48,112,.429,43,94,.457,5,18,.278,42,56,.750,40,83,123,13,12,56,19,73,143,5.3
521,Duby Okeke\duby-okeke-1,2015-16,Winthrop,C,29,0,496,57,89,.640,57,89,.640,0,0,,29,59,.492,49,90,139,5,8,72,31,70,143,5.4
522,Coreontae DeBerry\coreontae-deberry-1,2014-15,Cincinnati,C,34,0,360,54,99,.545,54,99,.545,0,0,,35,57,.614,25,47,72,3,2,33,24,52,143,3.0
523,Blaise Mbargorba\blaise-mbargorba-1,2015-16,Boston University,C,33,8,458,60,103,.583,60,103,.583,0,0,,23,33,.697,29,56,85,6,3,29,26,60,143,3.2
524,Willy Kouassi\willy-kouassi-1,2013-14,Kennesaw State,C,31,21,546,57,106,.538,57,106,.538,0,0,,29,63,.460,47,84,131,9,4,35,39,87,143,3.1
525,AJ West\aj-west-1,2013-14,Nevada,C,21,19,516,54,103,.524,54,102,.529,0,1,.000,34,70,.486,75,67,142,4,5,48,22,59,142,6.9
526,Duby Okeke\duby-okeke-1,2014-15,Winthrop,C,32,2,439,57,82,.695,57,82,.695,0,0,,28,51,.549,46,42,88,6,6,46,34,72,142,3.8
527,El Hadji Ndieguene\el-hadji-ndieguene-1,2013-14,Coastal Carolina,C,32,29,775,55,128,.430,55,128,.430,0,0,,32,46,.696,74,144,218,20,11,11,39,87,142,3.8
528,Zac Tillman\zac-tillman-1,2013-14,Monmouth,C,32,32,527,55,124,.444,55,124,.444,0,0,,31,55,.564,31,67,98,17,11,7,28,90,141,2.3
529,Jon Teske\jon-teske-1,2017-18,Michigan,C,41,2,506,53,98,.541,53,97,.546,0,1,.000,35,61,.574,57,78,135,15,23,26,15,66,141,3.8
530,Jailan Haslem\jailan-haslem-1,2017-18,Charlotte,C,29,28,505,57,98,.582,57,98,.582,0,0,,27,50,.540,60,68,128,8,4,13,31,80,141,3.6
531,Aaron Menzies\aaron-menzies-1,2015-16,Seattle,C,32,1,521,61,115,.530,61,115,.530,0,0,,19,42,.452,51,104,155,11,8,15,46,79,141,2.9
532,Jon Horford\jon-horford-1,2013-14,Michigan,C,37,7,511,62,110,.564,62,108,.574,0,2,.000,17,26,.654,49,105,154,19,10,26,19,75,141,3.9
533,David Onuorah\david-onuorah-1,2015-16,Cornell,C,28,28,715,54,107,.505,53,105,.505,1,2,.500,31,77,.403,54,135,189,11,21,45,44,99,140,4.4
534,Jamal Hunter\jamal-hunter-2,2013-14,Jacksonville State,C,31,28,636,56,90,.622,56,90,.622,0,0,,28,46,.609,62,74,136,21,14,45,27,104,140,4.8
535,Dallin Bachynski\dallin-bachynski-1,2014-15,Utah,C,34,1,426,47,88,.534,46,86,.535,1,2,.500,45,65,.692,26,58,84,7,10,11,15,64,140,3.1
536,Zech Smith\zech-smith-1,2014-15,Morgan State,C,28,27,663,58,110,.527,58,110,.527,0,0,,24,47,.511,96,99,195,3,9,43,21,60,140,6.1
537,Matt Willms\matt-willms-1,2014-15,Texas-El Paso,C,27,9,501,54,98,.551,54,98,.551,0,0,,32,51,.627,33,84,117,23,13,30,27,55,140,5.0
538,Tyler Hadden\tyler-hadden-1,2017-18,Belmont,C,33,12,344,52,98,.531,43,61,.705,9,37,.243,26,35,.743,20,41,61,11,4,9,24,52,139,2.6
539,Braden Burke\braden-burke-1,2016-17,Robert Morris,C,32,8,487,61,144,.424,61,144,.424,0,0,,17,44,.386,28,58,86,4,11,10,33,76,139,1.4
540,Koch Bar\koch-bar-1,2017-18,Bradley,C,30,21,532,47,107,.439,47,107,.439,0,0,,45,65,.692,39,67,106,13,9,25,39,68,139,3.1
541,Tonye Jekiri\tonye-jekiri-1,2013-14,Miami (FL),C,33,16,705,57,125,.456,57,125,.456,0,0,,25,43,.581,67,113,180,22,21,29,31,87,139,4.2
542,Thomas Welsh\thomas-welsh-1,2014-15,UCLA,C,36,3,565,62,132,.470,62,132,.470,0,0,,14,23,.609,54,83,137,8,14,39,17,85,138,3.5
543,Dominik Olejniczak\dominik-olejniczak-1,2017-18,Mississippi,C,32,11,450,60,113,.531,60,113,.531,0,0,,18,28,.643,38,45,83,13,14,20,29,76,138,3.0
544,Rickey Brice Jr.\rickey-bricejr-1,2016-17,North Texas,C,27,12,343,46,119,.387,46,118,.390,0,1,.000,46,65,.708,28,86,114,2,8,24,25,55,138,3.3
545,Isaiah Martin\isaiah-martin-1,2017-18,Florida A&M,C,17,17,462,59,99,.596,59,99,.596,0,0,,20,36,.556,48,62,110,7,7,36,19,36,138,8.3
546,Matt Heldt\max-heldt-1,2017-18,Marquette,C,35,32,768,55,85,.647,55,85,.647,0,0,,28,32,.875,57,107,164,26,9,35,18,102,138,4.7
547,Yanick Moreira\yanick-moreira-1,2013-14,Southern Methodist,C,23,14,310,53,103,.515,53,103,.515,0,0,,32,48,.667,26,64,90,9,5,13,24,30,138,4.5
548,Demarco Cox\demarco-cox-1,2013-14,Mississippi,C,33,16,548,51,94,.543,51,94,.543,0,0,,35,67,.522,51,77,128,7,16,25,20,70,137,3.9
549,Amir Warnock\amir-warnock-1,2016-17,Alabama State,C,31,18,440,61,123,.496,61,123,.496,0,0,,15,36,.417,54,97,151,7,6,14,36,72,137,2.9
550,Amadou Sidibe\amadou-sidibe-1,2014-15,Fairfield,C,24,22,547,54,110,.491,54,110,.491,0,0,,29,42,.690,56,107,163,16,12,3,30,56,137,5.0
551,Malik Miller\malik-miller-1,2016-17,Fairleigh Dickinson,C,30,3,443,55,109,.505,48,74,.649,7,35,.200,20,32,.625,30,81,111,4,10,27,23,61,137,3.6
552,Jamuni McNeace\jamuni-mcneace-1,2016-17,Oklahoma,C,31,0,481,57,103,.553,57,102,.559,0,1,.000,23,43,.535,38,76,114,5,6,38,24,85,137,3.5
553,Ebuka Izundu\ebuka-izundu-1,2016-17,Miami (FL),C,32,9,417,54,99,.545,54,99,.545,0,0,,29,42,.690,47,50,97,6,7,25,27,73,137,3.3
554,Ernest Aflakpui\ernest-aflakpui-1,2016-17,Temple,C,32,21,538,57,103,.553,57,103,.553,0,0,,22,43,.512,65,99,164,13,7,7,36,85,136,3.3
555,Steven Burrough\steven-burrough-1,2015-16,North Carolina A&T,C,28,19,529,51,107,.477,51,107,.477,0,0,,34,63,.540,31,60,91,12,8,31,25,77,136,3.3
556,Christian Mackey\christian-mackey-1,2015-16,Denver,C,31,0,379,46,101,.455,41,83,.494,5,18,.278,38,54,.704,31,50,81,41,11,17,39,73,135,3.1
557,Isaiah Manderson\isaiah-manderson-1,2014-15,Texas Tech,C,31,5,433,55,108,.509,55,107,.514,0,1,.000,25,51,.490,23,62,85,8,10,8,35,50,135,2.3
558,Micaiah Henry\micaiah-henry-1,2017-18,Tennessee Tech,C,32,1,459,59,96,.615,59,96,.615,0,0,,16,50,.320,32,55,87,11,6,20,42,87,134,2.1
559,Taylor Danaher\taylor-danaher-1,2014-15,Mount St. Mary's,C,30,4,576,50,88,.568,47,79,.595,3,9,.333,31,41,.756,38,76,114,15,15,38,27,73,134,4.5
560,Jimbo Lull\jimbo-lull-1,2017-18,San Francisco,C,31,1,342,56,99,.566,55,87,.632,1,12,.083,21,32,.656,30,64,94,9,5,18,31,53,134,3.1
561,C.J. Gettys\cj-gettys-1,2014-15,North Carolina-Wilmington,C,30,16,432,53,109,.486,53,109,.486,0,0,,27,46,.587,37,71,108,10,6,31,11,87,133,3.5
562,Chris Brady\chris-brady-1,2014-15,Monmouth,C,33,3,500,56,110,.509,54,101,.535,2,9,.222,19,26,.731,26,74,100,7,11,19,33,66,133,2.6
563,Adonis De La Rosa\adonis-de-la-rosa-1,2016-17,Kent State,C,36,15,477,45,109,.413,45,108,.417,0,1,.000,43,76,.566,53,79,132,11,9,26,46,91,133,2.1
564,Dererk Pardon\dererk-pardon-1,2015-16,Northwestern,C,20,2,332,53,82,.646,53,82,.646,0,0,,27,51,.529,35,49,84,6,4,12,14,48,133,5.5
565,Prince Ibeh\prince-ibeh-1,2015-16,Texas,C,32,22,579,52,91,.571,52,91,.571,0,0,,28,67,.418,72,89,161,2,9,64,40,105,132,3.9
566,John Ryan\john-ryan-2,2014-15,UC-Irvine,C,25,19,450,56,99,.566,56,99,.566,0,0,,20,34,.588,48,71,119,22,8,33,31,63,132,5.0
567,Ben Lammers\ben-lammers-1,2015-16,Georgia Tech,C,36,0,534,57,87,.655,57,87,.655,0,0,,17,34,.500,47,98,145,17,13,47,17,63,131,4.6
568,Zac Tillman\zac-tillman-1,2014-15,Monmouth,C,33,29,486,53,102,.520,53,102,.520,0,0,,25,44,.568,20,47,67,3,15,12,18,71,131,2.4
569,Joniah White\joniah-white-1,2016-17,Louisiana Tech,C,33,0,568,50,85,.588,50,85,.588,0,0,,31,63,.492,61,94,155,26,16,71,23,59,131,5.7
570,Moses Kingsley\moses-kingsley-1,2014-15,Arkansas,C,36,4,390,49,101,.485,49,101,.485,0,0,,33,53,.623,45,45,90,11,15,38,23,56,131,3.4
571,Albert Owens\albert-owens-1,2014-15,Oral Roberts,C,34,5,404,55,135,.407,54,132,.409,1,3,.333,19,37,.514,32,50,82,4,6,26,15,50,130,2.3
572,Omer Yurtseven\omer-yurtseven-1,2016-17,North Carolina State,C,22,14,416,53,116,.457,52,113,.460,1,3,.333,23,32,.719,30,66,96,26,4,16,28,62,130,4.0
573,Kennedy Esume\kennedy-esume-1,2014-15,Cal State Fullerton,C,31,15,461,54,108,.500,54,108,.500,0,0,,21,46,.457,36,65,101,5,9,19,26,60,129,2.8
574,Naofall Folahan\naofall-folahan-1,2013-14,Wagner,C,31,31,654,51,107,.477,51,107,.477,0,0,,27,42,.643,62,101,163,4,6,89,23,96,129,4.9
575,Marcel Boyd\marcel-boyd-1,2013-14,Howard,C,33,16,565,44,100,.440,44,100,.440,0,0,,41,74,.554,63,76,139,15,6,26,36,81,129,2.9
576,Moses Kingsley\moses-kingsley-1,2013-14,Arkansas,C,32,0,367,43,81,.531,42,79,.532,1,2,.500,41,63,.651,39,63,102,7,14,49,14,41,128,4.6
577,Ugochukwu Njoku\ugochukwu-njoku-1,2013-14,Detroit Mercy,C,31,27,660,54,105,.514,54,104,.519,0,1,.000,20,53,.377,72,108,180,14,34,47,31,87,128,5.1
578,Marin Maric\marin-maric-1,2014-15,Northern Illinois,C,26,7,377,47,82,.573,47,80,.588,0,2,.000,34,45,.756,45,58,103,14,7,10,31,51,128,4.1
579,Daniel Giddens\daniel-giddens-1,2015-16,Ohio State,C,33,7,599,51,110,.464,51,109,.468,0,1,.000,25,57,.439,49,70,119,9,17,50,33,108,127,2.9
580,Jake Giesler\jake-giesler-1,2013-14,Northern Kentucky,C,30,5,482,53,121,.438,44,90,.489,9,31,.290,12,27,.444,45,51,96,15,4,15,19,54,127,3.0
581,Armel TeTe\amel-tete-1,2017-18,Presbyterian,C,32,27,686,48,107,.449,48,107,.449,0,0,,30,53,.566,51,94,145,4,14,31,31,82,126,3.1
582,C.J. Gettys\cj-gettys-1,2015-16,North Carolina-Wilmington,C,24,16,375,46,92,.500,46,92,.500,0,0,,34,46,.739,46,77,123,12,3,33,21,74,126,4.8
583,Micah Potter\micah-potter-1,2016-17,Ohio State,C,30,12,422,43,99,.434,26,48,.542,17,51,.333,21,35,.600,35,57,92,8,8,11,20,68,124,2.7
584,Jordy Tshimanga\jordy-tshimanga-1,2017-18,Nebraska,C,31,18,423,51,112,.455,51,112,.455,0,0,,22,39,.564,60,83,143,15,8,14,37,71,124,2.9
585,Tyere Marshall\tyere-marshall-1,2016-17,Rider,C,31,3,408,54,115,.470,54,115,.470,0,0,,16,44,.364,51,71,122,7,14,12,22,78,124,2.7
586,Malik Williams\malik-williams-1,2017-18,Louisville,C,32,12,338,46,110,.418,26,48,.542,20,62,.323,11,16,.688,23,54,77,5,12,13,11,30,123,3.0
587,Willy Kouassi\willy-kouassi-1,2014-15,Kennesaw State,C,27,25,521,50,107,.467,50,107,.467,0,0,,23,54,.426,38,97,135,3,2,36,41,79,123,2.5
588,Chris Obekpa\chris-obekpa-1,2013-14,St. John's (NY),C,32,17,642,54,96,.563,54,96,.563,0,0,,15,37,.405,58,96,154,26,14,94,34,76,123,5.4
589,Ryan Gomes\ryan-gomes-2,2017-18,Mount St. Mary's,C,32,15,343,54,94,.574,54,94,.574,0,0,,15,32,.469,18,39,57,8,9,16,19,53,123,2.6
590,Prince Ibeh\prince-ibeh-1,2013-14,Texas,C,35,0,477,46,91,.505,46,90,.511,0,1,.000,31,60,.517,52,68,120,5,11,61,25,103,123,3.3
591,Kaj-Bjorn Sherman\kaj-bjorn-sherman-1,2013-14,Texas-San Antonio,C,28,2,470,37,78,.474,37,78,.474,0,0,,48,64,.750,35,63,98,5,8,6,40,66,122,2.4
592,Quinterian McConico\quinterian-mcconico-1,2015-16,Alabama A&M,C,18,7,325,53,83,.639,52,82,.634,1,1,1.000,15,21,.714,16,50,66,5,3,8,14,37,122,5.1
593,Michael Buchanan\michael-buchanan-1,2013-14,South Carolina Upstate,C,28,1,283,48,93,.516,48,93,.516,0,0,,25,50,.500,37,40,77,7,5,14,16,41,121,3.2
594,Dusan Ristic\dusan-ristic-1,2014-15,Arizona,C,36,0,308,48,78,.615,44,73,.603,4,5,.800,21,41,.512,21,54,75,2,2,9,9,45,121,2.5
595,Kameron Rooks\kameron-rooks-1,2015-16,University of California,C,33,10,566,47,80,.588,47,80,.588,0,0,,26,46,.565,62,97,159,12,5,27,18,98,120,3.7
596,Avery Diggs\avery-diggs-1,2017-18,South Carolina Upstate,C,31,12,431,53,94,.564,52,89,.584,1,5,.200,13,23,.565,43,68,111,8,7,16,24,62,120,3.1
597,Seth Dugan\seth-dugan-1,2017-18,Western Michigan,C,23,5,363,49,97,.505,49,95,.516,0,2,.000,22,44,.500,53,41,94,10,6,12,17,42,120,4.3
598,Justin Banks\justin-banks-1,2013-14,Alabama A&M,C,28,15,408,45,80,.563,45,79,.570,0,1,.000,30,38,.789,30,90,120,6,7,30,20,53,120,4.2
599,Mike Thorne\mike-thorne-1,2016-17,Illinois,C,24,10,318,52,95,.547,52,95,.547,0,0,,16,35,.457,28,50,78,8,1,8,27,50,120,2.8
600,Shaquille Cleare\shaquille-cleare-1,2015-16,Texas,C,33,0,402,49,89,.551,49,89,.551,0,0,,22,35,.629,34,61,95,4,3,1,21,60,120,2.3
601,Cody Stetler\cody-stetler-1,2015-16,Houston Baptist,C,24,14,341,46,95,.484,45,92,.489,1,3,.333,26,39,.667,25,43,68,16,5,8,19,59,119,3.1
602,Carson Shanks\carson-shanks-1,2014-15,North Dakota,C,19,13,373,42,99,.424,40,90,.444,2,9,.222,33,54,.611,18,51,69,13,1,27,25,59,119,3.5
603,Dominic Nelson\dominic-nelson-1,2016-17,Southeastern Louisiana,C,32,22,723,47,97,.485,47,97,.485,0,0,,25,58,.431,72,133,205,10,7,62,44,88,119,3.9
604,Luke Piotrowski\luke-piotrowski-1,2013-14,Eastern Illinois,C,30,14,434,48,101,.475,48,101,.475,0,0,,23,35,.657,21,37,58,13,5,26,29,42,119,2.5
605,Luke Kornet\luke-kornet-1,2013-14,Vanderbilt,C,30,2,461,45,131,.344,24,42,.571,21,89,.236,8,15,.533,19,49,68,23,9,17,21,34,119,2.4
606,Bryan Akinkugbe\bryan-akinkugbe-1,2014-15,North Carolina A&T,C,29,12,494,41,100,.410,41,100,.410,0,0,,37,60,.617,32,48,80,9,8,15,40,66,119,1.8
607,Andre Sands\andre-sands-1,2015-16,Sam Houston State,C,32,0,271,51,83,.614,51,81,.630,0,2,.000,17,32,.531,31,32,63,8,5,2,20,65,119,2.3
608,Kameron Rooks\kameron-rooks-1,2016-17,University of California,C,24,10,411,41,75,.547,41,75,.547,0,0,,36,60,.600,42,65,107,8,4,22,20,60,118,4.3
609,Bryan Akinkugbe\bryan-akinkugbe-1,2013-14,North Carolina A&T,C,29,17,392,46,100,.460,46,99,.465,0,1,.000,26,47,.553,44,40,84,7,4,34,34,83,118,2.3
610,Romelo Banks\romelo-banks-1,2013-14,North Florida,C,32,0,398,48,95,.505,48,95,.505,0,0,,22,42,.524,24,42,66,1,9,32,25,74,118,2.2
611,Micah Potter\micah-potter-1,2017-18,Ohio State,C,29,4,292,44,90,.489,38,70,.543,6,20,.300,24,30,.800,31,40,71,10,5,11,12,39,118,3.3
612,Christ Koumadje\jeanmarc-koumadje-1,2016-17,Florida State,C,35,0,355,53,81,.654,53,80,.663,0,1,.000,12,25,.480,19,46,65,4,7,40,17,60,118,2.9
613,Ahmed Ismail\ahmed-ismail-1,2016-17,Manhattan,C,30,19,487,42,83,.506,41,78,.526,1,5,.200,32,52,.615,49,95,144,8,7,29,46,99,117,2.6
614,Isaiah Johnson\isaiah-johnson-1,2013-14,Akron,C,31,11,414,46,93,.495,46,93,.495,0,0,,25,42,.595,45,41,86,12,8,27,19,53,117,3.3
615,Josh Sharma\josh-sharma-1,2017-18,Stanford,C,33,0,321,48,85,.565,44,71,.620,4,14,.286,17,27,.630,28,49,77,4,6,27,21,68,117,2.6
616,Jaleel Roberts\jaleel-roberts-1,2013-14,North Carolina-Asheville,C,31,3,389,41,82,.500,41,81,.506,0,1,.000,34,49,.694,27,72,99,9,3,38,22,67,116,3.1
617,Julius Francis\julius-francis-1,2013-14,Mississippi Valley State,C,31,22,447,45,126,.357,45,126,.357,0,0,,25,39,.641,18,78,96,7,5,10,29,74,115,1.1
618,Christian Mackey\christian-mackey-1,2016-17,Denver,C,30,1,321,46,77,.597,45,74,.608,1,3,.333,22,37,.595,40,58,98,15,3,2,23,51,115,3.0
619,Corbin Kaufusi\corbin-kaufasi-1,2014-15,Brigham Young,C,34,13,560,36,64,.563,36,64,.563,0,0,,43,70,.614,57,76,133,3,11,34,34,117,115,2.7
620,Jimbo Lull\jimbo-lull-1,2016-17,San Francisco,C,32,6,400,44,77,.571,41,64,.641,3,13,.231,24,33,.727,21,57,78,15,7,8,29,64,115,2.4
621,Quron Davis\quron-davis-1,2015-16,Chicago State,C,31,13,506,40,86,.465,40,86,.465,0,0,,35,60,.583,34,71,105,13,6,23,28,87,115,2.4
622,Austin Venable\austin-venable-1,2015-16,Presbyterian,C,30,5,372,49,95,.516,49,95,.516,0,0,,17,25,.680,19,45,64,2,8,17,32,67,115,1.8
623,James Hajek\james-hajek-1,2014-15,Weber State,C,30,10,529,46,87,.529,46,87,.529,0,0,,22,35,.629,42,81,123,12,7,24,19,68,114,3.5
624,Doral Moore\doral-moore-1,2015-16,Wake Forest,C,30,1,213,48,74,.649,48,74,.649,0,0,,18,31,.581,36,41,77,1,6,24,27,44,114,3.1
625,Josh Henderson\josh-henderson-1,2015-16,Vanderbilt,C,32,1,326,40,80,.500,38,77,.494,2,3,.667,31,49,.633,21,48,69,18,6,12,22,40,113,2.6
626,Tony Sabato\tony-sabato-1,2014-15,Elon,C,32,28,533,47,126,.373,47,126,.373,0,0,,19,41,.463,27,46,73,25,4,9,24,87,113,1.1
627,Brandon Cataldo\brandon-cataldo-1,2013-14,Portland State,C,28,0,287,47,80,.588,47,80,.588,0,0,,19,25,.760,43,48,91,6,2,9,9,46,113,3.7
628,Matt Hodgson\matt-hodgson-1,2013-14,Saint Mary's (CA),C,34,2,357,48,90,.533,48,89,.539,0,1,.000,17,40,.425,40,49,89,5,5,31,32,65,113,2.2
629,Austin Gillmann\austin-gillmann-1,2014-15,Saint Louis,C,32,9,496,44,99,.444,28,53,.528,16,46,.348,9,18,.500,15,52,67,34,4,12,33,54,113,2.0
630,Grant Verhoeven\grant-verhoeven-1,2016-17,Stanford,C,30,10,379,42,81,.519,37,68,.544,5,13,.385,24,33,.727,33,40,73,5,11,7,13,69,113,2.8
631,Marques Bolden\marques-bolden-1,2017-18,Duke,C,29,2,378,48,78,.615,48,78,.615,0,0,,16,27,.593,38,66,104,17,9,28,16,40,112,4.4
632,Terrell Carter\terrell-carter-1,2015-16,Fresno State,C,29,5,300,45,76,.592,45,76,.592,0,0,,22,31,.710,29,40,69,6,6,8,29,69,112,2.2
633,Derrik Smits\derrik-smits-1,2016-17,Valparaiso,C,33,15,424,48,100,.480,48,97,.495,0,3,.000,16,38,.421,24,47,71,25,4,17,36,75,112,1.5
634,Javon Baumann\javon-baumann-1,2014-15,Saint Joseph's,C,31,30,610,48,74,.649,48,74,.649,0,0,,15,40,.375,45,70,115,18,12,39,30,87,111,3.5
635,Josh Coleman\josh-coleman-1,2017-18,Coastal Carolina,C,32,28,507,51,105,.486,51,104,.490,0,1,.000,9,30,.300,70,56,126,2,3,21,16,75,111,2.8
636,Christian Mackey\christian-mackey-1,2017-18,Denver,C,29,1,268,47,77,.610,47,75,.627,0,2,.000,17,25,.680,36,37,73,6,1,6,24,41,111,2.7
637,Tyler McCullough\tyler-mccullough-1,2014-15,Missouri State,C,30,12,418,45,99,.455,45,99,.455,0,0,,21,29,.724,42,38,80,7,8,31,18,64,111,2.9
638,Luke Piotrowski\luke-piotrowski-1,2014-15,Eastern Illinois,C,31,19,397,45,92,.489,45,92,.489,0,0,,21,30,.700,27,37,64,12,7,31,18,31,111,3.2
639,Emondre Rickman\emondre-rickman-1,2017-18,Indiana State,C,29,2,387,43,95,.453,43,95,.453,0,0,,24,50,.480,34,69,103,9,8,28,32,51,110,2.6
640,Zac Tillman\zac-tillman-1,2015-16,Monmouth,C,33,7,328,41,87,.471,41,87,.471,0,0,,28,34,.824,29,48,77,10,7,15,9,68,110,2.6
641,Travis Elliott\travis-elliott-1,2014-15,Bethune-Cookman,C,26,14,485,45,80,.563,45,80,.563,0,0,,20,41,.488,57,77,134,11,8,5,39,83,110,2.8
642,Malik Miller\malik-miller-1,2015-16,Fairleigh Dickinson,C,30,0,275,42,78,.538,39,60,.650,3,18,.167,23,44,.523,24,43,67,4,6,15,11,49,110,2.7
643,Darius Lewis\darius-lewis-1,2014-15,Duquesne,C,31,21,455,39,76,.513,39,76,.513,0,0,,32,57,.561,27,69,96,11,1,31,32,86,110,2.1
644,Willie Wiley\willie-wiley-1,2016-17,Evansville,C,24,10,357,45,98,.459,45,97,.464,0,1,.000,20,35,.571,22,40,62,9,14,10,20,43,110,3.0
645,Dan Robinson\dan-robinson-2,2016-17,Norfolk State,C,33,14,546,46,102,.451,46,102,.451,0,0,,18,31,.581,58,66,124,18,9,33,34,99,110,2.5
646,Francis Ezeiru\francis-ezeiru-1,2013-14,Maryland-Eastern Shore,C,21,19,409,46,86,.535,46,86,.535,0,0,,18,39,.462,46,56,102,3,7,17,25,54,110,4.0
647,C.J. Turman\cj-turman-1,2015-16,Florida Atlantic,C,11,11,316,39,76,.513,39,75,.520,0,1,.000,31,42,.738,18,59,77,10,6,11,25,33,109,7.3
648,Eric Hutchison\eric-hutchison-1,2013-14,Montana,C,29,21,449,35,71,.493,35,71,.493,0,0,,39,44,.886,20,37,57,2,3,7,21,73,109,1.9
649,Miles Brookins\miles-brookins-1,2017-18,La Salle,C,29,1,372,40,67,.597,40,67,.597,0,0,,29,37,.784,22,33,55,10,5,12,16,68,109,2.7
650,Ray Barreno\ray-barreno-1,2015-16,Portland,C,31,26,446,46,88,.523,46,88,.523,0,0,,17,28,.607,47,96,143,6,6,18,44,79,109,2.3
651,LeMon Gregory\lemon-gregory-1,2014-15,Lamar,C,27,12,390,51,76,.671,51,76,.671,0,0,,6,19,.316,33,58,91,8,6,11,30,61,108,2.8
652,Kelvin Jones\kelvin-jones-1,2016-17,Texas-El Paso,C,32,2,406,45,87,.517,45,87,.517,0,0,,18,41,.439,54,64,118,12,8,27,25,83,108,2.8
653,Ashtin Chastain\ashtin-chastain-1,2017-18,San Jose State,C,27,16,494,39,94,.415,38,83,.458,1,11,.091,29,60,.483,34,52,86,17,5,8,38,64,108,1.6
654,Sam Alabakis\sam-alabakis-1,2016-17,Louisiana-Monroe,C,32,22,557,45,86,.523,45,86,.523,0,0,,18,32,.563,41,46,87,6,6,14,28,74,108,2.0
655,Bryan Gellineau\bryan-gellineau-1,2017-18,Norfolk State,C,26,9,293,48,80,.600,48,80,.600,0,0,,12,21,.571,29,27,56,9,6,9,27,61,108,2.4
656,Andrew Drone\andrew-drone-1,2013-14,Rice,C,30,0,315,46,86,.535,46,86,.535,0,0,,16,37,.432,21,36,57,2,2,8,15,49,108,1.9
657,Riley Barker\riley-barker-1,2013-14,Portland,C,31,0,439,41,83,.494,40,81,.494,1,2,.500,24,40,.600,34,62,96,11,12,30,17,66,107,3.2
658,Deng Riak\deng-riak-1,2016-17,East Carolina,C,33,17,702,45,113,.398,42,98,.429,3,15,.200,14,23,.609,44,127,171,13,9,15,46,76,107,1.9
659,David Wishon\david-wishon-1,2015-16,Lipscomb,C,26,10,259,40,78,.513,40,78,.513,0,0,,27,52,.519,20,43,63,2,3,11,33,38,107,1.9
660,Benas Griciunas\benas-griciunas-1,2015-16,Charlotte,C,27,4,254,44,89,.494,37,75,.493,7,14,.500,11,19,.579,30,44,74,7,4,9,24,39,106,2.5
661,Micaiah Henry\micaiah-henry-1,2016-17,Tennessee Tech,C,32,5,425,44,82,.537,44,82,.537,0,0,,18,41,.439,40,38,78,8,4,37,34,92,106,1.9
662,Abdul Ahmed\abdul-ahmed-2,2014-15,Cal State Bakersfield,C,33,5,426,37,103,.359,20,44,.455,17,59,.288,15,21,.714,18,47,65,23,4,5,22,60,106,1.5
663,Connor Osborne\connor-osborne-1,2013-14,Northern Colorado,C,31,30,502,42,80,.525,42,80,.525,0,0,,22,47,.468,33,59,92,13,4,15,26,69,106,2.2
664,Bradley Hayes\bradley-hayes-1,2016-17,Georgetown,C,25,11,340,47,88,.534,47,88,.534,0,0,,12,32,.375,32,69,101,21,8,21,31,46,106,3.5
665,Isaac Neilson\isaac-neilson-1,2014-15,Brigham Young,C,34,5,308,39,79,.494,31,56,.554,8,23,.348,20,32,.625,34,48,82,5,10,10,13,56,106,2.5
666,LeMon Gregory\lemon-gregory-1,2015-16,Lamar,C,29,10,324,42,80,.525,42,80,.525,0,0,,21,37,.568,23,49,72,5,9,11,29,59,105,2.0
667,DJ Haley\dj-haley-1,2013-14,Southern California,C,31,3,492,42,70,.600,42,70,.600,0,0,,21,49,.429,41,67,108,7,4,20,11,76,105,3.0
668,Duby Okeke\duby-okeke-1,2016-17,Winthrop,C,33,24,461,45,75,.600,45,74,.608,0,1,.000,15,56,.268,51,77,128,3,4,47,39,90,105,2.3
669,Dragan Sekelja\dragan-sekelja-1,2013-14,Florida Atlantic,C,22,12,391,35,76,.461,35,76,.461,0,0,,35,56,.625,27,79,106,30,4,12,41,50,105,3.3
670,Davis Rozitis\davis-rozitis-1,2013-14,Hawaii,C,29,1,344,41,62,.661,41,62,.661,0,0,,22,35,.629,31,65,96,6,10,24,15,61,104,3.6
671,Matthew Moss\matthew-moss-1,2014-15,McNeese State,C,31,10,425,38,107,.355,21,43,.488,17,64,.266,11,17,.647,19,32,51,6,12,4,14,89,104,1.1
672,Darius Lewis\darius-lewis-1,2016-17,Duquesne,C,30,11,420,42,80,.525,42,80,.525,0,0,,20,33,.606,36,102,138,16,7,28,37,76,104,2.9
673,Mark Laros\mark-laros-1,2017-18,Southeast Missouri State,C,27,9,405,48,76,.632,48,72,.667,0,4,.000,7,15,.467,40,54,94,9,8,11,28,36,103,3.3
674,Mike Thorne\mike-thorne-1,2015-16,Illinois,C,8,7,171,35,74,.473,35,74,.473,0,0,,33,55,.600,24,44,68,2,2,5,10,18,103,9.5
675,Michael Byron\michael-byron-1,2013-14,Gardner-Webb,C,33,32,478,43,73,.589,43,73,.589,0,0,,16,30,.533,43,68,111,9,13,33,26,45,102,3.4
676,Josh Sharma\josh-sharma-1,2016-17,Stanford,C,31,0,416,41,105,.390,35,83,.422,6,22,.273,13,29,.448,25,64,89,4,8,34,22,80,101,1.8
677,Kenyatta Smith\kenyatta-smith-1,2014-15,Harvard,C,23,12,292,41,72,.569,41,72,.569,0,0,,18,28,.643,15,43,58,5,6,27,20,42,100,3.3
678,Ido Flaisher\ido-flaisher-1,2016-17,Hawaii,C,30,0,318,39,71,.549,39,71,.549,0,0,,22,36,.611,36,51,87,6,3,8,27,66,100,2.0
679,Chris Brady\chris-brady-1,2013-14,Monmouth,C,32,13,430,42,99,.424,42,99,.424,0,0,,16,32,.500,41,52,93,8,3,28,30,54,100,1.9
680,Pete Rakocevic\pete-rakocevic-1,2013-14,Northern Illinois,C,31,5,411,39,88,.443,38,77,.494,1,11,.091,21,33,.636,27,35,62,10,5,18,33,71,100,1.3
681,Jacob Larsen\jacob-larsen-1,2017-18,Gonzaga,C,34,1,289,36,55,.655,36,55,.655,0,0,,28,42,.667,31,60,91,17,4,15,26,37,100,2.8
682,Sam Alabakis\sam-alabakis-1,2017-18,Louisiana-Monroe,C,31,27,619,38,67,.567,38,67,.567,0,0,,23,39,.590,26,68,94,0,6,6,37,85,99,1.2
683,Yankuba Sima\yankuba-sima-1,2017-18,Oklahoma State,C,27,8,395,41,82,.500,41,81,.506,0,1,.000,17,40,.425,39,44,83,9,13,29,32,67,99,2.6
684,Ifeanyi Onyekaba\ifeanyi-onyekaba-1,2013-14,Rhode Island,C,31,13,382,33,64,.516,33,64,.516,0,0,,32,59,.542,47,53,100,2,7,16,26,86,98,2.1
685,Tyler McCullough\tyler-mccullough-1,2013-14,Missouri State,C,28,20,404,39,75,.520,39,75,.520,0,0,,20,32,.625,22,49,71,10,6,24,23,56,98,2.5
686,Emmanuel Ndumanya\emmanuel-ndumanya-1,2016-17,Santa Clara,C,26,24,649,36,64,.563,36,64,.563,0,0,,26,47,.553,50,107,157,6,28,11,46,90,98,3.2
687,Michael Bradley\michael-bradley-2,2013-14,Samford,C,28,9,335,39,80,.488,39,79,.494,0,1,.000,20,27,.741,30,71,101,5,1,7,22,64,98,2.1
688,Emondre Rickman\emondre-rickman-1,2016-17,Indiana State,C,30,8,301,43,83,.518,43,83,.518,0,0,,11,23,.478,17,61,78,6,7,36,18,36,97,2.9
689,Trey McDonald\trey-mcdonald-1,2014-15,Ohio State,C,35,0,411,40,74,.541,40,74,.541,0,0,,17,33,.515,41,51,92,8,7,18,17,52,97,2.5
690,Darcy Malone\darcy-malone-1,2016-17,Cal State Fullerton,C,32,24,425,28,60,.467,23,47,.489,5,13,.385,36,51,.706,32,43,75,13,4,17,24,67,97,2.2
691,Olivier Sarr\olivier-sarr-1,2017-18,Wake Forest,C,30,0,453,32,92,.348,26,68,.382,6,24,.250,27,45,.600,30,59,89,11,10,21,32,76,97,1.6
692,Vladimir Pinchuk\vladimir-pinchuk-1,2017-18,New Mexico,C,31,14,441,37,61,.607,37,61,.607,0,0,,22,46,.478,27,51,78,6,2,12,16,57,96,2.2
693,John Crnogorac\john-crnogorac-1,2017-18,Texas-Rio Grande Valley,C,29,6,295,43,84,.512,43,82,.524,0,2,.000,10,17,.588,16,35,51,6,5,20,19,40,96,2.1
694,Joel Vander Pol\joel-vander-pol-1,2013-14,Liberty,C,32,7,369,37,68,.544,37,68,.544,0,0,,22,33,.667,23,72,95,7,7,15,31,61,96,2.0
695,AJ West\aj-west-1,2015-16,Nevada,C,10,6,237,31,68,.456,31,68,.456,0,0,,34,45,.756,43,34,77,6,7,18,22,18,96,9.1
696,Avibakuro Preh\avibakuro-preh-1,2013-14,Idaho State,C,29,28,713,39,55,.709,39,55,.709,0,0,,18,33,.545,52,80,132,13,21,35,26,96,96,4.1
697,Abdul Ahmed\abdul-ahmed-2,2013-14,Cal State Bakersfield,C,25,11,364,35,102,.343,23,68,.338,12,34,.353,14,21,.667,27,39,66,8,7,6,26,45,96,1.6
698,Ajak Magot\ajak-magot-1,2014-15,Idaho State,C,30,29,514,41,86,.477,41,85,.482,0,1,.000,13,24,.542,37,38,75,9,11,20,20,66,95,2.3
699,Shaquille Cleare\shaquille-cleare-1,2013-14,Maryland,C,32,20,440,39,69,.565,39,69,.565,0,0,,17,29,.586,28,51,79,8,8,14,22,70,95,2.1
700,Tim Thomas\tim-thomas-2,2013-14,Pacific,C,34,0,313,40,85,.471,40,84,.476,0,1,.000,14,25,.560,32,39,71,11,4,10,21,51,94,1.7
701,Kadeem Coleby\kadeem-coleby-1,2013-14,Wichita State,C,36,19,463,38,84,.452,38,84,.452,0,0,,18,36,.500,32,68,100,6,3,45,23,78,94,2.0
702,Tobias Sjoberg\tobias-sjoberg-1,2016-17,Marist,C,30,18,531,41,66,.621,41,66,.621,0,0,,12,22,.545,35,60,95,24,4,33,35,104,94,2.3
703,Brad Brechting\brad-brechting-1,2016-17,Oakland,C,31,5,296,33,62,.532,33,61,.541,0,1,.000,28,39,.718,23,62,85,8,16,23,24,55,94,2.8
704,Radwan Bakkali\radwan-bakkali-1,2017-18,Jacksonville,C,28,12,304,35,82,.427,33,77,.429,2,5,.400,22,28,.786,23,44,67,11,3,3,34,41,94,1.4
705,Evan Wieck\evan-wieck-1,2016-17,Navy,C,32,12,402,41,68,.603,41,67,.612,0,1,.000,12,24,.500,44,25,69,6,12,5,18,57,94,2.4
706,Brad Greene\brad-greene-1,2016-17,UC-Irvine,C,35,1,310,39,66,.591,39,66,.591,0,0,,16,27,.593,35,71,106,9,6,17,26,76,94,2.1
707,J.J. N'Ganga\jj-nganga-1,2014-15,New Mexico,C,29,0,344,36,61,.590,36,61,.590,0,0,,22,36,.611,18,30,48,6,1,5,31,54,94,1.3
708,Jaleel Cousins\jaleel-cousins-1,2014-15,South Florida,C,32,8,367,32,68,.471,32,68,.471,0,0,,29,67,.433,32,51,83,3,4,23,37,77,93,1.1
709,Jordan Railey\jordan-railey-1,2013-14,Washington State,C,31,25,503,38,97,.392,38,96,.396,0,1,.000,17,48,.354,34,45,79,26,11,30,30,77,93,1.8
710,Tomas Bruha\tomas-bruha-1,2013-14,Tulane,C,33,15,394,38,66,.576,38,66,.576,0,0,,17,34,.500,35,44,79,5,5,12,27,58,93,1.8
711,Kyle Sikora\kyle-sikora-1,2014-15,Stetson,C,28,26,505,38,72,.528,38,72,.528,0,0,,17,34,.500,22,80,102,4,7,15,29,52,93,2.2
712,Richard Peters\richard-peters-1,2015-16,Albany (NY),C,31,3,378,40,68,.588,40,68,.588,0,0,,13,22,.591,37,62,99,7,5,8,26,48,93,2.3
713,Darius Bolstad\darius-bolstad-1,2015-16,Radford,C,31,1,298,39,65,.600,39,65,.600,0,0,,14,25,.560,36,55,91,11,4,16,22,48,92,2.6
714,Elliott Eliason\eliott-eliason-1,2014-15,Minnesota,C,31,1,346,37,59,.627,37,59,.627,0,0,,18,40,.450,42,50,92,15,9,16,13,50,92,3.2
715,Nolan Berry\nolan-berry-1,2015-16,UC-Davis,C,10,0,175,26,55,.473,17,36,.472,9,19,.474,31,39,.795,4,36,40,6,8,2,14,25,92,6.4
716,L'Hassane Niangane\lhassane-niangane-1,2015-16,Gardner-Webb,C,33,23,557,31,66,.470,31,66,.470,0,0,,30,51,.588,71,80,151,12,11,37,35,103,92,2.8
717,Jayson Cheesman\jayson-cheesman-1,2013-14,Southern Utah,C,28,9,347,33,100,.330,33,100,.330,0,0,,26,43,.605,11,44,55,12,5,24,34,56,92,0.8
718,Nysier Brooks\nysier-brooks-1,2017-18,Cincinnati,C,35,2,340,38,77,.494,38,77,.494,0,0,,16,29,.552,32,49,81,8,12,20,22,54,92,2.1
719,Daniel Amigo\daniel-amigo-1,2014-15,Denver,C,15,15,234,36,78,.462,36,76,.474,0,2,.000,19,26,.731,9,13,22,17,8,11,27,57,91,2.4
720,Damion Moore\damion-moore-1,2017-18,Temple,C,26,0,246,38,67,.567,38,67,.567,0,0,,15,33,.455,24,26,50,2,5,6,11,27,91,2.5
721,Mike Samuels\mike-samuels-1,2014-15,Eastern Michigan,C,34,23,385,32,60,.533,32,60,.533,0,0,,27,42,.643,42,79,121,7,14,15,27,96,91,2.1
722,Jordan Dickerson\jordan-dickerson-2,2014-15,Penn State,C,34,19,582,33,68,.485,33,67,.493,0,1,.000,24,40,.600,42,71,113,9,10,53,23,105,90,2.6
723,Michael Ojo\michael-ojo-2,2013-14,Florida State,C,36,14,428,35,64,.547,35,64,.547,0,0,,20,47,.426,36,72,108,9,5,25,32,72,90,1.8
724,Novak Topalovic\novak-topalovic-1,2015-16,Idaho State,C,31,4,428,34,75,.453,34,75,.453,0,0,,22,43,.512,44,82,126,8,10,23,20,74,90,2.6
725,Paschal Chukwu\paschal-chukwu-1,2014-15,Providence,C,34,3,335,33,50,.660,33,50,.660,0,0,,24,40,.600,33,50,83,5,9,23,19,63,90,2.5
726,Grant Verhoeven\grant-verhoeven-1,2015-16,Stanford,C,27,11,399,32,73,.438,27,64,.422,5,9,.556,21,32,.656,29,26,55,6,11,13,12,78,90,2.1
727,Djery Baptiste\djery-baptiste-1,2017-18,Vanderbilt,C,29,10,442,30,66,.455,30,66,.455,0,0,,30,41,.732,34,69,103,5,7,26,24,74,90,2.4
728,Jordan Dickerson\jordan-dickerson-2,2015-16,Penn State,C,32,24,581,34,63,.540,34,63,.540,0,0,,22,41,.537,46,65,111,13,10,51,22,95,90,3.1
729,Zach Pirog\zach-pirog-1,2016-17,Omaha,C,31,21,311,38,65,.585,38,65,.585,0,0,,13,27,.481,32,47,79,3,6,28,14,78,89,2.3
730,David Onuorah\david-onuorah-1,2013-14,Cornell,C,28,22,513,37,68,.544,37,68,.544,0,0,,14,31,.452,59,48,107,7,15,28,25,86,88,3.0
731,Erik Poulsen\erik-poulsen-1,2017-18,San Francisco,C,25,0,225,32,95,.337,20,43,.465,12,52,.231,12,22,.545,17,30,47,7,3,5,15,36,88,1.3
732,Jarid Watson\jarid-watson-1,2014-15,Virginia Military Institute,C,30,8,372,38,69,.551,38,69,.551,0,0,,12,29,.414,43,48,91,14,8,26,13,58,88,3.1
733,Tom Koopman\tom-koopman-1,2013-14,Citadel,C,32,17,405,39,84,.464,39,83,.470,0,1,.000,10,17,.588,31,48,79,14,2,7,22,79,88,1.3
734,Valentine Izundu\valentine-izundu-1,2015-16,Washington State,C,23,13,342,36,56,.643,36,56,.643,0,0,,15,34,.441,27,34,61,6,6,50,19,52,87,3.9
735,Andrew Fishler\andrew-fishler-1,2015-16,Mercer,C,31,6,239,33,69,.478,33,69,.478,0,0,,21,35,.600,18,40,58,2,2,23,16,33,87,2.0
736,Andrew Fishler\andrew-fishler-1,2016-17,Mercer,C,30,2,266,36,65,.554,36,65,.554,0,0,,15,30,.500,20,36,56,5,1,23,9,36,87,2.4
737,Darius Harper\darius-harper-1,2016-17,Miami (OH),C,30,14,360,39,89,.438,39,89,.438,0,0,,9,29,.310,21,43,64,2,7,8,31,54,87,0.7
738,Hooper Vint\hooper-vint-1,2014-15,Texas-El Paso,C,30,1,364,38,75,.507,33,54,.611,5,21,.238,6,19,.316,23,40,63,13,0,15,11,51,87,2.0
739,Marshall Plumlee\marshall-plumlee-1,2014-15,Duke,C,39,0,375,32,42,.762,31,41,.756,1,1,1.000,22,31,.710,39,53,92,12,8,22,14,58,87,2.7
740,Isaiah Robinson\isaiah-robinson-1,2015-16,Houston Baptist,C,27,1,351,37,60,.617,37,59,.627,0,1,.000,13,23,.565,27,72,99,20,8,54,13,51,87,4.5
741,Cody Stetler\cody-stetler-1,2014-15,Houston Baptist,C,24,0,235,31,68,.456,30,62,.484,1,6,.167,23,33,.697,19,34,53,13,5,16,21,44,86,2.4
742,Pete Rakocevic\pete-rakocevic-1,2014-15,Northern Illinois,C,23,6,348,34,81,.420,34,71,.479,0,10,.000,18,23,.783,18,51,69,12,5,12,25,48,86,2.0
743,Javon Baumann\javon-baumann-1,2016-17,Saint Joseph's,C,30,0,394,35,55,.636,35,55,.636,0,0,,15,41,.366,50,57,107,1,9,22,17,52,85,3.0
744,Darnell Tillman\darnell-tillman-1,2015-16,Missouri-Kansas City,C,31,7,381,35,63,.556,35,63,.556,0,0,,15,28,.536,45,49,94,4,9,16,21,65,85,2.3
745,Dan Robinson\dan-robinson-2,2017-18,Norfolk State,C,29,14,394,31,72,.431,31,72,.431,0,0,,23,40,.575,39,55,94,7,2,21,35,75,85,1.4
746,Kennedy Esume\kennedy-esume-1,2015-16,Cal State Fullerton,C,30,17,529,31,91,.341,31,91,.341,0,0,,23,43,.535,62,98,160,9,14,9,23,68,85,2.5
747,Daouda Ndiaye\daouda-ndiaye-1,2017-18,Illinois State,C,20,15,361,35,66,.530,35,66,.530,0,0,,15,22,.682,27,52,79,8,11,25,11,45,85,4.5
748,Jordan Stone\jordan-stone-1,2013-14,Utah State,C,32,5,381,31,51,.608,31,51,.608,0,0,,23,35,.657,40,49,89,6,9,6,30,63,85,1.9
749,Ray Barreno\ray-barreno-1,2016-17,Portland,C,26,4,373,29,58,.500,29,58,.500,0,0,,26,36,.722,42,71,113,12,2,12,30,67,84,2.5
750,Oliver Ellison\oliver-ellison-1,2013-14,Howard,C,30,17,648,33,61,.541,33,61,.541,0,0,,18,37,.486,49,87,136,11,14,40,27,104,84,2.9
751,Zach Moer\zach-moer-1,2014-15,Air Force,C,30,0,259,33,65,.508,28,55,.509,5,10,.500,12,15,.800,18,30,48,12,7,16,28,53,83,1.6
752,Selvedin Planincic\selvedin-planincic-1,2016-17,Canisius,C,27,0,237,29,47,.617,27,38,.711,2,9,.222,23,34,.676,15,37,52,7,2,24,21,49,83,2.3
753,Kameron Rooks\kameron-rooks-1,2017-18,San Diego State,C,28,12,309,34,58,.586,34,58,.586,0,0,,15,29,.517,45,50,95,7,6,21,12,35,83,3.4
754,George Brammeier\george-brammeier-1,2017-18,Lipscomb,C,33,1,265,35,68,.515,35,68,.515,0,0,,13,31,.419,23,29,52,4,12,3,22,51,83,1.3
755,Sami Eleraky\sami-eleraky-1,2014-15,Pacific,C,23,17,401,30,62,.484,30,62,.484,0,0,,23,62,.371,33,59,92,12,2,25,28,53,83,2.4
756,Austin Venable\austin-venable-1,2016-17,Presbyterian,C,25,8,319,38,74,.514,38,74,.514,0,0,,6,12,.500,19,45,64,7,5,13,19,45,82,2.1
757,John Manning\john-manning-1,2013-14,Saint Louis,C,32,0,382,32,62,.516,31,58,.534,1,4,.250,16,31,.516,19,31,50,7,10,33,18,54,81,2.0
758,Joniah White\joniah-white-1,2017-18,Louisiana Tech,C,20,20,338,30,58,.517,30,58,.517,0,0,,21,33,.636,35,48,83,10,5,26,23,40,81,3.9
759,Ryan Edwards\ryan-edwards-1,2015-16,Gonzaga,C,31,0,270,28,57,.491,28,56,.500,0,1,.000,25,36,.694,29,40,69,4,1,8,19,54,81,1.6
760,Sukhmail Mathon\sukhmail-mathon-1,2017-18,Boston University,C,31,0,355,36,79,.456,36,79,.456,0,0,,9,18,.500,31,60,91,24,4,10,33,45,81,1.7
761,Josh Coleman\josh-coleman-1,2016-17,Coastal Carolina,C,29,12,329,35,63,.556,35,62,.565,0,1,.000,11,23,.478,37,44,81,2,3,9,17,53,81,2.0
762,Filip Nowicki\filip-nowicki-1,2014-15,Sacred Heart,C,29,11,322,38,69,.551,38,69,.551,0,0,,5,8,.625,33,53,86,4,2,12,22,48,81,2.0
763,Doral Moore\doral-moore-1,2016-17,Wake Forest,C,31,0,258,32,61,.525,32,61,.525,0,0,,16,30,.533,25,44,69,1,2,27,24,62,80,1.5
764,Andrew Bastien\andrew-bastien-1,2015-16,Utah Valley,C,26,23,349,28,63,.444,28,63,.444,0,0,,24,40,.600,39,71,110,6,5,33,18,65,80,3.0
765,Ryan Smith\ryan-smith-2,2015-16,Tulane,C,33,23,359,30,61,.492,30,61,.492,0,0,,20,33,.606,43,32,75,7,8,13,12,55,80,2.2
766,Isaiah Anderson\isaiah-anderson-1,2017-18,South Carolina Upstate,C,27,3,303,35,71,.493,33,64,.516,2,7,.286,8,17,.471,26,41,67,10,10,9,14,40,80,2.4
767,Jordan Prosser\jordan-prosser-1,2013-14,Bradley,C,26,3,398,32,65,.492,32,65,.492,0,0,,15,28,.536,28,48,76,7,4,11,11,51,79,2.3
768,Maverick Morgan\maverick-morgan-1,2014-15,Illinois,C,31,0,275,30,66,.455,30,66,.455,0,0,,19,23,.826,26,22,48,3,3,11,14,33,79,1.7
769,Nysier Brooks\nysier-brooks-1,2016-17,Cincinnati,C,33,0,279,28,53,.528,28,53,.528,0,0,,23,40,.575,20,33,53,2,3,22,19,55,79,1.5
770,Dominic Nelson\dominic-nelson-1,2015-16,Southeastern Louisiana,C,30,16,456,26,59,.441,26,59,.441,0,0,,27,62,.435,42,77,119,2,7,19,33,69,79,1.6
771,Earl Watson\earl-watson-2,2014-15,Rhode Island,C,31,0,307,31,54,.574,31,54,.574,0,0,,17,34,.500,32,50,82,6,3,27,15,55,79,2.4
772,Pierre Crawford\pierre-crawford-1,2013-14,Florida A&M,C,25,0,225,35,80,.438,35,80,.438,0,0,,9,20,.450,32,38,70,5,4,2,18,52,79,1.5
773,Oliver Ellison\oliver-ellison-1,2014-15,Howard,C,30,0,565,34,55,.618,34,55,.618,0,0,,11,30,.367,37,69,106,3,9,35,23,67,79,2.6
774,Damion Moore\damion-moore-1,2016-17,Temple,C,20,8,219,33,65,.508,32,64,.500,1,1,1.000,11,13,.846,18,37,55,2,4,12,12,28,78,3.0
775,Joe Kammerer\joe-kammerer-1,2013-14,Idaho,C,34,28,585,36,71,.507,36,71,.507,0,0,,6,15,.400,28,44,72,12,4,10,23,68,78,1.2
776,Ike Obiagu\ike-obiagu-1,2017-18,Florida State,C,34,14,364,33,57,.579,33,57,.579,0,0,,12,38,.316,33,54,87,2,7,71,25,60,78,2.6
777,Andrew Drone\andrew-drone-1,2016-17,Rice,C,30,3,227,30,41,.732,30,41,.732,0,0,,18,33,.545,18,22,40,6,5,14,18,42,78,2.0
778,Riley Barker\riley-barker-1,2014-15,Portland,C,16,2,302,30,65,.462,30,63,.476,0,2,.000,17,27,.630,38,43,81,8,14,15,16,38,77,4.9
779,Nate Wells\nate-wells-1,2014-15,Bradley,C,26,8,301,34,78,.436,31,64,.484,3,14,.214,6,10,.600,16,24,40,8,7,19,11,39,77,2.0
780,Seth Adelsperger\seth-adelsperger-1,2017-18,Belmont,C,30,13,290,33,55,.600,33,55,.600,0,0,,11,22,.500,15,37,52,5,1,7,15,45,77,1.5
781,Tyler Bergantino\tyler-bergantino-1,2015-16,Massachusetts,C,29,18,541,35,53,.660,35,53,.660,0,0,,7,15,.467,35,65,100,9,9,26,9,59,77,3.3
782,Moataz Aly\moataz-aly-1,2016-17,Cal State Bakersfield,C,31,13,380,31,48,.646,31,48,.646,0,0,,14,33,.424,37,44,81,9,9,54,26,80,76,2.6
783,Brandon Gilbeck\brandon-gilbeck-1,2015-16,Western Illinois,C,27,18,393,35,79,.443,35,79,.443,0,0,,6,16,.375,30,68,98,18,5,22,24,76,76,1.9
784,Eric Truog\eric-truog-1,2015-16,Marist,C,29,18,561,34,87,.391,32,78,.410,2,9,.222,6,16,.375,46,96,142,62,12,19,35,78,76,3.0
785,Nate Gehring\nate-gehring-1,2016-17,Pepperdine,C,27,5,300,33,55,.600,33,55,.600,0,0,,10,24,.417,20,50,70,7,5,11,21,41,76,2.0
786,Valentine Izundu\valentine-izundu-1,2016-17,San Diego State,C,30,9,508,32,52,.615,32,52,.615,0,0,,12,30,.400,52,48,100,4,5,53,16,68,76,3.3
787,Julian Torres\julian-torres-1,2015-16,Illinois-Chicago,C,28,2,268,28,67,.418,28,67,.418,0,0,,20,32,.625,27,40,67,8,4,14,21,64,76,1.4
788,Ryan Canty\ryan-canty-1,2013-14,Fordham,C,25,6,374,28,55,.509,28,55,.509,0,0,,20,33,.606,56,99,155,3,6,26,8,61,76,4.3
789,Marcel Boyd\marcel-boyd-1,2014-15,Howard,C,31,29,553,28,65,.431,28,65,.431,0,0,,19,36,.528,54,86,140,10,8,32,37,83,75,2.1
790,Ugur Hortum\ugur-hortum-1,2015-16,Grambling,C,27,10,410,26,78,.333,20,58,.345,6,20,.300,17,27,.630,16,53,69,11,5,4,26,49,75,0.9
791,Jacob Epperson\jacob-epperson-1,2017-18,Creighton,C,12,0,168,34,49,.694,30,45,.667,4,4,1.000,3,9,.333,6,29,35,3,2,11,6,18,75,5.3
792,Jake Giesler\jake-giesler-1,2014-15,Northern Kentucky,C,28,22,366,31,68,.456,31,60,.517,0,8,.000,12,26,.462,26,58,84,13,7,13,17,54,74,2.0
793,Richmond Aririguzoh\richmond-aririguzoh-1,2017-18,Princeton,C,27,4,247,31,52,.596,31,52,.596,0,0,,12,29,.414,19,26,45,20,1,14,24,30,74,2.0
794,Link Kabadyundi\link-kabadyundi-1,2017-18,Texas-Arlington,C,26,2,261,30,40,.750,30,40,.750,0,0,,14,34,.412,19,51,70,3,5,7,15,51,74,2.1
795,Gligorije Rakocevic\gligorije-rakocevic-1,2017-18,Oregon State,C,27,0,285,29,57,.509,29,56,.518,0,1,.000,16,28,.571,23,36,59,7,6,2,19,51,74,1.5
796,Matt Heldt\max-heldt-1,2016-17,Marquette,C,32,7,418,28,40,.700,28,40,.700,0,0,,18,32,.563,41,53,94,6,6,13,10,66,74,2.5
797,Kevin Allen\kevin-allen-1,2014-15,Boise State,C,21,3,164,30,47,.638,30,47,.638,0,0,,14,23,.609,10,26,36,1,2,1,11,29,74,2.1
798,Legend Robertin\legend-robertin-1,2017-18,Nicholls State,C,32,6,301,30,55,.545,30,54,.556,0,1,.000,14,26,.538,25,43,68,1,1,38,23,67,74,1.6
799,Ryan Smith\ryan-smith-2,2014-15,Tulane,C,31,27,320,32,64,.500,32,63,.508,0,1,.000,9,22,.409,24,42,66,2,5,11,22,60,73,1.1
800,L'Hassane Niangane\lhassane-niangane-1,2016-17,Gardner-Webb,C,33,32,475,27,57,.474,27,57,.474,0,0,,19,37,.514,61,56,117,16,7,33,30,92,73,2.1
801,Richard Peters\richard-peters-1,2014-15,Albany (NY),C,31,23,339,31,52,.596,31,52,.596,0,0,,10,21,.476,21,49,70,4,5,7,19,46,72,1.6
802,Bryan Gellineau\bryan-gellineau-1,2016-17,Norfolk State,C,23,4,238,29,45,.644,29,45,.644,0,0,,14,26,.538,25,40,65,1,5,9,23,61,72,1.8
803,Nikola Scekic\nikola-scekic-1,2017-18,South Florida,C,32,30,496,31,83,.373,28,77,.364,3,6,.500,7,17,.412,30,52,82,4,0,17,21,66,72,0.8
804,Devon Long\devon-long-1,2013-14,Cleveland State,C,32,8,385,32,63,.508,32,63,.508,0,0,,8,16,.500,32,22,54,9,5,4,18,65,72,1.1
805,Tom Koopman\tom-koopman-1,2016-17,Citadel,C,32,1,263,30,71,.423,26,58,.448,4,13,.308,7,11,.636,18,29,47,10,11,6,16,51,71,1.2
806,Kyle Sikora\kyle-sikora-1,2013-14,Stetson,C,30,8,390,31,52,.596,31,52,.596,0,0,,9,22,.409,26,50,76,2,6,17,30,50,71,1.5
807,Christian Mackey\christian-mackey-1,2014-15,Denver,C,25,1,265,28,43,.651,27,39,.692,1,4,.250,14,18,.778,14,31,45,25,1,8,18,58,71,2.1
808,Michael Ojo\michael-ojo-2,2014-15,Florida State,C,33,21,292,27,51,.529,27,51,.529,0,0,,17,44,.386,24,54,78,6,5,16,28,44,71,1.3
809,Thaddeus Smith\thaddeus-smith-1,2014-15,Missouri-Kansas City,C,30,21,525,29,64,.453,29,64,.453,0,0,,13,29,.448,60,72,132,3,19,44,30,78,71,2.9
810,Emondre Rickman\emondre-rickman-1,2015-16,Indiana State,C,30,2,362,26,56,.464,26,56,.464,0,0,,19,40,.475,34,53,87,6,5,24,9,49,71,2.4
811,David Wishon\david-wishon-1,2013-14,College of Charleston,C,30,0,377,27,63,.429,27,63,.429,0,0,,17,29,.586,33,49,82,6,2,20,33,49,71,1.3
812,Trey McDonald\trey-mcdonald-1,2013-14,Ohio State,C,35,0,423,29,55,.527,29,55,.527,0,0,,13,39,.333,31,27,58,5,7,19,20,70,71,1.1
813,Prince Ibeh\prince-ibeh-1,2014-15,Texas,C,34,2,359,29,49,.592,29,49,.592,0,0,,12,32,.375,23,62,85,6,11,47,22,68,70,2.1
814,Sergej Vucetic\sergej-vucetic-1,2016-17,Evansville,C,24,10,267,23,53,.434,23,53,.434,0,0,,24,34,.706,14,36,50,5,1,13,24,42,70,1.3
815,Ryan Gomes\ryan-gomes-2,2016-17,Mount St. Mary's,C,32,1,210,33,54,.611,33,53,.623,0,1,.000,4,10,.400,14,18,32,1,2,7,10,43,70,1.2
816,Malcolm Gilbert\malcolm-gilbert-1,2013-14,Fairfield,C,28,5,285,32,66,.485,32,66,.485,0,0,,6,17,.353,25,51,76,5,5,36,13,61,70,2.2
817,Ivo Basor\ivo-basor-1,2014-15,San Jose State,C,25,14,485,27,61,.443,24,51,.471,3,10,.300,13,29,.448,39,56,95,9,6,4,26,62,70,1.6
818,Zach Garber\zach-garber-1,2014-15,Toledo,C,33,0,423,14,45,.311,14,40,.350,0,5,.000,42,58,.724,34,46,80,6,5,8,14,74,70,1.4
819,Andy Martin\andy-martin-1,2013-14,Montana,C,30,9,303,26,52,.500,26,52,.500,0,0,,18,24,.750,22,41,63,7,6,18,15,70,70,1.7
820,Darrius Parker\darrius-parker-1,2013-14,Air Force,C,18,3,238,24,39,.615,22,32,.688,2,7,.286,19,32,.594,14,24,38,13,4,6,12,27,69,3.2
821,Emmanuel Okoroba\emmanuel-okoroba-1,2014-15,Hampton,C,26,2,294,19,60,.317,19,60,.317,0,0,,31,57,.544,20,41,61,10,4,9,26,62,69,0.7
822,Matthew Moss\matthew-moss-1,2015-16,McNeese State,C,28,0,195,25,57,.439,9,17,.529,16,40,.400,3,5,.600,11,28,39,9,2,3,10,36,69,1.4
823,Cody Stetler\cody-stetler-1,2016-17,Houston Baptist,C,29,2,277,26,66,.394,26,63,.413,0,3,.000,16,24,.667,21,38,59,18,6,9,16,52,68,1.5
824,Robin Jorch\robin-jorch-1,2016-17,Boise State,C,30,3,264,22,36,.611,22,36,.611,0,0,,24,38,.632,32,23,55,2,5,3,11,56,68,1.7
825,Dalen Traore\dalen-traore-1,2017-18,Evansville,C,30,14,371,17,47,.362,17,46,.370,0,1,.000,34,45,.756,29,52,81,6,5,3,14,57,68,1.6
826,Dwight Coleby\dwight-coleby-1,2013-14,Mississippi,C,29,4,291,24,51,.471,24,51,.471,0,0,,20,38,.526,24,28,52,7,1,18,13,50,68,1.6
827,Tom Koopman\tom-koopman-1,2015-16,Citadel,C,31,4,248,30,53,.566,30,50,.600,0,3,.000,7,12,.583,18,31,49,2,4,12,10,52,67,1.4
828,Tanveer Bhullar\tanveer-bhullar-1,2017-18,Missouri State,C,24,1,201,30,70,.429,30,69,.435,0,1,.000,7,15,.467,22,31,53,14,5,8,20,37,67,1.5
829,E.J. Datcher\ej-datcher-1,2017-18,Mississippi State,C,30,1,236,25,42,.595,25,42,.595,0,0,,17,24,.708,17,34,51,4,3,8,12,45,67,1.6
830,Aaron Geramipoor\aaron-geramipoor-1,2013-14,Seton Hall,C,30,5,306,30,43,.698,30,43,.698,0,0,,6,12,.500,14,42,56,4,6,11,8,51,66,1.9
831,Rafael Maia\rafael-maia-1,2015-16,Pittsburgh,C,33,25,397,24,52,.462,24,51,.471,0,1,.000,18,31,.581,49,69,118,18,15,6,15,63,66,2.4
832,Levi Cook\levi-cook-1,2016-17,DePaul,C,25,0,273,29,48,.604,29,48,.604,0,0,,8,13,.615,26,32,58,3,1,10,21,45,66,1.6
833,Tyler Alderman\tyler-alderman-1,2013-14,Jacksonville,C,13,1,210,26,55,.473,26,54,.481,0,1,.000,14,22,.636,17,30,47,11,5,15,12,30,66,4.2
834,Andre Washington\andre-washington-1,2013-14,Wake Forest,C,29,1,229,24,49,.490,24,49,.490,0,0,,18,33,.545,22,30,52,5,3,39,11,39,66,2.3
835,Chad Lang\chad-lang-1,2013-14,Belmont,C,26,0,119,27,48,.563,27,48,.563,0,0,,12,26,.462,11,15,26,0,3,6,15,35,66,1.1
836,Mark Kostelac\mark-kostelac-1,2017-18,Akron,C,30,11,370,30,61,.492,30,61,.492,0,0,,6,12,.500,18,34,52,9,9,13,31,89,66,0.5
837,Justin McBride\justin-mcbride-1,2013-14,Central Florida,C,15,1,140,26,38,.684,26,38,.684,0,0,,14,26,.538,17,23,40,0,1,6,10,24,66,3.3
838,Jordan Dallas\jordan-dallas-1,2016-17,Weber State,C,28,1,255,22,42,.524,22,41,.537,0,1,.000,21,27,.778,17,40,57,1,3,13,9,50,65,1.8
839,Blaise Mbargorba\blaise-mbargorba-1,2014-15,Boston University,C,28,0,297,26,55,.473,26,55,.473,0,0,,13,19,.684,12,31,43,6,2,4,13,38,65,1.2
840,Matt Husek\matt-husek-1,2014-15,Holy Cross,C,22,16,196,27,75,.360,24,52,.462,3,23,.130,8,17,.471,10,15,25,2,8,15,5,25,65,1.6
841,Dylan Johns\dylan-johns-1,2016-17,Cal State Northridge,C,29,13,378,29,50,.580,29,50,.580,0,0,,7,13,.538,21,36,57,10,5,25,27,60,65,1.5
842,Tyler Hadden\tyler-hadden-1,2014-15,Belmont,C,27,3,150,22,54,.407,16,37,.432,6,17,.353,15,24,.625,7,23,30,4,0,3,11,24,65,1.1
843,Barret Benson\barret-benson-1,2016-17,Northwestern,C,32,8,255,26,44,.591,26,44,.591,0,0,,13,23,.565,21,30,51,12,9,19,11,50,65,2.0
844,Andrew Bastien\andrew-bastien-1,2016-17,Utah Valley,C,25,6,245,28,44,.636,28,44,.636,0,0,,8,16,.500,19,45,64,6,3,17,11,32,64,2.5
845,Emmanuel Ndumanya\emmanuel-ndumanya-1,2014-15,Santa Clara,C,23,0,267,27,56,.482,27,56,.482,0,0,,10,25,.400,27,52,79,4,9,7,13,53,64,2.0
846,Josh Warren\josh-warren-2,2013-14,Troy,C,31,6,389,26,56,.464,26,56,.464,0,0,,12,26,.462,57,80,137,6,8,15,10,59,64,2.7
847,Terrell Carter\terrell-carter-1,2014-15,Fresno State,C,18,3,196,23,49,.469,23,49,.469,0,0,,18,35,.514,18,18,36,0,0,4,12,34,64,1.5
848,JD Wallace\jd-wallace-1,2016-17,Prairie View,C,20,14,384,23,40,.575,23,39,.590,0,1,.000,17,30,.567,22,53,75,5,13,28,8,44,63,4.0
849,Ryan Salmonson\ryan-salmonson-1,2013-14,North Dakota,C,26,14,251,25,53,.472,25,51,.490,0,2,.000,13,18,.722,12,22,34,1,3,1,18,63,63,0.4
850,Sidy Djitte\sidy-djitte-1,2014-15,Clemson,C,30,1,331,22,48,.458,22,48,.458,0,0,,19,34,.559,48,47,95,4,11,17,14,66,63,2.2
851,Djery Baptiste\djery-baptiste-1,2016-17,Vanderbilt,C,35,2,274,25,48,.521,25,48,.521,0,0,,13,20,.650,25,40,65,1,4,14,24,59,63,0.9
852,Akolda Manyang\akolda-manyang-1,2015-16,Oklahoma,C,25,0,199,24,51,.471,24,51,.471,0,0,,15,24,.625,17,34,51,0,2,33,13,35,63,2.1
853,Cole Harrison\cole-harrison-1,2017-18,William & Mary,C,27,1,174,27,51,.529,27,51,.529,0,0,,9,13,.692,13,27,40,7,1,3,13,36,63,1.3
854,Cole Walton\cole-walton-1,2013-14,Sacred Heart,C,28,15,351,25,54,.463,25,54,.463,0,0,,12,24,.500,24,36,60,14,9,8,19,59,62,1.4
855,Matthew Pegram\matthew-pegram-1,2015-16,Wofford,C,30,0,244,25,54,.463,25,54,.463,0,0,,12,13,.923,13,26,39,2,2,11,12,60,62,0.9
856,Jonathan Barnes\jonathan-barnes-1,2015-16,Wyoming,C,29,23,300,21,42,.500,21,42,.500,0,0,,20,41,.488,14,34,48,6,3,6,12,39,62,1.3
857,Ibby Djimde\ibby-djimde-1,2015-16,Southern Illinois,C,31,6,276,25,52,.481,25,52,.481,0,0,,12,21,.571,26,30,56,10,8,3,18,60,62,1.1
858,Willy Kouassi\willy-kouassi-1,2015-16,Arkansas,C,31,2,255,21,36,.583,21,36,.583,0,0,,20,36,.556,25,35,60,1,3,19,10,41,62,1.9
859,Babatunde Olomuwiya\babatunde-olomuwiya-1,2013-14,South Carolina Upstate,C,22,0,201,26,44,.591,26,44,.591,0,0,,10,21,.476,18,24,42,7,2,11,14,22,62,2.2
860,Cody Johnson\cody-johnson-1,2013-14,Loyola (IL),C,23,8,193,25,52,.481,18,33,.545,7,19,.368,4,6,.667,9,29,38,5,0,10,10,25,61,1.7
861,Armel TeTe\amel-tete-1,2016-17,Presbyterian,C,30,8,337,25,56,.446,25,55,.455,0,1,.000,11,28,.393,24,46,70,9,5,15,30,51,61,0.9
862,David Onuorah\david-onuorah-1,2014-15,Cornell,C,30,29,569,25,56,.446,25,56,.446,0,0,,11,28,.393,51,53,104,10,15,45,36,80,61,2.1
863,Evan Maxwell\evan-maxwell-1,2014-15,Liberty,C,29,0,176,23,40,.575,23,40,.575,0,0,,15,26,.577,11,20,31,0,1,5,17,29,61,0.9
864,Blake Brumwell\blake-brumwell-1,2014-15,Montana State,C,30,23,464,26,51,.510,26,51,.510,0,0,,9,19,.474,37,63,100,7,2,3,24,67,61,1.2
865,Yankuba Sima\yankuba-sima-1,2016-17,St. John's (NY),C,10,8,178,21,47,.447,21,47,.447,0,0,,18,25,.720,13,22,35,6,4,5,10,24,60,4.1
866,Luke Piotrowski\luke-piotrowski-1,2015-16,Eastern Illinois,C,21,8,171,21,38,.553,21,38,.553,0,0,,18,24,.750,13,27,40,4,0,13,6,23,60,2.5
867,Benas Griciunas\benas-griciunas-1,2016-17,Charlotte,C,20,7,190,24,52,.462,23,49,.469,1,3,.333,11,16,.688,11,25,36,6,4,4,8,36,60,1.8
868,Kingsley Okoroh\kingsley-okorah-1,2014-15,University of California,C,30,3,394,24,52,.462,24,52,.462,0,0,,12,23,.522,29,37,66,8,8,28,21,59,60,1.6
869,Dana Batt\dana-batt-1,2015-16,Colgate,C,27,11,371,26,49,.531,26,49,.531,0,0,,7,12,.583,23,44,67,6,8,8,15,63,59,1.5
870,Blake Truman\blake-truman-1,2017-18,Idaho State,C,28,4,280,22,62,.355,13,32,.406,9,30,.300,6,8,.750,18,35,53,11,6,0,20,35,59,0.9
871,Mario Karailiev\mario-karailiev-1,2015-16,Florida A&M,C,26,17,345,26,54,.481,26,53,.491,0,1,.000,7,14,.500,12,32,44,5,6,3,22,41,59,0.8
872,Bryce Cashman\bryce-cashman-1,2014-15,North Dakota,C,23,4,313,23,41,.561,23,41,.561,0,0,,13,34,.382,24,40,64,6,4,12,22,52,59,1.5
873,Moses Abraham\moses-abraham-1,2013-14,Georgetown,C,31,1,406,22,39,.564,22,39,.564,0,0,,15,33,.455,22,66,88,9,7,23,17,84,59,1.5
874,Barret Benson\barret-benson-1,2017-18,Northwestern,C,32,1,306,21,38,.553,21,37,.568,0,1,.000,17,32,.531,22,48,70,14,7,18,18,68,59,1.5
875,Brad Brechting\brad-brechting-1,2015-16,Oakland,C,34,13,244,22,47,.468,22,47,.468,0,0,,15,27,.556,21,43,64,7,5,28,11,59,59,1.5
876,Tanveer Bhullar\tanveer-bhullar-1,2016-17,New Mexico State,C,22,0,155,24,46,.522,24,46,.522,0,0,,11,24,.458,20,30,50,5,0,10,12,25,59,1.9
877,Zach Garber\zach-garber-1,2013-14,Toledo,C,33,0,335,17,44,.386,16,43,.372,1,1,1.000,23,33,.697,31,33,64,6,5,7,16,49,58,1.2
878,John Cannon\john-cannon-1,2015-16,North Carolina-Asheville,C,17,1,109,25,41,.610,25,39,.641,0,2,.000,8,14,.571,10,16,26,2,2,10,6,14,58,2.8
879,Zach Garber\zach-garber-1,2016-17,Toledo,C,16,11,246,17,35,.486,17,35,.486,0,0,,24,37,.649,21,49,70,11,4,5,15,42,58,3.0
880,Baye Moussa Keita\baye-moussa-keita-1,2013-14,Syracuse,C,32,1,497,24,48,.500,24,48,.500,0,0,,10,18,.556,69,54,123,10,12,30,24,78,58,2.5
881,Chudier Pal\chudier-pal-1,2014-15,North Carolina-Asheville,C,19,12,195,24,40,.600,24,40,.600,0,0,,10,17,.588,19,33,52,16,4,17,10,32,58,3.4
882,Mattias Markusson\mattias-markusson-1,2016-17,Loyola Marymount,C,25,1,187,19,40,.475,19,39,.487,0,1,.000,19,27,.704,15,23,38,4,4,13,10,38,57,1.7
883,Ibby Djimde\ibby-djimde-1,2014-15,Southern Illinois,C,24,1,287,24,53,.453,24,53,.453,0,0,,9,15,.600,17,10,27,7,4,6,17,57,57,0.6
884,Frank Snow\frank-snow-1,2013-14,Southern,C,28,8,241,22,38,.579,22,38,.579,0,0,,13,24,.542,23,34,57,6,8,17,21,54,57,1.5
885,Mario Karailiev\mario-karailiev-1,2014-15,Florida A&M,C,29,13,443,26,55,.473,26,55,.473,0,0,,4,14,.286,24,39,63,3,3,14,32,50,56,0.5
886,Maricus Glenn\maricus-glenn-1,2017-18,Savannah State,C,32,30,313,21,41,.512,21,37,.568,0,4,.000,14,26,.538,29,38,67,12,9,9,24,70,56,1.1
887,Bakary Konate\bakary-konate-1,2014-15,Minnesota,C,25,0,222,19,35,.543,19,35,.543,0,0,,18,34,.529,18,34,52,6,10,10,16,39,56,1.8
888,Shikei Blake\shikei-blake-1,2015-16,Montana State,C,24,12,219,19,45,.422,19,45,.422,0,0,,18,24,.750,22,26,48,1,5,2,13,53,56,1.1
889,John Manning\john-manning-1,2014-15,Saint Louis,C,28,21,401,21,52,.404,21,51,.412,0,1,.000,14,18,.778,8,45,53,14,5,23,16,49,56,1.5
890,Austin Gillmann\austin-gillmann-1,2015-16,Saint Louis,C,16,14,280,19,48,.396,12,25,.480,7,23,.304,10,14,.714,9,21,30,14,6,11,11,41,55,2.3
891,Udoka Azubuike\udoka-azubuike-1,2016-17,Kansas,C,11,6,142,22,35,.629,22,35,.629,0,0,,11,29,.379,13,35,48,2,2,18,15,31,55,3.7
892,Elbert Robinson\elbert-robinson-1,2015-16,Louisiana State,C,23,7,213,22,43,.512,22,43,.512,0,0,,11,26,.423,20,27,47,7,2,6,19,46,55,1.0
893,Rauno Nurger\rauno-nurger-1,2014-15,Wichita State,C,24,0,212,18,38,.474,13,20,.650,5,18,.278,14,20,.700,8,20,28,4,3,9,8,29,55,1.6
894,Shaquille Doorson\shaquille-doorson-1,2017-18,Rutgers,C,30,4,362,20,32,.625,20,32,.625,0,0,,15,32,.469,40,46,86,10,4,18,12,41,55,2.4
895,Dana Batt\dana-batt-1,2016-17,Colgate,C,30,0,264,22,37,.595,22,37,.595,0,0,,11,15,.733,14,33,47,7,4,5,20,55,55,0.9
896,Konstantin Kulikov\konstantin-kulikov-1,2017-18,Incarnate Word,C,14,7,190,24,52,.462,24,50,.480,0,2,.000,7,11,.636,16,31,47,6,2,18,19,22,55,2.7
897,Jordan Foster\jordan-foster-2,2017-18,Lamar,C,23,0,203,21,25,.840,21,25,.840,0,0,,13,28,.464,17,40,57,2,1,22,19,53,55,1.8
898,Conor Voss\conor-voss-1,2016-17,Columbia,C,26,0,203,21,35,.600,21,35,.600,0,0,,12,21,.571,20,28,48,16,1,14,13,23,54,2.2
899,Andrew Zelis\andrew-zelis-1,2015-16,Northern Illinois,C,27,0,196,24,45,.533,24,45,.533,0,0,,6,17,.353,14,45,59,2,2,12,8,40,54,1.4
900,Josh Henderson\josh-henderson-1,2013-14,Vanderbilt,C,8,3,152,21,43,.488,21,43,.488,0,0,,11,17,.647,14,20,34,3,5,3,6,16,53,5.2
901,Zach Elcano\zach-elcano-1,2014-15,American,C,22,14,331,21,47,.447,21,47,.447,0,0,,11,22,.500,9,31,40,21,5,11,32,36,53,0.9
902,Bakary Konate\bakary-konate-1,2016-17,Minnesota,C,33,1,320,19,41,.463,19,40,.475,0,1,.000,15,24,.625,29,62,91,3,8,25,18,73,53,1.4
903,Justice Green\justice-green-1,2017-18,Eastern Illinois,C,21,0,137,20,48,.417,11,18,.611,9,30,.300,4,8,.500,1,17,18,5,9,2,3,9,53,1.9
904,Jake Giesler\jake-giesler-1,2015-16,Northern Kentucky,C,30,0,213,22,44,.500,22,44,.500,0,0,,9,18,.500,17,32,49,8,7,5,13,44,53,1.1
905,James Banks\james-banks-2,2016-17,Texas,C,32,0,397,22,52,.423,22,52,.423,0,0,,9,15,.600,23,58,81,7,8,39,28,59,53,1.4
906,Philipp Hartwich\philipp-hartwich-1,2016-17,Portland,C,30,26,517,20,39,.513,20,39,.513,0,0,,13,31,.419,50,101,151,13,8,48,34,82,53,2.5
907,Maverick Morgan\maverick-morgan-1,2013-14,Illinois,C,35,0,250,21,36,.583,21,36,.583,0,0,,10,15,.667,20,23,43,3,3,8,13,45,52,1.0
908,Josh Henderson\josh-henderson-1,2014-15,Vanderbilt,C,24,2,175,22,44,.500,22,42,.524,0,2,.000,8,13,.615,13,16,29,3,2,2,8,24,52,1.2
909,Tanner Giddings\tanner-giddings-1,2013-14,Fresno State,C,28,0,402,23,53,.434,23,51,.451,0,2,.000,6,8,.750,22,30,52,5,11,10,14,61,52,1.1
910,Ibrahima Diallo\ibrahima-diallo-1,2015-16,Rutgers,C,14,0,219,21,46,.457,21,46,.457,0,0,,9,20,.450,16,31,47,3,2,7,12,41,51,1.7
911,Miles Banks\miles-banks-1,2016-17,Incarnate Word,C,13,7,254,22,47,.468,22,47,.468,0,0,,7,21,.333,26,54,80,10,3,2,14,39,51,2.9
912,Owen Hamilton\owen-hamilton-1,2017-18,Northern Illinois,C,27,0,184,22,34,.647,22,33,.667,0,1,.000,6,12,.500,11,24,35,3,7,3,10,30,50,1.4
913,Jordan Dallas\jordan-dallas-1,2017-18,Weber State,C,22,1,188,21,33,.636,20,31,.645,1,2,.500,7,13,.538,4,27,31,5,2,5,15,32,50,1.1
914,Josh Sharma\josh-sharma-1,2015-16,Stanford,C,26,1,205,22,46,.478,21,40,.525,1,6,.167,5,13,.385,13,27,40,3,5,23,6,43,50,1.6
915,Philipp Hartwich\philipp-hartwich-1,2015-16,Portland,C,31,5,353,19,32,.594,19,32,.594,0,0,,12,25,.480,34,51,85,3,7,31,21,88,50,1.4
916,Daniel Regis\daniel-regis-1,2017-18,Nicholls State,C,19,0,216,16,34,.471,16,33,.485,0,1,.000,18,34,.529,22,29,51,4,2,4,14,43,50,1.4
917,Quron Davis\quron-davis-1,2014-15,Chicago State,C,19,8,223,22,47,.468,22,47,.468,0,0,,6,14,.429,25,25,50,4,5,7,17,27,50,1.7
918,Josh Gomez\josh-gomez-2,2014-15,Bowling Green State,C,25,3,173,21,38,.553,20,37,.541,1,1,1.000,7,12,.583,14,27,41,3,5,9,10,31,50,1.5
919,George Brammeier\george-brammeier-1,2014-15,Lipscomb,C,30,0,231,23,45,.511,23,45,.511,0,0,,4,11,.364,15,31,46,1,3,9,13,59,50,0.6
920,Carl Engstrom\carl-engstrom-1,2013-14,Alabama,C,31,9,365,20,37,.541,20,37,.541,0,0,,10,16,.625,26,50,76,9,4,14,20,53,50,1.3
921,Matt Milk\matt-milk-1,2013-14,St. Francis (NY),C,29,28,283,23,42,.548,23,42,.548,0,0,,3,5,.600,21,23,44,10,5,15,13,43,49,1.4
922,Bakary Konate\bakary-konate-1,2017-18,Minnesota,C,28,12,410,20,38,.526,20,38,.526,0,0,,9,14,.643,36,61,97,8,11,15,15,61,49,2.1
923,Patrick Ackerman\patrick-ackerman-1,2014-15,Detroit Mercy,C,31,8,322,22,45,.489,22,45,.489,0,0,,5,8,.625,6,33,39,1,6,18,9,47,49,1.0
924,Marc Andre Fortin\marcandre-fortin-1,2015-16,Sam Houston State,C,28,0,185,20,47,.426,20,47,.426,0,0,,9,18,.500,26,16,42,11,4,6,14,39,49,1.1
925,Marvin Jones\marvin-jones-1,2015-16,Kent State,C,27,1,238,17,51,.333,13,32,.406,4,19,.211,11,14,.786,17,33,50,4,0,7,6,28,49,1.2
926,Yasin Kolo\yasin-kolo-1,2013-14,Hartford,C,7,0,110,14,27,.519,10,17,.588,4,10,.400,17,24,.708,6,14,20,3,3,3,9,12,49,5.0
927,Dalen Traore\dalen-traore-1,2016-17,Evansville,C,21,2,248,14,30,.467,14,30,.467,0,0,,21,39,.538,19,38,57,1,5,2,12,35,49,1.5
928,Trey Kalina\trey-kalina-1,2017-18,North Carolina-Wilmington,C,25,2,147,20,41,.488,20,41,.488,0,0,,8,15,.533,13,16,29,1,1,13,11,26,48,1.1
929,Ajak Magot\ajak-magot-1,2013-14,Idaho State,C,20,0,230,17,37,.459,17,37,.459,0,0,,14,22,.636,21,24,45,1,5,10,7,50,48,1.7
930,Marquis Cunningham\marquis-cunningham-1,2016-17,Arkansas-Pine Bluff,C,25,4,199,18,48,.375,18,48,.375,0,0,,12,21,.571,12,22,34,5,12,4,28,43,48,0.2
931,Daouda Ndiaye\daouda-ndiaye-1,2016-17,Illinois State,C,26,0,394,18,42,.429,18,42,.429,0,0,,12,18,.667,32,68,100,3,5,43,17,44,48,2.6
932,Emmanuel Ndumanya\emmanuel-ndumanya-1,2015-16,Santa Clara,C,31,17,407,16,38,.421,15,37,.405,1,1,1.000,14,34,.412,50,71,121,4,5,13,23,71,47,1.3
933,Will Simonton\will-simonton-1,2015-16,Quinnipiac,C,22,0,226,20,43,.465,19,42,.452,1,1,1.000,6,12,.500,18,24,42,12,5,7,16,48,47,1.2
934,Larenz Stalcup\larenz-stalcup-1,2017-18,Louisiana,C,24,2,130,19,37,.514,19,37,.514,0,0,,8,15,.533,10,15,25,7,3,4,5,32,46,1.2
935,Kingsley Okoroh\kingsley-okorah-1,2015-16,University of California,C,31,17,335,20,33,.606,20,33,.606,0,0,,6,17,.353,16,43,59,6,4,33,19,61,46,1.2
936,Jacob Enevold\jacob-jensen-1,2016-17,Drake,C,28,2,228,20,31,.645,20,31,.645,0,0,,6,8,.750,17,37,54,8,1,10,16,23,46,1.5
937,James Ringholt\james-ringholdt-1,2015-16,Texas-San Antonio,C,25,12,284,14,39,.359,5,6,.833,9,33,.273,9,12,.750,5,34,39,8,2,9,8,22,46,1.4
938,Elbert Robinson\elbert-robinson-1,2016-17,Louisiana State,C,22,1,140,17,28,.607,17,28,.607,0,0,,12,29,.414,13,18,31,6,3,6,20,39,46,0.8
939,Cody Stetler\cody-stetler-1,2013-14,Houston Baptist,C,24,0,176,16,44,.364,15,43,.349,1,1,1.000,12,24,.500,14,42,56,3,1,7,11,36,45,0.9
940,Jovan Grujic\jovan-grujic-1,2016-17,Stephen F. Austin,C,31,3,244,16,42,.381,15,39,.385,1,3,.333,12,16,.750,11,28,39,4,2,6,25,28,45,0.3
941,Nate Wells\nate-wells-1,2015-16,Ball State,C,28,0,216,17,38,.447,17,38,.447,0,0,,11,21,.524,6,32,38,8,5,9,13,36,45,0.9
942,Matt Neufeld\matt-neufeld-1,2015-16,Saint Louis,C,25,2,242,18,40,.450,18,35,.514,0,5,.000,9,24,.375,7,23,30,2,7,8,20,29,45,0.5
943,Shaquille Doorson\shaquille-doorson-1,2014-15,Rutgers,C,29,0,298,21,44,.477,21,44,.477,0,0,,3,13,.231,31,33,64,4,1,13,12,41,45,1.2
944,Jock Landale\jock-landale-1,2014-15,Saint Mary's (CA),C,21,0,105,19,31,.613,19,31,.613,0,0,,7,13,.538,3,16,19,2,0,5,13,16,45,1.0
945,Rauno Nurger\rauno-nurger-1,2015-16,Wichita State,C,28,0,214,16,38,.421,15,26,.577,1,12,.083,11,18,.611,12,22,34,2,2,7,8,37,44,0.8
946,Jock Perry\jock-perry-1,2017-18,Saint Mary's (CA),C,21,0,68,15,29,.517,9,12,.750,6,17,.353,8,11,.727,2,5,7,1,0,0,2,4,44,1.4
947,Przemek Karnowski\przemek-karnowski-1,2015-16,Gonzaga,C,5,5,124,19,32,.594,19,32,.594,0,0,,6,13,.462,5,22,27,6,4,3,12,10,44,6.2
948,Isaiah Cotton\isaiah-cotton-1,2014-15,Alabama A&M,C,24,6,213,16,35,.457,16,35,.457,0,0,,12,34,.353,19,29,48,5,5,12,20,53,44,0.6
949,Jerome Simmons\jerome-simmons-1,2013-14,North Carolina A&T,C,23,5,240,19,36,.528,19,36,.528,0,0,,6,12,.500,17,37,54,2,3,8,11,58,44,1.0
950,Nathaniel Musters\nathaniel-musters-1,2015-16,Lafayette,C,30,17,337,20,42,.476,20,42,.476,0,0,,4,6,.667,15,61,76,13,7,7,19,40,44,1.2
951,Willie Wiley\willie-wiley-1,2015-16,Evansville,C,18,0,127,16,35,.457,16,35,.457,0,0,,12,20,.600,14,22,36,2,5,4,11,19,44,1.7
952,Ben Oberfeld\ben-oberfeld-1,2014-15,Bucknell,C,24,0,185,16,33,.485,16,33,.485,0,0,,11,16,.688,15,25,40,1,1,3,5,26,43,1.3
953,Chance Comanche\chance-comanche-1,2015-16,Arizona,C,23,0,139,16,33,.485,16,33,.485,0,0,,11,16,.688,12,24,36,5,1,7,8,17,43,1.5
954,Devin Kirby\devin-kirby-1,2016-17,Montana State,C,32,0,255,16,34,.471,16,34,.471,0,0,,11,21,.524,23,24,47,4,0,8,19,43,43,0.5
955,Cheikh N'diaye\cheikh-ndiaye-1,2014-15,Oregon State,C,29,5,222,20,32,.625,20,32,.625,0,0,,3,8,.375,14,25,39,1,2,15,15,43,43,0.9
956,Tyler Bergantino\tyler-bergantino-1,2014-15,Massachusetts,C,32,0,291,20,27,.741,20,27,.741,0,0,,3,13,.231,17,25,42,2,3,5,5,44,43,1.0
957,Tonny Trocha-Morelos\tonny-trocha-morelos-1,2014-15,Texas A&M,C,29,1,297,18,64,.281,18,59,.305,0,5,.000,7,19,.368,23,34,57,5,6,12,11,33,43,0.7
958,Davante Cooper\davante-cooper-1,2015-16,Bradley,C,26,1,208,18,42,.429,18,42,.429,0,0,,7,11,.636,5,29,34,3,0,7,14,24,43,0.6
959,Richard Peters\richard-peters-1,2016-17,Cal State Fullerton,C,23,3,199,18,34,.529,18,34,.529,0,0,,7,17,.412,14,26,40,3,4,6,19,37,43,0.7
960,Michael Chavers\michael-chavers-1,2017-18,Eastern Illinois,C,14,1,136,17,37,.459,11,28,.393,6,9,.667,3,5,.600,10,22,32,8,4,3,4,7,43,3.0
961,Leon Bahner\leon-bahner-1,2015-16,San Jose State,C,26,1,201,14,37,.378,14,37,.378,0,0,,14,22,.636,20,40,60,8,2,16,15,38,42,1.3
962,Tyler McCullough\tyler-mccullough-1,2015-16,Missouri State,C,28,0,207,17,39,.436,17,39,.436,0,0,,8,12,.667,23,27,50,5,3,14,14,43,42,1.0
963,Matthew Atewe\matthew-atewe-1,2016-17,Washington,C,19,4,165,16,31,.516,16,31,.516,0,0,,10,21,.476,19,24,43,1,3,13,13,26,42,1.7
964,Cori Johnson\cori-johnson-1,2017-18,St. Francis (NY),C,15,0,116,14,39,.359,14,39,.359,0,0,,14,26,.538,11,17,28,3,1,9,10,21,42,1.3
965,Robin Jorch\robin-jorch-1,2017-18,Boise State,C,28,0,227,18,29,.621,18,29,.621,0,0,,6,12,.500,23,21,44,3,3,4,18,55,42,0.6
966,Robin Jorch\robin-jorch-1,2015-16,Boise State,C,22,8,154,15,30,.500,15,28,.536,0,2,.000,12,21,.571,13,5,18,0,2,2,9,39,42,0.6
967,Reggis Onwukamuche\reggis-onwukamuche-1,2013-14,Prairie View,C,31,15,310,16,45,.356,16,45,.356,0,0,,10,19,.526,20,26,46,2,2,14,27,74,42,-0.3
968,Deniz Celen\deniz-celen-1,2016-17,Fairfield,C,23,0,175,19,43,.442,17,25,.680,2,18,.111,2,8,.250,17,32,49,8,4,4,12,33,42,1.1
969,Thaddeus Smith\thaddeus-smith-1,2015-16,Missouri-Kansas City,C,28,17,324,19,34,.559,19,34,.559,0,0,,4,20,.200,32,54,86,2,9,20,19,68,42,1.3
970,Brandon Cataldo\brandon-cataldo-1,2014-15,Portland State,C,19,0,112,19,35,.543,19,35,.543,0,0,,4,8,.500,13,22,35,2,0,7,9,18,42,1.5
971,Michael Chandler\michael-chandler-2,2014-15,Oregon,C,19,0,101,14,28,.500,14,28,.500,0,0,,14,20,.700,15,11,26,0,2,2,11,21,42,1.2
972,Dwight Coleby\dwight-coleby-1,2016-17,Kansas,C,24,0,134,17,30,.567,17,30,.567,0,0,,7,18,.389,15,29,44,3,4,12,6,33,41,1.5
973,J.J. N'Ganga\jj-nganga-1,2016-17,Mercer,C,30,3,246,19,41,.463,19,41,.463,0,0,,3,10,.300,19,33,52,4,2,4,17,32,41,0.6
974,Tony Sabato\tony-sabato-1,2013-14,Elon,C,27,1,221,17,31,.548,17,31,.548,0,0,,7,8,.875,7,17,24,7,5,4,16,40,41,0.6
975,Lloyd Burgess\lloyd-burgess-1,2015-16,North Carolina-Greensboro,C,31,1,267,15,29,.517,15,29,.517,0,0,,10,25,.400,25,41,66,5,3,9,9,58,40,1.0
976,Sami Eleraky\sami-eleraky-1,2015-16,Pacific,C,16,0,166,13,27,.481,13,27,.481,0,0,,14,26,.538,7,23,30,2,2,10,12,27,40,1.3
977,Cole Harrison\cole-harrison-1,2014-15,Dartmouth,C,27,1,149,18,36,.500,18,36,.500,0,0,,4,12,.333,9,22,31,2,2,6,15,35,40,0.4
978,Tyler Hadden\tyler-hadden-1,2015-16,Belmont,C,24,1,94,15,31,.484,13,23,.565,2,8,.250,8,14,.571,4,16,20,1,1,2,7,24,40,0.7
979,Gligorije Rakocevic\gligorije-rakocevic-1,2015-16,Oregon State,C,27,0,190,15,32,.469,15,32,.469,0,0,,10,15,.667,13,23,36,3,4,0,10,33,40,0.8
980,Demola Onifade\demola-onifade-1,2016-17,Delaware State,C,30,28,469,18,56,.321,18,56,.321,0,0,,4,13,.308,35,59,94,9,6,29,25,71,40,0.9
981,Kolton Kohl\kolton-kohl-1,2017-18,Abilene Christian,C,25,0,105,15,36,.417,15,36,.417,0,0,,9,18,.500,8,15,23,3,0,10,8,24,39,0.7
982,Lawrence Fejokwu\lawrence-fejokwu-1,2014-15,Coppin State,C,29,10,284,16,40,.400,16,40,.400,0,0,,7,20,.350,22,35,57,7,14,14,17,57,39,0.9
983,Chris Snyder\chris-snyder-1,2016-17,Western Illinois,C,22,0,138,17,25,.680,17,24,.708,0,1,.000,5,10,.500,8,16,24,4,4,5,9,26,39,1.3
984,James Ringholt\james-ringholdt-1,2014-15,Texas-San Antonio,C,28,0,284,13,41,.317,2,6,.333,11,35,.314,2,7,.286,5,40,45,10,4,12,13,38,39,0.7
985,Shaquille Doorson\shaquille-doorson-1,2016-17,Rutgers,C,31,0,272,18,32,.563,18,32,.563,0,0,,3,15,.200,28,23,51,8,3,14,12,39,39,1.2
986,Jeremy Olsen\jeremy-olsen-1,2014-15,Utah,C,24,0,153,14,35,.400,14,35,.400,0,0,,10,20,.500,7,26,33,1,2,5,12,21,38,0.6
987,Chris Harris\chris-harris-3,2017-18,Houston,C,22,1,163,17,25,.680,17,25,.680,0,0,,4,17,.235,10,32,42,1,1,11,11,30,38,1.1
988,Nate Maxey\nate-maxey-1,2014-15,North Carolina Central,C,25,0,194,14,22,.636,14,22,.636,0,0,,10,21,.476,13,32,45,0,2,42,16,45,38,1.6
989,Robert Garrett\robert-garrett-1,2013-14,Santa Clara,C,29,2,199,14,30,.467,14,30,.467,0,0,,10,17,.588,27,30,57,3,4,20,14,37,38,1.3
990,Demola Onifade\demola-onifade-1,2015-16,Delaware State,C,28,19,421,17,46,.370,17,46,.370,0,0,,4,10,.400,26,59,85,6,5,30,23,64,38,1.0
991,Will Simonton\will-simonton-1,2013-14,Illinois-Chicago,C,20,0,185,16,32,.500,16,32,.500,0,0,,6,13,.462,15,25,40,2,4,11,8,32,38,1.5
992,Sidy Djitte\sidy-djitte-1,2013-14,Clemson,C,34,1,304,18,43,.419,18,43,.419,0,0,,2,12,.167,40,52,92,0,7,9,13,53,38,1.0
993,John Fenton\john-fenton-1,2014-15,Colgate,C,32,0,297,15,42,.357,15,42,.357,0,0,,8,20,.400,22,42,64,1,6,8,12,60,38,0.4
994,Link Kabadyundi\link-kabadyundi-1,2016-17,Texas-Arlington,C,31,0,163,12,24,.500,12,24,.500,0,0,,14,29,.483,13,26,39,1,2,10,15,37,38,0.5
995,Marshall Plumlee\marshall-plumlee-1,2013-14,Duke,C,30,0,253,16,29,.552,16,29,.552,0,0,,6,17,.353,36,29,65,8,6,17,10,29,38,1.9
996,Jerome Simmons\jerome-simmons-1,2014-15,North Carolina A&T,C,23,1,161,16,31,.516,16,31,.516,0,0,,5,8,.625,10,17,27,0,0,4,5,28,37,0.8
997,Mahamadou Kaba-Camara\mahamadou-kaba-camara-1,2017-18,Cal State Northridge,C,24,2,224,17,26,.654,17,26,.654,0,0,,3,13,.231,14,33,47,2,3,5,7,46,37,1.0
998,Mawdo Sallah\mawdo-sallah-1,2017-18,Kansas State,C,21,0,161,15,28,.536,15,28,.536,0,0,,7,14,.500,10,30,40,4,2,7,9,26,37,1.3
999,Maricus Glenn\maricus-glenn-1,2016-17,Savannah State,C,29,14,255,16,31,.516,16,31,.516,0,0,,5,13,.385,19,38,57,4,7,7,12,59,37,0.8
1000,Matthew Atewe\matthew-atewe-1,2013-14,Auburn,C,24,0,346,12,27,.444,12,27,.444,0,0,,13,25,.520,28,54,82,7,8,26,18,77,37,1.5
1001,Marques Bolden\marques-bolden-1,2016-17,Duke,C,24,1,157,16,35,.457,16,35,.457,0,0,,5,8,.625,14,12,26,2,2,7,11,32,37,0.7
1002,Daniel Wallace\daniel-wallace-1,2017-18,Saint Francis (PA),C,24,1,154,17,35,.486,17,34,.500,0,1,.000,3,5,.600,6,24,30,9,5,2,10,34,37,0.8
1003,L'Hassane Niangane\lhassane-niangane-1,2017-18,Gardner-Webb,C,32,13,522,14,40,.350,14,40,.350,0,0,,9,30,.300,69,65,134,7,1,30,30,85,37,1.2
1004,Larenz Stalcup\larenz-stalcup-1,2016-17,Louisiana,C,29,2,149,12,37,.324,12,37,.324,0,0,,13,16,.813,11,23,34,7,3,12,11,33,37,0.7
1005,Luke Fischer\luke-fischer-1,2013-14,Indiana,C,13,0,130,15,27,.556,15,27,.556,0,0,,7,9,.778,12,15,27,4,1,11,6,16,37,2.7
1006,Anthony Green\anthony-green-2,2015-16,Northeastern,C,20,1,106,14,26,.538,14,26,.538,0,0,,8,15,.533,8,15,23,1,1,8,4,23,36,1.2
1007,Sylvester Ogbonda\sylvester-ogbonda-1,2016-17,Georgia Tech,C,23,0,120,13,27,.481,13,27,.481,0,0,,10,16,.625,7,17,24,4,3,6,9,28,36,0.9
1008,Schuyler Rimmer\schuyler-rimmer-1,2015-16,Florida,C,25,0,161,13,30,.433,12,29,.414,1,1,1.000,9,10,.900,10,20,30,3,0,5,7,25,36,0.9
1009,Steven Burrough\steven-burrough-1,2013-14,North Carolina A&T,C,31,9,256,13,29,.448,13,29,.448,0,0,,10,29,.345,10,30,40,2,2,23,13,44,36,0.6
1010,Jordan Hughes\jordan-hughes-1,2016-17,Western Illinois,C,18,0,127,16,26,.615,16,26,.615,0,0,,4,7,.571,6,22,28,0,1,6,7,18,36,1.4
1011,Chudier Pal\chudier-pal-1,2013-14,North Carolina-Asheville,C,17,0,161,16,33,.485,16,33,.485,0,0,,4,9,.444,14,31,45,7,2,13,12,24,36,1.8
1012,Sami Eleraky\sami-eleraky-1,2016-17,Pacific,C,21,10,189,15,38,.395,15,38,.395,0,0,,6,14,.429,21,26,47,2,4,2,11,46,36,0.6
1013,Obij Aget\obij-aget-1,2013-14,New Mexico,C,28,2,176,14,26,.538,14,26,.538,0,0,,7,13,.538,13,24,37,2,1,5,7,29,35,0.8
1014,Mading Thok\mading-thok-1,2013-14,Ball State,C,13,0,97,16,23,.696,16,23,.696,0,0,,3,9,.333,10,19,29,3,1,2,6,13,35,2.2
1015,Michael Hughes\michael-hughes-2,2016-17,Akron,C,20,1,146,11,24,.458,11,24,.458,0,0,,13,20,.650,8,16,24,7,6,10,9,25,35,1.5
1016,Bush Wamukota\bush-wamukota-1,2014-15,Wichita State,C,32,0,192,10,22,.455,10,22,.455,0,0,,15,28,.536,19,29,48,1,2,5,8,36,35,0.8
1017,Derrell Robertson\derrell-robertson-1,2014-15,San Francisco,C,24,7,205,13,31,.419,13,31,.419,0,0,,9,16,.563,16,18,34,4,1,11,20,53,35,0.1
1018,Tom Koopman\tom-koopman-1,2014-15,Citadel,C,21,6,155,13,26,.500,13,26,.500,0,0,,9,10,.900,11,18,29,4,6,4,9,22,35,1.4
1019,Moses Abraham\moses-abraham-1,2014-15,Nebraska,C,22,0,225,15,30,.500,15,30,.500,0,0,,5,11,.455,32,43,75,2,5,10,20,45,35,1.3
1020,Boubacar Toure\boubecar-toure-1,2015-16,Grand Canyon,C,8,0,115,13,29,.448,13,28,.464,0,1,.000,9,19,.474,9,21,30,0,1,4,11,20,35,1.7
1021,Kevin Ndahiro\kevin-ndahiro-1,2016-17,Stetson,C,22,0,150,11,24,.458,11,24,.458,0,0,,13,20,.650,17,26,43,0,2,8,13,36,35,0.9
1022,Nathaniel Musters\nathaniel-musters-1,2013-14,Lafayette,C,28,7,297,16,27,.593,16,27,.593,0,0,,2,11,.182,14,41,55,9,7,16,13,38,34,1.3
1023,Julian Torres\julian-torres-1,2017-18,Southern Illinois-Edwardsville,C,5,2,73,13,33,.394,9,25,.360,4,8,.500,4,8,.500,6,10,16,2,1,4,8,16,34,2.5
1024,Seth Adelsperger\seth-adelsperger-1,2016-17,Belmont,C,27,0,102,10,23,.435,10,23,.435,0,0,,14,27,.519,9,22,31,1,1,3,8,17,34,0.7
1025,Alex Gavrilovic\alex-gavrilovic-1,2013-14,Dayton,C,15,0,99,15,24,.625,14,20,.700,1,4,.250,3,5,.600,6,15,21,1,1,1,3,15,34,1.6
1026,Matt Pollard\matt-pollard-1,2013-14,San Jose State,C,28,3,264,16,33,.485,16,33,.485,0,0,,2,9,.222,17,29,46,3,2,15,11,31,34,0.9
1027,Nolan Berry\nolan-berry-1,2013-14,Butler,C,18,0,90,13,26,.500,12,16,.750,1,10,.100,7,7,1.000,6,17,23,2,1,3,4,14,34,1.4
1028,Ryan Salmonson\ryan-salmonson-1,2014-15,North Dakota,C,15,6,124,14,28,.500,14,28,.500,0,0,,6,6,1.000,4,14,18,1,3,2,14,30,34,0.4
1029,Lucas Smith\lucas-smith-1,2017-18,Akron,C,25,5,284,10,40,.250,6,17,.353,4,23,.174,10,15,.667,19,42,61,8,4,1,10,50,34,0.6
1030,Ryan Edwards\ryan-edwards-1,2016-17,Gonzaga,C,17,0,46,15,24,.625,15,23,.652,0,1,.000,4,7,.571,5,12,17,4,0,1,1,8,34,1.7
1031,Kyle Caudill\kc-caudill-1,2013-14,Boston College,C,19,5,162,11,21,.524,11,21,.524,0,0,,12,18,.667,11,18,29,9,1,2,12,30,34,1.0
1032,Antonio Vrankovic\antonio-vrankovic-1,2016-17,Duke,C,13,0,101,13,19,.684,13,19,.684,0,0,,7,11,.636,16,18,34,5,0,4,7,16,33,2.5
1033,Pierre Crawford\pierre-crawford-1,2014-15,Jackson State,C,22,0,124,13,27,.481,13,27,.481,0,0,,7,18,.389,11,15,26,2,2,5,13,29,33,0.4
1034,Zech Smith\zech-smith-1,2013-14,Cal State Bakersfield,C,15,1,154,14,24,.583,14,24,.583,0,0,,5,16,.313,16,26,42,1,1,13,17,21,33,1.5
1035,Mo Ahmed\mo-ahmed-1,2017-18,Missouri-Kansas City,C,18,0,135,13,28,.464,13,28,.464,0,0,,7,14,.500,8,19,27,0,4,6,8,20,33,1.1
1036,Jamuni McNeace\jamuni-mcneace-1,2015-16,Oklahoma,C,27,0,207,12,22,.545,12,22,.545,0,0,,9,21,.429,14,23,37,1,2,8,8,36,33,0.7
1037,Christ Koumadje\jeanmarc-koumadje-1,2015-16,Florida State,C,26,1,159,13,27,.481,13,27,.481,0,0,,7,17,.412,10,28,38,1,0,19,11,36,33,0.7
1038,Andre Washington\andre-washington-1,2014-15,Wake Forest,C,21,0,103,11,24,.458,11,24,.458,0,0,,11,15,.733,9,9,18,1,3,14,5,25,33,1.3
1039,Jordan Dickerson\jordan-dickerson-2,2013-14,Penn State,C,22,7,285,13,26,.500,13,25,.520,0,1,.000,7,11,.636,18,25,43,0,3,29,14,51,33,1.2
1040,Bush Wamukota\bush-wamukota-1,2015-16,Wichita State,C,28,1,192,13,29,.448,13,28,.464,0,1,.000,7,8,.875,17,27,44,3,6,1,6,40,33,0.9
1041,Kameron Rooks\kameron-rooks-1,2013-14,University of California,C,26,0,182,12,28,.429,12,28,.429,0,0,,9,17,.529,13,28,41,4,3,10,6,31,33,1.0
1042,Jovan Grujic\jovan-grujic-1,2017-18,Stephen F. Austin,C,22,0,133,13,30,.433,13,28,.464,0,2,.000,6,11,.545,8,16,24,1,2,1,19,26,32,-0.1
1043,Aaron Scales\aaron-scales-1,2015-16,Cleveland State,C,24,0,193,10,26,.385,10,26,.385,0,0,,12,18,.667,23,12,35,0,3,6,9,39,32,0.7
1044,Jovan Grujic\jovan-grujic-1,2015-16,Stephen F. Austin,C,24,0,148,14,35,.400,14,32,.438,0,3,.000,4,6,.667,12,19,31,6,2,5,9,20,32,0.8
1045,Ebuka Izundu\ebuka-izundu-1,2015-16,Miami (FL),C,14,0,79,10,16,.625,10,16,.625,0,0,,12,19,.632,13,6,19,3,2,3,6,17,32,1.9
1046,Demetrice Clopton\demetrice-clopton-1,2017-18,Jackson State,C,17,7,110,13,34,.382,13,34,.382,0,0,,6,10,.600,15,18,33,4,2,0,8,23,32,0.9
1047,Cheikh N'diaye\cheikh-ndiaye-1,2016-17,Oregon State,C,9,8,97,12,23,.522,12,23,.522,0,0,,8,13,.615,8,12,20,1,0,7,10,13,32,2.0
1048,Jarid Watson\jarid-watson-1,2013-14,Virginia Military Institute,C,31,0,177,13,29,.448,13,29,.448,0,0,,6,12,.500,25,22,47,1,8,16,2,37,32,1.3
1049,Khalea Turner-Morris\khalea-turner-morris-1,2017-18,Massachusetts,C,24,1,150,11,18,.611,11,18,.611,0,0,,9,15,.600,12,20,32,3,0,2,10,30,31,0.7
1050,Ted Friedman\ted-friedman-1,2015-16,Northern Iowa,C,36,0,298,14,29,.483,14,28,.500,0,1,.000,3,18,.167,18,27,45,9,2,5,9,40,31,0.5
1051,Jake Wilson\jake-wilson-1,2017-18,Appalachian State,C,26,0,159,10,17,.588,10,17,.588,0,0,,11,26,.423,21,37,58,4,3,12,14,21,31,1.3
1052,David Nyarsuk\david-nyarsuk-1,2013-14,Cincinnati,C,22,0,148,12,21,.571,12,21,.571,0,0,,7,8,.875,14,15,29,2,2,12,8,24,31,1.3
1053,Ben Mills\ben-mills-1,2013-14,Colorado,C,25,1,99,11,23,.478,10,22,.455,1,1,1.000,8,10,.800,8,13,21,4,1,1,5,10,31,0.9
1054,DeAndre Leatherwood\deandre-leatherwood-1,2013-14,Morehead State,C,17,0,88,14,23,.609,14,23,.609,0,0,,3,9,.333,9,12,21,2,2,5,6,17,31,1.3
1055,Joseph Uchebo\joseph-uchebo-1,2014-15,Pittsburgh,C,21,4,130,14,36,.389,14,36,.389,0,0,,3,4,.750,15,25,40,3,1,2,6,18,31,1.0
1056,E.J. Datcher\ej-datcher-1,2016-17,Mississippi State,C,31,1,228,13,32,.406,13,32,.406,0,0,,5,9,.556,13,34,47,1,6,19,9,59,31,0.6
1057,Deivydas Kuzavas\deivydas-kuzavas-1,2016-17,Saint Francis (PA),C,26,2,197,11,29,.379,11,28,.393,0,1,.000,9,18,.500,17,26,43,8,1,9,14,31,31,0.7
1058,Johnny Hamilton\johnny-hamilton-1,2015-16,Virginia Tech,C,17,4,124,13,25,.520,13,25,.520,0,0,,5,13,.385,19,18,37,4,0,16,6,16,31,2.1
1059,Ernest Aflakpui\ernest-aflakpui-1,2015-16,Temple,C,17,6,135,12,23,.522,12,23,.522,0,0,,7,11,.636,16,20,36,2,3,6,5,20,31,1.8
1060,Oliver Ellison\oliver-ellison-1,2015-16,Howard,C,11,0,130,13,15,.867,13,15,.867,0,0,,4,11,.364,7,23,30,2,3,5,6,28,30,2.2
1061,John Hawkins\john-hawkins-1,2013-14,Miami (OH),C,24,1,131,13,30,.433,13,30,.433,0,0,,4,7,.571,8,14,22,3,2,6,10,19,30,0.6
1062,C.J. Gettys\cj-gettys-1,2013-14,North Carolina-Wilmington,C,11,2,97,14,29,.483,14,29,.483,0,0,,2,7,.286,12,7,19,3,5,2,4,17,30,2.0
1063,Rozelle Nix\rozelle-nix-1,2017-18,South Alabama,C,13,7,120,15,31,.484,15,31,.484,0,0,,0,2,.000,11,14,25,4,1,2,18,21,30,0.3
1064,David Onuorah\david-onuorah-1,2017-18,Connecticut,C,30,8,311,12,25,.480,12,24,.500,0,1,.000,6,11,.545,29,33,62,4,0,12,25,64,30,0.2
1065,James Herrick\james-herrick-1,2017-18,Sacramento State,C,24,1,110,10,24,.417,10,24,.417,0,0,,9,19,.474,6,22,28,1,1,1,5,24,29,0.5
1066,Ryan Keenan\ryan-keenan-2,2016-17,Pepperdine,C,24,6,185,13,22,.591,13,22,.591,0,0,,3,8,.375,10,11,21,2,1,2,9,23,29,0.5
1067,Chauncy Parker\chauncy-parker-1,2015-16,Arkansas-Pine Bluff,C,32,14,277,12,19,.632,12,19,.632,0,0,,4,12,.333,11,26,37,16,8,24,23,67,28,0.6
1068,Tyler Bergantino\tyler-bergantino-1,2013-14,Massachusetts,C,32,0,234,13,21,.619,13,21,.619,0,0,,2,8,.250,14,33,47,7,3,8,3,51,28,0.8
1069,Ido Flaisher\ido-flaisher-1,2017-18,Hawaii,C,22,1,123,10,23,.435,10,23,.435,0,0,,8,15,.533,4,20,24,1,0,1,12,25,28,0.1
1070,Joniah White\joniah-white-1,2014-15,Louisiana Tech,C,26,0,186,10,18,.556,10,18,.556,0,0,,8,14,.571,14,20,34,1,1,19,7,27,28,1.2
1071,Lawrence Fejokwu\lawrence-fejokwu-1,2015-16,Coppin State,C,28,2,268,9,24,.375,9,23,.391,0,1,.000,10,24,.417,23,33,56,1,4,18,17,58,28,0.4
1072,Bryden Boehning\bryden-boehning-1,2015-16,Montana,C,22,0,135,13,28,.464,13,28,.464,0,0,,2,7,.286,6,22,28,6,2,1,10,35,28,0.2
1073,Elhadji Dieng\elhadji-dieng-1,2017-18,Florida International,C,22,19,212,10,26,.385,10,26,.385,0,0,,7,27,.259,19,27,46,1,3,11,7,42,27,0.6
1074,Demola Onifade\demola-onifade-1,2017-18,Delaware State,C,28,8,332,13,48,.271,13,48,.271,0,0,,1,2,.500,19,45,64,6,3,9,15,41,27,0.3
1075,Marice Wright\marice-wright-1,2017-18,Alabama State,C,20,0,129,12,30,.400,11,23,.478,1,7,.143,2,9,.222,13,24,37,2,1,2,7,27,27,0.5
1076,Jeremy King\jeremy-king-3,2013-14,Loyola (IL),C,17,1,77,12,14,.857,12,14,.857,0,0,,3,9,.333,7,8,15,1,3,0,7,16,27,1.0
1077,Vieux Kande\vieux-kande-1,2013-14,Louisiana,C,25,0,122,10,15,.667,10,15,.667,0,0,,7,17,.412,9,12,21,2,3,4,4,25,27,0.8
1078,Tyler Hadden\tyler-hadden-1,2016-17,Belmont,C,25,1,91,11,24,.458,9,14,.643,2,10,.200,3,6,.500,7,19,26,4,2,4,9,20,27,0.6
1079,Daniel Amigo\daniel-amigo-1,2015-16,Denver,C,13,0,71,12,22,.545,12,22,.545,0,0,,3,10,.300,3,14,17,4,1,0,13,23,27,0.1
1080,Rozelle Nix\rozelle-nix-1,2016-17,Pittsburgh,C,20,0,126,9,24,.375,9,24,.375,0,0,,9,13,.692,18,34,52,1,0,4,7,33,27,0.9
1081,Mat Piotrowski\mat-piotrowski-1,2013-14,Eastern Illinois,C,17,4,168,11,37,.297,8,24,.333,3,13,.231,2,2,1.000,8,22,30,8,3,15,8,8,27,1.5
1082,Cheikh N'diaye\cheikh-ndiaye-1,2015-16,Oregon State,C,25,0,131,9,11,.818,9,11,.818,0,0,,9,15,.600,5,17,22,0,4,8,9,25,27,0.8
1083,Ivo Basor\ivo-basor-1,2015-16,San Jose State,C,15,2,60,9,14,.643,5,9,.556,4,5,.800,5,12,.417,4,8,12,2,0,0,3,11,27,1.1
1084,David Bell\david-bell-3,2015-16,Ohio State,C,23,0,125,6,13,.462,6,13,.462,0,0,,14,24,.583,18,16,34,1,1,5,4,24,26,1.1
1085,Ted Friedman\ted-friedman-1,2017-18,Northern Iowa,C,23,1,156,11,20,.550,9,16,.563,2,4,.500,2,5,.400,14,11,25,6,2,6,7,22,26,1.0
1086,John Miller\john-miller-1,2017-18,Army,C,21,0,127,11,17,.647,11,17,.647,0,0,,4,8,.500,11,17,28,3,4,5,8,18,26,1.1
1087,Darcy Malone\darcy-malone-1,2013-14,Louisiana State,C,19,0,73,11,20,.550,8,13,.615,3,7,.429,1,4,.250,7,11,18,3,1,1,6,26,26,0.6
1088,Schuyler Rimmer\schuyler-rimmer-1,2016-17,Florida,C,21,1,111,9,20,.450,9,19,.474,0,1,.000,8,13,.615,9,10,19,2,1,3,5,21,26,0.7
1089,Darius Bolstad\darius-bolstad-1,2017-18,Radford,C,15,0,61,11,18,.611,11,18,.611,0,0,,4,7,.571,6,9,15,1,0,5,6,17,26,1.0
1090,Artavious McDyess\artavious-mcdyess-1,2017-18,Arkansas-Pine Bluff,C,18,1,221,10,20,.500,10,20,.500,0,0,,6,10,.600,19,30,49,1,7,17,12,35,26,1.7
1091,Filip Nowicki\filip-nowicki-1,2015-16,Sacred Heart,C,11,2,108,11,19,.579,11,19,.579,0,0,,4,9,.444,7,15,22,4,1,1,14,17,26,0.7
1092,Trayvon Reed\trayvon-reed-1,2014-15,Auburn,C,23,0,205,9,22,.409,9,22,.409,0,0,,8,22,.364,17,29,46,3,2,16,12,36,26,0.8
1093,Jeremiah Kreisberg\jeremiah-kreisberg-1,2014-15,Northwestern,C,24,0,155,8,18,.444,8,18,.444,0,0,,9,14,.643,14,14,28,4,1,2,13,26,25,0.4
1094,John Cannon\john-cannon-1,2013-14,Georgia,C,18,0,82,11,22,.500,11,22,.500,0,0,,3,4,.750,7,12,19,0,1,5,9,11,25,0.7
1095,Davante Cooper\davante-cooper-1,2017-18,Washington State,C,18,2,113,11,17,.647,11,17,.647,0,0,,3,11,.273,4,17,21,5,2,7,10,19,25,0.8
1096,Aaron Scales\aaron-scales-1,2014-15,Cleveland State,C,24,0,133,11,26,.423,11,26,.423,0,0,,3,8,.375,16,13,29,2,5,2,12,29,25,0.4
1097,Matt Neufeld\matt-neufeld-1,2016-17,Saint Louis,C,28,1,150,10,20,.500,10,20,.500,0,0,,5,8,.625,5,18,23,4,2,1,11,24,25,0.3
1098,Osinachi Smart\osinachi-smart-1,2017-18,College of Charleston,C,20,0,168,8,19,.421,8,19,.421,0,0,,9,16,.563,17,30,47,3,5,6,4,31,25,1.4
1099,Kaleb Allison\kaleb-allison-1,2017-18,Mississippi Valley State,C,24,3,131,11,29,.379,11,29,.379,0,0,,3,11,.273,13,12,25,2,3,1,11,17,25,0.2
1100,Ryan Edwards\ryan-edwards-1,2013-14,Gonzaga,C,17,0,86,5,12,.417,5,12,.417,0,0,,14,17,.824,8,13,21,0,0,3,5,20,24,0.9
1101,Ak Ojo\ak-ojo-1,2016-17,Manhattan,C,30,1,233,9,18,.500,9,18,.500,0,0,,6,9,.667,16,30,46,2,4,15,14,62,24,0.4
1102,Noah Cummings\noah-cummings-1,2016-17,Grambling,C,24,4,162,9,18,.500,9,18,.500,0,0,,6,9,.667,12,12,24,1,1,8,17,36,24,0.1
1103,Mahamadou Kaba-Camara\mahamadou-kaba-camara-1,2016-17,Cal State Northridge,C,25,14,198,11,19,.579,11,19,.579,0,0,,2,9,.222,14,23,37,0,3,11,6,41,24,0.7
1104,Jack Ocwieja\jack-ocwieja-1,2015-16,Grambling,C,16,6,148,11,24,.458,11,23,.478,0,1,.000,2,2,1.000,4,13,17,0,0,4,5,19,24,0.5
1105,Benas Griciunas\benas-griciunas-1,2013-14,Auburn,C,12,1,112,10,26,.385,10,21,.476,0,5,.000,4,7,.571,6,15,21,3,0,5,5,14,24,1.0
1106,Matthew Moss\matthew-moss-1,2013-14,McNeese State,C,21,0,113,9,29,.310,5,7,.714,4,22,.182,2,3,.667,6,9,15,1,3,7,4,17,24,0.6
1107,Peter Jurkin\peter-jurkin-1,2016-17,East Tennessee State,C,14,0,91,9,24,.375,9,22,.409,0,2,.000,6,7,.857,6,15,21,1,5,7,10,15,24,1.0
1108,Malcolm Gilbert\malcolm-gilbert-1,2014-15,Fairfield,C,25,2,258,8,30,.267,8,30,.267,0,0,,7,11,.636,15,32,47,8,1,33,12,45,23,0.9
1109,Nate Fowler\nate-fowler-1,2015-16,Butler,C,20,0,125,10,18,.556,8,15,.533,2,3,.667,1,3,.333,11,15,26,4,2,1,7,29,23,0.6
1110,James Banks\james-banks-2,2017-18,Texas,C,14,0,95,8,14,.571,8,14,.571,0,0,,7,18,.389,10,14,24,0,1,11,3,18,23,1.6
1111,Simeon Lepichev\simeon-lepichev-1,2017-18,Florida Atlantic,C,16,1,106,10,20,.500,8,12,.667,2,8,.250,1,3,.333,5,17,22,2,3,2,7,20,23,0.7
1112,Bruce Marshall\bruce-marshall-1,2013-14,Missouri State,C,15,0,63,6,15,.400,3,5,.600,3,10,.300,8,9,.889,2,6,8,0,0,3,2,9,23,0.9
1113,Javon Baumann\javon-baumann-1,2013-14,Saint Joseph's,C,15,0,88,10,17,.588,10,17,.588,0,0,,3,12,.250,11,16,27,3,1,2,7,9,23,1.2
1114,Isaiah Jones\isaiah-jones-1,2017-18,Detroit Mercy,C,15,2,121,10,24,.417,10,24,.417,0,0,,3,7,.429,8,13,21,1,1,18,4,26,23,1.2
1115,Geoffrey Groselle\geoff-groselle-1,2013-14,Creighton,C,15,0,49,10,13,.769,10,13,.769,0,0,,3,6,.500,4,10,14,2,0,4,1,8,23,1.5
1116,Phillip Reed\phillip-reed-1,2014-15,Hampton,C,22,5,209,8,23,.348,8,23,.348,0,0,,6,13,.462,20,28,48,4,1,9,10,48,22,0.4
1117,Anton Larsen\anton-larsen-1,2013-14,Old Dominion,C,18,2,124,9,23,.391,9,15,.600,0,8,.000,4,6,.667,4,17,21,2,0,3,5,15,22,0.5
1118,Blake Brumwell\blake-brumwell-1,2013-14,Montana State,C,25,2,146,9,19,.474,9,19,.474,0,0,,4,6,.667,14,19,33,4,1,0,6,22,22,0.6
1119,Theo Turner\theo-turner-1,2014-15,Seattle,C,18,0,150,9,23,.391,9,22,.409,0,1,.000,4,14,.286,10,26,36,3,4,0,15,17,22,0.3
1120,Darcy Malone\darcy-malone-1,2014-15,Louisiana State,C,25,8,216,8,21,.381,8,16,.500,0,5,.000,6,12,.500,13,22,35,11,4,12,11,46,22,0.6
1121,Ben Lammers\ben-lammers-1,2014-15,Georgia Tech,C,19,0,113,9,21,.429,9,21,.429,0,0,,4,9,.444,9,19,28,1,3,4,3,7,22,1.1
1122,Dylan Johns\dylan-johns-1,2013-14,Texas A&M,C,26,0,215,10,17,.588,10,17,.588,0,0,,2,9,.222,12,12,24,3,3,11,11,31,22,0.5
1123,Theodore Boyomo\theodore-boyomo-1,2014-15,Howard,C,19,2,104,11,14,.786,11,14,.786,0,0,,0,3,.000,8,20,28,1,3,0,8,21,22,0.8
1124,J.J. Davenport\jj-davenport-1,2014-15,Louisiana,C,17,2,86,8,23,.348,8,20,.400,0,3,.000,6,9,.667,4,12,16,2,0,1,7,21,22,0.1
1125,Neville Fincher\neville-fincher-1,2015-16,Tennessee State,C,18,0,106,8,21,.381,7,18,.389,1,3,.333,5,8,.625,4,18,22,1,3,5,7,18,22,0.6
1126,Carlton Allen\carlton-allen-1,2014-15,Manhattan,C,21,1,146,8,12,.667,8,12,.667,0,0,,6,9,.667,7,15,22,1,1,2,5,37,22,0.4
1127,Duby Okeke\duby-okeke-1,2017-18,Nebraska,C,28,2,197,9,20,.450,9,20,.450,0,0,,4,10,.400,24,26,50,2,5,27,17,40,22,0.9
1128,Jake Wilson\jake-wilson-1,2016-17,Appalachian State,C,20,0,122,8,23,.348,8,23,.348,0,0,,6,18,.333,10,28,38,4,2,13,12,24,22,0.6
1129,Vieux Kande\vieux-kande-1,2014-15,Louisiana,C,20,0,63,9,13,.692,9,13,.692,0,0,,4,7,.571,5,8,13,0,0,1,7,14,22,0.5
1130,Zach Moer\zach-moer-1,2013-14,Air Force,C,12,0,52,7,14,.500,7,11,.636,0,3,.000,7,10,.700,2,6,8,5,1,4,5,8,21,1.3
1131,Grant Pelchen\grant-pelchen-1,2013-14,Florida Atlantic,C,20,0,131,9,19,.474,9,19,.474,0,0,,3,10,.300,12,16,28,10,2,14,2,28,21,1.4
1132,Leon Bahner\leon-bahner-1,2014-15,San Jose State,C,9,5,168,5,14,.357,5,14,.357,0,0,,11,19,.579,14,23,37,0,1,10,10,17,21,2.0
1133,Josh Gomez\josh-gomez-2,2013-14,Bowling Green State,C,26,0,147,9,30,.300,8,24,.333,1,6,.167,2,6,.333,10,14,24,2,3,8,11,26,21,0.1
1134,Daouda Ndiaye\daouda-ndiaye-1,2015-16,Illinois State,C,12,0,106,7,16,.438,7,16,.438,0,0,,7,21,.333,7,19,26,2,0,14,4,13,21,1.6
1135,Ivan Cucak\ivan-cucak-1,2017-18,Austin Peay,C,22,0,129,9,15,.600,8,14,.571,1,1,1.000,2,5,.400,3,5,8,4,3,2,15,24,21,0.0
1136,Justin Dahl\justin-dahl-1,2016-17,Northern Iowa,C,13,0,66,9,19,.474,9,19,.474,0,0,,3,8,.375,6,8,14,1,1,2,6,4,21,0.9
1137,Grant Verhoeven\grant-verhoeven-1,2013-14,Stanford,C,32,0,182,6,16,.375,6,16,.375,0,0,,9,13,.692,11,23,34,7,3,1,7,42,21,0.3
1138,Shaquille Benson\shaquille-benson-1,2017-18,Southern,C,12,1,78,8,25,.320,8,25,.320,0,0,,5,9,.556,16,11,27,0,4,3,7,16,21,1.0
1139,Sam Berlin\sam-berlin-1,2017-18,High Point,C,15,2,61,9,16,.563,9,16,.563,0,0,,3,11,.273,15,15,30,2,2,1,3,6,21,1.6
1140,Tyler Jackson\tyler-jackson-1,2016-17,UC-Santa Barbara,C,11,1,76,9,15,.600,9,15,.600,0,0,,3,6,.500,9,17,26,0,2,2,8,17,21,1.2
1141,Ryan Canty\ryan-canty-1,2015-16,Fordham,C,21,0,125,8,17,.471,8,17,.471,0,0,,5,13,.385,11,30,41,2,7,10,8,25,21,1.1
1142,Jordan Hughes\jordan-hughes-1,2017-18,Western Illinois,C,19,0,105,9,14,.643,9,14,.643,0,0,,2,4,.500,6,21,27,0,2,1,0,9,20,1.2
1143,Rawane Ndiaye\rawane-ndiaye-1,2013-14,Tennessee,C,22,0,71,8,18,.444,8,18,.444,0,0,,4,8,.500,15,6,21,0,0,2,8,11,20,0.5
1144,Joniya Gadson\joniya-gadson-1,2017-18,Bowling Green State,C,16,0,83,8,13,.615,8,13,.615,0,0,,4,11,.364,9,16,25,2,2,4,11,26,20,0.5
1145,Jonathan Barnes\jonathan-barnes-1,2014-15,Wyoming,C,14,0,64,7,14,.500,7,14,.500,0,0,,6,10,.600,4,11,15,1,1,4,5,6,20,1.0
1146,Zach Pirog\zach-pirog-1,2015-16,Omaha,C,15,0,80,9,22,.409,9,19,.474,0,3,.000,2,7,.286,9,17,26,0,1,10,8,16,20,0.7
1147,David Bell\david-bell-3,2016-17,Ohio State,C,15,0,101,8,18,.444,8,18,.444,0,0,,4,7,.571,10,19,29,2,2,7,3,17,20,1.4
1148,Brock Bertram\brock-bertram-1,2017-18,Buffalo,C,17,1,84,9,17,.529,9,17,.529,0,0,,2,4,.500,12,7,19,1,3,4,4,19,20,1.0
1149,Michael Phillip\michael-phillip-1,2014-15,Florida International,C,33,0,194,7,13,.538,7,13,.538,0,0,,6,15,.400,13,19,32,6,0,12,3,50,20,0.4
1150,Link Kabadyundi\link-kabadyundi-1,2014-15,Texas Christian,C,15,0,69,8,13,.615,8,13,.615,0,0,,3,12,.250,11,9,20,2,2,10,5,12,19,1.4
1151,Namdi Okonkwo\namdi-okonkwo-1,2015-16,Portland State,C,15,0,92,7,14,.500,7,14,.500,0,0,,5,11,.455,5,24,29,1,1,10,9,18,19,0.9
1152,David Wishon\david-wishon-1,2014-15,College of Charleston,C,10,2,83,8,13,.615,8,13,.615,0,0,,3,10,.300,4,6,10,0,1,6,7,18,19,0.6
1153,Innocent Nwoko\innocent-nwoko-1,2017-18,Central Michigan,C,27,1,82,9,13,.692,9,13,.692,0,0,,1,4,.250,7,11,18,1,4,2,4,13,19,0.6
1154,Carlton Allen\carlton-allen-1,2015-16,Manhattan,C,7,3,109,8,16,.500,8,16,.500,0,0,,3,3,1.000,7,10,17,1,4,0,8,26,19,0.7
1155,Philipp Hartwich\philipp-hartwich-1,2014-15,Portland,C,24,0,112,7,14,.500,7,14,.500,0,0,,5,15,.333,8,15,23,1,1,8,14,25,19,0.1
1156,Ben Oberfeld\ben-oberfeld-1,2015-16,Bucknell,C,12,0,50,7,13,.538,7,13,.538,0,0,,5,10,.500,7,7,14,0,0,0,5,18,19,0.5
1157,Richmond Aririguzoh\richmond-aririguzoh-1,2016-17,Princeton,C,13,0,66,7,17,.412,7,17,.412,0,0,,5,9,.556,2,11,13,4,3,4,3,7,19,1.2
1158,Joniah White\joniah-white-1,2015-16,Louisiana Tech,C,4,3,89,9,17,.529,9,17,.529,0,0,,1,4,.250,13,6,19,2,1,8,2,12,19,5.4
1159,Jonathan Barnes\jonathan-barnes-1,2016-17,Wyoming,C,15,5,80,6,11,.545,6,11,.545,0,0,,7,11,.636,7,10,17,0,2,2,3,11,19,1.1
1160,Wyatt Walker\wyatt-walker-1,2017-18,Samford,C,2,2,35,7,15,.467,7,15,.467,0,0,,4,5,.800,4,6,10,1,0,1,2,8,18,5.4
1161,Rodney Miller\rodney-miller-1,2017-18,Miami (FL),C,15,0,52,8,14,.571,8,14,.571,0,0,,2,12,.167,3,4,7,0,0,1,3,7,18,0.4
1162,Richard Harward\richard-harward-1,2017-18,Utah Valley,C,14,0,51,6,16,.375,6,16,.375,0,0,,6,12,.500,12,14,26,1,0,5,0,7,18,1.5
1163,Blaise Mbargorba\blaise-mbargorba-1,2016-17,Boston University,C,8,0,77,9,11,.818,9,11,.818,0,0,,0,3,.000,3,9,12,0,1,3,6,15,18,1.1
1164,Marin Maric\marin-maric-1,2013-14,Northern Illinois,C,6,0,53,8,12,.667,8,12,.667,0,0,,2,4,.500,10,5,15,2,1,0,5,4,18,2.7
1165,Hooper Vint\hooper-vint-1,2013-14,Texas-El Paso,C,21,0,149,8,24,.333,8,19,.421,0,5,.000,2,9,.222,9,19,28,7,0,2,8,26,18,0.1
1166,Ismaila Dauda\ismaila-dauda-1,2013-14,Cleveland State,C,23,0,124,7,16,.438,7,16,.438,0,0,,4,4,1.000,6,20,26,0,1,4,7,22,18,0.3
1167,Kevin Bleeker\kevin-bleeker-1,2013-14,Canisius,C,17,0,109,6,15,.400,3,7,.429,3,8,.375,3,5,.600,5,16,21,4,3,1,8,20,18,0.5
1168,Stefan Jovanovic\stefan-jovanovic-1,2013-14,Hawaii,C,10,0,36,7,13,.538,7,13,.538,0,0,,4,6,.667,5,8,13,1,0,2,5,14,18,0.8
1169,Artavious McDyess\artavious-mcdyess-1,2016-17,Arkansas-Pine Bluff,C,28,1,174,5,14,.357,5,14,.357,0,0,,8,20,.400,11,18,29,3,5,8,12,22,18,0.4
1170,Deng Leek\deng-leek-1,2015-16,Southern Illinois,C,19,1,57,8,12,.667,8,12,.667,0,0,,1,4,.250,7,14,21,0,1,7,4,8,17,1.0
1171,Luke Schultz\luke-schultz-1,2017-18,Montana State,C,10,1,49,5,8,.625,5,8,.625,0,0,,7,14,.500,9,7,16,0,2,0,5,11,17,1.2
1172,Nikola Scekic\nikola-scekic-1,2015-16,New Mexico,C,11,0,75,8,15,.533,8,15,.533,0,0,,1,1,1.000,3,5,8,1,1,1,7,15,17,0.2
1173,Nate Pollard\nate-pollard-1,2014-15,Rice,C,25,1,142,6,14,.429,6,14,.429,0,0,,5,9,.556,9,19,28,2,2,5,16,36,17,-0.1
1174,Hannes Polla\hannes-polla-1,2017-18,Oklahoma,C,16,0,49,8,17,.471,8,17,.471,0,0,,1,2,.500,9,8,17,1,0,1,5,9,17,0.6
1175,Corey Hensley\corey-hensley-1,2014-15,Gardner-Webb,C,19,1,121,8,16,.500,8,16,.500,0,0,,1,1,1.000,12,18,30,2,1,4,6,20,17,0.7
1176,Bryce Cashman\bryce-cashman-1,2015-16,North Dakota,C,10,1,86,6,13,.462,6,13,.462,0,0,,5,9,.556,8,10,18,0,2,3,7,24,17,0.5
1177,Ryan Smith\ryan-smith-2,2013-14,Tulane,C,26,3,189,8,16,.500,8,16,.500,0,0,,1,10,.100,12,21,33,1,1,14,12,49,17,0.0
1178,Percy Gibson\percy-gibson-1,2013-14,Iowa State,C,14,0,71,6,15,.400,6,14,.429,0,1,.000,5,7,.714,5,14,19,0,2,5,4,12,17,0.9
1179,Cole Harrison\cole-harrison-1,2015-16,Dartmouth,C,17,0,56,6,18,.333,6,18,.333,0,0,,5,6,.833,7,15,22,3,0,1,4,11,17,0.6
1180,Darcy Malone\darcy-malone-1,2015-16,Louisiana State,C,19,0,138,8,19,.421,8,13,.615,0,6,.000,0,2,.000,7,18,25,4,2,1,14,29,16,-0.2
1181,Bradley Hayes\bradley-hayes-1,2014-15,Georgetown,C,17,0,69,7,11,.636,7,11,.636,0,0,,2,5,.400,12,12,24,2,2,2,2,11,16,1.2
1182,Ugo Okam\ugo-okam-1,2014-15,Bethune-Cookman,C,16,4,114,6,13,.462,6,13,.462,0,0,,4,8,.500,7,8,15,3,1,4,10,18,16,0.2
1183,James Ringholt\james-ringholdt-1,2017-18,Texas-San Antonio,C,10,0,31,4,12,.333,2,4,.500,2,8,.250,6,7,.857,1,8,9,1,0,0,1,4,16,1.0
1184,Andrew Zelis\andrew-zelis-1,2017-18,Northern Illinois,C,11,0,65,7,14,.500,7,14,.500,0,0,,2,4,.500,6,4,10,3,0,4,3,11,16,1.0
1185,Ismaila Dauda\ismaila-dauda-1,2015-16,North Florida,C,15,0,54,4,11,.364,4,11,.364,0,0,,8,13,.615,1,11,12,1,0,1,8,5,16,0.2
1186,Dylan Johns\dylan-johns-1,2014-15,Texas A&M,C,13,0,70,7,12,.583,7,12,.583,0,0,,2,2,1.000,5,6,11,3,1,3,5,11,16,0.9
1187,Peace Ilegomah\peace-ilegomah-1,2017-18,Pittsburgh,C,23,2,133,5,9,.556,5,9,.556,0,0,,6,12,.500,7,15,22,3,2,8,11,44,16,0.0
1188,Cole Walton\cole-walton-1,2016-17,Sacred Heart,C,23,1,159,5,15,.333,5,14,.357,0,1,.000,6,13,.462,12,23,35,5,3,6,6,30,16,0.6
1189,Lucas O'Brien\lucas-obrien-1,2014-15,Texas-San Antonio,C,16,1,65,6,15,.400,5,11,.455,1,4,.250,3,5,.600,3,8,11,1,1,0,9,15,16,-0.1
1190,Conor Voss\conor-voss-1,2015-16,Columbia,C,15,2,54,5,11,.455,5,11,.455,0,0,,6,10,.600,9,3,12,0,2,6,5,5,16,1.0
1191,Andrew Poulter\andrew-poulter-1,2015-16,Purdue-Fort Wayne,C,12,0,40,8,17,.471,8,17,.471,0,0,,0,2,.000,7,4,11,0,0,0,1,4,16,0.8
1192,Marcelo Ruediger\marcelo-ruediger-1,2013-14,Monmouth,C,24,0,112,5,16,.313,5,16,.313,0,0,,6,12,.500,16,12,28,1,2,3,6,17,16,0.5
1193,Stuart Lagerson\stuart-lagerson-1,2013-14,Texas-Arlington,C,15,6,234,6,15,.400,6,14,.429,0,1,.000,4,10,.400,6,42,48,5,4,17,5,27,16,1.7
1194,Corey Young\corey-young-1,2013-14,Alcorn State,C,13,0,61,6,14,.429,3,5,.600,3,9,.333,0,0,,2,6,8,0,0,0,2,1,15,0.6
1195,Travis Avery\travis-avery-1,2013-14,New Orleans,C,17,0,43,5,12,.417,5,12,.417,0,0,,5,7,.714,4,6,10,1,1,2,4,7,15,0.5
1196,Paulius Vinogradovas\paulius-vinogradovas-1,2013-14,Norfolk State,C,23,1,94,7,14,.500,7,14,.500,0,0,,1,6,.167,5,13,18,1,2,0,5,15,15,0.2
1197,James Herrick\james-herrick-1,2015-16,Sacramento State,C,15,0,67,5,13,.385,5,13,.385,0,0,,5,8,.625,7,12,19,1,1,2,8,10,15,0.4
1198,Ted Friedman\ted-friedman-1,2013-14,Northern Iowa,C,21,3,106,3,7,.429,3,7,.429,0,0,,9,13,.692,6,11,17,0,1,1,5,17,15,0.3
1199,Ashtin Chastain\ashtin-chastain-1,2016-17,San Jose State,C,14,0,41,5,6,.833,5,6,.833,0,0,,5,15,.333,1,6,7,1,1,1,3,7,15,0.6
1200,Ibrahima Diallo\ibrahima-diallo-1,2016-17,Rutgers,C,18,0,150,6,27,.222,6,26,.231,0,1,.000,3,8,.375,13,19,32,5,5,11,9,30,15,0.4
1201,Lucas O'Brien\lucas-obrien-1,2013-14,Texas-San Antonio,C,15,0,93,5,14,.357,3,12,.250,2,2,1.000,3,7,.429,8,11,19,1,1,0,2,16,15,0.5
1202,Robert Ojeah\robert-ojeah-1,2015-16,Alabama State,C,13,8,81,6,12,.500,6,12,.500,0,0,,3,9,.333,9,13,22,1,0,1,4,22,15,0.4
1203,John Fenton\john-fenton-1,2013-14,Colgate,C,10,0,38,7,12,.583,7,12,.583,0,0,,1,5,.200,2,5,7,0,0,1,2,12,15,0.5
1204,Travis Avery\travis-avery-1,2015-16,New Orleans,C,21,0,62,5,11,.455,5,11,.455,0,0,,5,8,.625,2,7,9,3,1,1,2,11,15,0.4
1205,Nate Sestina\nate-sestina-1,2015-16,Bucknell,C,4,0,32,6,11,.545,4,8,.500,2,3,.667,1,1,1.000,1,4,5,3,2,0,4,7,15,2.2
1206,Josh Murray\josh-murray-2,2013-14,Jacksonville,C,21,0,149,4,13,.308,4,13,.308,0,0,,7,8,.875,11,18,29,2,4,13,6,19,15,1.0
1207,Josh Murray\josh-murray-2,2014-15,Jacksonville,C,16,0,129,7,21,.333,7,21,.333,0,0,,1,1,1.000,11,9,20,2,6,7,3,11,15,1.2
1208,David Tillman\david-tillman-1,2014-15,Arkansas-Pine Bluff,C,23,2,97,6,10,.600,6,10,.600,0,0,,3,9,.333,8,6,14,2,0,8,9,19,15,0.3
1209,Josh Gomez\josh-gomez-2,2015-16,Bowling Green State,C,8,0,41,5,10,.500,4,8,.500,1,2,.500,3,5,.600,1,6,7,1,3,1,4,10,14,0.9
1210,Julian Roche\julian-roche-1,2017-18,Santa Clara,C,6,0,32,6,8,.750,6,8,.750,0,0,,2,2,1.000,4,1,5,0,1,1,2,4,14,2.0
1211,Rodney Miller\rodney-miller-1,2016-17,Miami (FL),C,14,0,57,5,11,.455,5,11,.455,0,0,,4,9,.444,4,5,9,0,0,1,1,6,14,0.6
1212,Bol Riek\bol-riek-1,2017-18,New Orleans,C,12,1,41,4,8,.500,3,6,.500,1,2,.500,5,9,.556,4,5,9,3,0,6,4,8,14,1.0
1213,Zach Elcano\zach-elcano-1,2013-14,American,C,16,0,91,5,6,.833,5,6,.833,0,0,,4,6,.667,3,8,11,3,2,1,7,18,14,0.4
1214,Mading Thok\mading-thok-1,2014-15,Ball State,C,4,0,23,4,6,.667,4,6,.667,0,0,,6,10,.600,5,4,9,1,0,1,1,6,14,3.1
1215,Youssoupha Mbao\youssoupha-mbao-1,2013-14,Marshall,C,22,1,143,7,9,.778,7,9,.778,0,0,,0,1,.000,4,30,34,0,0,14,7,36,14,0.5
1216,Sooren Derboghosian\sooren-derboghosian-1,2014-15,Drexel,C,8,0,53,6,9,.667,6,9,.667,0,0,,2,3,.667,11,3,14,0,0,0,5,5,14,1.4
1217,Cheikh N'diaye\cheikh-ndiaye-1,2013-14,Oregon State,C,17,0,71,7,8,.875,7,8,.875,0,0,,0,2,.000,1,10,11,4,1,3,3,12,14,0.7
1218,Chris Vogt\chris-vogt-1,2017-18,Northern Kentucky,C,13,0,42,6,10,.600,6,10,.600,0,0,,2,6,.333,0,9,9,3,2,4,2,8,14,0.9
1219,Ted Friedman\ted-friedman-1,2016-17,Northern Iowa,C,29,4,214,6,14,.429,6,14,.429,0,0,,2,12,.167,19,11,30,7,3,3,8,28,14,0.3
1220,Legend Robertin\legend-robertin-1,2016-17,Clemson,C,15,0,97,6,10,.600,6,10,.600,0,0,,2,12,.167,6,8,14,0,1,13,3,17,14,0.8
1221,Gilles Dierickx\gilles-dierickx-1,2014-15,Washington,C,14,3,139,7,24,.292,7,24,.292,0,0,,0,1,.000,11,10,21,4,3,3,8,25,14,0.0
1222,Paul Newman\paul-newman-4,2017-18,Bucknell,C,20,0,74,4,9,.444,4,9,.444,0,0,,6,13,.462,3,15,18,2,4,2,7,8,14,0.5
1223,Bradley Hayes\bradley-hayes-1,2013-14,Georgetown,C,16,0,51,3,8,.375,3,8,.375,0,0,,8,14,.571,5,10,15,1,2,2,3,14,14,0.6
1224,Antonio Vrankovic\antonio-vrankovic-1,2017-18,Duke,C,14,0,66,6,12,.500,6,12,.500,0,0,,2,4,.500,5,10,15,7,0,2,4,11,14,0.8
1225,Matt Heldt\max-heldt-1,2015-16,Marquette,C,20,0,101,4,10,.400,4,10,.400,0,0,,5,9,.556,6,11,17,1,2,3,8,18,13,0.2
1226,Eric Truog\eric-truog-1,2013-14,Marist,C,12,0,65,5,15,.333,5,15,.333,0,0,,3,5,.600,8,8,16,1,0,2,4,10,13,0.5
1227,Mat Piotrowski\mat-piotrowski-1,2014-15,Eastern Illinois,C,17,2,97,6,19,.316,5,9,.556,1,10,.100,0,1,.000,1,21,22,0,2,12,3,9,13,0.7
1228,Admir Besovic\admir-besovic-1,2017-18,Montana,C,18,0,31,6,9,.667,6,9,.667,0,0,,1,1,1.000,2,3,5,1,0,1,2,10,13,0.4
1229,David Tillman\david-tillman-1,2017-18,Arkansas-Pine Bluff,C,21,6,136,5,9,.556,5,9,.556,0,0,,3,7,.429,7,9,16,2,2,7,8,38,13,0.0
1230,Javon Baumann\javon-baumann-1,2015-16,Saint Joseph's,C,23,0,99,4,9,.444,4,9,.444,0,0,,5,12,.417,10,13,23,2,2,3,1,15,13,0.6
1231,Malik Miller\malik-miller-1,2017-18,Fairleigh Dickinson,C,16,0,72,4,20,.200,2,8,.250,2,12,.167,3,4,.750,2,13,15,1,3,6,6,18,13,0.0
1232,Torin Walker\torin-walker-1,2013-14,Middle Tennessee,C,16,1,66,6,20,.300,6,20,.300,0,0,,1,2,.500,6,7,13,1,1,3,6,12,13,0.0
1233,Imoh Silas\imoh-silas-1,2015-16,Siena,C,20,1,98,6,15,.400,6,15,.400,0,0,,1,3,.333,6,14,20,3,3,11,12,26,13,0.1
1234,Lloyd Burgess\lloyd-burgess-1,2016-17,North Carolina-Greensboro,C,10,0,75,5,8,.625,5,8,.625,0,0,,3,8,.375,8,6,14,3,1,2,8,11,13,0.7
1235,Andrew Poulter\andrew-poulter-1,2013-14,Little Rock,C,7,0,13,6,9,.667,6,9,.667,0,0,,0,0,,0,3,3,0,0,0,0,1,12,1.2
1236,Grant Verhoeven\grant-verhoeven-1,2014-15,Stanford,C,8,4,92,5,12,.417,5,12,.417,0,0,,2,4,.500,10,8,18,4,3,4,3,16,12,1.7
1237,Jermaine Davis\jermaine-davis-1,2013-14,La Salle,C,14,0,43,4,7,.571,4,7,.571,0,0,,4,7,.571,3,9,12,0,0,1,6,8,12,0.3
1238,Tom Pupavac\tom-pupavac-1,2017-18,Winthrop,C,17,0,58,5,10,.500,5,10,.500,0,0,,2,3,.667,7,7,14,1,0,2,4,6,12,0.5
1239,Chauncy Parker\chauncy-parker-1,2014-15,Arkansas-Pine Bluff,C,25,2,176,4,13,.308,4,12,.333,0,1,.000,4,6,.667,3,16,19,12,8,15,14,22,12,0.6
1240,Tyler McCullough\tyler-mccullough-1,2016-17,Missouri State,C,21,0,149,4,13,.308,4,13,.308,0,0,,4,9,.444,12,15,27,2,0,4,4,27,12,0.2
1241,Blair Orr\blair-orr-1,2017-18,Cal State Northridge,C,10,0,38,5,9,.556,5,9,.556,0,0,,2,2,1.000,4,2,6,0,0,2,2,6,12,0.8
1242,Cole Harrison\cole-harrison-1,2013-14,Dartmouth,C,7,1,75,5,14,.357,5,14,.357,0,0,,2,6,.333,8,10,18,1,0,4,4,16,12,0.6
1243,Chinonso Obokoh\chinonso-obokoh-1,2015-16,Syracuse,C,11,0,67,5,8,.625,5,8,.625,0,0,,2,7,.286,4,14,18,1,3,5,3,21,12,0.8
1244,David Tillman\david-tillman-1,2015-16,Arkansas-Pine Bluff,C,24,3,144,6,14,.429,6,14,.429,0,0,,0,7,.000,3,7,10,4,1,12,9,28,12,-0.1
1245,Bennett Davis\bennett-davis-1,2015-16,Mississippi Valley State,C,10,2,43,6,7,.857,6,7,.857,0,0,,0,2,.000,5,4,9,0,0,0,5,9,12,0.5
1246,Paschal Chukwu\paschal-chukwu-1,2016-17,Syracuse,C,7,0,108,6,9,.667,6,9,.667,0,0,,0,9,.000,11,18,29,2,3,14,10,15,12,2.3
1247,Sergej Vucetic\sergej-vucetic-1,2015-16,Evansville,C,11,0,40,5,8,.625,5,8,.625,0,0,,2,4,.500,1,2,3,2,0,3,4,6,12,0.5
1248,Kieffer Jordan\kieffer-jordan-1,2013-14,Army,C,16,0,92,4,14,.286,3,8,.375,1,6,.167,3,5,.600,4,12,16,5,1,2,4,20,12,0.2
1249,Dougal Weir\dougal-weir-1,2015-16,Hartford,C,24,7,155,5,9,.556,5,8,.625,0,1,.000,2,2,1.000,7,15,22,5,3,2,4,24,12,0.5
1250,Sam Japhet-Mathias\sam-japhet-mathias-1,2016-17,Wake Forest,C,17,0,69,5,10,.500,5,10,.500,0,0,,2,2,1.000,7,8,15,1,0,4,7,22,12,0.1
1251,John Miller\john-miller-1,2016-17,Army,C,20,0,61,6,13,.462,6,13,.462,0,0,,0,3,.000,3,7,10,2,0,4,3,11,12,0.3
1252,Isaiah Manderson\isaiah-manderson-1,2015-16,Texas Tech,C,4,0,44,5,11,.455,5,10,.500,0,1,.000,2,3,.667,2,5,7,0,0,0,4,3,12,0.9
1253,David Tillman\david-tillman-1,2016-17,Arkansas-Pine Bluff,C,18,1,117,5,10,.500,5,10,.500,0,0,,1,2,.500,8,12,20,2,4,9,10,25,11,0.4
1254,Will Childs-Klein\will-childs-klein-1,2013-14,Yale,C,9,0,36,5,12,.417,4,9,.444,1,3,.333,0,0,,0,4,4,3,0,1,5,5,11,0.2
1255,Charles Smith\charles-smith-6,2015-16,Lipscomb,C,10,0,39,1,6,.167,1,6,.167,0,0,,9,12,.750,2,1,3,0,0,3,1,4,11,0.7
1256,Mac Brydon\mac-brydon-1,2017-18,Mercer,C,13,1,37,3,4,.750,3,4,.750,0,0,,5,7,.714,3,4,7,1,0,1,1,3,11,0.9
1257,Johnny Hamilton\johnny-hamilton-1,2016-17,Virginia Tech,C,3,0,21,4,4,1.000,4,4,1.000,0,0,,3,6,.500,3,1,4,0,2,1,0,3,11,4.2
1258,Asbjorn Midtgaard\asbjorn-midtgaard-1,2017-18,Wichita State,C,8,0,49,5,10,.500,5,10,.500,0,0,,1,2,.500,3,14,17,0,1,2,3,7,11,1.1
1259,Cole Walton\cole-walton-1,2015-16,Sacred Heart,C,15,5,112,4,14,.286,4,14,.286,0,0,,3,4,.750,9,11,20,2,2,2,4,20,11,0.3
1260,Ryan Okwudibonye\ryan-okwudibonye-1,2013-14,Sacramento State,C,7,0,22,4,6,.667,4,6,.667,0,0,,3,3,1.000,3,5,8,0,1,0,4,4,11,1.1
1261,Charles Smith\charles-smith-6,2013-14,Lipscomb,C,4,0,39,4,7,.571,4,7,.571,0,0,,3,4,.750,1,6,7,0,1,1,2,12,11,1.2
1262,Schnider Herard\schnider-herard-1,2017-18,Mississippi State,C,11,0,88,4,15,.267,4,15,.267,0,0,,3,7,.429,11,12,23,0,0,8,11,12,11,0.1
1263,Nick Detlev\nick-detlev-1,2016-17,Tennessee-Martin,C,7,0,20,5,6,.833,5,6,.833,0,0,,0,0,,1,3,4,0,0,3,3,3,10,1.0
1264,Travis Avery\travis-avery-1,2014-15,New Orleans,C,14,0,40,4,7,.571,4,7,.571,0,0,,2,6,.333,0,3,3,1,1,0,2,9,10,0.2
1265,Corbin Kaufusi\corbin-kaufasi-1,2016-17,Brigham Young,C,16,0,86,4,10,.400,4,10,.400,0,0,,2,7,.286,6,9,15,0,2,4,9,18,10,-0.1
1266,Conor Voss\conor-voss-1,2014-15,Columbia,C,19,0,61,3,9,.333,3,9,.333,0,0,,4,6,.667,2,12,14,1,0,0,5,13,10,0.0
1267,Robert Ojeah\robert-ojeah-1,2014-15,Alabama State,C,8,0,40,4,9,.444,4,9,.444,0,0,,2,2,1.000,4,8,12,0,1,3,4,10,10,0.7
1268,Mawdo Sallah\mawdo-sallah-1,2014-15,Mount St. Mary's,C,15,3,99,5,10,.500,5,10,.500,0,0,,0,3,.000,8,10,18,2,0,11,3,16,10,0.8
1269,Chinonso Obokoh\chinonso-obokoh-1,2016-17,St. Bonaventure,C,5,3,55,5,10,.500,5,10,.500,0,0,,0,1,.000,3,5,8,0,1,7,5,15,10,0.6
1270,Austin Gillmann\austin-gillmann-1,2016-17,Saint Louis,C,25,1,134,5,13,.385,5,7,.714,0,6,.000,0,3,.000,7,17,24,6,1,4,10,28,10,-0.1
1271,Sean Damaska\sean-damaska-1,2016-17,Northern Illinois,C,7,0,18,4,6,.667,4,6,.667,0,0,,2,3,.667,3,5,8,1,0,0,1,3,10,1.3
1272,Jermaine Davis\jermaine-davis-1,2015-16,Texas Southern,C,5,1,58,1,7,.143,0,5,.000,1,2,.500,7,10,.700,2,7,9,2,0,0,6,9,10,-0.1
1273,Aaron Liberman\aaron-liberman-1,2014-15,Tulane,C,13,0,45,5,7,.714,5,7,.714,0,0,,0,2,.000,3,2,5,2,1,3,2,8,10,0.6
1274,Daouda Soumaoro\daouda-soumaoro-1,2013-14,Western Kentucky,C,9,4,52,0,3,.000,0,3,.000,0,0,,10,10,1.000,4,8,12,0,1,2,0,6,10,1.5
1275,Carson Shanks\carson-shanks-1,2017-18,Loyola (IL),C,13,0,30,4,8,.500,4,7,.571,0,1,.000,2,2,1.000,0,4,4,1,0,1,1,5,10,0.4
1276,Khadim Dieng\khadim-dieng-1,2014-15,Western Michigan,C,12,0,53,4,7,.571,4,7,.571,0,0,,2,6,.333,1,10,11,1,0,2,3,8,10,0.4
1277,Artis Cleveland\artis-cleveland-1,2016-17,Alabama State,C,10,0,40,3,6,.500,3,6,.500,0,0,,4,7,.571,5,4,9,1,0,3,5,11,10,0.4
1278,Chinonso Obokoh\chinonso-obokoh-1,2014-15,Syracuse,C,13,0,89,4,6,.667,4,6,.667,0,0,,2,4,.500,10,11,21,3,3,4,1,19,10,1.2
1279,Cole Walton\cole-walton-1,2014-15,Sacred Heart,C,5,0,55,4,10,.400,4,10,.400,0,0,,1,2,.500,6,7,13,1,1,1,3,5,9,1.4
1280,Tanveer Bhullar\tanveer-bhullar-1,2014-15,New Mexico State,C,10,0,43,4,11,.364,4,11,.364,0,0,,1,2,.500,1,2,3,2,1,2,3,7,9,0.2
1281,Jake Campbell\jake-campbell-1,2014-15,Presbyterian,C,12,0,78,3,6,.500,3,6,.500,0,0,,3,4,.750,1,8,9,2,0,0,3,8,9,0.3
1282,Toriano Stokes\toriano-stokes-1,2015-16,East Tennessee State,C,11,0,47,4,8,.500,4,8,.500,0,0,,1,4,.250,5,6,11,0,0,6,1,6,9,0.9
1283,Deng Leek\deng-leek-1,2014-15,Southern Illinois,C,12,0,57,4,5,.800,4,5,.800,0,0,,1,5,.200,0,6,6,2,0,8,1,8,9,0.8
1284,Christian Kennedy\christian-kennedy-1,2015-16,Lamar,C,16,0,85,4,17,.235,4,16,.250,0,1,.000,1,8,.125,8,8,16,0,2,16,5,18,9,0.3
1285,Collin McManus\collin-mcmanus-1,2015-16,Pennsylvania,C,9,0,23,3,7,.429,3,7,.429,0,0,,3,4,.750,3,3,6,0,0,1,1,1,9,0.8
1286,Osahen Iduwe\osahen-iduwe-1,2015-16,Georgia,C,17,0,53,2,5,.400,2,5,.400,0,0,,5,10,.500,3,5,8,0,0,1,2,15,9,0.0
1287,Joey De La Rosa\joey-de-la-rosa-1,2014-15,St. John's (NY),C,18,2,85,4,10,.400,4,10,.400,0,0,,1,7,.143,6,10,16,0,1,3,3,20,9,0.0
1288,Leston Gordon\leston-gordon-1,2017-18,New Mexico State,C,18,0,36,4,9,.444,4,9,.444,0,0,,1,4,.250,5,6,11,2,1,0,4,10,9,0.2
1289,Lloyd Burgess\lloyd-burgess-1,2017-18,North Carolina-Greensboro,C,5,0,33,3,3,1.000,3,3,1.000,0,0,,3,7,.429,5,4,9,0,0,0,4,7,9,0.9
1290,Brendan Leonard\brendan-leonard-1,2016-17,Air Force,C,2,0,10,3,6,.500,1,2,.500,2,4,.500,0,0,,2,1,3,1,0,0,0,1,8,3.5
1291,Terry Tidwell\terry-tidwell-1,2013-14,Central Arkansas,C,5,3,61,4,10,.400,4,10,.400,0,0,,0,0,,1,5,6,1,2,2,8,7,8,-0.4
1292,Nate Gehring\nate-gehring-1,2014-15,Pepperdine,C,13,4,97,3,7,.429,3,7,.429,0,0,,2,2,1.000,3,12,15,4,6,1,3,4,8,1.1
1293,Ivan Jurkovic\ivan-jurkovic-1,2013-14,Florida International,C,22,1,114,3,14,.214,3,13,.231,0,1,.000,2,2,1.000,4,7,11,1,1,0,7,24,8,-0.5
1294,D'Andre Johnson\dandre-johnson-2,2017-18,North Carolina A&T,C,13,1,40,3,11,.273,3,7,.429,0,4,.000,2,5,.400,3,7,10,2,0,4,2,8,8,0.3
1295,Dougal Weir\dougal-weir-1,2014-15,Hartford,C,16,0,57,4,10,.400,4,10,.400,0,0,,0,0,,4,6,10,1,0,1,3,11,8,0.1
1296,Griffin Peevey\griffin-peevey-1,2016-17,Citadel,C,2,0,7,3,5,.600,3,5,.600,0,0,,2,2,1.000,3,0,3,0,0,0,0,0,8,3.9
1297,Valentine Sangoyomi\valentine-sangoyomi-1,2017-18,Houston,C,13,0,58,2,10,.200,2,10,.200,0,0,,4,6,.667,4,12,16,2,0,1,6,7,8,0.1
1298,Legend Robertin\legend-robertin-1,2015-16,Clemson,C,10,0,44,4,8,.500,4,8,.500,0,0,,0,1,.000,2,4,6,0,1,4,2,12,8,0.3
1299,Brian Hornstein\brian-hornstein-1,2014-15,Florida Atlantic,C,14,0,66,4,15,.267,4,14,.286,0,1,.000,0,0,,4,2,6,0,2,4,2,9,8,0.1
1300,Robert Puleikis\robert-puleikis-1,2013-14,Drake,C,8,0,17,3,4,.750,3,4,.750,0,0,,2,5,.400,2,1,3,0,1,0,0,1,8,0.9
1301,Gabe Brown\gabe-brown-1,2014-15,American,C,12,0,45,2,12,.167,2,12,.167,0,0,,3,4,.750,5,2,7,3,0,5,4,4,7,0.3
1302,Blake Vedder\blake-vedder-1,2014-15,Kent State,C,13,1,13,3,6,.500,2,2,1.000,1,4,.250,0,0,,0,1,1,0,0,0,2,2,7,0.1
1303,Josh Coleman\josh-coleman-1,2015-16,Coastal Carolina,C,10,0,30,2,6,.333,2,6,.333,0,0,,3,3,1.000,6,6,12,0,0,2,3,11,7,0.4
1304,Schuyler Rimmer\schuyler-rimmer-1,2013-14,Stanford,C,14,0,69,3,9,.333,3,9,.333,0,0,,1,7,.143,1,8,9,0,0,1,5,11,7,-0.4
1305,Nathaniel Musters\nathaniel-musters-1,2014-15,Lafayette,C,24,0,109,3,5,.600,3,5,.600,0,0,,1,3,.333,5,11,16,1,4,3,3,16,7,0.3
1306,Christian McCoggle\christian-mccoggle-1,2014-15,Texas Southern,C,10,2,94,2,6,.333,2,6,.333,0,0,,3,9,.333,12,16,28,2,1,4,3,16,7,1.0
1307,James Hunter\james-hunter-1,2013-14,Washington State,C,9,0,17,3,5,.600,3,5,.600,0,0,,1,5,.200,1,2,3,0,2,1,2,1,7,0.5
1308,Kevin Ndahiro\kevin-ndahiro-1,2015-16,Stetson,C,7,0,51,3,10,.300,3,10,.300,0,0,,1,4,.250,3,9,12,0,0,5,5,13,7,-0.3
1309,Carlton Allen\carlton-allen-1,2013-14,Manhattan,C,26,0,83,1,7,.143,1,7,.143,0,0,,5,10,.500,4,5,9,0,1,6,4,26,7,-0.2
1310,Charles Smith\charles-smith-6,2014-15,Lipscomb,C,17,0,68,3,7,.429,3,7,.429,0,0,,1,5,.200,7,4,11,1,0,4,1,7,7,0.4
1311,Caleb Sedore\caleb-sedore-1,2017-18,Lehigh,C,8,0,35,3,6,.500,3,5,.600,0,1,.000,1,4,.250,1,5,6,0,0,0,2,9,7,-0.1
1312,John Hawkins\john-hawkins-1,2014-15,Miami (OH),C,8,0,34,3,8,.375,3,7,.429,0,1,.000,1,2,.500,1,7,8,0,1,0,1,2,7,0.5
1313,Samba Ndiaye\samba-ndiaye-1,2017-18,College of Charleston,C,20,0,76,3,11,.273,3,11,.273,0,0,,1,4,.250,11,14,25,0,0,5,6,18,7,0.1
1314,Jake Gilliam\jake-gilliam-1,2017-18,San Diego,C,3,0,7,3,5,.600,3,5,.600,0,0,,1,5,.200,4,1,5,0,0,0,1,3,7,1.3
1315,Cole Israelson\cole-israelson-1,2016-17,Central Michigan,C,10,0,18,2,3,.667,2,3,.667,0,0,,3,4,.750,2,4,6,0,0,0,1,6,7,0.5
1316,Sylvester Ogbonda\sylvester-ogbonda-1,2017-18,Georgia Tech,C,9,0,21,3,5,.600,3,5,.600,0,0,,1,3,.333,3,4,7,0,0,3,5,5,7,0.3
1317,Jake Campbell\jake-campbell-1,2013-14,Presbyterian,C,24,0,120,3,8,.375,3,8,.375,0,0,,1,2,.500,1,11,12,2,2,0,4,19,7,-0.1
1318,Ak Ojo\ak-ojo-1,2015-16,Manhattan,C,5,3,48,2,2,1.000,2,2,1.000,0,0,,2,9,.222,1,11,12,0,2,3,10,15,6,-1.1
1319,Bobby Garbade\bobby-garbade-1,2013-14,Princeton,C,16,0,51,2,7,.286,1,3,.333,1,4,.250,1,2,.500,1,9,10,7,0,1,2,8,6,0.3
1320,Elbert Robinson\elbert-robinson-1,2014-15,Louisiana State,C,11,4,68,3,7,.429,3,7,.429,0,0,,0,2,.000,6,11,17,5,5,3,9,13,6,0.5
1321,Stuart Nezlek\stuart-nezlek-1,2016-17,Iowa State,C,4,0,9,2,5,.400,2,5,.400,0,0,,2,2,1.000,1,2,3,1,1,0,0,0,6,1.6
1322,Collin McManus\collin-mcmanus-1,2016-17,Pennsylvania,C,11,0,15,3,4,.750,3,4,.750,0,0,,0,0,,1,3,4,0,0,1,1,3,6,0.4
1323,Joey De La Rosa\joey-de-la-rosa-1,2013-14,Florida International,C,7,0,41,2,10,.200,2,10,.200,0,0,,2,6,.333,6,7,13,1,0,2,0,5,6,0.7
1324,Paulius Vinogradovas\paulius-vinogradovas-1,2014-15,Norfolk State,C,27,7,120,1,11,.091,1,11,.091,0,0,,4,10,.400,8,9,17,1,1,3,7,19,6,-0.2
1325,Daniel Wallace\daniel-wallace-1,2016-17,Saint Francis (PA),C,16,2,77,2,6,.333,2,6,.333,0,0,,2,6,.333,2,16,18,5,0,2,7,11,6,0.0
1326,Corey Hensley\corey-hensley-1,2013-14,Gardner-Webb,C,9,0,39,3,6,.500,3,6,.500,0,0,,0,0,,3,4,7,0,1,0,1,5,6,0.5
1327,Ben Oberfeld\ben-oberfeld-1,2013-14,Bucknell,C,6,0,29,3,8,.375,3,8,.375,0,0,,0,0,,3,3,6,1,0,1,0,1,6,0.9
1328,James Herrick\james-herrick-1,2016-17,Sacramento State,C,9,0,11,3,3,1.000,3,3,1.000,0,0,,0,0,,1,0,1,0,0,0,1,1,6,0.5
1329,Dajour Dickens\dajour-dickens-1,2017-18,Providence,C,3,0,10,3,5,.600,3,5,.600,0,0,,0,0,,0,3,3,0,0,1,0,1,6,1.6
1330,Jeremiah April\jeremiah-april-1,2014-15,Indiana,C,4,0,17,3,3,1.000,3,3,1.000,0,0,,0,0,,1,4,5,1,1,2,1,4,6,1.9
1331,James McDonnell\james-mcdonnell-1,2013-14,Massachusetts-Lowell,C,4,0,28,3,3,1.000,3,3,1.000,0,0,,0,0,,1,2,3,0,0,1,1,3,6,1.2
1332,Sam Japhet-Mathias\sam-japhet-mathias-1,2017-18,Wake Forest,C,6,0,44,3,5,.600,3,5,.600,0,0,,0,0,,5,3,8,0,0,0,3,8,6,0.3
1333,Matt Willms\matt-willms-1,2015-16,Texas-El Paso,C,2,2,23,2,4,.500,2,4,.500,0,0,,2,4,.500,2,4,6,0,0,0,3,3,6,0.8
1334,Demetrice Clopton\demetrice-clopton-1,2016-17,Jackson State,C,6,0,33,3,6,.500,3,6,.500,0,0,,0,2,.000,3,0,3,0,0,0,1,1,6,0.5
1335,Ikenna Okwarabizie\ikenna-okwarabizie-1,2017-18,UCLA,C,8,0,29,3,5,.600,3,4,.750,0,1,.000,0,0,,2,7,9,0,1,1,1,4,6,0.8
1336,Stephen Osu\stephen-osu-1,2017-18,Presbyterian,C,8,1,31,3,6,.500,3,6,.500,0,0,,0,0,,10,5,15,0,0,0,3,4,6,0.9
1337,Dennis Clifford\dennis-clifford-1,2013-14,Boston College,C,2,0,33,3,4,.750,3,4,.750,0,0,,0,0,,2,7,9,1,0,2,2,3,6,3.4
1338,Gabe Brown\gabe-brown-1,2015-16,American,C,3,0,17,3,4,.750,3,4,.750,0,0,,0,1,.000,1,0,1,2,0,1,4,3,6,0.5
1339,James Stawarz\james-stawarz-1,2014-15,Illinois State,C,6,0,14,3,4,.750,3,4,.750,0,0,,0,2,.000,1,1,2,0,1,0,1,2,6,0.6
1340,Jon Teske\jon-teske-1,2016-17,Michigan,C,20,0,60,1,7,.143,1,6,.167,0,1,.000,3,6,.500,7,5,12,2,2,6,1,10,5,0.4
1341,Kieffer Jordan\kieffer-jordan-1,2014-15,Army,C,10,0,60,2,5,.400,2,5,.400,0,0,,1,4,.250,4,8,12,2,0,1,3,11,5,0.1
1342,Ryan Keenan\ryan-keenan-2,2015-16,Pepperdine,C,10,0,41,2,3,.667,2,3,.667,0,0,,1,4,.250,2,2,4,1,0,0,3,7,5,-0.1
1343,Stephen Osu\stephen-osu-1,2014-15,Presbyterian,C,10,0,19,1,4,.250,1,4,.250,0,0,,3,6,.500,3,1,4,1,0,0,1,2,5,0.3
1344,Stephen Osu\stephen-osu-1,2016-17,Presbyterian,C,6,0,14,2,3,.667,2,3,.667,0,0,,1,4,.250,0,3,3,1,1,0,0,3,5,0.7
1345,Christian McCoggle\christian-mccoggle-1,2015-16,Texas Southern,C,5,0,15,1,4,.250,1,4,.250,0,0,,3,5,.600,3,2,5,0,0,0,0,1,5,0.8
1346,Willie Rosenthal\willie-rosenthal-1,2013-14,Chicago State,C,4,0,22,2,5,.400,2,5,.400,0,0,,1,2,.500,3,0,3,0,2,0,2,9,5,0.1
1347,Nate Wells\nate-wells-1,2013-14,Bradley,C,17,2,49,2,5,.400,2,5,.400,0,0,,1,2,.500,3,7,10,0,1,2,1,12,5,0.2
1348,Darius Lewis\darius-lewis-1,2013-14,Duquesne,C,10,0,46,2,3,.667,2,3,.667,0,0,,1,6,.167,6,7,13,1,3,2,3,13,5,0.5
1349,Evan Anderson\evan-anderson-1,2013-14,Wisconsin,C,14,0,36,2,6,.333,1,2,.500,1,4,.250,0,0,,0,3,3,1,0,3,2,9,5,0.0
1350,James Ringholt\james-ringholdt-1,2016-17,Texas-San Antonio,C,12,0,51,1,5,.200,0,0,,1,5,.200,2,4,.500,1,5,6,1,0,1,0,5,5,0.2
1351,Stephen Osu\stephen-osu-1,2015-16,Presbyterian,C,5,0,18,2,8,.250,2,8,.250,0,0,,1,4,.250,4,4,8,0,0,0,2,2,5,0.0
1352,Darius Harper\darius-harper-1,2017-18,Miami (OH),C,6,0,23,2,3,.667,2,3,.667,0,0,,0,0,,1,3,4,0,0,0,2,8,4,-0.2
1353,David Onuorah\david-onuorah-1,2016-17,Cornell,C,1,1,20,2,4,.500,2,4,.500,0,0,,0,0,,1,4,5,0,0,1,1,0,4,3.6
1354,Isaiah Manderson\isaiah-manderson-1,2016-17,South Florida,C,5,0,29,2,9,.222,2,9,.222,0,0,,0,1,.000,5,2,7,0,1,0,1,4,4,0.1
1355,Tao Xu\tao-xu-1,2013-14,San Francisco,C,9,0,51,2,7,.286,2,7,.286,0,0,,0,0,,1,4,5,1,0,1,9,12,4,-1.2
1356,Collin McManus\collin-mcmanus-1,2017-18,Pennsylvania,C,9,0,22,2,2,1.000,2,2,1.000,0,0,,0,0,,2,2,4,2,0,1,0,0,4,0.8
1357,Antonio Vrankovic\antonio-vrankovic-1,2015-16,Duke,C,5,0,14,2,2,1.000,2,2,1.000,0,0,,0,0,,2,5,7,0,1,1,3,3,4,0.8
1358,Chris Sodom\chris-sodom-1,2017-18,Georgetown,C,6,0,27,2,4,.500,2,4,.500,0,0,,0,0,,3,5,8,0,0,3,2,11,4,0.2
1359,Brandon Charnov\brandon-charnov-1,2016-17,Brown,C,3,0,11,1,2,.500,1,2,.500,0,0,,2,2,1.000,1,2,3,0,1,0,1,0,4,1.4
1360,Joseph Uchebo\joseph-uchebo-1,2013-14,Pittsburgh,C,9,0,23,2,5,.400,2,5,.400,0,0,,0,0,,2,5,7,0,2,0,1,4,4,0.4
1361,Nathan Smith\nathan-smith-2,2015-16,Western Kentucky,C,3,0,15,0,2,.000,0,2,.000,0,0,,4,4,1.000,1,2,3,0,0,0,1,3,4,0.6
1362,Rich Kalina\rich-kalina-1,2015-16,Chattanooga,C,4,0,14,2,4,.500,2,4,.500,0,0,,0,1,.000,3,4,7,0,0,2,2,3,4,0.8
1363,Payton Pervier\payton-pervier-1,2015-16,Old Dominion,C,3,0,27,1,8,.125,1,8,.125,0,0,,2,5,.400,3,3,6,0,0,2,2,4,4,-0.5
1364,Kyle Buffkin\kyle-buffkin-1,2013-14,Coastal Carolina,C,13,0,60,2,4,.500,2,4,.500,0,0,,0,3,.000,1,5,6,0,0,1,3,22,4,-0.6
1365,Nick Detlev\nick-detlev-1,2015-16,Tennessee-Martin,C,6,0,10,1,3,.333,1,3,.333,0,0,,2,4,.500,0,2,2,0,0,2,0,1,4,0.5
1366,Reginald Giles\reginald-giles-3,2017-18,Delaware State,C,2,0,15,2,5,.400,2,5,.400,0,0,,0,0,,1,3,4,0,0,0,0,1,4,1.3
1367,Sean Young\sean-young-1,2013-14,Central Arkansas,C,1,0,7,2,3,.667,2,3,.667,0,0,,0,0,,0,1,1,0,0,0,0,4,4,1.4
1368,Emmanuel Ezechinonso\emmanuel-ezechinonso-1,2014-15,Tulsa,C,13,0,37,1,2,.500,1,2,.500,0,0,,2,2,1.000,1,7,8,0,0,0,3,8,4,0.0
1369,Jordan Omogbehin\jordan-omogbehin-1,2014-15,Morgan State,C,10,0,30,2,5,.400,2,5,.400,0,0,,0,4,.000,5,3,8,1,1,2,3,9,4,0.1
1370,Justin Van Pelt\justin-vanpelt-1,2017-18,Sam Houston State,C,5,0,14,2,2,1.000,2,2,1.000,0,0,,0,0,,0,6,6,0,0,0,2,4,4,0.3
1371,Tobe Okafor\tobe-oakafor-1,2014-15,Grand Canyon,C,5,3,41,2,10,.200,2,10,.200,0,0,,0,0,,1,4,5,0,0,3,3,9,4,-1.0
1372,Daniel Huenermann\daniel-huenermann-1,2017-18,Indiana State,C,7,0,13,1,4,.250,1,3,.333,0,1,.000,2,4,.500,1,2,3,0,0,0,0,3,4,0.1
1373,Ibrahima Diallo\ibrahima-diallo-1,2017-18,Manhattan,C,7,0,16,1,4,.250,1,4,.250,0,0,,2,3,.667,3,6,9,0,0,0,3,5,4,0.0
1374,Matt Pollard\matt-pollard-1,2014-15,San Jose State,C,5,0,59,2,9,.222,2,9,.222,0,0,,0,2,.000,3,10,13,1,1,3,4,14,4,-0.6
1375,James Herrick\james-herrick-1,2014-15,Sacramento State,C,3,0,9,1,2,.500,1,2,.500,0,0,,2,2,1.000,2,3,5,0,0,0,0,1,4,1.6
1376,Lamont Prosser\lamont-prosser-1,2013-14,Portland State,C,2,0,6,1,1,1.000,1,1,1.000,0,0,,2,4,.500,1,2,3,0,0,0,0,1,4,1.9
1377,Sergej Vucetic\sergei-vucetic-1,2013-14,Nebraska,C,7,0,16,2,2,1.000,2,2,1.000,0,0,,0,2,.000,1,3,4,0,0,1,0,0,4,0.7
1378,Brendan Leonard\brendan-leonard-1,2015-16,Air Force,C,3,0,9,0,1,.000,0,0,,0,1,.000,3,4,.750,1,1,2,0,0,0,2,0,3,0.3
1379,Deng Riak\deng-riak-1,2015-16,East Carolina,C,8,1,45,1,8,.125,0,3,.000,1,5,.200,0,0,,2,6,8,2,1,2,3,7,3,-0.1
1380,Devonte' Neal\devonte-neal-1,2013-14,Alabama State,C,1,0,5,0,2,.000,0,2,.000,0,0,,3,4,.750,3,0,3,0,0,0,0,0,3,3.3
1381,Chier Ajou\chier-ajou-1,2014-15,Seton Hall,C,10,1,38,0,3,.000,0,3,.000,0,0,,3,4,.750,4,6,10,1,1,1,1,9,3,0.3
1382,Olumide Solanke\olumide-solanke-1,2013-14,Detroit Mercy,C,10,0,22,0,3,.000,0,3,.000,0,0,,3,4,.750,1,4,5,0,0,1,1,11,3,-0.2
1383,Daniel Wallace\daniel-wallace-1,2014-15,Saint Francis (PA),C,6,0,17,1,3,.333,1,3,.333,0,0,,1,2,.500,0,3,3,0,0,1,3,3,3,-0.3
1384,Gilles Dierickx\gilles-dierickx-1,2013-14,Washington,C,14,0,71,1,8,.125,1,8,.125,0,0,,1,2,.500,4,6,10,2,1,6,6,17,3,-0.3
1385,Chisom Obidike\chisom-obidike-1,2017-18,Florida Atlantic,C,4,0,9,1,1,1.000,1,1,1.000,0,0,,1,3,.333,0,1,1,0,0,0,1,3,3,0.0
1386,Jordan Omogbehin\jordan-omogbehin-1,2013-14,South Florida,C,9,0,24,1,1,1.000,1,1,1.000,0,0,,1,2,.500,2,5,7,0,0,3,2,5,3,0.4
1387,Tony Sabato\tony-sabato-1,2015-16,Elon,C,6,1,15,1,2,.500,1,2,.500,0,0,,1,3,.333,0,3,3,1,0,0,1,1,3,0.2
1388,Garrett Mullis\garrett-mullis-1,2015-16,Citadel,C,1,0,11,1,2,.500,0,1,.000,1,1,1.000,0,0,,0,4,4,0,0,0,1,3,3,1.0
1389,Cole Israelson\cole-israelson-1,2014-15,Central Michigan,C,5,0,10,1,6,.167,1,6,.167,0,0,,1,2,.500,0,1,1,0,0,2,0,1,3,0.0
1390,Buay Koka\buay-koka-1,2017-18,Tulane,C,7,0,27,1,4,.250,1,4,.250,0,0,,1,1,1.000,3,9,12,0,1,3,4,6,3,0.3
1391,Justin Stangel\justin-stangel-1,2014-15,Oregon State,C,10,1,30,1,2,.500,1,2,.500,0,0,,1,2,.500,1,3,4,0,0,1,3,10,3,-0.3
1392,Frank Toohey\frank-toohey-1,2014-15,Air Force,C,6,0,18,1,2,.500,1,2,.500,0,0,,1,6,.167,2,5,7,1,0,0,0,3,3,0.4
1393,Ray Barreno\ray-barreno-1,2013-14,Tulane,C,7,0,20,1,4,.250,1,4,.250,0,0,,0,0,,2,1,3,0,0,1,2,3,2,-0.2
1394,Miles Washington\miles-washington-1,2016-17,Mississippi State,C,6,0,13,1,3,.333,1,2,.500,0,1,.000,0,0,,0,0,0,0,0,1,0,3,2,0.0
1395,Karl Overstreet\karl-overstreet-1,2017-18,East Tennessee State,C,2,0,3,1,1,1.000,1,1,1.000,0,0,,0,0,,0,0,0,0,0,0,0,0,2,0.9
1396,Stuart Nezlek\stuart-nezlek-1,2015-16,Iowa State,C,7,0,9,1,2,.500,1,2,.500,0,0,,0,0,,0,1,1,0,0,0,3,1,2,-0.3
1397,Emmanuel Okoro\emmanuel-okoro-1,2013-14,Howard,C,7,0,11,1,1,1.000,1,1,1.000,0,0,,0,2,.000,4,1,5,0,0,0,0,1,2,0.5
1398,Geoffrey Frid\geoffrey-frid-1,2014-15,Northern Arizona,C,11,0,33,1,1,1.000,1,1,1.000,0,0,,0,0,,0,4,4,1,2,0,0,11,2,0.1
1399,Ikenna Okwarabizie\ikenna-okwarabizie-1,2016-17,UCLA,C,12,0,31,0,2,.000,0,2,.000,0,0,,2,6,.333,1,6,7,0,1,0,3,4,2,-0.2
1400,Derek Mountain\derek-mountain-1,2015-16,Holy Cross,C,4,0,7,1,3,.333,1,3,.333,0,0,,0,0,,1,2,3,0,0,0,1,1,2,0.1
1401,Kye Kurkowski\kye-kurkowski-1,2014-15,Nebraska,C,7,0,12,1,2,.500,1,2,.500,0,0,,0,0,,2,1,3,0,0,0,1,0,2,0.2
1402,Peter Jurkin\peter-jurkin-1,2013-14,Indiana,C,8,0,11,0,3,.000,0,3,.000,0,0,,2,5,.400,1,3,4,0,0,2,0,0,2,0.2
1403,Findlay Tevin\findlay-tevin-1,2016-17,Green Bay,C,1,1,13,1,5,.200,1,4,.250,0,1,.000,0,0,,1,1,2,2,0,0,1,1,2,-0.1
1404,Ifeanyi Onyekaba\ifeanyi-onyekaba-1,2014-15,Rhode Island,C,7,0,38,0,3,.000,0,3,.000,0,0,,2,4,.500,2,6,8,0,1,1,1,13,2,-0.3
1405,John Miller\john-miller-1,2015-16,Army,C,6,1,24,1,2,.500,1,2,.500,0,0,,0,4,.000,2,4,6,0,2,1,1,1,2,0.6
1406,Kyle Buffkin\kyle-buffkin-1,2014-15,Coastal Carolina,C,11,0,51,0,9,.000,0,9,.000,0,0,,2,6,.333,6,4,10,1,1,1,5,14,2,-0.8
1407,Tyler Hagan\tyler-hagan-1,2014-15,Savannah State,C,1,1,3,1,1,1.000,1,1,1.000,0,0,,0,0,,0,0,0,0,0,0,0,0,2,1.7
1408,Quron Davis\quron-davis-1,2013-14,Chicago State,C,10,0,33,1,9,.111,1,9,.111,0,0,,0,2,.000,4,2,6,0,0,0,1,8,2,-0.6
1409,Maxwell Omili\maxwell-omili-1,2016-17,Western Michigan,C,9,0,17,1,4,.250,1,4,.250,0,0,,0,0,,0,1,1,0,0,1,1,4,2,-0.2
1410,Aaron Liberman\aaron-liberman-1,2013-14,Northwestern,C,10,0,9,1,1,1.000,1,1,1.000,0,0,,0,0,,1,4,5,0,0,0,0,2,2,0.3
1411,Jason Baxter\jason-baxter-1,2015-16,Savannah State,C,7,0,15,1,1,1.000,1,1,1.000,0,0,,0,0,,0,2,2,0,0,1,2,3,2,0.0
1412,Phillip Reed\phillip-reed-1,2013-14,Hampton,C,9,0,33,0,1,.000,0,1,.000,0,0,,2,2,1.000,1,5,6,1,0,0,2,4,2,0.1
1413,Kye Kurkowski\kye-kurkowski-1,2013-14,Nebraska,C,5,0,10,1,1,1.000,1,1,1.000,0,0,,0,1,.000,0,3,3,0,0,0,0,1,2,0.4
1414,Jordan Hughes\jordan-hughes-1,2015-16,Western Illinois,C,5,0,14,0,3,.000,0,3,.000,0,0,,2,2,1.000,1,3,4,0,0,0,1,2,2,-0.1
1415,Dougal Weir\dougal-weir-1,2013-14,Hartford,C,9,0,34,1,4,.250,1,4,.250,0,0,,0,0,,0,3,3,1,0,1,1,1,2,0.1
1416,Braxston Bunce\braxston-bunce-1,2013-14,Cornell,C,9,0,32,1,3,.333,1,3,.333,0,0,,0,0,,2,8,10,0,0,1,2,4,2,0.1
1417,Brian Hornstein\brian-hornstein-1,2013-14,Florida Atlantic,C,8,0,18,0,2,.000,0,2,.000,0,0,,2,6,.333,4,3,7,1,0,2,2,4,2,0.2
1418,Chris Snyder\chris-snyder-1,2017-18,Western Illinois,C,5,0,39,1,4,.250,1,3,.333,0,1,.000,0,0,,0,7,7,1,0,2,0,5,2,0.4
1419,Bobby Garbade\bobby-garbade-1,2014-15,Princeton,C,16,1,52,1,9,.111,1,9,.111,0,0,,0,0,,1,5,6,8,0,0,3,6,2,-0.1
1420,Braxston Bunce\braxston-bunce-1,2014-15,Cornell,C,4,0,10,0,1,.000,0,1,.000,0,0,,1,2,.500,1,1,2,0,0,0,1,0,1,0.0
1421,Schuyler Rimmer\schuyler-rimmer-1,2014-15,Stanford,C,2,0,6,0,0,,0,0,,0,0,,1,2,.500,1,1,2,0,0,0,0,0,1,0.8
1422,Conor Voss\conor-voss-1,2013-14,Columbia,C,12,0,27,0,2,.000,0,2,.000,0,0,,1,2,.500,2,6,8,0,1,2,4,6,1,-0.1
1423,Jack Stevens\jack-stevens-1,2016-17,Holy Cross,C,9,0,9,0,1,.000,0,1,.000,0,0,,1,2,.500,1,3,4,0,0,1,1,2,1,0.0
1424,Blair Orr\blair-orr-1,2016-17,Cal State Northridge,C,6,1,17,0,2,.000,0,2,.000,0,0,,1,2,.500,1,2,3,0,1,0,0,2,1,0.1
1425,Cian Sullivan\cian-sullivan-1,2017-18,La Salle,C,7,2,22,0,4,.000,0,4,.000,0,0,,1,2,.500,3,5,8,0,0,4,1,4,1,0.2
1426,Ben Oberfeld\ben-oberfeld-1,2016-17,Bucknell,C,1,1,0,0,0,,0,0,,0,0,,0,0,,0,0,0,0,0,0,0,0,0,0.0
1427,Justin Dahl\justin-dahl-1,2017-18,Northern Iowa,C,2,0,7,0,5,.000,0,5,.000,0,0,,0,0,,2,0,2,0,0,0,2,0,0,-2.1
1428,Ibby Djimde\ibby-djimde-1,2013-14,Southern Illinois,C,1,0,0,0,0,,0,0,,0,0,,0,0,,0,0,0,0,0,0,0,0,0,0.0
1429,Daniel Wallace\daniel-wallace-1,2015-16,Saint Francis (PA),C,3,0,5,0,0,,0,0,,0,0,,0,2,.000,0,0,0,0,0,0,1,0,0,-0.6
1430,Dalen Victor\dalen-victor-1,2017-18,Tennessee-Martin,C,1,0,1,0,0,,0,0,,0,0,,0,0,,0,0,0,0,0,0,1,0,0,-1.0
1431,Daniel Jones\daniel-jones-1,2013-14,Oregon State,C,3,0,3,0,1,.000,0,0,,0,1,.000,0,0,,0,2,2,0,0,0,0,0,0,0.0
1432,Jordan Pierce\jordan-pierce-1,2017-18,Dayton,C,2,0,4,0,0,,0,0,,0,0,,0,0,,0,1,1,0,0,0,0,0,0,0.2
1433,Wyatt Hagerty\wyatt-hagerty-1,2013-14,Colgate,C,3,0,7,0,1,.000,0,1,.000,0,0,,0,1,.000,2,3,5,0,0,0,0,3,0,0.0
1434,Josh Clemons\josh-clemons-1,2013-14,Baylor,C,1,0,2,0,0,,0,0,,0,0,,0,0,,0,0,0,0,0,0,1,0,0,-1.0
1435,Justin Stangel\justin-stangel-1,2015-16,Oregon State,C,4,0,4,0,0,,0,0,,0,0,,0,0,,0,0,0,0,0,0,1,0,0,-0.3
1436,Avi Schafer\avi-schafer-1,2017-18,Georgia Tech,C,4,0,3,0,1,.000,0,1,.000,0,0,,0,0,,1,1,2,0,0,0,0,1,0,0.0
1437,Michael Tertsea\michael-tertsea-1,2017-18,Rhode Island,C,9,0,15,0,1,.000,0,1,.000,0,0,,0,0,,1,1,2,0,0,2,1,2,0,0.0
1438,Christian McCoggle\christian-mccoggle-1,2013-14,Texas Southern,C,7,1,19,0,3,.000,0,3,.000,0,0,,0,0,,2,1,3,0,0,1,0,1,0,0.0
1439,Wyatt Hagerty\wyatt-hagerty-1,2014-15,Colgate,C,4,0,26,0,4,.000,0,4,.000,0,0,,0,1,.000,2,3,5,0,0,0,1,3,0,-0.8
1440,Valentine Izundu\valentine-izundu-1,2013-14,Houston,C,4,0,25,0,1,.000,0,1,.000,0,0,,0,2,.000,1,2,3,1,0,1,2,5,0,-0.7
1441,Brandon Vanover\brandon-vanover-1,2017-18,Central Arkansas,C,3,0,3,0,0,,0,0,,0,0,,0,0,,0,0,0,0,0,0,0,0,0,0.0
1442,Kyle Weldon\kyle-weldon-1,2013-14,Army,C,3,0,5,0,2,.000,0,2,.000,0,0,,0,0,,1,1,2,0,1,0,0,0,0,0.2
1443,James Hajek\james-hajek-1,2013-14,Weber State,C,9,0,30,0,2,.000,0,2,.000,0,0,,0,5,.000,0,5,5,0,1,2,0,4,0,-0.1
1444,Joshua Currenton\joshua-currenton-1,2016-17,Cal State Fullerton,C,1,1,8,0,0,,0,0,,0,0,,0,0,,0,0,0,0,0,0,0,0,0,0.0
1445,Emmanuel Ezechinonso\emmanuel-ezechinonso-1,2015-16,Tulsa,C,6,0,39,0,0,,0,0,,0,0,,0,1,.000,0,4,4,0,0,0,0,3,0,-0.1
1446,Andrew Smith\andrew-smith-4,2016-17,Florida A&M,C,2,0,3,0,1,.000,0,1,.000,0,0,,0,0,,0,0,0,0,0,0,0,0,0,-0.4
1447,Chier Ajou\chier-ajou-1,2013-14,Northwestern,C,1,0,2,0,0,,0,0,,0,0,,0,0,,0,0,0,0,0,0,0,0,0,0.0
1448,Mac Bohuny\mac-bohuny-1,2017-18,Boston College,C,2,0,2,0,0,,0,0,,0,0,,0,0,,0,0,0,1,0,0,0,0,0,0.4
1449,Branden Johnson\branden-johnson-2,2015-16,Alabama State,C,1,0,0,0,0,,0,0,,0,0,,0,0,,0,0,0,0,0,0,0,1,0,-0.4
1450,Bilal Begic\bilal-begic-1,2014-15,Utah State,C,1,0,0,0,0,,0,0,,0,0,,0,0,,0,0,0,0,0,0,0,0,0,0.0
1451,Hobie Hughes\hobie-hughes-1,2013-14,Troy,C,6,0,8,0,0,,0,0,,0,0,,0,0,,0,1,1,1,0,0,0,2,0,0.0
1452,Ikenna Okwarabizie\ikenna-okwarabizie-1,2015-16,UCLA,C,7,0,13,0,2,.000,0,2,.000,0,0,,0,0,,1,3,4,0,0,0,2,4,0,-0.5
1453,Matt Husek\matt-husek-1,2013-14,Holy Cross,C,7,0,10,0,1,.000,0,1,.000,0,0,,0,0,,0,1,1,1,0,0,1,2,0,-0.2
1454,Jack Stevens\jack-stevens-1,2017-18,Holy Cross,C,2,0,4,0,1,.000,0,1,.000,0,0,,0,0,,1,1,2,0,0,0,0,0,0,0.2
1455,Nate Brown Bull\nate-brownbull-1,2015-16,Florida International,C,4,0,6,0,1,.000,0,1,.000,0,0,,0,0,,0,2,2,0,0,0,0,2,0,-0.2
1456,Brendan Leonard\brendan-leonard-1,2014-15,Air Force,C,2,0,5,0,0,,0,0,,0,0,,0,0,,0,0,0,2,0,0,0,0,0,0.7
1457,David Tillman\david-tillman-1,2013-14,Arkansas-Pine Bluff,C,3,0,5,0,0,,0,0,,0,0,,0,0,,0,0,0,0,0,0,0,0,0,0.0
1458,Nick Busch\nick-busch-1,2016-17,San Diego,C,2,0,2,0,0,,0,0,,0,0,,0,0,,0,0,0,0,0,0,0,1,0,-0.2
1459,Justin Cole\justin-cole-33,2016-17,St. John's (NY),C,2,0,5,0,1,.000,0,1,.000,0,0,,0,0,,0,1,1,0,0,0,0,0,0,-0.2
1460,Kenyatta Smith\kenyatta-smith-1,2013-14,Harvard,C,2,0,3,0,1,.000,0,1,.000,0,0,,0,0,,0,0,0,0,0,0,0,0,0,-0.4
1461,Justin Cole\justin-cole-33,2017-18,St. John's (NY),C,6,0,22,0,5,.000,0,5,.000,0,0,,0,0,,0,4,4,0,1,0,0,6,0,-0.6
1462,Adam Lacey\adam-lacey-1,2013-14,Manhattan,C,4,0,2,0,0,,0,0,,0,0,,0,0,,0,1,1,0,0,0,0,0,0,0.1
1463,Jack Lawrence\jack-lawrence-1,2017-18,Navy,C,1,0,3,0,2,.000,0,2,.000,0,0,,0,0,,0,0,0,0,0,1,0,0,0,-0.7
1464,Kyle Caudill\kc-caudill-1,2014-15,Boston College,C,1,0,1,0,0,,0,0,,0,0,,0,0,,0,0,0,0,0,0,0,0,0,0.0
1465,Alex Wilbourn\alex-wilbourn-1,2017-18,Youngstown State,C,4,0,14,0,4,.000,0,4,.000,0,0,,0,4,.000,2,2,4,1,0,1,1,2,0,-0.7
1466,Aaren Smith\aaren-smith-1,2017-18,Rutgers,C,5,0,11,0,1,.000,0,1,.000,0,0,,0,0,,2,2,4,1,1,0,2,4,0,-0.1
1467,Osahen Iduwe\osahen-iduwe-1,2014-15,Georgia,C,11,0,27,0,2,.000,0,2,.000,0,0,,0,0,,0,1,1,0,2,1,0,4,0,0.0
1468,Mike VanKirk\mike-vankirk-1,2013-14,San Jose State,C,3,0,7,0,0,,0,0,,0,0,,0,0,,0,0,0,0,0,0,0,1,0,-0.1
1469,Leland Miller\leland-miller-1,2014-15,Utah Valley,C,2,0,5,0,0,,0,0,,0,0,,0,0,,0,0,0,0,0,0,0,1,0,-0.2
1470,Arthur Gage\arthur-gage-1,2013-14,Chicago State,C,2,0,1,0,0,,0,0,,0,0,,0,0,,0,0,0,0,0,0,1,1,0,-0.7
1471,Aaren Smith\aaren-smith-1,2016-17,Rutgers,C,1,0,4,0,0,,0,0,,0,0,,0,2,.000,0,0,0,0,0,0,0,0,0,-0.8
1472,Donnell Frayer\donnell-frayer-1,2017-18,Coppin State,C,2,0,1,0,1,.000,0,0,,0,1,.000,0,0,,0,0,0,0,0,0,0,0,0,-0.4
1473,Bradley Fischer\bradley-fischer-1,2014-15,Montana State,C,11,1,59,0,5,.000,0,5,.000,0,0,,0,0,,1,8,9,0,0,2,3,19,0,-0.9
1474,Branden Johnson\branden-johnson-2,2016-17,Alabama State,C,5,0,8,0,3,.000,0,2,.000,0,1,.000,0,0,,1,0,1,0,0,0,1,2,0,-0.6
1475,Jamaree Strickland\jamaree-strickland-1,2014-15,Cincinnati,C,1,0,0,0,0,,0,0,,0,0,,0,0,,0,0,0,0,0,0,0,0,0,0.0
1476,Matthias Runs\matthias-runs-1,2013-14,St. Bonaventure,C,3,0,5,0,1,.000,0,1,.000,0,0,,0,0,,1,0,1,1,0,0,0,1,0,0.1
1477,Nate Pollard\nate-pollard-1,2015-16,Rice,C,3,0,13,0,1,.000,0,1,.000,0,0,,0,2,.000,0,1,1,1,0,1,1,1,0,-0.4
