Rk,Player,Season,School,Pos,G,GS,MP,FG,FGA,FG%,2P,2PA,2P%,3P,3PA,3P%,FT,FTA,FT%,ORB,DRB,TRB,AST,STL,BLK,TOV,PF,PTS,GmSc
1,Doug McDermott\doug-mcdermott-1,2013-14,Creighton,F,35,35,1181,330,627,.526,234,413,.567,96,214,.449,178,206,.864,57,187,244,55,8,5,62,67,934,19.2
2,Mike Daum\mike-daum-1,2016-17,South Dakota State,F,35,35,1143,274,533,.514,195,344,.567,79,189,.418,251,289,.869,76,209,285,49,20,15,98,87,878,18.5
3,T.J. Warren\tj-warren-1,2013-14,North Carolina State,F,35,35,1238,342,652,.525,311,536,.580,31,116,.267,156,226,.690,113,137,250,40,63,21,83,97,871,17.9
4,Mike Daum\mike-daum-1,2017-18,South Dakota State,F,35,35,1090,273,591,.462,177,365,.485,96,226,.425,194,228,.851,64,295,359,45,17,26,72,84,836,17.5
5,Rashawn Thomas\rashawn-thomas-1,2016-17,Texas A&M-Corpus Christi,F,34,33,1145,268,511,.524,254,474,.536,14,37,.378,215,298,.721,78,227,305,92,53,69,126,118,765,17.5
6,Kelan Martin\kelan-martin-1,2017-18,Butler,F,35,35,1249,259,580,.447,164,319,.514,95,261,.364,130,154,.844,33,186,219,70,26,16,84,67,743,13.9
7,Bogdan Bliznyuk\bogdan-bliznyuk-1,2017-18,Eastern Washington,F,35,35,1228,265,502,.528,220,389,.566,45,113,.398,166,184,.902,33,205,238,137,29,10,119,83,741,15.8
8,Ben Bentil\ben-bentil-1,2015-16,Providence,F,35,33,1198,246,533,.462,194,375,.517,52,158,.329,194,248,.782,94,174,268,40,30,36,67,97,738,15.3
9,Kyle Wiltjer\kyle-wiltjer-1,2015-16,Gonzaga,F,36,36,1209,260,529,.491,170,323,.526,90,206,.437,126,147,.857,61,167,228,53,13,29,74,66,736,14.6
10,Justin Jackson\justin-jackson-4,2016-17,North Carolina,F,40,39,1281,264,596,.443,159,312,.510,105,284,.370,98,131,.748,58,128,186,113,31,9,69,55,731,12.8
11,Jerome Robinson\jerome-robinson-2,2017-18,Boston College,F,35,35,1260,249,513,.485,168,315,.533,81,198,.409,146,176,.830,17,109,126,116,30,5,96,88,725,13.8
12,Georges Niang\georges-niang-1,2015-16,Iowa State,F,35,35,1162,283,518,.546,227,375,.605,56,143,.392,96,119,.807,46,172,218,117,31,22,92,111,718,15.3
13,Mikal Bridges\mikal-bridges-1,2017-18,Villanova,F,40,40,1285,244,475,.514,140,236,.593,104,239,.435,114,134,.851,54,158,212,77,61,43,54,86,706,15.1
14,Deandre Ayton\deandre-ayton-1,2017-18,Arizona,F,35,35,1172,276,451,.612,264,416,.635,12,35,.343,140,191,.733,118,287,405,57,20,66,69,81,704,18.6
15,D.J. Covington\dj-covington-1,2013-14,Virginia Military Institute,F,35,35,1040,268,452,.593,268,450,.596,0,2,.000,168,241,.697,94,232,326,29,34,106,74,108,704,17.5
16,Shawn Glover\shawn-glover-1,2013-14,Oral Roberts,F,33,32,1151,273,547,.499,248,495,.501,25,52,.481,132,159,.830,42,150,192,49,28,53,72,67,703,15.0
17,Bogdan Bliznyuk\bogdan-bliznyuk-1,2016-17,Eastern Washington,F,34,33,1251,251,529,.474,213,409,.521,38,120,.317,161,196,.821,36,186,222,136,36,7,104,92,701,14.5
18,Peyton Aldridge\peyton-aldridge-1,2017-18,Davidson,F,33,33,1245,252,526,.479,175,324,.540,77,202,.381,120,141,.851,46,205,251,82,13,20,40,51,701,16.5
19,Nick King\nick-king-1,2017-18,Middle Tennessee,F,33,33,1086,259,523,.495,217,415,.523,42,108,.389,134,183,.732,78,200,278,65,23,7,94,50,694,14.7
20,Marvin Bagley III\marvin-bagleyiii-1,2017-18,Duke,F,33,32,1114,270,440,.614,247,382,.647,23,58,.397,131,209,.627,132,234,366,50,27,29,75,60,694,18.4
21,Cameron Bairstow\cameron-bairstow-1,2013-14,New Mexico,F,34,34,1119,237,426,.556,236,423,.558,1,3,.333,219,298,.735,76,175,251,53,19,51,68,72,694,16.5
22,Jacob Wiley\jacob-wiley-1,2016-17,Eastern Washington,F,34,34,1165,264,411,.642,259,404,.641,5,7,.714,159,192,.828,95,214,309,80,26,94,128,102,692,17.8
23,Eric Mika\eric-mika-2,2016-17,Brigham Young,F,34,34,974,233,441,.528,233,440,.530,0,1,.000,225,295,.763,104,208,312,56,19,63,84,92,691,16.6
24,Pascal Siakam\pascal-siakam-1,2015-16,New Mexico State,F,34,34,1176,274,509,.538,271,494,.549,3,15,.200,137,202,.678,132,263,395,58,34,75,67,92,688,17.9
25,Stephen Madison\stephen-madison-1,2013-14,Idaho,F,34,34,1172,218,457,.477,179,337,.531,39,120,.325,209,275,.760,70,190,260,81,34,17,93,101,684,14.7
26,Jimmy Hall\jimmy-hall-1,2016-17,Kent State,F,36,34,1172,267,513,.520,264,493,.535,3,20,.150,146,188,.777,147,235,382,92,32,49,104,104,683,15.9
27,Reid Travis\reid-travis-1,2017-18,Stanford,F,35,35,1190,250,474,.527,232,413,.562,18,61,.295,164,243,.675,104,202,306,47,26,4,72,91,682,14.4
28,Caleb Martin\caleb-martin-1,2017-18,Nevada,F,36,26,1199,223,491,.454,123,243,.506,100,248,.403,134,179,.749,34,160,194,92,45,21,61,95,680,14.0
29,Alec Peters\alec-peters-1,2015-16,Valparaiso,F,37,37,1186,223,442,.505,132,235,.562,91,207,.440,142,167,.850,93,219,312,49,26,11,63,77,679,15.0
30,Brice Johnson\brice-johnson-1,2015-16,North Carolina,F,40,39,1121,267,435,.614,267,435,.614,0,0,,144,184,.783,115,301,416,58,43,59,71,106,678,16.2
31,Trevon Bluiett\trevon-bluiett-1,2017-18,Xavier,F,35,34,1200,202,462,.437,97,210,.462,105,252,.417,167,197,.848,29,164,193,87,26,9,70,76,676,13.8
32,Kevin Hervey\kevin-hervey-1,2017-18,Texas-Arlington,F,33,25,1064,243,545,.446,166,318,.522,77,227,.339,113,140,.807,77,205,282,73,41,20,90,60,676,14.8
33,David Laury\david-laury-1,2014-15,Iona,F,34,33,1201,244,514,.475,217,443,.490,27,71,.380,159,233,.682,85,244,329,96,27,45,101,92,674,14.8
34,Jerrelle Benimon\jerrelle-benimon-1,2013-14,Towson,F,36,36,1307,225,425,.529,211,381,.554,14,44,.318,209,293,.713,84,320,404,130,25,44,124,104,673,15.8
35,Keita Bates-Diop\keita-bates-diop-1,2017-18,Ohio State,F,34,34,1125,247,515,.480,181,331,.547,66,184,.359,112,141,.794,52,244,296,56,31,56,61,57,672,15.7
36,Jabari Parker\jabari-parker-1,2013-14,Duke,F,35,35,1074,236,499,.473,198,393,.504,38,106,.358,160,214,.748,105,201,306,41,37,43,81,83,670,14.5
37,LaDontae Henton\ladontae-henton-1,2014-15,Providence,F,34,34,1257,230,516,.446,166,327,.508,64,189,.339,145,191,.759,60,162,222,29,46,16,68,76,669,13.3
38,Alec Peters\alec-peters-1,2016-17,Valparaiso,F,29,29,1019,218,468,.466,160,308,.519,58,160,.363,172,194,.887,74,219,293,64,23,11,71,64,666,17.7
39,Trevon Bluiett\trevon-bluiett-1,2016-17,Xavier,F,36,35,1262,212,483,.439,121,239,.506,91,244,.373,149,198,.753,26,178,204,74,32,4,78,86,664,12.1
40,Semi Ojeleye\semi-ojeleye-1,2016-17,Southern Methodist,F,35,35,1195,209,428,.488,136,256,.531,73,172,.424,172,219,.785,79,160,239,53,15,14,50,62,663,14.8
41,James Kelly\james-kelly-1,2015-16,Marshall,F,33,33,1009,260,479,.543,211,320,.659,49,159,.308,94,126,.746,61,263,324,38,44,36,77,94,663,15.8
42,Peyton Aldridge\peyton-aldridge-1,2016-17,Davidson,F,32,32,1180,233,471,.495,163,300,.543,70,171,.409,120,144,.833,54,209,263,70,28,28,53,65,656,16.5
43,Jordan Caroline\jordan-caroline-1,2017-18,Nevada,F,37,36,1290,221,466,.474,185,355,.521,36,111,.324,178,251,.709,98,221,319,82,26,6,71,87,656,13.7
44,Jameel Warney\jameel-warney-1,2015-16,Stony Brook,F,33,33,1086,272,433,.628,272,433,.628,0,0,,111,178,.624,148,209,357,52,31,98,44,71,655,20.1
45,Isaiah Miles\isaiah-miles-1,2015-16,Saint Joseph's,F,36,36,1239,223,426,.523,158,257,.615,65,169,.385,142,160,.888,84,208,292,31,21,36,41,102,653,15.1
46,Michael Young\michael-young-3,2016-17,Pittsburgh,F,33,31,1097,217,478,.454,175,356,.492,42,122,.344,172,221,.778,53,170,223,90,19,25,70,59,648,14.4
47,T.J. Cline\tj-cline-1,2016-17,Richmond,F,35,35,1137,243,470,.517,195,318,.613,48,152,.316,114,166,.687,30,242,272,197,33,8,103,88,648,15.1
48,Michael Gbinije\michael-gbinije-1,2015-16,Syracuse,F,37,37,1403,225,488,.461,134,256,.523,91,232,.392,106,160,.663,40,111,151,159,70,13,105,98,647,13.0
49,Caleb Swanigan\caleb-swanigan-1,2016-17,Purdue,F,35,35,1139,222,421,.527,184,336,.548,38,85,.447,164,210,.781,96,340,436,106,15,28,118,97,646,15.5
50,Jerome Hill\jerome-hill-1,2014-15,Gardner-Webb,F,34,33,1126,211,446,.473,205,408,.502,6,38,.158,216,344,.628,118,227,345,75,18,23,101,76,644,13.9
51,Shawn Long\shawn-long-1,2015-16,Louisiana,F,34,33,1042,232,443,.524,214,376,.569,18,67,.269,160,235,.681,137,274,411,47,24,61,91,95,642,16.0
52,Perry Ellis\perry-ellis-1,2015-16,Kansas,F,38,38,1150,237,446,.531,209,382,.547,28,64,.438,139,177,.785,67,155,222,49,18,19,56,64,641,12.8
53,Tyler Cavanaugh\tyler-cavanaugh-1,2016-17,George Washington,F,35,35,1126,200,446,.448,133,282,.472,67,164,.409,173,204,.848,87,207,294,71,19,14,93,98,640,13.3
54,Bonzie Colson\bonzie-colson-1,2016-17,Notre Dame,F,36,36,1156,236,449,.526,210,389,.540,26,60,.433,141,180,.783,104,258,362,56,40,50,44,81,639,16.4
55,Kyle Wiltjer\kyle-wiltjer-1,2014-15,Gonzaga,F,38,37,1049,242,448,.540,174,302,.576,68,146,.466,86,109,.789,51,184,235,71,18,25,43,62,638,13.7
56,Tyler Cavanaugh\tyler-cavanaugh-1,2015-16,George Washington,F,38,38,1157,209,414,.505,156,287,.544,53,127,.417,167,202,.827,76,213,289,46,21,10,79,95,638,12.6
57,Yante Maten\yante-maten-1,2017-18,Georgia,F,33,33,1131,207,446,.464,178,361,.493,29,85,.341,193,241,.801,116,167,283,51,15,49,67,72,636,15.4
58,Dillon Brooks\dillon-brooks-1,2015-16,Oregon,F,38,38,1247,231,492,.470,183,350,.523,48,142,.338,125,155,.806,77,129,206,119,40,15,89,112,635,12.2
59,Domantas Sabonis\domantas-sabonis-1,2015-16,Gonzaga,F,36,31,1149,239,391,.611,234,377,.621,5,14,.357,150,195,.769,110,316,426,64,22,31,92,115,633,15.5
60,John Collins\john-collins-1,2016-17,Wake Forest,F,33,33,878,234,376,.622,234,375,.624,0,1,.000,164,220,.745,124,200,324,17,21,52,60,98,632,16.9
61,Ben Simmons\ben-simmons-1,2015-16,Louisiana State,F,33,32,1151,216,386,.560,215,383,.561,1,3,.333,199,297,.670,103,285,388,158,65,27,111,92,632,18.6
62,Shawn Long\shawn-long-1,2013-14,Louisiana,F,34,32,999,239,458,.522,206,380,.542,33,78,.423,120,178,.674,121,232,353,19,23,91,73,119,631,15.2
63,Bobby Portis\bobby-portis-1,2014-15,Arkansas,F,36,36,1076,250,466,.536,236,436,.541,14,30,.467,115,156,.737,133,188,321,42,39,50,56,78,629,15.3
64,Jordan Washington\jordan-washington-1,2016-17,Iona,F,35,26,760,233,422,.552,232,418,.555,1,4,.250,162,236,.686,83,182,265,22,32,14,78,122,629,12.6
65,DeAndre Bembry\deandre-bembry-1,2015-16,Saint Joseph's,F,36,35,1341,238,497,.479,204,369,.553,34,128,.266,117,178,.657,51,228,279,161,51,30,73,88,627,14.7
66,DeSean Murray\desean-murray-1,2015-16,Presbyterian,F,31,31,902,232,427,.543,232,420,.552,0,7,.000,163,211,.773,74,154,228,53,62,17,95,94,627,15.4
67,Justin Tillman\justin-tillman-1,2017-18,Virginia Commonwealth,F,33,33,1010,248,445,.557,221,363,.609,27,82,.329,102,156,.654,109,218,327,15,11,34,56,78,625,14.9
68,Luke Maye\luke-maye-1,2017-18,North Carolina,F,37,37,1193,251,516,.486,201,400,.503,50,116,.431,73,117,.624,113,260,373,88,36,38,69,92,625,14.1
69,Martin Breunig\martin-breunig-1,2015-16,Montana,F,33,33,1005,228,367,.621,225,357,.630,3,10,.300,165,233,.708,97,201,298,48,22,37,73,110,624,15.9
70,Yoeli Childs\yoeli-childs-1,2017-18,Brigham Young,F,35,34,1191,246,455,.541,231,407,.568,15,48,.313,117,182,.643,70,231,301,77,30,63,76,79,624,14.8
71,Jarrod Uthoff\jarrod-uthoff-1,2015-16,Iowa,F,33,33,1016,218,487,.448,152,314,.484,66,173,.382,122,150,.813,48,161,209,36,32,86,38,51,624,15.2
72,Jacorey Williams\jacorey-williams-1,2016-17,Middle Tennessee,F,36,36,1069,258,484,.533,256,469,.546,2,15,.133,103,148,.696,63,201,264,56,32,17,60,72,621,12.9
73,Jakob Poeltl\jakob-poeltl-1,2015-16,Utah,F,36,36,1093,228,353,.646,228,353,.646,0,0,,164,237,.692,102,225,327,70,21,56,74,83,620,16.0
74,Desmond Williams\desmond-williams-1,2017-18,Florida A&M,F,34,33,1212,221,504,.438,210,463,.454,11,41,.268,164,222,.739,60,148,208,64,40,25,100,78,617,11.4
75,John Brown\john-brown-3,2014-15,High Point,F,32,29,995,242,440,.550,242,434,.558,0,6,.000,133,176,.756,101,91,192,39,39,33,53,66,617,15.5
76,Erik Thomas\erik-thomas-1,2016-17,New Orleans,F,32,29,1043,223,379,.588,219,362,.605,4,17,.235,166,212,.783,95,155,250,73,47,11,88,68,616,16.4
77,K.J. McDaniels\kj-mcdaniels-1,2013-14,Clemson,F,36,35,1212,209,455,.459,167,317,.527,42,138,.304,154,183,.842,86,169,255,57,41,100,83,80,614,14.3
78,Dedric Lawson\dedric-lawson-1,2016-17,Memphis,F,32,32,1104,216,469,.461,186,358,.520,30,111,.270,152,205,.741,92,225,317,105,41,68,76,81,614,16.8
79,Jordon Varnado\jordon-varnado-1,2016-17,Troy,F,37,37,1068,233,442,.527,205,365,.562,28,77,.364,118,168,.702,76,188,264,50,19,51,70,100,612,12.6
80,Stephen Maxwell\stephen-maxwell-1,2013-14,Cal State Northridge,F,35,35,1210,216,395,.547,216,395,.547,0,0,,180,239,.753,129,180,309,20,26,3,80,87,612,13.4
81,Melvin Ejim\melvin-ejim-1,2013-14,Iowa State,F,34,33,1093,220,436,.505,176,309,.570,44,127,.346,121,159,.761,88,197,285,62,40,23,78,111,605,13.8
82,Lamar Stevens\lamar-stevens-1,2017-18,Penn State,F,39,39,1290,231,497,.465,201,403,.499,30,94,.319,112,161,.696,54,178,232,74,24,43,87,93,604,10.3
83,John Brown\john-brown-3,2013-14,High Point,F,31,31,986,224,411,.545,224,406,.552,0,5,.000,155,208,.745,105,134,239,60,47,51,49,79,603,17.5
84,Marcus Georges-Hunt\marcus-georges-hunt-1,2015-16,Georgia Tech,F,36,36,1167,178,392,.454,138,275,.502,40,117,.342,205,249,.823,32,90,122,119,31,16,73,94,601,12.3
85,Julius Randle\julius-randle-1,2013-14,Kentucky,F,40,40,1233,196,391,.501,193,373,.517,3,18,.167,204,289,.706,139,277,416,57,20,31,101,91,599,12.4
86,Antonio Campbell\antonio-campbell-1,2015-16,Ohio,F,35,35,1013,237,423,.560,194,306,.634,43,117,.368,81,111,.730,74,283,357,23,23,63,44,111,598,14.7
87,Marc Eddy Norelia\marc-eddy-norelia-1,2015-16,Florida Gulf Coast,F,35,34,1148,234,429,.545,234,427,.548,0,2,.000,129,192,.672,107,218,325,45,39,28,63,73,597,14.4
88,Kevin Hervey\kevin-hervey-1,2016-17,Texas-Arlington,F,35,28,973,208,454,.458,140,255,.549,68,199,.342,113,150,.753,49,250,299,74,43,14,66,65,597,13.4
89,Cameron Forte\cameron-forte-1,2015-16,Portland State,F,31,19,907,244,421,.580,243,419,.580,1,2,.500,107,194,.552,106,182,288,80,30,15,99,65,596,15.0
90,Justin Johnson\justin-johnson-7,2017-18,Western Kentucky,F,38,38,1314,239,464,.515,192,351,.547,47,113,.416,70,123,.569,84,276,360,48,27,28,57,69,595,12.7
91,Jerome Robinson\jerome-robinson-2,2016-17,Boston College,F,32,32,1089,212,502,.422,158,340,.465,54,162,.333,117,162,.722,19,104,123,108,55,12,102,89,595,11.1
92,Alex Francis\alex-francis-1,2013-14,Bryant,F,32,32,1152,225,390,.577,225,390,.577,0,0,,145,236,.614,85,177,262,46,37,26,97,93,595,13.8
93,Dikembe Dixson\dikembe-dixson-1,2015-16,Illinois-Chicago,F,30,30,1102,192,520,.369,151,385,.392,41,135,.304,169,256,.660,43,177,220,55,35,14,124,77,594,9.5
94,Javonte Green\javonte-green-1,2013-14,Radford,F,35,34,897,212,387,.548,200,352,.568,12,35,.343,157,229,.686,81,204,285,37,68,21,56,97,593,14.6
95,Bakari Copeland\bakari-copeland-1,2016-17,Maryland-Eastern Shore,F,34,34,1028,194,417,.465,154,322,.478,40,95,.421,164,212,.774,39,169,208,56,19,7,78,85,592,11.4
96,Cleanthony Early\cleanthony-early-1,2013-14,Wichita State,F,36,36,986,187,386,.484,121,209,.579,66,177,.373,151,179,.844,48,165,213,27,29,28,70,83,591,12.0
97,Gabe Levin\gabe-levin-1,2017-18,Cal State Long Beach,F,32,32,991,194,426,.455,171,365,.468,23,61,.377,180,221,.814,68,164,232,52,32,22,93,85,591,12.7
98,Ethan Happ\ethan-happ-1,2017-18,Wisconsin,F,33,33,1017,242,458,.528,241,447,.539,1,11,.091,105,191,.550,78,187,265,122,49,35,93,87,590,14.4
99,Brad Waldow\brad-waldow-1,2014-15,Saint Mary's (CA),F,31,31,1068,235,421,.558,235,421,.558,0,0,,120,182,.659,90,193,283,69,16,23,66,73,590,15.2
100,Elijah Minnie\elijah-minnie-1,2017-18,Eastern Michigan,F,35,34,1098,210,464,.453,132,233,.567,78,231,.338,91,108,.843,49,165,214,39,63,66,81,68,589,13.0
101,Johnathan Motley\johnathan-motley-1,2016-17,Baylor,F,34,34,1036,226,433,.522,217,401,.541,9,32,.281,128,183,.699,126,209,335,79,12,36,100,104,589,13.4
102,T.J. Cline\tj-cline-1,2015-16,Richmond,F,32,32,961,228,408,.559,184,289,.637,44,119,.370,88,137,.642,38,129,167,122,21,3,72,87,588,13.8
103,Erik McCree\erik-mccree-1,2016-17,Louisiana Tech,F,33,33,1046,202,424,.476,148,275,.538,54,149,.362,127,165,.770,53,242,295,44,15,15,84,53,585,12.6
104,Nick Perkins\nick-perkins-2,2017-18,Buffalo,F,36,10,990,211,445,.474,175,332,.527,36,113,.319,126,172,.733,80,137,217,28,11,23,72,85,584,10.5
105,Juwan Howard\juwan-howard--1,2013-14,Detroit Mercy,F,32,32,1105,216,515,.419,163,361,.452,53,154,.344,99,118,.839,57,113,170,71,31,15,62,75,584,11.7
106,Hayden Dalton\hayden-dalton-1,2017-18,Wyoming,F,33,33,1098,190,415,.458,105,204,.515,85,211,.403,119,142,.838,46,213,259,86,31,16,82,90,584,13.4
107,Jamel Artis\jamel-artis-1,2016-17,Pittsburgh,F,32,31,1097,196,413,.475,122,224,.545,74,189,.392,116,158,.734,40,116,156,106,13,9,83,61,582,12.6
108,Miles Bridges\miles-bridges-1,2017-18,Michigan State,F,34,33,1067,209,457,.457,138,262,.527,71,195,.364,93,109,.853,43,194,237,92,21,26,67,53,582,13.0
109,Jaron Blossomgame\jaron-blossomgame-1,2016-17,Clemson,F,33,33,1133,219,440,.498,195,346,.564,24,94,.255,119,167,.713,59,148,207,51,27,30,56,53,581,13.1
110,Tanner Leissner\tanner-leissner-1,2017-18,New Hampshire,F,31,31,1111,195,432,.451,157,317,.495,38,115,.330,153,199,.769,81,133,214,62,15,10,50,65,581,13.7
111,Jaron Blossomgame\jaron-blossomgame-1,2015-16,Clemson,F,31,31,1060,201,392,.513,156,290,.538,45,102,.441,133,170,.782,55,152,207,47,23,41,55,63,580,14.8
112,Shawn Prudhomme\shawn-prudhomme-1,2016-17,Southern,F,33,31,1103,212,480,.442,137,275,.498,75,205,.366,80,112,.714,45,150,195,44,33,32,65,88,579,11.4
113,Justin Moss\justin-moss--1,2014-15,Buffalo,F,33,32,991,203,390,.521,203,386,.526,0,4,.000,173,237,.730,91,211,302,21,32,25,73,98,579,13.4
114,Tyler Stone\tyler-stone-1,2013-14,Southeast Missouri State,F,30,26,1005,223,410,.544,200,342,.585,23,68,.338,109,153,.712,73,211,284,58,29,46,51,83,578,16.5
115,Juwan Howard\juwan-howard--1,2014-15,Detroit Mercy,F,33,32,1042,208,479,.434,144,322,.447,64,157,.408,96,113,.850,35,100,135,78,31,10,69,67,576,11.2
116,Lauri Markkanen\lauri-markkanen-1,2016-17,Arizona,F,37,37,1140,185,376,.492,116,213,.545,69,163,.423,137,164,.835,88,178,266,32,15,19,40,73,576,12.8
117,Kevin Knox\kevin-knox-1,2017-18,Kentucky,F,37,37,1198,196,440,.445,139,273,.509,57,167,.341,127,164,.774,33,167,200,53,31,10,85,82,576,9.8
118,Jameel Warney\jameel-warney-1,2014-15,Stony Brook,F,35,34,1156,243,452,.538,243,452,.538,0,0,,89,155,.574,150,259,409,72,26,87,59,74,575,16.0
119,Nick Mayo\nick-mayo-1,2016-17,Eastern Kentucky,F,31,31,1092,203,403,.504,171,321,.533,32,82,.390,137,177,.774,45,156,201,88,27,41,93,77,575,13.9
120,Nathan Knight\nathan-knight-1,2017-18,William & Mary,F,31,30,890,206,358,.575,195,322,.606,11,36,.306,150,195,.769,58,168,226,69,18,61,83,103,573,14.9
121,Kavin Gilder-Tilbury\kavin-gilder-tilbury-1,2016-17,Texas State,F,36,36,1103,205,415,.494,134,228,.588,71,187,.380,92,140,.657,37,165,202,64,43,34,69,103,573,11.7
122,Justin Strings\justin-strings-1,2017-18,Sacramento State,F,32,32,1157,223,522,.427,193,416,.464,30,106,.283,97,157,.618,46,179,225,75,19,30,73,77,573,10.9
123,Dan Trist\dan-trist-1,2014-15,Lafayette,F,33,32,892,230,399,.576,230,399,.576,0,0,,110,141,.780,76,146,222,43,12,23,75,71,570,12.8
124,Alec Peters\alec-peters-1,2014-15,Valparaiso,F,34,34,1039,195,399,.489,112,221,.507,83,178,.466,97,117,.829,64,163,227,42,24,11,49,67,570,12.9
125,Moritz Wagner\moritz-wagner-1,2017-18,Michigan,F,39,39,1078,216,409,.528,153,249,.614,63,160,.394,75,108,.694,57,221,278,33,38,20,56,120,570,11.1
126,TJ Leaf\tj-leaf-1,2016-17,UCLA,F,35,35,1048,235,381,.617,208,323,.644,27,58,.466,72,106,.679,78,209,287,85,22,39,52,89,569,14.9
127,Torrey Craig\torrey-craig-1,2013-14,South Carolina Upstate,F,34,34,1113,204,500,.408,136,267,.509,68,233,.292,93,151,.616,67,170,237,77,31,28,84,84,569,10.7
128,Derick Newton\derick-newton-2,2016-17,Stetson,F,32,31,1012,184,399,.461,123,234,.526,61,165,.370,139,171,.813,42,140,182,41,19,8,57,51,568,12.4
129,Georges Niang\georges-niang-1,2013-14,Iowa State,F,34,34,1025,222,468,.474,174,321,.542,48,147,.327,75,104,.721,34,118,152,123,21,21,82,109,567,10.9
130,J.R. Holder\jr-holder-1,2016-17,Jacksonville,F,32,32,1080,200,389,.514,155,265,.585,45,124,.363,120,167,.719,34,78,112,61,36,15,84,60,565,11.9
131,Devontae Cacok\devontae-cacok-1,2017-18,North Carolina-Wilmington,F,32,29,942,221,378,.585,221,378,.585,0,0,,123,201,.612,162,269,431,28,33,18,72,124,565,15.5
132,Joel Bolomboy\joel-bolomboy-1,2015-16,Weber State,F,33,33,1041,193,337,.573,173,282,.613,20,55,.364,159,228,.697,109,306,415,35,23,40,78,73,565,15.6
133,Dillon Brooks\dillon-brooks-1,2016-17,Oregon,F,35,27,886,206,422,.488,149,280,.532,57,142,.401,95,126,.754,35,78,113,95,38,18,72,97,564,11.2
134,Tim Williams\tim-williams-3,2013-14,Samford,F,32,32,1057,217,361,.601,216,358,.603,1,3,.333,129,172,.750,64,171,235,24,43,45,59,75,564,15.0
135,Jalen Cannon\jalen-cannon-1,2014-15,St. Francis (NY),F,35,35,1184,210,404,.520,183,323,.567,27,81,.333,117,168,.696,139,228,367,34,24,27,58,60,564,14.1
136,Tres Tinkle\tres-tinkle-1,2017-18,Oregon State,F,32,32,1164,192,407,.472,144,260,.554,48,147,.327,131,156,.840,56,175,231,117,45,18,93,88,563,14.0
137,Jermaine Crumpton\jermaine-crumpton-1,2017-18,Canisius,F,33,33,1063,205,426,.481,158,279,.566,47,147,.320,106,139,.763,66,111,177,50,23,17,59,60,563,12.1
138,Elgin Cook\elgin-cook-1,2015-16,Oregon,F,38,38,1213,191,405,.472,170,342,.497,21,63,.333,160,207,.773,59,136,195,88,54,13,80,107,563,11.1
139,Yante Maten\yante-maten-1,2015-16,Georgia,F,34,34,1020,212,427,.496,204,412,.495,8,15,.533,130,166,.783,89,184,273,27,9,62,76,92,562,12.0
140,Rodney Hood\rodney-hood-1,2013-14,Duke,F,35,33,1150,191,412,.464,120,243,.494,71,169,.420,109,135,.807,29,109,138,75,25,9,54,91,562,11.0
141,C.J. Fair\cj-fair-1,2013-14,Syracuse,F,34,34,1284,217,506,.429,193,419,.461,24,87,.276,103,142,.725,59,160,219,43,44,27,85,71,561,10.2
142,Henry Ellenson\henry-ellenson-1,2015-16,Marquette,F,33,33,1107,194,435,.446,164,331,.495,30,104,.288,143,191,.749,71,250,321,59,28,49,78,84,561,13.1
143,B.J. Johnson\bj-johnson-2,2017-18,La Salle,F,27,27,951,194,435,.446,147,304,.484,47,131,.359,126,145,.869,57,168,225,20,35,19,68,57,561,14.4
144,Z Mason\z-mason-1,2013-14,Chattanooga,F,31,31,939,201,410,.490,161,293,.549,40,117,.342,119,167,.713,91,209,300,24,28,92,74,72,561,15.1
145,Cameron Oliver\cameron-oliver-1,2016-17,Nevada,F,35,33,1115,202,434,.465,136,262,.519,66,172,.384,90,130,.692,57,247,304,64,29,91,83,101,560,12.8
146,Christian Standhardinger\christian-standhardinger-1,2013-14,Hawaii,F,31,31,989,176,371,.474,163,324,.503,13,47,.277,195,254,.768,92,169,261,46,42,23,85,89,560,13.9
147,Brandon McCoy\brandon-mccoy-1,2017-18,Nevada-Las Vegas,F,33,33,949,208,382,.545,205,373,.550,3,9,.333,140,193,.725,103,238,341,17,15,60,87,87,559,13.5
148,Jarnell Stokes\jarnell-stokes-1,2013-14,Tennessee,F,37,37,1199,199,375,.531,199,375,.531,0,0,,160,230,.696,155,237,392,75,26,34,77,73,558,14.1
149,Aaron White\aaron-white-3,2014-15,Iowa,F,34,34,1070,171,328,.521,150,269,.558,21,59,.356,195,238,.819,71,177,248,48,45,16,41,53,558,15.0
150,Jarell Martin\jarell-martin-1,2014-15,Louisiana State,F,33,32,1159,202,397,.509,188,345,.545,14,52,.269,140,203,.690,98,207,305,59,38,23,92,92,558,13.1
151,Shawn Long\shawn-long-1,2014-15,Louisiana,F,34,34,951,205,378,.542,177,301,.588,28,77,.364,120,182,.659,103,243,346,50,22,56,78,106,558,13.9
152,Nick Mayo\nick-mayo-1,2017-18,Eastern Kentucky,F,31,31,1062,202,384,.526,169,310,.545,33,74,.446,120,143,.839,47,161,208,67,24,46,98,88,557,13.3
153,Sam Dekker\sam-dekker-1,2014-15,Wisconsin,F,40,40,1239,213,406,.525,163,255,.639,50,151,.331,80,113,.708,77,143,220,49,21,18,36,42,556,11.4
154,Tanner Plomb\tanner-plomb-1,2015-16,Army,F,28,27,879,190,449,.423,110,222,.495,80,227,.352,95,129,.736,17,144,161,42,25,8,48,48,555,12.5
155,Amanze Egekeze\amanze-egekeze-1,2017-18,Belmont,F,33,33,1139,184,364,.505,88,138,.638,96,226,.425,89,111,.802,39,166,205,31,19,8,42,61,553,12.7
156,Derick Newton\derick-newton-2,2015-16,Stetson,F,34,34,1061,171,384,.445,114,262,.435,57,122,.467,154,186,.828,52,148,200,46,15,15,81,63,553,10.9
157,Oshae Brissett\oshae-brissett-1,2017-18,Syracuse,F,37,37,1411,162,458,.354,107,292,.366,55,166,.331,174,221,.787,82,245,327,34,43,29,69,83,553,10.7
158,Jake White\jake-white-1,2015-16,Omaha,F,32,32,829,197,347,.568,175,304,.576,22,43,.512,136,168,.810,74,125,199,10,10,7,48,97,552,12.5
159,Nigel Hayes\nigel-hayes-1,2015-16,Wisconsin,F,35,35,1267,161,438,.368,122,305,.400,39,133,.293,190,258,.736,69,135,204,104,39,14,79,71,551,11.0
160,Ovie Soko\ovie-soko-1,2013-14,Duquesne,F,30,30,930,171,366,.467,157,315,.498,14,51,.275,195,289,.675,61,179,240,50,26,19,80,95,551,12.6
161,Terry Allen\terry-allen-1,2015-16,Richmond,F,32,32,1065,192,391,.491,168,313,.537,24,78,.308,142,195,.728,66,179,245,69,52,19,59,83,550,14.2
162,DeAndre Bembry\deandre-bembry-1,2014-15,Saint Joseph's,F,31,31,1197,199,461,.432,149,308,.484,50,153,.327,102,160,.638,49,191,240,111,60,29,89,73,550,13.4
163,Jarvis Williams\jarvis-williams-3,2014-15,Murray State,F,35,35,1085,199,351,.567,199,350,.569,0,1,.000,152,228,.667,135,158,293,32,26,35,48,95,550,13.8
164,Montrezl Harrell\montrezl-harrell-1,2014-15,Louisville,F,35,35,1229,213,376,.566,204,339,.602,9,37,.243,114,191,.597,111,210,321,49,33,42,69,74,549,13.7
165,John Brown\john-brown-3,2015-16,High Point,F,28,28,830,212,352,.602,211,351,.601,1,1,1.000,124,177,.701,91,108,199,62,48,49,48,60,549,18.4
166,Vladimir Brodziansky\vladimir-brodziansky-1,2016-17,Texas Christian,F,39,30,934,203,360,.564,192,330,.582,11,30,.367,131,169,.775,85,137,222,24,13,82,42,81,548,12.2
167,Rashawn Thomas\rashawn-thomas-1,2015-16,Texas A&M-Corpus Christi,F,33,32,870,206,373,.552,202,357,.566,4,16,.250,132,191,.691,95,170,265,35,31,75,103,129,548,12.6
168,Tylor Ongwae\tylor-ongwae-1,2014-15,Louisiana-Monroe,F,38,38,1347,198,485,.408,173,382,.453,25,103,.243,127,152,.836,93,159,252,110,37,11,93,82,548,10.2
169,Tanner Leissner\tanner-leissner-1,2016-17,New Hampshire,F,32,32,1102,185,394,.470,164,321,.511,21,73,.288,156,188,.830,73,148,221,57,15,10,56,84,547,12.5
170,Jalen Hayes\jalen-hayes-1,2017-18,Oakland,F,29,29,1036,212,404,.525,207,381,.543,5,23,.217,117,141,.830,68,167,235,57,29,25,70,93,546,14.3
171,Kris Jenkins\kris-jenkins-1,2015-16,Villanova,F,40,38,1134,179,390,.459,79,131,.603,100,259,.386,87,103,.845,20,136,156,87,32,16,52,103,545,10.1
172,Kelan Martin\kelan-martin-1,2016-17,Butler,F,34,22,977,180,421,.428,116,237,.489,64,184,.348,120,153,.784,34,162,196,40,23,14,66,74,544,10.2
173,Alex Rosenberg\alex-rosenberg-1,2013-14,Columbia,F,34,21,984,133,308,.432,82,190,.432,51,118,.432,227,276,.822,39,86,125,45,24,3,55,71,544,11.5
174,Sebastian Saiz\sebastian-saiz-1,2016-17,Mississippi,F,36,36,1200,181,386,.469,160,313,.511,21,73,.288,160,215,.744,122,287,409,36,36,38,80,116,543,12.7
175,Zach LeDay\zach-leday-1,2015-16,Virginia Tech,F,35,32,1078,181,379,.478,160,320,.500,21,59,.356,160,210,.762,102,173,275,48,27,58,57,100,543,13.1
176,Desi Rodriguez\desi-rodriguez-1,2017-18,Seton Hall,F,31,29,939,204,410,.498,148,260,.569,56,150,.373,78,106,.736,33,116,149,63,32,15,62,74,542,12.2
177,Rakeem Christmas\rakeem-christmas-1,2014-15,Syracuse,F,31,31,1064,203,368,.552,203,367,.553,0,1,.000,136,191,.712,97,185,282,47,29,78,78,105,542,15.0
178,Chris Cokley\chris-cokley-1,2017-18,Alabama-Birmingham,F,32,29,870,219,376,.582,219,374,.586,0,2,.000,104,127,.819,100,176,276,49,18,13,47,52,542,14.8
179,Ryan Welage\ryan-welage-1,2017-18,San Jose State,F,30,29,1039,191,414,.461,131,274,.478,60,140,.429,100,114,.877,26,135,161,42,17,5,54,43,542,12.0
180,Jeff Roberson\jeff-roberson-1,2017-18,Vanderbilt,F,32,31,1102,164,343,.478,102,190,.537,62,153,.405,152,178,.854,61,167,228,49,28,11,49,91,542,13.6
181,Justin Sears\justin-sears-1,2013-14,Yale,F,32,30,978,183,354,.517,179,342,.523,4,12,.333,170,244,.697,91,129,220,46,39,62,70,83,540,14.1
182,Zachary Hamilton\zachary-hamilton-1,2017-18,Prairie View,F,34,34,936,181,453,.400,92,215,.428,89,238,.374,89,113,.788,35,110,145,43,32,9,57,94,540,9.3
183,Brett Bisping\brett-bisping-1,2015-16,Siena,F,34,33,1129,180,389,.463,140,275,.509,40,114,.351,140,176,.795,79,275,354,50,25,15,80,105,540,12.1
184,Taurean Prince\taurean-prince-1,2015-16,Baylor,F,34,34,1040,187,433,.432,134,286,.469,53,147,.361,113,146,.774,81,125,206,77,43,25,91,86,540,11.2
185,Jalen Hayes\jalen-hayes-1,2016-17,Oakland,F,34,34,1025,217,397,.547,212,384,.552,5,13,.385,101,142,.711,82,191,273,54,39,25,55,105,540,13.1
186,Tim Williams\tim-williams-3,2015-16,New Mexico,F,32,32,1078,215,356,.604,215,356,.604,0,0,,109,163,.669,65,172,237,33,19,39,48,67,539,13.9
187,Jermaine Crumpton\jermaine-crumpton-1,2016-17,Canisius,F,34,34,967,195,397,.491,138,264,.523,57,133,.429,92,128,.719,65,88,153,45,33,11,68,86,539,10.8
188,Cecil Williams\cecil-williams-1,2017-18,Central Michigan,F,36,36,1088,181,386,.469,158,310,.510,23,76,.303,153,197,.777,56,177,233,94,36,37,101,106,538,11.1
189,Jordan Murphy\jordan-murphy-1,2017-18,Minnesota,F,32,32,1019,202,385,.525,191,350,.546,11,35,.314,123,176,.699,129,232,361,45,39,32,83,81,538,14.5
190,Yuta Watanabe\yuta-watanabe-1,2017-18,George Washington,F,33,33,1207,193,442,.437,137,288,.476,56,154,.364,96,119,.807,42,158,200,52,26,54,51,50,538,12.2
191,Jarelle Reischel\jarelle-reischel-1,2015-16,Eastern Kentucky,F,30,29,941,165,339,.487,125,234,.534,40,105,.381,167,213,.784,38,166,204,96,50,13,124,88,537,13.0
192,Javon McCrea\javon-mccrea-1,2013-14,Buffalo,F,29,29,937,202,360,.561,201,358,.561,1,2,.500,132,198,.667,112,174,286,64,44,65,70,92,537,17.2
193,Jared Sam\jared-sam-1,2017-18,Southern,F,33,32,1106,177,405,.437,176,404,.436,1,1,1.000,181,236,.767,102,188,290,44,28,25,75,66,536,12.2
194,Daniel Utomi\daniel-utomi-1,2017-18,Akron,F,32,31,1104,175,389,.450,87,170,.512,88,219,.402,97,126,.770,33,137,170,60,30,9,67,74,535,11.5
195,Desharick Guidry\desharick-guidry-1,2014-15,McNeese State,F,31,31,1092,195,400,.488,158,301,.525,37,99,.374,108,151,.715,135,211,346,51,40,20,66,86,535,14.9
196,Martin Breunig\martin-breunig-1,2014-15,Montana,F,32,32,963,214,361,.593,212,348,.609,2,13,.154,104,141,.738,82,151,233,60,17,27,76,110,534,12.9
197,Seth Tuttle\seth-tuttle-1,2014-15,Northern Iowa,F,35,35,1062,183,303,.604,164,259,.633,19,44,.432,149,195,.764,47,193,240,114,33,20,99,75,534,13.3
198,Chimezie Metu\chimezie-metu-1,2016-17,Southern California,F,36,36,1128,202,366,.552,201,364,.552,1,2,.500,129,174,.741,73,207,280,50,28,55,76,89,534,12.3
199,Averyl Ugba\averyl-ugba-1,2017-18,Austin Peay,F,34,34,1020,202,368,.549,186,324,.574,16,44,.364,114,170,.671,101,172,273,34,16,36,77,97,534,12.0
200,LaQuinton Ross\laquinton-ross-1,2013-14,Ohio State,F,35,35,1015,184,412,.447,142,293,.485,42,119,.353,123,168,.732,63,145,208,29,25,20,60,54,533,10.4
201,Dean Wade\dean-wade-1,2017-18,Kansas State,F,33,32,1083,198,360,.550,158,269,.587,40,91,.440,97,129,.752,43,160,203,89,51,27,47,64,533,14.7
202,Chimezie Metu\chimezie-metu-1,2017-18,Southern California,F,34,33,1053,205,392,.523,193,352,.548,12,40,.300,111,152,.730,64,189,253,53,27,59,68,87,533,12.6
203,Isaiah Pineiro\isaiah-pineiro-1,2017-18,San Diego,F,34,30,957,188,383,.491,161,305,.528,27,78,.346,130,166,.783,33,179,212,71,40,27,88,107,533,11.2
204,Shane Richards\shane-richards-1,2015-16,Manhattan,F,31,31,1125,154,398,.387,76,183,.415,78,215,.363,146,170,.859,19,99,118,52,29,3,63,77,532,10.4
205,Jalen Moore\jalen-moore-1,2016-17,Utah State,F,32,32,1117,183,385,.475,118,232,.509,65,153,.425,101,128,.789,30,146,176,86,17,15,65,48,532,12.3
206,J.J. Avila\jj-avila-1,2013-14,Colorado State,F,32,31,1070,186,410,.454,162,334,.485,24,76,.316,136,171,.795,82,155,237,106,35,16,78,84,532,13.1
207,Christopher Galbreath Jr.\christopher-galbreathjr-1,2017-18,Sam Houston State,F,36,36,1004,219,464,.472,202,413,.489,17,51,.333,77,115,.670,94,193,287,45,23,21,79,101,532,9.8
208,Milik Yarbrough\milik-yarbrough-1,2017-18,Illinois State,F,32,28,895,172,380,.453,141,273,.516,31,107,.290,156,194,.804,46,164,210,152,30,21,126,85,531,12.2
209,Grant Williams\grant-williams-1,2017-18,Tennessee,F,35,35,1008,183,387,.473,180,362,.497,3,25,.120,162,212,.764,80,131,211,66,21,44,74,116,531,11.0
210,Ajdin Penava\ajdin-penava-1,2017-18,Marshall,F,34,34,1001,191,340,.562,158,243,.650,33,97,.340,116,154,.753,67,221,288,66,32,134,67,121,531,15.4
211,Raasean Davis\raasean-davis-1,2017-18,North Carolina Central,F,35,35,1015,233,347,.671,233,346,.673,0,1,.000,64,109,.587,102,180,282,15,20,35,70,82,530,12.6
212,Dorian Finney-Smith\dorian-finney-smith-1,2015-16,Florida,F,36,36,1145,169,388,.436,98,194,.505,71,194,.366,121,165,.733,89,211,300,74,33,29,68,78,530,12.2
213,Zach LeDay\zach-leday-1,2016-17,Virginia Tech,F,32,5,945,178,329,.541,167,289,.578,11,40,.275,162,211,.768,78,157,235,38,19,33,60,88,529,13.3
214,Twymond Howard\twymond-howard-1,2015-16,Tennessee-Martin,F,34,33,1129,187,414,.452,165,353,.467,22,61,.361,133,180,.739,41,196,237,83,24,13,78,80,529,10.7
215,Brad Waldow\brad-waldow-1,2013-14,Saint Mary's (CA),F,35,33,1013,191,338,.565,191,337,.567,0,1,.000,147,239,.615,111,150,261,50,21,46,59,80,529,12.9
216,Terrell Miller Jr.\terrell-millerjr-1,2016-17,Murray State,F,33,31,976,184,386,.477,117,217,.539,67,169,.396,94,121,.777,78,191,269,46,26,7,79,108,529,11.3
217,Yante Maten\yante-maten-1,2016-17,Georgia,F,29,28,842,179,345,.519,158,302,.523,21,43,.488,149,208,.716,72,125,197,43,21,43,72,80,528,13.8
218,Noah Dickerson\noah-dickerson-1,2017-18,Washington,F,34,33,916,178,313,.569,176,308,.571,2,5,.400,169,215,.786,93,191,284,30,23,19,77,114,527,12.3
219,Augustine Rubit\augustine-rubit-1,2013-14,South Alabama,F,31,30,973,185,400,.463,164,336,.488,21,64,.328,136,204,.667,129,163,292,42,23,46,61,79,527,13.7
220,Jaron Lane\jaron-lane-1,2013-14,North Carolina-Asheville,F,32,31,1070,168,335,.501,132,246,.537,36,89,.404,155,201,.771,49,128,177,48,30,14,53,68,527,12.7
221,Rob Marberry\rob-marberry-1,2017-18,Lipscomb,F,33,33,940,218,356,.612,218,354,.616,0,2,.000,90,122,.738,67,125,192,62,23,23,50,76,526,13.3
222,Chima Moneke\chima-moneke-1,2016-17,UC-Davis,F,36,33,981,192,364,.527,192,364,.527,0,0,,142,220,.645,93,248,341,29,32,51,94,95,526,11.5
223,Brayon Blake\brayon-blake-1,2017-18,Idaho,F,31,31,898,202,404,.500,150,288,.521,52,116,.448,70,106,.660,65,233,298,38,22,15,60,93,526,12.5
224,Javonte Green\javonte-green-1,2014-15,Radford,F,34,34,891,185,340,.544,184,331,.556,1,9,.111,154,221,.697,97,210,307,43,65,29,69,85,525,14.0
225,Venky Jois\venky-jois-1,2015-16,Eastern Washington,F,32,32,1060,220,324,.679,220,324,.679,0,0,,85,181,.470,59,219,278,79,32,56,82,78,525,14.6
226,Jordan Caroline\jordan-caroline-1,2016-17,Nevada,F,35,34,1230,174,376,.463,146,293,.498,28,83,.337,148,251,.590,122,199,321,68,39,11,62,83,524,12.4
227,Jimmy Hall\jimmy-hall-1,2015-16,Kent State,F,32,30,960,212,434,.488,206,414,.498,6,20,.300,94,134,.701,93,161,254,72,20,18,97,87,524,11.1
228,Lotanna Nwogbo\lotanna-nwogbo-1,2015-16,Longwood,F,33,33,987,194,328,.591,193,326,.592,1,2,.500,135,206,.655,104,168,272,19,16,43,84,102,524,12.2
229,Stanley Johnson\stanley-johnson-1,2014-15,Arizona,F,38,37,1081,174,390,.446,131,274,.478,43,116,.371,132,178,.742,75,172,247,63,57,15,82,100,523,10.4
230,Reggie Upshaw\reggie-upshaw-1,2016-17,Middle Tennessee,F,36,36,1152,199,379,.525,166,275,.604,33,104,.317,92,127,.724,78,167,245,85,40,31,55,81,523,12.8
231,Johnny O'Bryant\johnny-obryant-1,2013-14,Louisiana State,F,34,34,1020,202,409,.494,201,406,.495,1,3,.333,118,186,.634,102,160,262,55,17,31,108,108,523,9.9
232,Janari Joesaar\janari-joesaar-1,2014-15,Texas-Rio Grande Valley,F,31,31,1053,157,341,.460,95,177,.537,62,164,.378,147,180,.817,67,139,206,75,39,18,86,80,523,13.2
233,Emmy Andujar\emmy-andujar-1,2014-15,Manhattan,F,32,31,1019,192,375,.512,188,359,.524,4,16,.250,135,192,.703,86,157,243,111,65,7,131,93,523,12.5
234,Femi Olujobi\femi-olujobi-1,2017-18,North Carolina A&T,F,32,28,1022,185,345,.536,167,283,.590,18,62,.290,135,174,.776,54,191,245,37,14,22,80,85,523,11.8
235,Josh Scott\josh-scott-2,2015-16,Colorado,F,32,31,979,187,352,.531,184,343,.536,3,9,.333,146,195,.749,87,195,282,58,20,51,40,56,523,15.2
236,Jeff Beverly\jeff-beverly-2,2016-17,Texas-San Antonio,F,33,33,889,183,461,.397,161,366,.440,22,95,.232,134,178,.753,76,118,194,33,13,6,77,96,522,8.1
237,V.J. Beachem\vj-beachem-1,2016-17,Notre Dame,F,36,36,1230,187,443,.422,100,202,.495,87,241,.361,61,73,.836,23,123,146,31,33,38,40,46,522,9.9
238,Jerome Frink\jerome-frink-1,2016-17,Long Island University,F,31,31,1012,200,423,.473,171,337,.507,29,86,.337,93,146,.637,69,206,275,72,30,31,91,84,522,12.0
239,Georges Niang\georges-niang-1,2014-15,Iowa State,F,34,34,1045,187,406,.461,141,291,.485,46,115,.400,101,125,.808,35,149,184,117,17,16,91,96,521,10.4
240,Dedric Lawson\dedric-lawson-1,2015-16,Memphis,F,33,32,1062,182,445,.409,154,365,.422,28,80,.350,129,182,.709,104,203,307,84,39,55,104,86,521,11.9
241,Robert Franks\robert-franks-1,2017-18,Washington State,F,30,30,989,175,368,.476,109,205,.532,66,163,.405,105,123,.854,49,148,197,58,15,29,70,85,521,12.6
242,Brandon Edwards\brandon-edwards-3,2013-14,Texas-Arlington,F,32,32,1104,173,335,.516,132,221,.597,41,114,.360,134,171,.784,114,200,314,26,24,55,43,84,521,15.2
243,Mike Myers\mike-myers-1,2014-15,Maryland-Eastern Shore,F,33,32,871,169,285,.593,168,279,.602,1,6,.167,181,282,.642,87,145,232,45,39,12,105,111,520,11.6
244,Brandon Taylor\brandon-taylor-2,2015-16,Penn State,F,32,32,1032,188,434,.433,137,292,.469,51,142,.359,93,128,.727,51,156,207,50,19,17,80,94,520,9.6
245,L.J. Peak\lj-peak-1,2016-17,Georgetown,F,32,32,1051,167,348,.480,134,247,.543,33,101,.327,152,191,.796,33,89,122,111,34,12,86,88,519,11.7
246,Cory Jefferson\cory-jefferson-1,2013-14,Baylor,F,38,38,1103,184,368,.500,170,330,.515,14,38,.368,137,214,.640,107,205,312,37,15,49,51,83,519,11.4
247,Dion Wright\dion-wright--1,2015-16,St. Bonaventure,F,31,30,1150,199,426,.467,175,350,.500,24,76,.316,97,122,.795,90,192,282,38,30,23,45,87,519,13.0
248,Montrezl Harrell\montrezl-harrell-1,2013-14,Louisville,F,37,37,1083,223,366,.609,221,363,.609,2,3,.667,71,153,.464,120,191,311,45,38,49,53,89,519,12.9
249,Desi Rodriguez\desi-rodriguez-1,2016-17,Seton Hall,F,33,33,1054,192,437,.439,142,296,.480,50,141,.355,85,133,.639,43,128,171,58,27,14,69,83,519,9.5
250,Rodney Bullock\rodney-bullock-1,2016-17,Providence,F,33,33,1082,177,406,.436,131,261,.502,46,145,.317,119,159,.748,45,166,211,47,38,27,81,76,519,10.6
251,Marcus Gilbert\marcus-gilbert-1,2015-16,Fairfield,F,31,31,1020,165,385,.429,87,176,.494,78,209,.373,111,142,.782,24,138,162,45,29,19,67,71,519,11.0
252,Christian Wood\christian-wood-1,2014-15,Nevada-Las Vegas,F,33,32,1078,187,376,.497,162,288,.563,25,88,.284,120,163,.736,94,235,329,43,11,90,79,86,519,13.3
253,Mike Daum\mike-daum-1,2015-16,South Dakota State,F,34,3,706,172,311,.553,143,246,.581,29,65,.446,145,176,.824,71,136,207,27,17,11,56,71,518,12.0
254,Ike Azotam\ike-azotam-1,2013-14,Quinnipiac,F,32,32,1068,196,408,.480,196,407,.482,0,1,.000,126,201,.627,132,195,327,31,10,35,63,90,518,12.2
255,Venky Jois\venky-jois-1,2014-15,Eastern Washington,F,31,31,966,210,344,.610,207,334,.620,3,10,.300,95,176,.540,82,156,238,63,37,69,71,75,518,14.9
256,J.J. Avila\jj-avila-1,2014-15,Colorado State,F,31,31,995,206,373,.552,197,336,.586,9,37,.243,97,153,.634,91,140,231,88,62,11,84,81,518,14.1
257,Michael Young\michael-young-3,2015-16,Pittsburgh,F,33,32,971,189,352,.537,185,340,.544,4,12,.333,136,175,.777,76,152,228,77,11,18,81,54,518,12.3
258,Ethan Happ\ethan-happ-1,2016-17,Wisconsin,F,37,37,1033,218,371,.588,218,371,.588,0,0,,81,162,.500,117,215,332,105,67,43,80,102,517,13.7
259,Kelan Martin\kelan-martin-1,2015-16,Butler,F,33,14,935,183,409,.447,137,287,.477,46,122,.377,105,138,.761,52,172,224,36,25,18,54,88,517,10.7
260,Nigel Hayes\nigel-hayes-1,2016-17,Wisconsin,F,37,37,1190,180,394,.457,158,324,.488,22,70,.314,135,230,.587,82,163,245,100,28,14,63,67,517,10.8
261,Tymell Murphy\tymell-murphy-1,2013-14,Florida International,F,31,30,1066,198,338,.586,185,292,.634,13,46,.283,107,163,.656,67,163,230,70,60,47,91,90,516,14.4
262,Stefan Jankovic\stefan-jankovic-1,2015-16,Hawaii,F,33,33,817,172,317,.543,139,233,.597,33,84,.393,139,180,.772,57,161,218,39,20,40,58,100,516,12.5
263,Demetrius Treadwell\demetrius-treadwell-1,2013-14,Akron,F,34,34,1131,181,395,.458,180,385,.468,1,10,.100,153,253,.605,113,180,293,63,33,29,85,60,516,11.6
264,Malcolm Riley\malcolm-riley--1,2015-16,Texas Southern,F,33,30,1051,173,383,.452,96,173,.555,77,210,.367,92,117,.786,53,135,188,29,15,5,48,64,515,10.6
265,Marvin Dominique\marvin-dominique-1,2013-14,Saint Peter's,F,31,30,1040,190,400,.475,156,301,.518,34,99,.343,100,133,.752,92,183,275,20,29,27,72,81,514,12.1
266,Matt Tiby\matt-tiby-1,2015-16,Milwaukee,F,33,33,993,155,340,.456,112,225,.498,43,115,.374,161,195,.826,60,212,272,66,11,10,68,78,514,12.0
267,Victor Rudd\victor-rudd-1,2013-14,South Florida,F,32,32,1085,180,431,.418,147,304,.484,33,127,.260,121,164,.738,21,197,218,59,19,18,69,69,514,9.9
268,De'Mon Brooks\demon-brooks-1,2013-14,Davidson,F,27,26,724,173,295,.586,159,264,.602,14,31,.452,154,207,.744,60,131,191,37,18,22,60,94,514,14.8
269,Jerome Frink\jerome-frink-1,2015-16,Long Island University,F,31,31,1006,197,392,.503,160,294,.544,37,98,.378,83,124,.669,96,182,278,39,39,39,83,97,514,12.8
270,Scott Eatherton\scott-eatherton-1,2014-15,Northeastern,F,35,34,1054,197,333,.592,189,302,.626,8,31,.258,111,160,.694,63,161,224,53,19,43,71,92,513,11.7
271,Dave Dudzinski\dave-dudzinski-1,2013-14,Holy Cross,F,34,34,1057,184,393,.468,158,319,.495,26,74,.351,119,157,.758,87,164,251,21,24,26,65,82,513,10.8
272,Trevon Bluiett\trevon-bluiett-1,2015-16,Xavier,F,34,34,1042,170,401,.424,92,205,.449,78,196,.398,94,122,.770,49,160,209,74,31,11,56,79,512,11.0
273,Peyton Aldridge\peyton-aldridge-1,2015-16,Davidson,F,33,33,1143,179,364,.492,130,231,.563,49,133,.368,105,124,.847,68,147,215,74,19,33,47,86,512,12.9
274,Juwan Morgan\juwan-morgan-1,2017-18,Indiana,F,31,30,912,195,337,.579,179,284,.630,16,53,.302,106,168,.631,84,144,228,47,37,44,51,77,512,14.5
275,Jordan Dykstra\jordan-dykstra-1,2013-14,South Dakota State,F,32,32,1021,156,344,.453,105,217,.484,51,127,.402,149,178,.837,56,186,242,60,20,6,55,82,512,12.4
276,Casey Prather\casey-prather-1,2013-14,Florida,F,37,35,1034,190,315,.603,188,310,.606,2,5,.400,129,190,.679,72,112,184,60,37,20,80,78,511,11.0
277,Vince Edwards\vince-edwards-2,2017-18,Purdue,F,35,35,1106,180,378,.476,129,250,.516,51,128,.398,100,120,.833,71,188,259,101,18,21,71,62,511,12.1
278,Matt Klinewski\matt-klinewski-1,2017-18,Lafayette,F,31,31,831,177,351,.504,126,232,.543,51,119,.429,105,129,.814,35,144,179,46,14,22,61,74,510,11.7
279,Travis Munnings\travis-munnings-1,2017-18,Louisiana-Monroe,F,32,32,1106,185,394,.470,115,213,.540,70,181,.387,70,97,.722,53,180,233,76,40,6,53,80,510,12.5
280,Khris Lane\khris-lane-1,2016-17,Longwood,F,30,30,1034,207,386,.536,175,291,.601,32,95,.337,64,93,.688,49,169,218,36,24,35,69,83,510,12.3
281,Cameron Oliver\cameron-oliver-1,2015-16,Nevada,F,38,33,1118,200,395,.506,180,334,.539,20,61,.328,89,134,.664,103,242,345,30,23,99,79,116,509,11.2
282,Deng Adel\deng-adel-1,2017-18,Louisville,F,34,33,1126,178,397,.448,128,254,.504,50,143,.350,103,131,.786,22,154,176,94,21,11,77,49,509,10.3
283,Anthony Gill\anthony-gill-1,2015-16,Virginia,F,37,37,1037,189,326,.580,187,324,.577,2,2,1.000,129,173,.746,80,147,227,28,24,21,42,85,509,11.4
284,B.J. Johnson\bj-johnson-2,2016-17,La Salle,F,29,28,945,168,374,.449,104,197,.528,64,177,.362,109,130,.838,39,144,183,28,33,14,68,71,509,11.8
285,Earl Brown\earl-brown-3,2014-15,Saint Francis (PA),F,32,32,1133,188,349,.539,171,297,.576,17,52,.327,115,169,.680,74,181,255,61,34,31,106,59,508,12.3
286,TaShawn Thomas\tashawn-thomas-1,2013-14,Houston,F,33,33,1044,205,347,.591,204,341,.598,1,6,.167,97,163,.595,93,173,266,63,41,90,74,66,508,14.7
287,Scott Eatherton\scott-eatherton-1,2013-14,Northeastern,F,32,32,994,180,333,.541,165,299,.552,15,34,.441,133,200,.665,103,224,327,37,17,57,86,97,508,13.0
288,Javion Ogunyemi\javion-ogunyemi-1,2015-16,Siena,F,34,33,1065,182,335,.543,175,312,.561,7,23,.304,136,201,.677,113,95,208,33,14,71,66,105,507,11.9
289,Marcus Gilbert\marcus-gilbert-1,2014-15,Fairfield,F,31,31,1075,154,348,.443,98,177,.554,56,171,.327,143,184,.777,49,124,173,38,25,19,67,70,507,11.3
290,Justin Johnson\justin-johnson-7,2015-16,Western Kentucky,F,34,26,984,197,328,.601,196,319,.614,1,9,.111,112,166,.675,102,168,270,48,16,19,58,73,507,12.7
291,James Demery\james-demery-1,2017-18,Saint Joseph's,F,30,25,1024,195,409,.477,173,330,.524,22,79,.278,95,149,.638,49,116,165,33,35,9,45,48,507,11.5
292,Tyler Cook\tyler-cook-1,2017-18,Iowa,F,33,33,923,192,339,.566,191,332,.575,1,7,.143,121,183,.661,72,152,224,58,21,20,82,87,506,11.4
293,Luis Jacobo\luis-jacobo-2,2013-14,Purdue-Fort Wayne,F,33,21,964,171,370,.462,97,184,.527,74,186,.398,89,110,.809,24,135,159,45,25,9,58,57,505,10.5
294,Shonn Miller\shonn-miller-1,2014-15,Cornell,F,30,30,940,168,387,.434,140,283,.495,28,104,.269,141,169,.834,28,226,254,30,38,54,53,86,505,12.9
295,Jarvis Williams\jarvis-williams-3,2013-14,Murray State,F,34,34,1105,184,284,.648,184,284,.648,0,0,,137,208,.659,128,210,338,22,26,60,67,89,505,14.3
296,Dwight Powell\dwight-powell-1,2013-14,Stanford,F,36,36,1167,175,379,.462,165,340,.485,10,39,.256,145,211,.687,70,177,247,112,47,30,104,113,505,10.6
297,Ryan Anderson\ryan-anderson-3,2015-16,Arizona,F,33,33,963,174,319,.545,172,312,.551,2,7,.286,155,208,.745,99,235,334,26,23,20,63,70,505,13.2
298,Zach Auguste\zach-auguste-1,2015-16,Notre Dame,F,36,36,1065,192,343,.560,192,343,.560,0,0,,120,191,.628,122,264,386,38,23,39,88,86,504,12.0
299,Steve Taylor\steve-taylor-2,2016-17,Toledo,F,33,32,1058,210,400,.525,200,350,.571,10,50,.200,74,150,.493,78,326,404,123,10,16,117,70,504,11.9
300,Taylor Johns\taylor-johns-1,2014-15,UC-Riverside,F,31,31,1067,191,411,.465,182,373,.488,9,38,.237,113,177,.638,80,175,255,59,37,52,106,91,504,11.2
301,Cody Martin\cody-martin-1,2017-18,Nevada,F,36,34,1284,193,374,.516,178,323,.551,15,51,.294,103,147,.701,65,160,225,169,60,53,73,87,504,14.0
302,Angel Delgado\angel-delgado-1,2016-17,Seton Hall,F,33,33,1090,197,363,.543,197,363,.543,0,0,,109,196,.556,166,264,430,74,21,10,99,83,503,13.2
303,Reginald Johnson\reginald-johnson-1,2016-17,Alcorn State,F,32,3,805,205,388,.528,178,303,.587,27,85,.318,65,88,.739,83,144,227,25,14,12,44,53,502,11.9
304,Wendell Carter Jr.\wendell-carterjr-1,2017-18,Duke,F,37,37,993,179,319,.561,160,273,.586,19,46,.413,124,168,.738,109,226,335,74,30,76,75,105,501,13.3
305,John Carroll\john-carroll-2,2017-18,Hartford,F,33,32,1038,174,371,.469,154,305,.505,20,66,.303,133,186,.715,56,156,212,80,18,30,67,89,501,11.2
306,Tavrion Dawson\tavrion-dawson-1,2017-18,Cal State Northridge,F,30,29,988,195,441,.442,168,336,.500,27,105,.257,84,118,.712,45,152,197,60,27,22,70,64,501,10.8
307,Kennedy Meeks\kennedy-meeks-1,2016-17,North Carolina,F,40,40,973,206,372,.554,206,371,.555,0,1,.000,89,143,.622,152,226,378,41,38,47,48,94,501,12.2
308,Stacy Davis\stacy-davis-1,2014-15,Pepperdine,F,32,26,1025,165,349,.473,150,297,.505,15,52,.288,156,193,.808,75,173,248,59,30,35,87,74,501,12.2
309,Jeremy Hollowell\jeremy-hollowell-1,2016-17,Georgia State,F,33,33,1015,175,411,.426,116,235,.494,59,176,.335,91,121,.752,33,163,196,57,32,25,85,102,500,9.3
310,Eric Stutz\eric-stutz-1,2014-15,Eastern Kentucky,F,32,30,1025,190,312,.609,165,259,.637,25,53,.472,94,118,.797,61,121,182,76,27,21,68,57,499,13.4
311,Rodney Williams\rodney-williams-5,2016-17,Drexel,F,32,32,973,184,350,.526,181,337,.537,3,13,.231,128,190,.674,80,137,217,48,15,27,72,112,499,11.0
312,Scottie James\scottie-james-1,2017-18,Liberty,F,37,35,943,189,307,.616,174,261,.667,15,46,.326,106,141,.752,94,235,329,41,15,33,50,80,499,12.6
313,Grant Golden\grant-golden-1,2017-18,Richmond,F,32,32,981,208,418,.498,186,338,.550,22,80,.275,60,96,.625,49,166,215,69,19,39,82,79,498,10.6
314,Zachary Hamilton\zachary-hamilton-1,2016-17,Prairie View,F,33,29,1006,163,386,.422,83,186,.446,80,200,.400,92,111,.829,27,109,136,34,40,17,43,84,498,10.2
315,Larry Nance\larry-nance-2,2014-15,Wyoming,F,31,30,1082,185,360,.514,171,318,.538,14,42,.333,114,145,.786,44,180,224,76,37,37,70,69,498,13.3
316,Jaylen Brown\jaylen-brown-1,2015-16,University of California,F,34,34,939,163,378,.431,133,276,.482,30,102,.294,142,217,.654,36,146,182,68,27,22,105,108,498,8.2
317,Leland King\leland-king-1,2017-18,UC-Santa Barbara,F,32,31,1017,186,401,.464,133,273,.487,53,128,.414,73,97,.753,66,261,327,61,24,5,40,52,498,13.0
318,Cole Dickerson\cole-dickerson-1,2013-14,San Francisco,F,33,33,1004,196,382,.513,151,255,.592,45,127,.354,61,123,.496,65,188,253,57,25,13,65,94,498,10.8
319,Maurice Ndour\maurice-ndour-1,2013-14,Ohio,F,36,31,1084,182,356,.511,164,302,.543,18,54,.333,116,159,.730,58,194,252,56,22,55,89,95,498,10.4
320,Nigel Hayes\nigel-hayes-1,2014-15,Wisconsin,F,40,40,1319,166,334,.497,126,233,.541,40,101,.396,125,168,.744,85,162,247,79,34,16,51,76,497,11.0
321,LeAntwan Luckett\leantwan-luckett-1,2013-14,Alcorn State,F,31,22,924,171,404,.423,148,323,.458,23,81,.284,132,193,.684,24,48,72,69,43,7,82,88,497,8.7
322,Shane Hammink\shane-hammink-1,2016-17,Valparaiso,F,33,33,1042,169,338,.500,128,214,.598,41,124,.331,118,146,.808,30,100,130,81,34,11,84,63,497,10.8
323,Rashid Gaston\rashid-gaston-1,2014-15,Norfolk State,F,32,28,983,204,326,.626,204,326,.626,0,0,,88,162,.543,106,200,306,45,8,37,66,89,496,13.1
324,Jacob Parker\jacob-parker-1,2013-14,Stephen F. Austin,F,35,34,1010,175,325,.538,152,276,.551,23,49,.469,123,154,.799,86,161,247,70,48,19,42,100,496,13.2
325,DeAndre Daniels\deandre-daniels-1,2013-14,Connecticut,F,38,38,1103,188,401,.469,138,281,.491,50,120,.417,70,89,.787,55,173,228,17,26,54,56,90,496,9.4
326,Johnathan Williams\johnathan-williams-2,2017-18,Gonzaga,F,37,36,1082,197,350,.563,189,315,.600,8,35,.229,94,174,.540,87,226,313,59,27,40,80,98,496,10.9
327,Vladimir Brodziansky\vladimir-brodziansky-1,2017-18,Texas Christian,F,33,33,897,179,309,.579,158,247,.640,21,62,.339,117,143,.818,68,99,167,38,10,55,41,72,496,12.8
328,Jarrell Brantley\jarrell-brantley-1,2016-17,College of Charleston,F,35,34,1120,170,370,.459,139,286,.486,31,84,.369,125,165,.758,61,232,293,43,39,24,90,102,496,10.2
329,Zane Najdawi\zane-najdawi-1,2016-17,Citadel,F,33,32,791,157,334,.470,129,269,.480,28,65,.431,154,185,.832,93,127,220,26,33,38,73,113,496,11.4
330,Alize Johnson\alize-johnson-1,2017-18,Missouri State,F,33,33,1028,172,400,.430,131,254,.516,41,146,.281,110,145,.759,104,280,384,94,15,14,74,69,495,12.6
331,Jameel Warney\jameel-warney-1,2013-14,Stony Brook,F,34,31,1001,204,331,.616,204,331,.616,0,0,,86,142,.606,97,176,273,66,25,42,43,75,494,13.8
332,Justin Strings\justin-strings-1,2016-17,Sacramento State,F,31,30,1021,179,424,.422,124,267,.464,55,157,.350,81,133,.609,37,133,170,32,12,11,47,69,494,9.1
333,Tyler Seibring\tyler-seibring-1,2017-18,Elon,F,32,31,1090,183,373,.491,101,182,.555,82,191,.429,46,65,.708,48,168,216,70,9,21,35,49,494,12.5
334,Bam Adebayo\edrice-adebayo-1,2016-17,Kentucky,F,38,38,1145,170,284,.599,170,283,.601,0,1,.000,154,236,.653,118,186,304,32,26,57,64,99,494,11.9
335,Josh Scott\josh-scott-2,2013-14,Colorado,F,35,34,1107,159,311,.511,159,309,.515,0,2,.000,175,216,.810,102,193,295,22,28,40,51,63,493,12.8
336,Kyle Cain\kyle-cain-1,2013-14,North Carolina-Greensboro,F,32,32,973,201,422,.476,192,391,.491,9,31,.290,82,115,.713,77,208,285,37,22,11,64,72,493,10.7
337,Brice Johnson\brice-johnson-1,2014-15,North Carolina,F,38,37,940,207,366,.566,207,366,.566,0,0,,78,115,.678,89,206,295,35,26,42,58,112,492,10.7
338,Vince Hunter\vince-hunter-1,2014-15,Texas-El Paso,F,33,30,940,182,346,.526,178,336,.530,4,10,.400,124,206,.602,88,217,305,55,41,34,92,98,492,11.8
339,Daviyon Draper\daviyon-draper-1,2015-16,Florida International,F,31,31,1089,195,430,.453,162,346,.468,33,84,.393,69,98,.704,44,173,217,68,31,20,85,76,492,10.2
340,Justise Winslow\justise-winslow-1,2014-15,Duke,F,39,39,1135,173,356,.486,127,246,.516,46,110,.418,100,156,.641,49,203,252,82,52,34,71,108,492,10.4
341,Deontae Hawkins\deontae-hawkins-1,2016-17,Illinois State,F,35,35,956,186,396,.470,116,238,.487,70,158,.443,49,63,.778,60,168,228,40,26,25,50,93,491,10.3
342,Okaro White\okaro-white-1,2013-14,Florida State,F,36,35,1084,166,323,.514,142,259,.548,24,64,.375,134,168,.798,75,168,243,34,27,40,68,108,490,10.8
343,LeAntwan Luckett\leantwan-luckett-1,2014-15,Alcorn State,F,30,30,1031,158,424,.373,111,272,.408,47,152,.309,127,181,.702,52,51,103,52,40,13,68,86,490,9.0
344,Aurimas Majauskas\aurimas-majauskas-1,2015-16,Sam Houston State,F,34,34,811,160,290,.552,141,231,.610,19,59,.322,151,190,.795,62,128,190,54,8,15,51,123,490,11.0
345,Marc Loving\marc-loving-1,2015-16,Ohio State,F,35,35,1189,152,367,.414,96,202,.475,56,165,.339,130,172,.756,43,141,184,54,22,14,82,59,490,9.0
346,Emmanuel Omogbo\emmanuel-omogbo-1,2016-17,Colorado State,F,36,36,1095,171,355,.482,140,266,.526,31,89,.348,117,176,.665,101,272,373,62,38,23,69,98,490,11.9
347,LaDontae Henton\ladontae-henton-1,2013-14,Providence,F,35,35,1299,168,377,.446,120,243,.494,48,134,.358,106,142,.746,86,190,276,59,46,20,55,83,490,11.7
348,Lucas Troutman\lucas-troutman-1,2013-14,Elon,F,31,31,896,185,350,.529,184,349,.527,1,1,1.000,119,168,.708,49,143,192,25,23,58,65,70,490,11.8
349,Manny Atkins\manny-atkins-1,2013-14,Georgia State,F,34,34,1136,153,324,.472,78,151,.517,75,173,.434,108,131,.824,31,177,208,48,46,24,43,78,489,12.1
350,Jacob Evans\jacob-evans-1,2016-17,Cincinnati,F,36,36,1138,169,357,.473,100,192,.521,69,165,.418,82,112,.732,53,96,149,96,47,30,45,76,489,11.7
351,James Webb\james-webb-1,2015-16,Boise State,F,31,31,944,177,358,.494,150,249,.602,27,109,.248,108,158,.684,74,209,283,34,44,20,49,94,489,12.9
352,Akwasi Yeboah\akwasi-yeboah-1,2017-18,Stony Brook,F,32,31,912,156,345,.452,97,179,.542,59,166,.355,118,147,.803,30,132,162,44,28,7,74,81,489,9.9
353,Adrian Diaz\adrian-diaz-1,2015-16,Florida International,F,32,31,953,180,277,.650,180,277,.650,0,0,,128,206,.621,102,149,251,28,20,93,68,113,488,13.8
354,Jayson Tatum\jayson-tatum-1,2016-17,Duke,F,29,27,966,165,365,.452,125,248,.504,40,117,.342,118,139,.849,39,174,213,62,39,33,76,86,488,12.6
355,Chase Fieler\chase-fieler-1,2013-14,Florida Gulf Coast,F,35,35,1003,187,341,.548,169,282,.599,18,59,.305,96,136,.706,87,173,260,55,27,32,55,109,488,11.7
356,Seth Gearhart\seth-gearhart-1,2014-15,Rice,F,32,32,1084,143,324,.441,74,151,.490,69,173,.399,133,163,.816,36,134,170,58,31,12,71,89,488,10.8
357,Alize Johnson\alize-johnson-1,2016-17,Missouri State,F,33,33,997,169,346,.488,129,243,.531,40,103,.388,109,161,.677,110,241,351,63,20,6,76,83,487,12.1
358,Cody Larson\cody-larson-1,2014-15,South Dakota State,F,35,35,999,172,346,.497,169,337,.501,3,9,.333,140,191,.733,71,181,252,64,22,37,65,102,487,11.0
359,Justin Jackson\justin-jackson-4,2015-16,North Carolina,F,40,38,1135,194,416,.466,159,296,.537,35,120,.292,64,96,.667,71,85,156,111,25,17,42,69,487,9.5
360,Erik McCree\erik-mccree-1,2015-16,Louisiana Tech,F,30,29,955,165,373,.442,117,235,.498,48,138,.348,108,151,.715,39,184,223,38,20,16,74,68,486,10.4
361,Anton Grady\anton-gandy-1,2014-15,Cleveland State,F,34,34,1010,191,391,.488,187,381,.491,4,10,.400,100,155,.645,78,190,268,59,51,47,73,104,486,11.4
362,Admiral Schofield\admiral-schofield-1,2017-18,Tennessee,F,35,34,982,177,396,.447,113,234,.483,64,162,.395,68,90,.756,56,168,224,52,34,15,63,102,486,9.6
363,Jordan Loveridge\jordan-loveridge-1,2013-14,Utah,F,33,33,1136,163,388,.420,119,244,.488,44,144,.306,115,143,.804,46,184,230,77,25,15,65,59,485,10.8
364,Nick Ward\nick-ward-1,2016-17,Michigan State,F,35,21,694,181,306,.592,181,306,.592,0,0,,123,200,.615,97,130,227,14,12,54,58,98,485,10.9
365,Bruce Beckford\bruce-beckford-1,2014-15,North Carolina A&T,F,32,31,1063,167,378,.442,141,281,.502,26,97,.268,125,152,.822,70,163,233,45,28,22,88,85,485,10.2
366,Stephen Maxwell\stephen-maxwell-1,2014-15,Cal State Northridge,F,33,33,1111,171,350,.489,171,350,.489,0,0,,143,194,.737,108,155,263,19,25,5,67,88,485,10.6
367,Rodney Bullock\rodney-bullock-1,2017-18,Providence,F,34,34,1121,164,377,.435,117,236,.496,47,141,.333,110,149,.738,50,148,198,39,27,33,66,85,485,9.6
368,Shaq Goodwin\shaq-goodwin-1,2015-16,Memphis,F,33,32,976,162,338,.479,159,326,.488,3,12,.250,157,216,.727,77,172,249,49,33,61,65,105,484,12.0
369,Torrion Brummitt\torrion-brummitt-1,2015-16,Western Carolina,F,34,34,956,184,362,.508,175,318,.550,9,44,.205,107,171,.626,67,184,251,47,31,27,98,128,484,9.2
370,James Michael McAdoo\james-michael-mcadoo-1,2013-14,North Carolina,F,34,34,1023,173,378,.458,173,371,.466,0,7,.000,138,257,.537,90,140,230,59,45,31,48,92,484,10.9
371,Glenn Robinson\glenn-robinson-2,2013-14,Michigan,F,37,37,1194,182,373,.488,149,265,.562,33,108,.306,87,115,.757,54,110,164,44,35,11,46,55,484,9.8
372,Josh Cunningham\josh-cunningham-1,2017-18,Dayton,F,31,31,981,186,288,.646,178,254,.701,8,34,.235,103,149,.691,79,182,261,54,16,13,71,96,483,12.9
373,Tim Coleman\tim-coleman-2,2015-16,NJIT,F,35,34,967,165,352,.469,118,238,.496,47,114,.412,106,139,.763,43,219,262,82,51,32,76,109,483,11.3
374,Terrell Miller Jr.\terrell-millerjr-1,2017-18,Murray State,F,32,32,979,178,355,.501,108,181,.597,70,174,.402,57,79,.722,34,241,275,50,26,16,59,80,483,11.7
375,Brett Bailey\brett-bailey-1,2016-17,San Diego,F,31,31,1050,155,357,.434,122,262,.466,33,95,.347,140,185,.757,58,157,215,52,23,11,70,83,483,10.6
376,Justin Strings\justin-strings-1,2015-16,Sacramento State,F,31,21,976,174,354,.492,114,202,.564,60,152,.395,74,96,.771,51,158,209,30,20,25,29,86,482,12.0
377,Shakur Juiston\shakur-juiston-1,2017-18,Nevada-Las Vegas,F,33,33,1002,218,341,.639,216,339,.637,2,2,1.000,44,86,.512,89,240,329,64,30,21,84,93,482,12.6
378,Will Rayman\will-rayman-1,2017-18,Colgate,F,33,33,1052,160,358,.447,94,200,.470,66,158,.418,96,119,.807,62,159,221,38,34,28,54,83,482,11.2
379,Matt Klinewski\matt-klinewski-1,2016-17,Lafayette,F,30,30,825,195,380,.513,195,377,.517,0,3,.000,91,118,.771,48,131,179,36,14,16,76,80,481,9.9
380,Phil Valenti\phil-valenti-1,2015-16,Canisius,F,33,33,1036,170,366,.464,123,245,.502,47,121,.388,94,122,.770,60,141,201,65,31,15,51,89,481,11.1
381,Anthony Livingston\anthony-livingston-1,2015-16,Arkansas State,F,31,31,961,168,390,.431,146,306,.477,22,84,.262,122,142,.859,80,210,290,15,19,25,54,90,480,11.0
382,Seth Towns\seth-towns-1,2017-18,Harvard,F,30,24,838,161,384,.419,98,241,.407,63,143,.441,95,118,.805,32,138,170,54,25,19,64,74,480,10.4
383,Reggie Upshaw\reggie-upshaw-1,2015-16,Middle Tennessee,F,35,35,1091,185,372,.497,158,301,.525,27,71,.380,83,168,.494,103,195,298,76,51,29,64,81,480,12.0
384,Ed Polite Jr.\ed-politejr-1,2017-18,Radford,F,36,34,1154,166,350,.474,144,270,.533,22,80,.275,125,172,.727,81,202,283,53,68,34,67,83,479,11.9
385,Stacy Davis\stacy-davis-1,2015-16,Pepperdine,F,32,32,1093,159,353,.450,128,260,.492,31,93,.333,130,174,.747,83,209,292,64,18,19,72,80,479,11.6
386,JayVaughn Pinkston\jayvaughn-pinkston-1,2013-14,Villanova,F,34,33,921,160,307,.521,152,276,.551,8,31,.258,151,203,.744,74,134,208,49,31,19,58,83,479,11.4
387,Josh Hawkinson\josh-hawkinson-1,2016-17,Washington State,F,31,31,1097,173,326,.531,145,257,.564,28,69,.406,105,126,.833,56,259,315,79,19,25,53,73,479,14.1
388,Zane Najdawi\zane-najdawi-1,2017-18,Citadel,F,31,31,781,172,335,.513,128,227,.564,44,108,.407,91,128,.711,37,118,155,30,21,42,79,69,479,10.5
389,Maurice Ndour\maurice-ndour-1,2014-15,Ohio,F,30,29,1047,164,339,.484,137,277,.495,27,62,.435,124,158,.785,68,182,250,50,33,68,89,83,479,13.0
390,Jeromie Hill\jeromie-hill-1,2014-15,Texas-San Antonio,F,30,30,1006,183,433,.423,127,277,.458,56,156,.359,57,93,.613,73,171,244,40,33,20,73,75,479,10.3
391,Evan Boudreaux\evan-boudreaux-1,2015-16,Dartmouth,F,27,27,868,155,341,.455,127,272,.467,28,69,.406,140,169,.828,64,190,254,31,22,7,70,72,478,12.6
392,Seth Tuttle\seth-tuttle-1,2013-14,Northern Iowa,F,31,31,916,156,300,.520,147,262,.561,9,38,.237,157,203,.773,72,177,249,72,30,34,65,76,478,13.7
393,Jordan Mickey\jordan-mickey-1,2014-15,Louisiana State,F,31,31,1081,191,379,.504,190,370,.514,1,9,.111,95,147,.646,99,209,308,40,29,112,101,81,478,13.0
394,Davante Gardner\davante-gardner-1,2013-14,Marquette,F,32,8,850,159,301,.528,157,285,.551,2,16,.125,157,201,.781,69,113,182,43,10,15,36,65,477,12.0
395,Spencer Parker\spencer-parker-1,2015-16,Bowling Green State,F,34,32,986,164,355,.462,131,277,.473,33,78,.423,116,162,.716,51,124,175,58,16,14,80,73,477,9.0
396,Tanner Leissner\tanner-leissner-1,2015-16,New Hampshire,F,30,29,984,170,389,.437,148,312,.474,22,77,.286,115,153,.752,75,143,218,46,11,5,65,73,477,10.2
397,Steven Davis\steven-davis-2,2016-17,Wright State,F,32,32,901,169,342,.494,117,206,.568,52,136,.382,87,113,.770,54,85,139,32,16,14,66,94,477,9.5
398,Kirk Van Slyke\kirk-van-slyke-1,2013-14,Arkansas State,F,32,32,987,162,313,.518,124,220,.564,38,93,.409,115,141,.816,63,125,188,33,24,38,53,83,477,11.9
399,Quincy Ford\quincy-ford-1,2015-16,Northeastern,F,29,29,1008,158,386,.409,93,199,.467,65,187,.348,96,129,.744,45,157,202,75,43,25,63,62,477,12.4
400,Javion Ogunyemi\javion-ogunyemi-1,2016-17,Siena,F,34,34,1091,176,329,.535,171,309,.553,5,20,.250,119,189,.630,91,103,194,42,21,65,66,109,476,10.9
401,Jimmy Hall\jimmy-hall-1,2014-15,Kent State,F,30,28,859,193,363,.532,191,358,.534,2,5,.400,88,129,.682,89,142,231,46,15,29,68,96,476,11.6
402,Kyle Kuzma\kyle-kuzma-1,2016-17,Utah,F,29,29,894,182,361,.504,155,277,.560,27,84,.321,85,127,.669,81,190,271,71,18,14,62,46,476,13.5
403,Zach Auguste\zach-auguste-1,2014-15,Notre Dame,F,37,36,904,190,307,.619,190,307,.619,0,0,,96,151,.636,82,157,239,29,25,25,61,94,476,10.4
404,Jalen Cannon\jalen-cannon-1,2013-14,St. Francis (NY),F,32,32,959,164,335,.490,151,287,.526,13,48,.271,135,189,.714,94,169,263,39,20,17,37,57,476,12.5
405,Jamel Artis\jamel-artis-1,2015-16,Pittsburgh,F,33,33,991,165,351,.470,116,216,.537,49,135,.363,96,123,.780,41,119,160,98,19,8,80,59,475,10.3
406,Dwayne Evans\dwayne-evans-1,2013-14,Saint Louis,F,34,34,1005,168,340,.494,163,322,.506,5,18,.278,134,179,.749,66,156,222,42,41,20,82,96,475,10.1
407,Phil Valenti\phil-valenti-1,2016-17,Canisius,F,34,34,1026,181,361,.501,150,270,.556,31,91,.341,82,103,.796,62,139,201,82,36,4,64,93,475,10.8
408,Tanner Plomb\tanner-plomb-1,2014-15,Army,F,30,30,846,166,391,.425,100,216,.463,66,175,.377,76,94,.809,29,139,168,40,24,12,57,61,474,10.0
409,Jamar Gulley\jamar-gulley-1,2013-14,Missouri State,F,33,33,883,170,369,.461,144,283,.509,26,86,.302,108,147,.735,67,144,211,52,52,11,56,103,474,10.8
410,Leron Black\leron-black-1,2017-18,Illinois,F,31,30,789,188,344,.547,166,301,.551,22,43,.512,76,95,.800,55,106,161,26,10,8,56,104,474,9.9
411,Miles Bridges\miles-bridges-1,2016-17,Michigan State,F,28,27,895,177,364,.486,121,220,.550,56,144,.389,63,92,.685,41,191,232,58,19,43,66,52,473,13.1
412,Dominique Elliott\dominique-elliott-1,2015-16,Maryland-Eastern Shore,F,32,32,987,180,331,.544,175,314,.557,5,17,.294,108,169,.639,76,179,255,49,18,16,94,101,473,10.2
413,Mark Nwakamma\mark-nwakamma-1,2013-14,Hartford,F,31,31,910,171,324,.528,158,283,.558,13,41,.317,118,173,.682,55,126,181,60,23,23,95,109,473,10.0
414,Matt Van Scyoc\matt-vanscyoc-1,2013-14,Citadel,F,33,32,1062,145,333,.435,79,152,.520,66,181,.365,117,136,.860,32,144,176,34,12,23,54,98,473,9.5
415,Curtis Phillips\curtis-phillips-1,2017-18,Tennessee Tech,F,33,30,1011,152,387,.393,91,208,.438,61,179,.341,107,149,.718,34,137,171,72,59,20,99,69,472,9.3
416,Marvin Dominique\marvin-dominique-1,2014-15,Saint Peter's,F,34,34,1096,167,362,.461,130,260,.500,37,102,.363,101,135,.748,84,162,246,17,30,22,51,89,472,10.3
417,Danny Stewart\danny-stewart-1,2013-14,Rider,F,31,31,922,130,293,.444,105,230,.457,25,63,.397,187,219,.854,60,134,194,30,31,13,71,96,472,11.0
418,Chris Silva\chris-silva-1,2017-18,South Carolina,F,33,33,851,127,272,.467,122,260,.469,5,12,.417,213,283,.753,108,156,264,40,21,45,87,115,472,11.3
419,Jacob Parker\jacob-parker-1,2014-15,Stephen F. Austin,F,34,34,922,157,307,.511,102,182,.560,55,125,.440,103,123,.837,58,129,187,55,37,14,55,95,472,11.3
420,Evan Boudreaux\evan-boudreaux-1,2016-17,Dartmouth,F,27,27,903,166,378,.439,129,272,.474,37,106,.349,103,148,.696,56,202,258,24,19,12,80,59,472,11.0
421,Sam Dekker\sam-dekker-1,2013-14,Wisconsin,F,38,38,1134,168,358,.469,126,229,.550,42,129,.326,94,137,.686,65,166,231,52,29,22,41,52,472,10.2
422,Perry Ellis\perry-ellis-1,2013-14,Kansas,F,35,34,973,174,317,.549,166,300,.553,8,17,.471,116,152,.763,72,162,234,36,29,20,40,76,472,11.5
423,Jalen Moore\jalen-moore-1,2015-16,Utah State,F,31,31,1091,170,387,.439,120,237,.506,50,150,.333,81,113,.717,44,142,186,82,25,18,48,54,471,11.4
424,Desmond Williams\desmond-williams-1,2016-17,Florida A&M,F,29,28,936,182,376,.484,182,371,.491,0,5,.000,107,172,.622,45,131,176,44,29,35,63,58,471,11.2
425,Kris Jenkins\kris-jenkins-1,2016-17,Villanova,F,36,34,1118,142,370,.384,56,131,.427,86,239,.360,100,116,.862,13,136,149,73,40,10,52,70,470,9.2
426,Jalen Moore\jalen-moore-1,2014-15,Utah State,F,31,30,1066,157,319,.492,112,204,.549,45,115,.391,111,149,.745,36,173,209,53,19,27,37,44,470,12.6
427,Reid Travis\reid-travis-1,2016-17,Stanford,F,27,27,813,176,304,.579,176,303,.581,0,1,.000,118,181,.652,93,146,239,14,14,5,56,64,470,13.2
428,Aaron Gordon\aaron-gordon-1,2013-14,Arizona,F,38,38,1187,189,382,.495,173,337,.513,16,45,.356,76,180,.422,102,201,303,75,34,39,55,90,470,10.3
429,Ryan Taylor\ryan-taylor-1,2015-16,Marshall,F,33,33,882,168,303,.554,146,236,.619,22,67,.328,112,173,.647,66,152,218,99,35,25,80,124,470,11.7
430,Shawntrez Davis\shawntrez-davis-1,2017-18,Bethune-Cookman,F,32,32,863,181,327,.554,158,266,.594,23,61,.377,84,142,.592,86,191,277,40,15,39,78,109,469,11.1
431,Perry Ellis\perry-ellis-1,2014-15,Kansas,F,34,34,978,166,363,.457,148,317,.467,18,46,.391,119,163,.730,74,160,234,42,28,23,58,81,469,10.2
432,Jalen Henry\jalen-henry-1,2017-18,Southern Illinois-Edwardsville,F,29,26,815,157,374,.420,120,272,.441,37,102,.363,118,165,.715,45,166,211,34,23,24,73,84,469,10.0
433,David Caraher\david-caraher-1,2017-18,Houston Baptist,F,29,29,908,162,356,.455,106,202,.525,56,154,.364,89,121,.736,70,138,208,56,24,4,69,83,469,11.2
434,DeQuan Hicks\dequan-hicks-1,2013-14,Northwestern State,F,31,15,758,166,352,.472,164,338,.485,2,14,.143,135,198,.682,80,146,226,82,44,19,101,78,469,11.2
435,Stacy Davis\stacy-davis-1,2013-14,Pepperdine,F,31,23,910,155,329,.471,132,280,.471,23,49,.469,136,179,.760,66,170,236,48,14,20,68,73,469,11.1
436,Marquese Chriss\marquese-chriss-1,2015-16,Washington,F,34,34,848,179,338,.530,158,278,.568,21,60,.350,89,130,.685,85,98,183,26,32,55,69,138,468,10.0
437,Jacob Evans\jacob-evans-1,2017-18,Cincinnati,F,36,36,1107,161,377,.427,101,215,.470,60,162,.370,86,114,.754,50,120,170,113,47,35,63,72,468,10.8
438,Elgin Cook\elgin-cook-1,2014-15,Oregon,F,36,36,1059,169,325,.520,164,305,.538,5,20,.250,125,171,.731,52,136,188,59,38,6,80,117,468,9.0
439,Will Rayman\will-rayman-1,2016-17,Colgate,F,32,26,941,154,347,.444,89,183,.486,65,164,.396,94,136,.691,45,102,147,31,22,13,69,91,467,8.7
440,Jordon Varnado\jordon-varnado-1,2017-18,Troy,F,26,24,810,174,364,.478,148,274,.540,26,90,.289,93,126,.738,49,134,183,44,18,36,56,71,467,12.8
441,Rosco Allen\rosco-allen-1,2015-16,Stanford,F,30,30,1018,142,335,.424,86,169,.509,56,166,.337,127,172,.738,48,146,194,50,35,5,60,84,467,11.0
442,Shawn Jones\shawn-jones-1,2013-14,Middle Tennessee,F,33,32,930,183,317,.577,183,316,.579,0,1,.000,101,147,.687,99,180,279,20,30,63,48,91,467,12.9
443,Stone Gettings\stone-gettings-1,2017-18,Cornell,F,28,24,749,165,339,.487,122,222,.550,43,117,.368,94,114,.825,39,147,186,80,20,13,63,79,467,12.5
444,Colter Lasher\colter-lasher-1,2016-17,Houston Baptist,F,31,31,904,167,385,.434,109,224,.487,58,161,.360,75,97,.773,27,101,128,86,29,16,65,61,467,10.2
445,Bobby Hain\bobby-hain-1,2014-15,Youngstown State,F,32,32,1018,181,352,.514,174,321,.542,7,31,.226,97,137,.708,75,163,238,65,18,20,56,82,466,11.4
446,Kevin Larsen\kevin-larsen-1,2015-16,George Washington,F,38,38,1287,165,331,.498,148,295,.502,17,36,.472,119,165,.721,108,204,312,100,36,27,70,83,466,11.6
447,Killian Tillie\killian-tillie-1,2017-18,Gonzaga,F,36,35,938,181,312,.580,136,218,.624,45,94,.479,58,75,.773,61,151,212,60,30,37,57,88,465,11.3
448,Brandon Ashley\brandon-ashley-1,2014-15,Arizona,F,38,38,1055,166,323,.514,154,287,.537,12,36,.333,121,172,.703,69,128,197,25,23,25,55,107,465,8.7
449,Junior Etou\junior-etou-1,2017-18,Tulsa,F,31,31,942,145,311,.466,103,191,.539,42,120,.350,133,186,.715,77,167,244,47,16,8,72,66,465,11.1
450,Hayden Dalton\hayden-dalton-1,2016-17,Wyoming,F,38,4,1018,141,326,.433,89,175,.509,52,151,.344,131,157,.834,53,261,314,99,15,34,100,98,465,9.7
451,Gary Clark\gary-clark-2,2017-18,Cincinnati,F,36,36,1025,160,304,.526,133,242,.550,27,62,.435,117,158,.741,107,206,313,76,51,44,36,75,464,14.0
452,Devin Williams\devin-williams-1,2015-16,West Virginia,F,35,34,889,154,330,.467,154,330,.467,0,0,,156,225,.693,124,208,332,49,25,6,80,89,464,10.4
453,Angel Delgado\angel-delgado-1,2017-18,Seton Hall,F,34,34,1049,187,370,.505,187,368,.508,0,2,.000,90,147,.612,137,265,402,94,26,23,85,77,464,12.5
454,Justin Johnson\justin-johnson-7,2016-17,Western Kentucky,F,32,31,1005,173,331,.523,147,264,.557,26,67,.388,92,166,.554,83,220,303,65,11,18,42,45,464,12.7
455,Troy Williams\troy-williams-2,2015-16,Indiana,F,35,34,916,163,318,.513,137,243,.564,26,75,.347,112,162,.691,50,154,204,70,39,28,93,76,464,10.1
456,Jamel Artis\jamel-artis-1,2014-15,Pittsburgh,F,34,34,1082,160,341,.469,121,242,.500,39,99,.394,105,132,.795,67,138,205,77,25,15,60,63,464,10.9
457,Kyle Washington\kyle-washington-2,2016-17,Cincinnati,F,36,35,889,184,361,.510,169,319,.530,15,42,.357,81,115,.704,77,162,239,33,12,38,54,91,464,9.6
458,Jace Hogan\jace-hogan-1,2017-18,Jacksonville,F,27,26,828,194,376,.516,191,367,.520,3,9,.333,72,105,.686,62,117,179,32,22,14,51,61,463,11.9
459,Michael Carrera\michael-carrera-1,2015-16,South Carolina,F,32,32,888,145,323,.449,94,197,.477,51,126,.405,122,162,.753,70,177,247,40,32,33,61,86,463,11.5
460,Zane Waterman\zane-waterman-1,2016-17,Manhattan,F,32,31,888,151,313,.482,111,203,.547,40,110,.364,121,155,.781,62,161,223,20,24,14,66,96,463,10.2
461,David Laury\david-laury-1,2013-14,Iona,F,33,15,957,162,295,.549,162,295,.549,0,0,,139,237,.586,75,199,274,77,22,38,60,101,463,12.0
462,Khyle Marshall\khyle-marshall-1,2013-14,Butler,F,31,31,897,196,368,.533,195,358,.545,1,10,.100,70,153,.458,78,72,150,16,22,14,34,73,463,9.9
463,Drew Eubanks\drew-eubanks-1,2016-17,Oregon State,F,32,32,1027,182,310,.587,182,310,.587,0,0,,99,139,.712,81,185,266,39,20,69,96,92,463,11.8
464,Du'Vaughn Maxwell\duvaughn-maxwell-1,2013-14,Hampton,F,31,31,965,176,346,.509,171,325,.526,5,21,.238,105,205,.512,74,153,227,44,36,92,57,94,462,12.4
465,Isaac Fotu\isaac-fotu-1,2013-14,Hawaii,F,31,31,954,181,310,.584,180,302,.596,1,8,.125,99,135,.733,72,118,190,21,13,24,51,76,462,11.4
466,Jo Acuil\jo-acuil-1,2017-18,Baylor,F,33,33,1023,187,364,.514,181,343,.528,6,21,.286,82,116,.707,93,192,285,26,18,64,68,93,462,11.1
467,Karrington Ward\karrington-ward-1,2013-14,Eastern Michigan,F,37,35,1083,151,343,.440,94,192,.490,57,151,.377,103,159,.648,47,188,235,28,52,25,44,48,462,10.1
468,Ryan Taylor\ryan-taylor-1,2016-17,Marshall,F,32,32,921,160,315,.508,141,247,.571,19,68,.279,122,190,.642,66,202,268,73,26,53,77,111,461,11.8
469,Shaquille Morris\shaquille-morris-1,2017-18,Wichita State,F,33,29,783,176,318,.553,158,272,.581,18,46,.391,91,125,.728,55,130,185,44,18,51,48,79,461,11.4
470,Ronald Roberts\ronald-roberts--1,2013-14,Saint Joseph's,F,32,32,1065,174,290,.600,174,290,.600,0,0,,113,190,.595,92,146,238,41,11,43,63,78,461,11.9
471,Tyler Seibring\tyler-seibring-1,2016-17,Elon,F,32,32,1044,169,359,.471,109,207,.527,60,152,.395,63,85,.741,54,167,221,61,16,25,46,60,461,11.3
472,Kahlil Thomas\kahlil-thomas-1,2016-17,Rider,F,33,33,1012,179,339,.528,173,319,.542,6,20,.300,97,150,.647,84,207,291,40,34,29,76,96,461,11.0
473,Grandy Glaze\grandy-glaze-1,2015-16,Grand Canyon,F,33,29,872,198,331,.598,198,320,.619,0,11,.000,65,106,.613,76,214,290,26,18,0,52,51,461,11.3
474,Twymond Howard\twymond-howard-1,2014-15,Tennessee-Martin,F,34,33,1182,167,351,.476,146,290,.503,21,61,.344,106,148,.716,62,161,223,58,29,20,61,85,461,10.2
475,Gavin Ware\gavin-ware-1,2015-16,Mississippi State,F,30,27,842,183,298,.614,183,297,.616,0,1,.000,95,126,.754,87,147,234,27,28,32,55,83,461,13.3
476,Isaiah Hicks\isaiah-hicks-1,2016-17,North Carolina,F,39,39,907,174,303,.574,174,303,.574,0,0,,113,145,.779,72,141,213,55,16,29,64,119,461,9.3
477,Anthony Livingston\anthony-livingston-1,2014-15,Arkansas State,F,29,29,1039,166,358,.464,139,274,.507,27,84,.321,102,148,.689,77,214,291,22,14,29,78,67,461,11.1
478,Jeremy Combs\jeremy-combs-1,2015-16,North Texas,F,31,31,981,175,291,.601,175,291,.601,0,0,,111,190,.584,107,218,325,24,42,23,61,93,461,13.3
479,Alec Brown\alec-brown-1,2013-14,Green Bay,F,30,30,909,165,347,.476,123,247,.498,42,100,.420,88,121,.727,63,108,171,30,15,94,65,67,460,11.9
480,Marcus Derrickson\marcus-derrickson-1,2017-18,Georgetown,F,29,29,927,150,297,.505,103,196,.526,47,101,.465,113,131,.863,67,167,234,46,20,19,63,70,460,13.0
481,Taurean Prince\taurean-prince-1,2014-15,Baylor,F,33,6,868,167,354,.472,107,202,.530,60,152,.395,65,101,.644,60,124,184,42,49,29,67,70,459,10.5
482,Sam Rowley\sam-rowley-1,2014-15,Albany (NY),F,33,33,1094,168,332,.506,168,328,.512,0,4,.000,123,150,.820,81,170,251,59,40,26,88,90,459,11.1
483,Chris Boucher\chris-boucher-1,2015-16,Oregon,F,38,35,981,159,295,.539,120,180,.667,39,115,.339,102,149,.685,103,177,280,15,30,110,43,102,459,12.0
484,Rokas Gustys\rokas-gustys-1,2015-16,Hofstra,F,34,34,1033,192,291,.660,192,291,.660,0,0,,75,172,.436,141,301,442,31,32,40,60,114,459,13.5
485,Chris Eversley\chris-eversley-1,2013-14,Cal Poly,F,34,33,1057,167,417,.400,125,273,.458,42,144,.292,83,117,.709,74,167,241,55,44,13,46,72,459,10.0
486,Arnaud William Adala Moto\arnaudwilliam-adalamoto-1,2015-16,Towson,F,33,32,935,145,329,.441,128,271,.472,17,58,.293,151,208,.726,75,199,274,53,25,4,94,87,458,9.4
487,Markus Kennedy\markus-kennedy-1,2013-14,Southern Methodist,F,37,22,924,182,341,.534,181,336,.539,1,5,.200,93,158,.589,73,188,261,58,57,44,67,87,458,10.8
488,Ryan Anderson\ryan-anderson-3,2013-14,Boston College,F,32,31,1004,149,305,.489,145,290,.500,4,15,.267,156,211,.739,76,156,232,45,25,20,62,65,458,11.4
489,Jae'Sean Tate\jaesean-tate-1,2016-17,Ohio State,F,32,32,1021,182,333,.547,174,297,.586,8,36,.222,86,150,.573,62,143,205,64,34,15,72,101,458,10.5
490,Kadeem Jack\kadeem-jack-1,2013-14,Rutgers,F,32,32,938,175,349,.501,173,346,.500,2,3,.667,106,154,.688,87,132,219,23,23,41,60,92,458,10.5
491,Moritz Wagner\moritz-wagner-1,2016-17,Michigan,F,38,38,908,168,300,.560,123,186,.661,45,114,.395,77,106,.726,51,107,158,20,39,14,54,102,458,8.9
492,Dyshawn Pierre\dyshawn-pierre-1,2014-15,Dayton,F,36,35,1202,164,354,.463,127,250,.508,37,104,.356,92,136,.676,76,215,291,103,22,15,72,65,457,10.6
493,Richaun Holmes\richaun-holmes-1,2014-15,Bowling Green State,F,31,30,892,165,293,.563,147,250,.588,18,43,.419,109,153,.712,88,160,248,26,22,83,60,77,457,13.5
494,Jaleel Hogan\jaleel-hogan-1,2016-17,Detroit Mercy,F,30,28,792,175,296,.591,175,296,.591,0,0,,107,199,.538,84,91,175,31,16,31,68,113,457,10.5
495,Wesley Iwundu\wesley-iwundu-1,2016-17,Kansas State,F,35,35,1098,151,314,.481,119,229,.520,32,85,.376,122,159,.767,36,185,221,121,35,12,81,63,456,11.0
496,Justin Pierce\justin-pierce-1,2017-18,William & Mary,F,31,30,980,163,325,.502,116,212,.547,47,113,.416,83,105,.790,63,204,267,75,28,19,56,66,456,13.0
497,Roosevelt Jones\roosevelt-jones-1,2015-16,Butler,F,33,33,1109,166,355,.468,165,354,.466,1,1,1.000,123,182,.676,67,151,218,154,50,13,77,82,456,12.1
498,Franko House\franko-house-1,2016-17,Ball State,F,34,33,891,165,314,.525,144,256,.563,21,58,.362,105,138,.761,74,145,219,79,14,19,75,112,456,10.2
499,Josh Hawkinson\josh-hawkinson-1,2014-15,Washington State,F,31,29,1015,166,332,.500,159,297,.535,7,35,.200,116,136,.853,65,269,334,30,12,34,32,67,455,13.1
500,Kris Acox\kris-acox-1,2016-17,Furman,F,35,35,1003,199,317,.628,199,317,.628,0,0,,57,102,.559,78,190,268,48,49,25,67,91,455,11.5
501,Zac Cuthbertson\zac-cuthbertson-1,2017-18,Coastal Carolina,F,31,26,909,141,313,.450,112,217,.516,29,96,.302,144,181,.796,58,152,210,49,29,22,72,85,455,10.9
502,Anthony Tarke\anthony-tarke-1,2017-18,NJIT,F,29,29,930,161,399,.404,120,256,.469,41,143,.287,91,142,.641,45,136,181,57,38,24,60,65,454,10.3
503,Ja'Dante' Frye\jadante-frye-1,2016-17,Nicholls State,F,31,26,1044,157,343,.458,119,238,.500,38,105,.362,102,132,.773,55,130,185,48,26,14,60,59,454,10.6
504,Terry Allen\terry-allen-1,2014-15,Richmond,F,35,34,1093,170,331,.514,154,265,.581,16,66,.242,98,131,.748,56,177,233,47,48,23,67,77,454,10.5
505,Talib Zanna\talib-zanna-1,2013-14,Pittsburgh,F,35,35,1061,160,273,.586,160,271,.590,0,2,.000,134,201,.667,115,185,300,19,22,29,54,90,454,11.5
506,Michael Young\michael-young-3,2014-15,Pittsburgh,F,34,34,1077,167,315,.530,162,298,.544,5,17,.294,115,166,.693,111,138,249,44,21,28,38,89,454,11.7
507,Travis Charles\travis-charles-1,2017-18,Albany (NY),F,31,31,896,174,314,.554,174,314,.554,0,0,,106,129,.822,60,115,175,22,17,13,55,87,454,10.4
508,Dikembe Dixson\dikembe-dixson-1,2017-18,Illinois-Chicago,F,32,32,950,149,383,.389,114,272,.419,35,111,.315,120,164,.732,22,89,111,26,40,6,89,58,453,6.9
509,Rashawn Thomas\rashawn-thomas-1,2014-15,Texas A&M-Corpus Christi,F,33,28,913,154,281,.548,154,275,.560,0,6,.000,144,226,.637,95,167,262,34,18,40,103,121,452,9.7
510,Devin Thomas\devin-thomas-1,2015-16,Wake Forest,F,29,29,891,162,299,.542,162,299,.542,0,0,,128,219,.584,89,207,296,70,19,46,81,88,452,13.1
511,Ryan Rhoomes\ryan-rhoomes-1,2015-16,Fordham,F,31,31,984,187,289,.647,187,289,.647,0,0,,78,133,.586,130,171,301,42,21,57,63,100,452,13.9
512,Abdel Nader\abdel-nader-1,2015-16,Iowa State,F,35,35,1088,161,337,.478,109,197,.553,52,140,.371,78,106,.736,26,148,174,54,37,23,79,98,452,8.7
513,Willie Rodriguez\willie-rodriguez-1,2015-16,Binghamton,F,30,30,945,156,346,.451,134,262,.511,22,84,.262,118,154,.766,66,134,200,39,32,9,78,84,452,9.9
514,Derrick Barden\derrick-barden-1,2013-14,Northern Colorado,F,32,32,983,180,313,.575,164,270,.607,16,43,.372,76,115,.661,99,150,249,40,41,16,35,48,452,13.4
515,Clide Geffrard\clide-geffrard-1,2015-16,Stephen F. Austin,F,34,2,825,153,312,.490,108,182,.593,45,130,.346,100,125,.800,70,130,200,47,31,19,56,79,451,10.6
516,T.J. Holyfield\tj-holyfield-1,2017-18,Stephen F. Austin,F,35,35,956,167,305,.548,139,237,.586,28,68,.412,89,119,.748,84,139,223,30,40,44,95,101,451,10.0
517,Phil Fayne\phil-fayne-1,2017-18,Illinois State,F,29,27,866,181,304,.595,181,304,.595,0,0,,89,173,.514,99,117,216,27,35,28,51,82,451,12.8
518,Kyvon Davenport\kyvon-davenport-1,2017-18,Memphis,F,34,34,995,153,300,.510,114,190,.600,39,110,.355,106,153,.693,71,138,209,27,21,42,56,95,451,10.3
519,Loudon Love\loudon-love-1,2017-18,Wright State,F,35,35,972,186,349,.533,186,348,.534,0,1,.000,79,146,.541,106,235,341,38,27,34,84,95,451,10.1
520,Martin Smith\martin-smith-2,2013-14,Lipscomb,F,29,29,946,134,327,.410,66,138,.478,68,189,.360,115,142,.810,30,78,108,66,28,9,53,64,451,10.7
521,Nick Mayo\nick-mayo-1,2015-16,Eastern Kentucky,F,31,31,923,179,295,.607,164,268,.612,15,27,.556,77,96,.802,48,105,153,34,20,34,63,71,450,11.3
522,Ryan Taylor\ryan-taylor-1,2014-15,Marshall,F,32,32,920,152,359,.423,124,257,.482,28,102,.275,118,169,.698,60,215,275,90,28,25,88,100,450,10.2
523,Mike Moser\mike-moser-1,2013-14,Oregon,F,34,34,964,169,368,.459,113,220,.514,56,148,.378,56,73,.767,63,200,263,55,39,25,60,87,450,10.5
524,Anthony Lamb\anthony-lamb-2,2016-17,Vermont,F,35,35,787,172,335,.513,146,272,.537,26,63,.413,79,106,.745,69,124,193,24,27,43,70,98,449,9.2
525,Aundre Jackson\aundre-jackson-1,2016-17,Loyola (IL),F,32,8,764,177,265,.668,163,234,.697,14,31,.452,81,118,.686,39,94,133,31,17,11,54,80,449,10.5
526,Jared Sam\jared-sam-1,2016-17,Southern,F,33,33,1077,145,244,.594,145,243,.597,0,1,.000,159,208,.764,82,162,244,34,28,23,62,88,449,11.9
527,Phil Cofer\phil-cofer-1,2017-18,Florida State,F,35,35,1025,168,346,.486,120,218,.550,48,128,.375,65,94,.691,56,122,178,26,19,8,42,49,449,9.1
528,Devonta Pollard\devonta-pollard-1,2015-16,Houston,F,32,25,951,156,326,.479,155,324,.478,1,2,.500,136,182,.747,59,122,181,51,29,20,50,76,449,10.7
529,Remi Barry\remi-barry-1,2014-15,New Mexico State,F,34,34,1095,154,337,.457,111,239,.464,43,98,.439,98,128,.766,46,115,161,35,19,6,61,62,449,8.6
530,Jeffery Moss\jeffrey-moss-1,2013-14,Murray State,F,34,34,1170,147,337,.436,89,184,.484,58,153,.379,96,120,.800,24,90,114,72,15,10,42,72,448,9.0
531,Mike Morsell\mike-morsell-1,2017-18,Towson,F,32,32,899,162,369,.439,111,222,.500,51,147,.347,73,101,.723,46,88,134,30,33,14,56,94,448,8.5
532,Tyler Lydon\tyler-lydon-1,2016-17,Syracuse,F,34,34,1227,151,320,.472,102,195,.523,49,125,.392,97,116,.836,79,215,294,70,35,49,59,84,448,12.4
533,Jerome Hill\jerome-hill-1,2013-14,Gardner-Webb,F,31,28,909,154,314,.490,154,312,.494,0,2,.000,139,215,.647,102,162,264,40,25,14,62,76,447,11.3
534,Mark Tollefsen\mark-tollefsen-1,2014-15,San Francisco,F,32,32,1001,176,329,.535,134,218,.615,42,111,.378,53,82,.646,56,118,174,48,27,27,35,58,447,11.6
535,Earl Brown\earl-brown-3,2013-14,Saint Francis (PA),F,31,31,1032,181,341,.531,178,331,.538,3,10,.300,82,141,.582,82,166,248,49,22,34,80,74,447,10.8
536,Maurice Barrow\maurice-barrow-1,2013-14,Fairfield,F,32,4,943,149,342,.436,109,219,.498,40,123,.325,109,147,.741,53,106,159,39,28,24,60,91,447,9.3
537,Bryce Washington\bryce-washington-1,2016-17,Louisiana,F,33,33,1159,173,287,.603,173,281,.616,0,6,.000,101,158,.639,131,237,368,70,41,25,65,65,447,14.3
538,Calvin Hermanson\calvin-hermanson-1,2016-17,Saint Mary's (CA),F,34,34,971,155,314,.494,67,110,.609,88,204,.431,49,60,.817,23,78,101,31,16,6,33,79,447,8.9
539,Kruize Pinkins\kruize-pinkins-1,2014-15,San Francisco,F,32,27,837,154,316,.487,122,234,.521,32,82,.390,106,163,.650,70,106,176,44,22,13,57,99,446,9.7
540,Jaye Crockett\jaye-crockett-1,2013-14,Texas Tech,F,32,32,941,170,329,.517,150,266,.564,20,63,.317,86,104,.827,68,138,206,38,32,12,58,74,446,10.8
541,Josh Hawkinson\josh-hawkinson-1,2015-16,Washington State,F,29,28,967,170,313,.543,155,274,.566,15,39,.385,91,117,.778,45,276,321,44,20,31,59,60,446,13.4
542,Ousmane Drame\ousmane-drame-1,2014-15,Quinnipiac,F,30,13,873,158,347,.455,157,344,.456,1,3,.333,129,160,.806,108,227,335,31,21,88,69,89,446,13.2
543,Julian Washburn\julian-washburn-1,2013-14,Texas-El Paso,F,34,33,1170,162,380,.426,114,248,.460,48,132,.364,74,94,.787,20,100,120,85,33,13,49,51,446,9.2
544,David DiLeo\david-dileo-1,2017-18,Central Michigan,F,36,36,1210,140,359,.390,44,84,.524,96,275,.349,70,87,.805,67,172,239,50,34,9,27,64,446,10.1
545,Tre'Shawn Thurman\treshawn-thurman-1,2015-16,Omaha,F,32,32,878,172,321,.536,159,274,.580,13,47,.277,89,138,.645,62,151,213,43,25,35,52,93,446,10.9
546,Marcus Gilbert\marcus-gilbert-1,2013-14,Fairfield,F,32,31,1042,143,353,.405,70,154,.455,73,199,.367,86,112,.768,28,136,164,50,20,14,91,92,445,7.6
547,Jalen Hayes\jalen-hayes-1,2015-16,Oakland,F,34,33,1041,168,320,.525,165,311,.531,3,9,.333,105,144,.729,74,218,292,26,32,17,50,100,444,10.6
548,Raymond Spalding\raymond-spalding-1,2017-18,Louisville,F,36,34,996,183,337,.543,178,318,.560,5,19,.263,73,114,.640,113,199,312,46,54,62,61,107,444,11.9
549,Justin Sears\justin-sears-1,2014-15,Yale,F,31,30,1012,154,301,.512,152,295,.515,2,6,.333,134,194,.691,94,140,234,48,34,73,85,77,444,12.3
550,Vic Law\vic-law-1,2016-17,Northwestern,F,36,36,1155,147,366,.402,87,216,.403,60,150,.400,90,122,.738,46,163,209,63,37,18,56,96,444,8.7
551,Mike Morsell\mike-morsell-1,2016-17,Towson,F,33,26,896,141,324,.435,93,180,.517,48,144,.333,114,149,.765,33,68,101,43,27,19,69,81,444,8.2
552,Kendall Pollard\kendall-pollard-1,2014-15,Dayton,F,35,26,1020,159,288,.552,156,279,.559,3,9,.333,123,212,.580,39,148,187,37,30,32,85,116,444,8.3
553,Matt O'Leary\matt-oleary-1,2016-17,IUPUI,F,32,31,956,161,320,.503,93,168,.554,68,152,.447,54,74,.730,31,164,195,71,31,14,52,67,444,11.2
554,Robert Carter\robert-carter-1,2015-16,Maryland,F,36,36,950,170,307,.554,144,229,.629,26,78,.333,77,104,.740,61,189,250,67,30,45,79,102,443,10.4
555,Jeremy Hollowell\jeremy-hollowell-1,2015-16,Georgia State,F,30,30,958,152,349,.436,115,238,.483,37,111,.333,102,126,.810,30,116,146,50,31,13,56,88,443,9.7
556,Tyler Hagedorn\tyler-hagedorn-1,2017-18,South Dakota,F,34,34,836,153,346,.442,109,235,.464,44,111,.396,93,113,.823,51,148,199,37,24,28,45,84,443,9.6
557,Bashir Ahmed\bashir-ahmed-1,2016-17,St. John's (NY),F,33,33,881,142,360,.394,90,213,.423,52,147,.354,106,156,.679,59,121,180,40,18,19,75,83,442,7.7
558,DJ Laster\dj-laster-1,2017-18,Gardner-Webb,F,32,29,844,188,372,.505,167,306,.546,21,66,.318,45,74,.608,63,109,172,14,18,13,61,79,442,8.3
559,Luke Hancock\luke-hancock-1,2013-14,Louisville,F,36,21,861,124,304,.408,56,107,.523,68,197,.345,126,152,.829,22,73,95,79,36,7,53,95,442,8.6
560,Justice Sueing\justice-sueing-2,2017-18,University of California,F,32,31,1023,157,362,.434,115,227,.507,42,135,.311,86,128,.672,48,124,172,44,48,15,68,75,442,9.3
561,Jarrett Allen\jarrett-allen-1,2016-17,Texas,F,33,33,1061,179,316,.566,179,309,.579,0,7,.000,84,149,.564,100,179,279,26,19,51,84,68,442,10.7
562,Shonn Miller\shonn-miller-1,2015-16,Connecticut,F,36,36,924,170,296,.574,161,272,.592,9,24,.375,93,116,.802,44,142,186,20,34,31,22,108,442,10.3
563,Tre'Shawn Thurman\treshawn-thurman-1,2016-17,Omaha,F,32,32,954,166,334,.497,155,290,.534,11,44,.250,99,147,.673,65,183,248,43,13,26,63,91,442,9.9
564,Ashton Pankey\ashton-pankey-1,2014-15,Manhattan,F,33,32,908,145,274,.529,145,274,.529,0,0,,151,217,.696,77,143,220,31,23,47,76,120,441,10.0
565,Cedric Blossom\cedric-blossom-1,2014-15,Morgan State,F,31,31,1077,161,378,.426,159,370,.430,2,8,.250,117,168,.696,100,119,219,22,33,8,37,73,441,10.1
566,Jordan Washington\jordan-washington-1,2015-16,Iona,F,31,23,579,167,325,.514,167,325,.514,0,0,,107,180,.594,95,103,198,11,14,18,66,116,441,8.7
567,Ricardo Glenn\ricardo-glenn-1,2013-14,South Carolina Upstate,F,33,33,945,158,249,.635,158,248,.637,0,1,.000,125,176,.710,105,160,265,59,21,9,70,76,441,12.1
568,Bryson Williams\bryson-williams-1,2017-18,Fresno State,F,32,32,916,192,322,.596,191,318,.601,1,4,.250,56,93,.602,60,135,195,37,16,21,59,102,441,9.9
569,George Fant\george-fant-1,2014-15,Western Kentucky,F,32,32,920,170,321,.530,170,321,.530,0,0,,101,163,.620,103,165,268,50,30,21,66,107,441,11.0
570,Jeffery Moss\jeffrey-moss-1,2015-16,Murray State,F,31,31,1106,146,336,.435,66,143,.462,80,193,.415,69,88,.784,28,97,125,63,23,3,40,70,441,9.9
571,Vince Edwards\vince-edwards-2,2016-17,Purdue,F,35,27,1001,160,329,.486,113,218,.518,47,111,.423,73,89,.820,66,107,173,112,19,18,58,64,440,10.6
572,Will Davis\will-davis-1,2014-15,UC-Irvine,F,34,33,1012,185,341,.543,185,340,.544,0,1,.000,70,99,.707,83,157,240,33,18,34,45,47,440,10.9
573,Will Felder\will-felder-1,2013-14,Miami (OH),F,31,31,990,161,301,.535,156,275,.567,5,26,.192,113,135,.837,65,144,209,28,25,31,70,73,440,11.0
574,Justin Sears\justin-sears-1,2015-16,Yale,F,28,27,869,163,310,.526,158,294,.537,5,16,.313,109,163,.669,103,107,210,79,21,48,69,78,440,13.6
575,Javon Bess\javon-bess-1,2017-18,Saint Louis,F,33,33,1195,128,324,.395,104,235,.443,24,89,.270,160,211,.758,79,165,244,72,41,13,67,78,440,10.6
576,Devin Oliver\devin-oliver-1,2013-14,Dayton,F,37,37,1107,149,308,.484,107,202,.530,42,106,.396,100,131,.763,84,191,275,86,33,10,53,93,440,10.7
577,Kyle Davis\kyle-davis-2,2015-16,Brigham Young,F,37,37,1001,175,321,.545,168,306,.549,7,15,.467,82,136,.603,85,191,276,46,26,49,69,92,439,9.9
578,Jordan Barnett\jordan-barnett-1,2017-18,Missouri,F,32,32,1091,142,316,.449,60,118,.508,82,198,.414,73,82,.890,50,139,189,35,23,19,50,51,439,10.6
579,Brett Bisping\brett-bisping-1,2013-14,Siena,F,38,30,1023,156,302,.517,144,264,.545,12,38,.316,114,151,.755,98,150,248,29,23,35,50,131,438,9.3
580,Jake Layman\jake-layman-1,2014-15,Maryland,F,35,34,1053,143,304,.470,98,185,.530,45,119,.378,106,141,.752,45,158,203,49,28,26,67,75,437,9.4
581,Jakeenan Gant\jakeenan-gant-1,2017-18,Louisiana,F,32,31,815,176,318,.553,146,224,.652,30,94,.319,55,79,.696,70,114,184,28,18,74,39,70,437,11.9
582,Karrington Ward\karrington-ward-1,2014-15,Eastern Michigan,F,35,34,1095,155,371,.418,109,224,.487,46,147,.313,81,115,.704,59,169,228,20,47,46,23,50,437,10.5
583,Steve Forbes\steve-forbes-2,2013-14,Purdue-Fort Wayne,F,36,36,769,164,271,.605,164,271,.605,0,0,,109,163,.669,81,108,189,21,17,20,80,122,437,8.3
584,Pascal Siakam\pascal-siakam-1,2014-15,New Mexico State,F,34,27,1048,166,290,.572,166,288,.576,0,2,.000,104,137,.759,111,151,262,45,28,61,64,88,436,12.1
585,Sherman Blanford\sherman-blanford-1,2013-14,Eastern Illinois,F,30,28,810,155,299,.518,155,296,.524,0,3,.000,126,169,.746,89,150,239,46,31,23,56,68,436,12.5
586,Tylor Ongwae\tylor-ongwae-1,2013-14,Louisiana-Monroe,F,27,27,863,151,359,.421,124,259,.479,27,100,.270,107,140,.764,48,107,155,39,30,19,51,78,436,10.6
587,Neiko Hunter\neiko-hunter-1,2013-14,Middle Tennessee,F,33,31,912,165,349,.473,142,283,.502,23,66,.348,83,123,.675,71,89,160,29,31,20,55,81,436,9.0
588,Marshall Bjorklund\marshall-bjorklund-1,2013-14,North Dakota State,F,33,32,850,178,283,.629,178,283,.629,0,0,,80,126,.635,58,82,140,45,26,6,56,95,436,9.8
589,Kyle Kelm\kyle-kelm-1,2013-14,Milwaukee,F,35,29,1052,147,285,.516,140,244,.574,7,41,.171,135,190,.711,61,119,180,56,20,5,71,80,436,8.9
590,William Lee\william-lee-1,2016-17,Alabama-Birmingham,F,33,32,932,149,303,.492,105,185,.568,44,118,.373,93,120,.775,41,179,220,52,30,79,65,55,435,11.8
591,Nick Ward\nick-ward-1,2017-18,Michigan State,F,35,34,662,162,250,.648,161,249,.647,1,1,1.000,110,177,.621,94,155,249,18,11,47,58,82,435,10.7
592,Shane Richards\shane-richards-1,2014-15,Manhattan,F,33,33,1072,128,315,.406,36,73,.493,92,242,.380,87,107,.813,10,109,119,55,27,4,46,72,435,8.8
593,Henry Caruso\henry-caruso-1,2015-16,Princeton,F,29,29,825,152,291,.522,115,208,.553,37,83,.446,94,131,.718,54,127,181,50,37,3,47,49,435,12.4
594,Quincy Diggs\quincy-diggs-1,2013-14,Akron,F,34,20,1003,146,346,.422,94,194,.485,52,152,.342,91,139,.655,28,130,158,90,59,5,93,56,435,8.8
595,Jamar Akoh\jamar-akoh-1,2017-18,Montana,F,34,34,881,158,277,.570,157,272,.577,1,5,.200,118,177,.667,80,145,225,37,30,23,71,113,435,9.9
596,Jordan Mickey\jordan-mickey-1,2013-14,Louisiana State,F,34,34,1116,172,322,.534,172,317,.543,0,5,.000,91,131,.695,77,190,267,36,21,106,78,74,435,11.4
597,Ivan Rabb\ivan-rabb-1,2016-17,University of California,F,31,30,1012,151,312,.484,143,292,.490,8,20,.400,124,187,.663,94,230,324,48,21,31,67,96,434,11.5
598,Travis Munnings\travis-munnings-1,2016-17,Louisiana-Monroe,F,33,33,1113,160,358,.447,109,212,.514,51,146,.349,63,99,.636,69,197,266,67,27,10,73,91,434,9.5
599,Malcolm Miller\malcolm-miller-1,2014-15,Holy Cross,F,30,30,951,136,306,.444,91,185,.492,45,121,.372,117,141,.830,33,113,146,36,40,48,55,80,434,11.1
600,Ethan Happ\ethan-happ-1,2015-16,Wisconsin,F,35,35,982,163,303,.538,163,303,.538,0,0,,108,168,.643,88,190,278,44,63,32,76,106,434,10.8
601,Omari Spellman\omari-spellman-1,2017-18,Villanova,F,40,39,1125,160,336,.476,95,186,.511,65,150,.433,49,70,.700,90,231,321,30,26,59,40,92,434,10.0
602,Chris Cokley\chris-cokley-1,2015-16,Alabama-Birmingham,F,33,22,728,176,307,.573,176,307,.573,0,0,,81,112,.723,76,137,213,47,29,23,34,91,433,11.5
603,V.J. Beachem\vj-beachem-1,2015-16,Notre Dame,F,36,36,1126,159,334,.476,71,136,.522,88,198,.444,27,47,.574,27,112,139,28,29,30,31,60,433,8.9
604,Alec Peters\alec-peters-1,2013-14,Valparaiso,F,34,34,1006,154,314,.490,97,165,.588,57,149,.383,68,88,.773,33,131,164,49,29,5,65,75,433,8.9
605,Roosevelt Jones\roosevelt-jones-1,2014-15,Butler,F,34,34,1207,168,399,.421,168,399,.421,0,0,,97,160,.606,70,108,178,125,31,21,89,84,433,8.5
606,Wayne Martin\wayne-martin-1,2016-17,Tennessee State,F,30,29,957,172,297,.579,164,270,.607,8,27,.296,81,119,.681,88,187,275,23,25,28,76,89,433,11.5
607,AJ Brodeur\aj-brodeur-1,2017-18,Pennsylvania,F,33,33,1024,179,333,.538,159,263,.605,20,70,.286,55,90,.611,59,178,237,83,29,41,81,89,433,10.6
608,Malik Moore\malik-moore-2,2017-18,South Carolina Upstate,F,32,30,952,147,333,.441,114,211,.540,33,122,.270,105,148,.709,49,145,194,78,42,12,64,88,432,10.1
609,Devontae Cacok\devontae-cacok-1,2016-17,North Carolina-Wilmington,F,35,33,907,184,230,.800,184,230,.800,0,0,,63,107,.589,125,218,343,15,37,44,38,121,431,13.5
610,Eric Paschall\eric-paschall-1,2014-15,Fordham,F,27,27,842,150,358,.419,105,215,.488,45,143,.315,85,107,.794,45,103,148,27,21,12,76,53,430,9.0
611,Marvin King-Davis\marvin-king-davis-1,2015-16,Delaware,F,29,29,936,155,348,.445,155,346,.448,0,2,.000,120,162,.741,90,172,262,31,8,17,44,83,430,10.7
612,Kayel Locke\kayel-locke-1,2015-16,North Carolina-Greensboro,F,34,34,1031,168,369,.455,138,272,.507,30,97,.309,64,109,.587,53,132,185,56,18,3,66,72,430,7.7
613,Mike Morsell\mike-morsell-1,2015-16,Towson,F,33,31,1002,145,372,.390,103,237,.435,42,135,.311,97,133,.729,43,92,135,82,35,18,73,94,429,8.0
614,Clancy Rugg\clancy-rugg-1,2013-14,Vermont,F,33,33,922,120,219,.548,116,209,.555,4,10,.400,185,232,.797,63,132,195,25,25,38,65,74,429,11.0
615,Earvin Morris\earvin-morris-1,2015-16,Texas-El Paso,F,32,21,822,150,326,.460,100,185,.541,50,141,.355,79,118,.669,15,96,111,56,27,11,51,87,429,8.5
616,Kadeem Batts\kadeem-batts-1,2013-14,Providence,F,35,35,1071,147,339,.434,142,324,.438,5,15,.333,130,175,.743,108,151,259,43,11,27,59,122,429,8.7
617,Felix Von Hofe\felix-van-hofe-1,2015-16,Eastern Washington,F,33,31,1074,140,320,.438,35,72,.486,105,248,.423,44,57,.772,16,101,117,31,19,15,26,67,429,9.0
618,Adrian Diaz\adrian-diaz-1,2014-15,Florida International,F,33,33,1033,164,272,.603,164,272,.603,0,0,,101,176,.574,106,122,228,44,29,99,85,126,429,11.5
619,Kenny Jones\kenny-jones-2,2016-17,Austin Peay,F,30,29,957,168,283,.594,166,275,.604,2,8,.250,90,153,.588,69,162,231,26,31,30,68,74,428,11.4
620,Rui Hachimura\rui-hachimura-1,2017-18,Gonzaga,F,37,2,765,159,280,.568,154,254,.606,5,26,.192,105,132,.795,47,127,174,23,19,19,44,73,428,8.9
621,Hayden Graham\hayden-graham-1,2015-16,Air Force,F,31,31,1112,168,346,.486,133,255,.522,35,91,.385,57,87,.655,49,143,192,69,34,10,63,86,428,10.0
622,Jordan Bell\jordan-bell-1,2016-17,Oregon,F,39,38,1124,171,269,.636,168,255,.659,3,14,.214,82,117,.701,112,230,342,70,49,87,75,69,427,12.7
623,J.D. Weatherspoon\jd-weatherspoon-1,2014-15,Toledo,F,33,33,1038,156,277,.563,146,249,.586,10,28,.357,105,163,.644,67,209,276,34,21,20,67,48,427,10.7
624,Joel Wright\joel-wright-2,2013-14,Texas State,F,29,25,786,150,350,.429,135,293,.461,15,57,.263,112,150,.747,56,123,179,45,31,21,116,80,427,8.0
625,Kentwan Smith\kentwan-smith-1,2014-15,Stetson,F,31,31,880,160,304,.526,134,224,.598,26,80,.325,81,118,.686,85,125,210,40,17,46,74,77,427,10.7
626,Malachi Alexander\malachi-alexander-1,2016-17,Holy Cross,F,32,32,1104,149,337,.442,92,191,.482,57,146,.390,72,112,.643,30,129,159,63,57,12,58,75,427,9.9
627,JT Yoho\jt-yoho-1,2015-16,Wright State,F,34,21,1034,163,369,.442,112,240,.467,51,129,.395,50,71,.704,21,147,168,83,18,2,74,81,427,7.5
628,Murphy Burnatowski\murphy-burnatowski-1,2013-14,Colgate,F,30,30,967,150,359,.418,86,190,.453,64,169,.379,63,82,.768,32,95,127,48,41,13,47,80,427,9.5
629,Rondae Hollis-Jefferson\rondae-hollis-jefferson-1,2014-15,Arizona,F,38,25,1090,138,275,.502,132,246,.537,6,29,.207,145,205,.707,77,183,260,59,44,32,59,94,427,10.1
630,Abdul-Malik Abu\abdul-malik-abu-1,2015-16,North Carolina State,F,33,33,934,165,337,.490,165,337,.490,0,0,,97,154,.630,118,171,289,42,12,23,57,88,427,10.1
631,Franko House\franko-house-1,2015-16,Ball State,F,35,30,945,152,281,.541,149,266,.560,3,15,.200,120,169,.710,83,119,202,75,23,19,67,114,427,9.8
632,Demajeo Wiggins\demajeo-wiggins-1,2017-18,Bowling Green State,F,31,30,860,153,274,.558,153,274,.558,0,0,,120,173,.694,94,220,314,26,13,15,74,66,426,11.2
633,Ivan Rabb\ivan-rabb-1,2015-16,University of California,F,34,34,975,161,262,.615,160,260,.615,1,2,.500,103,154,.669,94,196,290,31,18,42,52,105,426,11.4
634,Rakeem Buckles\rakeem-buckles-1,2013-14,Florida International,F,31,30,932,150,334,.449,123,249,.494,27,85,.318,99,137,.723,83,183,266,23,33,42,71,109,426,10.1
635,Travin Thibodeaux\travin-thibodeaux-1,2017-18,New Orleans,F,26,22,746,160,295,.542,144,254,.567,16,41,.390,89,128,.695,31,119,150,76,36,29,56,69,425,13.5
636,Ja'Dante' Frye\jadante-frye-1,2015-16,Nicholls State,F,34,21,885,144,305,.472,119,234,.509,25,71,.352,112,139,.806,31,126,157,39,26,11,70,54,425,8.4
637,Isaac Copeland\isaac-copeland-1,2017-18,Nebraska,F,33,33,1012,159,337,.472,118,226,.522,41,111,.369,66,94,.702,55,146,201,38,27,33,33,56,425,10.5
638,MiKyle McIntosh\mikyle-mcintosh-1,2017-18,Oregon,F,36,36,1012,147,322,.457,110,218,.505,37,104,.356,94,129,.729,56,164,220,53,29,12,63,119,425,8.2
639,Phillip Carr\phillip-carr-1,2017-18,Morgan State,F,31,30,1018,152,352,.432,141,311,.453,11,41,.268,110,130,.846,91,197,288,39,21,21,53,77,425,10.8
640,Richaun Holmes\richaun-holmes-1,2013-14,Bowling Green State,F,32,31,1024,150,296,.507,138,256,.539,12,40,.300,113,160,.706,86,159,245,29,36,88,58,90,425,12.2
641,Tre' McLean\tre-mclean-1,2015-16,Chattanooga,F,35,35,1084,151,316,.478,116,220,.527,35,96,.365,88,112,.786,59,162,221,87,56,25,75,81,425,10.6
642,Myke Henry\myke-henry-1,2015-16,DePaul,F,31,31,896,170,317,.536,148,257,.576,22,60,.367,63,87,.724,66,126,192,31,26,8,76,95,425,9.2
643,Jordyn Martin\jordyn-martin-1,2016-17,Northern Arizona,F,32,32,965,169,322,.525,160,303,.528,9,19,.474,78,114,.684,113,170,283,38,23,8,68,97,425,10.4
644,Aaron White\aaron-white-3,2013-14,Iowa,F,33,33,926,143,245,.584,135,214,.631,8,31,.258,130,161,.807,57,164,221,60,32,19,59,39,424,12.1
645,JaKarr Sampson\jakarr-sampson-1,2013-14,St. John's (NY),F,33,32,957,181,366,.495,180,361,.499,1,5,.200,61,108,.565,68,134,202,39,21,32,52,92,424,8.8
646,Konner Frey\konner-frey-1,2015-16,Utah Valley,F,30,30,825,141,334,.422,96,199,.482,45,135,.333,97,134,.724,59,153,212,36,18,11,69,78,424,9.0
647,Simi Socks\simi-socks-1,2016-17,Incarnate Word,F,28,26,814,140,301,.465,108,218,.495,32,83,.386,112,134,.836,27,88,115,32,26,14,73,106,424,8.9
648,Shaquielle McKissic\shaquielle-mckissic-1,2014-15,Arizona State,F,34,34,1060,145,332,.437,103,208,.495,42,124,.339,91,135,.674,43,116,159,59,56,6,49,70,423,9.4
649,Tavrion Dawson\tavrion-dawson-1,2016-17,Cal State Northridge,F,30,23,896,152,292,.521,130,229,.568,22,63,.349,97,126,.770,62,146,208,48,31,18,51,76,423,11.7
650,Miles Bowman\miles-bowman-1,2016-17,High Point,F,30,29,802,140,274,.511,106,205,.517,34,69,.493,109,121,.901,73,174,247,21,15,20,42,61,423,12.1
651,Rod Odom\rod-odom-1,2013-14,Vanderbilt,F,31,31,1116,136,342,.398,51,121,.421,85,221,.385,66,92,.717,41,121,162,37,18,18,42,75,423,8.9
652,Arnaud William Adala Moto\arnaudwilliam-adalamoto-1,2016-17,Towson,F,33,31,869,126,311,.405,114,263,.433,12,48,.250,158,218,.725,73,145,218,43,27,8,67,96,422,8.6
653,Bogdan Bliznyuk\bogdan-bliznyuk-1,2015-16,Eastern Washington,F,34,31,1121,148,331,.447,105,210,.500,43,121,.355,83,104,.798,55,175,230,102,42,24,85,105,422,9.9
654,Alex Thompson\alex-thompson-2,2016-17,Samford,F,36,33,925,146,337,.433,73,156,.468,73,181,.403,57,71,.803,25,129,154,28,15,18,44,74,422,7.5
655,Drew Eubanks\drew-eubanks-1,2017-18,Oregon State,F,32,32,1003,164,263,.624,164,263,.624,0,0,,94,134,.701,59,159,218,35,15,55,56,87,422,11.4
656,Jarrod Uthoff\jarrod-uthoff-1,2014-15,Iowa,F,34,34,1031,156,363,.430,102,218,.468,54,145,.372,56,76,.737,60,158,218,59,38,56,35,52,422,11.0
657,Justin Tuoyo\justin-tuoyo-1,2016-17,Chattanooga,F,31,30,896,156,242,.645,148,222,.667,8,20,.400,102,152,.671,75,129,204,33,22,89,54,84,422,13.1
658,Jaren Lewis\jaren-lewis-1,2017-18,Abilene Christian,F,32,32,998,159,291,.546,146,255,.573,13,36,.361,91,115,.791,79,168,247,59,50,30,75,76,422,12.0
659,Desi Rodriguez\desi-rodriguez-1,2015-16,Seton Hall,F,34,33,883,151,300,.503,119,217,.548,32,83,.386,87,126,.690,51,120,171,47,54,7,59,65,421,9.8
660,Alan Herndon\alan-herndon-1,2016-17,Wyoming,F,38,36,1179,151,323,.467,93,171,.544,58,152,.382,61,97,.629,40,185,225,49,22,74,50,92,421,9.1
661,Kenrich Williams\kenrich-williams-1,2016-17,Texas Christian,F,37,36,1211,159,321,.495,114,197,.579,45,124,.363,58,99,.586,122,237,359,101,55,24,44,92,421,12.5
662,Trey Porter\trey-porter-1,2017-18,Old Dominion,F,32,31,756,146,249,.586,145,248,.585,1,1,1.000,128,191,.670,79,118,197,16,15,43,41,88,421,11.0
663,Kenrich Williams\kenrich-williams-1,2017-18,Texas Christian,F,32,32,1153,155,325,.477,110,211,.521,45,114,.395,66,96,.688,89,208,297,124,56,15,65,81,421,13.3
664,Ethan O'Day\ethan-oday-1,2014-15,Vermont,F,34,32,880,175,302,.579,175,302,.579,0,0,,71,104,.683,51,106,157,29,28,71,50,103,421,10.0
665,BaeBae Daniels\baebae-daniels-1,2015-16,North Florida,F,34,0,867,160,306,.523,131,221,.593,29,85,.341,71,101,.703,70,106,176,46,26,71,50,103,420,10.5
666,Treg Setty\treg-setty-1,2015-16,Ohio,F,35,35,985,155,319,.486,123,233,.528,32,86,.372,78,108,.722,51,127,178,30,29,9,55,97,420,8.1
667,Eli Chuha\eli-chuha-1,2016-17,New Mexico State,F,34,32,883,153,251,.610,152,246,.618,1,5,.200,113,169,.669,123,179,302,38,19,12,55,74,420,11.5
668,Isaiah Armwood\isaiah-armwood-1,2013-14,George Washington,F,33,33,1056,145,297,.488,143,287,.498,2,10,.200,128,194,.660,77,199,276,53,25,51,62,91,420,10.8
669,Dion Wright\dion-wright--1,2014-15,St. Bonaventure,F,31,30,1087,175,323,.542,170,309,.550,5,14,.357,65,84,.774,91,126,217,43,26,18,49,84,420,11.1
670,Kennedy Meeks\kennedy-meeks-1,2014-15,North Carolina,F,37,32,862,168,299,.562,168,298,.564,0,1,.000,84,131,.641,95,176,271,39,23,46,58,98,420,9.8
671,Matt Tiby\matt-tiby-1,2013-14,Milwaukee,F,35,35,934,114,270,.422,91,198,.460,23,72,.319,169,225,.751,65,163,228,68,18,10,98,98,420,8.1
672,Vince Hunter\vince-hunter-1,2013-14,Texas-El Paso,F,34,28,876,148,265,.558,148,263,.563,0,2,.000,123,202,.609,77,145,222,43,27,25,67,111,419,9.5
673,D.J. Wilson\dj-wilson-1,2016-17,Michigan,F,38,36,1155,164,305,.538,123,195,.631,41,110,.373,50,60,.833,57,146,203,50,20,57,42,73,419,9.9
674,Cody Larson\cody-larson-1,2013-14,South Dakota State,F,32,32,928,159,306,.520,159,303,.525,0,3,.000,101,146,.692,66,159,225,64,19,36,74,97,419,10.0
675,Payton Henson\payton-henson-1,2017-18,Vermont,F,34,34,1060,145,322,.450,109,233,.468,36,89,.404,93,115,.809,50,137,187,53,11,11,59,51,419,8.7
676,Lamar Stevens\lamar-stevens-1,2016-17,Penn State,F,33,33,918,148,344,.430,137,310,.442,11,34,.324,112,146,.767,54,130,184,55,26,22,72,90,419,8.3
677,Obi Enechionyia\obi-enechionyia-1,2016-17,Temple,F,32,32,1048,156,384,.406,81,189,.429,75,195,.385,32,47,.681,41,143,184,31,22,49,42,93,419,8.7
678,Connar Tava\connar-tava-1,2014-15,Western Michigan,F,34,34,1025,150,288,.521,149,278,.536,1,10,.100,118,174,.678,49,161,210,113,36,11,97,87,419,9.7
679,Rob Marberry\rob-marberry-1,2016-17,Lipscomb,F,33,33,797,172,282,.610,172,282,.610,0,0,,75,101,.743,61,100,161,69,18,30,53,94,419,10.6
680,Bobby Portis\bobby-portis-1,2013-14,Arkansas,F,34,34,918,161,316,.509,152,283,.537,9,33,.273,87,118,.737,86,144,230,50,35,54,41,59,418,11.6
681,Aundre Jackson\aundre-jackson-1,2017-18,Loyola (IL),F,38,14,720,170,295,.576,150,240,.625,20,55,.364,58,77,.753,35,88,123,36,17,10,59,91,418,7.3
682,Brett Bisping\brett-bisping-1,2016-17,Siena,F,34,34,1108,153,320,.478,121,234,.517,32,86,.372,80,107,.748,87,243,330,54,40,16,76,110,418,10.2
683,Jae'Sean Tate\jaesean-tate-1,2017-18,Ohio State,F,34,34,1005,171,307,.557,160,272,.588,11,35,.314,65,110,.591,44,168,212,98,36,19,75,108,418,9.8
684,Wayne Langston\wayne-langston-1,2015-16,Murray State,F,31,31,927,163,258,.632,163,258,.632,0,0,,92,132,.697,83,105,188,42,24,11,46,111,418,11.2
685,Willie Green\willie-green-2,2013-14,Stetson,F,31,31,801,158,307,.515,152,285,.533,6,22,.273,96,137,.701,55,66,121,26,19,41,33,65,418,10.2
686,Tyler Harris\tyler-harris-1,2015-16,Auburn,F,30,29,855,141,312,.452,132,276,.478,9,36,.250,127,194,.655,84,146,230,40,21,14,76,99,418,9.2
687,Chris Davenport\chris-davenport-2,2015-16,North Florida,F,34,34,918,153,289,.529,116,189,.614,37,100,.370,74,103,.718,44,201,245,109,23,67,92,95,417,10.9
688,Dustin Hogue\dustin-hogue-1,2013-14,Iowa State,F,36,36,1077,150,262,.573,128,198,.646,22,64,.344,95,143,.664,90,212,302,36,28,20,36,97,417,10.9
689,Troy Williams\troy-williams-2,2014-15,Indiana,F,32,28,882,161,298,.540,155,285,.544,6,13,.462,89,120,.742,71,167,238,64,32,15,71,72,417,10.9
690,David Collette\david-collette-1,2017-18,Utah,F,34,34,738,169,268,.631,167,262,.637,2,6,.333,77,107,.720,47,107,154,43,26,23,47,92,417,10.0
691,Winston Shepard\winston-shepard-1,2015-16,San Diego State,F,37,29,1067,135,350,.386,125,304,.411,10,46,.217,137,194,.706,64,174,238,113,33,13,77,60,417,8.7
692,Cameron Jackson\cameron-jackson-1,2016-17,Wofford,F,33,30,689,171,291,.588,170,288,.590,1,3,.333,74,115,.643,75,113,188,49,42,31,64,118,417,10.3
693,Mike Holloway\mike-holloway-1,2017-18,Fairleigh Dickinson,F,31,31,922,159,329,.483,152,306,.497,7,23,.304,91,132,.689,80,137,217,38,21,22,74,108,416,8.9
694,Sam Iorio\sam-iorio-2,2017-18,American,F,28,28,934,143,300,.477,81,158,.513,62,142,.437,68,86,.791,46,137,183,37,38,25,49,72,416,11.9
695,Jordan Loveridge\jordan-loveridge-1,2015-16,Utah,F,36,36,1108,125,319,.392,35,96,.365,90,223,.404,76,96,.792,14,124,138,62,21,5,44,74,416,7.7
696,Jake Layman\jake-layman-1,2015-16,Maryland,F,36,36,1112,140,280,.500,83,136,.610,57,144,.396,79,95,.832,38,151,189,41,40,36,61,69,416,9.6
697,Josh Fox\josh-fox-2,2015-16,UC-Davis,F,28,28,886,165,321,.514,165,320,.516,0,1,.000,86,130,.662,55,134,189,58,31,12,72,69,416,10.7
698,Kevon Looney\kevon-looney-1,2014-15,UCLA,F,36,36,1113,151,321,.470,129,268,.481,22,53,.415,92,147,.626,122,209,331,51,46,32,45,104,416,11.0
699,Kenny Kaminski\kenny-kaminski-1,2015-16,Ohio,F,33,33,1004,132,341,.387,49,112,.438,83,229,.362,69,80,.863,13,110,123,41,17,10,38,73,416,7.7
700,Nate Navigato\nate-navigato-1,2017-18,Toledo,F,34,33,1107,132,293,.451,38,73,.521,94,220,.427,58,74,.784,28,114,142,59,14,18,21,52,416,9.9
701,Shaquille Hines\shaquille-hines-1,2015-16,Texas-Rio Grande Valley,F,30,30,970,158,342,.462,122,241,.506,36,101,.356,64,86,.744,47,119,166,81,28,19,53,82,416,10.4
702,Mario Moody\mario-moody-1,2015-16,Bethune-Cookman,F,32,26,889,153,313,.489,125,228,.548,28,85,.329,81,116,.698,79,158,237,33,29,76,80,101,415,10.3
703,Kayel Locke\kayel-locke-1,2014-15,North Carolina-Greensboro,F,33,33,973,158,342,.462,155,325,.477,3,17,.176,96,147,.653,74,115,189,26,11,9,61,92,415,7.3
704,Marquis Vance\marquis-vance-1,2014-15,Alcorn State,F,32,32,1075,132,350,.377,109,268,.407,23,82,.280,128,190,.674,67,183,250,54,21,21,61,70,415,8.9
705,Kevin Mays\kevin-mays-2,2015-16,Cal State Bakersfield,F,33,32,819,160,309,.518,153,289,.529,7,20,.350,88,131,.672,115,148,263,33,33,10,40,93,415,10.8
706,Branden Dawson\branden-dawson-1,2014-15,Michigan State,F,35,32,1055,182,340,.535,182,340,.535,0,0,,51,104,.490,102,216,318,59,42,58,67,72,415,11.2
707,Markis McDuffie\markis-mcduffie-1,2016-17,Wichita State,F,36,28,918,132,288,.458,99,195,.508,33,93,.355,118,144,.819,62,142,204,61,42,11,50,72,415,9.9
708,Venky Jois\venky-jois-1,2013-14,Eastern Washington,F,31,31,985,160,303,.528,159,294,.541,1,9,.111,94,178,.528,73,174,247,77,28,49,80,79,415,11.0
709,Dyshawn Pierre\dyshawn-pierre-1,2013-14,Dayton,F,37,36,994,148,299,.495,121,233,.519,27,66,.409,92,136,.676,87,117,204,60,20,13,59,60,415,9.0
710,Phillip Carr\phillip-carr-1,2016-17,Morgan State,F,25,25,911,150,327,.459,137,298,.460,13,29,.448,102,123,.829,80,159,239,28,15,21,51,58,415,12.7
711,Bonzie Colson\bonzie-colson-1,2017-18,Notre Dame,F,21,21,680,157,312,.503,140,254,.551,17,58,.293,83,109,.761,48,164,212,19,35,47,32,36,414,17.4
712,Adom Jacko\adom-jacko-1,2015-16,Loyola Marymount,F,25,22,683,170,305,.557,169,303,.558,1,2,.500,73,100,.730,59,100,159,16,18,22,45,95,414,11.6
713,Duop Reath\duop-reath-1,2017-18,Louisiana State,F,33,28,800,167,307,.544,148,262,.565,19,45,.422,61,97,.629,64,111,175,22,15,32,55,81,414,8.9
714,Alessandro Lever\alessandro-lever-1,2017-18,Grand Canyon,F,34,27,724,140,309,.453,114,228,.500,26,81,.321,108,141,.766,42,107,149,40,12,14,59,90,414,7.6
715,Jarrell Brantley\jarrell-brantley-1,2017-18,College of Charleston,F,24,21,775,153,306,.500,123,228,.539,30,78,.385,78,95,.821,43,127,170,40,25,18,60,72,414,12.5
716,Marvin Clark\marvin-clark-1,2017-18,St. John's (NY),F,33,33,1022,143,312,.458,78,154,.506,65,158,.411,63,74,.851,39,117,156,32,38,5,61,112,414,8.1
717,Aubrey Williams\aubrey-williams-2,2016-17,Kennesaw State,F,32,32,1029,152,261,.582,152,261,.582,0,0,,109,160,.681,105,241,346,43,24,22,54,106,413,12.2
718,DeAndre Bembry\deandre-bembry-1,2013-14,Saint Joseph's,F,34,34,1107,143,312,.458,107,208,.514,36,104,.346,91,156,.583,37,116,153,92,32,19,86,88,413,8.1
719,Dillon Brooks\dillon-brooks-1,2014-15,Oregon,F,36,33,1020,150,329,.456,122,246,.496,28,83,.337,85,103,.825,62,114,176,65,18,20,73,111,413,7.6
720,Daniel Gafford\daniel-gafford-1,2017-18,Arkansas,F,35,26,790,164,271,.605,164,271,.605,0,0,,85,161,.528,76,140,216,24,19,76,37,114,413,10.3
721,Nikola Jovanovic\nikola-jovanovic-1,2015-16,Southern California,F,34,34,877,154,294,.524,147,281,.523,7,13,.538,98,150,.653,73,165,238,13,11,27,47,81,413,9.1
722,Malcolm Smith\malcolm-smith-1,2013-14,Lipscomb,F,30,30,779,130,253,.514,123,220,.559,7,33,.212,146,220,.664,64,88,152,46,20,5,63,103,413,9.4
723,T.J. Cline\tj-cline-1,2014-15,Richmond,F,35,28,812,162,314,.516,112,185,.605,50,129,.388,39,60,.650,26,104,130,55,25,7,52,78,413,8.1
724,Juvonte Reddic\juvonte-reddic-1,2013-14,Virginia Commonwealth,F,35,35,975,165,324,.509,162,315,.514,3,9,.333,80,146,.548,126,168,294,24,47,41,61,81,413,10.4
725,Brian Dawkins\brian-dawkins-1,2016-17,Elon,F,32,31,836,168,326,.515,123,225,.547,45,101,.446,31,55,.564,38,133,171,29,13,6,36,73,412,8.8
726,Rafriel Guthrie\rafriel-guthrie-1,2013-14,Towson,F,36,11,909,127,308,.412,96,220,.436,31,88,.352,127,201,.632,33,73,106,33,26,4,66,88,412,5.9
727,Malachi Alexander\malachi-alexander-1,2015-16,Holy Cross,F,35,35,1147,138,293,.471,88,179,.492,50,114,.439,86,136,.632,58,139,197,99,31,5,61,91,412,9.5
728,Cinmeon Bowers\cinmeon-bowers-1,2014-15,Auburn,F,34,34,1023,154,370,.416,149,342,.436,5,28,.179,99,207,.478,123,203,326,45,36,20,85,89,412,8.2
729,Jerrell Wright\jerrell-wright-1,2013-14,La Salle,F,31,30,786,160,278,.576,160,278,.576,0,0,,92,154,.597,96,110,206,20,12,13,52,76,412,10.0
730,Tre' McLean\tre-mclean-1,2016-17,Chattanooga,F,30,29,975,139,307,.453,84,166,.506,55,141,.390,79,99,.798,43,119,162,65,48,9,49,49,412,11.4
731,George Fant\george-fant-1,2013-14,Western Kentucky,F,31,31,916,149,281,.530,149,281,.530,0,0,,114,208,.548,89,117,206,27,27,27,52,97,412,10.0
732,Josh Nzeakor\josh-nzeakor-1,2017-18,Lamar,F,33,33,922,155,302,.513,155,301,.515,0,1,.000,102,168,.607,101,145,246,22,28,18,59,96,412,9.4
733,Xavier Sneed\xavier-sneed-1,2017-18,Kansas State,F,37,37,1160,141,338,.417,76,149,.510,65,189,.344,65,88,.739,42,146,188,65,59,12,41,85,412,9.0
734,Kerry Blackshear Jr.\kerry-blackshearjr-1,2017-18,Virginia Tech,F,33,32,832,139,249,.558,124,200,.620,15,49,.306,118,158,.747,56,140,196,40,27,30,50,102,411,10.4
735,Malik Pope\malik-pope-1,2017-18,San Diego State,F,32,32,842,168,323,.520,154,284,.542,14,39,.359,61,89,.685,70,146,216,38,23,37,58,71,411,10.1
736,Jarell Eddie\jarell-eddie-1,2013-14,Virginia Tech,F,31,30,1011,134,377,.355,54,164,.329,80,213,.376,63,81,.778,32,135,167,38,11,11,53,48,411,7.4
737,Obinna Oleka\obinna-oleka-1,2016-17,Arizona State,F,33,32,1085,141,328,.430,117,233,.502,24,95,.253,105,146,.719,98,229,327,38,32,27,63,81,411,10.3
738,A.J. Pacher\aj-pacher-1,2013-14,Wright State,F,36,34,832,147,244,.602,132,200,.660,15,44,.341,101,145,.697,47,129,176,30,17,9,73,117,410,7.7
739,Ousmane Drame\ousmane-drame-1,2013-14,Quinnipiac,F,30,28,871,149,303,.492,149,303,.492,0,0,,112,164,.683,114,200,314,26,18,64,74,104,410,11.4
740,Chris Lewis\chris-lewis-4,2017-18,Harvard,F,32,28,837,172,286,.601,172,286,.601,0,0,,66,96,.688,60,116,176,39,17,48,56,88,410,10.3
741,Shane Whitfield\shane-whitfield-1,2016-17,Campbell,F,37,36,1063,121,274,.442,120,266,.451,1,8,.125,167,222,.752,38,124,162,69,22,9,99,105,410,6.6
742,Kyle Steward\kyle-steward-1,2016-17,Missouri-Kansas City,F,35,29,940,141,324,.435,94,196,.480,47,128,.367,81,120,.675,53,131,184,35,23,17,62,107,410,7.3
743,Erik McCree\erik-mccree-1,2014-15,Louisiana Tech,F,36,36,878,150,316,.475,116,212,.547,34,104,.327,75,106,.708,51,151,202,21,26,16,55,69,409,7.9
744,Darnell Harris\darnell-harris-2,2015-16,Middle Tennessee,F,35,32,931,138,336,.411,80,190,.421,58,146,.397,75,117,.641,48,93,141,43,17,23,47,91,409,7.2
745,Jett Raines\jett-raines-1,2015-16,Pepperdine,F,32,32,887,148,284,.521,141,251,.562,7,33,.212,106,146,.726,66,91,157,20,18,17,36,82,409,9.4
746,Michael Murray\michael-murray-1,2013-14,Coppin State,F,28,27,979,147,359,.409,117,243,.481,30,116,.259,85,129,.659,59,135,194,32,32,17,56,62,409,9.5
747,Joseph Lopez\joseph-lopez-1,2016-17,Sacred Heart,F,31,31,880,170,301,.565,169,293,.577,1,8,.125,68,112,.607,102,163,265,26,23,38,56,77,409,11.3
748,Jalen Jenkins\jalen-jenkins-1,2016-17,George Mason,F,34,34,943,158,258,.612,158,258,.612,0,0,,93,137,.679,94,112,206,65,14,9,79,100,409,9.4
749,Tyler Livingston\tyler-livingston-1,2016-17,Massachusetts-Lowell,F,31,31,999,154,307,.502,75,136,.551,79,171,.462,22,28,.786,39,103,142,53,19,13,39,110,409,9.5
750,Jordon Varnado\jordon-varnado-1,2015-16,Troy,F,31,30,878,159,328,.485,131,240,.546,28,88,.318,63,99,.636,72,143,215,29,18,37,34,78,409,10.4
751,Josh Nebo\josh-nebo-1,2016-17,Saint Francis (PA),F,34,32,1011,168,297,.566,167,295,.566,1,2,.500,72,121,.595,89,191,280,23,10,89,78,83,409,10.2
752,Winston Shepard\winston-shepard-1,2013-14,San Diego State,F,35,34,932,137,331,.414,130,293,.444,7,38,.184,128,202,.634,59,111,170,74,35,12,80,45,409,7.8
753,Myles Taylor\myles-taylor-1,2013-14,Tennessee-Martin,F,28,21,705,144,283,.509,136,258,.527,8,25,.320,113,153,.739,66,111,177,16,27,27,42,93,409,11.1
754,Jonathan Holmes\jonathan-holmes-2,2013-14,Texas,F,32,31,776,141,279,.505,113,195,.579,28,84,.333,99,133,.744,89,140,229,30,18,40,51,80,409,10.8
755,Tai Odiase\tai-odiase-1,2016-17,Illinois-Chicago,F,36,36,962,162,281,.577,162,281,.577,0,0,,85,143,.594,104,145,249,12,20,102,48,98,409,10.6
756,Frederick Scott\frederick-scott-1,2017-18,Rider,F,32,10,763,149,286,.521,117,202,.579,32,84,.381,79,177,.446,66,143,209,25,19,9,57,73,409,8.6
757,Hassan Martin\hassan-martin-1,2016-17,Rhode Island,F,30,30,784,165,278,.594,164,274,.599,1,4,.250,77,117,.658,63,140,203,22,21,70,44,86,408,11.9
758,Luke Petrasek\luke-petrasek-1,2016-17,Columbia,F,27,27,790,148,304,.487,105,188,.559,43,116,.371,69,86,.802,27,125,152,51,32,18,53,57,408,11.4
759,Shaquille Hines\shaquille-hines-1,2013-14,Texas-Rio Grande Valley,F,32,29,1042,169,346,.488,162,307,.528,7,39,.179,63,109,.578,75,125,200,47,22,19,78,92,408,8.1
760,Justin Jackson\justin-jackson-4,2014-15,North Carolina,F,38,37,1014,157,329,.477,129,237,.544,28,92,.304,66,93,.710,52,87,139,88,20,19,52,55,408,8.2
761,Trevon Bluiett\trevon-bluiett-1,2014-15,Xavier,F,37,32,1048,133,315,.422,88,177,.497,45,138,.326,97,130,.746,52,104,156,71,23,2,51,83,408,7.7
762,Will Neighbour\will-neighbour-1,2013-14,Little Rock,F,25,24,776,131,263,.498,106,198,.535,25,65,.385,121,157,.771,49,125,174,36,32,27,64,47,408,13.1
763,Braxton Key\braxton-key-1,2016-17,Alabama,F,34,30,1012,139,321,.433,107,224,.478,32,97,.330,97,153,.634,54,139,193,86,21,21,106,86,407,7.4
764,Jaron Blossomgame\jaron-blossomgame-1,2014-15,Clemson,F,31,31,958,144,296,.486,127,237,.536,17,59,.288,102,144,.708,76,177,253,30,24,11,54,45,407,10.6
765,Kyle Washington\kyle-washington-2,2017-18,Cincinnati,F,36,34,838,165,327,.505,145,271,.535,20,56,.357,57,77,.740,60,137,197,14,9,50,45,65,407,8.4
766,Marcus Georges-Hunt\marcus-georges-hunt-1,2014-15,Georgia Tech,F,30,30,926,135,313,.431,114,240,.475,21,73,.288,116,152,.763,56,109,165,54,39,4,59,64,407,9.8
767,Steven Cook\steven-cook-1,2016-17,Princeton,F,30,30,907,143,294,.486,91,172,.529,52,122,.426,69,104,.663,44,110,154,52,47,8,42,62,407,11.0
768,Mike Amius\mike-amius-1,2017-18,Western Carolina,F,32,28,738,152,277,.549,152,277,.549,0,0,,102,161,.634,62,117,179,35,38,27,90,97,406,8.8
769,Calvin Godfrey\calvin-godfrey-1,2013-14,Southern,F,31,29,834,155,279,.556,155,279,.556,0,0,,96,147,.653,85,188,273,26,14,49,49,92,406,11.3
770,Emmanuel Nzekwesi\emmanuel-nzekwesi-1,2017-18,Oral Roberts,F,32,32,974,161,355,.454,146,291,.502,15,64,.234,69,102,.676,85,144,229,55,38,21,68,70,406,9.6
771,Alex Murphy\alex-murphy-1,2016-17,Northeastern,F,29,29,943,152,307,.495,104,181,.575,48,126,.381,54,102,.529,38,130,168,53,21,18,64,66,406,9.6
772,Ryan Watkins\ryan-watkins-1,2013-14,Boise State,F,34,34,1027,151,263,.574,151,262,.576,0,1,.000,104,140,.743,170,191,361,34,26,37,36,99,406,13.1
773,Alex Rosenberg\alex-rosenberg-1,2015-16,Columbia,F,30,25,870,125,304,.411,87,189,.460,38,115,.330,117,163,.718,46,79,125,58,22,8,42,70,405,9.3
774,Jamal Aytes\jamal-aytes-1,2017-18,Southern Utah,F,32,17,681,164,281,.584,163,279,.584,1,2,.500,76,103,.738,53,115,168,21,16,8,47,102,405,8.9
775,Calvin Hermanson\calvin-hermanson-1,2017-18,Saint Mary's (CA),F,36,36,1160,140,283,.495,63,109,.578,77,174,.443,48,61,.787,27,90,117,40,27,12,37,90,405,8.2
776,Tyler Harris\tyler-harris-1,2013-14,Providence,F,35,35,1126,136,314,.433,107,224,.478,29,90,.322,104,124,.839,76,103,179,49,34,23,75,104,405,8.1
777,L.J. Peak\lj-peak-1,2015-16,Georgetown,F,33,12,824,136,277,.491,98,184,.533,38,93,.409,95,125,.760,23,85,108,56,25,21,57,116,405,8.2
778,TaShawn Thomas\tashawn-thomas-1,2014-15,Oklahoma,F,35,35,1038,160,308,.519,160,305,.525,0,3,.000,85,123,.691,77,151,228,51,22,53,68,73,405,9.6
779,Nicholas West\nicholas-west-1,2015-16,Alabama A&M,F,29,29,878,132,286,.462,114,222,.514,18,64,.281,123,170,.724,73,154,227,43,17,27,71,95,405,10.1
780,Kurt Steidl\kurt-steidl-1,2015-16,Vermont,F,36,36,1071,127,283,.449,57,96,.594,70,187,.374,80,99,.808,19,172,191,38,35,12,43,88,404,8.5
781,Octavius Brown\octavius-brown-1,2013-14,Alcorn State,F,30,28,992,144,289,.498,115,210,.548,29,79,.367,87,133,.654,51,143,194,23,22,29,42,70,404,10.3
782,Antwan Burrus\antwan-burrus-1,2013-14,Liberty,F,31,20,820,167,335,.499,165,330,.500,2,5,.400,68,92,.739,78,86,164,15,14,20,49,64,404,8.7
783,Justin Tillman\justin-tillman-1,2016-17,Virginia Commonwealth,F,33,23,840,174,294,.592,174,293,.594,0,1,.000,56,91,.615,96,192,288,12,9,17,34,75,404,10.4
784,Faronte Drakeford\faronte-drakeford-1,2013-14,Central Connecticut State,F,30,30,804,171,351,.487,166,334,.497,5,17,.294,56,81,.691,50,109,159,30,29,17,82,102,403,7.4
785,Kruize Pinkins\kruize-pinkins-1,2013-14,San Francisco,F,33,19,825,144,279,.516,143,267,.536,1,12,.083,114,187,.610,106,109,215,34,18,25,50,108,403,9.4
786,Aric Holman\aric-holman-1,2017-18,Mississippi State,F,37,30,852,146,255,.573,109,171,.637,37,84,.440,74,101,.733,79,170,249,28,17,66,48,71,403,10.4
787,Devon Collier\devon-collier-1,2013-14,Oregon State,F,30,15,783,143,236,.606,143,236,.606,0,0,,117,199,.588,60,108,168,45,18,37,49,58,403,11.3
788,Chaise Daniels\chaise-daniels-1,2016-17,Quinnipiac,F,31,31,877,161,313,.514,161,311,.518,0,2,.000,81,136,.596,68,125,193,40,14,52,65,103,403,9.1
789,Tyran de Lattibeaudiere\tyran-de-lattibeaudiere-1,2014-15,Lamar,F,30,30,893,167,290,.576,167,290,.576,0,0,,68,128,.531,86,146,232,47,40,63,94,99,402,11.0
790,Ethan O'Day\ethan-oday-1,2015-16,Vermont,F,35,34,989,168,307,.547,168,306,.549,0,1,.000,66,109,.606,63,156,219,45,22,70,62,107,402,9.3
791,Eric Paschall\eric-paschall-1,2017-18,Villanova,F,38,38,1133,144,270,.533,108,169,.639,36,101,.356,78,96,.813,70,130,200,83,35,24,64,93,402,9.5
792,Hayden Graham\hayden-graham-1,2016-17,Air Force,F,32,32,940,150,317,.473,109,207,.527,41,110,.373,61,90,.678,41,143,184,63,22,19,49,86,402,9.3
793,Grant Williams\grant-williams-1,2016-17,Tennessee,F,32,29,814,132,262,.504,120,230,.522,12,32,.375,126,189,.667,94,95,189,36,26,61,62,105,402,10.3
794,Junior Etou\junior-etou-1,2016-17,Tulsa,F,32,32,935,123,251,.490,79,148,.534,44,103,.427,112,146,.767,54,161,215,40,15,3,81,77,402,8.8
795,Duncan Robinson\duncan-robinson-1,2015-16,Michigan,F,36,27,1040,134,293,.457,39,82,.476,95,211,.450,39,44,.886,22,104,126,65,23,8,36,81,402,8.4
796,Josh Huestis\josh-huestis-1,2013-14,Stanford,F,36,36,1266,156,346,.451,130,269,.483,26,77,.338,64,102,.627,91,204,295,43,21,69,43,76,402,9.9
797,Matt Klinewski\matt-klinewski-1,2015-16,Lafayette,F,30,27,779,151,304,.497,150,301,.498,1,3,.333,99,130,.762,47,101,148,39,11,14,53,85,402,8.7
798,Tony Parker\tony-parker-1,2015-16,UCLA,F,32,27,802,164,304,.539,164,304,.539,0,0,,74,150,.493,104,158,262,21,20,31,54,103,402,9.6
799,Ben Moore\ben-moore-1,2016-17,Southern Methodist,F,35,35,1131,160,288,.556,159,283,.562,1,5,.200,80,128,.625,92,181,273,85,31,38,56,94,401,11.0
800,Emmitt Holt\emmitt-holt-1,2016-17,Providence,F,32,28,879,149,285,.523,128,224,.571,21,61,.344,82,121,.678,55,117,172,32,22,25,45,101,401,9.2
801,Karl-Anthony Towns\karl-anthony-towns-1,2014-15,Kentucky,F,39,39,822,145,256,.566,143,248,.577,2,8,.250,109,134,.813,92,169,261,44,18,88,53,115,401,10.2
802,Dennis Kramer\dennis-kramer-1,2013-14,San Diego,F,35,35,932,164,307,.534,145,245,.592,19,62,.306,54,74,.730,57,174,231,29,18,30,53,99,401,8.6
803,Cody Joyce\cody-joyce-1,2014-15,Maryland-Baltimore County,F,30,28,1012,148,293,.505,148,293,.505,0,0,,105,157,.669,46,127,173,32,17,18,68,83,401,8.5
804,PJ Washington\pj-washington-1,2017-18,Kentucky,F,37,30,1012,135,260,.519,130,239,.544,5,21,.238,126,208,.606,67,144,211,57,28,31,71,100,401,8.3
805,Deng Adel\deng-adel-1,2016-17,Louisville,F,33,30,993,141,333,.423,97,207,.469,44,126,.349,74,96,.771,23,124,147,70,20,12,45,61,400,8.4
806,Josh Ajayi\josh-ajayi-1,2017-18,South Alabama,F,31,29,919,144,297,.485,131,249,.526,13,48,.271,99,133,.744,56,152,208,29,16,13,70,57,400,8.8
807,Luka Garza\luka-garza-1,2017-18,Iowa,F,33,26,715,146,262,.557,130,216,.602,16,46,.348,92,135,.681,79,132,211,35,11,32,35,80,400,10.4
808,Larry Nance\larry-nance-2,2013-14,Wyoming,F,26,26,902,147,270,.544,138,233,.592,9,37,.243,97,128,.758,35,189,224,42,37,55,44,73,400,14.2
809,Martinas Geben\martinas-geben-1,2017-18,Notre Dame,F,36,36,891,157,259,.606,156,256,.609,1,3,.333,85,100,.850,106,183,289,42,21,32,60,72,400,10.8
810,Nick McGlynn\nick-mcglynn-1,2017-18,Drake,F,34,34,787,161,308,.523,153,284,.539,8,24,.333,70,93,.753,70,125,195,39,13,56,36,105,400,9.6
811,Evan Bruinsma\evan-bruinsma-1,2013-14,Detroit Mercy,F,32,32,1064,128,286,.448,109,218,.500,19,68,.279,125,163,.767,77,169,246,62,34,21,81,96,400,9.8
812,Tyshawn Bell\tyshawn-bell-1,2014-15,Delaware State,F,36,35,1067,139,343,.405,66,148,.446,73,195,.374,49,58,.845,45,154,199,35,33,8,31,87,400,8.0
813,Reggie McAdams\reggie-mcadams-1,2015-16,Akron,F,35,35,926,125,294,.425,27,55,.491,98,239,.410,52,72,.722,37,104,141,30,25,10,26,69,400,8.4
814,Rodney Bullock\rodney-bullock-1,2015-16,Providence,F,35,35,1149,145,327,.443,111,226,.491,34,101,.337,76,106,.717,77,162,239,34,24,47,63,104,400,8.4
815,Devin Robinson\devin-robinson-1,2016-17,Florida,F,36,35,952,142,299,.475,99,189,.524,43,110,.391,73,101,.723,62,158,220,23,31,29,39,81,400,9.0
816,Bonzie Colson\bonzie-colson-1,2015-16,Notre Dame,F,36,24,910,150,282,.532,146,270,.541,4,12,.333,96,124,.774,87,153,240,34,31,36,36,86,400,10.2
817,Spencer Parker\spencer-parker-1,2013-14,Bowling Green State,F,32,30,1120,135,285,.474,126,232,.543,9,53,.170,121,172,.703,46,118,164,41,22,11,103,85,400,7.0
818,Chris Cokley\chris-cokley-1,2016-17,Alabama-Birmingham,F,33,17,716,164,283,.580,164,282,.582,0,1,.000,72,91,.791,69,130,199,48,21,20,62,72,400,9.8
819,Ryan Nicholas\ryan-nicholas-1,2013-14,Portland,F,31,31,910,145,298,.487,122,239,.510,23,59,.390,86,112,.768,71,202,273,40,11,14,54,78,399,10.1
820,Joel Bolomboy\joel-bolomboy-1,2014-15,Weber State,F,30,29,997,131,277,.473,116,236,.492,15,41,.366,122,166,.735,107,199,306,25,20,51,80,71,399,11.3
821,Winston Shepard\winston-shepard-1,2014-15,San Diego State,F,36,36,955,138,339,.407,121,282,.429,17,57,.298,106,158,.671,64,126,190,67,22,10,88,54,399,6.8
822,Matt Tiby\matt-tiby-1,2014-15,Milwaukee,F,30,30,884,121,290,.417,90,195,.462,31,95,.326,125,154,.812,39,195,234,57,12,12,79,80,398,8.9
823,Marcus Damas\marcus-damas-1,2013-14,Towson,F,36,36,1114,137,317,.432,94,194,.485,43,123,.350,81,111,.730,50,133,183,43,19,34,61,106,398,7.3
824,Ronnie Drinnon\ronnie-drinnon-1,2015-16,Saint Francis (PA),F,30,30,977,150,309,.485,136,263,.517,14,46,.304,84,143,.587,112,217,329,50,21,3,52,73,398,11.3
825,David Kravish\david-kravish-1,2013-14,University of California,F,35,34,1126,178,328,.543,176,321,.548,2,7,.286,40,54,.741,79,189,268,38,21,73,47,93,398,10.3
826,Darius Carter\darius-carter-1,2014-15,Wichita State,F,35,35,750,157,300,.523,153,293,.522,4,7,.571,80,124,.645,66,123,189,19,15,21,37,79,398,8.3
827,Secean Johnson\secean-johnson-1,2015-16,UC-Riverside,F,33,31,941,123,297,.414,95,210,.452,28,87,.322,124,165,.752,49,142,191,65,29,7,81,97,398,7.9
828,Jerrell Wright\jerrell-wright-1,2014-15,La Salle,F,33,32,922,155,296,.524,155,296,.524,0,0,,88,146,.603,96,119,215,49,24,24,74,91,398,9.0
829,Ryan Taylor\ryan-taylor-1,2013-14,Marshall,F,31,29,796,136,286,.476,117,220,.532,19,66,.288,106,151,.702,62,162,224,30,22,19,57,111,397,9.0
830,Johnathan Williams\johnathan-williams-2,2016-17,Gonzaga,F,39,39,951,155,262,.592,139,222,.626,16,40,.400,71,126,.563,70,181,251,31,27,36,53,82,397,8.8
831,Vince Edwards\vince-edwards-2,2015-16,Purdue,F,35,35,961,139,309,.450,93,196,.474,46,113,.407,73,89,.820,64,124,188,100,19,11,58,78,397,9.1
832,Emani Gant\emani-gant-1,2015-16,Texas State,F,29,29,790,152,302,.503,152,300,.507,0,2,.000,93,129,.721,77,145,222,41,23,15,52,68,397,10.8
833,David Collette\david-collette-1,2014-15,Utah State,F,31,31,792,163,276,.591,161,270,.596,2,6,.333,69,116,.595,47,109,156,37,25,56,36,115,397,10.4
834,Kwan Cheatham\kwan-cheatham-1,2016-17,Akron,F,36,35,1028,136,332,.410,58,129,.450,78,203,.384,47,59,.797,54,204,258,65,18,35,55,97,397,8.5
835,Ishmael Lane\ishmael-lane-1,2017-18,Northwestern State,F,29,28,749,149,281,.530,132,236,.559,17,45,.378,82,128,.641,69,141,210,24,25,53,71,76,397,10.7
836,Cole Huff\cole-huff-1,2013-14,Nevada,F,32,32,1029,129,286,.451,73,147,.497,56,139,.403,83,101,.822,52,122,174,26,18,22,44,88,397,9.0
837,Charlie Brown\charlie-brown-2,2016-17,Saint Joseph's,F,31,30,1060,129,344,.375,58,159,.365,71,185,.384,68,83,.819,33,122,155,33,24,21,36,67,397,8.4
838,Jaren Lewis\jaren-lewis-1,2016-17,Abilene Christian,F,29,29,939,148,289,.512,137,255,.537,11,34,.324,90,125,.720,39,151,190,61,53,12,75,72,397,10.8
839,Greg Mays\greg-mays-1,2014-15,Green Bay,F,33,33,926,154,310,.497,141,257,.549,13,53,.245,76,113,.673,43,112,155,28,14,48,62,65,397,8.2
840,Stephon Jelks\stephon-jelks-1,2015-16,Mercer,F,34,34,987,138,320,.431,90,185,.486,48,135,.356,73,93,.785,82,202,284,66,29,11,50,81,397,10.0
841,Nick Perkins\nick-perkins-2,2016-17,Buffalo,F,32,19,826,148,349,.424,116,231,.502,32,118,.271,68,108,.630,57,157,214,21,10,25,74,92,396,6.7
842,Cole Huff\cole-huff-1,2015-16,Creighton,F,35,23,777,135,310,.435,73,140,.521,62,170,.365,64,81,.790,21,157,178,20,23,10,27,78,396,7.8
843,Javier Martinez\javier-martinez-1,2016-17,Tennessee-Martin,F,31,31,897,168,250,.672,168,250,.672,0,0,,60,75,.800,110,157,267,51,15,14,50,69,396,12.6
844,Gabe McCray\gabe-mccray-1,2015-16,South Carolina State,F,34,34,855,150,307,.489,129,252,.512,21,55,.382,75,120,.625,56,109,165,33,23,1,51,92,396,7.5
845,DaVon Haynes\davon-haynes-1,2013-14,Arkansas-Pine Bluff,F,31,31,967,144,294,.490,132,259,.510,12,35,.343,96,156,.615,60,131,191,35,34,26,69,89,396,8.9
846,Troy Brown\troy-brown-5,2017-18,Oregon,F,35,35,1093,143,322,.444,111,212,.524,32,110,.291,78,105,.743,53,164,217,111,55,7,86,78,396,9.2
847,Koby Thomas\koby-thomas-1,2017-18,Robert Morris,F,33,32,885,145,330,.439,126,251,.502,19,79,.241,86,134,.642,72,155,227,20,20,6,63,58,395,7.6
848,Ryan Welage\ryan-welage-1,2016-17,San Jose State,F,30,27,822,144,333,.432,91,189,.481,53,144,.368,54,65,.831,29,107,136,33,17,5,39,47,395,8.4
849,Makinde London\makinde-london-1,2017-18,Chattanooga,F,29,15,769,133,334,.398,88,200,.440,45,134,.336,84,115,.730,40,159,199,52,26,23,86,83,395,8.2
850,Jordan Swopshire\jordan-swopshire-1,2017-18,Colgate,F,33,33,921,127,308,.412,50,106,.472,77,202,.381,64,82,.780,40,125,165,41,18,8,46,59,395,8.2
851,Bennett Koch\bennett-koch-1,2017-18,Northern Iowa,F,31,23,749,134,241,.556,134,241,.556,0,0,,127,173,.734,59,130,189,16,21,26,61,72,395,9.8
852,Anthony Gill\anthony-gill-1,2014-15,Virginia,F,34,30,859,142,244,.582,142,243,.584,0,1,.000,111,164,.677,102,118,220,29,29,16,39,74,395,10.5
853,Steve Forbes\steve-forbes-2,2014-15,Purdue-Fort Wayne,F,28,27,678,141,249,.566,141,249,.566,0,0,,113,150,.753,59,111,170,29,9,22,51,71,395,10.8
854,Wesley Iwundu\wesley-iwundu-1,2015-16,Kansas State,F,33,32,1070,140,293,.478,134,263,.510,6,30,.200,108,155,.697,39,111,150,123,44,8,95,78,394,9.0
855,Dane Pineau\dane-pineau-1,2015-16,Saint Mary's (CA),F,35,35,938,174,261,.667,172,252,.683,2,9,.222,44,85,.518,96,186,282,50,27,51,41,98,394,11.6
856,Willis Hall\willis-hall-1,2013-14,College of Charleston,F,32,32,1065,147,313,.470,104,197,.528,43,116,.371,57,73,.781,90,203,293,28,17,11,67,77,394,9.3
857,Max Jacobsen\max-jacobsen-1,2013-14,Northern Arizona,F,32,30,875,169,286,.591,164,269,.610,5,17,.294,51,77,.662,58,75,133,47,15,16,68,80,394,8.5
858,Rico Gathers\rico-gathers-1,2014-15,Baylor,F,34,34,1015,134,292,.459,134,292,.459,0,0,,126,204,.618,164,230,394,16,41,35,35,91,394,11.8
859,Nikola Jovanovic\nikola-jovanovic-1,2014-15,Southern California,F,32,31,896,154,299,.515,152,286,.531,2,13,.154,84,130,.646,74,150,224,15,13,24,71,88,394,8.1
860,K.J. Lawson\kj-lawson-1,2016-17,Memphis,F,32,31,1078,145,363,.399,123,296,.416,22,67,.328,82,118,.695,73,186,259,88,16,13,66,72,394,8.8
861,Devin Williams\devin-williams-1,2014-15,West Virginia,F,34,34,847,127,285,.446,127,284,.447,0,1,.000,139,198,.702,94,182,276,45,26,9,75,100,393,8.5
862,Jason Burnell\jason-burnell-1,2017-18,Jacksonville State,F,35,18,888,144,282,.511,117,202,.579,27,80,.338,78,99,.788,64,146,210,64,29,35,51,95,393,9.8
863,Travis Wallace\travis-wallace-2,2013-14,North Florida,F,32,32,844,159,317,.502,159,317,.502,0,0,,75,124,.605,83,152,235,33,20,31,55,62,393,9.5
864,Stanton Kidd\stanton-kidd-1,2014-15,Colorado State,F,34,34,1023,148,319,.464,111,227,.489,37,92,.402,60,81,.741,76,96,172,62,28,28,50,82,393,9.1
865,Ioannis Dimakopoulos\ioannis-dimakopoulos-1,2016-17,UC-Irvine,F,36,36,746,157,305,.515,136,245,.555,21,60,.350,57,83,.687,35,113,148,41,9,31,54,82,392,7.3
866,Eli Scott\eli-scott-1,2017-18,Loyola Marymount,F,31,22,958,148,314,.471,146,299,.488,2,15,.133,94,155,.606,87,138,225,72,24,10,84,65,392,9.1
867,Myles Taylor\myles-taylor-1,2015-16,Tennessee-Martin,F,33,27,850,133,214,.621,130,206,.631,3,8,.375,123,156,.788,74,117,191,30,25,19,61,116,392,9.7
868,Marc Loving\marc-loving-1,2016-17,Ohio State,F,32,32,1086,123,295,.417,65,143,.455,58,152,.382,88,119,.739,33,117,150,60,18,17,89,69,392,7.4
869,Tony Parker\tony-parker-1,2014-15,UCLA,F,34,33,838,150,276,.543,150,276,.543,0,0,,92,160,.575,93,136,229,14,19,31,59,118,392,8.3
870,John Simons\john-simons-1,2014-15,Central Michigan,F,32,32,982,121,243,.498,30,43,.698,91,200,.455,59,70,.843,51,156,207,22,36,16,22,68,392,11.3
871,Alan Herndon\alan-herndon-1,2017-18,Wyoming,F,33,32,1054,145,283,.512,100,149,.671,45,134,.336,56,92,.609,30,157,187,66,27,72,44,78,391,10.7
872,Averyl Ugba\averyl-ugba-1,2016-17,Grambling,F,30,30,901,141,254,.555,141,253,.557,0,1,.000,109,161,.677,135,157,292,22,35,22,57,70,391,12.4
873,Dom Morris\dom-morris-1,2013-14,Boston University,F,35,34,982,151,287,.526,140,257,.545,11,30,.367,78,110,.709,66,148,214,25,16,11,51,73,391,8.3
874,Maurice Walker\maurice-walker-1,2014-15,Minnesota,F,33,31,799,152,264,.576,152,264,.576,0,0,,87,120,.725,73,147,220,22,48,44,67,88,391,10.3
875,Jeffery Moss\jeffrey-moss-1,2014-15,Murray State,F,35,35,1160,136,279,.487,81,149,.544,55,130,.423,64,75,.853,33,101,134,76,37,4,42,78,391,9.1
876,Shaq Goodwin\shaq-goodwin-1,2013-14,Memphis,F,34,33,981,149,255,.584,148,254,.583,1,1,1.000,92,156,.590,87,135,222,60,44,61,76,101,391,10.6
877,Cedric Kuakumensah\cedric-kuakumensah-1,2015-16,Brown,F,28,28,832,147,314,.468,115,240,.479,32,74,.432,65,92,.707,72,196,268,33,7,76,65,73,391,11.3
878,Brendan Lane\brendan-lane-1,2013-14,Pepperdine,F,30,30,878,164,300,.547,154,273,.564,10,27,.370,53,87,.609,62,157,219,40,12,73,55,92,391,10.8
879,Zach Collins\zach-collins-1,2016-17,Gonzaga,F,39,0,673,135,207,.652,125,186,.672,10,21,.476,110,148,.743,65,164,229,16,18,69,60,105,390,9.1
880,Demario Beck\demario-beck-1,2016-17,Coastal Carolina,F,39,34,1024,153,329,.465,121,207,.585,32,122,.262,52,98,.531,103,204,307,25,25,38,47,105,390,8.1
881,Cedric Blossom\cedric-blossom-1,2015-16,Morgan State,F,26,26,854,149,293,.509,146,277,.527,3,16,.188,89,136,.654,57,115,172,25,20,1,45,61,390,10.3
882,Connar Tava\connar-tava-1,2013-14,Western Michigan,F,33,33,978,138,236,.585,137,226,.606,1,10,.100,113,173,.653,59,128,187,96,39,17,108,88,390,9.4
883,Noah Dickerson\noah-dickerson-1,2016-17,Washington,F,31,27,843,146,267,.547,145,258,.562,1,9,.111,96,142,.676,83,170,253,24,15,14,45,98,389,10.0
884,Kadeem Jack\kadeem-jack-1,2014-15,Rutgers,F,30,29,930,154,361,.427,139,313,.444,15,48,.313,66,114,.579,74,118,192,33,28,21,79,68,389,7.5
885,Nigel Pruitt\nigel-pruitt-1,2014-15,Kennesaw State,F,32,30,902,128,309,.414,58,120,.483,70,189,.370,63,82,.768,35,94,129,40,31,9,53,82,389,7.8
886,Carl Baptiste\carl-baptiste-1,2013-14,Delaware,F,35,34,965,161,281,.573,161,281,.573,0,0,,67,95,.705,85,193,278,14,11,50,56,119,389,9.0
887,Will Saunders\will-saunders-1,2014-15,Charleston Southern,F,30,2,828,123,297,.414,28,64,.438,95,233,.408,48,67,.716,45,136,181,30,20,5,38,89,389,8.9
888,Sagaba Konate\sagaba-konate-1,2017-18,West Virginia,F,36,36,919,155,304,.510,155,304,.510,0,0,,79,100,.790,94,181,275,24,15,116,45,106,389,10.4
889,Eric Mika\eric-mika-2,2013-14,Brigham Young,F,33,28,842,139,264,.527,139,264,.527,0,0,,111,180,.617,93,118,211,32,15,24,49,107,389,8.9
890,Keita Bates-Diop\keita-bates-diop-1,2015-16,Ohio State,F,33,33,1040,141,311,.453,105,200,.525,36,111,.324,70,89,.787,47,163,210,36,24,41,45,61,388,9.4
891,Denton Koon\denton-koon-1,2015-16,Hofstra,F,34,34,1211,139,324,.429,85,172,.494,54,152,.355,56,83,.675,62,162,224,53,20,17,56,67,388,8.4
892,Tyshon Pickett\tyshon-pickett-1,2013-14,Bradley,F,32,31,1067,155,337,.460,145,299,.485,10,38,.263,68,88,.773,86,158,244,47,40,11,59,92,388,9.3
893,Andrew Chrabascz\andrew-chrabascz-1,2016-17,Butler,F,34,34,1112,129,284,.454,104,215,.484,25,69,.362,105,138,.761,52,103,155,107,24,9,57,83,388,9.1
894,Chima Moneke\chima-moneke-1,2017-18,UC-Davis,F,21,21,631,134,260,.515,125,236,.530,9,24,.375,110,154,.714,45,156,201,22,21,23,56,59,387,13.9
895,Gary Clark\gary-clark-2,2016-17,Cincinnati,F,36,35,1031,145,275,.527,131,226,.580,14,49,.286,83,119,.697,106,175,281,76,36,39,42,69,387,11.4
896,Tony Gill\tony-gill-1,2013-14,Pacific,F,34,28,882,145,281,.516,107,179,.598,38,102,.373,59,81,.728,65,134,199,38,25,9,56,98,387,8.5
897,Kedar Edwards\kedar-edwards-1,2016-17,Tennessee-Martin,F,32,27,989,148,331,.447,120,228,.526,28,103,.272,63,97,.649,75,125,200,137,52,20,111,70,387,9.8
898,Faronte Drakeford\faronte-drakeford-1,2014-15,Central Connecticut State,F,30,30,937,142,341,.416,140,327,.428,2,14,.143,101,130,.777,72,139,211,48,38,5,89,89,387,7.9
899,Mohamed Bamba\mohamed-bamba-1,2017-18,Texas,F,30,29,906,146,270,.541,132,219,.603,14,51,.275,81,119,.681,96,220,316,15,23,111,46,76,387,13.6
900,Christian Sengfelder\christian-sengfelder-1,2016-17,Fordham,F,32,32,1039,142,335,.424,70,120,.583,72,215,.335,31,44,.705,40,124,164,24,30,13,24,76,387,8.5
901,Flavien Davis\flavien-davis-1,2013-14,Montana State,F,31,24,796,130,274,.474,128,267,.479,2,7,.286,125,189,.661,52,61,113,18,22,7,56,73,387,7.4
902,Austin Arians\austin-arians-1,2013-14,Milwaukee,F,35,33,1142,136,292,.466,71,115,.617,65,177,.367,50,65,.769,29,92,121,49,28,4,48,69,387,7.7
903,Tyler Jones\tyler-jones-5,2017-18,Maryland-Eastern Shore,F,32,31,941,142,340,.418,120,248,.484,22,92,.239,81,113,.717,51,109,160,20,13,20,53,75,387,6.9
904,Kyle Kuzma\kyle-kuzma-1,2015-16,Utah,F,36,35,867,154,295,.522,141,244,.578,13,51,.255,66,108,.611,64,142,206,51,12,16,71,73,387,7.5
905,Alex Hicks\alex-hicks-1,2017-18,Troy,F,33,31,872,148,265,.558,131,218,.601,17,47,.362,74,100,.740,75,202,277,36,24,37,56,90,387,10.5
906,Max Mahoney\max-mahoney-1,2017-18,Boston University,F,30,20,630,163,271,.601,163,271,.601,0,0,,60,108,.556,44,101,145,36,19,28,54,81,386,9.4
907,Marcus Georges-Hunt\marcus-georges-hunt-1,2013-14,Georgia Tech,F,33,33,1028,133,320,.416,104,235,.443,29,85,.341,91,135,.674,55,87,142,68,27,5,53,84,386,7.7
908,Tim Coleman\tim-coleman-2,2016-17,NJIT,F,31,30,904,130,318,.409,104,230,.452,26,88,.295,100,136,.735,42,172,214,75,38,32,69,110,386,9.1
909,Tahjai Teague\tahjai-teague-1,2017-18,Ball State,F,32,23,816,149,281,.530,142,235,.604,7,46,.152,81,124,.653,58,183,241,39,38,28,47,82,386,10.4
910,Jose Rodriguez\jose-rodriguez-1,2013-14,Texas Southern,F,34,19,868,133,268,.496,114,220,.518,19,48,.396,101,158,.639,48,145,193,56,14,4,67,100,386,7.5
911,Kahlil Thomas\kahlil-thomas-1,2015-16,Rider,F,33,32,909,152,269,.565,151,265,.570,1,4,.250,81,138,.587,91,172,263,27,12,24,57,76,386,9.4
912,Jerami Grant\jerami-grant-1,2013-14,Syracuse,F,32,20,1005,133,268,.496,133,263,.506,0,5,.000,120,178,.674,78,139,217,44,26,18,37,75,386,10.2
913,Noah Horchler\noah-horchler-1,2017-18,North Florida,F,33,31,867,155,282,.550,132,216,.611,23,66,.348,52,86,.605,79,206,285,44,18,54,47,78,385,11.0
914,Durand Johnson\durand-johnson-1,2015-16,St. John's (NY),F,32,25,886,131,351,.373,75,180,.417,56,171,.327,67,91,.736,17,106,123,53,39,9,58,91,385,6.7
915,Justin Martin\justin-martin-1,2013-14,Xavier,F,33,30,930,126,279,.452,76,145,.524,50,134,.373,83,108,.769,36,134,170,32,27,9,62,91,385,7.7
916,Carson Williams\carson-williams-1,2017-18,Northern Kentucky,F,32,27,861,152,250,.608,145,231,.628,7,19,.368,74,114,.649,61,119,180,38,29,14,44,51,385,10.4
917,Donte Thomas\donte-thomas-1,2017-18,Bradley,F,33,32,857,150,276,.543,143,244,.586,7,32,.219,78,110,.709,80,159,239,32,35,34,52,90,385,10.2
918,Devin Thomas\devin-thomas-1,2014-15,Wake Forest,F,32,32,869,138,279,.495,138,279,.495,0,0,,109,184,.592,82,200,282,51,22,26,96,88,385,8.7
919,D.J. Johnson\dj-johnson-2,2016-17,Kansas State,F,34,33,883,147,236,.623,147,236,.623,0,0,,91,130,.700,74,119,193,15,24,52,53,111,385,9.5
920,AJ Brodeur\aj-brodeur-1,2016-17,Pennsylvania,F,28,28,865,163,310,.526,155,291,.533,8,19,.421,51,84,.607,50,144,194,54,27,66,67,75,385,11.2
921,Dan Trist\dan-trist-1,2013-14,Lafayette,F,30,14,669,156,286,.545,156,286,.545,0,0,,73,105,.695,67,96,163,35,9,5,69,79,385,8.2
922,Justin Alston\justin-alston-1,2016-17,Boston University,F,32,32,764,154,274,.562,154,273,.564,0,1,.000,77,103,.748,66,134,200,22,13,22,49,89,385,9.1
923,Pablo Rivas\pablo-rivas-1,2017-18,North Carolina Central,F,33,3,878,150,303,.495,108,182,.593,42,121,.347,43,57,.754,62,170,232,33,25,35,38,95,385,9.6
924,Quinton Stephens\quinton-stephens-1,2016-17,Georgia Tech,F,37,37,1232,130,347,.375,70,157,.446,60,190,.316,64,93,.688,50,233,283,80,44,27,72,80,384,8.1
925,Myke Henry\myke-henry-1,2014-15,DePaul,F,32,32,898,148,319,.464,117,236,.496,31,83,.373,57,83,.687,66,108,174,38,35,18,70,113,384,7.7
926,Karl Ziegler\karl-ziegler-1,2013-14,Longwood,F,32,29,1007,139,270,.515,138,266,.519,1,4,.250,105,136,.772,51,110,161,41,20,6,58,82,384,8.4
927,Drew Urquhart\drew-urguhart-1,2017-18,Vermont,F,35,23,838,143,235,.609,130,209,.622,13,26,.500,85,111,.766,47,138,185,58,8,37,38,87,384,9.8
928,Chris Davenport\chris-davenport-2,2014-15,North Florida,F,34,34,954,134,249,.538,120,211,.569,14,38,.368,101,136,.743,46,175,221,76,29,35,76,91,383,9.6
929,Esa Ahmad\esa-ahmad-1,2016-17,West Virginia,F,34,32,810,129,269,.480,114,231,.494,15,38,.395,110,162,.679,62,85,147,59,31,21,72,70,383,8.3
930,Jordan Murphy\jordan-murphy-1,2016-17,Minnesota,F,34,34,934,144,287,.502,140,255,.549,4,32,.125,91,148,.615,82,218,300,29,23,36,56,102,383,9.2
931,Jonathan Isaac\jonathan-isaac-1,2016-17,Florida State,F,32,32,839,130,256,.508,99,167,.593,31,89,.348,92,118,.780,56,195,251,37,37,49,48,70,383,11.4
932,Demondre Chapman\demondre-chapman-1,2013-14,Prairie View,F,33,19,828,142,274,.518,142,273,.520,0,1,.000,98,208,.471,81,104,185,7,15,21,49,84,382,7.4
933,Jarred Shaw\jarred-shaw-1,2013-14,Utah State,F,27,27,737,157,325,.483,157,320,.491,0,5,.000,68,87,.782,52,171,223,24,6,31,51,83,382,9.5
934,Amile Jefferson\amile-jefferson-1,2016-17,Duke,F,35,35,1039,146,238,.613,146,238,.613,0,0,,90,143,.629,84,209,293,53,24,65,49,93,382,11.3
935,Kerem Kanter\kerem-kanter-1,2017-18,Xavier,F,35,16,573,146,250,.584,129,199,.648,17,51,.333,73,94,.777,44,114,158,17,10,10,29,46,382,8.7
936,Marcus Thornton\marcus-thornton-2,2014-15,Georgia,F,31,31,905,135,281,.480,126,251,.502,9,30,.300,103,149,.691,53,173,226,32,23,35,46,94,382,9.6
937,Matt Ross\matt-ross-1,2013-14,Chicago State,F,32,29,1041,141,326,.433,98,191,.513,43,135,.319,57,71,.803,71,168,239,28,34,43,37,95,382,9.8
938,Jaren Jackson Jr.\jaren-jacksonjr-1,2017-18,Michigan State,F,35,34,764,119,232,.513,81,136,.596,38,96,.396,106,133,.797,52,151,203,39,21,106,62,112,382,10.1
939,Emani Gant\emani-gant-1,2014-15,Texas State,F,30,30,917,145,305,.475,144,304,.474,1,1,1.000,91,142,.641,75,132,207,49,37,17,77,89,382,9.0
940,Calvin Hermanson\calvin-hermanson-1,2015-16,Saint Mary's (CA),F,35,35,982,135,303,.446,61,117,.521,74,186,.398,38,53,.717,27,74,101,24,10,9,23,62,382,7.0
941,Gabe Taylor\gabe-taylor-1,2016-17,Portland,F,33,33,1113,138,313,.441,110,230,.478,28,83,.337,78,105,.743,39,142,181,25,13,18,49,57,382,7.5
942,Tim Williams\tim-williams-3,2016-17,New Mexico,F,22,22,736,149,265,.562,148,260,.569,1,5,.200,83,120,.692,42,110,152,33,12,14,39,45,382,13.3
943,Michael Gbinije\michael-gbinije-1,2014-15,Syracuse,F,30,24,1050,138,300,.460,89,175,.509,49,125,.392,56,98,.571,35,115,150,107,56,10,64,84,381,10.3
944,Khem Birch\khem-birch-1,2013-14,Nevada-Las Vegas,F,33,32,1037,125,245,.510,125,245,.510,0,0,,131,189,.693,131,206,337,40,21,124,44,76,381,13.7
945,Tim Coleman\tim-coleman-2,2014-15,NJIT,F,33,32,831,131,249,.526,96,165,.582,35,84,.417,84,130,.646,38,131,169,57,37,42,71,95,381,9.2
946,Anthony Lee\anthony-lee-1,2013-14,Temple,F,28,27,870,153,309,.495,152,306,.497,1,3,.333,74,113,.655,89,151,240,23,17,24,44,97,381,10.2
947,Kavin Gilder-Tilbury\kavin-gilder-tilbury-1,2015-16,Texas State,F,31,31,890,130,282,.461,86,165,.521,44,117,.376,77,107,.720,42,82,124,55,31,13,69,88,381,8.1
948,Johnathan Williams\johnathan-williams-2,2014-15,Missouri,F,32,32,941,128,311,.412,106,247,.429,22,64,.344,103,167,.617,78,150,228,27,10,19,82,86,381,6.7
949,Christian Mekowulu\christian-mekowulu-1,2017-18,Tennessee State,F,30,29,873,121,233,.519,119,228,.522,2,5,.400,137,184,.745,73,164,237,26,27,46,73,95,381,10.5
950,Devin Davis\devin-davis-1,2017-18,Houston,F,35,35,907,157,322,.488,156,315,.495,1,7,.143,66,97,.680,55,164,219,46,23,24,38,100,381,8.2
951,Brandon Sherrod\brandon-sherrod-1,2015-16,Yale,F,30,30,835,137,241,.568,137,240,.571,0,1,.000,107,183,.585,84,127,211,36,23,20,39,70,381,11.0
952,Chris Udofia\chris-udofia-1,2013-14,Denver,F,31,31,1066,137,276,.496,124,221,.561,13,55,.236,94,159,.591,57,109,166,122,46,70,55,105,381,12.0
953,Matisse Thybulle\matisse-thybulle-1,2017-18,Washington,F,34,33,1094,141,317,.445,83,158,.525,58,159,.365,40,56,.714,29,70,99,89,101,49,76,80,380,10.0
954,Joab Jerome\joab-jerome-1,2013-14,Winthrop,F,31,29,890,117,264,.443,79,178,.444,38,86,.442,108,142,.761,32,96,128,78,29,11,84,85,380,8.2
955,Bruce Beckford\bruce-beckford-1,2015-16,North Carolina A&T,F,29,25,878,125,296,.422,96,216,.444,29,80,.363,101,133,.759,47,152,199,29,20,11,79,95,380,7.6
956,Jamee Crockett\jamee-crockett-1,2014-15,DePaul,F,32,32,993,137,292,.469,95,169,.562,42,123,.341,64,91,.703,36,62,98,43,45,18,49,82,380,8.4
957,Tyler Rawson\tyler-rawson-1,2017-18,Utah,F,35,35,1093,126,281,.448,63,112,.563,63,169,.373,65,84,.774,40,198,238,128,24,32,68,71,380,10.1
958,Chris Silva\chris-silva-1,2016-17,South Carolina,F,37,37,775,123,234,.526,123,233,.528,0,1,.000,134,178,.753,85,140,225,13,22,51,69,141,380,7.9
959,Troy Snyder\troy-snyder-1,2013-14,Maryland-Eastern Shore,F,30,28,934,140,275,.509,122,228,.535,18,47,.383,82,118,.695,93,110,203,50,31,12,61,89,380,10.2
960,Felix Von Hofe\felix-van-hofe-1,2016-17,Eastern Washington,F,34,34,1137,121,313,.387,25,63,.397,96,250,.384,42,53,.792,8,98,106,32,21,14,28,71,380,7.0
961,Theo Pinson\theo-pinson-1,2017-18,North Carolina,F,37,37,1100,130,275,.473,118,222,.532,12,53,.226,108,132,.818,55,185,240,187,40,20,89,84,380,10.4
962,Damani Applewhite\damani-applewhite-1,2017-18,South Carolina State,F,30,27,878,147,273,.538,146,270,.541,1,3,.333,85,122,.697,57,145,202,20,16,6,36,48,380,9.8
963,Kevin Larsen\kevin-larsen-1,2014-15,George Washington,F,35,35,1162,144,294,.490,137,275,.498,7,19,.368,85,139,.612,111,148,259,83,17,36,66,55,380,9.8
964,Tyler Flack\tyler-flack-1,2016-17,South Dakota,F,25,25,673,147,281,.523,135,234,.577,12,47,.255,74,95,.779,60,110,170,21,19,41,35,68,380,12.4
965,Henry Caruso\henry-caruso-1,2017-18,Santa Clara,F,31,31,1116,121,252,.480,91,169,.538,30,83,.361,107,127,.843,75,142,217,54,38,6,44,53,379,11.4
966,Taylor Funk\taylor-funk-1,2017-18,Saint Joseph's,F,32,21,920,127,298,.426,43,85,.506,84,213,.394,41,49,.837,33,123,156,43,25,15,34,72,379,8.8
967,Jeff Roberson\jeff-roberson-1,2016-17,Vanderbilt,F,35,35,1108,122,293,.416,83,178,.466,39,115,.339,96,121,.793,70,176,246,61,29,13,64,91,379,8.4
968,Carson Williams\carson-williams-1,2016-17,Northern Kentucky,F,35,34,866,139,231,.602,139,229,.607,0,2,.000,101,144,.701,88,118,206,42,18,15,51,49,379,9.7
969,Caleb Martin\caleb-martin-1,2015-16,North Carolina State,F,33,19,1001,128,329,.389,49,110,.445,79,219,.361,44,66,.667,31,123,154,47,30,19,50,75,379,7.5
970,Duncan Robinson\duncan-robinson-1,2017-18,Michigan,F,41,19,1059,122,277,.440,44,74,.595,78,203,.384,57,64,.891,19,81,100,44,27,16,25,99,379,6.7
971,Sam Rowley\sam-rowley-1,2013-14,Albany (NY),F,34,33,993,150,292,.514,150,291,.515,0,1,.000,79,114,.693,77,157,234,61,38,20,99,113,379,8.0
972,Jeffrey Solarin\jeffrey-solarin-1,2014-15,Idaho State,F,30,29,957,167,300,.557,167,300,.557,0,0,,44,84,.524,110,158,268,28,19,27,57,63,378,10.6
973,Willie Rodriguez\willie-rodriguez-1,2014-15,Binghamton,F,32,30,1011,137,313,.438,123,249,.494,14,64,.219,90,131,.687,44,131,175,41,26,23,87,80,378,6.9
974,Christian Sengfelder\christian-sengfelder-1,2017-18,Boise State,F,32,32,911,138,292,.473,81,144,.563,57,148,.385,45,61,.738,69,142,211,20,19,9,42,61,378,8.9
975,Bennie Boatwright\bennie-boatwright-1,2015-16,Southern California,F,33,32,805,121,307,.394,61,140,.436,60,167,.359,76,103,.738,50,121,171,34,13,26,45,105,378,7.3
976,Justin Jackson\justin-jackson-3,2013-14,Cincinnati,F,34,33,944,160,301,.532,160,301,.532,0,0,,58,126,.460,110,137,247,59,55,98,67,104,378,11.1
977,John Davis\john-davis-4,2014-15,Towson,F,32,4,820,144,308,.468,143,306,.467,1,2,.500,89,136,.654,96,163,259,9,7,16,54,79,378,8.0
978,Camyn Boone\camyn-boone-1,2015-16,Missouri State,F,31,28,775,143,284,.504,143,284,.504,0,0,,92,133,.692,59,144,203,37,9,15,43,66,378,9.0
979,Jehyve Floyd\jehyve-floyd-1,2017-18,Holy Cross,F,31,31,924,165,247,.668,165,247,.668,0,0,,47,97,.485,33,140,173,50,29,67,72,104,377,10.1
980,Austin Arians\austin-arians-1,2015-16,Milwaukee,F,33,33,1029,127,321,.396,48,97,.495,79,224,.353,44,52,.846,26,101,127,42,25,6,21,64,377,7.9
981,Pat Andree\pat-andree-1,2017-18,Lehigh,F,30,29,840,126,275,.458,47,91,.516,79,184,.429,46,54,.852,27,148,175,22,16,12,29,69,377,9.3
982,Johnathan Motley\johnathan-motley-1,2015-16,Baylor,F,34,9,711,153,249,.614,153,247,.619,0,2,.000,71,117,.607,78,96,174,30,18,39,50,102,377,9.0
983,Nick Jacobs\nick-jacobs-1,2015-16,Georgia Tech,F,36,28,818,159,334,.476,159,334,.476,0,0,,59,76,.776,66,142,208,9,13,25,51,64,377,6.9
984,Lavelle Scottie\lavelle-scottie-1,2017-18,Air Force,F,31,28,826,145,317,.457,108,212,.509,37,105,.352,50,69,.725,46,90,136,43,22,14,68,72,377,7.4
985,Dante Sterling\dante-sterling-1,2017-18,Alcorn State,F,32,30,867,116,299,.388,58,138,.420,58,161,.360,87,107,.813,21,84,105,48,31,4,67,46,377,7.1
986,Abdul-Malik Abu\abdul-malik-abu-1,2016-17,North Carolina State,F,32,31,911,153,289,.529,153,285,.537,0,4,.000,71,99,.717,71,153,224,34,13,28,64,100,377,8.5
987,Lester Wilson\lester-wilson-1,2014-15,East Tennessee State,F,30,30,846,132,308,.429,60,103,.583,72,205,.351,41,56,.732,31,82,113,14,24,9,38,72,377,7.6
988,Kevin Larsen\kevin-larsen-1,2013-14,George Washington,F,33,33,1030,151,275,.549,151,273,.553,0,2,.000,75,120,.625,79,149,228,55,18,23,46,65,377,9.9
989,Chris Patton\chris-patton--1,2013-14,UC-Riverside,F,29,21,765,151,292,.517,151,292,.517,0,0,,75,108,.694,63,104,167,35,17,19,66,75,377,8.8
990,Shaquille Hines\shaquille-hines-1,2014-15,Texas-Rio Grande Valley,F,31,31,1040,163,320,.509,163,309,.528,0,11,.000,51,84,.607,65,101,166,44,22,14,63,82,377,8.0
991,Yohanny Dalembert\yohanny-dalembert-1,2014-15,James Madison,F,33,33,831,137,237,.578,136,236,.576,1,1,1.000,101,150,.673,71,126,197,35,15,37,70,94,376,8.8
992,Zach Smith\zach-smith-1,2016-17,Texas Tech,F,31,30,975,144,283,.509,127,240,.529,17,43,.395,71,108,.657,80,143,223,42,14,42,60,71,376,9.8
993,Hassan Martin\hassan-martin-1,2014-15,Rhode Island,F,33,33,949,146,244,.598,146,239,.611,0,5,.000,84,138,.609,74,180,254,11,24,103,44,86,376,11.3
994,Kevin Puryear\kevin-puryear-1,2016-17,Missouri,F,32,32,946,132,323,.409,112,261,.429,20,62,.323,92,125,.736,58,133,191,30,12,10,56,77,376,7.0
995,Mo Alie-Cox\mo-alie-cox-1,2015-16,Virginia Commonwealth,F,36,36,960,137,224,.612,137,224,.612,0,0,,102,137,.745,88,97,185,37,25,68,52,79,376,10.2
996,Jackson Rowe\jackson-rowe-1,2017-18,Cal State Fullerton,F,31,31,929,136,234,.581,112,176,.636,24,58,.414,80,103,.777,42,166,208,50,29,31,64,70,376,10.7
997,Ryan Spangler\ryan-spangler-1,2015-16,Oklahoma,F,37,37,1217,146,267,.547,114,179,.637,32,88,.364,52,87,.598,93,241,334,72,16,20,62,82,376,9.6
998,Josh Scott\josh-scott-2,2014-15,Colorado,F,26,25,802,130,239,.544,129,235,.549,1,4,.250,115,153,.752,89,130,219,29,18,46,24,45,376,14.4
999,Malcolm Miller\malcolm-miller-1,2013-14,Holy Cross,F,34,34,1038,128,275,.465,89,182,.489,39,93,.419,80,105,.762,33,162,195,73,29,63,58,98,375,9.5
1000,Jalen Henry\jalen-henry-1,2016-17,Southern Illinois-Edwardsville,F,30,30,782,128,276,.464,112,228,.491,16,48,.333,103,152,.678,51,116,167,13,11,24,61,99,375,7.3
1001,TrayVonn Wright\trayvonn-wright-1,2013-14,North Dakota State,F,33,32,970,147,302,.487,108,184,.587,39,118,.331,42,61,.689,45,126,171,20,30,56,29,76,375,9.3
1002,Bo Calhoun\bo-calhoun-1,2015-16,Ball State,F,35,31,929,143,311,.460,107,209,.512,36,102,.353,53,68,.779,82,214,296,40,30,19,62,84,375,8.7
1003,Jake Layman\jake-layman-1,2013-14,Maryland,F,32,28,1016,125,312,.401,64,145,.441,61,167,.365,64,89,.719,41,118,159,30,34,27,37,66,375,8.5
1004,Matthew Hezekiah\matthew-hezekiah-1,2013-14,South Carolina State,F,30,20,884,151,277,.545,151,275,.549,0,2,.000,73,102,.716,69,117,186,18,22,23,50,46,375,9.9
1005,Tyler Lydon\tyler-lydon-1,2015-16,Syracuse,F,37,0,1122,127,265,.479,78,144,.542,49,121,.405,72,93,.774,66,167,233,41,42,67,47,100,375,9.7
1006,Michael Kessens\michael-kessens-1,2016-17,Florida International,F,29,29,876,152,269,.565,148,252,.587,4,17,.235,67,97,.691,72,188,260,33,26,16,70,90,375,10.2
1007,MiKyle McIntosh\mikyle-mcintosh-1,2016-17,Illinois State,F,30,29,802,120,293,.410,88,201,.438,32,92,.348,103,135,.763,47,120,167,53,20,25,74,91,375,7.9
1008,Jemerrio Jones\jemerrio-jones-1,2017-18,New Mexico State,F,34,33,964,167,332,.503,163,289,.564,4,43,.093,37,71,.521,127,323,450,106,36,19,81,76,375,11.6
1009,Jamil Wilson\jamil-wilson-1,2013-14,Marquette,F,32,32,926,136,318,.428,104,220,.473,32,98,.327,71,106,.670,45,144,189,82,19,16,60,94,375,8.0
1010,Chase Foster\chase-foster-1,2017-18,San Francisco,F,36,28,944,127,311,.408,69,152,.454,58,159,.365,62,83,.747,41,109,150,61,22,8,60,65,374,6.8
1011,Matt Costello\matt-costello-1,2015-16,Michigan State,F,35,35,802,148,264,.561,146,256,.570,2,8,.250,76,101,.752,102,186,288,46,23,42,38,75,374,10.9
1012,T.J. Holyfield\tj-holyfield-1,2016-17,Stephen F. Austin,F,32,32,881,138,263,.525,118,203,.581,20,60,.333,78,101,.772,73,156,229,35,31,39,78,117,374,9.1
1013,Daveon Boardingham\daveon-boardingham-1,2013-14,Southern Mississippi,F,36,27,805,129,223,.578,129,223,.578,0,0,,115,172,.669,81,90,171,24,19,35,59,110,373,8.0
1014,Drew Windler\drew-windler-1,2013-14,Belmont,F,36,36,837,126,256,.492,45,80,.563,81,176,.460,40,55,.727,35,113,148,43,28,33,47,107,373,8.0
1015,Taylor Johns\taylor-johns-1,2013-14,UC-Riverside,F,31,29,988,142,266,.534,141,262,.538,1,4,.250,88,147,.599,87,156,243,41,26,72,86,93,373,10.0
1016,Aaron Brown\aaron-brown-2,2015-16,Saint Joseph's,F,36,36,951,136,305,.446,102,206,.495,34,99,.343,67,94,.713,26,89,115,47,13,1,44,67,373,6.2
1017,Ako Kaluna\ako-kaluna-1,2015-16,Northern Arizona,F,30,29,945,138,337,.409,108,239,.452,30,98,.306,67,104,.644,51,165,216,35,22,17,50,80,373,8.0
1018,Elijah Thomas\elijah-thomas-1,2017-18,Clemson,F,35,32,873,145,259,.560,145,259,.560,0,0,,83,134,.619,80,203,283,37,22,79,72,111,373,9.5
1019,David Kravish\david-kravish-1,2014-15,University of California,F,33,33,973,162,339,.478,158,325,.486,4,14,.286,45,62,.726,58,172,230,38,13,49,50,104,373,8.1
1020,Norville Carey\norville-carey-1,2016-17,Rider,F,33,31,785,151,311,.486,150,305,.492,1,6,.167,70,111,.631,79,149,228,18,37,25,71,88,373,7.9
1021,Trip Day\trip-day-1,2017-18,North Florida,F,33,8,656,151,258,.585,129,205,.629,22,53,.415,49,66,.742,60,77,137,30,20,17,47,84,373,8.6
1022,Isaiah Pineiro\isaiah-pineiro-1,2015-16,Portland State,F,31,20,706,137,270,.507,128,242,.529,9,28,.321,90,118,.763,44,127,171,34,34,17,46,102,373,9.0
1023,Duop Reath\duop-reath-1,2016-17,Louisiana State,F,31,30,859,157,308,.510,146,273,.535,11,35,.314,47,78,.603,63,128,191,25,16,46,66,105,372,8.0
1024,Mike Best\mike-best-1,2015-16,UC-Irvine,F,38,37,852,152,314,.484,152,312,.487,0,2,.000,68,90,.756,54,141,195,25,7,26,60,88,372,6.1
1025,Bashir Ahmed\bashir-ahmed-1,2017-18,St. John's (NY),F,33,33,996,130,319,.408,86,191,.450,44,128,.344,68,111,.613,53,102,155,31,35,11,49,94,372,6.9
1026,Justin Gordon\justin-gordon-1,2015-16,Wofford,F,32,31,812,141,290,.486,135,273,.495,6,17,.353,84,142,.592,49,84,133,63,18,17,82,95,372,6.7
1027,Aaron Brennan\aaron-brennan-1,2017-18,IUPUI,F,30,30,818,140,302,.464,111,218,.509,29,84,.345,63,79,.797,38,97,135,48,31,19,53,78,372,8.7
1028,Kinard Gadsden-Gilliard\kinard-gadsden-gilliard-1,2013-14,East Tennessee State,F,34,30,1079,126,301,.419,99,223,.444,27,78,.346,93,127,.732,31,145,176,99,37,16,82,117,372,7.4
1029,Karam Mashour\karam-mashour-1,2014-15,Morehead State,F,34,27,748,139,282,.493,119,211,.564,20,71,.282,73,104,.702,53,149,202,32,33,13,45,75,371,8.5
1030,Travon Harper\travon-harper-1,2017-18,Arkansas-Pine Bluff,F,35,35,818,140,251,.558,129,220,.586,11,31,.355,80,113,.708,59,108,167,25,20,30,55,118,371,7.7
1031,Cameron Jackson\cameron-jackson-1,2017-18,Wofford,F,31,29,718,158,263,.601,158,260,.608,0,3,.000,55,90,.611,57,127,184,48,55,45,53,100,371,11.0
1032,Sam Hughes\sam-hughes-1,2015-16,North Carolina-Asheville,F,34,30,899,140,278,.504,133,260,.512,7,18,.389,84,117,.718,58,94,152,40,44,44,61,91,371,8.6
1033,Fatodd Lewis\fatodd-lewis-1,2017-18,Tennessee-Martin,F,30,19,875,143,317,.451,121,234,.517,22,83,.265,63,88,.716,63,157,220,40,31,17,61,74,371,8.9
1034,Terry Harris Jr\terry-harrisjr-1,2015-16,Coppin State,F,30,28,912,123,339,.363,105,257,.409,18,82,.220,107,147,.728,67,150,217,29,19,25,53,73,371,7.8
1035,Daniel Ochefu\daniel-ochefu-1,2015-16,Villanova,F,37,34,865,153,244,.627,153,243,.630,0,1,.000,65,95,.684,76,202,278,63,29,57,50,91,371,10.5
1036,Karl Charles\karl-charles-1,2015-16,Holy Cross,F,35,35,993,110,260,.423,81,158,.513,29,102,.284,122,154,.792,42,104,146,86,37,20,74,74,371,8.2
1037,Matt Rafferty\matt-rafferty-1,2017-18,Furman,F,33,33,868,147,246,.598,134,207,.647,13,39,.333,64,89,.719,74,162,236,91,54,21,33,82,371,12.6
1038,Frank Rogers\frank-rogers-1,2015-16,San Jose State,F,31,31,892,134,292,.459,97,184,.527,37,108,.343,65,95,.684,65,155,220,47,23,22,57,94,370,8.9
1039,Nick Duncan\nick-duncan-1,2015-16,Boise State,F,32,27,1013,118,269,.439,56,92,.609,62,177,.350,72,95,.758,36,99,135,58,30,17,57,103,370,8.1
1040,Kayel Locke\kayel-locke-1,2013-14,North Carolina-Greensboro,F,32,31,870,132,285,.463,127,263,.483,5,22,.227,101,136,.743,72,69,141,31,15,4,62,97,370,6.8
1041,Zane Waterman\zane-waterman-1,2017-18,Manhattan,F,31,25,881,129,274,.471,94,177,.531,35,97,.361,77,121,.636,63,141,204,34,19,12,69,79,370,8.0
1042,J.J. O'Brien\jj-obrien-1,2014-15,San Diego State,F,36,36,1183,149,320,.466,138,285,.484,11,35,.314,60,93,.645,79,108,187,88,51,7,54,47,369,9.0
1043,Domantas Sabonis\domantas-sabonis-1,2014-15,Gonzaga,F,38,1,822,145,217,.668,145,217,.668,0,0,,79,119,.664,82,186,268,33,17,12,59,104,369,8.4
1044,Roland Griffin\roland-griffin-1,2017-18,Iona,F,33,10,788,144,271,.531,142,262,.542,2,9,.222,79,118,.669,40,131,171,46,15,23,51,94,369,8.0
1045,Cedrick Williams\cedrick-williams-1,2013-14,North Carolina-Wilmington,F,32,30,971,137,277,.495,131,255,.514,6,22,.273,89,118,.754,94,117,211,26,28,46,47,84,369,9.9
1046,J.J. Moore\jj-moore-1,2013-14,Rutgers,F,33,30,877,120,285,.421,78,145,.538,42,140,.300,87,113,.770,32,65,97,29,32,12,34,63,369,7.6
1047,Zena Edosomwan\zena-edosomwan-1,2015-16,Harvard,F,28,26,729,147,290,.507,147,290,.507,0,0,,75,153,.490,73,202,275,54,13,35,59,82,369,10.3
1048,Brian White\brian-white-1,2013-14,Citadel,F,33,30,901,147,271,.542,145,259,.560,2,12,.167,72,94,.766,51,130,181,10,7,28,36,67,368,8.3
1049,Roger Woods\roger-woods-2,2014-15,Little Rock,F,31,26,818,131,275,.476,118,246,.480,13,29,.448,93,145,.641,71,132,203,33,22,17,55,75,368,8.7
1050,Zach Braxton\zach-braxton-1,2017-18,Weber State,F,30,30,840,133,240,.554,133,239,.556,0,1,.000,102,154,.662,52,181,233,40,10,31,39,82,368,10.4
1051,Dorian Finney-Smith\dorian-finney-smith-1,2014-15,Florida,F,28,23,782,137,290,.472,88,175,.503,49,115,.426,44,75,.587,73,101,174,44,32,24,54,74,367,10.1
1052,Luke Knapke\luke-knapke-1,2017-18,Toledo,F,34,2,808,135,243,.556,113,185,.611,22,58,.379,75,100,.750,61,152,213,40,10,60,63,106,367,8.9
1053,Robert Williams\robert-williams-3,2016-17,Texas A&M,F,31,17,801,153,275,.556,151,257,.588,2,18,.111,59,100,.590,94,158,252,44,21,76,54,57,367,11.6
1054,Maurice Rivers\maurice-rivers-1,2017-18,Jackson State,F,28,11,697,133,333,.399,119,286,.416,14,47,.298,87,125,.696,54,100,154,30,20,24,51,90,367,7.5
1055,Ryan Weber\ryan-weber-1,2013-14,Youngstown State,F,30,28,991,122,281,.434,54,118,.458,68,163,.417,55,64,.859,33,95,128,45,27,14,54,58,367,8.6
1056,Devin Thomas\devin-thomas-1,2013-14,Wake Forest,F,33,32,928,138,256,.539,138,255,.541,0,1,.000,91,172,.529,64,185,249,50,19,29,82,106,367,7.9
1057,Jalen Reynolds\jalen-reynolds-1,2014-15,Xavier,F,37,3,751,152,246,.618,152,245,.620,0,1,.000,63,95,.663,69,155,224,13,21,36,44,115,367,8.2
1058,Justin Tuoyo\justin-tuoyo-1,2015-16,Chattanooga,F,33,32,830,130,246,.528,128,235,.545,2,11,.182,105,152,.691,69,96,165,32,23,77,41,90,367,9.9
1059,Halil Kanacevic\halil-kanacevic-1,2013-14,Saint Joseph's,F,34,34,1091,138,258,.535,120,208,.577,18,50,.360,72,124,.581,67,231,298,149,23,52,97,126,366,10.4
1060,DeShawn Freeman\deshawn-freeman-1,2017-18,Rutgers,F,33,28,839,134,333,.402,129,301,.429,5,32,.156,93,130,.715,81,160,241,29,51,24,63,76,366,8.2
1061,Chris Boucher\chris-boucher-1,2016-17,Oregon,F,31,12,731,141,269,.524,105,166,.633,36,103,.350,48,85,.565,54,134,188,13,12,79,32,83,366,10.0
1062,Mike Thomas\mike-thomas-2,2017-18,Hawaii,F,28,26,651,126,224,.563,120,199,.603,6,25,.240,108,154,.701,57,112,169,33,5,8,44,87,366,9.6
1063,Isaac Copeland\isaac-copeland-1,2015-16,Georgetown,F,33,33,1048,130,303,.429,96,178,.539,34,125,.272,71,92,.772,47,131,178,66,25,20,54,68,365,8.3
1064,C.J. Washington\cj-washington-2,2013-14,Alabama-Birmingham,F,28,27,762,144,299,.482,116,215,.540,28,84,.333,49,89,.551,82,111,193,16,25,21,35,77,365,9.8
1065,Justin Miller\justin-miller-2,2016-17,Louisiana,F,33,31,790,128,265,.483,103,196,.526,25,69,.362,84,121,.694,60,110,170,45,13,7,65,97,365,7.2
1066,DeShawn Freeman\deshawn-freeman-1,2016-17,Rutgers,F,33,31,890,137,284,.482,131,268,.489,6,16,.375,85,137,.620,94,163,257,29,32,30,64,87,365,8.8
1067,Cameron Lard\cameron-lard-1,2017-18,Iowa State,F,29,16,767,161,268,.601,161,268,.601,0,0,,43,73,.589,98,136,234,17,15,63,54,81,365,11.2
1068,Darious Moten\darious-moten-1,2014-15,Mercer,F,32,31,894,128,263,.487,109,225,.484,19,38,.500,90,122,.738,61,80,141,41,24,29,44,61,365,9.1
1069,Daniel Coursey\daniel-coursey-1,2013-14,Mercer,F,36,35,856,156,273,.571,156,273,.571,0,0,,53,74,.716,80,152,232,16,12,74,30,112,365,9.2
1070,Marcus Lee\marcus-lee-2,2017-18,University of California,F,32,31,888,151,268,.563,151,268,.563,0,0,,63,103,.612,98,132,230,42,21,52,85,115,365,8.9
1071,Ed Polite Jr.\ed-politejr-1,2016-17,Radford,F,31,30,989,128,258,.496,123,235,.523,5,23,.217,104,155,.671,86,208,294,59,56,30,67,73,365,11.6
1072,Ethan Wragge\ethan-wragge-1,2013-14,Creighton,F,35,28,946,112,242,.463,2,8,.250,110,234,.470,31,38,.816,18,120,138,27,15,4,20,92,365,7.6
1073,Dewan Hernandez\dewan-huell-1,2017-18,Miami (FL),F,32,32,825,147,255,.576,147,252,.583,0,3,.000,71,103,.689,65,148,213,14,16,31,44,60,365,9.4
1074,Kendall Pollard\kendall-pollard-1,2016-17,Dayton,F,26,24,674,125,238,.525,119,215,.553,6,23,.261,109,170,.641,27,103,130,38,39,18,47,74,365,10.6
1075,Chris Bond\chris-bond-1,2013-14,Ball State,F,30,30,942,126,287,.439,105,208,.505,21,79,.266,92,135,.681,63,115,178,57,30,14,73,61,365,8.6
1076,Lee Skinner\lee-skinner-1,2013-14,Wofford,F,33,33,1048,135,282,.479,132,267,.494,3,15,.200,92,137,.672,96,184,280,67,29,6,66,65,365,9.5
1077,Prokop Slanina\prokop-slanina-1,2017-18,Fordham,F,29,28,922,145,291,.498,110,196,.561,35,95,.368,39,51,.765,45,102,147,42,36,37,44,103,364,9.7
1078,Thomas Gipson\thomas-gipson-1,2013-14,Kansas State,F,31,28,821,140,249,.562,140,249,.562,0,0,,84,120,.700,70,132,202,18,11,15,67,82,364,8.2
1079,Devonta Pollard\devonta-pollard-1,2014-15,Houston,F,32,26,976,132,289,.457,132,288,.458,0,1,.000,100,138,.725,84,121,205,39,39,14,75,87,364,8.1
1080,James Farr\james-farr-1,2015-16,Xavier,F,34,4,700,144,264,.545,143,256,.559,1,8,.125,75,103,.728,97,169,266,19,26,34,46,82,364,9.7
1081,Charles Mitchell\charles-mitchell-1,2015-16,Georgia Tech,F,36,33,901,154,297,.519,154,297,.519,0,0,,56,95,.589,138,211,349,21,22,14,62,97,364,8.5
1082,Quincy Ford\quincy-ford-1,2014-15,Northeastern,F,35,35,1101,113,282,.401,58,135,.430,55,147,.374,83,110,.755,41,147,188,79,34,37,73,63,364,8.3
1083,Jalen Billups\jalen-billups-1,2015-16,Northern Kentucky,F,30,29,592,142,243,.584,142,243,.584,0,0,,80,121,.661,53,111,164,21,7,40,54,81,364,8.9
1084,Joseph Lopez\joseph-lopez-1,2017-18,Sacred Heart,F,30,30,802,157,326,.482,156,307,.508,1,19,.053,49,109,.450,104,171,275,27,19,13,64,78,364,8.4
1085,Earvin Morris\earvin-morris-1,2014-15,Texas-El Paso,F,33,13,767,120,268,.448,65,131,.496,55,137,.401,68,97,.701,7,69,76,38,28,10,56,77,363,6.4
1086,Maxie Esho\maxie-esho-1,2014-15,Massachusetts,F,32,32,863,133,266,.500,129,254,.508,4,12,.333,93,137,.679,62,142,204,30,23,28,66,96,363,8.1
1087,Will Triggs\will-triggs-1,2013-14,Austin Peay,F,30,29,874,124,217,.571,124,216,.574,0,1,.000,115,172,.669,47,109,156,39,17,13,56,63,363,9.2
1088,Nemanja Djurisic\nemanja-djurisic-1,2014-15,Georgia,F,33,32,991,130,278,.468,96,178,.539,34,100,.340,69,98,.704,62,111,173,48,23,16,61,74,363,8.0
1089,Tyrell Green\tyrell-green-1,2016-17,Nevada-Las Vegas,F,31,20,796,123,306,.402,76,168,.452,47,138,.341,70,88,.795,44,125,169,34,20,4,38,60,363,7.9
1090,Mitchell Hahn\mitchell-hahn-1,2016-17,Omaha,F,31,3,820,107,241,.444,47,98,.480,60,143,.420,88,105,.838,37,95,132,23,27,22,31,54,362,9.3
1091,Chris Hooper\chris-hooper-1,2015-16,St. Francis (NY),F,32,11,682,141,244,.578,141,242,.583,0,2,.000,80,140,.571,61,101,162,48,33,42,76,97,362,8.7
1092,Moses Greenwood\moses-greenwood-1,2016-17,Southeastern Louisiana,F,32,22,841,148,266,.556,148,265,.558,0,1,.000,66,101,.653,77,113,190,15,35,20,57,93,362,8.6
1093,Tim Rusthoven\tim-rusthoven-1,2013-14,William & Mary,F,30,30,755,138,234,.590,138,234,.590,0,0,,86,130,.662,53,91,144,55,10,24,52,90,362,9.3
1094,Christian Sengfelder\christian-sengfelder-1,2014-15,Fordham,F,31,31,1049,136,275,.495,99,161,.615,37,114,.325,53,80,.663,64,155,219,21,16,13,50,95,362,8.3
1095,Donta Hall\donta-hall-1,2017-18,Alabama,F,34,31,806,151,208,.726,151,208,.726,0,0,,60,108,.556,76,148,224,20,24,68,43,59,362,11.0
1096,Malcolm Smith\malcolm-smith-1,2014-15,Lipscomb,F,25,22,641,107,232,.461,99,208,.476,8,24,.333,140,191,.733,50,77,127,39,20,3,60,65,362,9.7
1097,Jordan Murphy\jordan-murphy-1,2015-16,Minnesota,F,31,20,822,135,293,.461,126,252,.500,9,41,.220,82,134,.612,86,161,247,22,32,32,55,103,361,8.7
1098,Trey Moses\trey-moses-1,2017-18,Ball State,F,32,22,836,134,235,.570,134,234,.573,0,1,.000,93,155,.600,81,180,261,66,15,27,71,76,361,9.8
1099,Jarrell Brantley\jarrell-brantley-1,2015-16,College of Charleston,F,31,31,880,133,289,.460,120,250,.480,13,39,.333,82,115,.713,64,163,227,40,40,14,79,99,361,8.1
1100,Delante Jones\delante-jones-1,2015-16,American,F,30,25,997,116,272,.426,77,166,.464,39,106,.368,90,129,.698,26,81,107,53,22,6,79,82,361,6.5
1101,Stone Gettings\stone-gettings-1,2016-17,Cornell,F,29,29,742,134,286,.469,95,177,.537,39,109,.358,54,79,.684,41,128,169,84,21,25,83,85,361,8.7
1102,Arnold Fripp\arnold-fripp-1,2014-15,Coppin State,F,31,31,834,134,321,.417,82,179,.458,52,142,.366,41,55,.745,46,127,173,20,15,29,41,84,361,7.4
1103,Chris Reyes\chris-reyes-1,2016-17,Pepperdine,F,27,27,891,145,270,.537,142,262,.542,3,8,.375,68,118,.576,61,151,212,64,9,38,42,69,361,11.4
1104,Isiaha Mike\isiaha-mike-1,2016-17,Duquesne,F,32,32,908,131,302,.434,85,164,.518,46,138,.333,52,78,.667,42,142,184,51,26,27,76,85,360,7.3
1105,Matthew Wilson\matthew-wilson-2,2017-18,Army,F,30,28,739,157,263,.597,157,263,.597,0,0,,46,90,.511,54,116,170,15,8,7,50,72,360,7.9
1106,Dexter Werner\dexter-werner-1,2016-17,North Dakota State,F,30,11,739,131,215,.609,131,214,.612,0,1,.000,98,133,.737,79,140,219,39,44,31,31,73,360,12.6
1107,Jaron Nash\jaron-nash-1,2014-15,North Dakota,F,29,28,787,139,287,.484,128,241,.531,11,46,.239,71,123,.577,45,138,183,21,26,16,41,65,360,8.7
1108,Goanar Mar\goanar-mar-1,2017-18,George Mason,F,33,33,1053,109,253,.431,69,141,.489,40,112,.357,102,128,.797,62,82,144,27,22,4,59,93,360,7.0
1109,Jeronne Maymon\jeronne-maymon-1,2013-14,Tennessee,F,37,36,1047,128,240,.533,128,239,.536,0,1,.000,104,152,.684,123,177,300,39,25,15,64,100,360,8.7
1110,Thomas Gipson\thomas-gipson-1,2014-15,Kansas State,F,32,31,920,118,215,.549,118,215,.549,0,0,,124,163,.761,57,111,168,14,15,18,52,89,360,8.3
1111,Trent Wiedeman\trent-weideman-1,2014-15,Georgia Southern,F,31,31,899,145,296,.490,140,275,.509,5,21,.238,65,93,.699,67,107,174,32,22,31,53,60,360,8.6
1112,Mario Matasovic\mario-matasovic-1,2017-18,Sacred Heart,F,31,31,853,142,256,.555,120,190,.632,22,66,.333,53,72,.736,67,128,195,41,18,15,72,88,359,8.5
1113,James Webb\james-webb-1,2014-15,Boise State,F,32,27,886,137,248,.552,90,133,.677,47,115,.409,38,58,.655,63,194,257,19,36,20,31,81,359,10.5
1114,Joe Reed\joe-reed-1,2015-16,Purdue-Fort Wayne,F,34,34,994,128,239,.536,110,184,.598,18,55,.327,85,131,.649,57,107,164,40,19,19,44,87,359,8.2
1115,Derrick Griffin\derek-griffin-1,2015-16,Texas Southern,F,27,26,918,143,216,.662,143,213,.671,0,3,.000,73,139,.525,131,167,298,16,19,60,29,73,359,14.6
1116,Sean Sellers\sean-sellers-1,2014-15,Ball State,F,30,29,889,110,249,.442,44,98,.449,66,151,.437,73,90,.811,22,65,87,37,9,10,47,54,359,7.7
1117,D.J. Mason\dj-mason-1,2014-15,Campbell,F,32,24,845,144,286,.503,131,249,.526,13,37,.351,58,104,.558,64,102,166,64,22,30,44,75,359,9.0
1118,Rico Gathers\rico-gathers-1,2015-16,Baylor,F,32,25,817,133,260,.512,132,259,.510,1,1,1.000,92,146,.630,128,159,287,16,30,26,38,78,359,10.5
1119,J.D. Weatherspoon\jd-weatherspoon-1,2013-14,Toledo,F,34,33,992,123,229,.537,113,195,.579,10,34,.294,103,176,.585,55,167,222,34,28,25,34,61,359,9.4
1120,Emmanuel Omogbo\emmanuel-omogbo-1,2015-16,Colorado State,F,33,29,808,130,284,.458,119,234,.509,11,50,.220,88,131,.672,102,162,264,33,14,8,41,76,359,8.7
1121,Conner Avants\conner-avants-1,2017-18,North Dakota,F,31,31,888,149,262,.569,149,261,.571,0,1,.000,61,102,.598,60,126,186,29,25,12,54,85,359,8.5
1122,Malik Moore\malik-moore-2,2016-17,South Carolina Upstate,F,33,22,841,122,263,.464,78,139,.561,44,124,.355,71,108,.657,34,136,170,51,27,14,49,71,359,8.1
1123,Reggie Upshaw\reggie-upshaw-1,2014-15,Middle Tennessee,F,36,24,1048,131,298,.440,116,246,.472,15,52,.288,81,125,.648,68,183,251,57,35,35,65,81,358,8.0
1124,Sam Thompson\sam-thompson-1,2014-15,Ohio State,F,35,34,1139,135,290,.466,113,206,.549,22,84,.262,66,96,.688,32,103,135,63,46,33,44,70,358,8.3
1125,Richard Ross\richard-ross-1,2013-14,Old Dominion,F,36,34,1155,149,284,.525,149,283,.527,0,1,.000,60,119,.504,93,160,253,32,27,81,54,87,358,9.0
1126,Austin Nichols\austin-nichols-2,2014-15,Memphis,F,27,26,796,151,304,.497,149,295,.505,2,9,.222,54,89,.607,54,111,165,26,21,93,38,50,358,11.4
1127,Samuel Idowu\samuel-idowu-1,2017-18,Saint Peter's,F,32,32,778,131,278,.471,104,183,.568,27,95,.284,68,85,.800,53,136,189,24,16,40,45,100,357,8.2
1128,Nate Kratch\nate-kratch-1,2016-17,Santa Clara,F,33,33,1123,148,303,.488,99,186,.532,49,117,.419,12,24,.500,36,179,215,35,18,15,39,101,357,7.6
1129,Isaiah Hicks\isaiah-hicks-1,2015-16,North Carolina,F,40,3,723,132,215,.614,132,215,.614,0,0,,93,123,.756,79,106,185,27,20,23,47,121,357,7.4
1130,E.J. Reed\ej-reed-1,2013-14,Long Island University,F,29,29,749,118,268,.440,104,210,.495,14,58,.241,107,157,.682,45,117,162,18,10,32,69,101,357,6.9
1131,Demetris Morant\demetris-morant-1,2016-17,Florida Gulf Coast,F,34,33,875,158,209,.756,158,209,.756,0,0,,41,66,.621,95,173,268,18,11,48,45,98,357,10.5
1132,Jarrid Rhodes\jarrid-rhodes-1,2017-18,Missouri State,F,33,33,1009,124,286,.434,58,120,.483,66,166,.398,43,48,.896,40,95,135,47,19,6,33,61,357,7.9
1133,Luke Petrasek\luke-petrasek-1,2015-16,Columbia,F,35,28,831,125,250,.500,79,146,.541,46,104,.442,61,77,.792,40,119,159,49,22,40,52,72,357,8.4
1134,Torrion Brummitt\torrion-brummitt-1,2014-15,Western Carolina,F,32,32,833,130,281,.463,129,264,.489,1,17,.059,96,141,.681,70,132,202,37,31,31,77,121,357,7.4
1135,Tanner Leissner\tanner-leissner-1,2014-15,New Hampshire,F,29,27,899,117,261,.448,91,187,.487,26,74,.351,97,135,.719,60,149,209,31,20,19,59,60,357,9.1
1136,Mike Miklusak\mike-miklusak-1,2016-17,Western Illinois,F,23,21,808,122,289,.422,61,142,.430,61,147,.415,52,72,.722,15,189,204,54,27,4,50,80,357,10.8
1137,Fran Dougherty\fran-dougherty-1,2013-14,Pennsylvania,F,28,28,801,143,258,.554,137,239,.573,6,19,.316,64,97,.660,57,147,204,30,27,20,57,72,356,10.0
1138,David Samuels\david-samuels-1,2014-15,Cal State Long Beach,F,33,31,881,135,267,.506,129,246,.524,6,21,.286,80,128,.625,95,149,244,40,17,23,69,91,356,8.2
1139,Jordan Heath\jordan-heath-1,2013-14,Canisius,F,34,34,940,134,251,.534,89,142,.627,45,109,.413,43,88,.489,59,129,188,30,35,72,34,107,356,9.6
1140,Chris Jones\chris-jones-6,2014-15,Louisville,F,26,24,807,114,301,.379,75,186,.403,39,115,.339,89,122,.730,29,74,103,94,53,1,60,68,356,9.7
1141,Roger Woods\roger-woods-2,2015-16,Little Rock,F,35,19,795,126,234,.538,115,199,.578,11,35,.314,93,143,.650,42,107,149,56,33,8,52,73,356,8.0
1142,Bobby Hain\bobby-hain-1,2013-14,Youngstown State,F,32,31,895,142,279,.509,137,258,.531,5,21,.238,67,96,.698,81,166,247,35,12,16,34,95,356,9.0
1143,Malcolm Riley\malcolm-riley--1,2014-15,Texas Southern,F,35,29,1023,119,238,.500,94,180,.522,25,58,.431,93,125,.744,68,156,224,19,35,4,30,72,356,8.9
1144,Nathan Adrian\nathan-adrian-1,2016-17,West Virginia,F,37,37,1121,125,295,.424,93,186,.500,32,109,.294,74,104,.712,97,125,222,108,48,18,58,79,356,9.2
1145,Dale Jones\dale-jones-1,2017-18,North Dakota,F,30,29,782,120,276,.435,52,95,.547,68,181,.376,47,57,.825,19,176,195,31,18,11,49,98,355,7.7
1146,Terrence Smith\terrence-smith-1,2013-14,NJIT,F,29,29,773,154,245,.629,154,245,.629,0,0,,47,64,.734,67,106,173,16,14,14,36,74,355,9.9
1147,Jaron Nash\jaron-nash-1,2013-14,North Dakota,F,33,22,769,151,289,.522,130,229,.568,21,60,.350,32,90,.356,54,93,147,19,35,18,48,66,355,7.3
1148,Kenny Kaminski\kenny-kaminski-1,2016-17,Ohio,F,30,30,850,119,300,.397,38,110,.345,81,190,.426,36,46,.783,19,72,91,27,25,6,30,76,355,7.0
1149,Lester Wilson\lester-wilson-1,2013-14,East Tennessee State,F,35,7,764,126,328,.384,63,139,.453,63,189,.333,40,49,.816,28,96,124,17,15,2,20,81,355,5.6
1150,Kevin Puryear\kevin-puryear-1,2015-16,Missouri,F,31,31,767,120,258,.465,107,217,.493,13,41,.317,102,122,.836,40,104,144,13,12,4,50,51,355,7.3
1151,Jameel McKay\jameel-mckay-1,2015-16,Iowa State,F,32,28,975,147,243,.605,147,243,.605,0,0,,61,114,.535,104,178,282,28,16,55,47,72,355,10.8
1152,DJ Hogg\dj-hogg-1,2017-18,Texas A&M,F,32,31,989,119,290,.410,54,118,.458,65,172,.378,51,71,.718,37,132,169,84,27,27,52,67,354,8.8
1153,Sandy Cohen\sandy-cohen-1,2017-18,Green Bay,F,22,20,725,117,247,.474,87,161,.540,30,86,.349,90,127,.709,12,113,125,56,34,14,57,68,354,11.6
1154,Worth Smith\worth-smith-1,2013-14,Navy,F,30,30,903,141,329,.429,128,274,.467,13,55,.236,59,83,.711,64,104,168,24,24,27,50,71,354,7.6
1155,Montel James\montel-james-1,2015-16,Loyola (IL),F,29,16,765,115,263,.437,112,246,.455,3,17,.176,121,160,.756,52,153,205,12,24,30,52,59,354,9.0
1156,Will Sheehey\will-sheehey-1,2013-14,Indiana,F,31,31,938,136,288,.472,103,188,.548,33,100,.330,49,71,.690,44,81,125,57,28,8,65,82,354,7.4
1157,Tommy Rutherford\tommy-rutherford-1,2017-18,UC-Irvine,F,35,32,747,133,228,.583,127,214,.593,6,14,.429,82,115,.713,62,137,199,28,9,23,72,103,354,7.2
1158,Kameron Hankerson\kameron-hankerson-1,2017-18,Green Bay,F,33,24,906,127,287,.443,79,163,.485,48,124,.387,51,69,.739,20,81,101,87,32,21,78,76,353,7.1
1159,Darral Willis Jr.\darral-willisjr-1,2016-17,Wichita State,F,36,15,591,127,236,.538,127,235,.540,0,1,.000,99,134,.739,64,120,184,23,15,29,54,87,353,7.4
1160,Travis McKie\travis-mckie-1,2013-14,Wake Forest,F,33,33,956,104,251,.414,65,127,.512,39,124,.315,106,131,.809,35,101,136,43,30,21,38,62,353,8.4
1161,Will Davis\will-davis-1,2013-14,UC-Irvine,F,32,32,819,148,261,.567,148,261,.567,0,0,,57,86,.663,77,128,205,24,16,31,44,59,353,9.3
1162,Gary Johnson\gary-johnson-3,2013-14,Albany (NY),F,32,30,974,124,237,.523,122,229,.533,2,8,.250,103,139,.741,41,117,158,46,20,12,60,65,353,8.1
1163,Logan McLane\logan-mclane-1,2016-17,Miami (OH),F,30,25,829,138,259,.533,130,222,.586,8,37,.216,69,102,.676,47,148,195,45,33,21,52,64,353,9.8
1164,Tres Tinkle\tres-tinkle-1,2015-16,Oregon State,F,27,11,748,108,245,.441,79,165,.479,29,80,.363,108,147,.735,40,106,146,30,32,14,38,72,353,9.8
1165,Brian Dawkins\brian-dawkins-1,2017-18,Elon,F,29,28,821,142,288,.493,104,171,.608,38,117,.325,31,51,.608,32,125,157,34,11,8,36,73,353,8.1
1166,Bryce Washington\bryce-washington-1,2017-18,Louisiana,F,34,34,1013,137,264,.519,137,261,.525,0,3,.000,79,123,.642,126,230,356,72,44,30,68,86,353,11.0
1167,Cory Dixon\cory-dixon-2,2013-14,New Orleans,F,26,25,694,107,218,.491,107,218,.491,0,0,,138,185,.746,61,140,201,36,18,26,92,66,352,9.7
1168,DeAndre Dishman\deandre-dishman-1,2017-18,Eastern Kentucky,F,30,23,820,130,229,.568,130,228,.570,0,1,.000,92,145,.634,66,120,186,32,28,23,51,71,352,9.7
1169,DeJuan Marrero\dejuan-marrero-1,2016-17,Morehead State,F,29,29,825,145,343,.423,145,343,.423,0,0,,62,89,.697,88,158,246,42,30,16,75,88,352,7.9
1170,Luke Meyer\luke-meyer-2,2017-18,Central Michigan,F,36,35,861,128,246,.520,74,114,.649,54,132,.409,42,46,.913,54,118,172,24,10,43,32,85,352,8.2
1171,Obi Enechionyia\obi-enechionyia-1,2015-16,Temple,F,32,25,809,126,297,.424,70,152,.461,56,145,.386,44,64,.688,31,89,120,18,11,30,29,85,352,6.8
1172,Tashombe Riley\tashombe-riley-1,2016-17,South Carolina State,F,31,29,775,151,303,.498,143,277,.516,8,26,.308,42,56,.750,46,115,161,24,23,7,29,99,352,7.7
1173,Andrew Chrabascz\andrew-chrabascz-1,2015-16,Butler,F,33,31,996,128,259,.494,104,194,.536,24,65,.369,72,91,.791,48,89,137,64,33,15,31,83,352,9.1
1174,Mark Gasperini\mark-gasperini-1,2016-17,American,F,30,29,819,153,313,.489,141,266,.530,12,47,.255,33,60,.550,41,85,126,46,18,15,56,101,351,6.7
1175,Brice Johnson\brice-johnson-1,2013-14,North Carolina,F,34,2,661,150,265,.566,150,265,.566,0,0,,51,82,.622,77,132,209,30,25,43,40,95,351,9.0
1176,Kamren Belin\kamren-belin-1,2013-14,Youngstown State,F,31,31,944,116,316,.367,56,128,.438,60,188,.319,59,73,.808,36,102,138,48,17,19,49,88,351,6.6
1177,Mikal Bridges\mikal-bridges-1,2016-17,Villanova,F,36,33,1073,128,233,.549,84,121,.694,44,112,.393,51,56,.911,41,124,165,71,61,32,46,82,351,9.9
1178,Michael Humphrey\michael-humphrey-1,2017-18,Stanford,F,35,35,900,133,288,.462,108,224,.482,25,64,.391,60,86,.698,65,192,257,25,25,33,55,116,351,7.4
1179,Kerem Kanter\kerem-kanter-1,2016-17,Green Bay,F,31,20,592,137,270,.507,123,230,.535,14,40,.350,63,99,.636,64,132,196,19,9,18,42,65,351,8.2
1180,Tyshawn Bell\tyshawn-bell-1,2013-14,Delaware State,F,29,21,829,117,267,.438,76,148,.514,41,119,.345,75,87,.862,25,87,112,27,28,8,41,82,350,7.8
1181,Dennis Ogbe\dennis-ogbe-1,2013-14,Tennessee Tech,F,33,29,757,128,210,.610,119,169,.704,9,41,.220,85,121,.702,80,112,192,22,21,27,43,110,350,9.0
1182,Mike Watkins\mike-watkins-1,2017-18,Penn State,F,29,28,764,146,213,.685,146,212,.689,0,1,.000,58,95,.611,58,200,258,20,28,68,49,70,350,12.3
1183,Rob Loe\rob-loe-1,2013-14,Saint Louis,F,34,34,941,121,267,.453,83,143,.580,38,124,.306,70,93,.753,51,143,194,67,30,41,50,100,350,8.7
1184,P.J. Horgan\pj-horgan-1,2014-15,Citadel,F,30,30,937,131,240,.546,131,240,.546,0,0,,88,127,.693,73,123,196,27,17,32,60,65,350,9.3
1185,Marquis Vance\marquis-vance-1,2016-17,Alcorn State,F,32,31,921,122,322,.379,83,204,.407,39,118,.331,67,129,.519,69,170,239,66,24,32,68,74,350,7.6
1186,JayVaughn Pinkston\jayvaughn-pinkston-1,2014-15,Villanova,F,36,36,933,102,225,.453,102,219,.466,0,6,.000,146,188,.777,70,124,194,41,29,29,60,76,350,8.1
1187,Chris Olivier\chris-olivier-1,2014-15,Eastern Illinois,F,27,10,634,135,249,.542,135,249,.542,0,0,,80,143,.559,44,98,142,27,13,38,40,66,350,9.5
1188,Willie Cauley-Stein\willie-cauley-stein-1,2014-15,Kentucky,F,39,38,1012,135,236,.572,135,236,.572,0,0,,79,128,.617,89,162,251,38,47,67,48,78,349,9.5
1189,Tyler Hood\tyler-hood-1,2014-15,Samford,F,32,32,874,120,261,.460,51,88,.580,69,173,.399,40,44,.909,20,88,108,41,20,12,33,90,349,7.5
1190,Tony Armstrong\tony-armstrong-1,2016-17,Alabama State,F,31,22,843,126,271,.465,126,271,.465,0,0,,97,148,.655,74,131,205,25,15,23,53,88,349,7.8
1191,Spencer Weisz\spencer-weisz-1,2014-15,Princeton,F,30,29,963,113,243,.465,62,118,.525,51,125,.408,72,89,.809,19,128,147,78,32,8,64,66,349,9.0
1192,Jahlil Tripp\jahlil-tripp-1,2017-18,Pacific,F,32,31,1122,125,281,.445,108,227,.476,17,54,.315,82,125,.656,78,172,250,145,48,7,93,91,349,9.9
1193,Tomasz Gielo\tomasz-gielo-1,2013-14,Liberty,F,32,31,997,127,274,.464,87,175,.497,40,99,.404,55,71,.775,49,141,190,46,21,19,55,65,349,8.2
1194,Nik Popovic\nik-popovic-1,2017-18,Boston College,F,35,33,911,138,272,.507,133,247,.538,5,25,.200,67,94,.713,90,126,216,45,15,27,66,90,348,7.6
1195,Jordan Tolbert\jordan-tolbert-1,2015-16,Southern Methodist,F,30,24,799,133,239,.556,131,235,.557,2,4,.500,80,122,.656,106,150,256,25,25,22,39,54,348,11.1
1196,Griffin Kinney\griffin-kinney-1,2017-18,Appalachian State,F,33,33,779,130,223,.583,127,214,.593,3,9,.333,85,116,.733,53,131,184,44,19,11,65,101,348,7.9
1197,Joshua Patton\joshua-patton-1,2017-18,Sacramento State,F,32,32,785,124,203,.611,124,203,.611,0,0,,100,142,.704,61,103,164,18,16,58,53,118,348,8.8
1198,William Lee\william-lee-1,2015-16,Alabama-Birmingham,F,33,19,818,137,278,.493,105,185,.568,32,93,.344,42,65,.646,55,148,203,51,23,92,52,54,348,10.0
1199,Caleb Swanigan\caleb-swanigan-1,2015-16,Purdue,F,34,34,875,130,282,.461,109,210,.519,21,72,.292,67,94,.713,54,228,282,61,12,8,90,75,348,7.0
1200,John Walton\josh-walton-1,2015-16,Troy,F,31,31,909,115,257,.447,114,254,.449,1,3,.333,117,169,.692,87,170,257,26,20,20,59,93,348,8.4
1201,Rondae Hollis-Jefferson\rondae-hollis-jefferson-1,2013-14,Arizona,F,38,6,960,121,247,.490,119,237,.502,2,10,.200,103,151,.682,83,132,215,55,28,40,44,92,347,8.3
1202,Ryan Weber\ryan-weber-1,2015-16,Ball State,F,33,33,952,106,247,.429,36,72,.500,70,175,.400,65,82,.793,28,118,146,52,13,7,48,58,347,7.5
1203,Alex Thompson\alex-thompson-2,2017-18,Samford,F,30,22,741,127,281,.452,87,154,.565,40,127,.315,53,68,.779,20,92,112,21,12,7,22,66,347,7.3
1204,Brandon Walters\brandon-walters-2,2017-18,Middle Tennessee,F,32,24,736,142,218,.651,141,213,.662,1,5,.200,62,89,.697,83,84,167,19,21,30,39,116,347,9.2
1205,Justin Jackson\justin-jackson-5,2016-17,Maryland,F,33,30,919,117,267,.438,71,162,.438,46,105,.438,67,96,.698,58,141,199,31,29,26,54,72,347,8.0
1206,Xavier Lundy\xavier-lundy-1,2016-17,Rider,F,33,33,1029,121,298,.406,75,156,.481,46,142,.324,58,72,.806,41,98,139,45,30,31,59,80,346,7.0
1207,DeVon Barnett\devon-barnett-1,2014-15,Sacred Heart,F,32,31,813,141,247,.571,141,246,.573,0,1,.000,64,100,.640,54,100,154,28,26,18,47,97,346,8.0
1208,Artem Tavakalyan\artem-tavakalyan-1,2017-18,Delaware State,F,32,26,880,121,264,.458,76,157,.484,45,107,.421,59,77,.766,42,134,176,49,29,6,58,71,346,7.9
1209,Mark Tollefsen\mark-tollefsen-1,2013-14,San Francisco,F,33,33,950,123,231,.532,89,135,.659,34,96,.354,66,91,.725,45,85,130,58,14,30,31,79,346,8.9
1210,Will Kelly\will-kelly-1,2015-16,Navy,F,33,33,889,134,216,.620,134,216,.620,0,0,,78,143,.545,59,131,190,42,19,87,68,107,346,9.1
1211,Laimonas Chatkevicius\laimonas-chatkevicius-1,2015-16,South Carolina,F,34,28,752,140,260,.538,133,233,.571,7,27,.259,59,80,.738,71,91,162,25,18,31,58,82,346,7.5
1212,Xavier Lundy\xavier-lundy-1,2015-16,Rider,F,33,19,799,136,273,.498,106,186,.570,30,87,.345,44,67,.657,49,85,134,27,19,30,49,76,346,7.3
1213,B.J. West\bj-west-1,2013-14,Jackson State,F,27,21,748,132,237,.557,132,233,.567,0,4,.000,82,108,.759,98,163,261,17,21,54,55,76,346,12.0
1214,Matt Mitchell\matt-mitchell-4,2017-18,San Diego State,F,33,32,874,116,258,.450,67,121,.554,49,137,.358,65,85,.765,24,107,131,57,36,8,66,82,346,7.1
1215,Till Gloger\till-gloger-1,2014-15,Maine,F,30,28,795,140,266,.526,140,265,.528,0,1,.000,66,85,.776,38,107,145,22,18,8,56,66,346,7.5
1216,Myles Turner\myles-turner-1,2014-15,Texas,F,34,7,755,117,257,.455,100,195,.513,17,62,.274,94,112,.839,44,178,222,20,10,89,47,82,345,8.7
1217,Devonte Upson\devonte-upson-1,2014-15,Southeastern Louisiana,F,32,31,1031,145,239,.607,145,239,.607,0,0,,55,89,.618,81,157,238,18,24,49,61,94,345,9.3
1218,Derrick Jones Jr.\derrick-jonesjr-1,2015-16,Nevada-Las Vegas,F,30,15,646,129,219,.589,121,180,.672,8,39,.205,79,133,.594,52,82,134,24,27,40,36,93,345,9.4
1219,L.G. Gill\lg-gill-1,2015-16,Duquesne,F,34,34,1021,125,285,.439,72,131,.550,53,154,.344,42,57,.737,50,170,220,33,7,21,39,101,345,7.1
1220,J.J. Panoske\jj-panoske-1,2015-16,Milwaukee,F,33,33,754,135,263,.513,92,157,.586,43,106,.406,32,41,.780,37,135,172,46,6,54,44,89,345,8.3
1221,Jalen McDaniels\jalen-mcdaniels-1,2017-18,San Diego State,F,33,21,815,126,215,.586,122,196,.622,4,19,.211,89,113,.788,74,174,248,29,27,19,36,77,345,10.1
1222,Lee Skinner\lee-skinner-1,2014-15,Wofford,F,35,35,1035,130,261,.498,129,258,.500,1,3,.333,84,122,.689,56,145,201,72,26,4,54,76,345,7.9
1223,Darral Willis Jr.\darral-willisjr-1,2017-18,Wichita State,F,33,5,599,123,241,.510,105,194,.541,18,47,.383,81,122,.664,59,140,199,33,8,14,52,57,345,7.8
1224,Seth Towns\seth-towns-1,2016-17,Harvard,F,28,20,689,119,278,.428,81,180,.450,38,98,.388,69,84,.821,32,90,122,36,27,15,65,85,345,7.3
1225,Bruce Stevens\bruce-stevens-1,2017-18,Mississippi,F,32,19,715,121,235,.515,107,184,.582,14,51,.275,89,117,.761,60,111,171,38,16,16,35,95,345,8.6
1226,Ramel Thompkins\ramel-thompkins-1,2017-18,South Carolina Upstate,F,32,31,1004,113,276,.409,40,84,.476,73,192,.380,46,54,.852,38,147,185,28,23,33,35,73,345,8.3
1227,Ben Moore\ben-moore-1,2015-16,Southern Methodist,F,29,27,863,134,244,.549,134,244,.549,0,0,,77,107,.720,84,131,215,64,21,41,46,77,345,11.4
1228,Obi Enechionyia\obi-enechionyia-1,2017-18,Temple,F,32,32,957,109,286,.381,52,123,.423,57,163,.350,69,87,.793,53,132,185,37,16,46,42,87,344,7.9
1229,Delante Jones\delante-jones-1,2016-17,American,F,30,30,949,121,298,.406,82,183,.448,39,115,.339,63,92,.685,28,74,102,53,22,7,94,89,344,4.9
1230,Taylor Johns\taylor-johns-1,2015-16,UC-Riverside,F,22,18,673,118,247,.478,106,202,.525,12,45,.267,96,139,.691,49,116,165,46,16,32,71,63,344,11.1
1231,Lorenzo Cugini\lorenzo-cugini-1,2015-16,High Point,F,32,32,888,123,280,.439,55,123,.447,68,157,.433,30,35,.857,21,89,110,43,12,2,34,57,344,7.0
1232,Georgi Boyanov\georgi-boyanov-1,2015-16,South Alabama,F,33,30,837,112,222,.505,93,165,.564,19,57,.333,101,139,.727,87,156,243,14,25,14,43,76,344,9.0
1233,Hans Brase\hans-brase-1,2014-15,Princeton,F,30,28,932,108,255,.424,57,107,.533,51,148,.345,77,97,.794,42,184,226,63,17,14,57,82,344,8.9
1234,Rashaan Holloway\rashaan-holloway-1,2016-17,Massachusetts,F,33,27,628,132,212,.623,132,211,.626,0,1,.000,80,138,.580,65,125,190,26,19,42,70,95,344,8.1
1235,Kyndahl Hill\kyndahl-hill-1,2016-17,Weber State,F,34,34,1042,114,234,.487,114,228,.500,0,6,.000,116,152,.763,79,191,270,42,24,51,55,101,344,9.3
1236,William Lee\william-lee-1,2017-18,Alabama-Birmingham,F,33,32,850,137,271,.506,100,160,.625,37,111,.333,33,51,.647,50,174,224,34,25,68,47,66,344,9.5
1237,Gary Clark\gary-clark-2,2015-16,Cincinnati,F,33,32,1002,126,243,.519,113,218,.518,13,25,.520,79,115,.687,113,177,290,70,41,49,42,76,344,11.9
1238,Roscoe Smith\roscoe-smith-1,2013-14,Nevada-Las Vegas,F,31,30,904,129,243,.531,127,233,.545,2,10,.200,84,126,.667,109,228,337,17,9,22,39,72,344,10.4
1239,Sampson Carter\sampson-carter-1,2013-14,Massachusetts,F,33,33,921,114,275,.415,79,175,.451,35,100,.350,80,114,.702,46,113,159,40,16,13,59,76,343,6.4
1240,Demonte Flannigan\demonte-flannigan-1,2015-16,Cleveland State,F,30,30,697,142,293,.485,135,272,.496,7,21,.333,52,78,.667,45,116,161,23,9,28,49,73,343,7.2
1241,Christopher Galbreath Jr.\christopher-galbreathjr-1,2016-17,Sam Houston State,F,34,10,647,139,287,.484,137,274,.500,2,13,.154,63,92,.685,79,137,216,17,19,24,57,100,343,6.9
1242,Mason Ramsey\mason-ramsay-1,2017-18,Tennessee Tech,F,33,33,897,135,270,.500,130,245,.531,5,25,.200,68,91,.747,62,73,135,41,34,11,49,119,343,7.2
1243,Zach Braxton\zach-braxton-1,2016-17,Weber State,F,34,34,800,135,227,.595,135,227,.595,0,0,,73,133,.549,63,140,203,32,10,31,49,95,343,7.9
1244,Jordan Tolbert\jordan-tolbert-1,2013-14,Texas Tech,F,32,31,843,131,239,.548,121,206,.587,10,33,.303,71,100,.710,62,124,186,24,26,23,55,93,343,8.2
1245,Marcel Pettway\marcel-pettway-1,2015-16,Bryant,F,30,24,965,151,253,.597,151,253,.597,0,0,,41,83,.494,72,139,211,55,32,19,49,71,343,10.3
1246,Joe Furstinger\joe-furstinger-1,2017-18,New Mexico,F,33,25,895,117,211,.555,113,187,.604,4,24,.167,105,131,.802,49,175,224,70,22,53,49,97,343,10.3
1247,Cameron Neubauer\cameron-neubauer-1,2016-17,San Diego,F,31,31,940,108,255,.424,59,106,.557,49,149,.329,77,106,.726,45,122,167,75,12,6,68,116,342,7.0
1248,DeSean Murray\desean-murray-1,2017-18,Auburn,F,34,34,811,112,246,.455,94,190,.495,18,56,.321,100,119,.840,92,137,229,59,30,19,63,81,342,8.9
1249,Sam Downey\sam-downey-1,2016-17,Yale,F,29,29,833,141,250,.564,140,242,.579,1,8,.125,59,91,.648,74,125,199,33,17,11,35,68,342,9.8
1250,Amos Wilson\amos-wilson-1,2013-14,Lamar,F,30,29,898,131,269,.487,131,267,.491,0,2,.000,80,101,.792,47,115,162,25,20,18,55,108,342,7.2
1251,Gibson Johnson\gibson-johnson-1,2016-17,Hawaii,F,30,30,743,129,251,.514,124,222,.559,5,29,.172,79,119,.664,67,77,144,44,17,18,53,88,342,8.1
1252,Sean Obi\sean-obi-1,2013-14,Rice,F,30,29,791,140,237,.591,140,237,.591,0,0,,62,114,.544,74,205,279,24,15,22,59,91,342,9.2
1253,Dakota Slaughter\dakota-slaughter-1,2015-16,Texas-Rio Grande Valley,F,30,30,934,121,273,.443,65,119,.546,56,154,.364,44,59,.746,27,103,130,63,16,14,48,87,342,7.7
1254,Payton Henson\payton-henson-1,2016-17,Vermont,F,30,23,799,128,249,.514,106,180,.589,22,69,.319,64,79,.810,41,116,157,35,15,11,39,57,342,8.7
1255,Evan Smotrycz\evan-smotrycz-1,2013-14,Maryland,F,31,28,865,117,292,.401,63,145,.434,54,147,.367,53,71,.746,52,134,186,52,24,6,49,98,341,7.4
1256,Zane Waterman\zane-waterman-1,2015-16,Manhattan,F,31,30,729,119,242,.492,91,157,.580,28,85,.329,75,101,.743,60,126,186,18,23,11,62,115,341,7.2
1257,Mike Holloway\mike-holloway-1,2016-17,Fairleigh Dickinson,F,30,30,809,133,235,.566,133,233,.571,0,2,.000,75,113,.664,81,109,190,34,22,17,71,103,341,8.3
1258,Erik Thomas\erik-thomas-1,2015-16,New Orleans,F,29,15,662,124,223,.556,124,221,.561,0,2,.000,93,133,.699,77,122,199,44,26,13,46,59,341,10.5
1259,Cedrick Lang\cedrick-lang-1,2014-15,Texas-El Paso,F,33,32,883,114,184,.620,114,183,.623,0,1,.000,113,173,.653,78,143,221,59,16,17,51,111,341,9.2
1260,Yuta Watanabe\yuta-watanabe-1,2016-17,George Washington,F,28,27,982,119,268,.444,92,182,.505,27,86,.314,76,93,.817,39,94,133,70,31,32,51,45,341,10.1
1261,John Davis\john-davis-4,2015-16,Towson,F,33,29,837,129,275,.469,104,209,.498,25,66,.379,58,87,.667,62,120,182,23,19,12,39,79,341,7.3
1262,Trevor Thompson\trevor-thompson-1,2016-17,Ohio State,F,32,20,737,125,219,.571,125,219,.571,0,0,,90,125,.720,86,207,293,14,12,48,45,111,340,9.7
1263,Steven Cook\steven-cook-1,2015-16,Princeton,F,29,29,803,124,273,.454,77,141,.546,47,132,.356,45,60,.750,35,85,120,49,31,20,39,41,340,9.2
1264,Tristan Spurlock\tristan-spurlock-1,2013-14,Central Florida,F,31,28,883,115,276,.417,69,137,.504,46,139,.331,64,85,.753,56,113,169,37,38,33,40,59,340,9.1
1265,Julian Washburn\julian-washburn-1,2014-15,Texas-El Paso,F,33,31,1117,127,306,.415,87,201,.433,40,105,.381,46,64,.719,29,107,136,86,29,19,42,63,340,7.8
1266,Jett Raines\jett-raines-1,2014-15,Pepperdine,F,32,32,913,133,272,.489,121,233,.519,12,39,.308,62,79,.785,45,117,162,16,21,22,31,67,340,7.9
1267,Vitto Brown\vitto-brown-1,2015-16,Wisconsin,F,35,34,888,130,292,.445,92,197,.467,38,95,.400,42,55,.764,60,114,174,29,19,19,40,86,340,6.8
1268,Brandon Peel\brandon-peel-1,2015-16,Central Connecticut State,F,29,29,862,130,294,.442,130,291,.447,0,3,.000,80,103,.777,89,176,265,59,19,39,56,71,340,10.2
1269,Bryce Nze\bryce-nze-1,2017-18,Milwaukee,F,33,29,972,147,255,.576,139,226,.615,8,29,.276,38,79,.481,96,184,280,43,28,48,70,96,340,9.4
1270,Markus Crider\markus-crider-1,2014-15,Georgia State,F,35,35,1104,141,237,.595,141,235,.600,0,2,.000,58,86,.674,58,167,225,64,44,12,58,113,340,8.7
1271,Marvin Prochet\marvin-prochet-1,2017-18,Niagara,F,33,33,1089,117,281,.416,66,147,.449,51,134,.381,55,78,.705,67,195,262,60,27,34,22,73,340,9.9
1272,Colter Lasher\colter-lasher-1,2015-16,Houston Baptist,F,32,29,834,135,286,.472,100,186,.538,35,100,.350,34,57,.596,30,119,149,64,29,16,54,54,339,7.8
1273,Amanze Egekeze\amanze-egekeze-1,2016-17,Belmont,F,30,29,817,112,230,.487,56,84,.667,56,146,.384,59,70,.843,41,124,165,28,11,23,41,91,339,8.5
1274,Lamont West\lamont-west-1,2017-18,West Virginia,F,36,20,815,113,275,.411,58,112,.518,55,163,.337,58,76,.763,49,89,138,22,14,6,37,71,339,5.9
1275,Dan Garvin\dan-garvin-1,2014-15,Bryant,F,31,31,961,139,265,.525,137,257,.533,2,8,.250,59,89,.663,96,148,244,37,30,48,59,118,339,9.4
1276,Ryan Spangler\ryan-spangler-1,2014-15,Oklahoma,F,35,35,1088,136,234,.581,126,201,.627,10,33,.303,57,79,.722,86,202,288,46,24,38,46,87,339,9.8
1277,Leon Gilmore\leon-gilmore-1,2016-17,Stephen F. Austin,F,32,22,802,128,264,.485,123,228,.539,5,36,.139,78,116,.672,69,119,188,48,27,9,68,78,339,7.6
1278,Gilvydas Biruta\gilvydas-biruta-1,2013-14,Rhode Island,F,32,32,829,132,264,.500,126,232,.543,6,32,.188,69,103,.670,86,138,224,43,11,23,66,111,339,7.6
1279,MiKyle McIntosh\mikyle-mcintosh-1,2015-16,Illinois State,F,31,27,745,114,263,.433,81,176,.460,33,87,.379,78,117,.667,59,89,148,56,20,18,69,110,339,6.8
1280,Rayshaun McGrew\rayshaun-mcgrew-1,2015-16,Stony Brook,F,32,32,885,152,304,.500,152,300,.507,0,4,.000,35,77,.455,62,129,191,39,20,10,40,65,339,7.5
1281,Tyrell Sturdivant\tyrell-sturdivant-1,2016-17,Stony Brook,F,32,32,761,121,272,.445,121,272,.445,0,0,,96,150,.640,66,108,174,20,18,13,49,81,338,6.6
1282,Kaleb Wesson\kaleb-wesson-1,2017-18,Ohio State,F,33,30,682,118,210,.562,114,196,.582,4,14,.286,98,136,.721,76,87,163,36,18,21,34,93,338,8.8
1283,Tyler Harris\tyler-harris-1,2014-15,Providence,F,34,12,908,118,280,.421,96,203,.473,22,77,.286,80,109,.734,43,94,137,34,30,7,38,81,338,6.6
1284,Angel Delgado\angel-delgado-1,2015-16,Seton Hall,F,34,34,1027,139,245,.567,139,243,.572,0,2,.000,60,112,.536,103,214,317,33,19,28,63,94,338,8.8
1285,Kaven Bernard\kaven-bernard-1,2014-15,Jackson State,F,32,0,681,126,294,.429,110,226,.487,16,68,.235,70,98,.714,62,96,158,30,16,16,44,67,338,6.9
1286,Shawn Prudhomme\shawn-prudhomme-1,2015-16,Southern,F,35,2,687,127,268,.474,80,145,.552,47,123,.382,37,41,.902,36,82,118,18,27,21,32,76,338,6.9
1287,Abdul Lewis\abdul-lewis-1,2017-18,NJIT,F,28,28,813,120,236,.508,110,211,.521,10,25,.400,88,134,.657,89,157,246,56,10,24,85,82,338,9.3
1288,Noah Vonleh\noah-vonleh-1,2013-14,Indiana,F,30,29,794,113,216,.523,97,183,.530,16,33,.485,96,134,.716,71,198,269,18,26,41,64,81,338,9.9
1289,Mark Nwakamma\mark-nwakamma-1,2014-15,Hartford,F,28,28,727,137,272,.504,129,252,.512,8,20,.400,56,91,.615,46,112,158,54,33,8,71,86,338,8.0
1290,Chris Jones\chris-jones-6,2013-14,Louisville,F,33,27,844,117,296,.395,74,182,.407,43,114,.377,61,79,.772,25,52,77,96,73,2,47,79,338,8.1
1291,Terry Allen\terry-allen-1,2013-14,Richmond,F,33,16,799,129,257,.502,115,220,.523,14,37,.378,65,97,.670,55,132,187,30,22,18,55,77,337,7.4
1292,Kameron Edwards\kameron-edwards-1,2017-18,Pepperdine,F,23,21,672,126,264,.477,114,233,.489,12,31,.387,73,109,.670,38,109,147,25,19,8,45,64,337,9.5
1293,Cedric Kuakumensah\cedric-kuakumensah-1,2014-15,Brown,F,30,29,842,119,264,.451,93,189,.492,26,75,.347,73,109,.670,55,166,221,25,16,76,58,97,337,8.8
1294,Montel James\montel-james-1,2014-15,Loyola (IL),F,36,34,764,141,265,.532,141,265,.532,0,0,,55,98,.561,60,96,156,23,16,23,50,47,337,6.7
1295,Hans Brase\hans-brase-1,2013-14,Princeton,F,30,30,810,112,254,.441,78,149,.523,34,105,.324,79,107,.738,52,118,170,65,22,17,56,83,337,8.5
1296,Octavius Ellis\octavius-ellis-1,2014-15,Cincinnati,F,34,34,975,122,219,.557,122,218,.560,0,1,.000,93,135,.689,93,152,245,44,28,67,76,90,337,9.4
1297,Devonta Walker\devonta-walker-1,2014-15,Louisiana,F,36,18,752,110,218,.505,106,207,.512,4,11,.364,113,141,.801,72,117,189,38,25,13,66,70,337,7.5
1298,Andrew Chrabascz\andrew-chrabascz-1,2014-15,Butler,F,30,29,861,120,269,.446,97,202,.480,23,67,.343,74,120,.617,47,62,109,50,24,17,40,80,337,7.6
1299,Mindaugas Kacinas\mindaugas-kacinas-1,2015-16,South Carolina,F,34,34,995,127,249,.510,105,183,.574,22,66,.333,61,94,.649,67,106,173,31,16,16,34,71,337,7.8
1300,Willie Clayton\willie-clayton-1,2013-14,Charlotte,F,31,30,914,127,214,.593,127,214,.593,0,0,,82,166,.494,118,157,275,24,25,18,69,109,336,8.9
1301,John Simons\john-simons-1,2013-14,Central Michigan,F,31,31,957,116,252,.460,58,99,.586,58,153,.379,46,62,.742,48,129,177,24,18,8,25,76,336,8.3
1302,Mitch Bruneel\mitch-bruneel-1,2014-15,Utah Valley,F,29,28,971,124,248,.500,103,174,.592,21,74,.284,67,98,.684,82,93,175,28,20,4,47,53,336,8.9
1303,Ako Kaluna\ako-kaluna-1,2016-17,Northern Arizona,F,30,29,727,122,264,.462,99,195,.508,23,69,.333,69,100,.690,75,90,165,41,15,16,55,84,336,7.8
1304,Marcus Byrd\marcus-byrd-1,2015-16,Denver,F,31,31,859,125,252,.496,74,129,.574,51,123,.415,35,44,.795,14,103,117,47,20,21,40,93,336,7.6
1305,Nikola Gajic\nikola-gajic-1,2013-14,Stephen F. Austin,F,35,34,809,116,241,.481,73,128,.570,43,113,.381,61,88,.693,63,111,174,63,49,18,49,97,336,8.5
1306,Rashad Smith\rashad-smith-1,2013-14,Tulsa,F,28,24,698,128,235,.545,127,230,.552,1,5,.200,79,141,.560,53,84,137,31,20,24,38,73,336,9.0
1307,Alex Long\alex-long-1,2017-18,Norfolk State,F,32,31,861,141,275,.513,141,271,.520,0,4,.000,53,96,.552,56,128,184,29,28,27,63,100,335,7.0
1308,Moses Greenwood\moses-greenwood-1,2017-18,Southeastern Louisiana,F,33,13,727,139,258,.539,135,246,.549,4,12,.333,53,78,.679,70,114,184,13,14,30,59,90,335,7.0
1309,Glenn Bryant\glenn-bryant-1,2013-14,Eastern Michigan,F,36,10,762,135,241,.560,134,233,.575,1,8,.125,64,92,.696,74,94,168,9,30,54,23,69,335,8.7
1310,Nuni Omot\nuni-omot-1,2017-18,Baylor,F,34,19,805,109,223,.489,57,103,.553,52,120,.433,65,76,.855,31,93,124,59,18,11,52,52,335,7.7
1311,Tai Odiase\tai-odiase-1,2017-18,Illinois-Chicago,F,36,36,907,130,229,.568,130,229,.568,0,0,,75,117,.641,83,118,201,8,24,112,37,73,335,9.6
1312,Kouat Noi\kouat-noi-1,2017-18,Texas Christian,F,33,9,726,118,238,.496,59,102,.578,59,136,.434,40,66,.606,37,91,128,24,21,3,28,62,335,7.4
1313,Soufiyane Diakite\soufiyane-diakite-1,2017-18,Bethune-Cookman,F,32,30,891,134,234,.573,126,210,.600,8,24,.333,59,94,.628,102,211,313,36,27,29,63,86,335,10.0
1314,Steve Moundou-Missi\steve-moundou-missi-1,2013-14,Harvard,F,32,31,806,118,219,.539,118,218,.541,0,1,.000,99,129,.767,64,127,191,19,24,43,42,90,335,9.0
1315,Nicholas West\nicholas-west-1,2014-15,Alabama A&M,F,27,26,854,106,254,.417,87,190,.458,19,64,.297,104,139,.748,68,145,213,26,14,26,69,73,335,8.5
1316,Joey King\joey-king-1,2015-16,Minnesota,F,29,19,854,99,235,.421,40,89,.449,59,146,.404,78,88,.886,27,83,110,38,15,9,27,85,335,8.2
1317,Zach Nelson\zach-nelson-2,2013-14,Utah Valley,F,32,32,990,132,254,.520,114,193,.591,18,61,.295,53,87,.609,53,147,200,109,23,32,74,84,335,9.1
1318,Bakari Copeland\bakari-copeland-1,2015-16,Maryland-Eastern Shore,F,32,29,814,101,234,.432,83,168,.494,18,66,.273,115,153,.752,21,125,146,45,8,5,63,88,335,6.0
1319,Badou Diagne\badou-diagne-1,2015-16,Coastal Carolina,F,30,28,823,119,265,.449,92,174,.529,27,91,.297,70,99,.707,48,160,208,26,20,28,54,83,335,7.9
1320,Chase Foster\chase-foster-1,2016-17,San Francisco,F,33,17,735,114,250,.456,64,125,.512,50,125,.400,56,70,.800,16,96,112,38,19,7,37,59,334,6.9
1321,Nick Stover\nick-stover-1,2015-16,South Alabama,F,33,32,945,115,280,.411,83,183,.454,32,97,.330,72,105,.686,30,86,116,56,25,15,77,72,334,5.7
1322,Kale Abrahamson\kale-abrahamson-1,2015-16,Drake,F,30,26,830,111,284,.391,57,126,.452,54,158,.342,58,85,.682,25,91,116,28,11,4,41,63,334,6.0
1323,Jalen Billups\jalen-billups-1,2014-15,Northern Kentucky,F,30,4,645,142,204,.696,142,203,.700,0,1,.000,50,80,.625,71,106,177,17,13,36,50,81,334,9.5
1324,Drew Kelly\drew-kelly-1,2013-14,Morehead State,F,34,33,864,115,242,.475,79,142,.556,36,100,.360,68,95,.716,52,97,149,22,19,14,36,127,334,6.6
1325,Cleveland Melvin\cleveland-melvin-1,2013-14,DePaul,F,20,20,652,121,257,.471,88,187,.471,33,70,.471,59,93,.634,49,78,127,19,11,31,35,37,334,12.1
1326,Payton Banks\payton-banks-1,2016-17,Penn State,F,32,13,853,106,293,.362,33,92,.359,73,201,.363,49,60,.817,12,59,71,31,14,9,31,64,334,5.6
1327,Isaiah Miles\isaiah-miles-1,2014-15,Saint Joseph's,F,31,31,969,115,296,.389,62,146,.425,53,150,.353,50,67,.746,65,94,159,26,20,29,52,107,333,6.5
1328,Stefan Kenic\stefan-kenic-1,2017-18,Cleveland State,F,35,31,815,106,253,.419,57,121,.471,49,132,.371,72,91,.791,26,88,114,20,17,11,64,81,333,5.1
1329,Danjel Purifoy\danjel-purifoy-1,2016-17,Auburn,F,29,25,831,97,244,.398,38,84,.452,59,160,.369,80,91,.879,28,108,136,51,41,5,45,65,333,8.9
1330,Kuran Iverson\kuran-iverson-1,2016-17,Rhode Island,F,35,35,910,125,265,.472,101,183,.552,24,82,.293,59,100,.590,77,180,257,60,22,46,62,102,333,8.1
1331,Mo Alie-Cox\mo-alie-cox-1,2016-17,Virginia Commonwealth,F,35,27,922,126,232,.543,126,232,.543,0,0,,81,109,.743,76,71,147,36,29,71,55,90,333,8.5
1332,Brian Bennett\brian-bennett-1,2014-15,Cal Poly,F,29,28,879,146,288,.507,146,287,.509,0,1,.000,41,76,.539,56,128,184,25,19,9,35,66,333,8.1
1333,Royce O'Neale\royce-oneale-1,2014-15,Baylor,F,33,33,1060,108,237,.456,59,125,.472,49,112,.438,68,88,.773,66,127,193,113,38,11,55,75,333,9.9
1334,Bryce Douvier\bryce-douvier-1,2015-16,Texas A&M-Corpus Christi,F,33,33,760,105,215,.488,80,150,.533,25,65,.385,98,126,.778,64,157,221,22,29,25,55,105,333,8.2
1335,Jeylani Dublin\jeyani-dubin-1,2013-14,Longwood,F,32,6,609,147,268,.549,147,268,.549,0,0,,38,65,.585,73,62,135,6,21,10,45,90,332,6.7
1336,Ryley Beaumont\ryley-beaumont-1,2013-14,Elon,F,32,32,939,135,299,.452,111,216,.514,24,83,.289,38,62,.613,51,116,167,57,12,9,57,97,332,6.3
1337,Kourtney Roberson\kourtney-roberson-1,2013-14,Texas A&M,F,34,34,867,134,229,.585,134,229,.585,0,0,,64,105,.610,94,136,230,23,23,23,44,84,332,8.6
1338,Daniel Ochefu\daniel-ochefu-1,2014-15,Villanova,F,36,34,864,130,202,.644,130,202,.644,0,0,,72,104,.692,95,210,305,55,31,50,66,76,332,10.2
1339,Brandan Stith\brandan-stith-1,2015-16,Old Dominion,F,32,31,869,133,242,.550,133,242,.550,0,0,,66,138,.478,118,192,310,12,21,64,40,85,332,10.2
1340,Rhamel Brown\rhamel-brown-1,2013-14,Manhattan,F,33,33,788,128,232,.552,128,232,.552,0,0,,76,148,.514,90,104,194,22,22,120,47,101,332,9.7
1341,Jared Sam\jared-sam-1,2015-16,Southern,F,35,34,933,121,214,.565,121,214,.565,0,0,,90,139,.647,71,152,223,31,27,25,41,97,332,8.4
1342,Wayne Martin\wayne-martin-1,2015-16,Tennessee State,F,30,18,764,130,267,.487,129,254,.508,1,13,.077,71,114,.623,96,176,272,9,22,34,66,83,332,8.4
1343,Payton Banks\payton-banks-1,2017-18,South Florida,F,29,25,823,108,289,.374,47,107,.439,61,182,.335,54,72,.750,18,87,105,34,35,6,52,75,331,6.4
1344,Dante Williams\dante-williams-2,2014-15,Oakland,F,33,22,1154,118,291,.405,51,99,.515,67,192,.349,28,39,.718,31,59,90,57,26,10,43,93,331,6.1
1345,Jarell Martin\jarell-martin-1,2013-14,Louisiana State,F,32,25,837,121,257,.471,94,176,.534,27,81,.333,62,90,.689,56,90,146,29,27,22,52,78,331,7.3
1346,Tyler Cook\tyler-cook-1,2016-17,Iowa,F,27,26,662,128,231,.554,126,223,.565,2,8,.250,73,122,.598,53,90,143,26,18,11,65,67,331,8.0
1347,Jordan Swopshire\jordan-swopshire-1,2016-17,Colgate,F,32,20,828,102,257,.397,36,81,.444,66,176,.375,60,77,.779,23,127,150,37,21,11,56,62,330,6.6
1348,Jalen Canty\jalen-canty-1,2017-18,UC-Santa Barbara,F,26,25,714,129,220,.586,129,220,.586,0,0,,72,109,.661,89,111,200,25,14,48,33,64,330,12.1
1349,Tim Huskisson\tim-huskisson-1,2013-14,Northern Colorado,F,32,12,663,118,216,.546,93,159,.585,25,57,.439,69,108,.639,46,68,114,45,27,19,50,84,330,7.9
1350,Jaleel Williams\jaleel-williams-1,2013-14,San Jose State,F,31,30,896,118,296,.399,72,143,.503,46,153,.301,48,74,.649,36,142,178,29,10,3,41,77,330,6.1
1351,Noah Morgan\noah-morgan-1,2017-18,Fairleigh Dickinson,F,30,26,838,117,246,.476,69,136,.507,48,110,.436,48,58,.828,39,108,147,41,24,20,61,83,330,7.8
1352,Zach Nelson\zach-nelson-2,2014-15,Utah Valley,F,30,27,901,124,267,.464,82,141,.582,42,126,.333,40,57,.702,45,139,184,67,21,35,72,77,330,8.3
1353,Deontae Hawkins\deontae-hawkins-1,2015-16,Illinois State,F,32,31,796,125,301,.415,73,159,.459,52,142,.366,28,41,.683,53,134,187,34,22,23,41,80,330,7.2
1354,Jemerrio Jones\jemerrio-jones-1,2016-17,New Mexico State,F,34,0,833,132,263,.502,127,241,.527,5,22,.227,61,100,.610,98,189,287,103,37,25,70,92,330,9.7
1355,Gavin Ware\gavin-ware-1,2013-14,Mississippi State,F,33,33,859,129,222,.581,129,222,.581,0,0,,72,111,.649,73,163,236,7,28,12,45,82,330,8.3
1356,Nino Williams\nino-williams-1,2014-15,Kansas State,F,29,28,781,120,251,.478,117,243,.481,3,8,.375,87,105,.829,52,103,155,32,16,6,37,96,330,7.9
1357,Marcel Pettway\marcel-pettway-1,2016-17,Bryant,F,32,31,917,140,241,.581,140,241,.581,0,0,,50,90,.556,74,134,208,48,32,13,63,78,330,8.6
1358,Cam Gregory\cam-gregory-1,2017-18,Loyola (MD),F,31,31,900,130,222,.586,130,222,.586,0,0,,70,107,.654,95,160,255,17,15,20,50,78,330,9.2
1359,Eric Carter\eric-carter-1,2017-18,Delaware,F,30,30,869,121,204,.593,121,203,.596,0,1,.000,88,134,.657,71,201,272,53,17,25,60,95,330,10.0
1360,Richard Solomon\richard-solomon-1,2013-14,University of California,F,30,29,875,125,230,.543,125,230,.543,0,0,,80,151,.530,83,224,307,39,33,39,54,86,330,10.5
1361,Jonathan Holmes\jonathan-holmes-2,2014-15,Texas,F,32,31,835,105,270,.389,62,140,.443,43,130,.331,77,99,.778,71,125,196,34,17,33,47,71,330,7.8
1362,Solomon Mangham\solomon-mangham-1,2016-17,Howard,F,34,33,1077,119,360,.331,60,162,.370,59,198,.298,32,54,.593,63,177,240,32,19,15,41,72,329,5.7
1363,Josh Ajayi\josh-ajayi-1,2016-17,South Alabama,F,31,25,760,113,232,.487,90,176,.511,23,56,.411,80,121,.661,42,126,168,27,24,10,58,68,329,7.3
1364,Mitch Bruneel\mitch-bruneel-1,2013-14,Utah Valley,F,32,32,1022,124,236,.525,102,173,.590,22,63,.349,59,82,.720,76,89,165,34,23,5,28,68,329,8.7
1365,Jorge Bilbao\jorge-bilbao-1,2016-17,Texas-Arlington,F,36,36,906,118,219,.539,118,214,.551,0,5,.000,93,137,.679,112,130,242,34,29,12,50,121,329,7.9
1366,Matt O'Leary\matt-oleary-1,2015-16,IUPUI,F,32,32,896,128,264,.485,100,163,.613,28,101,.277,45,78,.577,39,152,191,69,32,10,56,70,329,8.1
1367,Ognjen Miljkovic\ognjen-miljkovic-1,2014-15,Eastern Washington,F,34,33,812,111,270,.411,56,124,.452,55,146,.377,52,70,.743,26,81,107,32,21,22,58,90,329,5.4
1368,Ryan Weber\ryan-weber-1,2016-17,Ball State,F,34,25,873,103,243,.424,36,60,.600,67,183,.366,55,65,.846,25,76,101,52,28,4,57,59,328,6.5
1369,Mustafa Jones\mustafa-jones-1,2017-18,Central Connecticut State,F,32,23,909,146,277,.527,144,268,.537,2,9,.222,34,47,.723,40,112,152,30,21,35,48,63,328,7.6
1370,Dean Wade\dean-wade-1,2015-16,Kansas State,F,33,31,871,111,256,.434,85,167,.509,26,89,.292,80,122,.656,67,101,168,37,20,17,31,88,328,7.4
1371,Rod Rucker\rod-rucker-1,2013-14,Alabama-Birmingham,F,30,29,918,114,303,.376,113,295,.383,1,8,.125,99,142,.697,62,150,212,63,13,12,61,67,328,7.0
1372,Aaron Ross\aaron-ross-1,2015-16,Texas Tech,F,32,1,693,99,214,.463,66,126,.524,33,88,.375,97,111,.874,30,115,145,27,8,9,35,75,328,7.4
1373,Ako Kaluna\ako-kaluna-1,2014-15,Northern Arizona,F,38,18,761,125,262,.477,89,181,.492,36,81,.444,42,58,.724,50,78,128,29,20,10,42,94,328,5.6
1374,Jae'Sean Tate\jaesean-tate-1,2015-16,Ohio State,F,28,28,813,135,259,.521,121,219,.553,14,40,.350,44,85,.518,55,124,179,42,35,9,45,85,328,9.0
1375,Donovan Ross\donovan-ross-1,2013-14,Lamar,F,30,30,907,123,222,.554,123,222,.554,0,0,,81,104,.779,49,106,155,26,24,20,59,76,327,8.2
1376,Darius Leonard\darius-leonard-1,2013-14,Campbell,F,32,30,823,127,252,.504,92,160,.575,35,92,.380,38,53,.717,51,107,158,42,15,12,40,70,327,7.8
1377,Jon Harris\jon-harris-2,2013-14,Cleveland State,F,32,0,856,118,223,.529,78,122,.639,40,101,.396,51,63,.810,42,144,186,44,31,25,37,77,327,9.3
1378,Javan White\javan-white-1,2017-18,Oral Roberts,F,32,29,881,132,257,.514,126,242,.521,6,15,.400,57,103,.553,113,174,287,43,30,21,50,76,327,9.6
1379,Rokas Gustys\rokas-gustys-1,2017-18,Hofstra,F,31,31,921,141,220,.641,141,220,.641,0,0,,45,120,.375,127,245,372,40,26,11,53,100,327,10.7
1380,Cam Gregory\cam-gregory-1,2016-17,Loyola (MD),F,33,26,878,134,210,.638,133,207,.643,1,3,.333,57,118,.483,96,156,252,34,29,30,36,89,326,9.8
1381,Tevin Calhoun\tevin-calhoun-1,2013-14,Troy,F,31,20,757,110,253,.435,71,140,.507,39,113,.345,67,107,.626,39,87,126,16,12,16,38,59,326,6.6
1382,Justin Tuoyo\justin-tuoyo-1,2014-15,Chattanooga,F,32,31,923,119,221,.538,117,213,.549,2,8,.250,86,135,.637,93,112,205,25,25,104,47,107,326,10.1
1383,Jalen Reynolds\jalen-reynolds-1,2015-16,Xavier,F,34,32,666,127,243,.523,125,237,.527,2,6,.333,70,107,.654,67,153,220,24,23,22,53,104,326,7.2
1384,Davaris McGowens\davaris-mcgowens-1,2017-18,North Carolina A&T,F,31,21,659,129,222,.581,129,221,.584,0,1,.000,68,104,.654,54,109,163,29,21,14,36,62,326,8.7
1385,Dean Wade\dean-wade-1,2016-17,Kansas State,F,35,35,980,117,236,.496,78,139,.561,39,97,.402,53,80,.663,57,101,158,64,26,23,34,84,326,8.2
1386,Jontay Porter\jontay-porter-1,2017-18,Missouri,F,33,7,808,104,238,.437,64,128,.500,40,110,.364,78,104,.750,50,174,224,74,28,55,63,97,326,8.9
1387,Marquez Letcher-Ellis\marquez-letcher-ellis-1,2015-16,Rice,F,32,1,690,110,214,.514,102,173,.590,8,41,.195,98,152,.645,50,109,159,21,25,36,59,101,326,7.2
1388,Tyler Roberson\tyler-roberson-1,2015-16,Syracuse,F,37,37,1140,133,253,.526,133,251,.530,0,2,.000,60,104,.577,150,163,313,50,28,24,57,85,326,8.8
1389,Josiah Heath\josiah-heath-1,2014-15,Canisius,F,33,33,850,135,263,.513,135,258,.523,0,5,.000,56,99,.566,88,135,223,40,30,35,37,89,326,8.8
1390,Will Saunders\will-saunders-1,2013-14,Charleston Southern,F,31,5,670,97,235,.413,23,52,.442,74,183,.404,57,74,.770,37,115,152,24,13,7,34,64,325,7.4
1391,Gabas Maldunas\gabas-maldunas-1,2014-15,Dartmouth,F,29,28,814,126,256,.492,126,255,.494,0,1,.000,73,127,.575,65,131,196,45,35,54,70,93,325,8.8
1392,Joshua Treadwell\joshua-treadwell-1,2015-16,Coppin State,F,31,12,699,112,254,.441,73,151,.483,39,103,.379,62,80,.775,36,108,144,35,16,5,46,70,325,6.9
1393,Phillip Carr\phillip-carr-1,2015-16,Morgan State,F,31,30,932,107,280,.382,78,194,.402,29,86,.337,82,110,.745,62,153,215,37,14,35,43,72,325,7.8
1394,Vic Law\vic-law-1,2017-18,Northwestern,F,27,27,853,109,261,.418,58,128,.453,51,133,.383,56,68,.824,30,126,156,60,29,15,45,73,325,9.2
1395,Brady Manek\brady-manek-1,2017-18,Oklahoma,F,32,26,759,124,266,.466,65,112,.580,59,154,.383,18,30,.600,40,125,165,15,11,22,23,30,325,7.8
1396,Romello White\romello-white-1,2017-18,Arizona State,F,31,29,752,120,184,.652,120,184,.652,0,0,,85,154,.552,79,141,220,13,8,23,44,100,325,8.5
1397,Shaquille Morris\shaquille-morris-1,2016-17,Wichita State,F,34,23,611,125,239,.523,121,225,.538,4,14,.286,71,90,.789,40,132,172,36,12,35,40,80,325,7.6
1398,Nate Navigato\nate-navigato-1,2016-17,Toledo,F,34,9,946,98,244,.402,29,75,.387,69,169,.408,59,73,.808,20,80,100,50,17,14,31,48,324,7.0
1399,Samir Sehic\samir-sehic-1,2017-18,Tulane,F,31,0,631,111,194,.572,93,142,.655,18,52,.346,84,118,.712,74,88,162,24,10,14,35,67,324,8.8
1400,Jaleel Hogan\jaleel-hogan-1,2015-16,Detroit Mercy,F,31,31,690,132,229,.576,132,229,.576,0,0,,60,106,.566,65,63,128,28,17,23,56,112,324,6.9
1401,Tyler Scanlon\tyler-scanlon-1,2017-18,Boston University,F,31,30,968,111,249,.446,64,129,.496,47,120,.392,55,71,.775,31,141,172,94,44,4,60,54,324,9.1
1402,Stephon Jelks\stephon-jelks-1,2017-18,Mercer,F,34,34,889,116,222,.523,72,123,.585,44,99,.444,48,62,.774,60,186,246,56,23,13,43,85,324,8.9
1403,Secean Johnson\secean-johnson-1,2016-17,UC-Riverside,F,27,25,816,94,260,.362,72,185,.389,22,75,.293,114,149,.765,41,115,156,42,33,12,62,86,324,7.5
1404,Lorenzo Cugini\lorenzo-cugini-1,2014-15,High Point,F,33,24,956,116,224,.518,61,102,.598,55,122,.451,37,42,.881,34,125,159,33,7,3,26,49,324,7.9
1405,Matisse Thybulle\matisse-thybulle-1,2016-17,Washington,F,31,31,928,117,261,.448,64,130,.492,53,131,.405,37,44,.841,25,71,96,55,65,22,63,90,324,7.9
1406,Chaise Daniels\chaise-daniels-1,2017-18,Quinnipiac,F,30,9,633,122,231,.528,122,231,.528,0,0,,80,122,.656,39,80,119,14,11,30,67,95,324,6.1
1407,Majok Majok\majok-majok-1,2013-14,Ball State,F,29,28,865,123,225,.547,123,225,.547,0,0,,78,134,.582,100,189,289,33,10,24,75,93,324,8.9
1408,Brent Calhoun\brent-calhoun-1,2016-17,Purdue-Fort Wayne,F,33,33,675,140,244,.574,139,242,.574,1,2,.500,42,62,.677,64,138,202,31,14,51,57,90,323,8.0
1409,Justin Browning\justin-browning-1,2015-16,Western Carolina,F,33,32,1031,115,223,.516,94,158,.595,21,65,.323,72,112,.643,63,135,198,55,73,33,63,114,323,9.3
1410,Octavius Ellis\octavius-ellis-1,2015-16,Cincinnati,F,33,32,835,117,214,.547,117,214,.547,0,0,,89,139,.640,94,154,248,38,26,50,72,96,323,8.8
1411,Thomas Bruce\thomas-bruce-1,2017-18,Binghamton,F,29,28,903,132,221,.597,132,220,.600,0,1,.000,59,109,.541,56,200,256,37,17,61,51,79,323,10.5
1412,John Simons\john-simons-1,2015-16,Central Michigan,F,33,33,1146,96,249,.386,21,44,.477,75,205,.366,56,75,.747,53,186,239,29,18,6,29,69,323,7.8
1413,Dorian Finney-Smith\dorian-finney-smith-1,2013-14,Florida,F,37,2,950,105,283,.371,66,151,.437,39,132,.295,74,115,.643,94,153,247,76,16,16,61,80,323,6.7
1414,Anton Grady\anton-gandy-1,2013-14,Cleveland State,F,31,31,762,129,271,.476,128,263,.487,1,8,.125,64,101,.634,70,141,211,53,23,30,54,114,323,7.8
1415,Devin Robinson\devin-robinson-1,2015-16,Florida,F,36,18,833,114,250,.456,78,144,.542,36,106,.340,59,77,.766,62,139,201,17,18,21,29,87,323,7.0
1416,Traylin Farris\traylin-farris-1,2016-17,Portland State,F,30,22,668,126,204,.618,125,199,.628,1,5,.200,70,114,.614,50,105,155,18,20,28,23,95,323,9.0
1417,Miryne Thomas\miryne-thomas-1,2017-18,Maryland-Eastern Shore,F,29,27,764,116,265,.438,108,214,.505,8,51,.157,83,127,.654,72,154,226,25,17,11,73,99,323,6.6
1418,Trey Kellum\trey-kellum-1,2016-17,Southeast Missouri State,F,28,23,692,114,214,.533,114,214,.533,0,0,,95,131,.725,80,97,177,15,22,10,54,100,323,8.4
1419,Admassu Williams\admassu-williams-1,2015-16,Prairie View,F,31,31,811,117,240,.488,117,240,.488,0,0,,88,139,.633,75,121,196,20,12,20,85,78,322,6.2
1420,Jo Acuil\jo-acuil-1,2016-17,Baylor,F,35,35,914,134,244,.549,126,220,.573,8,24,.333,46,93,.495,80,154,234,12,12,87,39,81,322,8.5
1421,Ryan Sawvell\ryan-sawvell-1,2016-17,Wofford,F,33,33,980,122,234,.521,94,167,.563,28,67,.418,50,69,.725,65,153,218,62,12,6,45,61,322,8.5
1422,Karachi Edo\karachi-edo-1,2015-16,Fresno State,F,32,30,785,125,225,.556,125,224,.558,0,1,.000,72,123,.585,103,99,202,13,12,52,31,81,322,9.1
1423,Badou Diagne\badou-diagne-1,2014-15,Coastal Carolina,F,34,34,936,114,233,.489,85,166,.512,29,67,.433,65,99,.657,67,181,248,24,26,33,67,90,322,7.5
1424,Abayomi Iyiola\abayomi-iyiola-1,2017-18,Stetson,F,32,8,615,139,268,.519,139,265,.525,0,3,.000,44,65,.677,77,122,199,5,16,21,35,97,322,7.3
1425,Ishmael Lane\ishmael-lane-1,2015-16,Northwestern State,F,28,27,703,120,212,.566,120,211,.569,0,1,.000,82,121,.678,56,102,158,16,20,27,44,86,322,8.8
1426,Gabe Levin\gabe-levin-1,2013-14,Loyola Marymount,F,29,29,906,108,261,.414,98,220,.445,10,41,.244,96,126,.762,69,139,208,26,20,34,50,80,322,8.3
1427,Demajeo Wiggins\demajeo-wiggins-1,2016-17,Bowling Green State,F,32,32,787,113,231,.489,113,231,.489,0,0,,96,157,.611,89,161,250,22,11,18,54,63,322,7.9
1428,David Andoh\david-andoh-1,2014-15,Liberty,F,32,15,821,123,290,.424,123,282,.436,0,8,.000,75,97,.773,65,113,178,18,14,12,84,76,321,5.0
1429,Temidayo Yussuf\temidayo-yussuf-1,2016-17,Cal State Long Beach,F,34,28,642,122,232,.526,122,232,.526,0,0,,77,130,.592,63,95,158,47,7,17,64,96,321,6.1
1430,Brayon Blake\brayon-blake-1,2016-17,Idaho,F,32,10,682,118,276,.428,96,211,.455,22,65,.338,63,90,.700,58,136,194,23,15,7,38,81,321,6.6
1431,Dantiel Daniels\dantiel-daniels-1,2015-16,Colorado State,F,34,34,952,120,194,.619,120,194,.619,0,0,,81,142,.570,121,139,260,22,16,27,40,76,321,9.3
1432,Deion James\deion-james-2,2017-18,Colorado State,F,31,21,800,125,276,.453,112,226,.496,13,50,.260,58,82,.707,71,94,165,51,20,19,55,97,321,7.1
1433,Ramone Snowden\ramone-snowden-1,2014-15,Niagara,F,30,30,980,98,252,.389,55,126,.437,43,126,.341,82,131,.626,43,136,179,70,34,14,64,84,321,7.7
1434,Eric Adams\eric-adams-2,2017-18,Samford,F,32,30,765,126,185,.681,126,185,.681,0,0,,69,93,.742,80,127,207,18,43,46,45,90,321,10.4
1435,Cole Huff\cole-huff-1,2016-17,Creighton,F,35,35,805,106,231,.459,44,97,.454,62,134,.463,47,56,.839,19,118,137,22,14,4,22,61,321,6.6
1436,Beau Levesque\beau-levesque-1,2013-14,Saint Mary's (CA),F,35,32,903,110,252,.437,80,165,.485,30,87,.345,71,91,.780,55,129,184,80,24,8,64,90,321,7.0
1437,Milik Yarbrough\milik-yarbrough-1,2014-15,Saint Louis,F,32,22,759,129,274,.471,124,249,.498,5,25,.200,58,102,.569,52,102,154,47,20,12,68,64,321,6.2
1438,Ryan Welage\ryan-welage-1,2015-16,San Jose State,F,31,26,817,122,301,.405,74,168,.440,48,133,.361,29,55,.527,29,133,162,39,21,3,45,71,321,6.0
1439,Yuta Watanabe\yuta-watanabe-1,2015-16,George Washington,F,38,37,1051,111,263,.422,77,152,.507,34,111,.306,65,92,.707,37,115,152,53,21,40,43,73,321,6.4
1440,Terry Winn\terry-winn-1,2015-16,Texas-El Paso,F,32,26,741,121,237,.511,120,236,.508,1,1,1.000,78,149,.523,55,149,204,19,16,25,46,108,321,6.7
1441,Zach Smith\zach-smith-1,2015-16,Texas Tech,F,32,32,1046,119,233,.511,115,211,.545,4,22,.182,79,120,.658,57,177,234,56,28,47,50,52,321,9.7
1442,Kyle Richardson\kyle-richardson-1,2013-14,Portland State,F,32,32,872,134,226,.593,134,226,.593,0,0,,52,86,.605,87,115,202,20,22,34,61,101,320,8.0
1443,Roschon Prince\roschon-prince-1,2016-17,Cal State Long Beach,F,34,20,878,104,223,.466,104,223,.466,0,0,,112,147,.762,63,172,235,35,21,12,58,82,320,7.4
1444,Phil Fayne\phil-fayne-1,2016-17,Illinois State,F,35,33,861,128,217,.590,128,217,.590,0,0,,64,116,.552,88,134,222,16,20,40,35,80,320,8.4
1445,William Powell\william-powell-1,2016-17,Seattle,F,30,30,906,105,209,.502,105,205,.512,0,4,.000,110,150,.733,40,117,157,96,29,11,102,74,320,7.8
1446,Jaylen Bond\jaylen-bond-1,2015-16,Temple,F,31,30,904,149,315,.473,146,291,.502,3,24,.125,19,49,.388,102,162,264,42,32,13,42,91,320,8.4
1447,Vladimir Brodziansky\vladimir-brodziansky-1,2015-16,Texas Christian,F,33,17,720,120,231,.519,106,188,.564,14,43,.326,66,96,.688,58,92,150,18,8,34,41,71,320,7.2
1448,Blake Reynolds\blake-reynolds-1,2017-18,Yale,F,30,28,851,132,272,.485,100,159,.629,32,113,.283,24,35,.686,43,123,166,73,28,7,59,77,320,8.0
1449,D.J. Mason\dj-mason-1,2015-16,Campbell,F,30,21,734,135,274,.493,121,226,.535,14,48,.292,36,73,.493,62,126,188,58,24,12,44,80,320,8.2
1450,Coty Clarke\coty-clarke-1,2013-14,Arkansas,F,34,30,752,105,238,.441,80,180,.444,25,58,.431,85,105,.810,47,143,190,81,51,18,45,103,320,8.7
1451,T.J. Hallice\tj-hallice-1,2014-15,Mercer,F,35,34,1158,127,256,.496,124,240,.517,3,16,.188,63,108,.583,91,138,229,44,27,23,36,74,320,8.2
1452,Derail Green\derail-green-1,2015-16,Incarnate Word,F,29,26,794,115,256,.449,95,206,.461,20,50,.400,70,85,.824,34,91,125,58,15,9,55,70,320,7.3
1453,Greg Mays\greg-mays-1,2013-14,Green Bay,F,31,30,788,130,222,.586,127,213,.596,3,9,.333,57,88,.648,40,120,160,23,17,31,46,64,320,8.1
1454,Jalen Jackson\jalen-jackson-1,2016-17,Little Rock,F,32,16,797,119,253,.470,100,211,.474,19,42,.452,63,81,.778,30,109,139,56,25,23,59,61,320,7.3
1455,T.J. Maston\tj-maston-1,2017-18,Baylor,F,28,2,644,139,261,.533,136,246,.553,3,15,.200,39,54,.722,64,96,160,19,10,8,42,46,320,8.2
1456,Trahson Burrell\trahson-burrell-1,2015-16,Memphis,F,32,10,766,114,268,.425,85,177,.480,29,91,.319,63,78,.808,72,125,197,87,35,22,42,79,320,9.3
1457,Drick Bernstine\drick-bernstine-1,2015-16,North Dakota,F,33,33,993,134,271,.494,133,269,.494,1,2,.500,50,105,.476,62,237,299,72,36,20,81,110,319,7.6
1458,Roquez Johnson\roquez-johnson-1,2013-14,Mississippi State,F,33,8,781,114,239,.477,114,233,.489,0,6,.000,91,147,.619,64,88,152,17,18,4,47,72,319,6.2
1459,Ishmael Lane\ishmael-lane-1,2016-17,Northwestern State,F,29,28,739,117,223,.525,115,220,.523,2,3,.667,83,142,.585,56,125,181,26,17,20,55,64,319,8.0
1460,Jeantal Cylla\jeantal-cylla-1,2015-16,Florida Atlantic,F,33,25,870,105,272,.386,61,144,.424,44,128,.344,65,89,.730,25,89,114,16,18,15,44,85,319,5.1
1461,Bud Thomas\bud-thomas-1,2013-14,Mercer,F,36,36,935,123,267,.461,55,92,.598,68,175,.389,5,13,.385,23,120,143,72,22,13,32,68,319,7.0
1462,Joey King\joey-king-1,2014-15,Minnesota,F,33,33,961,110,237,.464,55,103,.534,55,134,.410,44,53,.830,30,69,99,50,17,13,48,80,319,6.6
1463,Mike Watkins\mike-watkins-1,2016-17,Penn State,F,33,24,786,128,218,.587,128,218,.587,0,0,,63,98,.643,81,182,263,20,26,89,44,83,319,10.3
1464,Jordan Swopshire\jordan-swopshire-1,2015-16,Colgate,F,30,26,759,103,224,.460,40,80,.500,63,144,.438,50,66,.758,27,113,140,29,11,6,51,55,319,7.1
1465,Kavon Waller\kavon-waller-1,2016-17,Delaware State,F,32,29,986,111,259,.429,38,83,.458,73,176,.415,24,36,.667,26,100,126,49,9,13,49,87,319,6.1
1466,Leon Gilmore\leon-gilmore-1,2017-18,Stephen F. Austin,F,35,33,812,117,228,.513,109,197,.553,8,31,.258,77,119,.647,45,130,175,46,35,17,59,70,319,7.2
1467,Bennett Koch\bennett-koch-1,2016-17,Northern Iowa,F,29,26,588,110,193,.570,110,192,.573,0,1,.000,99,130,.762,34,75,109,13,13,21,67,86,319,6.8
1468,Jamaal Samuel\jamaal-samuel-1,2015-16,Louisiana-Monroe,F,34,33,865,130,296,.439,90,191,.471,40,105,.381,18,27,.667,40,116,156,19,15,23,41,77,318,5.7
1469,Oscar Frayer\oscar-frayer-1,2017-18,Grand Canyon,F,33,28,873,121,251,.482,80,139,.576,41,112,.366,35,64,.547,56,115,171,41,41,24,48,80,318,7.9
1470,Marcus Weathers\marcus-weathers-1,2016-17,Miami (OH),F,32,11,798,100,197,.508,86,157,.548,14,40,.350,104,152,.684,64,125,189,28,28,21,49,90,318,8.1
1471,John Davis\john-davis-4,2016-17,Towson,F,27,3,620,126,239,.527,121,216,.560,5,23,.217,61,90,.678,58,147,205,21,15,13,39,66,318,9.2
1472,Anthony Gill\anthony-gill-1,2013-14,Virginia,F,37,6,732,111,189,.587,111,189,.587,0,0,,96,153,.627,49,99,148,16,11,20,41,77,318,6.4
1473,Che Bob\che-bob-1,2017-18,Colorado State,F,32,28,807,105,244,.430,87,182,.478,18,62,.290,90,133,.677,56,134,190,56,31,38,76,94,318,7.3
1474,Omar Sherman\omar-sherman-1,2016-17,Louisiana Tech,F,33,33,680,136,234,.581,134,216,.620,2,18,.111,44,69,.638,54,112,166,26,14,36,52,73,318,7.5
1475,Dan Jennings\dan-jennings-1,2013-14,Cal State Long Beach,F,32,30,861,136,229,.594,136,229,.594,0,0,,45,100,.450,104,163,267,16,17,35,53,92,317,8.6
1476,Antonnio Benton\antonnio-benton-1,2013-14,Southeastern Louisiana,F,27,25,816,117,249,.470,102,202,.505,15,47,.319,68,96,.708,44,125,169,37,15,22,73,62,317,7.6
1477,Tomasz Gielo\tomasz-gielo-1,2015-16,Mississippi,F,32,25,877,110,283,.389,56,129,.434,54,154,.351,43,53,.811,27,111,138,51,17,13,36,85,317,6.3
1478,Alex Poythress\alex-poythress-1,2015-16,Kentucky,F,31,23,732,119,198,.601,112,175,.640,7,23,.304,72,102,.706,55,132,187,10,19,21,37,112,317,8.1
1479,Spencer Weisz\spencer-weisz-1,2016-17,Princeton,F,30,30,994,112,288,.389,51,115,.443,61,173,.353,32,46,.696,24,137,161,125,46,9,48,66,317,9.3
1480,Marek Olesinski\marek-olesinski-1,2013-14,Air Force,F,30,28,904,107,249,.430,60,109,.550,47,140,.336,56,72,.778,34,113,147,50,18,10,47,72,317,7.4
1481,J.R. Holder\jr-holder-1,2015-16,Jacksonville,F,32,21,740,99,219,.452,80,159,.503,19,60,.317,100,142,.704,44,78,122,42,29,9,52,66,317,7.1
1482,Dustin Hogue\dustin-hogue-1,2014-15,Iowa State,F,34,34,892,117,210,.557,89,145,.614,28,65,.431,55,100,.550,55,111,166,38,23,11,53,86,317,7.1
1483,Donte Grantham\donte-grantham-1,2015-16,Clemson,F,31,31,1010,108,281,.384,52,123,.423,56,158,.354,44,52,.846,33,93,126,72,31,15,44,61,316,7.5
1484,J.P. Tokoto\jp-tokoto-1,2014-15,North Carolina,F,38,34,1106,116,271,.428,104,239,.435,12,32,.375,72,117,.615,61,152,213,163,56,13,85,91,316,7.9
1485,Brandon Nazione\brandon-nazione-1,2015-16,Eastern Michigan,F,33,33,891,110,203,.542,99,181,.547,11,22,.500,85,115,.739,59,153,212,36,37,13,50,90,316,8.4
1486,Anthony Livingston\anthony-livingston-1,2016-17,Texas Tech,F,32,29,755,111,258,.430,56,120,.467,55,138,.399,39,53,.736,19,96,115,35,5,4,31,58,316,6.1
1487,Jacoby Armstrong\jacoby-armstrong-1,2014-15,New Hampshire,F,32,26,785,124,241,.515,122,231,.528,2,10,.200,66,105,.629,49,82,131,34,12,16,54,103,316,6.0
1488,Ryan Spangler\ryan-spangler-1,2013-14,Oklahoma,F,33,33,964,115,197,.584,112,186,.602,3,11,.273,83,121,.686,107,200,307,45,18,31,39,94,316,10.3
1489,Rodney Williams\rodney-williams-5,2015-16,Drexel,F,30,28,785,107,234,.457,107,234,.457,0,0,,102,151,.675,62,105,167,37,11,32,45,106,316,7.4
1490,Danrad Knowles\danrad-knowles-1,2014-15,Houston,F,32,31,877,108,267,.404,71,152,.467,37,115,.322,63,100,.630,69,111,180,34,17,42,43,80,316,7.3
1491,Perris Blackwell\perris-blackwell-1,2013-14,Washington,F,31,25,852,124,230,.539,124,230,.539,0,0,,67,107,.626,96,114,210,29,15,24,39,88,315,8.6
1492,Angel Nunez\angel-nunez-1,2015-16,South Florida,F,33,29,958,118,302,.391,95,205,.463,23,97,.237,56,84,.667,41,159,200,33,24,22,71,62,315,5.5
1493,Austin Nichols\austin-nichols-2,2013-14,Memphis,F,34,33,774,139,236,.589,139,235,.591,0,1,.000,37,69,.536,43,102,145,17,12,42,34,48,315,7.5
1494,Cinmeon Bowers\cinmeon-bowers-1,2015-16,Auburn,F,30,20,854,104,282,.369,89,221,.403,15,61,.246,92,170,.541,64,225,289,47,29,13,88,70,315,6.5
1495,Josh Ferguson\josh-ferguson-1,2017-18,Winthrop,F,31,26,812,123,202,.609,119,184,.647,4,18,.222,65,86,.756,68,161,229,28,21,34,56,67,315,9.4
1496,Tyler Wideman\tyler-wideman-1,2017-18,Butler,F,34,34,696,121,180,.672,121,177,.684,0,3,.000,73,89,.820,77,98,175,17,18,14,45,96,315,8.0
1497,J.P. Tokoto\jp-tokoto-1,2013-14,North Carolina,F,34,33,975,129,264,.489,121,228,.531,8,36,.222,49,98,.500,65,132,197,104,55,18,64,92,315,8.4
1498,M.J. Rhett\mj-rhett-1,2013-14,Tennessee State,F,29,29,947,112,207,.541,112,207,.541,0,0,,91,126,.722,87,178,265,22,17,29,62,97,315,9.2
1499,Branden Dawson\branden-dawson-1,2013-14,Michigan State,F,28,24,792,136,222,.613,136,221,.615,0,1,.000,42,64,.656,83,150,233,46,35,25,36,41,314,12.1
1500,Justin Gorham\justin-gorham-1,2017-18,Towson,F,32,9,735,119,221,.538,116,207,.560,3,14,.214,73,103,.709,75,140,215,24,11,6,49,79,314,7.5
1501,Klint Carlson\klint-carlson-1,2017-18,Northern Iowa,F,32,32,1042,120,285,.421,86,178,.483,34,107,.318,40,58,.690,40,159,199,51,21,11,58,73,314,6.5
1502,Tom Rivard\tom-rivard-1,2015-16,Colgate,F,30,18,730,123,253,.486,90,158,.570,33,95,.347,35,57,.614,39,98,137,34,17,17,50,91,314,6.7
1503,Trey Burch-Manning\trey-burch-manning-1,2016-17,South Dakota,F,34,34,914,113,252,.448,108,238,.454,5,14,.357,83,142,.585,65,162,227,42,26,8,70,109,314,5.9
1504,Landon Atterberry\landon-atterberry-1,2013-14,Long Island University,F,29,23,696,131,252,.520,116,205,.566,15,47,.319,37,68,.544,37,81,118,9,17,11,40,85,314,6.4
1505,Desmond Ringer\desmond-ringer-1,2017-18,Mercer,F,34,34,867,118,199,.593,116,194,.598,2,5,.400,76,93,.817,71,118,189,16,9,12,58,88,314,6.9
1506,Brandon Taylor\brandon-taylor-2,2013-14,Penn State,F,34,30,848,105,266,.395,59,123,.480,46,143,.322,57,65,.877,41,126,167,19,5,36,33,98,313,6.0
1507,Tevin Glass\tevin-glass-1,2016-17,East Tennessee State,F,35,34,785,115,213,.540,112,198,.566,3,15,.200,80,110,.727,62,157,219,31,27,19,51,71,313,7.7
1508,Bennie Boatwright\bennie-boatwright-1,2017-18,Southern California,F,23,18,638,107,258,.415,61,125,.488,46,133,.346,53,73,.726,39,108,147,45,7,19,32,42,313,10.0
1509,Tiegbe Bamba\tiegbe-bamba-1,2014-15,Portland State,F,27,20,822,111,202,.550,97,163,.595,14,39,.359,77,112,.688,52,131,183,30,33,5,46,66,313,9.7
1510,Trey Lyles\trey-lyles-1,2014-15,Kentucky,F,36,21,828,117,240,.488,113,211,.536,4,29,.138,75,102,.735,65,123,188,38,19,16,41,57,313,7.1
1511,Jermaine Crumpton\jermaine-crumpton-1,2015-16,Canisius,F,30,0,652,114,268,.425,76,162,.469,38,106,.358,47,68,.691,29,64,93,25,16,7,27,60,313,6.3
1512,DeSean Murray\desean-murray-1,2014-15,Presbyterian,F,20,20,661,122,235,.519,121,231,.524,1,4,.250,68,115,.591,70,93,163,32,30,10,54,55,313,11.9
1513,D.J. Shelton\dj-shelton-1,2013-14,Washington State,F,31,29,955,108,272,.397,82,161,.509,26,111,.234,71,90,.789,68,229,297,46,23,12,59,60,313,8.2
1514,Matt McMullen\matt-mcmullen-1,2014-15,Colgate,F,33,33,1086,109,208,.524,61,110,.555,48,98,.490,47,57,.825,35,180,215,69,34,25,57,81,313,9.0
1515,Kris Acox\kris-acox-1,2015-16,Furman,F,35,34,804,135,220,.614,135,219,.616,0,1,.000,43,87,.494,84,120,204,18,25,20,49,77,313,7.5
1516,Hassan Martin\hassan-martin-1,2015-16,Rhode Island,F,26,25,727,125,219,.571,124,215,.577,1,4,.250,62,101,.614,55,90,145,24,18,65,48,78,313,10.0
1517,Logan McLane\logan-mclane-1,2017-18,Miami (OH),F,34,27,789,132,250,.528,120,204,.588,12,46,.261,37,74,.500,52,130,182,23,32,26,56,66,313,6.9
1518,Spencer Weisz\spencer-weisz-1,2015-16,Princeton,F,29,29,921,106,253,.419,43,93,.462,63,160,.394,38,47,.809,23,129,152,113,25,4,40,62,313,9.4
1519,Demario Beck\demario-beck-1,2017-18,Coastal Carolina,F,32,13,762,124,230,.539,105,162,.648,19,68,.279,45,76,.592,79,150,229,22,16,22,55,98,312,7.5
1520,James Siakam\james-siakam-1,2014-15,Vanderbilt,F,34,20,827,99,158,.627,97,155,.626,2,3,.667,112,148,.757,91,110,201,22,33,42,44,102,312,9.3
1521,Keith Fisher III\kieth-fisheriii-1,2017-18,San Jose State,F,30,30,769,122,248,.492,122,248,.492,0,0,,68,105,.648,56,134,190,26,25,7,61,97,312,6.7
1522,Tyler Seibring\tyler-seibring-1,2015-16,Elon,F,32,31,899,116,250,.464,57,100,.570,59,150,.393,21,32,.656,41,112,153,62,15,17,28,78,312,7.9
1523,Keonta Vernon\keonta-vernon-1,2017-18,Grand Canyon,F,34,34,781,125,242,.517,125,238,.525,0,4,.000,62,111,.559,78,149,227,46,26,39,42,116,312,7.9
1524,Tyler Gaskins\tyler-gaskins-1,2014-15,Saint Peter's,F,34,34,937,115,280,.411,67,153,.438,48,127,.378,34,61,.557,24,57,81,58,28,4,63,69,312,4.9
1525,Taurean Thompson\taurean-thompson-1,2016-17,Syracuse,F,34,21,607,130,237,.549,127,221,.575,3,16,.188,49,76,.645,47,83,130,19,23,32,44,84,312,6.7
1526,Quatarrius Wilson\quatarrius-wilson-1,2017-18,McNeese State,F,29,26,868,125,247,.506,119,222,.536,6,25,.240,56,91,.615,105,192,297,39,22,28,67,69,312,9.7
1527,Shane Hammink\shane-hammink-1,2015-16,Valparaiso,F,35,10,772,112,225,.498,90,153,.588,22,72,.306,66,84,.786,20,89,109,61,26,10,70,74,312,6.0
1528,Zack Moore\zack-moore-1,2016-17,Seattle,F,30,16,798,101,243,.416,27,48,.563,74,195,.379,36,41,.878,14,102,116,27,24,5,29,61,312,7.1
1529,Connor Boehm\connor-boehm-1,2015-16,Dartmouth,F,28,28,786,128,256,.500,111,207,.536,17,49,.347,39,75,.520,69,82,151,58,20,4,46,82,312,8.1
1530,Wajid Aminu\al-wajid-aminu-1,2016-17,North Florida,F,34,26,884,123,227,.542,115,199,.578,8,28,.286,57,116,.491,90,130,220,25,14,36,71,121,311,6.4
1531,Tarique Thompson\tarique-thompson-1,2016-17,High Point,F,31,3,734,126,221,.570,118,201,.587,8,20,.400,51,66,.773,61,100,161,21,26,17,42,75,311,8.2
1532,Nino Johnson\nino-johnson-1,2014-15,Southeast Missouri State,F,30,30,874,123,228,.539,123,227,.542,0,1,.000,65,126,.516,70,141,211,36,41,64,63,89,311,9.3
1533,Deionte Simmons\deionte-simmons-1,2017-18,Chicago State,F,26,18,595,116,194,.598,116,194,.598,0,0,,79,114,.693,63,90,153,5,21,11,44,77,311,9.1
1534,C.J. Bobbitt\cj-bobbitt-1,2016-17,Denver,F,30,28,780,122,247,.494,99,185,.535,23,62,.371,44,62,.710,39,104,143,31,13,4,51,91,311,6.3
1535,Andrew Fleming\andrew-fleming-3,2017-18,Maine,F,32,32,857,119,289,.412,113,256,.441,6,33,.182,67,97,.691,61,109,170,42,17,25,83,106,311,4.9
1536,Jakob Poeltl\jakob-poeltl-1,2014-15,Utah,F,34,34,792,128,188,.681,128,187,.684,0,1,.000,55,124,.444,92,138,230,23,12,63,55,82,311,8.6
1537,Tim Huskisson\tim-huskisson-1,2014-15,Northern Colorado,F,29,7,623,109,189,.577,89,136,.654,20,53,.377,73,101,.723,50,65,115,36,27,12,46,97,311,8.3
1538,Josip Vrankic\josip-vrankic-1,2017-18,Santa Clara,F,30,26,896,106,260,.408,74,151,.490,32,109,.294,67,94,.713,35,98,133,49,31,24,67,97,311,6.4
1539,Tre'Darius McCallum\tredarius-mccallum-1,2016-17,DePaul,F,32,32,993,124,280,.443,102,202,.505,22,78,.282,41,55,.745,49,168,217,43,49,26,52,92,311,7.9
1540,Simon Okolue\simon-okolue-1,2017-18,Delaware State,F,27,25,720,134,219,.612,134,218,.615,0,1,.000,43,68,.632,77,114,191,7,16,29,43,88,311,9.3
1541,D.J. Felder\dj-felder-1,2014-15,Jacksonville State,F,31,23,715,122,289,.422,110,252,.437,12,37,.324,55,80,.688,58,111,169,23,12,21,40,83,311,6.2
1542,Nick Allen\nick-allen-1,2017-18,Texas-San Antonio,F,35,35,869,119,231,.515,86,154,.558,33,77,.429,40,59,.678,59,119,178,36,16,14,58,98,311,6.3
1543,Marvin Prochet\marvin-prochet-1,2016-17,Niagara,F,33,30,1004,118,297,.397,87,195,.446,31,102,.304,44,54,.815,55,126,181,42,21,37,37,83,311,6.9
1544,Michale Kyser\michale-kyser-1,2014-15,Louisiana Tech,F,36,35,1022,127,209,.608,127,209,.608,0,0,,57,94,.606,79,157,236,15,23,102,29,96,311,9.5
1545,Gibson Johnson\gibson-johnson-1,2017-18,Hawaii,F,30,29,698,112,209,.536,104,189,.550,8,20,.400,79,116,.681,48,92,140,40,19,19,44,79,311,8.0
1546,Robert Williams\robert-williams-3,2017-18,Texas A&M,F,30,23,769,139,220,.632,139,208,.668,0,12,.000,33,70,.471,71,206,277,43,24,78,52,66,311,11.3
1547,Christian Sengfelder\christian-sengfelder-1,2015-16,Fordham,F,30,30,915,106,248,.427,55,120,.458,51,128,.398,47,59,.797,53,103,156,30,23,8,44,80,310,7.2
1548,Pauly Paulicap\pauly-paulicap-1,2017-18,Manhattan,F,31,31,734,111,199,.558,111,199,.558,0,0,,88,142,.620,92,122,214,8,8,78,50,106,310,8.7
1549,Jeremy Combs\jeremy-combs-1,2014-15,North Texas,F,31,26,794,120,214,.561,120,214,.561,0,0,,70,144,.486,79,130,209,10,29,22,40,90,310,8.0
1550,Reese Holliday\reese-holliday-1,2014-15,Missouri-Kansas City,F,32,29,831,93,215,.433,62,133,.466,31,82,.378,93,122,.762,44,115,159,38,24,4,64,69,310,6.6
1551,Kipper Nichols\kipper-nichols-1,2017-18,Illinois,F,31,9,590,99,226,.438,68,144,.472,31,82,.378,81,94,.862,44,85,129,23,25,11,36,71,310,7.3
1552,Michael Humphrey\michael-humphrey-1,2015-16,Stanford,F,30,26,726,128,260,.492,119,232,.513,9,28,.321,45,70,.643,57,134,191,23,30,38,45,95,310,8.0
1553,Brett Prahl\brett-prahl-1,2017-18,Milwaukee,F,33,32,981,130,209,.622,126,193,.653,4,16,.250,46,65,.708,58,107,165,44,18,46,62,66,310,8.3
1554,Tre'Darius McCallum\tredarius-mccallum-1,2017-18,DePaul,F,31,31,909,130,285,.456,104,193,.539,26,92,.283,24,38,.632,44,134,178,29,41,13,45,81,310,7.1
1555,Konstantinos Mitoglou\konstantinos-mitoglou-1,2014-15,Wake Forest,F,32,13,713,103,233,.442,51,98,.520,52,135,.385,51,71,.718,52,94,146,13,16,19,35,65,309,6.9
1556,Kyle Casey\kyle-casey-1,2013-14,Harvard,F,32,32,703,117,254,.461,110,228,.482,7,26,.269,68,100,.680,41,138,179,42,22,37,46,108,309,7.0
1557,Will Barrett\will-barrett-1,2013-14,Princeton,F,30,30,761,97,228,.425,34,63,.540,63,165,.382,52,69,.754,27,69,96,32,25,25,33,61,309,7.6
1558,Anthony Townes\anthony-townes-1,2016-17,Pacific,F,30,23,690,132,248,.532,132,248,.532,0,0,,45,73,.616,80,134,214,15,20,24,40,91,309,8.1
1559,Gregory Graves\gregory-graves-1,2015-16,Mount St. Mary's,F,33,32,892,104,272,.382,83,202,.411,21,70,.300,80,121,.661,61,122,183,25,30,22,54,82,309,6.0
1560,Nick Fuller\nick-fuller-1,2017-18,South Dakota,F,35,1,575,112,200,.560,101,160,.631,11,40,.275,74,93,.796,45,100,145,16,13,12,29,77,309,6.9
1561,Paul White\paul-white-1,2017-18,Oregon,F,33,24,771,103,218,.472,72,130,.554,31,88,.352,72,86,.837,46,68,114,51,20,15,31,112,309,7.1
1562,Jacoby Armstrong\jacoby-armstrong-1,2015-16,New Hampshire,F,28,7,674,118,256,.461,112,236,.475,6,20,.300,67,98,.684,47,101,148,17,10,8,42,91,309,6.3
1563,Ja'Dante' Frye\jadante-frye-1,2014-15,Nicholls State,F,29,26,797,116,229,.507,115,220,.523,1,9,.111,76,108,.704,38,57,95,26,28,6,50,42,309,7.2
1564,Shavon Coleman\shavon-coleman-1,2013-14,Louisiana State,F,34,23,860,106,253,.419,62,130,.477,44,123,.358,53,70,.757,31,116,147,64,50,11,54,69,309,7.2
1565,Franko House\franko-house-1,2014-15,Ball State,F,30,29,861,110,219,.502,107,193,.554,3,26,.115,86,122,.705,61,104,165,72,28,15,65,106,309,8.0
1566,Dominique Lee\dominique-lee-1,2014-15,Northern Colorado,F,30,27,776,118,196,.602,111,179,.620,7,17,.412,66,105,.629,82,140,222,26,36,27,31,93,309,10.3
1567,Hunter Harris\hunter-harris-1,2013-14,East Tennessee State,F,34,33,854,115,218,.528,112,204,.549,3,14,.214,76,118,.644,66,119,185,12,34,40,41,120,309,7.3
1568,Andrew Eudy\andrew-eudy-1,2017-18,Campbell,F,34,33,843,127,238,.534,103,185,.557,24,53,.453,31,39,.795,55,112,167,92,33,65,67,100,309,8.8
1569,Marek Olesinski\marek-olesinski-1,2014-15,Air Force,F,31,31,928,112,222,.505,67,107,.626,45,115,.391,39,56,.696,39,108,147,56,23,9,34,50,308,8.5
1570,Jae'Sean Tate\jaesean-tate-1,2014-15,Ohio State,F,35,16,771,126,214,.589,123,195,.631,3,19,.158,53,102,.520,66,109,175,12,31,21,42,88,308,7.0
1571,Kevin Hill\kevin-hill-1,2014-15,New Orleans,F,29,21,704,105,230,.457,105,230,.457,0,0,,98,131,.748,66,127,193,20,17,22,64,62,308,7.5
1572,Bruno Fernando\bruno-fernando-1,2017-18,Maryland,F,30,20,671,118,204,.578,117,201,.582,1,3,.333,71,96,.740,45,151,196,21,11,37,53,87,308,8.1
1573,Anthony Elechi\anthony-elechi-1,2015-16,Morehead State,F,37,37,726,120,225,.533,120,225,.533,0,0,,68,87,.782,100,104,204,13,16,11,37,125,308,6.4
1574,Obinna Oleka\obinna-oleka-1,2015-16,Arizona State,F,32,18,792,104,263,.395,77,177,.435,27,86,.314,73,94,.777,63,132,195,22,22,17,43,67,308,6.9
1575,V.J. King\vj-king-1,2017-18,Louisville,F,36,36,914,106,266,.398,82,191,.429,24,75,.320,72,98,.735,23,97,120,32,21,4,51,63,308,4.7
1576,Andrew Smith\andrew-smith-3,2014-15,Liberty,F,32,26,858,130,245,.531,130,238,.546,0,7,.000,48,73,.658,82,160,242,28,34,40,57,97,308,8.4
1577,Chinanu Onuaku\chinanu-onuaku-1,2015-16,Louisville,F,31,29,762,137,221,.620,137,220,.623,0,1,.000,33,56,.589,91,172,263,51,24,62,65,92,307,10.1
1578,Muusa Dama\muusa-dama-1,2017-18,Eastern Illinois,F,31,26,759,124,227,.546,123,224,.549,1,3,.333,58,82,.707,64,131,195,36,15,36,59,99,307,7.7
1579,Bryce Douvier\bryce-douvier-1,2014-15,Texas A&M-Corpus Christi,F,34,30,859,103,226,.456,69,142,.486,34,84,.405,67,81,.827,47,149,196,19,13,12,55,110,307,5.8
1580,Anthony Tarke\anthony-tarke-1,2016-17,NJIT,F,31,7,687,119,228,.522,92,154,.597,27,74,.365,42,72,.583,51,94,145,30,33,16,69,62,307,7.0
1581,Anthony Horton\anthony-horton-1,2013-14,Incarnate Word,F,26,25,705,118,228,.518,100,173,.578,18,55,.327,53,78,.679,34,91,125,36,17,19,57,78,307,7.8
1582,Travis McConico\travis-mcconico-1,2017-18,Charleston Southern,F,30,17,755,105,240,.438,44,83,.530,61,157,.389,36,51,.706,37,86,123,32,36,9,38,56,307,7.7
1583,Kyle Mallers\kyle-mallers-1,2017-18,Ball State,F,32,32,890,98,215,.456,64,114,.561,34,101,.337,77,90,.856,65,93,158,41,17,13,42,81,307,7.6
1584,Jordan Giles\jordan-giles-1,2017-18,Missouri-Kansas City,F,30,25,664,92,211,.436,75,141,.532,17,70,.243,106,142,.746,32,68,100,30,18,10,77,104,307,5.1
1585,Jordan Allen\jordan-allen-1,2015-16,Sacred Heart,F,30,30,787,118,219,.539,117,216,.542,1,3,.333,70,117,.598,76,85,161,60,32,5,56,113,307,7.9
1586,Marin Mornar\marin-mornar-1,2014-15,Loyola Marymount,F,31,22,829,113,220,.514,96,170,.565,17,50,.340,64,87,.736,62,102,164,24,4,47,40,72,307,8.0
1587,Dwayne Brown Jr.\dwayne-brownjr-1,2017-18,Utah State,F,34,33,871,115,257,.447,84,158,.532,31,99,.313,45,64,.703,49,120,169,47,21,8,57,90,306,5.9
1588,Will Regan\will-regan-1,2013-14,Buffalo,F,29,28,852,98,204,.480,63,109,.578,35,95,.368,75,95,.789,62,105,167,23,11,20,37,57,306,8.6
1589,Chris Davenport\chris-davenport-2,2016-17,North Florida,F,28,9,752,110,219,.502,83,139,.597,27,80,.338,59,81,.728,32,152,184,97,20,36,114,66,306,8.2
1590,Jesse Chuku\jesse-chuku-1,2015-16,Lehigh,F,32,32,1001,108,250,.432,53,114,.465,55,136,.404,35,43,.814,47,128,175,42,20,41,35,76,306,8.0
1591,Jonathan Arledge\jonathan-arledge-1,2014-15,Old Dominion,F,35,35,704,115,264,.436,99,204,.485,16,60,.267,60,98,.612,63,108,171,21,20,19,49,89,306,5.5
1592,Isaiah Philmore\isaiah-philmore-1,2013-14,Xavier,F,33,26,821,105,194,.541,105,187,.561,0,7,.000,96,136,.706,66,99,165,16,8,2,46,91,306,6.4
1593,Cody Joyce\cody-joyce-1,2013-14,Houston Baptist,F,31,20,703,123,236,.521,123,236,.521,0,0,,60,108,.556,48,71,119,19,11,10,40,58,306,6.3
1594,Yoeli Childs\yoeli-childs-1,2016-17,Brigham Young,F,33,26,854,122,223,.547,122,221,.552,0,2,.000,62,106,.585,62,209,271,41,19,46,57,80,306,8.4
1595,Sebastian Saiz\sebastian-saiz-1,2015-16,Mississippi,F,26,24,741,115,234,.491,113,224,.504,2,10,.200,73,112,.652,79,148,227,17,23,28,35,78,305,10.0
1596,Ray Crossland\ray-crossland-1,2016-17,Eastern Illinois,F,29,20,821,119,278,.428,107,240,.446,12,38,.316,55,77,.714,59,118,177,44,44,6,64,87,305,7.1
1597,Bogdan Bliznyuk\bogdan-bliznyuk-1,2014-15,Eastern Washington,F,35,0,665,112,191,.586,88,148,.595,24,43,.558,57,72,.792,45,96,141,39,19,14,47,84,305,7.0
1598,Connor Boehm\connor-boehm-1,2013-14,Dartmouth,F,28,26,760,127,240,.529,121,224,.540,6,16,.375,45,65,.692,58,98,156,29,13,0,51,70,305,7.3
1599,Mitchell Solomon\mitchell-solomon-1,2017-18,Oklahoma State,F,36,36,857,116,213,.545,109,182,.599,7,31,.226,66,75,.880,114,121,235,50,34,36,55,121,305,8.5
1600,Joel Angus III\joel-angusiii-1,2015-16,Southeast Missouri State,F,29,29,816,111,222,.500,111,220,.505,0,2,.000,83,115,.722,65,107,172,32,20,14,60,63,305,7.8
1601,Gabe Levin\gabe-levin-1,2015-16,Cal State Long Beach,F,32,30,835,108,215,.502,102,187,.545,6,28,.214,83,123,.675,71,117,188,47,29,27,61,95,305,7.8
1602,Worth Smith\worth-smith-1,2014-15,Navy,F,21,21,665,126,262,.481,101,204,.495,25,58,.431,28,36,.778,38,85,123,23,27,21,31,44,305,11.0
1603,Zarko Valjarevic\zarko-valjarevic-1,2013-14,Maine,F,27,27,849,106,232,.457,39,79,.494,67,153,.438,25,36,.694,5,47,52,38,13,0,28,40,304,7.1
1604,Jason Carter\jason-carter-5,2016-17,Ohio,F,31,15,642,114,225,.507,105,181,.580,9,44,.205,67,98,.684,61,141,202,18,20,20,37,70,304,7.9
1605,Trey Burch-Manning\trey-burch-manning-1,2017-18,South Dakota,F,35,35,873,117,233,.502,110,214,.514,7,19,.368,63,99,.636,57,177,234,51,33,3,45,95,304,7.3
1606,Auston Barnes\auston-barnes-1,2014-15,Bradley,F,31,29,993,100,253,.395,54,121,.446,46,132,.348,58,65,.892,43,105,148,29,34,16,53,75,304,6.7
1607,DeJuan Marrero\dejuan-marrero-1,2015-16,Morehead State,F,37,25,886,120,257,.467,120,257,.467,0,0,,64,123,.520,98,168,266,48,40,24,74,107,304,6.5
1608,Mark Gary\mark-gary-1,2014-15,Grambling,F,29,21,783,91,217,.419,74,174,.425,17,43,.395,105,139,.755,53,118,171,20,13,9,84,69,304,5.8
1609,Andrey Semenov\andrey-semenov-1,2013-14,James Madison,F,28,24,807,95,260,.365,48,119,.403,47,141,.333,67,88,.761,29,86,115,33,20,12,47,76,304,6.1
1610,Aaron Epps\aaron-epps-1,2017-18,Louisiana State,F,32,28,765,115,220,.523,80,117,.684,35,103,.340,39,51,.765,60,117,177,13,13,29,24,79,304,8.0
1611,Kennedy Meeks\kennedy-meeks-1,2015-16,North Carolina,F,33,28,679,131,239,.548,131,239,.548,0,0,,42,61,.689,80,116,196,34,27,34,46,74,304,8.2
1612,Trinity Hall\trinity-hall-1,2013-14,Missouri-Kansas City,F,30,28,808,112,250,.448,98,198,.495,14,52,.269,66,104,.635,52,114,166,26,23,18,57,91,304,6.3
1613,Kendrick Washington\kendrick-washington-1,2013-14,Arkansas State,F,30,29,932,110,206,.534,105,190,.553,5,16,.313,79,131,.603,54,143,197,48,23,18,58,105,304,7.8
1614,Lenjo Kilo\lenjo-kilo-1,2015-16,Savannah State,F,32,31,828,117,251,.466,109,223,.489,8,28,.286,62,120,.517,74,102,176,14,18,25,65,95,304,5.5
1615,Tom Tankelewicz\tom-tankelewicz-1,2013-14,Western Carolina,F,34,4,663,97,239,.406,30,60,.500,67,179,.374,42,46,.913,17,50,67,21,20,3,37,52,303,5.3
1616,Matthew McCarthy\matthew-mccarthy-1,2017-18,San Francisco,F,37,35,848,127,242,.525,122,213,.573,5,29,.172,44,77,.571,58,155,213,42,22,16,56,106,303,6.0
1617,James Dickey\james-dickey-1,2017-18,North Carolina-Greensboro,F,34,33,942,120,224,.536,120,224,.536,0,0,,63,108,.583,100,186,286,44,27,69,81,86,303,8.6
1618,Charles Mitchell\charles-mitchell-1,2014-15,Georgia Tech,F,31,18,684,124,238,.521,124,238,.521,0,0,,55,83,.663,109,109,218,12,11,14,66,79,303,6.9
1619,Donta Harper\donta-harper-1,2013-14,Gardner-Webb,F,30,30,816,111,260,.427,111,253,.439,0,7,.000,81,105,.771,36,83,119,55,31,15,69,85,303,6.1
1620,Jordan Caroline\jordan-caroline-1,2014-15,Southern Illinois,F,33,32,844,100,223,.448,98,220,.445,2,3,.667,101,153,.660,79,127,206,29,23,8,53,68,303,6.9
1621,Cameron McGriff\cameron-mcgriff-1,2017-18,Oklahoma State,F,36,17,868,96,200,.480,75,143,.524,21,57,.368,90,104,.865,79,116,195,36,28,19,50,92,303,7.4
1622,Mason Ramsey\mason-ramsay-1,2016-17,Tennessee Tech,F,32,30,851,118,232,.509,114,209,.545,4,23,.174,63,99,.636,64,75,139,41,32,9,52,114,303,6.6
1623,Xavier Ford\xavier-ford-1,2014-15,Buffalo,F,31,15,718,110,235,.468,91,179,.508,19,56,.339,63,91,.692,75,117,192,18,33,16,47,88,302,7.5
1624,Jack Whitman\jack-whitman-1,2016-17,William & Mary,F,30,26,662,105,159,.660,105,159,.660,0,0,,92,154,.597,61,101,162,37,8,34,46,85,302,8.6
1625,Peyton Aldridge\peyton-aldridge-1,2014-15,Davidson,F,32,30,972,111,241,.461,68,130,.523,43,111,.387,37,53,.698,58,105,163,49,13,35,26,93,302,7.9
1626,Trey Moses\trey-moses-1,2016-17,Ball State,F,33,32,902,119,212,.561,118,211,.559,1,1,1.000,63,118,.534,80,194,274,75,13,37,72,103,302,8.2
1627,Andre Berry\andre-berry-1,2017-18,Rhode Island,F,34,33,594,127,208,.611,127,208,.611,0,0,,48,68,.706,53,84,137,13,2,10,46,78,302,6.0
1628,Marc Loving\marc-loving-1,2014-15,Ohio State,F,32,18,759,96,209,.459,49,107,.458,47,102,.461,63,82,.768,40,76,116,20,16,10,37,67,302,6.6
1629,Karl Charles\karl-charles-1,2016-17,Holy Cross,F,32,30,994,83,195,.426,50,107,.467,33,88,.375,103,128,.805,21,84,105,115,51,4,64,90,302,8.2
1630,Steven Cook\steven-cook-1,2014-15,Princeton,F,29,23,835,95,215,.442,51,103,.495,44,112,.393,68,91,.747,21,78,99,44,45,10,51,62,302,7.8
1631,Jalen Johnson\jalen-johnson-2,2017-18,Saint Louis,F,33,24,896,91,217,.419,39,85,.459,52,132,.394,67,86,.779,30,97,127,22,12,21,42,76,301,6.0
1632,Cordell Pemsl\cordell-pemsl-1,2016-17,Iowa,F,34,14,655,116,188,.617,116,187,.620,0,1,.000,69,120,.575,61,108,169,37,25,24,53,84,301,7.4
1633,Nick Duncan\nick-duncan-1,2014-15,Boise State,F,32,31,1004,98,246,.398,22,48,.458,76,198,.384,29,35,.829,24,87,111,30,20,14,26,90,301,6.2
1634,Shannon Hale\shannon-hale-1,2015-16,Alabama,F,28,12,688,95,257,.370,52,126,.413,43,131,.328,68,91,.747,24,56,80,14,13,7,58,64,301,4.6
1635,Thik Bol\thik-bol-1,2016-17,Southern Illinois,F,33,33,968,129,242,.533,129,242,.533,0,0,,43,70,.614,80,144,224,10,9,76,37,77,301,8.3
1636,Mike Holloway\mike-holloway-1,2015-16,Fairleigh Dickinson,F,32,30,762,118,202,.584,118,202,.584,0,0,,65,103,.631,86,96,182,24,20,33,32,114,301,8.2
1637,Payton Banks\payton-banks-1,2015-16,Penn State,F,32,31,922,108,283,.382,68,160,.425,40,123,.325,45,61,.738,36,102,138,37,26,3,45,73,301,5.5
1638,Jaleel Williams\jaleel-williams-1,2014-15,San Jose State,F,27,26,870,110,265,.415,59,116,.509,51,149,.342,30,53,.566,28,99,127,22,13,5,41,46,301,6.4
1639,Gavin Ware\gavin-ware-1,2014-15,Mississippi State,F,30,25,803,110,220,.500,110,220,.500,0,0,,81,109,.743,62,150,212,9,11,32,45,70,301,7.8
1640,David Collette\david-collette-1,2016-17,Utah,F,22,22,558,124,207,.599,122,204,.598,2,3,.667,50,80,.625,39,74,113,23,17,20,34,73,300,10.3
1641,Jace Hogan\jace-hogan-1,2015-16,Navy,F,31,3,714,112,243,.461,112,242,.463,0,1,.000,76,104,.731,51,99,150,19,10,9,34,69,300,6.4
1642,Keith Stone\keith-stone-1,2017-18,Florida,F,34,26,817,98,224,.438,59,132,.447,39,92,.424,65,90,.722,53,94,147,24,20,29,46,91,300,6.2
1643,Austin Cooke\austin-cooke-1,2014-15,Abilene Christian,F,31,31,902,103,233,.442,50,110,.455,53,123,.431,41,52,.788,45,142,187,28,17,2,39,86,300,6.9
1644,Kevin Mays\kevin-mays-2,2014-15,Cal State Bakersfield,F,32,32,888,115,241,.477,115,236,.487,0,5,.000,70,95,.737,102,155,257,34,36,4,57,100,300,7.8
1645,Nick Duncan\nick-duncan-1,2016-17,Boise State,F,32,32,988,91,249,.365,20,41,.488,71,208,.341,47,67,.701,34,80,114,56,17,17,47,94,300,5.8
1646,Alihan Demir\alihan-demir-1,2017-18,Drexel,F,28,24,875,119,248,.480,96,185,.519,23,63,.365,39,52,.750,54,98,152,52,12,4,47,63,300,7.7
1647,Jodd Maxey\jodd-maxey-1,2013-14,South Carolina Upstate,F,34,34,871,124,226,.549,124,224,.554,0,2,.000,52,85,.612,74,137,211,40,37,38,38,99,300,8.4
1648,Abdul Lewis\abdul-lewis-1,2016-17,NJIT,F,31,31,848,109,245,.445,101,215,.470,8,30,.267,74,111,.667,86,178,264,44,16,16,67,101,300,7.1
1649,James Thomas\james-thomas-2,2013-14,Sam Houston State,F,35,35,942,102,201,.507,102,200,.510,0,1,.000,96,153,.627,64,64,128,36,12,2,51,79,300,5.6
1650,Zylan Cheatham\zylan-cheatham-1,2015-16,San Diego State,F,38,26,790,93,176,.528,90,159,.566,3,17,.176,111,155,.716,62,143,205,36,22,26,72,87,300,6.4
1651,Antonio Campbell\antonio-campbell-1,2014-15,Ohio,F,30,24,722,121,250,.484,93,168,.554,28,82,.341,30,48,.625,57,172,229,19,14,27,36,99,300,7.6
1652,Demonte Flannigan\demonte-flannigan-1,2016-17,Cleveland State,F,27,26,690,126,272,.463,120,250,.480,6,22,.273,41,62,.661,49,101,150,20,9,20,54,84,299,6.1
1653,Dan Kimasa\dan-kimasa-1,2015-16,Texas-Rio Grande Valley,F,30,28,787,114,254,.449,113,243,.465,1,11,.091,70,104,.673,67,130,197,31,13,28,52,85,299,6.9
1654,Nigel Snipes\nigel-snipes-1,2015-16,Western Kentucky,F,34,8,728,100,222,.450,38,85,.447,62,137,.453,37,51,.725,21,64,85,37,21,11,47,90,299,5.4
1655,Billy Wampler\billy-wampler-1,2016-17,Drake,F,31,16,689,100,267,.375,40,92,.435,60,175,.343,39,49,.796,18,58,76,22,17,1,26,54,299,5.3
1656,Marquis Vance\marquis-vance-1,2013-14,Alcorn State,F,30,17,771,104,250,.416,89,196,.454,15,54,.278,76,126,.603,57,96,153,33,14,10,43,45,299,6.6
1657,Corvon Butler\corvon-butler-1,2015-16,Alabama State,F,31,18,693,128,230,.557,127,222,.572,1,8,.125,42,62,.677,72,113,185,29,20,19,33,94,299,8.0
1658,Shaq Goodwin\shaq-goodwin-1,2014-15,Memphis,F,31,24,803,112,206,.544,107,188,.569,5,18,.278,70,109,.642,80,141,221,49,20,35,61,71,299,8.8
1659,Hasahn French\hasahn-french-1,2017-18,Saint Louis,F,32,32,965,129,241,.535,129,240,.538,0,1,.000,40,110,.364,94,134,228,48,24,59,63,105,298,7.9
1660,Iba Camara\iba-camara-1,2017-18,New Hampshire,F,31,30,808,110,230,.478,110,230,.478,0,0,,78,108,.722,78,253,331,27,17,14,58,89,298,8.1
1661,Terrance Motley\terrance-motley-1,2013-14,Sam Houston State,F,35,0,564,120,229,.524,116,222,.523,4,7,.571,54,84,.643,56,94,150,15,21,13,40,101,298,5.8
1662,Liam Thomas\liam-thomas-1,2015-16,Nicholls State,F,34,32,839,113,210,.538,101,165,.612,12,45,.267,60,101,.594,58,120,178,70,21,85,76,109,298,7.8
1663,Davaris McGowens\davaris-mcgowens-1,2016-17,North Carolina A&T,F,31,25,835,112,227,.493,112,227,.493,0,0,,74,111,.667,68,146,214,37,21,17,57,87,298,7.3
1664,Nate Buss\nate-buss-1,2013-14,Northern Iowa,F,28,4,578,111,208,.534,69,125,.552,42,83,.506,34,43,.791,38,102,140,9,12,9,20,66,298,8.2
1665,Colter Lasher\colter-lasher-1,2014-15,Houston Baptist,F,28,26,631,117,246,.476,92,170,.541,25,76,.329,38,48,.792,36,68,104,43,22,4,39,68,297,7.2
1666,Kasey Wilson\kasey-wilson-1,2013-14,Central Florida,F,31,22,827,101,237,.426,62,131,.473,39,106,.368,56,85,.659,49,128,177,18,26,16,45,87,297,6.5
1667,Jeff Roberson\jeff-roberson-1,2015-16,Vanderbilt,F,32,25,858,91,186,.489,61,117,.521,30,69,.435,85,102,.833,58,121,179,38,15,6,34,101,297,7.6
1668,Tavrion Dawson\tavrion-dawson-1,2015-16,Cal State Northridge,F,30,14,773,109,235,.464,103,202,.510,6,33,.182,73,101,.723,52,102,154,33,12,10,33,64,297,7.2
1669,Matthew Wilson\matthew-wilson-2,2016-17,Army,F,32,0,536,122,189,.646,122,189,.646,0,0,,53,95,.558,46,111,157,11,6,6,47,73,297,6.4
1670,Renaldo Dixon\renaldo-dixon-1,2013-14,New Mexico State,F,35,12,867,106,196,.541,102,180,.567,4,16,.250,81,102,.794,73,124,197,34,15,32,48,75,297,7.6
1671,Mike Rostampour\mike-rostampour-1,2014-15,Omaha,F,29,29,709,100,223,.448,89,195,.456,11,28,.393,86,121,.711,85,137,222,12,25,14,56,112,297,7.2
1672,Matt Rose\matt-rose-1,2015-16,Samford,F,33,9,831,98,240,.408,35,86,.407,63,154,.409,37,57,.649,36,102,138,23,24,5,36,59,296,6.0
1673,Walter Pitchford\walter-pitchford-1,2013-14,Nebraska,F,32,31,742,107,226,.473,59,109,.541,48,117,.410,34,49,.694,36,115,151,16,12,18,15,81,296,7.0
1674,Malik Hines\malik-hines-1,2017-18,Massachusetts,F,33,32,892,121,184,.658,121,184,.658,0,0,,54,74,.730,76,126,202,26,14,28,56,89,296,7.8
1675,D.J. Johnson\dj-johnson-2,2015-16,Kansas State,F,32,12,651,107,176,.608,107,176,.608,0,0,,82,122,.672,84,82,166,9,23,29,52,85,296,7.7
1676,Michael Zangari\michael-zangari-1,2013-14,East Carolina,F,34,34,782,109,212,.514,108,205,.527,1,7,.143,77,112,.688,83,94,177,10,7,19,47,93,296,6.1
1677,Nick Stover\nick-stover-1,2016-17,South Alabama,F,31,9,689,106,225,.471,70,129,.543,36,96,.375,48,66,.727,32,57,89,42,13,8,53,54,296,6.0
1678,Roquez Johnson\roquez-johnson-1,2014-15,Mississippi State,F,32,26,831,98,186,.527,98,186,.527,0,0,,100,149,.671,66,98,164,17,27,6,66,80,296,6.4
1679,Alandise Harris\alandise-harris-1,2013-14,Arkansas,F,33,4,615,104,225,.462,97,200,.485,7,25,.280,81,119,.681,28,80,108,38,27,31,54,76,296,6.0
1680,Dominique Reid\dominique-reid-1,2014-15,Niagara,F,30,13,656,101,259,.390,99,252,.393,2,7,.286,91,130,.700,63,113,176,25,13,14,60,88,295,5.4
1681,Zoran Talley\zoran-talley-1,2016-17,Old Dominion,F,26,6,600,127,285,.446,126,274,.460,1,11,.091,40,63,.635,29,58,87,45,10,4,41,48,295,6.1
1682,Griffin Kinney\griffin-kinney-1,2016-17,Appalachian State,F,30,30,679,102,198,.515,100,192,.521,2,6,.333,89,140,.636,50,138,188,41,15,14,81,86,295,6.4
1683,Josh Cuthbertson\josh-cuthbertson-1,2015-16,South Carolina Upstate,F,31,26,840,103,234,.440,64,110,.582,39,124,.315,50,70,.714,30,109,139,84,18,2,52,58,295,7.1
1684,Quintin Brewer\quentin-brewer-1,2014-15,Bethune-Cookman,F,32,17,899,113,223,.507,107,207,.517,6,16,.375,63,89,.708,77,147,224,20,25,34,69,103,295,7.0
1685,Brandon Mobley\brandon-mobley-1,2014-15,Seton Hall,F,30,29,735,106,247,.429,81,168,.482,25,79,.316,58,72,.806,44,107,151,19,20,33,30,87,295,7.1
1686,Conner Avants\conner-avants-1,2016-17,North Dakota,F,31,30,708,126,228,.553,125,221,.566,1,7,.143,42,57,.737,68,80,148,18,20,16,43,94,295,6.9
1687,Konstantinos Mitoglou\konstantinos-mitoglou-1,2016-17,Wake Forest,F,33,32,811,93,221,.421,64,134,.478,29,87,.333,80,100,.800,59,143,202,29,20,22,49,76,295,7.0
1688,Dwayne Benjamin\dwayne-benjamin-1,2015-16,Oregon,F,38,2,826,102,254,.402,57,112,.509,45,142,.317,46,68,.676,21,92,113,33,39,10,39,61,295,5.2
1689,Tarekeyi Edogi\tarekeyi-edogi-1,2017-18,Iona,F,34,31,820,124,218,.569,123,212,.580,1,6,.167,45,60,.750,88,155,243,14,18,39,50,82,294,7.8
1690,Immanuel King\immanuel-king-1,2017-18,Texas State,F,33,32,756,122,211,.578,122,211,.578,0,0,,50,96,.521,71,122,193,29,14,26,41,70,294,7.5
1691,Akwasi Yeboah\akwasi-yeboah-1,2016-17,Stony Brook,F,31,10,657,97,261,.372,52,129,.403,45,132,.341,55,70,.786,48,111,159,19,14,16,33,73,294,6.0
1692,Nate Sherwood\nate-sherwood-1,2017-18,Idaho,F,31,29,904,111,210,.529,97,181,.536,14,29,.483,58,70,.829,57,88,145,54,18,12,48,78,294,7.7
1693,Sean Sellers\sean-sellers-1,2016-17,Ball State,F,34,19,862,94,217,.433,26,53,.491,68,164,.415,38,50,.760,9,87,96,45,18,11,37,55,294,6.0
1694,George Kiernan\george-kiernan-1,2017-18,Navy,F,30,2,600,93,231,.403,46,92,.500,47,139,.338,61,74,.824,29,111,140,23,10,5,40,73,294,5.9
1695,Mike Rostampour\mike-rostampour-1,2013-14,Omaha,F,32,31,662,93,168,.554,84,145,.579,9,23,.391,99,147,.673,91,148,239,14,26,9,31,116,294,8.4
1696,Chase Plummer\chase-plummer-1,2013-14,Maryland-Baltimore County,F,28,2,533,97,249,.390,72,171,.421,25,78,.321,75,123,.610,37,103,140,28,31,4,49,66,294,6.2
1697,Tulio Da Silva\tulio-dasilva-1,2016-17,South Florida,F,30,21,840,118,250,.472,118,245,.482,0,5,.000,58,105,.552,67,137,204,24,28,12,82,77,294,5.9
1698,Nico Carvacho\nico-carvacho-1,2017-18,Colorado State,F,32,32,919,107,211,.507,101,195,.518,6,16,.375,73,120,.608,124,206,330,71,23,22,64,107,293,9.4
1699,Kendrec Ferrara\kendrec-ferrara-1,2013-14,Furman,F,30,25,877,116,235,.494,108,201,.537,8,34,.235,53,80,.663,61,86,147,24,7,27,68,66,293,6.0
1700,Emmanuel Nzekwesi\emmanuel-nzekwesi-1,2016-17,Oral Roberts,F,30,29,725,117,262,.447,97,193,.503,20,69,.290,39,59,.661,52,141,193,36,18,15,45,80,293,6.8
1701,Nura Zanna\nura-zanna-1,2016-17,Long Island University,F,32,30,804,121,194,.624,121,194,.624,0,0,,51,108,.472,108,170,278,17,21,10,88,115,293,6.7
1702,Eric Stutz\eric-stutz-1,2013-14,Eastern Kentucky,F,34,30,856,110,169,.651,109,165,.661,1,4,.250,72,93,.774,50,108,158,61,29,24,48,112,293,8.0
1703,Rayshaun McGrew\rayshaun-mcgrew-1,2014-15,Stony Brook,F,35,35,932,117,261,.448,117,259,.452,0,2,.000,59,89,.663,99,179,278,37,22,2,56,78,293,6.6
1704,Traylin Farris\traylin-farris-1,2014-15,Incarnate Word,F,29,28,693,124,224,.554,124,221,.561,0,3,.000,45,88,.511,55,81,136,16,19,27,35,96,293,7.1
1705,Brandon Hollins\brandon-hollins-1,2017-18,Portland State,F,30,23,771,117,211,.555,113,189,.598,4,22,.182,55,81,.679,78,153,231,21,30,5,35,87,293,8.7
1706,Jake Gollon\jake-gollon-1,2013-14,Mercer,F,36,36,926,99,221,.448,78,165,.473,21,56,.375,74,95,.779,48,113,161,91,36,7,65,78,293,6.8
1707,John Edgar Jr.\john-edgarjr-1,2017-18,UC-Irvine,F,35,27,850,117,285,.411,82,157,.522,35,128,.273,24,33,.727,32,110,142,34,14,1,52,49,293,4.5
1708,Karim York\karim-york-1,2014-15,Prairie View,F,32,27,799,114,248,.460,91,178,.511,23,70,.329,41,68,.603,63,100,163,25,21,13,74,97,292,5.1
1709,Nick Rakocevic\nick-rakocevic-1,2017-18,Southern California,F,36,22,759,126,201,.627,126,201,.627,0,0,,40,73,.548,97,126,223,17,26,19,32,106,292,7.5
1710,Jordan Perkins\jordan-perkins-1,2017-18,North Carolina Central,F,35,25,954,103,234,.440,82,180,.456,21,54,.389,65,91,.714,24,78,102,190,21,9,95,99,292,6.4
1711,Nigel Hayes\nigel-hayes-1,2013-14,Wisconsin,F,38,0,663,98,192,.510,98,192,.510,0,0,,96,164,.585,34,72,106,36,32,20,45,99,292,5.3
1712,Austin Williams\austin-williams-2,2017-18,Drexel,F,31,30,917,129,216,.597,129,215,.600,0,1,.000,34,74,.459,96,168,264,21,12,92,61,101,292,9.2
1713,Bobby Ahearn\bobby-ahearn-1,2016-17,Binghamton,F,30,24,733,110,204,.539,89,147,.605,21,57,.368,51,64,.797,43,95,138,21,9,9,53,77,292,6.4
1714,Rhon Mitchell\rhon-mitchell-1,2013-14,Lamar,F,29,22,695,112,271,.413,112,263,.426,0,8,.000,68,83,.819,25,68,93,34,14,12,71,37,292,4.8
1715,Raphiael Putney\raphiael-putney-1,2013-14,Massachusetts,F,33,32,797,111,246,.451,80,149,.537,31,97,.320,39,52,.750,36,142,178,48,22,39,57,89,292,6.6
1716,George Blagojevic\george-blagojevic-1,2015-16,Hartford,F,31,26,814,103,252,.409,71,161,.441,32,91,.352,54,80,.675,37,91,128,46,24,15,66,87,292,5.3
1717,Jaren Lewis\jaren-lewis-1,2015-16,Abilene Christian,F,31,11,673,110,218,.505,91,172,.529,19,46,.413,53,73,.726,36,144,180,40,34,18,34,64,292,8.3
1718,James Demery\james-demery-1,2015-16,Saint Joseph's,F,36,1,779,108,214,.505,98,172,.570,10,42,.238,66,100,.660,39,90,129,18,15,4,26,60,292,5.7
1719,Jeffrey Solarin\jeffrey-solarin-1,2013-14,Idaho State,F,28,28,838,125,207,.604,125,206,.607,0,1,.000,41,64,.641,109,130,239,26,17,8,39,67,291,9.9
1720,Brandon Taylor\brandon-taylor-2,2014-15,Penn State,F,32,25,860,109,294,.371,55,133,.414,54,161,.335,19,30,.633,28,142,170,29,17,25,55,65,291,5.0
1721,Kyle Thomas\kyle-thomas-3,2016-17,Morgan State,F,29,15,798,105,296,.355,71,172,.413,34,124,.274,47,70,.671,28,98,126,26,20,9,43,49,291,5.1
1722,Orlando Coleman\orlando-coleman-1,2013-14,Kennesaw State,F,30,29,813,120,231,.519,102,178,.573,18,53,.340,33,57,.579,60,125,185,43,24,15,62,54,291,7.6
1723,Hanner Mosquera-Perea\hanner-mosquera-perea-1,2016-17,East Tennessee State,F,35,35,767,106,182,.582,106,181,.586,0,1,.000,79,141,.560,55,108,163,25,23,43,45,91,291,6.9
1724,Brekkott Chapman\brekkott-chapman-1,2017-18,Weber State,F,27,26,734,103,227,.454,62,130,.477,41,97,.423,44,59,.746,20,140,160,38,24,45,64,94,291,7.5
1725,Trent Steen\trent-steen-1,2016-17,Arkansas-Pine Bluff,F,32,30,689,115,226,.509,115,224,.513,0,2,.000,61,102,.598,44,96,140,20,34,23,66,90,291,5.8
1726,Duncan Robinson\duncan-robinson-1,2016-17,Michigan,F,38,3,764,101,215,.470,37,64,.578,64,151,.424,25,32,.781,11,55,66,33,14,9,19,70,291,5.2
1727,Tyler Cavanaugh\tyler-cavanaugh-1,2013-14,Wake Forest,F,33,22,700,86,204,.422,65,137,.474,21,67,.313,98,124,.790,32,95,127,22,7,11,48,90,291,5.1
1728,Kentwan Smith\kentwan-smith-1,2013-14,Stetson,F,31,28,813,113,227,.498,96,161,.596,17,66,.258,48,82,.585,54,103,157,43,32,26,65,62,291,7.2
1729,Norville Carey\norville-carey-1,2014-15,Southern Mississippi,F,27,16,730,113,207,.546,108,190,.568,5,17,.294,60,91,.659,58,94,152,22,24,24,52,62,291,8.4
1730,Dominique McKoy\dominique-mckoy-1,2013-14,Duquesne,F,30,30,886,116,195,.595,116,193,.601,0,2,.000,58,94,.617,68,148,216,34,22,35,38,75,290,9.3
1731,Aurimas Majauskas\aurimas-majauskas-1,2016-17,Sam Houston State,F,32,32,604,114,194,.588,104,173,.601,10,21,.476,52,75,.693,50,70,120,36,12,8,41,107,290,6.4
1732,Bryce Washington\bryce-washington-1,2015-16,Louisiana,F,33,22,848,115,195,.590,113,187,.604,2,8,.250,58,95,.611,82,107,189,45,26,15,46,60,290,8.2
1733,Elmo Stephen\elmo-stephen-1,2016-17,Florida International,F,29,19,722,101,228,.443,48,92,.522,53,136,.390,35,46,.761,19,62,81,26,9,2,27,41,290,6.3
1734,Vince Edwards\vince-edwards-2,2014-15,Purdue,F,33,30,889,110,228,.482,81,139,.583,29,89,.326,41,52,.788,64,95,159,90,12,13,50,73,290,7.5
1735,Iba Camara\iba-camara-1,2016-17,New Hampshire,F,31,27,770,119,211,.564,119,211,.564,0,0,,52,110,.473,73,220,293,30,16,16,62,95,290,7.5
1736,Andrew Fleming\andrew-fleming-3,2016-17,Maine,F,27,21,784,112,242,.463,107,226,.473,5,16,.313,61,96,.635,47,128,175,29,18,19,57,77,290,6.9
1737,Kevin Hervey\kevin-hervey-1,2015-16,Texas-Arlington,F,16,16,476,102,225,.453,72,132,.545,30,93,.323,56,74,.757,36,120,156,46,11,13,38,27,290,14.4
1738,Brandan Stith\brandan-stith-1,2016-17,Old Dominion,F,28,24,709,107,214,.500,106,210,.505,1,4,.250,75,115,.652,75,120,195,33,24,41,36,67,290,9.6
1739,Denell Henderson\denell-henderson-1,2014-15,Oral Roberts,F,33,29,687,108,206,.524,105,194,.541,3,12,.250,71,102,.696,70,96,166,25,6,43,66,102,290,6.1
1740,Martins Igbanu\martins-igbanu-1,2017-18,Tulsa,F,31,23,697,99,187,.529,97,180,.539,2,7,.286,90,125,.720,57,101,158,15,9,5,46,54,290,6.8
1741,Joe Reed\joe-reed-1,2013-14,Purdue-Fort Wayne,F,36,0,881,111,197,.563,107,178,.601,4,19,.211,64,103,.621,91,99,190,47,23,11,33,63,290,7.8
1742,Darren Goodson\darren-goodson-1,2013-14,Kent State,F,32,21,693,106,277,.383,80,183,.437,26,94,.277,52,81,.642,32,97,129,72,17,2,70,97,290,4.3
1743,Bruce Beckford\bruce-beckford-1,2013-14,North Carolina A&T,F,26,24,743,101,229,.441,92,178,.517,9,51,.176,79,104,.760,37,156,193,21,19,19,70,83,290,6.8
1744,Jalen Billups\jalen-billups-1,2013-14,Northern Kentucky,F,30,25,583,120,209,.574,119,206,.578,1,3,.333,48,71,.676,48,107,155,8,8,32,52,78,289,6.7
1745,LaDarien Griffin\ladarien-griffin-1,2017-18,St. Bonaventure,F,33,25,979,107,219,.489,106,213,.498,1,6,.167,74,107,.692,80,129,209,37,24,40,39,85,289,8.0
1746,Keonta Vernon\keonta-vernon-1,2016-17,Grand Canyon,F,31,25,755,119,211,.564,119,211,.564,0,0,,51,95,.537,75,142,217,30,35,15,39,102,289,8.2
1747,Adonis Burbage\adonis-burbage-1,2015-16,Gardner-Webb,F,30,11,764,100,260,.385,36,89,.404,64,171,.374,25,40,.625,28,77,105,26,23,1,37,43,289,5.7
1748,Kourtney Roberson\kourtney-roberson-1,2014-15,Texas A&M,F,33,32,795,117,186,.629,117,186,.629,0,0,,55,92,.598,81,132,213,37,17,13,33,76,289,8.4
1749,James Demery\james-demery-1,2016-17,Saint Joseph's,F,20,18,636,102,241,.423,95,213,.446,7,28,.250,78,132,.591,23,107,130,32,9,9,61,51,289,7.2
1750,Jonathan Kasibabu\jonathan-kasibabu-1,2017-18,Fairfield,F,32,31,681,104,154,.675,95,132,.720,9,22,.409,72,107,.673,58,120,178,37,13,35,53,107,289,7.9
1751,BaeBae Daniels\baebae-daniels-1,2014-15,North Florida,F,31,0,763,103,206,.500,81,150,.540,22,56,.393,61,87,.701,66,117,183,32,13,55,32,81,289,8.6
1752,Richard Ross\richard-ross-1,2014-15,Old Dominion,F,35,26,883,132,222,.595,132,222,.595,0,0,,24,50,.480,73,123,196,42,26,54,54,69,288,7.8
1753,Javion Ogunyemi\javion-ogunyemi-1,2014-15,Siena,F,31,28,833,119,218,.546,119,218,.546,0,0,,50,90,.556,77,71,148,25,9,48,42,106,288,7.0
1754,Kevin Thomas\kevin-thomas-4,2014-15,Troy,F,28,28,911,122,198,.616,122,196,.622,0,2,.000,44,71,.620,99,128,227,31,38,31,82,65,288,9.6
1755,Angel Delgado\angel-delgado-1,2014-15,Seton Hall,F,31,29,873,121,218,.555,121,217,.558,0,1,.000,46,111,.414,112,193,305,27,16,39,39,78,288,9.2
1756,Paul Atkinson\paul-atkinson-1,2017-18,Yale,F,31,30,749,110,159,.692,110,159,.692,0,0,,68,102,.667,53,89,142,32,21,17,31,79,288,8.5
1757,Bo Calhoun\bo-calhoun-1,2014-15,Ball State,F,30,8,762,116,221,.525,100,170,.588,16,51,.314,40,50,.800,55,124,179,18,13,14,39,81,288,7.2
1758,Aaron Brown\aaron-brown-2,2014-15,Saint Joseph's,F,31,3,758,96,226,.425,88,198,.444,8,28,.286,88,126,.698,34,86,120,37,19,5,50,65,288,5.6
1759,Steve Moundou-Missi\steve-moundou-missi-1,2014-15,Harvard,F,30,29,898,115,251,.458,111,241,.461,4,10,.400,54,75,.720,57,162,219,28,26,43,47,75,288,7.9
1760,Khris Lane\khris-lane-1,2015-16,Longwood,F,33,21,833,117,230,.509,99,182,.544,18,48,.375,36,55,.655,66,137,203,21,20,11,39,102,288,6.5
1761,J.R. Holder\jr-holder-1,2014-15,Jacksonville,F,32,15,900,96,238,.403,79,181,.436,17,57,.298,79,114,.693,38,97,135,40,21,8,65,62,288,5.2
1762,Calvin Crawford\calvin-crawford-1,2016-17,Manhattan,F,31,12,745,109,243,.449,76,148,.514,33,95,.347,37,48,.771,35,90,125,22,24,17,53,77,288,5.7
1763,Cameron Naylor\cameron-naylor-2,2015-16,Texas State,F,30,20,746,109,232,.470,104,221,.471,5,11,.455,65,99,.657,36,123,159,20,17,8,46,77,288,5.9
1764,Mustafa Jones\mustafa-jones-1,2016-17,Central Connecticut State,F,27,26,811,127,273,.465,125,263,.475,2,10,.200,32,50,.640,42,91,133,31,15,30,42,59,288,7.0
1765,Jack Purchase\jack-purchase-1,2016-17,Hawaii,F,30,30,900,91,223,.408,19,38,.500,72,185,.389,34,38,.895,21,105,126,63,19,12,43,54,288,7.3
1766,Keaton Jackson\keaton-jackson-1,2013-14,Southern Illinois-Edwardsville,F,31,1,564,111,150,.740,109,147,.741,2,3,.667,64,94,.681,56,98,154,13,9,65,37,102,288,8.7
1767,Dion Wright\dion-wright--1,2013-14,St. Bonaventure,F,33,0,722,120,240,.500,119,233,.511,1,7,.143,47,63,.746,74,85,159,20,23,13,22,83,288,7.0
1768,Adjehi Baru\adjehi-baru-1,2013-14,College of Charleston,F,32,31,921,102,203,.502,102,203,.502,0,0,,83,131,.634,75,164,239,34,20,45,57,106,287,7.6
1769,Dwayne Benjamin\dwayne-benjamin-1,2014-15,Oregon,F,34,13,789,111,248,.448,75,146,.514,36,102,.353,29,59,.492,57,139,196,35,30,15,26,70,287,7.0
1770,Brandon Graham\brandon-graham-1,2013-14,Alabama State,F,32,30,848,102,220,.464,75,130,.577,27,90,.300,56,79,.709,46,115,161,25,23,26,45,89,287,6.5
1771,Trey Chapman\trey-chapman-1,2016-17,Virginia Military Institute,F,30,30,771,104,222,.468,91,168,.542,13,54,.241,66,98,.673,57,103,160,25,11,23,40,89,287,6.7
1772,Adonis Burbage\adonis-burbage-1,2014-15,Gardner-Webb,F,35,33,958,104,250,.416,40,76,.526,64,174,.368,15,24,.625,26,62,88,38,26,3,49,77,287,4.6
1773,Shaquielle McKissic\shaquielle-mckissic-1,2013-14,Arizona State,F,32,26,918,93,196,.474,71,129,.550,22,67,.328,79,120,.658,38,134,172,83,41,1,28,70,287,8.8
1774,Mathias Seilund\mathias-seilund-1,2013-14,Fairleigh Dickinson,F,31,30,883,103,225,.458,69,144,.479,34,81,.420,47,59,.797,61,90,151,25,26,43,44,102,287,7.2
1775,Lamontray Harris\lamontray-harris-1,2017-18,Morehead State,F,26,17,603,106,225,.471,89,157,.567,17,68,.250,58,67,.866,57,108,165,24,13,9,55,81,287,7.3
1776,Josh Fox\josh-fox-2,2014-15,UC-Davis,F,32,2,754,112,188,.596,111,179,.620,1,9,.111,62,106,.585,42,95,137,35,12,10,32,66,287,7.1
1777,Brian White\brian-white-1,2015-16,Citadel,F,32,15,535,96,209,.459,71,126,.563,25,83,.301,70,89,.787,32,74,106,11,21,12,37,71,287,5.9
1778,Kazembe Abif\kazembe-abif-1,2015-16,Drexel,F,31,30,926,111,238,.466,110,229,.480,1,9,.111,64,103,.621,68,149,217,26,13,10,40,104,287,6.4
1779,Jamorko Pickett\jamorko-pickett-1,2017-18,Georgetown,F,30,28,826,95,262,.363,39,105,.371,56,157,.357,41,55,.745,17,95,112,53,12,17,73,57,287,4.7
1780,Kevin Hill\kevin-hill-1,2015-16,New Orleans,F,29,10,618,105,216,.486,105,216,.486,0,0,,77,110,.700,63,114,177,21,14,18,58,61,287,7.0
1781,Bennie Boatwright\bennie-boatwright-1,2016-17,Southern California,F,19,18,524,86,201,.428,39,72,.542,47,129,.364,68,75,.907,29,57,86,32,8,7,30,40,287,10.8
1782,Craig Victor\craig-victor-1,2015-16,Louisiana State,F,25,24,673,108,238,.454,107,232,.461,1,6,.167,70,114,.614,54,85,139,20,25,16,30,97,287,7.6
1783,Brandon Parrish\brandon-parrish-1,2015-16,Texas Christian,F,33,33,1022,100,237,.422,56,131,.427,44,106,.415,43,73,.589,25,89,114,44,17,12,54,77,287,5.0
1784,Craig McFerrin\craig-mcferrin-1,2013-14,McNeese State,F,31,29,859,119,243,.490,119,241,.494,0,2,.000,48,79,.608,71,130,201,20,12,30,58,72,286,6.5
1785,Konstantinos Mitoglou\konstantinos-mitoglou-1,2015-16,Wake Forest,F,31,30,738,94,220,.427,52,88,.591,42,132,.318,56,73,.767,56,111,167,22,16,24,44,86,286,6.6
1786,Chris Perry\chris-perry-1,2013-14,South Florida,F,32,10,656,112,222,.505,112,222,.505,0,0,,62,109,.569,64,106,170,14,9,24,37,92,286,6.1
1787,Max Bielfeldt\max-bielfeldt-1,2015-16,Indiana,F,35,5,612,113,219,.516,84,154,.545,29,65,.446,31,43,.721,59,99,158,25,29,16,39,75,286,6.7
1788,Markus Kennedy\markus-kennedy-1,2014-15,Southern Methodist,F,24,0,551,108,197,.548,108,194,.557,0,3,.000,70,109,.642,56,94,150,27,33,20,37,53,286,10.5
1789,Troy Simmons\troy-simmons-2,2017-18,New Mexico,F,29,11,676,96,242,.397,43,96,.448,53,146,.363,41,52,.788,33,56,89,42,52,5,32,67,286,7.5
1790,Kevin Johnson\kevin-johnson-6,2016-17,Cincinnati,F,36,36,1017,101,267,.378,51,105,.486,50,162,.309,34,42,.810,27,51,78,46,45,4,39,62,286,5.2
1791,William Powell\william-powell-1,2015-16,Seattle,F,32,32,942,94,193,.487,94,192,.490,0,1,.000,98,163,.601,75,144,219,81,32,2,92,92,286,6.9
1792,Willie Rodriguez\willie-rodriguez-1,2017-18,Binghamton,F,31,30,853,115,247,.466,96,178,.539,19,69,.275,37,75,.493,48,105,153,36,19,26,49,63,286,6.4
1793,Ryan Swan-Ford\ryan-swan-ford-1,2017-18,Air Force,F,31,18,657,102,214,.477,81,166,.488,21,48,.438,61,82,.744,53,87,140,42,19,17,35,71,286,7.4
1794,Marc Gosselin\marc-gosselin-1,2016-17,Western Carolina,F,32,31,877,102,236,.432,72,153,.471,30,83,.361,52,65,.800,64,150,214,31,32,21,73,101,286,6.3
1795,Colin Borchert\colin-borchert-1,2013-14,Mississippi State,F,33,25,868,103,258,.399,63,127,.496,40,131,.305,40,53,.755,23,116,139,43,26,33,67,93,286,5.1
1796,Kyndahl Hill\kyndahl-hill-1,2015-16,Weber State,F,35,3,814,105,172,.610,104,162,.642,1,10,.100,74,98,.755,63,141,204,29,16,36,40,91,285,7.7
1797,Nemanja Djurisic\nemanja-djurisic-1,2013-14,Georgia,F,34,3,777,94,195,.482,62,121,.512,32,74,.432,65,95,.684,44,93,137,27,17,12,57,76,285,5.6
1798,Chris Cokley\chris-cokley-1,2014-15,Alabama-Birmingham,F,36,0,620,119,220,.541,119,219,.543,0,1,.000,47,71,.662,73,95,168,18,24,24,35,59,285,6.8
1799,Reggie Agbeko\reggie-agbeko-1,2016-17,Saint Louis,F,33,17,822,112,208,.538,111,207,.536,1,1,1.000,60,111,.541,65,158,223,26,11,16,80,103,285,5.3
1800,Kevin Thomas\kevin-thomas-4,2013-14,Troy,F,31,24,862,111,223,.498,111,223,.498,0,0,,63,99,.636,86,129,215,33,29,22,84,75,285,6.8
1801,Emmy Andujar\emmy-andujar-1,2013-14,Manhattan,F,33,5,770,103,194,.531,99,183,.541,4,11,.364,75,110,.682,65,111,176,74,39,13,71,87,285,7.6
1802,Blake Hibbitts\blake-hibbitts-1,2013-14,Central Michigan,F,31,31,951,92,238,.387,26,55,.473,66,183,.361,35,48,.729,36,75,111,14,13,11,31,66,285,5.5
1803,Rashad Smith\rashad-smith-1,2014-15,Tulsa,F,34,34,962,115,253,.455,105,214,.491,10,39,.256,45,86,.523,57,146,203,25,17,16,42,67,285,5.8
1804,Makur Puou\matthew-puou-1,2017-18,New Orleans,F,33,29,896,109,226,.482,109,225,.484,0,1,.000,67,96,.698,64,121,185,34,21,24,60,67,285,6.5
1805,Blake Jenkins\blake-jenkins-1,2013-14,Belmont,F,35,35,751,104,170,.612,97,157,.618,7,13,.538,70,119,.588,58,108,166,28,8,19,44,110,285,6.1
1806,Tai Odiase\tai-odiase-1,2015-16,Illinois-Chicago,F,30,30,835,114,228,.500,114,227,.502,0,1,.000,57,120,.475,95,98,193,6,15,97,35,82,285,8.7
1807,Adam Kemp\adam-kemp-1,2013-14,Marist,F,28,28,779,109,213,.512,109,213,.512,0,0,,66,117,.564,91,122,213,16,8,58,44,85,284,8.6
1808,Chris Freeman\chris-freeman-1,2014-15,Austin Peay,F,30,26,759,118,198,.596,118,198,.596,0,0,,48,68,.706,51,104,155,21,13,23,50,81,284,7.1
1809,Ross Travis\ross-travis-1,2013-14,Penn State,F,34,26,999,100,228,.439,91,198,.460,9,30,.300,75,109,.688,64,175,239,33,19,12,51,77,284,6.4
1810,Justin Gray\justin-gray-2,2016-17,Texas Tech,F,32,27,925,113,213,.531,107,186,.575,6,27,.222,52,71,.732,52,115,167,54,32,27,44,82,284,8.0
1811,Maxie Esho\maxie-esho-1,2013-14,Massachusetts,F,32,1,679,112,199,.563,112,196,.571,0,3,.000,60,99,.606,45,115,160,13,32,28,51,95,284,6.6
1812,Steven Thornton\steven-thornton-1,2014-15,UC-Riverside,F,31,31,890,87,224,.388,47,107,.439,40,117,.342,70,94,.745,29,72,101,32,33,10,38,101,284,5.8
1813,Maurius Hill\maurius-hill-1,2016-17,Little Rock,F,32,30,896,103,220,.468,91,178,.511,12,42,.286,66,94,.702,50,118,168,64,38,13,54,73,284,7.5
1814,Laimonas Chatkevicius\laimonas-chatkevicius-1,2014-15,South Carolina,F,33,26,753,118,237,.498,110,210,.524,8,27,.296,40,55,.727,52,120,172,21,11,44,45,74,284,6.5
1815,Ed Dyson\ed-dyson-1,2014-15,Austin Peay,F,30,30,886,93,238,.391,58,124,.468,35,114,.307,63,94,.670,15,72,87,48,29,3,46,68,284,5.5
1816,Kenny Jones\kenny-jones-2,2015-16,Austin Peay,F,36,35,864,121,229,.528,117,218,.537,4,11,.364,38,91,.418,52,140,192,46,28,17,57,88,284,5.8
1817,Roschon Prince\roschon-prince-1,2017-18,Detroit Mercy,F,31,20,690,104,188,.553,104,182,.571,0,6,.000,76,104,.731,72,89,161,38,20,13,39,78,284,7.9
1818,Joe Hugley\joe-hugley-1,2017-18,Central Connecticut State,F,30,6,568,92,204,.451,48,92,.522,44,112,.393,56,73,.767,31,86,117,11,10,15,49,84,284,5.5
1819,Devine Eke\devine-eke-1,2015-16,Maine,F,29,21,695,122,196,.622,122,194,.629,0,2,.000,39,103,.379,65,130,195,22,21,47,36,64,283,9.0
1820,Michael Humphrey\michael-humphrey-1,2016-17,Stanford,F,30,25,721,113,248,.456,107,221,.484,6,27,.222,51,70,.729,67,120,187,28,27,18,48,104,283,6.7
1821,Derek Cooke\derek-cooke-1,2014-15,Wyoming,F,35,34,921,116,161,.720,115,160,.719,1,1,1.000,50,92,.543,51,153,204,33,30,31,49,78,283,7.9
1822,Kenrich Williams\kenrich-williams-1,2014-15,Texas Christian,F,33,17,917,102,214,.477,91,183,.497,11,31,.355,68,112,.607,93,128,221,46,30,32,36,80,283,8.4
1823,Bryant Mbamalu\bryant-mbamalu-1,2013-14,Louisiana,F,23,21,669,101,235,.430,68,145,.469,33,90,.367,48,76,.632,41,58,99,30,19,2,38,62,283,7.5
1824,Prince Oduro\prince-oduro-1,2017-18,Siena,F,31,27,795,121,250,.484,121,250,.484,0,0,,41,123,.333,48,109,157,23,7,21,66,100,283,3.9
1825,Kevin Puryear\kevin-puryear-1,2017-18,Missouri,F,33,26,835,93,211,.441,80,160,.500,13,51,.255,84,102,.824,51,90,141,27,10,8,48,73,283,5.6
1826,Marcus Thornton\marcus-thornton-2,2013-14,Georgia,F,34,32,880,95,217,.438,90,206,.437,5,11,.455,88,136,.647,76,131,207,16,18,45,51,82,283,6.5
1827,Zoran Talley\zoran-talley-1,2015-16,Old Dominion,F,35,31,806,124,243,.510,121,230,.526,3,13,.231,32,45,.711,43,114,157,56,16,3,30,50,283,6.5
1828,Stephen Ugochukwu\stephen-ugochukwu-1,2016-17,McNeese State,F,26,25,727,104,229,.454,100,217,.461,4,12,.333,71,104,.683,67,142,209,24,27,27,43,93,283,8.6
1829,Khalil Iverson\khalil-iverson-1,2017-18,Wisconsin,F,33,33,1003,107,196,.546,107,172,.622,0,24,.000,69,101,.683,60,109,169,58,26,30,67,54,283,7.6
1830,Clide Geffrard\clide-geffrard-1,2014-15,Stephen F. Austin,F,33,3,524,99,194,.510,79,132,.598,20,62,.323,64,93,.688,38,58,96,29,20,16,54,63,282,5.8
1831,Trahson Burrell\trahson-burrell-1,2014-15,Memphis,F,31,11,741,105,234,.449,85,165,.515,20,69,.290,52,81,.642,73,87,160,59,27,17,38,58,282,7.9
1832,Abdul Ado\abdul-ado-1,2017-18,Mississippi State,F,36,36,953,112,182,.615,112,182,.615,0,0,,58,113,.513,103,128,231,13,28,67,71,93,282,7.3
1833,Eric Jacobsen\eric-jacobsen-1,2014-15,Arizona State,F,34,34,972,102,163,.626,102,163,.626,0,0,,78,137,.569,84,118,202,32,19,41,61,122,282,7.0
1834,Philip Whittington\philip-whittington-1,2016-17,South Carolina Upstate,F,33,13,595,119,251,.474,118,240,.492,1,11,.091,43,69,.623,71,132,203,23,17,37,48,84,282,6.4
1835,Tommy Spagnolo\tommy-spagnolo-1,2014-15,Appalachian State,F,29,29,780,115,227,.507,109,210,.519,6,17,.353,46,63,.730,60,143,203,29,15,13,61,81,282,6.8
1836,Zylan Cheatham\zylan-cheatham-1,2016-17,San Diego State,F,31,22,726,95,183,.519,93,171,.544,2,12,.167,90,119,.756,69,125,194,43,33,18,60,83,282,8.0
1837,Austin Arians\austin-arians-1,2016-17,Wake Forest,F,33,33,754,94,201,.468,33,58,.569,61,143,.427,33,37,.892,16,46,62,37,17,3,21,67,282,6.0
1838,Jalen Hayes\jalen-hayes-1,2014-15,Oakland,F,33,21,786,99,199,.497,95,187,.508,4,12,.333,80,114,.702,55,114,169,38,33,11,42,85,282,7.1
1839,Nathan Dieudonne\nathan-dieudonne-1,2014-15,Boston University,F,29,25,881,99,209,.474,84,151,.556,15,58,.259,69,107,.645,69,147,216,47,21,12,56,85,282,7.8
1840,Anthony Lawrence Jr.\anthony-lawrencejr-1,2017-18,Miami (FL),F,32,31,975,100,214,.467,62,126,.492,38,88,.432,43,63,.683,45,163,208,74,46,31,53,81,281,8.7
1841,Ethan Chargois\ethan-chargois-1,2017-18,Southern Methodist,F,31,24,661,101,218,.463,66,113,.584,35,105,.333,44,77,.571,46,89,135,33,25,21,41,82,281,6.6
1842,Savon Goodman\savon-goodman-1,2014-15,Arizona State,F,25,21,654,115,199,.578,115,199,.578,0,0,,51,91,.560,66,123,189,19,20,9,51,71,281,8.6
1843,Jalen Jackson\jalen-jackson-1,2015-16,Little Rock,F,33,0,509,113,226,.500,107,211,.507,6,15,.400,49,68,.721,26,43,69,22,17,9,48,51,281,4.9
1844,Marcus Ware\marcus-ware-1,2013-14,Niagara,F,33,23,729,95,211,.450,95,208,.457,0,3,.000,91,135,.674,76,113,189,17,20,9,41,121,281,5.7
1845,Donte Thomas\donte-thomas-1,2015-16,Bradley,F,31,27,771,97,223,.435,79,157,.503,18,66,.273,69,93,.742,49,143,192,24,17,15,68,109,281,5.3
1846,Rashid Gaston\rashid-gaston-1,2016-17,Xavier,F,38,18,689,115,195,.590,115,195,.590,0,0,,51,92,.554,93,131,224,23,6,18,41,87,281,6.2
1847,Jake Kretzer\jake-kretzer-1,2015-16,Akron,F,34,8,849,90,209,.431,16,32,.500,74,177,.418,27,31,.871,35,104,139,43,19,3,20,75,281,6.6
1848,Kentan Facey\kentan-facey-1,2016-17,Connecticut,F,33,28,941,105,217,.484,105,215,.488,0,2,.000,71,101,.703,82,153,235,20,7,38,50,84,281,6.9
1849,Dwayne Polee\dwayne-polee-2,2013-14,San Diego State,F,33,0,592,100,212,.472,64,120,.533,36,92,.391,45,60,.750,23,85,108,13,36,17,31,63,281,6.3
1850,Nnamdi Ezenwa\nnamdi-ezenwa-1,2014-15,Idaho State,F,30,29,954,89,197,.452,56,123,.455,33,74,.446,70,101,.693,36,105,141,53,36,7,52,79,281,7.2
1851,Billy Giles\billy-giles-1,2015-16,Robert Morris,F,32,26,803,120,198,.606,120,194,.619,0,4,.000,41,80,.513,65,97,162,12,20,25,39,88,281,6.9
1852,Jordan Barnett\jordan-barnett-1,2016-17,Missouri,F,23,13,630,101,231,.437,65,111,.586,36,120,.300,43,55,.782,42,90,132,13,14,10,30,47,281,8.4
1853,Brandon Peel\brandon-peel-1,2014-15,Central Connecticut State,F,31,31,1026,125,267,.468,121,256,.473,4,11,.364,27,44,.614,99,173,272,31,25,52,70,80,281,7.7
1854,Kristian Doolittle\kristian-doolittle-2,2016-17,Oklahoma,F,31,25,778,87,221,.394,70,178,.393,17,43,.395,90,111,.811,62,131,193,35,20,10,51,59,281,6.8
1855,Lamontray Harris\lamontray-harris-1,2016-17,Morehead State,F,30,1,566,107,237,.451,89,176,.506,18,61,.295,49,61,.803,46,110,156,37,11,17,59,84,281,5.8
1856,Develle Phillips\develle-phillips-1,2017-18,James Madison,F,32,30,735,117,198,.591,117,198,.591,0,0,,46,87,.529,74,127,201,29,11,38,51,113,280,7.0
1857,Jackson Rowe\jackson-rowe-1,2016-17,Cal State Fullerton,F,27,26,799,100,183,.546,85,139,.612,15,44,.341,65,92,.707,64,131,195,52,16,22,71,70,280,8.7
1858,Don MuepoKelly\dj-muepo-1,2016-17,South Alabama,F,32,32,722,107,213,.502,107,211,.507,0,2,.000,66,113,.584,61,100,161,29,41,37,41,81,280,7.5
1859,Lukas Meisner\lukas-meisner-1,2017-18,Columbia,F,25,24,688,106,212,.500,63,109,.578,43,103,.417,25,42,.595,36,151,187,46,13,11,48,72,280,8.6
1860,Jordan Loveridge\jordan-loveridge-1,2014-15,Utah,F,28,27,735,89,214,.416,35,90,.389,54,124,.435,48,55,.873,12,97,109,28,17,6,38,48,280,6.6
1861,Christian Cunningham\christian-cunningham-2,2016-17,Jacksonville State,F,34,27,907,117,191,.613,117,191,.613,0,0,,46,76,.605,100,175,275,36,20,59,46,98,280,9.0
1862,Eddie Keith\eddie-keith-1,2017-18,Towson,F,32,28,794,111,227,.489,98,180,.544,13,47,.277,45,85,.529,55,102,157,66,28,36,45,105,280,7.2
1863,Yohanny Dalembert\yohanny-dalembert-1,2015-16,James Madison,F,30,29,638,115,212,.542,115,212,.542,0,0,,50,103,.485,65,139,204,23,10,39,68,83,280,6.5
1864,Tanner Plomb\tanner-plomb-1,2013-14,Army,F,27,22,527,95,206,.461,59,116,.509,36,90,.400,54,70,.771,21,93,114,33,12,7,35,26,280,7.6
1865,Brandan Stith\brandan-stith-1,2017-18,Old Dominion,F,32,32,874,118,220,.536,118,219,.539,0,1,.000,44,69,.638,98,149,247,40,35,52,48,74,280,9.3
1866,Malik Osborne\malik-osborne-1,2017-18,Rice,F,31,27,840,92,222,.414,70,139,.504,22,83,.265,74,115,.643,71,131,202,26,19,24,57,69,280,6.6
1867,Alex King\alex-king-1,2017-18,Army,F,30,0,585,98,221,.443,56,129,.434,42,92,.457,41,59,.695,21,83,104,23,19,18,52,75,279,5.4
1868,Matt Rafferty\matt-rafferty-1,2015-16,Furman,F,35,30,839,97,201,.483,80,148,.541,17,53,.321,68,86,.791,83,150,233,64,35,30,44,71,279,8.6
1869,Josh Nzeakor\josh-nzeakor-1,2016-17,Lamar,F,34,32,704,112,192,.583,112,191,.586,0,1,.000,55,101,.545,68,97,165,20,15,23,54,82,279,6.1
1870,Jesse Chuku\jesse-chuku-1,2013-14,Lehigh,F,32,31,878,96,254,.378,55,138,.399,41,116,.353,46,64,.719,56,132,188,22,14,46,31,70,279,6.7
1871,Jack Williams\jack-williams-1,2016-17,Pacific,F,32,0,770,96,254,.378,46,126,.365,50,128,.391,37,54,.685,57,146,203,24,13,9,23,64,279,6.4
1872,Brian Fitzpatrick\brian-fitzpatrick-1,2013-14,Bucknell,F,30,30,735,115,195,.590,110,184,.598,5,11,.455,44,61,.721,45,108,153,28,4,6,45,74,279,6.6
1873,Zarko Valjarevic\zarko-valjarevic-1,2014-15,Maine,F,28,19,882,93,270,.344,29,83,.349,64,187,.342,29,38,.763,13,52,65,41,18,2,40,63,279,4.7
1874,Kendall Pollard\kendall-pollard-1,2015-16,Dayton,F,27,26,704,103,209,.493,100,195,.513,3,14,.214,70,127,.551,33,98,131,38,17,11,53,71,279,6.4
1875,Landen Lucas\landen-lucas-1,2016-17,Kansas,F,35,30,895,113,179,.631,113,179,.631,0,0,,53,85,.624,106,184,290,37,18,34,62,117,279,7.8
1876,Issac Vann\issac-vann-1,2015-16,Maine,F,17,16,481,90,197,.457,69,146,.473,21,51,.412,78,100,.780,30,69,99,29,27,14,39,55,279,12.1
1877,Jordyn Martin\jordyn-martin-1,2014-15,Northern Arizona,F,36,32,1044,118,213,.554,118,213,.554,0,0,,42,64,.656,128,149,277,28,16,14,32,117,278,7.5
1878,Tanksley Efianayi\tanksley-efianayi-1,2016-17,Central Florida,F,34,23,842,91,230,.396,63,144,.438,28,86,.326,68,93,.731,27,91,118,44,16,4,61,51,278,4.6
1879,Tariq Owens\tariq-owens-1,2017-18,St. John's (NY),F,33,26,1001,113,224,.504,101,187,.540,12,37,.324,40,58,.690,52,143,195,17,20,94,42,102,278,7.7
1880,Kwan Cheatham\kwan-cheatham-1,2014-15,Akron,F,35,30,825,100,272,.368,51,122,.418,49,150,.327,29,45,.644,40,134,174,54,14,39,59,82,278,5.0
1881,Jacob Grandison\jacob-grandison-1,2017-18,Holy Cross,F,31,18,852,100,226,.442,62,106,.585,38,120,.317,40,54,.741,24,117,141,61,24,5,55,74,278,6.2
1882,Jacob Evans\jacob-evans-1,2015-16,Cincinnati,F,33,8,806,94,253,.372,49,118,.415,45,135,.333,45,56,.804,36,99,135,54,27,27,25,61,278,6.8
1883,Kurt Steidl\kurt-steidl-1,2014-15,Vermont,F,34,31,928,86,216,.398,29,64,.453,57,152,.375,49,61,.803,20,103,123,39,24,13,40,65,278,5.8
1884,Wajid Aminu\wajid-aminu-2,2017-18,North Florida,F,28,28,714,96,223,.430,94,196,.480,2,27,.074,84,119,.706,58,128,186,49,23,29,45,75,278,8.1
1885,Leland King\leland-king-1,2013-14,Brown,F,29,6,529,113,249,.454,88,166,.530,25,83,.301,27,50,.540,46,104,150,18,14,16,38,54,278,6.3
1886,Jerran Young\jerran-young-1,2013-14,Wright State,F,35,9,730,100,210,.476,82,152,.539,18,58,.310,60,92,.652,40,85,125,45,51,41,61,105,278,6.3
1887,Jeff Beverly\jeff-beverly-2,2013-14,Texas A&M-Corpus Christi,F,34,34,667,100,225,.444,81,179,.453,19,46,.413,59,81,.728,48,54,102,13,11,7,58,83,278,4.0
1888,Amanze Egekeze\amanze-egekeze-1,2015-16,Belmont,F,31,31,705,96,178,.539,53,76,.697,43,102,.422,43,56,.768,30,76,106,22,13,13,27,96,278,6.5
1889,Isaiah Roby\isaiah-roby-1,2017-18,Nebraska,F,32,13,769,95,168,.565,78,126,.619,17,42,.405,71,98,.724,53,147,200,53,20,63,48,103,278,8.8
1890,Dyshawn Pierre\dyshawn-pierre-1,2015-16,Dayton,F,22,20,731,93,209,.445,67,134,.500,26,75,.347,66,78,.846,54,132,186,50,13,4,38,46,278,10.7
1891,Dexter Werner\dexter-werner-1,2014-15,North Dakota State,F,33,3,656,107,209,.512,107,209,.512,0,0,,64,95,.674,69,108,177,24,19,34,39,75,278,7.1
1892,Ross Rivera\ross-rivera-1,2013-14,Pacific,F,34,9,650,96,218,.440,72,156,.462,24,62,.387,62,71,.873,26,56,82,24,18,10,36,82,278,4.9
1893,Steven Thornton\steven-thornton-1,2013-14,UC-Riverside,F,31,31,876,88,209,.421,52,100,.520,36,109,.330,65,86,.756,22,54,76,30,27,8,33,89,277,5.6
1894,Elijah Childs\elijah-childs-1,2017-18,Bradley,F,33,12,691,113,225,.502,106,200,.530,7,25,.280,44,82,.537,77,127,204,21,24,46,45,76,277,7.2
1895,Malik Pope\malik-pope-1,2015-16,San Diego State,F,38,16,810,101,252,.401,63,150,.420,38,102,.373,37,57,.649,33,156,189,29,9,29,42,56,277,5.0
1896,Danny Robison\danny-robison-1,2014-15,Montana State,F,30,21,794,93,205,.454,59,114,.518,34,91,.374,57,89,.640,41,97,138,20,8,8,38,97,277,5.6
1897,Devin Williams\devin-williams-1,2013-14,West Virginia,F,33,31,769,99,239,.414,99,239,.414,0,0,,79,138,.572,81,157,238,25,19,7,52,96,277,5.5
1898,Travin Thibodeaux\travin-thibodeaux-1,2016-17,New Orleans,F,32,31,922,105,203,.517,105,199,.528,0,4,.000,67,96,.698,66,167,233,104,47,15,93,103,277,8.1
1899,Dexter Werner\dexter-werner-1,2015-16,North Dakota State,F,33,2,730,104,209,.498,104,208,.500,0,1,.000,69,116,.595,83,137,220,26,25,31,33,71,277,7.8
1900,Darius Carter\darius-carter-1,2013-14,Wichita State,F,35,6,639,97,185,.524,97,185,.524,0,0,,82,128,.641,49,108,157,12,10,28,16,71,276,6.5
1901,Mike Aaman\mike-aaman-2,2015-16,Wagner,F,34,21,654,110,218,.505,110,218,.505,0,0,,56,94,.596,83,104,187,19,15,20,46,89,276,5.9
1902,Volodymyr Gerun\volodymyr-gerun-1,2014-15,Portland,F,33,30,802,106,213,.498,103,200,.515,3,13,.231,61,91,.670,89,108,197,27,22,39,55,87,276,7.0
1903,Mike Parks Jr.\mike-parksjr-1,2017-18,Memphis,F,34,33,753,116,209,.555,114,202,.564,2,7,.286,42,60,.700,67,86,153,22,8,22,47,67,276,6.1
1904,Tre'Shawn Thurman\treshawn-thurman-1,2014-15,Omaha,F,29,26,749,99,213,.465,86,169,.509,13,44,.295,65,102,.637,33,130,163,26,31,30,41,79,276,7.3
1905,Dominic Robb\dominic-robb-1,2016-17,Niagara,F,33,30,845,111,241,.461,111,241,.461,0,0,,54,84,.643,71,136,207,22,6,74,39,106,276,6.7
1906,Emani Gant\emani-gant-1,2013-14,Texas State,F,31,30,741,118,216,.546,118,216,.546,0,0,,40,70,.571,61,95,156,38,18,20,51,82,276,6.6
1907,Paulius Satkus\paulius-satkus-1,2016-17,James Madison,F,32,21,622,105,189,.556,102,181,.564,3,8,.375,63,81,.778,39,82,121,31,9,6,53,83,276,5.6
1908,Adam Link\adam-link-1,2013-14,Western Illinois,F,30,21,866,114,196,.582,114,195,.585,0,1,.000,48,84,.571,42,98,140,51,20,15,52,46,276,7.5
1909,Paul Thomas\paul-thomas-1,2016-17,Texas-El Paso,F,32,29,795,114,207,.551,114,204,.559,0,3,.000,48,83,.578,46,149,195,52,22,13,52,117,276,6.5
1910,Myo Baxter-Bell\myo-baxter-bell-1,2016-17,Liberty,F,35,28,626,104,219,.475,103,210,.490,1,9,.111,67,95,.705,41,76,117,30,28,4,47,87,276,5.0
1911,Donovan Ross\donovan-ross-1,2014-15,Lamar,F,30,17,710,98,190,.516,97,181,.536,1,9,.111,79,97,.814,43,75,118,23,27,20,50,62,276,7.0
1912,Auston Barnes\auston-barnes-1,2013-14,Bradley,F,32,31,1016,96,220,.436,66,132,.500,30,88,.341,53,67,.791,73,106,179,34,20,11,35,73,275,7.0
1913,Joshua Treadwell\joshua-treadwell-1,2016-17,Coppin State,F,32,11,650,88,259,.340,50,140,.357,38,119,.319,61,78,.782,26,97,123,20,17,1,48,64,275,4.0
1914,Sam Thompson\sam-thompson-1,2013-14,Ohio State,F,35,14,862,103,229,.450,76,153,.497,27,76,.355,42,68,.618,20,75,95,28,23,30,27,60,275,5.6
1915,Shane Richards\shane-richards-1,2013-14,Manhattan,F,33,4,716,84,203,.414,7,20,.350,77,183,.421,30,39,.769,11,46,57,23,22,3,18,71,275,5.4
1916,Jonathan Holton\jonathan-holton-1,2015-16,West Virginia,F,31,20,717,105,197,.533,94,152,.618,11,45,.244,54,81,.667,113,122,235,44,31,10,37,83,275,9.1
1917,Willie Rodriguez\willie-rodriguez-1,2016-17,Binghamton,F,23,20,613,103,207,.498,81,150,.540,22,57,.386,47,64,.734,32,94,126,26,16,14,48,46,275,8.4
1918,Kurt Steidl\kurt-steidl-1,2016-17,Vermont,F,35,34,1003,87,210,.414,29,63,.460,58,147,.395,43,52,.827,15,136,151,43,31,21,22,69,275,6.8
1919,Uche Ofoegbu\uche-ofoegbu-1,2015-16,San Francisco,F,30,21,775,101,199,.508,71,130,.546,30,69,.435,43,67,.642,30,107,137,25,18,10,51,71,275,6.1
1920,Bennett Koch\bennett-koch-1,2015-16,Northern Iowa,F,36,36,675,99,199,.497,99,199,.497,0,0,,77,104,.740,35,92,127,16,10,13,52,91,275,4.4
1921,Matt Van Scyoc\matt-vanscyoc-1,2016-17,Indiana State,F,31,30,754,85,212,.401,17,40,.425,68,172,.395,37,64,.578,12,73,85,22,11,6,32,85,275,4.7
1922,Jameel McKay\jameel-mckay-1,2014-15,Iowa State,F,25,12,679,98,168,.583,98,168,.583,0,0,,79,132,.598,68,122,190,14,19,59,30,57,275,11.1
1923,Maurice Strong\maurice-strong-2,2013-14,Alabama State,F,32,32,878,101,218,.463,101,215,.470,0,3,.000,72,122,.590,89,126,215,25,23,32,62,105,274,6.3
1924,J.J. O'Brien\jj-obrien-1,2013-14,San Diego State,F,35,35,975,101,220,.459,96,201,.478,5,19,.263,67,104,.644,71,92,163,38,24,12,48,73,274,5.8
1925,Donte Grantham\donte-grantham-1,2014-15,Clemson,F,31,31,918,102,274,.372,61,127,.480,41,147,.279,29,53,.547,50,92,142,52,27,31,53,46,274,6.1
1926,Shannon Hale\shannon-hale-1,2013-14,Alabama,F,31,19,698,88,203,.433,57,115,.496,31,88,.352,67,106,.632,28,83,111,32,17,11,54,62,274,5.3
1927,Tashombe Riley\tashombe-riley-1,2015-16,South Carolina State,F,34,25,729,120,263,.456,118,249,.474,2,14,.143,32,40,.800,60,115,175,15,11,8,25,82,274,5.3
1928,Eli Chuha\eli-chuha-1,2017-18,New Mexico State,F,33,1,612,106,210,.505,98,178,.551,8,32,.250,54,91,.593,61,98,159,31,14,7,44,67,274,6.0
1929,Kuran Iverson\kuran-iverson-1,2015-16,Rhode Island,F,28,25,759,109,228,.478,93,187,.497,16,41,.390,40,79,.506,58,142,200,43,22,33,62,83,274,7.3
1930,Alex Larsson\alex-larsson-1,2017-18,UC-Riverside,F,28,25,668,111,210,.529,111,210,.529,0,0,,52,82,.634,55,105,160,20,8,17,67,82,274,5.8
1931,Aurimas Majauskas\aurimas-majauskas-1,2014-15,Sam Houston State,F,34,0,469,85,152,.559,74,126,.587,11,26,.423,93,120,.775,55,83,138,17,8,3,41,78,274,6.0
1932,Blake Reynolds\blake-reynolds-1,2016-17,Yale,F,29,29,754,97,228,.425,56,116,.483,41,112,.366,39,52,.750,42,102,144,73,23,3,46,47,274,7.6
1933,Kimani Jackson\kimani-jackson-1,2017-18,Nicholls State,F,32,26,676,104,161,.646,103,157,.656,1,4,.250,65,96,.677,78,106,184,12,23,26,53,115,274,7.1
1934,Curtis Phillips\curtis-phillips-1,2014-15,Campbell,F,32,15,750,84,222,.378,40,103,.388,44,119,.370,62,87,.713,37,96,133,31,29,12,48,74,274,5.6
1935,Mike Rowley\michael-rowley-1,2015-16,Albany (NY),F,33,33,953,104,179,.581,104,178,.584,0,1,.000,66,91,.725,86,128,214,38,33,11,53,93,274,7.8
1936,Marc Eddy Norelia\marc-eddy-norelia-1,2014-15,Florida Gulf Coast,F,33,4,723,110,216,.509,110,216,.509,0,0,,53,86,.616,56,114,170,29,14,7,43,58,273,6.0
1937,Matt Costello\matt-costello-1,2014-15,Michigan State,F,39,6,794,110,190,.579,110,186,.591,0,4,.000,53,79,.671,79,123,202,29,16,48,31,107,273,6.7
1938,Michael Finke\michael-finke-1,2017-18,Illinois,F,28,25,699,107,218,.491,78,124,.629,29,94,.309,30,49,.612,52,78,130,30,9,8,22,56,273,7.4
1939,Colin Voss\colin-voss-1,2014-15,North Texas,F,31,30,926,105,218,.482,105,217,.484,0,1,.000,63,78,.808,54,126,180,58,15,24,47,88,273,7.2
1940,David DiLeo\david-dileo-1,2016-17,Central Michigan,F,32,1,784,85,221,.385,21,51,.412,64,170,.376,39,46,.848,44,117,161,23,21,3,20,71,273,6.4
1941,Nate Kratch\nate-kratch-1,2015-16,Santa Clara,F,31,29,860,110,203,.542,110,203,.542,0,0,,53,91,.582,88,156,244,19,20,23,33,92,273,8.0
1942,Brian Williams\brian-williams-9,2014-15,Louisiana,F,27,22,623,101,214,.472,92,191,.482,9,23,.391,62,84,.738,38,61,99,27,23,16,42,42,273,7.2
1943,Jose Rodriguez\jose-rodriguez-1,2015-16,Texas Southern,F,31,8,628,93,217,.429,59,137,.431,34,80,.425,53,70,.757,28,73,101,40,13,5,45,82,273,5.2
1944,Trey Kellum\trey-kellum-1,2013-14,Florida A&M,F,31,27,736,111,224,.496,111,224,.496,0,0,,51,82,.622,78,124,202,21,25,22,59,107,273,6.2
1945,Onochie Ochie\onochie-ochie-1,2014-15,Southeastern Louisiana,F,32,26,736,101,173,.584,99,168,.589,2,5,.400,69,109,.633,49,122,171,12,15,31,57,124,273,5.8
1946,Gregory Graves\gregory-graves-1,2014-15,Mount St. Mary's,F,27,27,797,90,213,.423,71,163,.436,19,50,.380,74,107,.692,65,134,199,34,34,14,46,65,273,8.4
1947,Del'Vin Dickerson\delvin-dickerson-1,2016-17,North Carolina Central,F,34,34,683,103,196,.526,89,146,.610,14,50,.280,53,86,.616,48,110,158,15,21,17,33,81,273,6.1
1948,Octavius Brown\octavius-brown-1,2015-16,Alcorn State,F,21,21,651,99,207,.478,71,136,.522,28,71,.394,47,62,.758,36,111,147,19,16,28,38,50,273,10.1
1949,Stephen Zimmerman Jr.\stephen-zimmermanjr-1,2015-16,Nevada-Las Vegas,F,26,24,680,102,214,.477,97,197,.492,5,17,.294,63,101,.624,56,171,227,22,14,51,54,79,272,8.4
1950,Tevin Falzon\tevin-falzon-1,2015-16,Sacred Heart,F,25,22,762,81,217,.373,63,155,.406,18,62,.290,92,115,.800,94,113,207,38,8,36,34,71,272,9.6
1951,Nathan Dieudonne\nathan-dieudonne-1,2015-16,Boston University,F,28,25,805,99,201,.493,94,181,.519,5,20,.250,69,118,.585,72,146,218,59,26,7,68,90,272,7.6
1952,Ramel Thompkins\ramel-thompkins-1,2016-17,South Carolina Upstate,F,33,27,895,94,220,.427,34,57,.596,60,163,.368,24,36,.667,38,119,157,55,22,19,37,49,272,7.0
1953,Paulius Zalys\paulius-zalys-1,2016-17,Lafayette,F,30,19,697,104,229,.454,72,130,.554,32,99,.323,32,47,.681,21,101,122,46,12,7,69,62,272,4.9
1954,Chris Perry\chris-perry-1,2015-16,South Florida,F,27,19,651,105,230,.457,105,225,.467,0,5,.000,62,93,.667,61,116,177,31,11,13,48,72,272,6.8
1955,Jake Zuilhof\jake-zuilhof-1,2014-15,Central Arkansas,F,29,29,877,100,194,.515,100,194,.515,0,0,,72,111,.649,68,110,178,31,23,49,74,83,272,7.3
1956,Marc Gosselin\marc-gosselin-1,2017-18,Western Carolina,F,31,30,843,104,225,.462,77,152,.507,27,73,.370,37,48,.771,60,142,202,45,34,19,59,90,272,7.1
1957,Arkadiy Mkrtychyan\arkadiy-mkrtychyan-1,2016-17,Idaho,F,33,21,679,103,197,.523,99,184,.538,4,13,.308,62,95,.653,42,99,141,30,12,10,35,85,272,5.8
1958,Matt Rose\matt-rose-1,2017-18,Lipscomb,F,33,8,655,83,211,.393,21,43,.488,62,168,.369,44,54,.815,21,74,95,31,7,6,24,52,272,5.4
1959,Jack Williams\jack-williams-1,2017-18,Pacific,F,32,32,992,99,255,.388,59,137,.431,40,118,.339,34,53,.642,44,146,190,28,10,9,33,63,272,5.6
1960,Marquez Letcher-Ellis\marquez-letcher-ellis-1,2016-17,Rice,F,35,15,667,86,183,.470,67,128,.523,19,55,.345,80,121,.661,50,120,170,18,28,36,76,110,271,5.1
1961,Justin Gray\justin-gray-2,2015-16,Texas Tech,F,31,12,730,89,174,.511,67,122,.549,22,52,.423,71,91,.780,47,69,116,26,26,17,35,65,271,7.3
1962,Devonte Elliott\devonte-elliott-1,2014-15,Cal State Northridge,F,33,24,882,102,258,.395,94,219,.429,8,39,.205,59,73,.808,41,144,185,29,20,44,50,91,271,5.5
1963,Jaylen Johnson\jaylen-johnson-1,2016-17,Louisville,F,34,26,696,106,180,.589,102,173,.590,4,7,.571,55,88,.625,91,105,196,18,16,17,44,82,271,6.9
1964,Jamar Hurdle\jamar-hurdle-1,2016-17,Green Bay,F,31,4,546,114,238,.479,99,205,.483,15,33,.455,28,41,.683,47,77,124,16,25,28,42,76,271,5.9
1965,Josh Cuthbertson\josh-cuthbertson-1,2016-17,South Carolina Upstate,F,32,29,898,100,222,.450,62,112,.554,38,110,.345,33,46,.717,36,78,114,103,14,3,54,57,271,6.6
1966,Naji Marshall\naji-marshall-1,2017-18,Xavier,F,35,18,764,96,181,.530,81,138,.587,15,43,.349,64,85,.753,41,113,154,57,23,10,56,59,271,6.5
1967,Mike Tobey\mike-tobey-1,2015-16,Virginia,F,37,7,581,119,198,.601,117,188,.622,2,10,.200,31,50,.620,56,105,161,15,10,22,25,78,271,6.0
1968,Dalonte Brown\dalonte-brown-1,2017-18,Miami (OH),F,34,33,736,104,241,.432,76,160,.475,28,81,.346,35,58,.603,36,148,184,11,14,22,40,86,271,4.9
1969,Montae Glenn\montae-glenn-1,2017-18,Georgia Southern,F,30,29,768,112,205,.546,111,204,.544,1,1,1.000,46,74,.622,126,117,243,11,20,42,34,70,271,9.3
1970,Cole Darling\cole-darling-1,2013-14,Wright State,F,32,24,598,82,222,.369,67,178,.376,15,44,.341,92,116,.793,31,75,106,19,29,19,41,107,271,4.8
1971,Aric Holman\aric-holman-1,2016-17,Mississippi State,F,32,25,747,105,211,.498,93,162,.574,12,49,.245,49,75,.653,57,136,193,20,21,63,54,79,271,7.2
1972,Daviyon Draper\daviyon-draper-1,2014-15,Florida International,F,31,22,836,100,225,.444,91,200,.455,9,25,.360,61,85,.718,33,124,157,35,49,22,63,85,270,6.3
1973,Jamaal Samuel\jamaal-samuel-1,2014-15,Louisiana-Monroe,F,38,18,735,111,263,.422,82,158,.519,29,105,.276,19,33,.576,32,110,142,18,13,39,36,71,270,4.4
1974,Jyles Smith\jyles-smith-1,2013-14,Savannah State,F,32,31,881,104,192,.542,104,191,.545,0,1,.000,62,102,.608,79,183,262,23,29,98,69,108,270,8.5
1975,Damian Young\damion-young-1,2015-16,Mississippi Valley State,F,34,17,680,93,259,.359,59,154,.383,34,105,.324,50,63,.794,23,65,88,32,54,10,54,63,270,4.7
1976,Andrew Smith\andrew-smith-3,2013-14,Liberty,F,32,18,684,111,179,.620,110,178,.618,1,1,1.000,47,81,.580,62,122,184,25,25,36,42,88,270,7.7
1977,Jeremiah Tilmon\jeremiah-tilmon-1,2017-18,Missouri,F,33,33,640,115,204,.564,115,204,.564,0,0,,40,76,.526,63,75,138,15,8,33,70,121,270,4.5
1978,Aaron Falzon\aaron-falzon-1,2015-16,Northwestern,F,32,29,785,87,227,.383,24,49,.490,63,178,.354,33,46,.717,42,67,109,28,11,10,21,74,270,5.5
1979,Royce O'Neale\royce-oneale-1,2013-14,Baylor,F,38,31,1036,92,177,.520,63,115,.548,29,62,.468,57,95,.600,74,131,205,110,34,7,63,88,270,7.3
1980,Joshua Montgomery\joshua-montgomery-1,2013-14,Savannah State,F,31,15,764,92,212,.434,74,141,.525,18,71,.254,68,96,.708,52,103,155,19,31,7,43,73,270,6.2
1981,Ed Polite Jr.\ed-politejr-1,2015-16,Radford,F,31,14,784,105,194,.541,105,194,.541,0,0,,60,114,.526,100,128,228,25,26,55,53,80,270,8.4
1982,Aaron Brennan\aaron-brennan-1,2016-17,IUPUI,F,32,10,596,102,203,.502,75,146,.514,27,57,.474,39,54,.722,26,85,111,26,16,10,30,76,270,5.9
1983,A.J. Turner\aj-turner-1,2016-17,Boston College,F,32,28,987,97,230,.422,48,98,.490,49,132,.371,27,40,.675,20,85,105,96,19,7,33,47,270,6.9
1984,Donte Grantham\donte-grantham-1,2017-18,Clemson,F,19,19,605,102,182,.560,76,120,.633,26,62,.419,39,50,.780,30,101,131,45,15,17,32,38,269,12.7
1985,Brian Bennett\brian-bennett-1,2015-16,Cal Poly,F,30,8,577,123,240,.513,123,240,.513,0,0,,23,47,.489,43,78,121,22,6,6,24,55,269,5.8
1986,Nate Navigato\nate-navigato-1,2015-16,Toledo,F,32,9,731,84,209,.402,23,50,.460,61,159,.384,40,48,.833,20,90,110,42,22,6,32,66,269,6.0
1987,Mike Thomas\mike-thomas-2,2015-16,Hawaii,F,34,34,741,100,192,.521,94,160,.588,6,32,.188,63,111,.568,63,126,189,28,11,12,46,97,269,5.6
1988,Jerome Robinson\jerome-robinson-2,2015-16,Boston College,F,23,23,769,100,233,.429,77,171,.450,23,62,.371,46,71,.648,9,84,93,70,32,7,61,49,269,7.5
1989,Camyn Boone\camyn-boone-1,2014-15,Missouri State,F,31,30,710,101,177,.571,101,177,.571,0,0,,67,99,.677,63,105,168,23,12,25,43,101,269,6.8
1990,Tony Bradley\tony-bradley-1,2016-17,North Carolina,F,38,0,553,102,178,.573,102,178,.573,0,0,,65,105,.619,98,97,195,23,10,22,25,69,269,6.7
1991,Christian Jones\christian-jones-1,2015-16,St. John's (NY),F,32,19,807,110,230,.478,109,227,.480,1,3,.333,48,79,.608,46,121,167,44,27,17,61,67,269,5.9
1992,Rashawn Thomas\rashawn-thomas-1,2013-14,Texas A&M-Corpus Christi,F,25,0,547,109,183,.596,106,172,.616,3,11,.273,48,87,.552,40,89,129,12,16,33,49,66,269,7.8
1993,Luke Meyer\luke-meyer-2,2015-16,Central Michigan,F,33,33,707,110,193,.570,100,157,.637,10,36,.278,39,53,.736,56,99,155,8,16,35,16,94,269,7.1
1994,Brandon Johnson\brandon-johnson-56,2017-18,Western Michigan,F,29,29,787,106,219,.484,99,194,.510,7,25,.280,50,77,.649,61,106,167,20,13,16,33,75,269,6.8
1995,Phillip Lawrence-Ricks\phillip-lawrence-1,2014-15,Marist,F,32,31,846,95,207,.459,62,110,.564,33,97,.340,46,70,.657,33,88,121,29,19,12,38,79,269,5.6
1996,Jordan Allen\jordan-allen-1,2014-15,Sacred Heart,F,31,1,666,109,175,.623,109,175,.623,0,0,,51,104,.490,61,70,131,28,23,11,48,98,269,6.3
1997,Sam McBeath\sam-mcbeath-1,2014-15,Nicholls State,F,29,29,728,92,201,.458,69,130,.531,23,71,.324,62,98,.633,55,140,195,49,23,15,69,78,269,6.9
1998,Luke Meikle\luke-meikle-1,2017-18,Cal Poly,F,31,29,789,94,253,.372,61,154,.396,33,99,.333,48,56,.857,29,103,132,36,14,8,36,62,269,5.2
1999,Antravious Simmons\antravious-simmons-1,2015-16,Florida Gulf Coast,F,34,16,562,112,207,.541,112,206,.544,0,1,.000,45,72,.625,59,119,178,23,14,14,36,101,269,5.8
2000,Markus Crider\markus-crider-1,2015-16,Georgia State,F,30,22,870,101,187,.540,101,185,.546,0,2,.000,66,98,.673,38,112,150,29,25,16,44,96,268,6.6
2001,Gilvydas Biruta\gilvydas-biruta-1,2014-15,Rhode Island,F,33,32,687,103,184,.560,101,173,.584,2,11,.182,60,87,.690,67,84,151,33,17,15,43,92,268,6.4
2002,Savon Goodman\savon-goodman-1,2015-16,Arizona State,F,28,6,588,105,191,.550,105,187,.561,0,4,.000,58,126,.460,61,119,180,15,16,15,40,87,268,6.8
2003,Phillip Anglade\phillip-anglade-1,2014-15,Virginia Military Institute,F,30,22,693,111,185,.600,111,184,.603,0,1,.000,46,97,.474,91,82,173,25,24,87,43,101,268,9.0
2004,Reggie Spencer\reggie-spencer-1,2013-14,Northeastern,F,29,25,799,100,209,.478,100,208,.481,0,1,.000,68,112,.607,66,126,192,20,8,15,44,73,268,6.5
2005,Chuck Ester\chuck-ester-1,2015-16,Chattanooga,F,35,30,857,106,206,.515,92,171,.538,14,35,.400,42,69,.609,37,133,170,57,35,15,61,61,268,6.3
2006,JD Miller\jd-miller-1,2016-17,Texas Christian,F,37,36,697,101,239,.423,69,138,.500,32,101,.317,34,56,.607,30,90,120,37,19,15,39,47,268,4.8
2007,Cody Helgeland\cody-helgeland-1,2017-18,Jacksonville,F,33,20,970,90,239,.377,28,61,.459,62,178,.348,26,34,.765,25,80,105,34,18,14,48,68,268,4.6
2008,Sheldon Jeter\sheldon-jeter-1,2016-17,Pittsburgh,F,33,33,955,94,222,.423,66,145,.455,28,77,.364,52,72,.722,79,161,240,54,30,33,50,92,268,7.6
2009,Nate Buss\nate-buss-1,2014-15,Northern Iowa,F,35,0,613,94,200,.470,54,102,.529,40,98,.408,40,50,.800,25,71,96,2,3,15,21,55,268,4.9
2010,Nick Smith\nick-smith-3,2016-17,Belmont,F,30,1,418,90,190,.474,21,27,.778,69,163,.423,19,20,.950,16,32,48,9,8,2,6,40,268,6.2
2011,Willie Atwood\willie-atwood-1,2015-16,Arizona State,F,32,32,866,78,196,.398,46,94,.489,32,102,.314,80,102,.784,50,89,139,44,15,9,30,97,268,6.2
2012,Tamas Bruce\tamas-bruce-1,2017-18,Arkansas State,F,30,25,672,103,194,.531,103,193,.534,0,1,.000,62,98,.633,83,89,172,12,22,21,46,108,268,6.7
2013,Tom Lacey\tom-lacey-1,2017-18,Navy,F,31,30,810,89,175,.509,88,169,.521,1,6,.167,88,131,.672,62,141,203,51,24,11,54,73,267,7.5
2014,Luke Morrison\luke-morrison-1,2016-17,Army,F,30,20,597,96,240,.400,26,47,.553,70,193,.363,5,7,.714,25,114,139,19,14,8,36,56,267,5.4
2015,David Jesperson\david-jesperson-1,2017-18,Green Bay,F,33,33,819,97,227,.427,43,82,.524,54,145,.372,19,23,.826,31,100,131,32,15,17,36,67,267,5.6
2016,Ed Drew\ed-drew-1,2016-17,Presbyterian,F,30,25,792,96,232,.414,96,222,.432,0,10,.000,75,99,.758,72,97,169,16,24,25,50,69,267,6.3
2017,Zach Brown\zach-brown-2,2016-17,Wichita State,F,36,29,755,82,201,.408,44,91,.484,38,110,.345,65,94,.691,41,74,115,56,24,7,38,73,267,5.5
2018,Connor Boehm\connor-boehm-1,2014-15,Dartmouth,F,28,27,769,106,202,.525,89,163,.546,17,39,.436,38,69,.551,50,92,142,29,12,5,52,71,267,6.2
2019,Brandon Morris\brandon-morris-3,2013-14,Georgia,F,31,25,787,86,173,.497,80,153,.523,6,20,.300,89,140,.636,39,65,104,44,19,12,55,74,267,5.8
2020,Justin Leon\justin-leon-1,2016-17,Florida,F,36,36,804,92,213,.432,43,90,.478,49,123,.398,34,43,.791,49,96,145,17,17,5,28,82,267,5.2
2021,Sacar Anim\sacar-anim-1,2017-18,Marquette,F,35,30,944,104,216,.481,96,182,.527,8,34,.235,51,82,.622,44,59,103,57,28,2,47,96,267,5.1
2022,Ed Dyson\ed-dyson-1,2013-14,Austin Peay,F,27,26,670,90,178,.506,65,119,.546,25,59,.424,62,95,.653,14,71,85,41,23,1,46,63,267,6.6
2023,Derek Willis\derek-willis-1,2016-17,Kentucky,F,38,15,833,98,205,.478,49,75,.653,49,130,.377,22,32,.688,40,165,205,33,25,39,26,76,267,6.7
2024,Antonio Jenifer\antonio-jenifer-1,2015-16,St. Francis (NY),F,32,22,781,87,214,.407,59,115,.513,28,99,.283,65,90,.722,56,142,198,33,18,23,49,90,267,6.1
2025,Jailyn Ingram\jailyn-ingram-1,2017-18,Florida Atlantic,F,30,30,787,105,259,.405,97,228,.425,8,31,.258,49,71,.690,37,92,129,46,17,9,74,76,267,4.1
2026,Mo Alie-Cox\mo-alie-cox-1,2014-15,Virginia Commonwealth,F,36,36,935,101,170,.594,101,170,.594,0,0,,64,106,.604,110,95,205,28,23,68,38,77,266,8.3
2027,Jaylen Bond\jaylen-bond-1,2014-15,Temple,F,35,29,939,117,263,.445,107,216,.495,10,47,.213,22,61,.361,116,161,277,32,48,26,34,105,266,7.3
2028,Danny Pippen\danny-pippen-1,2017-18,Kent State,F,33,23,721,90,220,.409,57,127,.449,33,93,.355,53,66,.803,74,149,223,19,13,53,48,97,266,6.5
2029,Craig McFerrin\craig-mcferrin-1,2015-16,McNeese State,F,29,27,760,110,209,.526,110,205,.537,0,4,.000,46,71,.648,67,161,228,29,15,23,56,82,266,7.3
2030,Jay Copeland\jay-copeland-1,2013-14,North Carolina Central,F,34,34,749,93,179,.520,93,179,.520,0,0,,80,123,.650,94,104,198,8,18,25,48,116,266,6.0
2031,Sean Sellers\sean-sellers-1,2017-18,Ball State,F,32,31,869,91,216,.421,34,63,.540,57,153,.373,27,33,.818,26,112,138,37,20,12,34,58,266,6.2
2032,Ramone Snowden\ramone-snowden-1,2013-14,Niagara,F,33,30,856,82,192,.427,53,111,.477,29,81,.358,73,105,.695,54,128,182,38,31,11,56,109,266,5.9
2033,Alandise Harris\alandise-harris-1,2014-15,Arkansas,F,35,26,748,96,202,.475,87,170,.512,9,32,.281,65,90,.722,38,77,115,53,28,35,41,74,266,6.3
2034,Jake Wiegand\jake-wiegand-1,2014-15,Illinois-Chicago,F,34,20,688,94,225,.418,89,203,.438,5,22,.227,73,102,.716,69,107,176,8,13,2,44,78,266,4.7
2035,Cullen Russo\cullen-russo-1,2015-16,Fresno State,F,34,15,868,92,221,.416,80,164,.488,12,57,.211,70,107,.654,55,149,204,59,60,20,42,105,266,7.3
2036,William Powell\william-powell-1,2014-15,Seattle,F,34,34,974,96,187,.513,96,186,.516,0,1,.000,73,118,.619,87,132,219,69,17,12,75,92,265,6.4
2037,Terry Harris Jr\terry-harrisjr-1,2016-17,Coppin State,F,29,27,769,84,249,.337,69,185,.373,15,64,.234,82,104,.788,42,113,155,28,22,18,53,79,265,5.1
2038,Dan Garvin\dan-garvin-1,2015-16,Bryant,F,26,25,689,111,245,.453,110,237,.464,1,8,.125,42,80,.525,84,123,207,31,18,35,56,89,265,7.3
2039,William Lee\william-lee-1,2014-15,Alabama-Birmingham,F,33,27,783,97,200,.485,76,154,.494,21,46,.457,50,63,.794,55,143,198,36,17,51,46,67,265,7.4
2040,DeMondre Harvey\demondre-harvey-1,2015-16,Louisiana-Monroe,F,34,21,833,90,158,.570,90,158,.570,0,0,,85,124,.685,70,122,192,40,19,21,42,82,265,7.3
2041,Gary Clark\gary-clark-2,2014-15,Cincinnati,F,34,34,945,110,210,.524,110,205,.537,0,5,.000,45,72,.625,94,152,246,57,35,45,38,54,265,9.1
2042,Kameron Woods\kameron-woods-1,2014-15,Butler,F,34,34,1065,91,180,.506,91,180,.506,0,0,,83,126,.659,101,236,337,39,40,32,41,69,265,9.4
2043,Casey Oliverson\casey-oliverson-1,2015-16,Southern Utah,F,30,30,765,115,213,.540,114,208,.548,1,5,.200,34,50,.680,42,77,119,14,14,16,29,80,265,6.1
2044,Kaleb Bishop\kaleb-bishop-1,2017-18,Fairleigh Dickinson,F,30,22,701,107,208,.514,99,187,.529,8,21,.381,43,62,.694,68,122,190,18,11,15,41,88,265,6.6
2045,Nick Perkins\nick-perkins-2,2015-16,Buffalo,F,35,5,670,96,219,.438,64,122,.525,32,97,.330,41,71,.577,40,110,150,11,9,14,48,87,265,4.1
2046,Mark Donnal\mark-donnal-1,2015-16,Michigan,F,34,25,659,104,181,.575,94,148,.635,10,33,.303,47,66,.712,59,67,126,12,12,25,24,84,265,6.3
2047,Juan Davis Jr.\juan-davisjr-1,2016-17,Troy,F,37,21,739,92,185,.497,49,78,.628,43,107,.402,37,46,.804,41,105,146,10,15,12,34,72,264,5.3
2048,Alfonzo McKinnie\alfonzo-mckinnie-1,2014-15,Green Bay,F,33,20,713,105,232,.453,84,168,.500,21,64,.328,33,65,.508,65,111,176,6,16,16,46,112,264,4.6
2049,Marquise Simmons\marquise-simmons-1,2013-14,St. Bonaventure,F,33,33,738,110,185,.595,110,185,.595,0,0,,44,80,.550,73,99,172,20,19,3,37,69,264,6.5
2050,Darius Dawkins\darius-dawkins-1,2015-16,Jacksonville,F,19,17,555,87,186,.468,17,46,.370,70,140,.500,20,25,.800,10,60,70,9,4,8,20,50,264,8.8
2051,Malik Pope\malik-pope-1,2016-17,San Diego State,F,24,21,621,96,212,.453,76,161,.472,20,51,.392,52,74,.703,42,105,147,36,18,23,34,52,264,8.8
2052,Joey King\joey-king-1,2013-14,Minnesota,F,37,15,827,89,184,.484,63,113,.558,26,71,.366,60,76,.789,32,68,100,28,15,10,34,101,264,4.7
2053,Arkadiy Mkrtychyan\arkadiy-mkrtychyan-1,2014-15,Idaho,F,30,5,633,86,150,.573,84,143,.587,2,7,.286,90,131,.687,51,94,145,16,13,2,38,82,264,6.5
2054,Greig Stire\greig-stire-1,2017-18,Albany (NY),F,32,32,965,102,188,.543,102,187,.545,0,1,.000,60,87,.690,99,167,266,37,15,6,35,93,264,8.0
2055,Eric Robertson\eric-robertson-2,2015-16,South Dakota,F,32,32,656,104,221,.471,102,217,.470,2,4,.500,54,67,.806,35,67,102,10,13,18,25,76,264,5.2
2056,Braxton Tucker\braxton-tucker-1,2014-15,Portland State,F,23,22,634,109,218,.500,108,213,.507,1,5,.200,45,62,.726,53,69,122,17,11,11,30,58,264,8.0
2057,Jordan Harks\jordan-harks-1,2013-14,Illinois-Chicago,F,31,28,638,112,185,.605,112,184,.609,0,1,.000,39,79,.494,48,125,173,27,22,11,31,91,263,6.9
2058,Maik Kotsar\maik-kotsar-1,2017-18,South Carolina,F,33,33,875,107,251,.426,101,224,.451,6,27,.222,43,76,.566,58,99,157,47,31,17,58,91,263,5.1
2059,Robert Carter\robert-carter-1,2013-14,Georgia Tech,F,23,17,616,100,214,.467,86,161,.534,14,53,.264,49,75,.653,44,149,193,26,18,26,41,50,263,9.2
2060,Sam Hughes\sam-hughes-1,2013-14,North Carolina-Asheville,F,32,30,797,92,216,.426,75,167,.449,17,49,.347,62,83,.747,47,77,124,48,25,10,51,88,263,5.5
2061,Temidayo Yussuf\temidayo-yussuf-1,2017-18,Cal State Long Beach,F,29,18,546,92,208,.442,92,207,.444,0,1,.000,79,129,.612,75,104,179,37,16,12,60,100,263,5.8
2062,Georgi Boyanov\georgi-boyanov-1,2016-17,South Alabama,F,30,7,621,99,181,.547,80,139,.576,19,42,.452,46,80,.575,55,88,143,23,14,5,36,46,263,6.9
2063,Johnathan Motley\johnathan-motley-1,2014-15,Baylor,F,34,34,730,100,240,.417,97,225,.431,3,15,.200,60,96,.625,75,68,143,23,14,46,55,97,263,4.8
2064,Jonathan Holton\jonathan-holton-1,2014-15,West Virginia,F,35,35,754,100,221,.452,87,157,.554,13,64,.203,50,76,.658,105,101,206,41,41,29,51,118,263,6.7
2065,Kyle Davis\kyle-davis-2,2013-14,Utah State,F,29,27,726,89,177,.503,89,174,.511,0,3,.000,85,125,.680,89,132,221,37,12,39,45,62,263,8.8
2066,Garrett Jackson\garrett-jackson-1,2014-15,Saint Mary's (CA),F,31,20,680,98,188,.521,77,143,.538,21,45,.467,46,64,.719,59,76,135,40,16,12,34,66,263,7.1
2067,DJ Hogg\dj-hogg-1,2016-17,Texas A&M,F,22,18,652,97,244,.398,53,124,.427,44,120,.367,25,44,.568,29,83,112,75,21,21,59,46,263,8.2
2068,Shawn Kemp\shawn-kemp-1,2014-15,Washington,F,27,26,709,110,181,.608,110,181,.608,0,0,,43,72,.597,50,45,95,6,7,19,30,64,263,6.9
2069,Justin Gordon\justin-gordon-1,2014-15,Wofford,F,35,32,743,105,192,.547,104,191,.545,1,1,1.000,52,96,.542,66,75,141,46,19,17,54,93,263,5.5
2070,Angel Matias\angel-matias-1,2013-14,Georgia Southern,F,34,33,841,104,205,.507,99,168,.589,5,37,.135,50,102,.490,77,150,227,19,19,9,52,76,263,5.7
2071,David Burrell\david-burrell-3,2016-17,East Tennessee State,F,35,1,597,101,193,.523,70,117,.598,31,76,.408,30,50,.600,35,77,112,19,14,19,23,58,263,5.8
2072,Mike Aaman\mike-aaman-2,2016-17,Wagner,F,26,21,567,102,208,.490,102,208,.490,0,0,,59,93,.634,72,89,161,15,16,31,45,63,263,7.7
2073,Elijah Minnie\elijah-minnie-1,2015-16,Robert Morris,F,22,15,648,97,227,.427,61,117,.521,36,110,.327,33,43,.767,34,111,145,21,19,42,52,59,263,8.3
2074,Elliott Welmer\elliott-welmer-1,2016-17,Saint Louis,F,33,31,810,90,201,.448,57,112,.509,33,89,.371,49,78,.628,42,116,158,25,15,32,38,89,262,5.8
2075,JD Miller\jd-miller-1,2017-18,Texas Christian,F,33,24,655,101,214,.472,82,153,.536,19,61,.311,41,62,.661,42,84,126,33,20,18,37,46,262,6.0
2076,Sean Sheldon\sean-sheldon-1,2015-16,William & Mary,F,31,31,775,108,173,.624,108,173,.624,0,0,,46,70,.657,51,97,148,52,5,15,34,80,262,7.3
2077,Xeyrius Williams\xeryius-williams-1,2016-17,Dayton,F,32,9,728,93,192,.484,54,98,.551,39,94,.415,37,47,.787,52,102,154,31,20,36,34,81,262,7.1
2078,Spencer Weisz\spencer-weisz-1,2013-14,Princeton,F,30,20,845,91,195,.467,57,98,.582,34,97,.351,46,73,.630,28,117,145,67,25,12,42,53,262,7.4
2079,Daniel Alexander\daniel-alexander-1,2014-15,Grand Canyon,F,29,7,695,95,214,.444,64,105,.610,31,109,.284,41,46,.891,28,113,141,34,19,24,39,67,262,6.7
2080,Jerome Frink\jerome-frink-1,2013-14,Florida International,F,31,31,912,100,218,.459,93,182,.511,7,36,.194,54,74,.730,58,77,135,28,17,25,47,93,261,5.6
2081,DJ Laster\dj-laster-1,2016-17,Gardner-Webb,F,33,2,593,104,203,.512,89,161,.553,15,42,.357,38,61,.623,44,78,122,15,15,8,34,65,261,5.4
2082,Jordan Session\jordan-session-1,2017-18,Georgia State,F,35,35,910,102,187,.545,96,173,.555,6,14,.429,51,96,.531,73,137,210,31,44,42,47,121,261,7.0
2083,Josh Davis\josh-davis-6,2013-14,San Diego State,F,34,34,1040,105,231,.455,105,231,.455,0,0,,51,108,.472,115,227,342,29,35,16,47,69,261,7.6
2084,Lennard Freeman\lennard-freeman-1,2017-18,North Carolina State,F,33,12,569,97,149,.651,97,149,.651,0,0,,67,101,.663,52,90,142,4,29,26,23,65,261,7.5
2085,Joel Bolomboy\joel-bolomboy-1,2013-14,Weber State,F,30,28,903,83,170,.488,82,169,.485,1,1,1.000,94,129,.729,107,222,329,17,15,25,44,76,261,9.1
2086,A.J. John\aj-john-1,2017-18,UC-Davis,F,33,13,695,94,197,.477,49,80,.613,45,117,.385,28,36,.778,40,91,131,14,9,15,28,89,261,5.4
2087,Deyonta Davis\deyonta-davis-1,2015-16,Michigan State,F,35,16,650,119,199,.598,119,199,.598,0,0,,23,38,.605,72,119,191,26,9,64,30,80,261,7.4
2088,Eric Paschall\eric-paschall-1,2016-17,Villanova,F,36,8,781,100,195,.513,81,127,.638,19,68,.279,41,59,.695,49,86,135,22,19,18,43,90,260,5.1
2089,Chris Manhertz\chris-manhertz-1,2013-14,Canisius,F,31,31,746,87,178,.489,87,177,.492,0,1,.000,86,118,.729,87,128,215,24,16,14,44,102,260,6.9
2090,Tawaski King\tawaski-king-1,2013-14,Western Carolina,F,34,32,871,94,214,.439,94,213,.441,0,1,.000,72,102,.706,71,91,162,22,19,7,54,83,260,4.9
2091,Yuta Watanabe\yuta-watanabe-1,2014-15,George Washington,F,35,10,787,86,224,.384,47,112,.420,39,112,.348,49,59,.831,29,95,124,22,15,21,25,72,260,5.0
2092,Xzavier Taylor\xzavier-taylor-1,2017-18,Purdue-Fort Wayne,F,33,33,695,106,187,.567,101,174,.580,5,13,.385,43,75,.573,60,83,143,29,4,23,43,91,260,5.7
2093,Joshua Howard\joshua-howard-1,2016-17,Brown,F,30,22,615,100,193,.518,94,167,.563,6,26,.231,54,83,.651,42,83,125,3,35,18,36,76,260,6.4
2094,DeVaughn Mallory\devaughn-mallory-1,2016-17,Delaware State,F,25,20,612,119,210,.567,119,210,.567,0,0,,22,35,.629,70,88,158,21,15,11,31,75,260,8.3
2095,Eli Pepper\eli-pepper-1,2015-16,Lipscomb,F,33,33,758,101,197,.513,89,156,.571,12,41,.293,46,85,.541,62,193,255,53,9,29,60,80,260,6.7
2096,L.J. Peak\lj-peak-1,2014-15,Georgetown,F,33,32,834,91,231,.394,74,162,.457,17,69,.246,61,87,.701,24,51,75,32,28,12,44,67,260,4.4
2097,Till Gloger\till-gloger-1,2015-16,Maine,F,29,11,463,112,200,.560,112,200,.560,0,0,,36,57,.632,35,43,78,2,9,3,29,38,260,5.6
2098,JT Yoho\jt-yoho-1,2013-14,Wright State,F,33,12,678,95,215,.442,51,95,.537,44,120,.367,26,39,.667,17,84,101,46,10,1,48,62,260,4.5
2099,Tevin Falzon\tevin-falzon-1,2014-15,Sacred Heart,F,32,21,722,87,204,.426,84,187,.449,3,17,.176,83,121,.686,102,140,242,26,26,48,54,75,260,7.6
2100,Josh Cunningham\josh-cunningham-1,2014-15,Bradley,F,33,32,999,96,221,.434,81,157,.516,15,64,.234,53,93,.570,86,161,247,18,34,14,50,60,260,6.6
2101,Khadeem Lattin\khadeem-lattin-1,2016-17,Oklahoma,F,31,31,738,94,182,.516,94,182,.516,0,0,,72,100,.720,74,120,194,13,36,66,44,109,260,8.1
2102,Sarp Gobeloglu\sarp-gobeloglu-1,2015-16,Montana State,F,31,0,627,91,202,.450,37,64,.578,54,138,.391,24,29,.828,27,83,110,19,7,14,37,70,260,5.2
2103,Tyler Scanlon\tyler-scanlon-1,2016-17,Boston University,F,32,22,808,93,219,.425,32,68,.471,61,151,.404,13,21,.619,18,88,106,35,33,5,26,42,260,6.2
2104,Ivan Raut\ivan-raut-1,2017-18,Fordham,F,31,29,891,88,229,.384,33,63,.524,55,166,.331,29,35,.829,11,102,113,47,28,0,47,49,260,5.3
2105,Cedric Kuakumensah\cedric-kuakumensah-1,2013-14,Brown,F,29,28,738,101,251,.402,101,250,.404,0,1,.000,58,83,.699,60,149,209,26,11,93,41,100,260,7.4
2106,Spencer Parker\spencer-parker-1,2014-15,Bowling Green State,F,33,26,822,88,216,.407,72,156,.462,16,60,.267,67,92,.728,37,85,122,30,21,4,43,77,259,4.7
2107,Jayon James\jayon-james-2,2013-14,Louisiana-Monroe,F,27,26,847,97,204,.475,96,192,.500,1,12,.083,64,117,.547,29,134,163,124,31,19,72,73,259,8.3
2108,Mangok Mathiang\mangok-mathiang-1,2016-17,Louisville,F,33,19,686,104,196,.531,104,196,.531,0,0,,51,76,.671,85,113,198,24,17,37,38,82,259,7.1
2109,Marshall Wood\marshall-wood-1,2015-16,Richmond,F,30,3,701,88,200,.440,30,56,.536,58,144,.403,25,48,.521,29,88,117,14,15,14,23,68,259,5.9
2110,George Kiernan\george-kiernan-1,2016-17,Navy,F,30,0,568,83,204,.407,38,83,.458,45,121,.372,48,62,.774,28,74,102,19,15,11,42,88,259,4.8
2111,Justin Tillman\justin-tillman-1,2015-16,Virginia Commonwealth,F,36,4,593,108,179,.603,108,178,.607,0,1,.000,43,76,.566,83,136,219,8,12,17,23,54,259,6.9
2112,Trey Kellum\trey-kellum-1,2015-16,Southeast Missouri State,F,25,23,596,99,201,.493,99,201,.493,0,0,,61,105,.581,52,90,142,14,12,4,52,92,259,5.6
2113,Markus Kennedy\markus-kennedy-1,2015-16,Southern Methodist,F,28,9,646,110,216,.509,108,212,.509,2,4,.500,37,66,.561,59,118,177,61,20,34,48,66,259,8.2
2114,Mario Moody\mario-moody-1,2013-14,Wagner,F,29,14,646,103,226,.456,94,198,.475,9,28,.321,43,67,.642,64,106,170,15,19,39,42,78,258,6.6
2115,Marko Gujanicic\marko-gujanicic-1,2015-16,George Mason,F,28,22,724,94,222,.423,66,137,.482,28,85,.329,42,59,.712,56,125,181,41,5,2,37,69,258,6.5
2116,Patrik Auda\patrik-auda-1,2013-14,Seton Hall,F,27,21,659,89,166,.536,78,133,.586,11,33,.333,69,91,.758,29,93,122,40,17,12,38,66,258,7.6
2117,Arnaldo Toro\arnaldo-toro-1,2017-18,George Washington,F,33,27,842,91,217,.419,84,183,.459,7,34,.206,69,90,.767,88,141,229,39,20,27,39,63,258,7.3
2118,Vance Jackson\vance-jackson-1,2016-17,Connecticut,F,32,21,835,79,193,.409,29,67,.433,50,126,.397,50,74,.676,22,101,123,44,10,5,42,74,258,5.1
2119,Michael Kibiloski\michael-kibiloski-1,2013-14,Purdue-Fort Wayne,F,36,36,691,90,197,.457,25,38,.658,65,159,.409,13,17,.765,21,67,88,21,17,4,23,73,258,4.8
2120,Trent Steen\trent-steen-1,2017-18,Arkansas-Pine Bluff,F,34,31,697,107,231,.463,105,222,.473,2,9,.222,42,65,.646,26,88,114,17,29,45,60,112,258,4.2
2121,Anthony Lamb\anthony-lamb-2,2017-18,Vermont,F,18,13,422,88,188,.468,74,144,.514,14,44,.318,68,82,.829,26,64,90,16,10,14,30,42,258,9.9
2122,Luke Morrison\luke-morrison-1,2017-18,Army,F,30,30,588,91,219,.416,26,62,.419,65,157,.414,11,15,.733,23,89,112,29,9,0,23,58,258,5.5
2123,Sheldon Jeter\sheldon-jeter-1,2015-16,Pittsburgh,F,32,4,595,104,195,.533,99,172,.576,5,23,.217,45,54,.833,54,98,152,22,21,24,24,70,258,7.1
2124,Rokas Gustys\rokas-gustys-1,2016-17,Hofstra,F,28,28,779,115,210,.548,115,210,.548,0,0,,28,100,.280,110,228,338,21,25,20,48,97,258,8.6
2125,Jaylen Key\jaylen-key-1,2016-17,Northern Illinois,F,32,25,698,100,205,.488,87,177,.492,13,28,.464,44,66,.667,44,93,137,23,13,12,43,76,257,5.2
2126,Tyler Wideman\tyler-wideman-1,2015-16,Butler,F,33,33,806,98,162,.605,98,161,.609,0,1,.000,61,101,.604,72,115,187,27,34,49,35,114,257,7.8
2127,Karachi Edo\karachi-edo-1,2014-15,Fresno State,F,32,20,716,93,165,.564,93,165,.564,0,0,,71,105,.676,66,70,136,9,10,41,21,65,257,7.2
2128,Darren Payen\darren-payen-1,2015-16,Vermont,F,37,25,694,109,203,.537,109,203,.537,0,0,,39,65,.600,54,107,161,9,10,33,46,91,257,4.7
2129,Cecil Williams\cecil-williams-1,2016-17,Central Michigan,F,32,32,782,76,159,.478,62,127,.488,14,32,.438,91,115,.791,80,113,193,18,17,8,48,101,257,6.4
2130,Dwayne Morgan\dwayne-morgan-1,2017-18,Southern Utah,F,21,21,530,103,214,.481,96,186,.516,7,28,.250,44,70,.629,29,111,140,19,13,19,55,85,257,6.8
2131,Sebastian Saiz\sebastian-saiz-1,2014-15,Mississippi,F,34,32,790,104,180,.578,104,179,.581,0,1,.000,49,76,.645,66,120,186,10,22,33,28,99,257,6.7
2132,Juan Anderson\juan-anderson-1,2014-15,Marquette,F,31,27,883,97,198,.490,81,152,.533,16,46,.348,47,85,.553,68,110,178,54,35,12,64,77,257,6.7
2133,Brandon Mobley\brandon-mobley-1,2013-14,Seton Hall,F,34,16,815,87,208,.418,59,113,.522,28,95,.295,55,69,.797,28,116,144,27,13,31,34,95,257,5.2
2134,Marlin Mason\marlin-mason-1,2014-15,Cleveland State,F,31,29,808,97,198,.490,70,125,.560,27,73,.370,36,53,.679,51,98,149,26,21,32,51,85,257,6.2
2135,Jon Ekey\jon-ekey-1,2013-14,Illinois,F,35,23,915,91,224,.406,32,63,.508,59,161,.366,16,21,.762,59,110,169,9,31,12,16,74,257,6.0
2136,Lyonell Gaines\lyonell-gaines-1,2015-16,Morehead State,F,37,12,697,101,203,.498,96,177,.542,5,26,.192,50,73,.685,70,83,153,26,19,3,32,59,257,5.5
2137,Kennedy Meeks\kennedy-meeks-1,2013-14,North Carolina,F,34,17,554,103,188,.548,103,188,.548,0,0,,51,87,.586,80,127,207,26,11,27,35,58,257,6.9
2138,Jordan Butler\jordan-butler-1,2015-16,Norfolk State,F,34,32,904,94,170,.553,94,170,.553,0,0,,68,94,.723,80,144,224,29,13,73,40,106,256,7.8
2139,Paulius Zalys\paulius-zalys-1,2017-18,Lafayette,F,31,27,760,103,207,.498,96,170,.565,7,37,.189,43,62,.694,42,123,165,67,18,12,84,81,256,5.4
2140,T.J. Holyfield\tj-holyfield-1,2015-16,Stephen F. Austin,F,34,34,675,97,186,.522,81,143,.566,16,43,.372,46,63,.730,55,88,143,36,25,50,62,114,256,5.9
2141,Badou Diagne\badou-diagne-1,2013-14,Coastal Carolina,F,32,15,723,92,176,.523,68,113,.602,24,63,.381,48,69,.696,53,155,208,27,15,22,49,81,256,6.6
2142,Aubrey Williams\aubrey-williams-2,2015-16,Kennesaw State,F,31,1,689,86,160,.538,86,160,.538,0,0,,84,117,.718,77,119,196,26,25,16,30,83,256,7.9
2143,Drick Bernstine\drick-bernstine-1,2016-17,North Dakota,F,31,30,858,109,205,.532,108,200,.540,1,5,.200,37,67,.552,52,180,232,78,28,17,59,91,256,7.5
2144,Nikola Jovanovic\nikola-jovanovic-1,2013-14,Southern California,F,32,24,667,98,190,.516,89,157,.567,9,33,.273,51,67,.761,54,86,140,15,8,8,44,75,256,5.3
2145,Duran Porter\duran-porter-1,2015-16,Abilene Christian,F,31,30,615,103,176,.585,103,176,.585,0,0,,49,75,.653,38,78,116,18,10,27,44,87,255,5.7
2146,Brandon Johnson\brandon-johnson-56,2016-17,Western Michigan,F,32,32,737,105,204,.515,100,188,.532,5,16,.313,40,69,.580,70,107,177,23,12,19,34,81,255,6.2
2147,Sean Rhea\sean-rhea-1,2017-18,Texas A&M-Corpus Christi,F,27,26,713,94,188,.500,91,180,.506,3,8,.375,64,112,.571,49,101,150,14,21,22,59,91,255,5.8
2148,Christian Jones\christian-jones-1,2016-17,Nevada-Las Vegas,F,24,22,737,104,221,.471,104,221,.471,0,0,,47,79,.595,46,116,162,25,17,11,42,47,255,7.4
2149,Nino Johnson\nino-johnson-1,2013-14,Southeast Missouri State,F,30,21,766,84,148,.568,83,146,.568,1,2,.500,86,128,.672,63,118,181,31,31,28,47,86,255,8.0
2150,Nicholas Baer\nicholas-baer-1,2016-17,Iowa,F,34,10,808,91,203,.448,45,87,.517,46,116,.397,27,44,.614,69,127,196,59,48,43,27,78,255,8.5
2151,Nura Zanna\nura-zanna-1,2014-15,Long Island University,F,30,30,699,91,192,.474,91,190,.479,0,2,.000,73,135,.541,67,121,188,13,16,15,67,111,255,4.7
2152,Tyler Flack\tyler-flack-1,2013-14,South Dakota,F,30,27,638,102,186,.548,88,155,.568,14,31,.452,37,55,.673,26,115,141,16,12,44,33,89,255,6.6
2153,Chuma Okeke\chuma-okeke-1,2017-18,Auburn,F,34,0,734,92,201,.458,58,114,.509,34,87,.391,37,55,.673,69,128,197,38,23,25,27,66,255,7.2
2154,Josh Cuthbertson\josh-cuthbertson-1,2014-15,South Carolina Upstate,F,36,3,764,98,234,.419,61,117,.521,37,117,.316,22,37,.595,58,92,150,67,26,3,40,51,255,5.8
2155,Justin Carpenter\justin-carpenter-1,2017-18,Southeast Missouri State,F,30,23,641,99,189,.524,93,167,.557,6,22,.273,51,76,.671,58,83,141,21,13,13,35,80,255,6.3
2156,Nick Harney\nick-harney-1,2013-14,Akron,F,30,11,630,98,202,.485,92,174,.529,6,28,.214,52,85,.612,38,66,104,22,18,15,47,85,254,4.9
2157,Tommy Spagnolo\tommy-spagnolo-1,2013-14,Appalachian State,F,30,18,724,102,171,.596,102,171,.596,0,0,,50,91,.549,56,152,208,28,15,26,40,86,254,7.4
2158,Tony Parker\tony-parker-1,2013-14,UCLA,F,37,9,638,109,181,.602,109,181,.602,0,0,,36,77,.468,66,98,164,5,15,23,36,108,254,5.0
2159,Nathan Knight\nathan-knight-1,2016-17,William & Mary,F,31,6,534,96,166,.578,94,154,.610,2,12,.167,60,101,.594,42,93,135,33,12,41,32,87,254,6.9
2160,Justin Minaya\justin-minaya-1,2017-18,South Carolina,F,32,30,860,90,231,.390,51,124,.411,39,107,.364,35,51,.686,52,82,134,47,20,8,40,64,254,5.5
2161,Anthony Townes\anthony-townes-1,2017-18,Pacific,F,32,15,681,107,195,.549,107,195,.549,0,0,,40,55,.727,59,71,130,11,30,20,35,93,254,6.1
2162,Eric Thompson\eric-thompson-2,2014-15,Pacific,F,31,28,738,89,170,.524,89,170,.524,0,0,,76,125,.608,72,102,174,26,13,26,44,114,254,6.2
2163,Stefan Jankovic\stefan-jankovic-1,2014-15,Hawaii,F,24,14,491,85,173,.491,69,123,.561,16,50,.320,68,96,.708,47,70,117,17,14,33,42,80,254,7.7
2164,Mikal Bridges\mikal-bridges-1,2015-16,Villanova,F,40,0,813,86,165,.521,63,88,.716,23,77,.299,59,75,.787,36,92,128,35,42,26,24,89,254,6.1
2165,Jacquez Rozier\jacquez-rozier-1,2014-15,Middle Tennessee,F,36,32,903,90,179,.503,88,173,.509,2,6,.333,72,120,.600,89,90,179,26,26,23,55,89,254,5.7
2166,Kedar Edwards\kedar-edwards-1,2015-16,Tennessee-Martin,F,31,19,752,93,231,.403,67,138,.486,26,93,.280,42,70,.600,85,135,220,50,46,14,55,57,254,7.5
2167,Bryson Williams\bryson-williams-1,2016-17,Fresno State,F,33,26,566,105,174,.603,105,174,.603,0,0,,43,66,.652,49,95,144,5,13,18,39,102,253,5.3
2168,Eugene Omoruyi\eugene-omoruyi-1,2017-18,Rutgers,F,32,7,694,97,205,.473,97,200,.485,0,5,.000,59,109,.541,70,90,160,31,28,24,44,69,253,6.2
2169,Chris Knight\chris-knight-3,2017-18,Dartmouth,F,25,11,536,103,197,.523,103,196,.526,0,1,.000,47,77,.610,34,68,102,28,16,27,50,63,253,6.7
2170,Toby Hegner\toby-hegner-1,2017-18,Creighton,F,30,28,676,92,185,.497,56,90,.622,36,95,.379,33,39,.846,27,66,93,26,7,15,21,70,253,6.1
2171,Andre Kennedy\andre-kennedy-1,2017-18,Alabama A&M,F,29,22,762,106,213,.498,106,205,.517,0,8,.000,41,73,.562,58,113,171,19,15,17,57,57,253,5.8
2172,Roderick Perkins\roderick-perkins-1,2016-17,Winthrop,F,33,27,651,87,202,.431,35,67,.522,52,135,.385,27,45,.600,25,58,83,34,23,7,32,42,253,5.4
2173,M.J. Rhett\mj-rhett-1,2014-15,Mississippi,F,34,31,754,110,192,.573,110,191,.576,0,1,.000,33,44,.750,57,100,157,17,7,18,38,78,253,5.6
2174,Matija Milin\matija-milin-1,2015-16,Fairfield,F,31,3,618,93,187,.497,74,121,.612,19,66,.288,48,69,.696,35,79,114,32,8,11,33,76,253,5.6
2175,Tony Armstrong\tony-armstrong-1,2015-16,Alabama State,F,21,19,561,97,202,.480,97,202,.480,0,0,,59,93,.634,36,89,125,16,12,23,24,74,253,8.3
2176,Luke Meikle\luke-meikle-1,2016-17,Cal Poly,F,30,27,778,101,276,.366,71,169,.420,30,107,.280,21,34,.618,26,106,132,23,19,17,36,57,253,4.4
2177,Brandon Ashley\brandon-ashley-1,2013-14,Arizona,F,22,22,609,93,178,.522,82,149,.550,11,29,.379,56,74,.757,41,86,127,22,14,16,37,70,253,8.6
2178,Luuk van Bree\luke-vanbree-1,2015-16,Bradley,F,30,28,810,90,235,.383,46,110,.418,44,125,.352,29,44,.659,39,100,139,26,17,13,52,113,253,4.1
2179,D'Andre Wright\dandre-wright-1,2013-14,Tulsa,F,34,21,583,86,188,.457,80,172,.465,6,16,.375,75,108,.694,52,82,134,15,10,18,48,103,253,4.3
2180,Chris Wray\chris-wray-1,2016-17,Mount St. Mary's,F,36,33,1061,112,193,.580,112,191,.586,0,2,.000,29,93,.312,90,116,206,54,49,54,50,74,253,7.8
2181,Michael Hoffman\michael-hoffman-1,2016-17,Texas-Rio Grande Valley,F,32,14,619,98,211,.464,65,123,.528,33,88,.375,24,28,.857,42,87,129,23,26,25,28,96,253,6.0
2182,Chris Cunningham\chris-cunningham-2,2013-14,San Jose State,F,31,28,831,87,197,.442,81,177,.458,6,20,.300,73,98,.745,86,110,196,26,7,24,66,113,253,5.3
2183,Vitto Brown\vitto-brown-1,2016-17,Wisconsin,F,37,37,772,92,232,.397,48,94,.511,44,138,.319,25,33,.758,46,95,141,37,19,16,53,76,253,4.3
2184,Michale Kyser\michale-kyser-1,2013-14,Louisiana Tech,F,36,34,839,104,182,.571,104,182,.571,0,0,,45,90,.500,85,154,239,14,18,109,23,97,253,8.3
2185,Jonathan Gilling\jonathan-gilling-1,2013-14,Arizona State,F,33,18,939,80,191,.419,14,39,.359,66,152,.434,27,42,.643,11,115,126,88,18,5,44,94,253,5.7
2186,Kwan Cheatham\kwan-cheatham-1,2015-16,Akron,F,35,34,787,87,235,.370,49,121,.405,38,114,.333,41,62,.661,44,128,172,56,8,34,45,91,253,5.0
2187,Isaiah Hicks\isaiah-hicks-1,2014-15,North Carolina,F,38,3,563,99,182,.544,99,181,.547,0,1,.000,54,87,.621,56,57,113,11,9,15,34,95,252,4.3
2188,Karamo Jawara\karamo-jawara-1,2014-15,North Carolina Central,F,33,33,1109,89,201,.443,66,137,.482,23,64,.359,51,72,.708,33,179,212,76,35,24,55,91,252,6.9
2189,Markis McDuffie\markis-mcduffie-1,2015-16,Wichita State,F,34,1,630,87,204,.426,64,131,.489,23,73,.315,55,77,.714,36,75,111,25,27,7,33,55,252,5.2
2190,Joel Awich\joel-awich-1,2014-15,Cal Poly,F,29,28,850,93,255,.365,68,185,.368,25,70,.357,41,56,.732,46,131,177,35,22,38,44,86,252,5.9
2191,Darion Atkins\darion-atkins-1,2014-15,Virginia,F,33,27,789,113,221,.511,113,220,.514,0,1,.000,26,50,.520,73,124,197,23,27,36,37,67,252,6.8
2192,Tre Hale-Edmerson\tre-hale-edmerson-1,2015-16,Cal State Northridge,F,30,30,952,97,196,.495,76,137,.555,21,59,.356,37,51,.725,21,169,190,94,26,52,60,98,252,8.1
2193,Lew Evans\lew-evans-1,2015-16,Utah State,F,30,16,642,77,187,.412,51,114,.447,26,73,.356,72,101,.713,57,112,169,27,11,5,53,78,252,5.4
2194,Willie Cauley-Stein\willie-cauley-stein-1,2013-14,Kentucky,F,37,18,880,106,178,.596,106,178,.596,0,0,,40,83,.482,94,131,225,25,44,106,31,98,252,8.7
2195,Jonathan Baehre\jonathan-baehre-1,2017-18,North Carolina-Asheville,F,34,21,741,103,191,.539,78,124,.629,25,67,.373,21,26,.808,54,103,157,33,22,61,39,92,252,7.0
2196,Malcolm Regisford\malcolm-regisford-1,2016-17,Colgate,F,32,32,806,96,196,.490,95,193,.492,1,3,.333,59,109,.541,66,166,232,36,13,26,68,83,252,5.8
2197,Travis Charles\travis-charles-1,2016-17,Albany (NY),F,32,0,559,106,173,.613,106,173,.613,0,0,,40,63,.635,39,73,112,15,4,6,28,89,252,5.3
2198,Muusa Dama\muusa-dama-1,2016-17,Eastern Illinois,F,28,27,768,96,192,.500,96,192,.500,0,0,,60,84,.714,79,190,269,16,19,61,53,98,252,8.6
2199,Paul Thomas\paul-thomas-1,2017-18,Texas-El Paso,F,31,29,774,105,228,.461,97,199,.487,8,29,.276,34,67,.507,34,132,166,42,11,10,58,103,252,4.3
2200,Christian Cunningham\christian-cunningham-2,2017-18,Jacksonville State,F,33,29,777,109,165,.661,109,165,.661,0,0,,34,71,.479,84,150,234,15,24,57,48,92,252,7.8
2201,R.J. Kelly\rj-kelly-1,2016-17,Savannah State,F,26,16,621,92,150,.613,78,116,.672,14,34,.412,54,88,.614,64,92,156,31,17,29,35,72,252,9.1
2202,Leron Black\leron-black-1,2016-17,Illinois,F,31,27,627,101,223,.453,90,186,.484,11,37,.297,39,54,.722,55,141,196,13,14,3,37,89,252,5.3
2203,Jarrod Uthoff\jarrod-uthoff-1,2013-14,Iowa,F,33,0,601,84,168,.500,67,128,.523,17,40,.425,67,82,.817,40,112,152,26,11,35,31,38,252,7.0
2204,Marcus Byrd\marcus-byrd-1,2014-15,Denver,F,30,17,846,87,178,.489,38,67,.567,49,111,.441,28,35,.800,14,96,110,54,15,10,44,86,251,5.9
2205,Onochie Ochie\onochie-ochie-1,2013-14,Southeastern Louisiana,F,30,8,597,88,182,.484,80,149,.537,8,33,.242,67,96,.698,33,104,137,15,13,34,38,103,251,5.7
2206,Marquise Collins\marquise-collins-1,2017-18,Delaware State,F,28,11,542,84,203,.414,53,119,.445,31,84,.369,52,63,.825,18,60,78,16,7,6,42,53,251,4.6
2207,Maurice Strong\maurice-strong-2,2014-15,Alabama State,F,29,28,792,102,234,.436,102,233,.438,0,1,.000,47,91,.516,65,159,224,31,16,24,47,65,251,6.4
2208,Lorenzo Cugini\lorenzo-cugini-1,2013-14,High Point,F,31,22,859,100,212,.472,66,118,.559,34,94,.362,17,27,.630,30,94,124,38,15,5,31,61,251,5.7
2209,Fabijan Krslovic\fabijan-krslovic-1,2017-18,Montana,F,34,34,847,92,163,.564,92,157,.586,0,6,.000,67,94,.713,52,120,172,48,30,19,50,95,251,6.6
2210,Wenyen Gabriel\wenyen-gabriel-1,2017-18,Kentucky,F,37,7,854,87,197,.442,45,91,.495,42,106,.396,35,56,.625,65,133,198,21,30,40,41,113,251,5.7
2211,Malachi Alexander\malachi-alexander-1,2014-15,Holy Cross,F,30,17,760,79,182,.434,58,135,.430,21,47,.447,72,98,.735,48,103,151,30,24,16,45,91,251,6.1
2212,Akil Mitchell\akil-mitchell-1,2013-14,Virginia,F,37,36,952,105,187,.561,105,186,.565,0,1,.000,41,96,.427,72,187,259,44,29,21,49,70,251,6.6
2213,Tyler Hood\tyler-hood-1,2013-14,Samford,F,32,26,679,84,187,.449,57,109,.523,27,78,.346,56,72,.778,26,73,99,26,16,10,21,72,251,5.6
2214,Evan Fisher\evan-fisher-1,2017-18,Siena,F,32,28,896,89,205,.434,62,134,.463,27,71,.380,46,62,.742,31,126,157,26,12,23,52,88,251,4.9
2215,Luke Apfeld\luke-apfeld-1,2013-14,Vermont,F,32,19,584,96,201,.478,85,155,.548,11,46,.239,48,70,.686,31,49,80,12,14,9,26,84,251,4.5
2216,Calvin Crawford\calvin-crawford-1,2017-18,Manhattan,F,31,10,836,91,224,.406,56,133,.421,35,91,.385,34,43,.791,37,106,143,43,22,17,61,64,251,5.2
2217,Derail Green\derail-green-1,2016-17,North Texas,F,30,23,745,83,199,.417,27,55,.491,56,144,.389,29,37,.784,14,70,84,27,14,9,37,91,251,4.6
2218,D.J. Felder\dj-felder-1,2013-14,Jacksonville State,F,30,23,625,100,190,.526,100,189,.529,0,1,.000,50,68,.735,49,98,147,17,16,10,36,71,250,6.1
2219,Dimitrije Cabarkapa\dimitrije-cabarkapa-1,2015-16,James Madison,F,26,0,435,97,187,.519,62,96,.646,35,91,.385,21,25,.840,20,63,83,6,4,6,28,28,250,6.2
2220,Franz Rassman\will-rassman-1,2015-16,Loyola (MD),F,30,30,729,106,207,.512,103,180,.572,3,27,.111,35,57,.614,40,103,143,20,15,24,40,86,250,5.6
2221,Klint Carlson\klint-carlson-1,2016-17,Northern Iowa,F,30,28,994,96,247,.389,72,152,.474,24,95,.253,34,47,.723,24,122,146,64,22,4,44,55,250,5.6
2222,K.J. Santos\kj-santos-1,2016-17,Illinois-Chicago,F,35,30,858,87,224,.388,50,123,.407,37,101,.366,39,60,.650,42,104,146,41,13,9,64,98,250,3.6
2223,Lis Shoshi\lis-shoshi-1,2015-16,Little Rock,F,35,34,794,103,211,.488,91,178,.511,12,33,.364,32,50,.640,62,125,187,29,8,39,28,96,250,5.9
2224,Anton Gill\anton-gill-1,2017-18,Nebraska,F,31,14,761,81,203,.399,27,60,.450,54,143,.378,34,41,.829,6,53,59,34,14,2,23,44,250,5.0
2225,Hector Harold\hector-harold-1,2014-15,Vermont,F,31,31,694,91,221,.412,59,124,.476,32,97,.330,36,55,.655,15,105,120,34,19,21,52,80,250,4.5
2226,Greig Stire\greig-stire-1,2016-17,Albany (NY),F,35,35,820,94,167,.563,94,167,.563,0,0,,62,103,.602,98,112,210,37,13,9,40,109,250,6.2
2227,Shawn Smith\shawn-smith-3,2013-14,Marshall,F,33,15,715,87,203,.429,67,132,.508,20,71,.282,56,87,.644,47,89,136,21,18,12,36,77,250,5.0
2228,Justin Harris\justin-harris-1,2014-15,Quinnipiac,F,30,28,808,88,205,.429,87,191,.455,1,14,.071,73,92,.793,90,103,193,23,8,32,42,53,250,7.0
2229,Darryl Palmer\darryl-palmer-1,2015-16,South Carolina State,F,34,13,841,99,202,.490,98,189,.519,1,13,.077,51,85,.600,48,149,197,32,17,49,22,91,250,6.7
2230,JT Yoho\jt-yoho-1,2014-15,Wright State,F,16,14,531,89,209,.426,65,136,.478,24,73,.329,48,60,.800,19,84,103,33,12,4,37,32,250,10.1
2231,Moses Greenwood\moses-greenwood-1,2015-16,Southeastern Louisiana,F,33,11,591,98,172,.570,98,171,.573,0,1,.000,54,85,.635,43,99,142,9,13,19,33,102,250,5.3
2232,Joe Mvuezolo Jr.\joe-mvuezolojr-1,2017-18,Montana State,F,32,2,668,89,220,.405,60,134,.448,29,86,.337,43,62,.694,21,88,109,25,18,19,38,53,250,4.8
2233,Jerry Brown\jerry-brown-1,2013-14,Santa Clara,F,33,17,692,91,157,.580,91,157,.580,0,0,,68,127,.535,69,113,182,14,24,28,35,65,250,6.9
2234,Maurice Walker\maurice-walker-1,2013-14,Minnesota,F,32,3,592,91,161,.565,91,161,.565,0,0,,68,102,.667,54,89,143,27,24,30,47,95,250,6.4
2235,D'Angelo Scott\deangelo-scott-1,2013-14,Texas Southern,F,34,31,905,83,139,.597,82,132,.621,1,7,.143,82,103,.796,90,120,210,41,36,13,52,74,249,7.9
2236,Phillip Anglade\phillip-anglade-1,2015-16,Virginia Military Institute,F,30,30,768,113,212,.533,113,211,.536,0,1,.000,23,71,.324,77,84,161,16,23,48,31,99,249,6.8
2237,Leland King\leland-king-1,2014-15,Brown,F,17,14,433,97,206,.471,79,146,.541,18,60,.300,37,49,.755,25,107,132,27,11,12,46,23,249,10.1
2238,Curtis Washington\curtis-washington-1,2013-14,Georgia State,F,33,31,750,105,160,.656,105,160,.656,0,0,,39,62,.629,60,135,195,5,9,78,19,78,249,8.2
2239,Devonte Upson\devonte-upson-1,2013-14,Southeastern Louisiana,F,30,27,815,96,163,.589,96,162,.593,0,1,.000,57,106,.538,70,112,182,27,19,50,36,84,249,8.0
2240,Titus Rubles\titus-rubles-1,2013-14,Cincinnati,F,34,33,985,83,205,.405,83,202,.411,0,3,.000,83,108,.769,86,145,231,67,44,28,50,103,249,7.4
2241,Noah Dickerson\noah-dickerson-1,2015-16,Washington,F,33,25,736,93,199,.467,93,198,.470,0,1,.000,63,101,.624,59,113,172,10,26,21,46,114,249,4.9
2242,Zachary Hamilton\zachary-hamilton-1,2015-16,Prairie View,F,31,23,799,87,255,.341,66,177,.373,21,78,.269,54,73,.740,48,74,122,26,23,11,39,65,249,4.4
2243,Max Rothschild\max-rothschild-1,2017-18,Pennsylvania,F,33,32,739,98,193,.508,98,193,.508,0,0,,53,83,.639,57,131,188,78,25,13,71,90,249,6.1
2244,Elijah Olaniyi\elijah-olaniyi-1,2017-18,Stony Brook,F,32,8,713,96,211,.455,70,128,.547,26,83,.313,31,58,.534,39,84,123,21,32,4,48,62,249,4.9
2245,Jalen Johnson\jalen-johnson-2,2016-17,Saint Louis,F,33,20,791,85,213,.399,50,117,.427,35,96,.365,44,60,.733,47,102,149,25,23,17,44,88,249,5.0
2246,Jarmal Reid\jarmal-reid-1,2014-15,Oregon State,F,30,2,668,84,191,.440,83,186,.446,1,5,.200,79,107,.738,27,55,82,35,26,12,41,99,248,5.0
2247,Alan Herndon\alan-herndon-1,2015-16,Wyoming,F,32,31,898,91,175,.520,74,119,.622,17,56,.304,49,80,.613,27,123,150,37,18,27,35,81,248,6.3
2248,Chris Olivier\chris-olivier-1,2015-16,Oklahoma State,F,32,2,518,94,182,.516,94,182,.516,0,0,,60,94,.638,36,58,94,10,4,32,32,57,248,5.2
2249,Sebastian Townes\sebastian-townes-1,2017-18,Bryant,F,22,16,493,93,211,.441,93,202,.460,0,9,.000,62,90,.689,42,45,87,39,8,5,35,49,248,7.0
2250,RJ Slawson\rj-slawson-1,2013-14,Jacksonville,F,30,30,703,86,185,.465,77,155,.497,9,30,.300,67,96,.698,85,99,184,13,30,43,49,103,248,7.0
2251,Matej Buovac\matej-buovac-1,2016-17,Sacred Heart,F,28,0,618,73,202,.361,15,39,.385,58,163,.356,44,57,.772,17,67,84,15,14,3,27,41,248,5.2
2252,Eric McAlister\eric-mcalister-1,2013-14,Stony Brook,F,33,33,837,99,171,.579,97,165,.588,2,6,.333,48,64,.750,64,117,181,26,20,38,29,98,248,7.2
2253,Matt Van Scyoc\matt-vanscyoc-1,2015-16,Indiana State,F,32,28,706,83,216,.384,33,65,.508,50,151,.331,32,55,.582,19,84,103,12,7,12,40,92,248,3.3
2254,Justin Alston\justin-alston-1,2014-15,Boston University,F,30,30,751,105,184,.571,105,183,.574,0,1,.000,38,55,.691,50,112,162,27,17,20,47,79,248,6.5
2255,Chris Ortiz\chris-ortiz-1,2015-16,Kent State,F,32,9,807,81,188,.431,65,136,.478,16,52,.308,70,104,.673,49,127,176,24,15,14,44,77,248,5.5
2256,Michael Finke\michael-finke-1,2015-16,Illinois,F,33,17,671,90,207,.435,50,98,.510,40,109,.367,28,43,.651,45,76,121,32,4,5,31,60,248,4.9
2257,Moses Morgan\moses-morgan-1,2014-15,Cal State Fullerton,F,31,27,794,89,270,.330,45,128,.352,44,142,.310,25,45,.556,16,54,70,18,14,8,42,54,247,2.6
2258,Ahman Fells\ahman-fells-1,2014-15,Illinois-Chicago,F,33,22,751,98,187,.524,69,113,.611,29,74,.392,22,32,.688,43,82,125,16,30,9,21,70,247,6.2
2259,Brandon Parrish\brandon-parrish-1,2013-14,Texas Christian,F,31,30,916,88,241,.365,54,136,.397,34,105,.324,37,59,.627,31,64,95,26,16,7,35,63,247,4.0
2260,Xavier Sneed\xavier-sneed-1,2016-17,Kansas State,F,35,2,639,78,182,.429,40,70,.571,38,112,.339,53,73,.726,29,61,90,22,33,7,35,79,247,4.8
2261,Derek Willis\derek-willis-1,2015-16,Kentucky,F,32,11,596,81,168,.482,28,48,.583,53,120,.442,32,36,.889,30,97,127,12,21,24,22,55,247,6.6
2262,DavRon Williams\davron-williams-1,2014-15,IUPUI,F,31,7,721,101,175,.577,101,174,.580,0,1,.000,45,77,.584,64,132,196,22,22,22,44,96,247,6.7
2263,Donte Thomas\donte-thomas-1,2016-17,Bradley,F,32,25,694,93,180,.517,91,168,.542,2,12,.167,59,87,.678,61,148,209,26,25,17,38,79,247,6.9
2264,Jalen Jenkins\jalen-jenkins-1,2014-15,George Mason,F,31,22,692,92,198,.465,91,195,.467,1,3,.333,62,108,.574,54,83,137,38,18,26,61,104,247,4.8
2265,Chris Davenport\chris-davenport-2,2013-14,North Florida,F,32,31,687,85,160,.531,72,118,.610,13,42,.310,64,90,.711,45,130,175,53,16,15,89,87,247,5.3
2266,Juwan Morgan\juwan-morgan-1,2016-17,Indiana,F,32,20,722,86,157,.548,76,117,.650,10,40,.250,65,88,.739,65,113,178,34,19,29,36,84,247,7.4
2267,Kenneth Lowe\kenneth-lowe-1,2015-16,Green Bay,F,36,36,766,104,195,.533,104,195,.533,0,0,,38,79,.481,63,77,140,41,35,42,50,105,246,5.6
2268,Oscar Frayer\oscar-frayer-1,2016-17,Grand Canyon,F,31,25,763,92,232,.397,64,123,.520,28,109,.257,34,50,.680,42,97,139,24,33,24,42,75,246,5.4
2269,Cameron Naylor\cameron-naylor-2,2014-15,Texas State,F,30,16,722,98,230,.426,98,224,.438,0,6,.000,50,67,.746,45,103,148,14,10,9,46,51,246,4.7
2270,Alex Long\alex-long-1,2016-17,Norfolk State,F,33,25,782,93,190,.489,93,190,.489,0,0,,60,104,.577,50,127,177,22,25,41,73,105,246,4.8
2271,Iba Camara\iba-camara-1,2015-16,New Hampshire,F,33,30,732,93,178,.522,93,177,.525,0,1,.000,60,100,.600,87,198,285,25,13,15,63,81,246,6.3
2272,Wesley Gordon\wesley-gordon-1,2015-16,Colorado,F,34,33,947,80,192,.417,74,177,.418,6,15,.400,80,116,.690,100,160,260,45,13,68,38,79,246,7.9
2273,Javon Dawson\javon-dawson-1,2013-14,Jacksonville,F,27,26,792,98,222,.441,90,197,.457,8,25,.320,42,65,.646,54,132,186,24,20,3,48,56,246,6.2
2274,Mike Kirkland\mike-kirkland-1,2014-15,Fairfield,F,31,31,784,87,215,.405,78,180,.433,9,35,.257,63,84,.750,36,87,123,32,17,4,50,80,246,4.3
2275,Travis Munnings\travis-munnings-1,2015-16,Louisiana-Monroe,F,34,16,879,96,190,.505,81,146,.555,15,44,.341,39,65,.600,73,110,183,46,32,10,62,79,246,6.0
2276,Kammeon Holsey\kammeon-holsey-1,2013-14,Georgia Tech,F,33,16,690,97,183,.530,97,183,.530,0,0,,52,77,.675,68,96,164,28,10,9,45,82,246,5.5
2277,Tony Washington\tony-washington-1,2017-18,La Salle,F,32,29,729,104,165,.630,104,165,.630,0,0,,38,62,.613,72,130,202,20,10,21,48,101,246,6.3
2278,Kavin Gilder-Tilbury\kavin-gilder-tilbury-1,2014-15,Texas State,F,31,22,714,76,206,.369,50,134,.373,26,72,.361,68,90,.756,37,72,109,38,34,6,53,75,246,4.9
2279,David Taylor\david-taylor-2,2014-15,Pacific,F,31,26,769,85,224,.379,38,93,.409,47,131,.359,29,36,.806,13,40,53,47,13,1,43,62,246,3.9
2280,Travis Wear\travis-wear-1,2013-14,UCLA,F,34,28,812,105,198,.530,94,173,.543,11,25,.440,25,30,.833,33,75,108,49,25,23,13,104,246,6.3
2281,Anas Mahmoud\anas-mahmoud-1,2017-18,Louisville,F,36,22,841,109,198,.551,109,198,.551,0,0,,27,58,.466,62,119,181,36,29,104,46,67,245,7.5
2282,Reggie McAdams\reggie-mcadams-1,2014-15,Akron,F,35,10,648,81,189,.429,16,31,.516,65,158,.411,18,23,.783,22,49,71,22,20,14,8,39,245,5.6
2283,Rico Gathers\rico-gathers-1,2013-14,Baylor,F,38,1,678,80,169,.473,80,169,.473,0,0,,85,146,.582,102,140,242,6,28,18,30,96,245,5.9
2284,Cedrick Bowen\cedrick-bowen-1,2014-15,Charleston Southern,F,31,31,735,103,166,.620,103,166,.620,0,0,,39,60,.650,76,56,132,19,19,14,24,53,245,7.4
2285,Anthony Vanhook\anthony-vanhook-1,2016-17,Charlotte,F,27,19,653,90,188,.479,90,187,.481,0,1,.000,65,90,.722,46,118,164,75,29,14,43,87,245,8.2
2286,D.J. Foreman\dj-foreman-1,2015-16,Rutgers,F,31,23,820,91,190,.479,88,184,.478,3,6,.500,60,109,.550,49,141,190,21,21,19,60,93,245,5.1
2287,Eric Jacobsen\eric-jacobsen-1,2015-16,Arizona State,F,32,32,722,91,158,.576,90,156,.577,1,2,.500,62,97,.639,72,91,163,16,6,31,29,101,245,6.4
2288,Tyler Wideman\tyler-wideman-1,2016-17,Butler,F,34,34,781,96,156,.615,96,154,.623,0,2,.000,53,81,.654,70,100,170,15,20,26,38,102,245,6.2
2289,Kaiser Gates\kaiser-gates-1,2017-18,Xavier,F,34,18,810,74,179,.413,20,36,.556,54,143,.378,43,52,.827,32,123,155,31,16,9,22,84,245,5.7
2290,Jailyn Ingram\jailyn-ingram-1,2016-17,Florida Atlantic,F,30,28,722,102,236,.432,96,207,.464,6,29,.207,35,56,.625,27,98,125,39,17,9,41,60,245,4.9
2291,Mfiondu Kabengele\mfiondu-kabengele-1,2017-18,Florida State,F,34,0,503,85,173,.491,75,147,.510,10,26,.385,65,99,.657,63,95,158,10,15,29,35,73,245,5.7
2292,Joe Reed\joe-reed-1,2014-15,Purdue-Fort Wayne,F,30,17,771,89,164,.543,79,136,.581,10,28,.357,57,85,.671,43,92,135,43,20,11,37,60,245,7.0
2293,Tamas Bruce\tamas-bruce-1,2016-17,Arkansas State,F,32,12,498,107,178,.601,107,178,.601,0,0,,30,78,.385,70,114,184,8,24,23,35,102,244,6.1
2294,Marquis Horne\marquis-horne-1,2013-14,Cal State Fullerton,F,30,25,671,92,224,.411,67,152,.441,25,72,.347,35,50,.700,38,92,130,29,17,10,40,73,244,4.9
2295,Austin Cooke\austin-cooke-1,2013-14,Abilene Christian,F,31,31,914,80,183,.437,33,67,.493,47,116,.405,37,51,.725,54,123,177,61,29,5,30,76,244,7.5
2296,Fabijan Krslovic\fabijan-krslovic-1,2016-17,Montana,F,32,32,882,97,175,.554,97,175,.554,0,0,,50,79,.633,72,134,206,46,38,20,49,99,244,7.3
2297,David Andoh\david-andoh-1,2016-17,St. Bonaventure,F,32,7,609,97,220,.441,84,176,.477,13,44,.295,37,55,.673,36,71,107,13,9,11,36,61,244,4.2
2298,Tyrell Johnson\tyrell-johnson-1,2017-18,Appalachian State,F,33,30,731,88,212,.415,57,113,.504,31,99,.313,37,54,.685,37,99,136,19,8,38,39,79,244,4.8
2299,Donte Grantham\donte-grantham-1,2016-17,Clemson,F,33,32,915,91,236,.386,53,119,.445,38,117,.325,24,32,.750,42,101,143,51,25,21,40,44,244,5.7
2300,Will Magarity\will-magarity-1,2016-17,Davidson,F,29,27,707,92,194,.474,69,104,.663,23,90,.256,37,46,.804,35,112,147,28,10,40,43,86,244,6.2
2301,Michael Weisner\michael-weisner-1,2013-14,Montana,F,30,15,741,80,158,.506,32,55,.582,48,103,.466,36,38,.947,19,60,79,19,13,10,34,78,244,5.5
2302,Issac Vann\issac-vann-1,2017-18,Virginia Commonwealth,F,25,18,648,94,221,.425,72,135,.533,22,86,.256,34,48,.708,22,74,96,33,24,9,38,54,244,6.1
2303,Jordan Blount\jordan-blount-1,2017-18,Illinois-Chicago,F,36,36,898,98,211,.464,82,144,.569,16,67,.239,32,49,.653,57,189,246,84,39,17,102,126,244,5.1
2304,John Golden\john-golden-1,2013-14,Dartmouth,F,28,28,821,83,190,.437,68,132,.515,15,58,.259,63,92,.685,31,85,116,51,22,8,34,62,244,6.6
2305,Nick Osborne\nick-osborne-1,2015-16,IUPUI,F,30,14,612,101,223,.453,85,187,.455,16,36,.444,26,35,.743,60,121,181,11,13,13,34,103,244,5.3
2306,Teddy Allen\teddy-allen-1,2017-18,West Virginia,F,35,0,423,91,195,.467,88,170,.518,3,25,.120,59,80,.738,44,52,96,19,13,0,33,64,244,4.3
2307,Axel Mpoyo\axel-mpoyo-1,2017-18,Grambling,F,31,17,798,90,215,.419,87,192,.453,3,23,.130,61,91,.670,55,118,173,7,24,21,58,87,244,4.6
2308,Dorian Chatman\dorian-chatman-1,2015-16,Lamar,F,29,18,576,90,193,.466,89,192,.464,1,1,1.000,63,98,.643,47,67,114,27,15,34,64,89,244,4.9
2309,ShunQuez Stephens\shunquez-stephens-1,2014-15,South Carolina Upstate,F,35,32,772,90,213,.423,68,133,.511,22,80,.275,42,57,.737,62,153,215,45,27,8,43,88,244,5.7
2310,Admiral Schofield\admiral-schofield-1,2015-16,Tennessee,F,32,22,598,92,207,.444,67,124,.540,25,83,.301,35,39,.897,43,86,129,29,12,10,23,88,244,5.4
2311,Drew Eubanks\drew-eubanks-1,2015-16,Oregon State,F,32,30,685,102,175,.583,102,175,.583,0,0,,40,63,.635,45,101,146,13,14,39,42,91,244,5.8
2312,Kelan Martin\kelan-martin-1,2014-15,Butler,F,34,0,495,91,221,.412,72,144,.500,19,77,.247,42,60,.700,21,49,70,15,5,8,33,54,243,3.3
2313,John Walton\josh-walton-1,2014-15,Troy,F,29,29,810,87,204,.426,87,203,.429,0,1,.000,69,115,.600,60,105,165,21,16,5,59,89,243,4.5
2314,Rasheed Worrell\rasheed-worrell-1,2015-16,Bowling Green State,F,34,28,681,96,193,.497,92,184,.500,4,9,.444,47,80,.588,54,102,156,16,8,29,27,92,243,5.2
2315,Tom Lacey\tom-lacey-1,2016-17,Navy,F,32,31,874,87,175,.497,87,175,.497,0,0,,69,107,.645,100,146,246,49,16,11,49,91,243,7.1
2316,Aaron Ross\aaron-ross-1,2016-17,Texas Tech,F,27,9,603,74,167,.443,44,86,.512,30,81,.370,65,76,.855,16,61,77,32,9,2,25,72,243,5.9
2317,Tervell Beck\tervell-beck-1,2017-18,Nevada-Las Vegas,F,33,13,533,88,148,.595,79,123,.642,9,25,.360,57,92,.620,35,43,78,16,6,4,32,49,242,5.0
2318,Greig Stire\greig-stire-1,2015-16,Albany (NY),F,32,32,742,90,165,.545,90,165,.545,0,0,,62,97,.639,90,102,192,25,14,4,33,102,242,6.3
2319,DaQuan Jeffries\daquan-jeffries-1,2017-18,Tulsa,F,25,9,549,90,166,.542,66,105,.629,24,61,.393,38,48,.792,45,78,123,20,15,36,35,79,242,8.0
2320,DeVon Barnett\devon-barnett-1,2013-14,Sacred Heart,F,22,15,606,105,199,.528,105,199,.528,0,0,,32,60,.533,54,48,102,11,22,14,33,64,242,7.6
2321,Liam Thomas\liam-thomas-1,2016-17,Nicholls State,F,31,31,863,92,152,.605,90,142,.634,2,10,.200,56,81,.691,75,124,199,65,20,130,65,99,242,9.8
2322,Olaf Schaftenaar\olaf-schaftenaar-1,2014-15,Oregon State,F,31,28,929,81,204,.397,34,79,.430,47,125,.376,33,41,.805,24,77,101,49,15,10,42,59,242,5.1
2323,Tonnie Collier\tonnie-collier-1,2014-15,Texas Southern,F,33,3,521,73,175,.417,36,66,.545,37,109,.339,59,76,.776,28,64,92,9,8,2,33,45,242,4.4
2324,David Wear\david-wear-1,2013-14,UCLA,F,37,37,848,93,185,.503,70,133,.526,23,52,.442,33,41,.805,52,90,142,28,23,7,33,74,242,5.3
2325,Nnanna Egwu\nnanna-egwu-1,2013-14,Illinois,F,35,35,1038,101,244,.414,96,221,.434,5,23,.217,35,45,.778,89,122,211,15,12,73,39,109,242,5.6
2326,Luke Meikle\luke-meikle-1,2015-16,Cal Poly,F,30,9,586,80,207,.386,49,121,.405,31,86,.360,51,66,.773,18,74,92,17,8,10,18,66,242,4.7
2327,Ray Crossland\ray-crossland-1,2017-18,Eastern Illinois,F,30,23,916,84,223,.377,56,141,.397,28,82,.341,46,73,.630,58,86,144,39,31,11,59,79,242,5.0
2328,Matija Milin\matija-milin-1,2016-17,Fairfield,F,29,17,700,99,205,.483,70,115,.609,29,90,.322,15,26,.577,32,86,118,25,14,9,37,73,242,5.3
2329,Desmond Ringer\desmond-ringer-1,2016-17,Mercer,F,32,31,785,92,160,.575,92,160,.575,0,0,,58,75,.773,69,118,187,13,8,10,47,78,242,5.9
2330,Cedrick Williams\cedrick-williams-1,2014-15,North Carolina-Wilmington,F,32,26,865,96,199,.482,93,184,.505,3,15,.200,46,80,.575,87,113,200,22,31,41,36,104,241,6.8
2331,Duke Ethridge\duke-ethridge-1,2015-16,Chattanooga,F,32,2,515,84,171,.491,69,124,.556,15,47,.319,58,75,.773,41,81,122,11,13,15,26,46,241,5.9
2332,Damarion Geter\damarion-geter-1,2017-18,Longwood,F,29,28,939,92,161,.571,90,156,.577,2,5,.400,55,83,.663,61,150,211,58,25,34,44,69,241,8.9
2333,Anton Grady\anton-gandy-1,2015-16,Wichita State,F,31,5,537,91,178,.511,90,169,.533,1,9,.111,58,96,.604,40,102,142,11,13,20,44,86,241,4.9
2334,Jordy Kuiper\jordy-kuiper-1,2017-18,North Carolina-Greensboro,F,34,34,930,87,220,.395,48,106,.453,39,114,.342,28,43,.651,58,106,164,38,21,12,40,84,241,5.0
2335,Ben Moore\ben-moore-1,2014-15,Southern Methodist,F,34,30,762,82,187,.439,82,187,.439,0,0,,77,113,.681,66,95,161,64,31,30,55,84,241,6.2
2336,Treshaad Williams\treshaad-williams-1,2016-17,Morehead State,F,30,30,624,96,133,.722,96,133,.722,0,0,,49,71,.690,75,61,136,15,18,6,23,89,241,7.4
2337,Isaac Johnson\isaac-johnson-1,2017-18,Appalachian State,F,33,33,908,77,158,.487,71,132,.538,6,26,.231,81,129,.628,84,193,277,49,30,16,52,76,241,7.6
2338,Javis Howard\javis-howard-1,2016-17,Charleston Southern,F,31,31,900,103,184,.560,103,182,.566,0,2,.000,35,54,.648,92,88,180,14,17,14,36,67,241,6.8
2339,Franz Rassman\will-rassman-1,2014-15,Loyola (MD),F,30,30,736,90,198,.455,80,181,.442,10,17,.588,51,72,.708,39,96,135,29,14,24,40,102,241,5.2
2340,Tahjai Teague\tahjai-teague-1,2016-17,Ball State,F,33,3,628,92,182,.505,76,143,.531,16,39,.410,41,68,.603,48,142,190,28,39,29,50,84,241,6.4
2341,Mike Thomas\mike-thomas-2,2014-15,Hawaii,F,34,23,608,91,185,.492,88,174,.506,3,11,.273,55,76,.724,56,62,118,15,23,34,30,104,240,5.4
2342,Darnell Harris\darnell-harris-2,2014-15,Middle Tennessee,F,36,13,641,86,196,.439,54,110,.491,32,86,.372,36,47,.766,39,80,119,22,10,10,30,66,240,4.4
2343,Lis Shoshi\lis-shoshi-1,2016-17,Little Rock,F,27,22,666,89,184,.484,83,157,.529,6,27,.222,56,75,.747,60,113,173,39,16,41,41,82,240,7.9
2344,Trevond Barnes\trevond-barnes-1,2017-18,Hampton,F,34,33,671,87,155,.561,81,131,.618,6,24,.250,60,86,.698,50,94,144,20,10,44,31,93,240,6.1
2345,Jorge Bilbao\jorge-bilbao-1,2015-16,Texas-Arlington,F,35,34,854,91,197,.462,89,189,.471,2,8,.250,56,92,.609,90,157,247,55,24,19,61,111,240,5.8
2346,Jalen Jackson\jalen-jackson-1,2013-14,Central Arkansas,F,25,12,520,90,184,.489,59,119,.496,31,65,.477,29,50,.580,22,83,105,52,34,12,48,56,240,7.5
2347,Rosco Allen\rosco-allen-1,2014-15,Stanford,F,33,23,872,82,215,.381,44,110,.400,38,105,.362,38,55,.691,34,110,144,39,18,12,37,77,240,4.8
2348,Khaliq Spicer\khaliq-spicer-1,2015-16,Kent State,F,32,29,718,92,150,.613,92,150,.613,0,0,,56,90,.622,74,124,198,17,10,51,24,70,240,7.9
2349,Derek Ogbeide\derek-ogbeide-1,2016-17,Georgia,F,34,33,788,101,178,.567,101,178,.567,0,0,,38,66,.576,78,181,259,20,12,39,43,93,240,6.7
2350,Cody Helgeland\cody-helgeland-1,2016-17,Jacksonville,F,30,22,736,75,184,.408,25,59,.424,50,125,.400,40,44,.909,21,72,93,38,20,5,35,67,240,5.5
2351,Mason Peatling\mason-peatling-1,2017-18,Eastern Washington,F,31,26,643,95,181,.525,90,160,.563,5,21,.238,44,71,.620,64,111,175,20,28,35,27,104,239,7.0
2352,Amile Jefferson\amile-jefferson-1,2014-15,Duke,F,39,26,831,94,149,.631,94,149,.631,0,0,,51,92,.554,91,135,226,33,22,26,41,76,239,6.5
2353,Ken'Darrius Hamilton\kendarrius-hamilton-1,2017-18,Tennessee State,F,28,26,655,89,195,.456,60,99,.606,29,96,.302,32,36,.889,26,91,117,22,18,15,57,99,239,4.6
2354,Jon Smith\jon-smith-2,2013-14,Ohio,F,34,33,953,102,158,.646,102,158,.646,0,0,,35,53,.660,76,129,205,37,38,54,35,102,239,8.2
2355,Lester Wilson\lester-wilson-1,2015-16,East Tennessee State,F,35,9,603,75,193,.389,13,39,.333,62,154,.403,27,37,.730,24,74,98,18,13,4,20,65,239,4.3
2356,Shane Whitfield\shane-whitfield-1,2017-18,Campbell,F,34,34,993,81,163,.497,81,161,.503,0,2,.000,77,117,.658,18,119,137,85,18,4,61,79,239,5.2
2357,Zachary Simmons\zachary-simmons-1,2017-18,North Texas,F,37,29,762,102,155,.658,102,154,.662,0,1,.000,35,62,.565,79,112,191,15,16,24,35,129,239,5.6
2358,DeVon Barnett\devon-barnett-1,2016-17,Sacred Heart,F,31,28,707,108,207,.522,108,202,.535,0,5,.000,22,46,.478,41,110,151,36,18,14,45,72,238,5.4
2359,Adjehi Baru\adjehi-baru-1,2014-15,College of Charleston,F,32,31,834,91,191,.476,91,191,.476,0,0,,56,104,.538,71,130,201,25,18,18,48,101,238,5.3
2360,D'Andre Wright\dandre-wright-1,2014-15,Tulsa,F,34,24,730,81,208,.389,68,162,.420,13,46,.283,63,89,.708,68,82,150,30,7,12,51,115,238,3.7
2361,Lewis Sullivan\lewis-sullivan-1,2017-18,Alabama-Birmingham,F,33,5,627,95,166,.572,91,150,.607,4,16,.250,44,64,.688,50,95,145,29,16,19,53,77,238,5.5
2362,Cameron Black\cameron-black-1,2013-14,Bowling Green State,F,32,32,952,110,219,.502,110,219,.502,0,0,,18,42,.429,52,193,245,47,22,53,51,80,238,7.0
2363,Marcus Byrd\marcus-byrd-1,2013-14,Denver,F,30,2,720,81,176,.460,28,49,.571,53,127,.417,23,30,.767,17,60,77,31,20,10,25,70,238,5.7
2364,Zach Hanson\zach-hanson-1,2015-16,Creighton,F,35,1,520,97,148,.655,97,148,.655,0,0,,44,64,.688,55,55,110,5,7,27,32,99,238,5.1
2365,Pablo Rivas\pablo-rivas-1,2016-17,North Carolina Central,F,34,1,626,99,153,.647,88,126,.698,11,27,.407,29,41,.707,48,102,150,12,15,23,23,84,238,6.3
2366,Orlando Sanchez\orlando-sanchez-1,2013-14,St. John's (NY),F,32,18,714,92,180,.511,81,136,.596,11,44,.250,43,56,.768,48,130,178,44,25,36,43,82,238,6.9
2367,Marquis Vance\marquis-vance-1,2015-16,Alcorn State,F,30,27,892,75,222,.338,46,132,.348,29,90,.322,59,98,.602,44,118,162,56,13,17,60,58,238,4.8
2368,Kevin Mickle\kevin-mickle-1,2017-18,Ohio,F,28,2,584,98,203,.483,93,185,.503,5,18,.278,37,56,.661,32,71,103,25,23,12,36,49,238,5.9
2369,Brett Prahl\brett-prahl-1,2016-17,Milwaukee,F,33,32,653,99,149,.664,99,147,.673,0,2,.000,39,63,.619,48,72,120,15,15,27,29,71,237,6.2
2370,Dante Williams\dante-williams-2,2013-14,Oakland,F,31,1,772,84,185,.454,52,96,.542,32,89,.360,37,56,.661,39,74,113,43,25,9,22,87,237,6.1
2371,Zane Knowles\zane-knowles-2,2013-14,Texas A&M-Corpus Christi,F,34,34,823,102,174,.586,102,174,.586,0,0,,33,78,.423,81,176,257,17,9,34,53,102,237,5.8
2372,Mark Tollefsen\mark-tollefsen-1,2015-16,Arizona,F,34,13,744,90,175,.514,64,102,.627,26,73,.356,31,39,.795,42,60,102,44,13,20,19,64,237,6.1
2373,Klint Carlson\klint-carlson-1,2015-16,Northern Iowa,F,32,0,703,90,187,.481,75,136,.551,15,51,.294,42,54,.778,26,92,118,21,23,7,28,60,237,5.4
2374,Calvin Crawford\calvin-crawford-1,2015-16,Manhattan,F,22,0,541,89,181,.492,80,148,.541,9,33,.273,50,65,.769,27,74,101,16,14,33,41,58,237,7.5
2375,Anthony Morse\anthony-morse-1,2015-16,Tennessee Tech,F,31,31,713,91,152,.599,91,151,.603,0,1,.000,55,94,.585,66,118,184,11,16,59,31,109,237,7.2
2376,Issa Thiam\issa-thiam-1,2017-18,Rutgers,F,34,33,986,88,206,.427,44,85,.518,44,121,.364,17,24,.708,34,114,148,21,24,8,28,63,237,5.1
2377,Skal Labissiere\skal-labissiere-1,2015-16,Kentucky,F,36,18,567,98,190,.516,98,188,.521,0,2,.000,41,62,.661,35,78,113,11,9,59,33,108,237,4.6
2378,Mike Tobey\mike-tobey-1,2013-14,Virginia,F,37,28,668,99,206,.481,98,203,.483,1,3,.333,38,56,.679,70,69,139,11,9,39,34,73,237,4.7
2379,Torry Butler\torry-butler-1,2016-17,Sam Houston State,F,34,26,666,97,188,.516,90,158,.570,7,30,.233,35,57,.614,59,157,216,33,28,26,31,89,236,6.6
2380,Nate Renfro\nate-renfro-1,2017-18,San Francisco,F,39,29,910,94,190,.495,76,116,.655,18,74,.243,30,72,.417,56,149,205,59,25,43,55,113,236,5.2
2381,Tre Hale-Edmerson\tre-hale-edmerson-1,2013-14,Cal State Northridge,F,35,35,993,91,197,.462,88,177,.497,3,20,.150,51,70,.729,58,174,232,76,46,62,62,123,236,7.2
2382,Jamar Hurdle\jamar-hurdle-1,2015-16,Green Bay,F,35,1,523,92,181,.508,81,155,.523,11,26,.423,41,57,.719,48,64,112,18,17,38,28,86,236,5.3
2383,John Kopriva\john-kopriva-1,2014-15,George Washington,F,35,35,856,88,181,.486,69,138,.500,19,43,.442,41,63,.651,39,89,128,15,9,29,31,69,236,4.9
2384,Janarius Middleton\janarius-middleton-1,2015-16,Jackson State,F,36,15,777,106,228,.465,97,205,.473,9,23,.391,15,32,.469,75,107,182,41,16,21,38,96,236,5.0
2385,A.J. Avery\aj-avery-1,2015-16,Western Michigan,F,32,32,786,85,173,.491,81,164,.494,4,9,.444,62,91,.681,68,122,190,22,23,22,34,105,236,6.2
2386,Dominique McKoy\dominique-mckoy-1,2014-15,Duquesne,F,30,23,713,106,195,.544,106,194,.546,0,1,.000,24,65,.369,50,137,187,30,17,16,34,62,236,6.4
2387,Corey Kispert\corey-kispert-1,2017-18,Gonzaga,F,35,7,680,86,187,.460,46,73,.630,40,114,.351,24,36,.667,37,74,111,26,10,6,22,36,236,5.1
2388,Amric Fields\amric-fields-1,2013-14,Texas Christian,F,18,14,564,85,196,.434,65,137,.474,20,59,.339,46,72,.639,26,83,109,22,8,16,32,36,236,8.5
2389,Reginald Johnson\reginald-johnson-1,2014-15,Alcorn State,F,24,3,497,96,212,.453,82,166,.494,14,46,.304,30,45,.667,56,30,86,11,4,2,16,40,236,6.2
2390,Kyle Benton\kyle-benton-1,2015-16,North Carolina Central,F,31,0,720,88,154,.571,88,152,.579,0,2,.000,59,94,.628,96,100,196,8,15,20,31,71,235,7.1
2391,Remi Dibo\remi-dibo-1,2013-14,West Virginia,F,32,13,621,79,200,.395,28,64,.438,51,136,.375,26,31,.839,24,76,100,21,12,6,20,86,235,4.4
2392,Patrick Onwenu\patrick-onwenu-1,2015-16,Alcorn State,F,29,22,727,70,146,.479,70,138,.507,0,8,.000,95,130,.731,48,68,116,24,10,30,52,80,235,5.7
2393,Blake Davis\blake-davis-2,2013-14,Grand Canyon,F,30,28,895,77,197,.391,32,70,.457,45,127,.354,36,44,.818,27,87,114,50,23,17,40,95,235,5.4
2394,Ashton Pankey\ashton-pankey-1,2013-14,Manhattan,F,33,21,585,82,142,.577,82,142,.577,0,0,,71,137,.518,49,94,143,7,8,35,46,102,235,4.7
2395,Keonta Vernon\keonta-vernon-1,2015-16,Grand Canyon,F,34,14,634,95,202,.470,94,200,.470,1,2,.500,44,84,.524,77,109,186,17,19,17,56,120,235,4.1
2396,Alex Peacock\alex-peacock-1,2017-18,Texas State,F,33,27,811,81,160,.506,59,95,.621,22,65,.338,51,70,.729,51,113,164,61,33,10,50,70,235,6.7
2397,Gyorgy Goloman\gyorgy-goloman-1,2017-18,UCLA,F,33,30,805,85,155,.548,67,113,.593,18,42,.429,47,75,.627,53,87,140,39,19,42,34,114,235,6.3
2398,Jordan Morgan\jordan-morgan-1,2013-14,Michigan,F,37,27,743,98,140,.700,98,140,.700,0,0,,39,62,.629,72,113,185,22,16,16,32,95,235,6.1
2399,Brandon Murphy\brandon-murphy-1,2017-18,Indiana State,F,31,30,647,81,134,.604,81,134,.604,0,0,,73,114,.640,81,74,155,25,15,18,49,73,235,6.5
2400,Zach Brown\zach-brown-2,2015-16,Wichita State,F,35,31,668,72,158,.456,46,73,.630,26,85,.306,65,92,.707,38,63,101,32,27,13,36,76,235,5.1
2401,Sean O'Mara\sean-omara-1,2017-18,Xavier,F,35,1,512,93,157,.592,93,157,.592,0,0,,49,61,.803,43,69,112,34,11,23,29,48,235,6.0
2402,Sam Jones\sam-jones-1,2015-16,Pennsylvania,F,28,23,694,70,196,.357,12,21,.571,58,175,.331,37,42,.881,13,89,102,21,10,7,23,38,235,5.4
2403,Staphon Blair\staphon-blair-1,2014-15,Central Florida,F,30,17,746,95,156,.609,95,155,.613,0,1,.000,45,81,.556,61,94,155,3,9,38,32,73,235,6.6
2404,Dejan Kravic\dejan-kravic-1,2013-14,Texas Tech,F,32,29,679,96,190,.505,95,188,.505,1,2,.500,42,65,.646,66,82,148,26,14,41,38,46,235,6.5
2405,Zach Braxton\zach-braxton-1,2015-16,Weber State,F,34,34,697,89,144,.618,89,144,.618,0,0,,57,109,.523,44,95,139,17,9,18,51,85,235,4.6
2406,Wally Judge\wally-judge-1,2013-14,Rutgers,F,31,29,706,88,183,.481,88,182,.484,0,1,.000,58,109,.532,73,120,193,23,18,34,55,114,234,5.3
2407,Troy Williams\troy-williams-2,2013-14,Indiana,F,32,32,688,88,173,.509,82,144,.569,6,29,.207,52,77,.675,46,94,140,29,26,13,57,46,234,5.6
2408,Kenneth Lowe\kenneth-lowe-1,2016-17,Green Bay,F,32,31,703,105,190,.553,105,189,.556,0,1,.000,24,62,.387,68,100,168,50,37,48,45,71,234,7.4
2409,Oliver Powell\oliver-powell-1,2017-18,Louisiana Tech,F,32,13,750,94,170,.553,94,168,.560,0,2,.000,46,70,.657,44,103,147,17,11,20,33,56,234,5.8
2410,Tanner Morgan\tanner-morgan-1,2017-18,Northern Colorado,F,38,38,913,94,195,.482,89,174,.511,5,21,.238,41,66,.621,57,164,221,23,16,26,51,125,234,4.3
2411,Jordan Weethee\jordan-weethee-1,2013-14,Virginia Military Institute,F,35,12,636,85,215,.395,50,88,.568,35,127,.276,29,44,.659,37,94,131,30,16,13,23,65,234,4.6
2412,Devante Jackson\devante-jackson-1,2017-18,Grambling,F,29,21,592,82,178,.461,71,149,.477,11,29,.379,59,83,.711,37,88,125,19,5,24,43,85,234,4.9
2413,Ronnie Drinnon\ronnie-drinnon-1,2014-15,Saint Francis (PA),F,29,27,856,94,225,.418,89,205,.434,5,20,.250,41,69,.594,85,140,225,38,42,13,37,80,234,7.3
2414,Damien Wilson\damien-wilson-1,2014-15,Kennesaw State,F,22,16,632,88,230,.383,83,189,.439,5,41,.122,53,68,.779,31,75,106,42,18,7,59,50,234,5.4
2415,Marvin Prochet\marvin-prochet-1,2015-16,Niagara,F,32,28,856,78,202,.386,59,143,.413,19,59,.322,59,90,.656,53,121,174,28,20,25,42,67,234,5.4
2416,Jake Wiegand\jake-wiegand-1,2013-14,Illinois-Chicago,F,31,16,641,79,175,.451,78,161,.484,1,14,.071,75,96,.781,70,88,158,8,13,4,29,104,234,5.2
2417,Moussa Kone\moussa-kone-1,2013-14,Hofstra,F,33,24,709,100,178,.562,100,178,.562,0,0,,34,61,.557,79,115,194,16,20,37,34,115,234,6.2
2418,Tidell Pierre\tidell-pierre-1,2016-17,Central Connecticut State,F,29,27,734,83,199,.417,81,193,.420,2,6,.333,66,115,.574,94,104,198,22,14,4,42,88,234,5.5
2419,Gabe Taylor\gabe-taylor-1,2015-16,Portland,F,32,32,665,90,199,.452,84,168,.500,6,31,.194,48,66,.727,47,83,130,15,12,18,24,89,234,4.9
2420,Alex Poythress\alex-poythress-1,2013-14,Kentucky,F,40,0,734,88,177,.497,80,144,.556,8,33,.242,50,80,.625,72,109,181,17,12,29,38,85,234,4.7
2421,Connor Lammert\connor-lammert-1,2015-16,Texas,F,33,33,939,78,195,.400,30,52,.577,48,143,.336,30,37,.811,48,126,174,31,20,14,23,87,234,5.8
2422,Taurean Prince\taurean-prince-1,2013-14,Baylor,F,38,2,542,79,170,.465,64,129,.496,15,41,.366,61,86,.709,40,65,105,23,20,7,51,78,234,3.8
2423,Gaellen Bewernick\gaellen-bewernick-1,2013-14,Northern Arizona,F,32,32,967,98,213,.460,88,186,.473,10,27,.370,27,43,.628,50,140,190,56,21,8,56,47,233,5.8
2424,Mike Tobey\mike-tobey-1,2014-15,Virginia,F,34,11,582,93,181,.514,93,180,.517,0,1,.000,47,63,.746,66,106,172,12,9,22,26,66,233,5.8
2425,Danrad Knowles\danrad-knowles-1,2016-17,Houston,F,31,25,713,87,194,.448,86,183,.470,1,11,.091,58,87,.667,57,59,116,15,8,30,26,81,233,5.1
2426,Kendrec Ferrara\kendrec-ferrara-1,2014-15,Furman,F,33,12,814,94,221,.425,79,174,.454,15,47,.319,30,58,.517,46,98,144,26,9,41,54,70,233,4.2
2427,Scooter Gillette\scooter-gillette-1,2013-14,Fairleigh Dickinson,F,29,25,640,83,132,.629,83,131,.634,0,1,.000,67,98,.684,57,71,128,9,10,44,34,91,233,6.9
2428,Bryce Nze\bryce-nze-1,2016-17,Milwaukee,F,35,2,628,100,150,.667,99,148,.669,1,2,.500,32,77,.416,85,91,176,24,18,9,47,105,233,5.4
2429,Mark Henniger\mark-henniger-1,2013-14,Kent State,F,32,22,712,83,136,.610,83,134,.619,0,2,.000,67,85,.788,85,78,163,9,16,34,39,112,233,6.5
2430,Cornelius Hudson\cornelius-hudson-1,2014-15,Wake Forest,F,31,10,680,73,204,.358,27,60,.450,46,144,.319,41,57,.719,21,75,96,33,27,7,40,58,233,4.6
2431,Hayden Graham\hayden-graham-1,2014-15,Air Force,F,30,18,714,96,205,.468,85,141,.603,11,64,.172,30,45,.667,42,88,130,38,16,7,40,64,233,5.3
2432,Donnavan Kirk\donnavan-kirk-1,2013-14,Miami (FL),F,31,28,810,93,205,.454,81,165,.491,12,40,.300,35,58,.603,67,87,154,5,11,46,39,62,233,5.6
2433,Marvin King-Davis\marvin-king-davis-1,2014-15,Delaware,F,24,23,563,84,163,.515,84,163,.515,0,0,,65,94,.691,33,104,137,17,7,14,25,52,233,7.4
2434,Stephon Jelks\stephon-jelks-1,2016-17,Mercer,F,32,31,850,75,189,.397,53,112,.473,22,77,.286,61,76,.803,71,142,213,57,14,15,37,69,233,6.8
2435,Chandler Thomas\chandler-thomas-1,2013-14,Grambling,F,29,16,662,85,189,.450,75,162,.463,10,27,.370,53,90,.589,57,114,171,12,27,10,43,70,233,5.7
2436,Willie Clayton\willie-clayton-1,2014-15,Charlotte,F,32,22,725,96,169,.568,96,169,.568,0,0,,41,108,.380,99,101,200,16,20,9,66,94,233,5.0
2437,Tre Drye\trevante-drye-1,2013-14,Tulane,F,34,33,1023,81,168,.482,75,144,.521,6,24,.250,65,114,.570,80,180,260,29,29,11,55,87,233,6.0
2438,T.J. Maston\tj-maston-1,2016-17,Baylor,F,33,0,516,94,181,.519,94,176,.534,0,5,.000,45,55,.818,53,73,126,19,14,10,42,64,233,5.0
2439,Malik Dime\malik-dime-1,2015-16,Washington,F,34,9,720,91,147,.619,91,147,.619,0,0,,51,68,.750,81,110,191,3,13,86,28,105,233,7.5
2440,Karamo Jawara\karamo-jawara-1,2013-14,North Carolina Central,F,31,30,924,81,162,.500,70,124,.565,11,38,.289,60,82,.732,39,107,146,82,29,22,28,95,233,7.7
2441,Chris Washburn\chris-washburn-2,2014-15,Texas Christian,F,33,32,790,91,189,.481,90,186,.484,1,3,.333,50,95,.526,58,132,190,43,46,45,34,90,233,7.2
2442,Luke Knapke\luke-knapke-1,2016-17,Toledo,F,34,18,653,89,152,.586,72,118,.610,17,34,.500,38,50,.760,41,102,143,40,8,27,43,92,233,5.6
2443,Shaq Thomas\shaquille-thomas-1,2013-14,Cincinnati,F,34,33,779,89,196,.454,84,177,.475,5,19,.263,49,74,.662,37,57,94,32,29,12,36,55,232,4.9
2444,Colin Voss\colin-voss-1,2013-14,North Texas,F,32,29,817,92,197,.467,92,195,.472,0,2,.000,48,72,.667,64,122,186,19,18,16,45,75,232,5.3
2445,Kamryn Williams\kamryn-williams-1,2013-14,Air Force,F,23,22,718,90,209,.431,70,146,.479,20,63,.317,32,53,.604,48,102,150,57,20,21,51,58,232,7.7
2446,Abdul Lewis\abdul-lewis-1,2014-15,South Alabama,F,33,27,910,88,188,.468,87,184,.473,1,4,.250,55,104,.529,63,164,227,22,9,18,72,91,232,4.2
2447,Marcus Derrickson\marcus-derrickson-1,2016-17,Georgetown,F,28,17,665,76,176,.432,44,83,.530,32,93,.344,48,58,.828,34,89,123,40,12,18,37,84,232,6.0
2448,Greg Gainey\greg-gainey-1,2014-15,Texas-Arlington,F,24,12,493,87,194,.448,58,110,.527,29,84,.345,29,41,.707,31,65,96,9,9,11,23,62,232,5.9
2449,Tyrell Sturdivant\tyrell-sturdivant-1,2017-18,Stony Brook,F,32,24,719,80,211,.379,51,108,.472,29,103,.282,43,78,.551,40,105,145,56,52,13,63,88,232,5.1
2450,Javis Howard\javis-howard-1,2015-16,Charleston Southern,F,30,29,739,97,185,.524,94,175,.537,3,10,.300,35,67,.522,54,92,146,20,20,7,49,66,232,5.2
2451,Tyrel Hunt\tyrel-hunt-1,2014-15,Alcorn State,F,30,26,628,86,183,.470,83,177,.469,3,6,.500,57,87,.655,29,65,94,12,14,15,27,66,232,4.9
2452,Brandon Parrish\brandon-parrish-1,2016-17,Texas Christian,F,39,3,728,83,193,.430,34,60,.567,49,133,.368,17,27,.630,23,78,101,22,16,8,18,65,232,4.1
2453,Ryan Rosburg\ryan-rosburg-1,2015-16,Missouri,F,31,21,614,92,147,.626,92,147,.626,0,0,,48,87,.552,35,84,119,15,10,15,26,89,232,5.5
2454,Kamari Murphy\kamari-murphy-1,2016-17,Miami (FL),F,33,33,971,95,188,.505,95,187,.508,0,1,.000,42,69,.609,79,162,241,18,13,23,50,78,232,5.8
2455,Kameron Edwards\kameron-edwards-1,2015-16,Pepperdine,F,32,28,765,85,193,.440,84,183,.459,1,10,.100,61,100,.610,51,83,134,40,26,10,53,71,232,4.9
2456,Charles McRoy\charles-mcroy-1,2013-14,North Florida,F,32,31,792,74,175,.423,58,128,.453,16,47,.340,68,101,.673,38,70,108,50,15,3,49,63,232,4.7
2457,Kezie Okpala\kezie-okpala-1,2017-18,Stanford,F,23,21,655,75,191,.393,68,160,.425,7,31,.226,74,109,.679,27,59,86,41,23,13,57,70,231,5.5
2458,Kyndahl Hill\kyndahl-hill-1,2014-15,Weber State,F,30,29,802,72,156,.462,55,105,.524,17,51,.333,70,91,.769,38,114,152,25,18,24,47,91,231,5.7
2459,Dominic Robb\dominic-robb-1,2017-18,Niagara,F,33,15,638,93,159,.585,92,158,.582,1,1,1.000,44,74,.595,45,88,133,14,7,48,28,77,231,5.9
2460,Daniel Broughton\daniel-broughton-1,2013-14,Arkansas-Pine Bluff,F,29,28,743,85,227,.374,64,172,.372,21,55,.382,40,55,.727,35,99,134,22,18,14,58,107,231,3.3
2461,Kyle Washington\kyle-washington-2,2014-15,North Carolina State,F,34,18,604,98,210,.467,91,197,.462,7,13,.538,28,39,.718,40,99,139,15,7,37,32,71,231,4.7
2462,Bryce Washington\bryce-washington-1,2014-15,Louisiana,F,36,17,845,94,176,.534,90,164,.549,4,12,.333,39,58,.672,67,121,188,56,23,18,46,73,231,6.1
2463,Chris Wray\chris-wray-1,2017-18,Mount St. Mary's,F,24,23,768,102,164,.622,102,163,.626,0,1,.000,27,84,.321,72,126,198,92,49,50,46,61,231,12.5
2464,Jonathan Fairell\jonathan-fairell-1,2013-14,Murray State,F,34,34,749,92,142,.648,92,142,.648,0,0,,47,108,.435,97,134,231,23,18,34,54,116,231,6.2
2465,Jarrid Rhodes\jarrid-rhodes-1,2016-17,Missouri State,F,33,27,731,85,201,.423,48,106,.453,37,95,.389,24,33,.727,28,86,114,21,9,8,42,59,231,3.9
2466,Melsahn Basabe\melsahn-basabe-1,2013-14,Iowa,F,32,31,568,92,164,.561,91,163,.558,1,1,1.000,46,68,.676,59,123,182,10,12,26,33,49,231,6.5
2467,Jacob Calloway\jacob-calloway-1,2016-17,Southern Utah,F,31,8,494,76,180,.422,40,81,.494,36,99,.364,43,55,.782,40,63,103,20,13,10,35,88,231,4.6
2468,Tosin Mehinti\tosin-mehinti-1,2014-15,Alabama-Birmingham,F,34,34,763,95,186,.511,95,186,.511,0,0,,41,72,.569,54,106,160,25,12,68,61,87,231,5.2
2469,Zane Najdawi\zane-najdawi-1,2015-16,Citadel,F,32,28,593,83,180,.461,74,151,.490,9,29,.310,56,73,.767,49,85,134,12,24,58,39,103,231,5.8
2470,Tyler Roberson\tyler-roberson-1,2014-15,Syracuse,F,28,19,803,93,210,.443,93,207,.449,0,3,.000,45,70,.643,79,124,203,45,25,18,33,57,231,7.8
2471,Admiral Schofield\admiral-schofield-1,2016-17,Tennessee,F,28,2,533,78,172,.453,57,118,.483,21,54,.389,53,68,.779,26,98,124,21,9,5,32,65,230,5.4
2472,Joshua Phillips\joshua-phillips-1,2017-18,Chattanooga,F,25,20,612,93,169,.550,93,169,.550,0,0,,44,78,.564,55,99,154,12,7,10,40,64,230,6.4
2473,Naz Bohannon\naz-bohannon-1,2017-18,Youngstown State,F,32,30,933,93,226,.412,87,200,.435,6,26,.231,38,66,.576,108,151,259,44,23,5,52,84,230,6.0
2474,J.J. Panoske\jj-panoske-1,2014-15,Milwaukee,F,30,27,624,86,190,.453,64,126,.508,22,64,.344,36,42,.857,30,80,110,25,10,31,43,64,230,5.2
2475,Kenny Wooten\kenny-wooten-1,2017-18,Oregon,F,36,11,711,96,141,.681,96,140,.686,0,1,.000,38,64,.594,48,115,163,11,22,92,32,98,230,7.0
2476,Shaquille Morris\shaquille-morris-1,2015-16,Wichita State,F,34,29,523,94,166,.566,94,166,.566,0,0,,42,64,.656,42,79,121,13,11,35,25,95,230,5.2
2477,Fred Chatmon\fred-chatmon-1,2013-14,Missouri-Kansas City,F,29,26,680,98,193,.508,96,172,.558,2,21,.095,32,83,.386,69,130,199,11,20,24,39,79,230,6.0
2478,Konner Frey\konner-frey-1,2017-18,Montana State,F,32,2,539,82,156,.526,63,112,.563,19,44,.432,47,64,.734,54,107,161,22,21,2,23,100,230,6.0
2479,Moussa Kone\moussa-kone-1,2014-15,Hofstra,F,26,25,525,97,144,.674,97,144,.674,0,0,,36,60,.600,57,89,146,13,13,21,22,83,230,7.9
2480,Sean O'Mara\sean-omara-1,2016-17,Xavier,F,38,9,523,88,146,.603,88,146,.603,0,0,,54,79,.684,51,65,116,23,12,13,32,66,230,4.9
2481,Shannon Hale\shannon-hale-1,2014-15,Alabama,F,28,15,542,75,180,.417,49,94,.521,26,86,.302,54,77,.701,29,60,89,32,21,14,53,54,230,5.1
2482,Junior Etou\junior-etou-1,2014-15,Rutgers,F,31,31,919,81,207,.391,58,133,.436,23,74,.311,45,68,.662,46,160,206,18,12,13,38,57,230,5.2
2483,Antravious Simmons\antravious-simmons-1,2017-18,Florida Gulf Coast,F,33,21,575,94,163,.577,94,163,.577,0,0,,42,62,.677,61,101,162,35,16,4,32,83,230,6.0
2484,David Burrell\david-burrell-3,2017-18,East Tennessee State,F,33,33,718,90,186,.484,72,120,.600,18,66,.273,32,53,.604,48,112,160,30,16,20,43,58,230,5.4
2485,DJ Hogg\dj-hogg-1,2015-16,Texas A&M,F,37,3,673,81,212,.382,35,73,.479,46,139,.331,22,34,.647,28,78,106,35,20,5,24,44,230,4.3
2486,Allen Payne\allen-payne-1,2013-14,Auburn,F,30,29,845,86,185,.465,80,156,.513,6,29,.207,51,67,.761,51,111,162,51,37,6,52,66,229,6.5
2487,De'Quon Lake\dequon-lake-1,2017-18,Arizona State,F,32,1,546,91,128,.711,91,128,.711,0,0,,47,71,.662,59,108,167,4,9,43,14,91,229,7.2
2488,Paulius Zalys\paulius-zalys-1,2015-16,Lafayette,F,30,3,693,83,169,.491,60,102,.588,23,67,.343,40,62,.645,41,73,114,38,12,11,64,73,229,4.6
2489,Jordan Latham\jordan-latham-1,2013-14,Loyola (MD),F,30,25,680,89,207,.430,88,203,.433,1,4,.250,50,82,.610,45,70,115,26,16,40,50,90,229,4.5
2490,Marin Mornar\marin-mornar-1,2015-16,Loyola Marymount,F,30,9,676,82,181,.453,52,93,.559,30,88,.341,35,49,.714,31,90,121,21,10,38,25,63,229,6.0
2491,Anthony Duruji\anthony-duruji-1,2017-18,Louisiana Tech,F,32,19,682,82,182,.451,54,111,.486,28,71,.394,37,62,.597,36,95,131,26,12,45,38,77,229,5.3
2492,Abdul-Malik Abu\abdul-malik-abu-1,2014-15,North Carolina State,F,36,22,687,87,186,.468,86,181,.475,1,5,.200,54,96,.563,68,104,172,22,6,18,35,79,229,4.5
2493,LaRon Smith\laron-smith-1,2015-16,Bethune-Cookman,F,32,32,814,108,184,.587,108,184,.587,0,0,,13,49,.265,91,131,222,19,11,96,37,95,229,7.8
2494,Eli Pepper\eli-pepper-1,2017-18,Lipscomb,F,33,33,803,86,173,.497,71,117,.607,15,56,.268,42,78,.538,60,201,261,64,17,22,61,102,229,6.2
2495,Phil Cofer\phil-cofer-1,2014-15,Florida State,F,33,24,737,78,171,.456,72,156,.462,6,15,.400,67,106,.632,51,98,149,6,9,20,34,57,229,4.9
2496,Cameron Neubauer\cameron-neubauer-1,2017-18,San Diego,F,34,31,972,71,183,.388,26,51,.510,45,132,.341,42,59,.712,26,90,116,53,18,8,53,100,229,4.0
2497,Cody Joyce\cody-joyce-1,2015-16,Maryland-Baltimore County,F,29,17,606,84,172,.488,84,171,.491,0,1,.000,61,87,.701,33,78,111,13,10,5,38,76,229,4.6
2498,Desharick Guidry\desharick-guidry-1,2013-14,McNeese State,F,23,20,770,87,217,.401,73,160,.456,14,57,.246,41,58,.707,75,110,185,27,25,10,39,81,229,7.4
2499,Ben Moore\ben-moore-1,2013-14,Southern Methodist,F,37,1,547,84,137,.613,84,137,.613,0,0,,61,97,.629,62,70,132,30,19,16,38,62,229,5.5
2500,Antonio Campbell\antonio-campbell-1,2016-17,Ohio,F,15,14,334,88,166,.530,65,102,.637,23,64,.359,30,46,.652,25,100,125,11,9,16,26,49,229,11.4
2501,Marcus Lee\marcus-lee-2,2015-16,Kentucky,F,36,20,785,102,150,.680,102,150,.680,0,0,,25,62,.403,87,129,216,11,12,58,35,109,229,6.4
2502,Trevor Thompson\trevor-thompson-1,2015-16,Ohio State,F,35,28,628,84,161,.522,84,161,.522,0,0,,60,80,.750,60,118,178,6,11,42,42,97,228,5.2
2503,Kris Jenkins\kris-jenkins-1,2014-15,Villanova,F,36,1,668,67,161,.416,19,32,.594,48,129,.372,46,59,.780,16,57,73,34,23,8,21,59,228,4.8
2504,Elgin Cook\elgin-cook-1,2013-14,Oregon,F,34,1,566,77,134,.575,75,121,.620,2,13,.154,72,109,.661,56,70,126,15,21,16,29,87,228,5.6
2505,Derek Ogbeide\derek-ogbeide-1,2017-18,Georgia,F,33,28,722,101,171,.591,101,170,.594,0,1,.000,26,55,.473,61,142,203,22,11,29,38,66,228,6.2
2506,C.J. Washington\cj-washington-2,2014-15,Alabama-Birmingham,F,34,11,603,84,223,.377,69,167,.413,15,56,.268,45,62,.726,53,76,129,15,20,10,48,66,228,3.6
2507,Darren Payen\darren-payen-1,2016-17,Vermont,F,34,1,409,94,134,.701,94,133,.707,0,1,.000,40,56,.714,33,50,83,10,9,24,32,49,228,5.4
2508,Donovan Gibbs\donovan-gibbs-1,2013-14,IUPUI,F,32,22,803,88,176,.500,71,128,.555,17,48,.354,35,47,.745,38,110,148,23,9,11,32,56,228,5.4
2509,Nick Havener\nick-havener-1,2015-16,Boston University,F,34,16,705,95,192,.495,93,186,.500,2,6,.333,36,57,.632,57,150,207,45,38,40,48,115,228,6.2
2510,Steve Harris\steve-harris-3,2017-18,Austin Peay,F,34,1,671,91,201,.453,84,180,.467,7,21,.333,39,60,.650,24,36,60,29,22,10,55,63,228,3.3
2511,Bira Seck\bira-seck-1,2014-15,Idaho,F,30,30,703,97,184,.527,96,183,.525,1,1,1.000,33,50,.660,61,140,201,30,15,8,55,103,228,5.4
2512,Jalen Jenkins\jalen-jenkins-1,2015-16,George Mason,F,32,4,686,87,175,.497,87,175,.497,0,0,,54,78,.692,77,100,177,18,15,25,49,106,228,5.3
2513,Amile Jefferson\amile-jefferson-1,2013-14,Duke,F,35,26,796,94,146,.644,94,146,.644,0,0,,40,81,.494,101,139,240,36,23,20,23,93,228,7.5
2514,Robert Jones III\robert-jonesiii-1,2016-17,Idaho State,F,30,21,706,82,175,.469,50,93,.538,32,82,.390,32,48,.667,23,79,102,35,21,15,51,87,228,4.7
2515,Chris Olivier\chris-olivier-1,2013-14,Eastern Illinois,F,20,7,398,96,191,.503,96,190,.505,0,1,.000,36,55,.655,27,60,87,9,4,33,31,53,228,7.2
2516,Dominique Elliott\dominique-elliott-1,2014-15,Maryland-Eastern Shore,F,32,17,673,81,179,.453,80,165,.485,1,14,.071,65,100,.650,53,90,143,39,29,6,70,95,228,4.3
2517,Dallas Gary\dallas-gary-1,2014-15,Coppin State,F,29,3,548,70,188,.372,56,127,.441,14,61,.230,74,103,.718,13,75,88,20,10,9,48,43,228,3.8
2518,Shane Whitfield\shane-whitfield-1,2015-16,Campbell,F,30,27,806,71,123,.577,71,122,.582,0,1,.000,85,116,.733,30,81,111,46,21,2,40,97,227,5.9
2519,Nick Madray\nick-madray-1,2013-14,Binghamton,F,21,17,586,76,174,.437,41,82,.500,35,92,.380,40,54,.741,21,57,78,10,12,10,34,61,227,6.2
2520,Roschon Prince\roschon-prince-1,2015-16,Cal State Long Beach,F,35,12,647,74,168,.440,74,168,.440,0,0,,79,122,.648,45,79,124,19,19,7,33,98,227,4.1
2521,Junior Saintel\junior-saintel-1,2017-18,Stony Brook,F,32,32,685,88,196,.449,82,171,.480,6,25,.240,45,68,.662,51,99,150,19,29,24,44,67,227,5.3
2522,Nate Sherwood\nate-sherwood-1,2016-17,Idaho,F,33,32,838,86,187,.460,75,153,.490,11,34,.324,44,67,.657,61,119,180,44,12,16,36,94,227,5.5
2523,Khris Lane\khris-lane-1,2017-18,Virginia Commonwealth,F,33,16,481,91,162,.562,79,129,.612,12,33,.364,33,54,.611,41,83,124,20,9,8,45,47,227,4.8
2524,Martin Krampelj\martin-krampelj-1,2017-18,Creighton,F,19,19,441,94,140,.671,88,117,.752,6,23,.261,33,53,.623,41,112,153,23,16,13,25,52,227,11.4
2525,Evan Hall\evan-hall-1,2016-17,IUPUI,F,30,22,596,96,163,.589,96,163,.589,0,0,,35,89,.393,73,83,156,14,16,24,40,83,227,5.8
2526,Marcus Derrickson\marcus-derrickson-1,2015-16,Georgetown,F,32,27,692,68,167,.407,30,66,.455,38,101,.376,53,61,.869,47,97,144,36,14,19,51,100,227,4.9
2527,Alex Fountain\alex-fountain-1,2016-17,Houston Baptist,F,31,6,587,79,168,.470,56,110,.509,23,58,.397,46,63,.730,25,49,74,41,11,9,27,64,227,5.2
2528,John Collins\john-collins-1,2015-16,Wake Forest,F,31,1,446,81,148,.547,81,148,.547,0,0,,65,94,.691,52,70,122,7,9,23,31,82,227,5.4
2529,Chas Brown\chas-brown-1,2016-17,Coppin State,F,18,18,481,86,153,.562,86,151,.570,0,2,.000,55,103,.534,47,80,127,16,12,16,46,71,227,8.4
2530,Arnaud William Adala Moto\arnaudwilliam-adalamoto-1,2013-14,Wake Forest,F,33,11,648,80,172,.465,79,165,.479,1,7,.143,66,101,.653,58,113,171,19,17,4,52,94,227,4.3
2531,Alonzo Traylor\alonzo-traylor-1,2013-14,North Dakota,F,31,6,515,95,156,.609,95,156,.609,0,0,,37,66,.561,50,66,116,4,9,19,29,94,227,5.1
2532,Rod Mills\rod-mills-1,2016-17,Miami (OH),F,32,24,705,90,208,.433,63,123,.512,27,85,.318,20,31,.645,23,76,99,24,23,6,40,76,227,3.9
2533,Bola Olaniyan\bola-olaniyan-1,2015-16,Southern Illinois,F,29,26,693,86,152,.566,86,152,.566,0,0,,55,83,.663,88,166,254,24,26,6,47,109,227,7.3
2534,Ede Egharevba\ede-egharevba-1,2015-16,North Carolina A&T,F,32,16,572,88,204,.431,63,126,.500,25,78,.321,26,44,.591,33,82,115,22,26,9,37,79,227,4.3
2535,Arkadiy Mkrtychyan\arkadiy-mkrtychyan-1,2015-16,Idaho,F,31,22,576,83,172,.483,83,169,.491,0,3,.000,61,103,.592,37,80,117,22,19,2,46,80,227,4.2
2536,Kion Brown\kion-brown-1,2013-14,Radford,F,35,4,575,93,165,.564,93,165,.564,0,0,,41,79,.519,42,58,100,8,4,1,40,81,227,3.4
2537,Timajh Parker-Rivera\timajh-parker-rivera-1,2014-15,Towson,F,32,31,900,81,182,.445,81,175,.463,0,7,.000,64,123,.520,74,115,189,42,21,29,56,93,226,5.4
2538,Phil Valenti\phil-valenti-1,2014-15,Canisius,F,24,20,602,85,190,.447,73,154,.474,12,36,.333,44,62,.710,41,68,109,58,23,7,45,64,226,7.0
2539,Will Weeks\will-weeks-1,2015-16,North Carolina-Asheville,F,33,4,821,94,182,.516,94,182,.516,0,0,,38,74,.514,54,87,141,59,37,4,40,61,226,6.1
2540,Justin Miller\justin-miller-2,2017-18,Louisiana,F,32,3,438,77,183,.421,62,127,.488,15,56,.268,57,72,.792,45,73,118,37,13,4,36,68,226,4.8
2541,Anthony Perez\anthony-perez-1,2013-14,Mississippi,F,32,12,646,67,167,.401,41,89,.461,26,78,.333,66,96,.688,33,80,113,22,22,20,47,75,226,4.5
2542,Nick Smith\nick-smith-3,2014-15,Belmont,F,33,6,497,77,187,.412,19,39,.487,58,148,.392,14,14,1.000,26,40,66,9,4,7,19,42,226,4.1
2543,Wesley Gordon\wesley-gordon-1,2014-15,Colorado,F,34,31,894,83,151,.550,79,137,.577,4,14,.286,56,84,.667,87,146,233,40,13,47,40,67,226,7.5
2544,Conner Avants\conner-avants-1,2015-16,North Dakota,F,33,8,644,81,165,.491,73,146,.500,8,19,.421,56,82,.683,34,72,106,11,18,8,39,98,226,4.0
2545,Matt Townsend\matt-townsend-1,2014-15,Yale,F,30,29,827,96,182,.527,95,175,.543,1,7,.143,33,53,.623,47,63,110,46,11,7,43,67,226,5.3
2546,Tyrell Johnson\tyrell-johnson-1,2016-17,Appalachian State,F,30,26,586,82,184,.446,74,155,.477,8,29,.276,54,85,.635,33,80,113,12,10,33,36,88,226,4.5
2547,Justin Goldsborough\justin-goldsborough-1,2014-15,Lehigh,F,30,22,702,93,160,.581,93,160,.581,0,0,,40,66,.606,58,115,173,18,12,38,48,78,226,6.3
2548,Jeremy Watson\jeremy-watson-1,2015-16,Jacksonville State,F,29,13,730,68,173,.393,56,133,.421,12,40,.300,77,102,.755,54,115,169,13,11,8,43,66,225,5.2
2549,Kameron Woods\kameron-woods-1,2013-14,Butler,F,30,30,1003,77,172,.448,77,172,.448,0,0,,71,108,.657,61,209,270,61,26,30,70,60,225,7.4
2550,Chaise Daniels\chaise-daniels-1,2015-16,Quinnipiac,F,23,20,596,92,234,.393,92,233,.395,0,1,.000,41,66,.621,48,94,142,23,8,39,54,72,225,5.1
2551,Georgi Funtarov\georgi-funtarov-1,2013-14,UC-Davis,F,26,22,630,86,200,.430,54,102,.529,32,98,.327,21,39,.538,36,91,127,21,8,7,35,59,225,5.1
2552,Stephen Ugochukwu\stephen-ugochukwu-1,2017-18,McNeese State,F,28,25,639,86,198,.434,85,194,.438,1,4,.250,52,85,.612,46,102,148,24,15,35,40,86,225,5.4
2553,Jack Purchase\jack-purchase-1,2017-18,Hawaii,F,30,8,758,76,207,.367,26,51,.510,50,156,.321,23,35,.657,24,128,152,63,16,16,35,59,225,5.8
2554,Shane Temara\shane-temara-1,2017-18,North Texas,F,29,22,599,88,190,.463,57,97,.588,31,93,.333,18,34,.529,46,92,138,15,5,20,21,42,225,5.9
2555,Alvin Ellis\alvin-ellis-1,2016-17,Michigan State,F,35,8,678,72,180,.400,31,67,.463,41,113,.363,40,57,.702,22,86,108,43,22,13,49,67,225,4.2
2556,Isaac Copeland\isaac-copeland-1,2014-15,Georgetown,F,33,11,661,83,184,.451,62,130,.477,21,54,.389,38,47,.809,30,97,127,23,8,19,36,46,225,4.8
2557,Darryl Palmer\darryl-palmer-1,2014-15,South Carolina State,F,30,25,811,90,217,.415,89,206,.432,1,11,.091,44,75,.587,64,138,202,25,16,66,24,74,225,7.0
2558,Dan Kimasa\dan-kimasa-1,2014-15,Texas-Rio Grande Valley,F,31,31,859,82,198,.414,82,198,.414,0,0,,61,102,.598,56,145,201,18,15,44,31,73,225,5.9
2559,Jack McVeigh\jack-mcveigh-1,2016-17,Nebraska,F,30,11,688,73,196,.372,26,57,.456,47,139,.338,32,41,.780,14,62,76,19,16,8,21,27,225,4.8
2560,Clarence Trent\clarence-trent-1,2013-14,Seattle,F,30,30,651,80,192,.417,57,115,.496,23,77,.299,42,66,.636,39,95,134,31,38,21,44,82,225,5.5
2561,Tyree Robinson\tyree-robinson-1,2017-18,Youngstown State,F,30,9,385,97,156,.622,97,156,.622,0,0,,31,58,.534,38,69,107,13,27,29,37,75,225,6.0
2562,Kasey Wilson\kasey-wilson-1,2014-15,Central Florida,F,29,22,680,78,188,.415,51,106,.481,27,82,.329,42,62,.677,38,104,142,30,11,16,42,73,225,5.0
2563,Joel Awich\joel-awich-1,2015-16,Cal Poly,F,28,20,611,81,205,.395,60,130,.462,21,75,.280,42,56,.750,30,89,119,21,9,29,36,60,225,5.0
2564,Justas Furmanavicius\justas-furmanavicius-1,2016-17,Mississippi,F,36,17,901,73,153,.477,65,122,.533,8,31,.258,71,115,.617,73,107,180,38,26,38,37,105,225,5.9
2565,Anthony Thomas\anthony-thomas-6,2013-14,College of Charleston,F,32,22,795,94,198,.475,91,181,.503,3,17,.176,34,65,.523,54,94,148,29,23,19,50,72,225,4.9
2566,Ed Morrow\edward-morrow-1,2016-17,Nebraska,F,24,18,562,92,179,.514,92,179,.514,0,0,,41,67,.612,77,103,180,8,8,27,47,67,225,7.1
2567,Janarius Middleton\janarius-middleton-1,2016-17,Jackson State,F,32,31,978,89,191,.466,88,180,.489,1,11,.091,46,71,.648,118,140,258,37,17,8,50,96,225,6.3
2568,Edrico McGregor\edrico-mcgregor-1,2013-14,Texas-San Antonio,F,29,28,715,94,152,.618,94,152,.618,0,0,,36,64,.563,53,112,165,25,10,12,59,87,224,5.4
2569,Charles Wilson-Fisher\charle-wilson-fisher-1,2017-18,Hampton,F,34,12,562,94,169,.556,93,160,.581,1,9,.111,35,51,.686,61,115,176,16,10,32,42,98,224,5.2
2570,Tristan Clark\tristan-clark-1,2017-18,Baylor,F,33,30,657,93,153,.608,91,146,.623,2,7,.286,36,55,.655,47,101,148,25,18,29,38,80,224,5.9
2571,Courtney Alexander II\courtney-alexanderii-1,2017-18,Tennessee Tech,F,33,32,873,79,171,.462,79,170,.465,0,1,.000,66,128,.516,72,190,262,56,29,26,76,83,224,5.9
2572,Isaiah Wilkins\isaiah-wilkins-1,2016-17,Virginia,F,33,28,874,90,162,.556,86,155,.555,4,7,.571,40,57,.702,78,120,198,37,33,43,34,61,224,7.9
2573,Trhae Mitchell\trhae-mitchell-1,2017-18,South Alabama,F,32,32,956,82,178,.461,69,142,.486,13,36,.361,47,76,.618,32,162,194,83,29,45,54,83,224,7.0
2574,Albert Almanza\albert-almanza-1,2015-16,Sam Houston State,F,34,16,740,75,185,.405,24,54,.444,51,131,.389,23,28,.821,30,108,138,34,13,5,20,87,224,4.7
2575,Karl Charles\karl-charles-1,2017-18,Holy Cross,F,22,22,652,70,160,.438,48,81,.593,22,79,.278,62,80,.775,11,52,63,69,33,5,51,55,224,7.6
2576,Anthony Lawrence Jr.\anthony-lawrencejr-1,2016-17,Miami (FL),F,33,18,856,72,173,.416,37,74,.500,35,99,.354,45,62,.726,27,97,124,57,42,15,47,78,224,5.7
2577,Vic Law\vic-law-1,2014-15,Northwestern,F,32,19,780,74,191,.387,47,115,.409,27,76,.355,49,64,.766,31,122,153,41,21,15,48,76,224,4.8
2578,Kris Acox\kris-acox-1,2014-15,Furman,F,32,30,889,91,152,.599,91,152,.599,0,0,,42,84,.500,109,132,241,12,20,15,48,83,224,6.6
2579,Kyle Benton\kyle-benton-1,2016-17,North Carolina Central,F,24,18,716,90,145,.621,90,145,.621,0,0,,44,89,.494,86,115,201,12,20,30,23,56,224,10.0
2580,Tom Rivard\tom-rivard-1,2016-17,Colgate,F,32,16,635,88,188,.468,69,130,.531,19,58,.328,29,51,.569,31,85,116,35,15,11,49,60,224,4.4
2581,Nick Banyard\nick-banyard-1,2016-17,Central Florida,F,36,22,1021,82,188,.436,50,120,.417,32,68,.471,28,48,.583,47,169,216,59,17,9,73,74,224,4.5
2582,Travis Fuller\travis-fuller-1,2016-17,Brown,F,30,8,524,80,154,.519,79,144,.549,1,10,.100,63,95,.663,58,114,172,20,9,12,41,67,224,5.8
2583,Juwan Gray\juwan-gray-1,2016-17,San Diego,F,31,21,853,78,180,.433,51,114,.447,27,66,.409,41,66,.621,29,144,173,31,25,17,36,83,224,5.6
2584,Quinn Taylor\quinn-taylor-1,2017-18,Utah State,F,33,17,763,92,152,.605,78,118,.661,14,34,.412,26,46,.565,67,87,154,45,13,24,28,83,224,6.7
2585,Tyrique Jones\tyrique-jones-1,2017-18,Xavier,F,32,19,479,84,134,.627,84,134,.627,0,0,,56,95,.589,47,97,144,16,18,19,24,65,224,6.3
2586,Evan Hall\evan-hall-1,2017-18,IUPUI,F,29,29,655,97,215,.451,97,215,.451,0,0,,30,102,.294,74,104,178,20,21,25,54,79,224,4.6
2587,Leo Goodman\leo-goodman-1,2015-16,Stetson,F,34,2,547,80,190,.421,41,90,.456,39,100,.390,24,28,.857,31,45,76,12,15,5,20,55,223,4.1
2588,Brandon Sherrod\brandon-sherrod-1,2013-14,Yale,F,33,14,692,77,180,.428,77,179,.430,0,1,.000,69,111,.622,62,80,142,37,12,28,34,69,223,5.3
2589,Tony Washington\tony-washington-1,2015-16,La Salle,F,29,25,774,98,162,.605,98,162,.605,0,0,,27,54,.500,68,148,216,19,14,44,45,102,223,7.0
2590,Timajh Parker-Rivera\timajh-parker-rivera-1,2013-14,Towson,F,36,36,911,82,153,.536,82,153,.536,0,0,,59,102,.578,95,92,187,12,20,44,16,100,223,6.4
2591,Matthew McCarthy\matthew-mccarthy-1,2016-17,San Francisco,F,33,28,723,95,188,.505,88,159,.553,7,29,.241,26,42,.619,64,119,183,37,20,17,54,85,223,5.3
2592,Kyle Thomas\kyle-thomas-3,2015-16,Morgan State,F,30,10,611,81,226,.358,53,131,.405,28,95,.295,33,47,.702,26,62,88,13,13,17,37,72,223,3.2
2593,Till Gloger\till-gloger-1,2013-14,Maine,F,29,8,582,90,164,.549,90,164,.549,0,0,,43,59,.729,38,79,117,12,15,5,36,38,223,5.6
2594,Evan Wiley\evan-wiley-2,2017-18,Alabama A&M,F,31,19,792,79,191,.414,44,98,.449,35,93,.376,30,49,.612,48,78,126,28,13,8,38,65,223,4.7
2595,JD Miller\jd-miller-1,2015-16,Texas Christian,F,33,3,640,72,189,.381,66,169,.391,6,20,.300,73,103,.709,63,78,141,21,26,18,50,52,223,4.8
2596,Ta'Jay Henry\tajay-henry-1,2016-17,Mississippi Valley State,F,21,17,601,87,152,.572,87,152,.572,0,0,,49,84,.583,66,93,159,17,19,2,40,66,223,8.4
2597,James Siakam\james-siakam-1,2013-14,Vanderbilt,F,31,28,748,76,129,.589,76,125,.608,0,4,.000,70,101,.693,71,93,164,36,28,41,40,104,222,7.3
2598,Keaton Jackson\keaton-jackson-1,2014-15,Southern Illinois-Edwardsville,F,28,27,568,91,163,.558,91,163,.558,0,0,,40,67,.597,76,92,168,13,8,58,45,99,222,6.7
2599,Deandre Davis\deandre-davis-2,2015-16,Alcorn State,F,30,18,553,90,154,.584,84,139,.604,6,15,.400,36,59,.610,76,58,134,8,14,21,32,90,222,5.9
2600,Kevarrius Hayes\kevarrius-hayes-1,2016-17,Florida,F,36,16,659,77,128,.602,77,127,.606,0,1,.000,68,101,.673,69,91,160,7,25,60,28,85,222,6.5
2601,Max Hoetzel\max-hoetzel-1,2016-17,San Diego State,F,29,10,556,68,187,.364,16,37,.432,52,150,.347,34,42,.810,31,80,111,12,17,7,25,50,222,5.0
2602,Jalen Jenkins\jalen-jenkins-1,2013-14,George Mason,F,31,17,707,76,155,.490,76,153,.497,0,2,.000,70,101,.693,61,125,186,42,25,31,61,96,222,6.1
2603,Mark Vital\mark-vital-1,2017-18,Baylor,F,33,18,786,87,181,.481,86,171,.503,1,10,.100,47,93,.505,75,109,184,71,26,21,68,73,222,5.8
2604,Toby Hegner\toby-hegner-1,2014-15,Creighton,F,33,28,632,72,172,.419,27,47,.574,45,125,.360,33,40,.825,27,84,111,25,5,12,26,73,222,4.5
2605,Khary Doby\khary-doby-1,2014-15,North Carolina A&T,F,32,18,717,75,202,.371,53,124,.427,22,78,.282,50,79,.633,32,79,111,15,12,15,48,64,222,3.3
2606,Luther Page\luther-page-1,2013-14,Alabama State,F,32,26,826,79,161,.491,79,158,.500,0,3,.000,64,100,.640,77,85,162,27,33,19,57,92,222,5.5
2607,Alex Davis\alex-davis-3,2013-14,Fresno State,F,38,31,951,79,164,.482,77,156,.494,2,8,.250,62,105,.590,62,79,141,26,21,72,61,135,222,4.3
2608,Tommy Rutherford\tommy-rutherford-1,2016-17,UC-Irvine,F,36,1,641,88,147,.599,88,147,.599,0,0,,46,71,.648,72,117,189,15,7,32,42,85,222,5.4
2609,Elijah Macon\elijah-macon-1,2016-17,West Virginia,F,35,25,561,88,159,.553,88,159,.553,0,0,,46,72,.639,59,87,146,22,8,14,29,76,222,5.0
2610,Danrad Knowles\danrad-knowles-1,2013-14,Houston,F,31,10,595,81,174,.466,71,148,.480,10,26,.385,49,71,.690,41,93,134,16,13,37,42,70,221,5.1
2611,Derrell Taylor\derrell-taylor-1,2013-14,Jackson State,F,31,10,685,76,152,.500,76,150,.507,0,2,.000,69,95,.726,54,81,135,25,23,16,44,84,221,5.5
2612,Rayshaun Hammonds\rayshaun-hammonds-1,2017-18,Georgia,F,33,26,797,82,195,.421,66,139,.475,16,56,.286,41,59,.695,49,113,162,45,15,6,43,81,221,4.7
2613,Kyle Gaillard\kyle-gaillard-1,2013-14,William & Mary,F,32,31,819,82,176,.466,54,101,.535,28,75,.373,29,48,.604,29,88,117,49,18,8,27,74,221,5.3
2614,Zach Nelson\zach-nelson-2,2016-17,Utah Valley,F,30,30,640,90,186,.484,79,117,.675,11,69,.159,30,44,.682,29,98,127,39,16,10,48,63,221,4.9
2615,Angel Matias\angel-matias-1,2014-15,Georgia Southern,F,27,27,702,90,182,.495,86,168,.512,4,14,.286,37,54,.685,65,87,152,50,23,11,45,62,221,7.0
2616,Abdulai Bundu\abdulai-bundu-1,2015-16,Quinnipiac,F,30,20,696,82,171,.480,82,171,.480,0,0,,57,94,.606,105,93,198,10,7,13,36,60,221,6.1
2617,Nate Sherwood\nate-sherwood-1,2015-16,Idaho,F,34,18,756,87,176,.494,79,149,.530,8,27,.296,39,52,.750,52,76,128,20,8,8,34,87,221,4.3
2618,Torren Jones\torren-jones-1,2015-16,Fresno State,F,21,17,553,90,173,.520,90,173,.520,0,0,,41,62,.661,71,94,165,14,16,12,39,58,221,8.4
2619,Londell King\londell-king-1,2017-18,Morehead State,F,26,12,517,83,154,.539,71,115,.617,12,39,.308,43,62,.694,69,104,173,18,15,27,52,77,221,7.0
2620,Nigel Pruitt\nigel-pruitt-1,2013-14,Kennesaw State,F,31,11,499,64,189,.339,29,74,.392,35,115,.304,58,73,.795,24,37,61,26,21,8,43,63,221,3.6
2621,Kaven Bernard\kaven-bernard-1,2015-16,Jackson State,F,36,4,529,86,184,.467,74,147,.503,12,37,.324,36,52,.692,39,80,119,16,12,9,31,73,220,3.9
2622,Latrell Love\latrell-love-1,2015-16,Mississippi Valley State,F,35,12,554,73,191,.382,73,188,.388,0,3,.000,74,116,.638,18,53,71,12,9,9,31,36,220,3.0
2623,Kevin Johnson\kevin-johnson-6,2014-15,Cincinnati,F,34,24,742,74,195,.379,31,72,.431,43,123,.350,29,44,.659,6,40,46,45,28,4,54,68,220,3.1
2624,Austin Williams\austin-williams-2,2016-17,Drexel,F,31,26,675,98,160,.613,98,159,.616,0,1,.000,24,50,.480,70,124,194,15,11,37,45,112,220,5.8
2625,Maurice Rivers\maurice-rivers-1,2016-17,Jackson State,F,31,18,612,77,161,.478,76,152,.500,1,9,.111,65,95,.684,54,96,150,23,18,14,42,95,220,5.1
2626,Michael Finke\michael-finke-1,2016-17,Illinois,F,32,8,635,83,172,.483,46,82,.561,37,90,.411,17,31,.548,49,86,135,21,10,5,30,44,220,5.2
2627,Kevin Hervey\kevin-hervey-1,2014-15,Texas-Arlington,F,31,15,673,78,212,.368,49,100,.490,29,112,.259,35,49,.714,59,126,185,23,19,8,42,63,220,4.8
2628,Patrick Konan\patrick-konan-1,2013-14,New Hampshire,F,20,16,528,72,188,.383,48,111,.432,24,77,.312,52,82,.634,26,85,111,21,10,6,38,49,220,6.0
2629,Jito Kok\jito-kok-1,2015-16,San Diego,F,30,30,704,79,150,.527,79,150,.527,0,0,,62,93,.667,60,77,137,27,3,76,65,84,220,5.9
2630,David Howard\david-howard-1,2016-17,Evansville,F,32,25,696,87,162,.537,87,162,.537,0,0,,46,77,.597,56,109,165,14,10,18,27,92,220,5.3
2631,D.J. Foreman\dj-foreman-1,2017-18,Saint Louis,F,32,15,619,87,139,.626,87,138,.630,0,1,.000,46,91,.505,36,72,108,27,11,10,55,80,220,4.3
2632,Wesley Iwundu\wesley-iwundu-1,2013-14,Kansas State,F,33,32,780,71,154,.461,64,137,.467,7,17,.412,71,112,.634,43,96,139,61,19,12,42,71,220,5.5
2633,Sam Beeler\sam-beeler-1,2015-16,UC-Santa Barbara,F,33,33,634,101,140,.721,101,140,.721,0,0,,18,49,.367,48,105,153,20,6,24,33,99,220,5.4
2634,Lotanna Nwogbo\lotanna-nwogbo-1,2014-15,Longwood,F,17,17,512,83,137,.606,83,136,.610,0,1,.000,53,74,.716,54,85,139,6,12,15,50,59,219,9.7
2635,Dane Pineau\dane-pineau-1,2016-17,Saint Mary's (CA),F,33,0,784,93,153,.608,88,131,.672,5,22,.227,28,51,.549,71,128,199,25,30,36,36,100,219,6.8
2636,Chimezie Metu\chimezie-metu-1,2015-16,Southern California,F,34,2,628,89,171,.520,89,170,.524,0,1,.000,41,80,.513,54,69,123,18,19,54,36,85,219,5.2
2637,Trevin Harris\trevin-harris-1,2013-14,Pacific,F,29,28,652,71,142,.500,39,64,.609,32,78,.410,45,53,.849,34,72,106,55,16,4,26,64,219,6.8
2638,Uche Ofoegbu\uche-ofoegbu-1,2016-17,Nevada-Las Vegas,F,31,30,799,74,195,.379,47,111,.423,27,84,.321,44,60,.733,33,77,110,47,37,0,42,61,219,5.0
2639,Paris Maragkos\paris-maragkos-1,2015-16,American,F,31,31,463,90,180,.500,81,163,.497,9,17,.529,30,43,.698,19,51,70,28,12,5,54,67,219,3.4
2640,Chris Ortiz\chris-ortiz-1,2014-15,Kent State,F,35,22,798,71,180,.394,54,113,.478,17,67,.254,60,86,.698,43,114,157,18,19,13,41,66,219,4.2
2641,Isaac Banks\isaac-banks-1,2015-16,East Tennessee State,F,36,30,835,90,150,.600,90,150,.600,0,0,,39,79,.494,76,140,216,19,9,23,40,90,219,5.3
2642,Richard Amardi\richard-amardi-1,2013-14,Oregon,F,34,5,546,89,171,.520,88,168,.524,1,3,.333,40,72,.556,42,92,134,13,25,17,39,116,219,4.1
2643,Donnie Tillman\donnie-tillman-1,2017-18,Utah,F,28,4,569,77,161,.478,68,133,.511,9,28,.321,56,72,.778,38,95,133,17,12,8,41,47,219,5.6
2644,Eric Carter\eric-carter-1,2016-17,Delaware,F,33,24,695,79,156,.506,79,155,.510,0,1,.000,61,92,.663,61,117,178,44,11,14,56,96,219,5.0
2645,Shaq Thomas\shaquille-thomas-1,2014-15,Cincinnati,F,34,21,765,86,188,.457,80,170,.471,6,18,.333,41,70,.586,39,66,105,19,20,17,49,53,219,3.9
2646,Emanual Shepherd\emanual-shepherd-1,2017-18,Southern,F,33,30,817,90,193,.466,89,190,.468,1,3,.333,38,69,.551,63,115,178,38,22,24,43,78,219,5.4
2647,Norbert Janicek\norbert-janicek-1,2016-17,Utah State,F,32,28,659,96,164,.585,95,161,.590,1,3,.333,25,51,.490,43,77,120,22,9,4,56,72,218,4.0
2648,Norense Odiase\norense-odiase-1,2014-15,Texas Tech,F,31,30,673,82,162,.506,81,161,.503,1,1,1.000,53,110,.482,71,74,145,26,10,20,51,89,218,4.6
2649,Kerry Blackshear Jr.\kerry-blackshearjr-1,2015-16,Virginia Tech,F,35,5,671,83,150,.553,79,133,.594,4,17,.235,48,86,.558,59,97,156,20,17,15,35,97,218,4.8
2650,Godwin Okonji\godwin-okonji-1,2014-15,Loyola Marymount,F,30,27,824,75,184,.408,75,184,.408,0,0,,68,104,.654,89,78,167,32,40,8,52,86,218,5.7
2651,Chris Lewis\chris-lewis-4,2016-17,Harvard,F,28,23,527,88,135,.652,88,134,.657,0,1,.000,42,63,.667,48,88,136,26,24,35,39,68,218,7.5
2652,Oscar Da Silva\oscar-dasilva-1,2017-18,Stanford,F,35,11,844,77,149,.517,48,97,.495,29,52,.558,35,55,.636,53,110,163,40,15,30,54,96,218,5.1
2653,Wayne Martin\wayne-martin-1,2013-14,St. Francis (NY),F,31,0,525,87,180,.483,86,174,.494,1,6,.167,43,80,.538,52,101,153,12,17,42,59,70,218,4.7
2654,Cody Schwartz\cody-schwartz-1,2015-16,San Jose State,F,31,26,746,72,195,.369,20,42,.476,52,153,.340,22,30,.733,21,62,83,32,15,7,21,77,218,4.2
2655,Tommie McCune\tommie-mccune-1,2014-15,Oakland,F,33,26,601,76,153,.497,63,114,.553,13,39,.333,53,78,.679,35,100,135,36,11,7,59,73,218,4.2
2656,Keith Davis\keith-davis-1,2014-15,Southern,F,35,19,731,87,170,.512,87,170,.512,0,0,,44,81,.543,53,89,142,13,15,38,54,107,218,3.9
2657,Rashad Smith\rashad-smith-1,2015-16,Tulsa,F,30,29,634,93,177,.525,88,160,.550,5,17,.294,27,49,.551,50,75,125,35,22,19,40,64,218,5.8
2658,Amric Fields\amric-fields-1,2014-15,Texas Christian,F,29,1,537,83,175,.474,69,128,.539,14,47,.298,38,82,.463,28,75,103,22,8,20,25,49,218,5.0
2659,Arnold Fripp\arnold-fripp-1,2013-14,Coppin State,F,31,18,609,80,184,.435,60,133,.451,20,51,.392,38,57,.667,37,82,119,10,10,15,25,60,218,4.6
2660,Fatodd Lewis\fatodd-lewis-1,2016-17,Tennessee-Martin,F,33,5,640,79,175,.451,58,118,.492,21,57,.368,39,76,.513,42,99,141,29,19,11,37,54,218,4.8
2661,Derrick Dandridge\derrick-dandridge-1,2016-17,Florida A&M,F,30,21,626,79,187,.422,76,173,.439,3,14,.214,57,95,.600,41,96,137,20,12,6,41,78,218,4.0
2662,Matt Hubbard\matt-hubbard-1,2014-15,Santa Clara,F,32,24,729,80,195,.410,52,106,.491,28,89,.315,30,42,.714,41,86,127,18,7,10,40,65,218,3.9
2663,Jonathan Laurent\jonathan-laurent-1,2015-16,Rutgers,F,27,12,655,79,170,.465,73,145,.503,6,25,.240,54,74,.730,32,106,138,23,13,5,43,61,218,5.3
2664,Walter Pitchford\walter-pitchford-1,2014-15,Nebraska,F,30,26,812,82,217,.378,45,89,.506,37,128,.289,16,33,.485,29,108,137,14,10,14,33,72,217,3.7
2665,Brandon Conley\brandon-conley-1,2015-16,Oral Roberts,F,30,23,591,91,162,.562,91,162,.562,0,0,,35,57,.614,65,97,162,34,10,18,61,106,217,5.0
2666,Filip Cvjeticanin\filip-cvjeticanin-1,2013-14,Florida Gulf Coast,F,32,6,716,71,170,.418,16,33,.485,55,137,.401,20,27,.741,21,64,85,14,10,4,35,40,217,4.0
2667,Steffon Mitchell\steffon-mitchell-1,2017-18,Boston College,F,34,27,1128,73,175,.417,51,95,.537,22,80,.275,49,94,.521,100,181,281,72,38,35,37,63,217,8.3
2668,Tomas Murphy\tomas-murphy-1,2017-18,Northeastern,F,33,0,533,88,155,.568,84,139,.604,4,16,.250,37,49,.755,39,40,79,26,4,3,31,72,217,4.3
2669,Zach Charles\zach-charles-1,2016-17,Eastern Kentucky,F,31,28,765,69,133,.519,68,122,.557,1,11,.091,78,109,.716,67,136,203,14,19,41,25,91,217,7.2
2670,Elijah Minnie\elijah-minnie-1,2014-15,Robert Morris,F,32,21,699,82,150,.547,59,98,.602,23,52,.442,29,38,.763,47,109,156,13,32,36,40,67,216,6.4
2671,Jakub Niziol\jakub-niziol-1,2017-18,Cal Poly,F,30,6,548,66,182,.363,17,40,.425,49,142,.345,35,43,.814,11,57,68,23,14,11,16,39,216,4.8
2672,Tate Stensgaard\tate-stensgaard-1,2015-16,Western Illinois,F,25,25,596,84,139,.604,84,139,.604,0,0,,48,70,.686,45,90,135,20,8,14,32,86,216,6.7
2673,Antwan Space\antwan-space-1,2013-14,Texas A&M,F,34,22,791,79,194,.407,66,143,.462,13,51,.255,45,80,.563,44,115,159,28,16,17,44,77,216,4.0
2674,Tyler Stone\tyler-stone-2,2015-16,Howard,F,30,27,781,71,186,.382,65,155,.419,6,31,.194,68,97,.701,54,117,171,13,16,20,46,90,216,4.4
2675,Timajh Parker-Rivera\timajh-parker-rivera-1,2015-16,Towson,F,33,33,834,79,137,.577,79,136,.581,0,1,.000,58,115,.504,95,120,215,40,31,39,45,89,216,7.2
2676,Taran Brown\taran-brown-1,2013-14,UC-Santa Barbara,F,30,24,790,76,182,.418,38,61,.623,38,121,.314,26,33,.788,33,99,132,44,15,25,23,64,216,6.1
2677,Donovan Smith\donovan-smith-1,2015-16,Quinnipiac,F,30,10,567,90,222,.405,90,221,.407,0,1,.000,36,48,.750,58,116,174,17,11,53,46,74,216,5.1
2678,Ben Bentil\ben-bentil-1,2014-15,Providence,F,34,23,730,75,172,.436,66,142,.465,9,30,.300,57,82,.695,79,87,166,21,9,12,40,89,216,4.5
2679,Anthony Perez\anthony-perez-1,2015-16,Mississippi,F,31,21,721,70,165,.424,40,89,.449,30,76,.395,46,67,.687,46,80,126,31,19,8,36,88,216,4.9
2680,Wesley Gordon\wesley-gordon-1,2016-17,Colorado,F,32,31,786,79,154,.513,77,148,.520,2,6,.333,56,84,.667,73,130,203,62,15,48,42,86,216,7.3
2681,Jacoby Armstrong\jacoby-armstrong-1,2013-14,New Hampshire,F,28,21,682,72,191,.377,68,167,.407,4,24,.167,68,100,.680,41,98,139,20,6,3,52,113,216,2.9
2682,Brian Voelkel\brian-voelkel-1,2013-14,Vermont,F,33,31,1007,59,127,.465,53,108,.491,6,19,.316,92,142,.648,64,202,266,190,51,7,82,59,216,9.7
2683,Maik Kotsar\maik-kotsar-1,2016-17,South Carolina,F,37,33,886,97,198,.490,97,198,.490,0,0,,21,53,.396,72,104,176,26,27,14,44,117,215,4.0
2684,Tyler Rawson\tyler-rawson-1,2014-15,Southern Utah,F,29,2,497,78,162,.481,67,128,.523,11,34,.324,48,71,.676,28,90,118,23,13,35,38,68,215,5.5
2685,Obediah Church\obediah-church-1,2017-18,Missouri State,F,32,31,762,89,135,.659,89,134,.664,0,1,.000,37,66,.561,75,104,179,40,17,60,45,72,215,7.5
2686,Josh Ayeni\josh-ayeni-1,2016-17,St. Bonaventure,F,32,23,547,76,159,.478,76,159,.478,0,0,,63,79,.797,35,47,82,6,21,6,25,112,215,3.9
2687,Geoff Beans\geoff-beans-1,2016-17,Furman,F,34,20,611,68,169,.402,14,31,.452,54,138,.391,25,29,.862,22,62,84,17,17,9,14,88,215,4.2
2688,D.J. Mason\dj-mason-1,2013-14,Campbell,F,20,1,407,82,162,.506,66,123,.537,16,39,.410,35,54,.648,39,63,102,23,10,22,41,55,215,7.6
2689,Cedrick Lang\cedrick-lang-1,2013-14,Texas-El Paso,F,33,10,762,74,145,.510,74,145,.510,0,0,,67,114,.588,65,114,179,26,12,8,38,93,215,5.0
2690,Ajdin Penava\ajdin-penava-1,2016-17,Marshall,F,35,14,542,78,151,.517,69,111,.622,9,40,.225,50,64,.781,39,99,138,18,15,38,34,126,215,4.6
2691,Will Weeks\will-weeks-1,2016-17,North Carolina-Asheville,F,33,22,857,79,148,.534,79,148,.534,0,0,,57,101,.564,70,88,158,75,29,6,51,78,215,6.2
2692,Luuk van Bree\luke-vanbree-1,2016-17,Bradley,F,33,10,661,77,193,.399,37,75,.493,40,118,.339,21,33,.636,15,95,110,29,26,14,44,98,215,3.6
2693,Michael Young\michael-young-3,2013-14,Pittsburgh,F,36,36,779,69,167,.413,59,139,.424,10,28,.357,67,82,.817,56,91,147,32,15,16,32,63,215,4.9
2694,Gregory Graves\gregory-graves-1,2013-14,Mount St. Mary's,F,33,3,717,72,153,.471,65,130,.500,7,23,.304,64,95,.674,66,113,179,11,17,21,27,67,215,5.8
2695,Anton Waters\anton-waters-1,2016-17,Western Kentucky,F,32,14,573,88,167,.527,85,155,.548,3,12,.250,35,59,.593,57,76,133,10,10,8,36,67,214,4.5
2696,Brandon Alston\brandon-alston-2,2016-17,Lehigh,F,32,10,660,78,171,.456,59,117,.504,19,54,.352,39,54,.722,15,54,69,37,13,3,40,67,214,3.8
2697,Marek Dolezaj\marek-dolezaj-1,2017-18,Syracuse,F,37,17,1033,79,147,.537,77,138,.558,2,9,.222,54,76,.711,72,107,179,57,30,28,51,102,214,5.8
2698,Tyler Creammer\tyler-creammer-1,2017-18,Virginia Military Institute,F,30,27,591,86,190,.453,86,189,.455,0,1,.000,42,59,.712,59,103,162,19,13,16,41,69,214,5.0
2699,Jalen Carethers\jalen-carethers-1,2013-14,Radford,F,35,2,555,84,163,.515,84,162,.519,0,1,.000,46,64,.719,39,71,110,14,16,46,19,86,214,5.1
2700,Doug Taylor\doug-taylor-1,2017-18,Ohio,F,31,31,745,94,166,.566,93,163,.571,1,3,.333,25,47,.532,73,149,222,21,17,61,43,88,214,7.1
2701,Johnathon Wilkins\jonathan-wilkins-1,2017-18,New Mexico State,F,34,33,602,93,171,.544,78,132,.591,15,39,.385,13,25,.520,46,52,98,45,5,20,31,79,214,4.8
2702,Michael Carrera\michael-carrera-1,2014-15,South Carolina,F,30,21,635,70,167,.419,58,128,.453,12,39,.308,62,88,.705,65,107,172,12,12,20,32,88,214,5.3
2703,Sai Tummala\sai-tummala-1,2015-16,Hawaii,F,34,2,585,76,174,.437,33,65,.508,43,109,.394,19,30,.633,35,65,100,26,10,8,29,89,214,3.9
2704,Jacob Lancaster\jacob-lancaster-1,2013-14,Abilene Christian,F,31,11,434,88,159,.553,87,158,.551,1,1,1.000,37,58,.638,45,99,144,7,7,37,41,49,214,5.4
2705,Marc Eddy Norelia\marc-eddy-norelia-1,2016-17,Florida Gulf Coast,F,24,10,515,86,158,.544,85,154,.552,1,4,.250,41,65,.631,35,82,117,28,12,14,26,38,214,7.4
2706,Jeantal Cylla\jeantal-cylla-1,2016-17,Florida Atlantic,F,30,30,660,75,196,.383,52,109,.477,23,87,.264,41,56,.732,28,70,98,13,13,10,29,58,214,3.9
2707,Brett Wishon\brett-wishon-1,2015-16,Lipscomb,F,33,3,566,70,180,.389,26,50,.520,44,130,.338,30,37,.811,19,79,98,45,5,11,41,45,214,4.1
2708,Esa Ahmad\esa-ahmad-1,2017-18,West Virginia,F,21,16,569,75,165,.455,64,129,.496,11,36,.306,53,76,.697,38,77,115,41,20,8,35,42,214,8.2
2709,Ladon Carter\ladon-carter-1,2013-14,Tennessee Tech,F,31,3,549,92,143,.643,92,143,.643,0,0,,30,64,.469,60,80,140,21,38,38,35,36,214,7.5
2710,Steve McClellan\steven-mcclellan-1,2014-15,Cal State Fullerton,F,31,28,786,90,162,.556,90,162,.556,0,0,,34,52,.654,82,169,251,20,11,10,42,89,214,6.2
2711,Casey Oliverson\casey-oliverson-1,2014-15,Southern Utah,F,29,27,618,98,160,.613,98,159,.616,0,1,.000,18,42,.429,42,78,120,11,11,9,32,65,214,5.2
2712,Anthony Vanhook\anthony-vanhook-1,2015-16,Charlotte,F,29,6,707,89,186,.478,87,181,.481,2,5,.400,34,50,.680,48,74,122,80,26,10,39,77,214,6.5
2713,Brian White\brian-white-1,2014-15,Citadel,F,30,18,641,73,123,.593,73,123,.593,0,0,,68,80,.850,37,91,128,9,10,6,25,59,214,5.9
2714,Carson Desrosiers\carson-desrosiers-1,2014-15,Providence,F,32,31,804,75,167,.449,69,152,.454,6,15,.400,58,80,.725,49,91,140,27,11,79,29,94,214,6.2
2715,Gavin Skelly\gavin-skelly-1,2016-17,Northwestern,F,36,0,637,72,155,.465,54,95,.568,18,60,.300,52,69,.754,51,81,132,46,12,44,47,100,214,4.9
2716,Arthur Capers\arther-capers-1,2013-14,Alabama A&M,F,30,13,568,81,186,.435,55,110,.500,26,76,.342,25,37,.676,22,60,82,30,23,9,40,63,213,4.3
2717,Bernard Morena\benard-morena-1,2015-16,Kennesaw State,F,31,23,666,83,177,.469,82,170,.482,1,7,.143,46,71,.648,38,90,128,50,20,27,54,98,213,4.7
2718,Justin Satchell\justin-satchell-1,2015-16,Niagara,F,32,14,613,87,207,.420,65,130,.500,22,77,.286,17,26,.654,37,88,125,20,17,7,41,53,213,3.9
2719,Leo Goodman\leo-goodman-1,2016-17,Stetson,F,32,0,552,73,204,.358,34,64,.531,39,140,.279,28,36,.778,20,64,84,13,7,6,26,53,213,3.2
2720,L.G. Gill\lg-gill-1,2014-15,Duquesne,F,31,8,620,80,202,.396,44,93,.473,36,109,.330,17,29,.586,41,87,128,29,14,18,28,75,213,4.6
2721,Jordan Garnett\jordan-garnett-1,2017-18,Northern Kentucky,F,32,32,932,75,159,.472,36,63,.571,39,96,.406,24,35,.686,29,72,101,64,28,13,34,79,213,5.8
2722,Malachi Alexander\malachi-alexander-1,2013-14,Holy Cross,F,34,0,733,67,172,.390,61,143,.427,6,29,.207,73,110,.664,44,98,142,33,16,20,66,76,213,3.6
2723,Brandon Peel\brandon-peel-1,2013-14,Central Connecticut State,F,30,24,691,89,163,.546,89,162,.549,0,1,.000,35,49,.714,56,133,189,21,22,61,26,66,213,7.8
2724,Mladen Armus\mladen-armus-1,2017-18,East Tennessee State,F,34,6,617,84,134,.627,84,133,.632,0,1,.000,45,73,.616,86,101,187,17,19,15,46,68,213,5.9
2725,Russell Woods\russell-woods-1,2016-17,Missouri,F,32,32,710,73,151,.483,73,151,.483,0,0,,67,114,.588,71,67,138,12,11,5,34,107,213,4.2
2726,Nnanna Egwu\nnanna-egwu-1,2014-15,Illinois,F,33,33,982,85,197,.431,75,164,.457,10,33,.303,33,42,.786,84,112,196,33,26,59,36,99,213,6.4
2727,Alex Hart\alex-hart-1,2016-17,UC-Santa Barbara,F,28,21,646,82,180,.456,82,167,.491,0,13,.000,49,82,.598,71,103,174,14,9,18,32,76,213,5.6
2728,Ognjen Miljkovic\ognjen-miljkovic-1,2013-14,Eastern Washington,F,25,7,465,75,178,.421,49,105,.467,26,73,.356,36,48,.750,23,60,83,14,11,5,37,64,212,4.3
2729,Khadeem Lattin\khadeem-lattin-1,2017-18,Oklahoma,F,32,27,642,83,140,.593,83,139,.597,0,1,.000,46,61,.754,59,129,188,16,36,61,22,85,212,8.0
2730,Alec Wnuk\alec-wnuk-1,2016-17,North Carolina-Asheville,F,29,0,563,78,148,.527,75,138,.543,3,10,.300,53,87,.609,36,76,112,36,16,4,50,61,212,5.0
2731,Zach Haney\zach-haney-1,2017-18,Boise State,F,32,32,720,92,179,.514,88,157,.561,4,22,.182,24,49,.490,75,101,176,22,14,21,38,92,212,5.2
2732,Trevond Barnes\trevond-barnes-1,2016-17,Hampton,F,31,29,616,74,136,.544,60,107,.561,14,29,.483,50,72,.694,44,81,125,10,3,48,25,89,212,5.7
2733,Sean Sellers\sean-sellers-1,2015-16,Ball State,F,33,2,605,69,158,.437,31,60,.517,38,98,.388,36,49,.735,26,73,99,37,13,7,27,42,212,5.0
2734,Brett Wishon\brett-wishon-1,2014-15,Lipscomb,F,29,16,698,70,195,.359,17,43,.395,53,152,.349,19,25,.760,24,81,105,62,12,9,43,54,212,4.8
2735,Devin Robinson\devin-robinson-1,2014-15,Florida,F,33,18,628,78,194,.402,57,112,.509,21,82,.256,35,55,.636,27,65,92,23,17,13,31,57,212,3.8
2736,Mark Gray\mark-gray-1,2015-16,Grambling,F,31,20,830,65,162,.401,46,97,.474,19,65,.292,63,89,.708,32,107,139,16,15,5,52,69,212,3.8
2737,Torry Butler\torry-butler-1,2015-16,Sam Houston State,F,34,17,679,83,180,.461,74,145,.510,9,35,.257,37,65,.569,58,142,200,47,28,10,35,96,212,5.5
2738,Brandon Swannegan\brandon-swannegan-1,2015-16,Tulsa,F,32,12,640,79,136,.581,79,136,.581,0,0,,54,89,.607,55,70,125,8,14,30,24,78,212,5.6
2739,Terrance Syon\terrance-syon-1,2014-15,New Orleans,F,28,16,656,82,157,.522,82,157,.522,0,0,,48,85,.565,66,93,159,14,16,12,54,94,212,4.9
2740,Aleksandar Dozic\aleksandar-dozic-1,2017-18,Marist,F,29,17,670,77,194,.397,41,79,.519,36,115,.313,22,32,.688,21,103,124,52,8,6,50,62,212,4.2
2741,Kyle Steward\kyle-steward-1,2015-16,Missouri-Kansas City,F,31,8,650,72,168,.429,39,95,.411,33,73,.452,35,44,.795,37,83,120,18,18,13,30,58,212,5.1
2742,Geoff Beans\geoff-beans-1,2014-15,Furman,F,27,18,577,60,168,.357,14,32,.438,46,136,.338,45,53,.849,8,51,59,11,10,6,13,67,211,4.3
2743,Oliver Black\oliver-black-1,2017-18,Little Rock,F,32,29,886,82,164,.500,82,163,.503,0,1,.000,47,88,.534,76,142,218,36,10,22,49,91,211,5.4
2744,Raheem Watts\raheem-watts-1,2016-17,Southern Mississippi,F,31,30,671,74,173,.428,65,133,.489,9,40,.225,54,73,.740,23,96,119,16,11,7,67,89,211,2.6
2745,Raheem Watts\raheem-watts-1,2015-16,Southern Mississippi,F,28,23,620,74,161,.460,56,105,.533,18,56,.321,45,60,.750,23,65,88,15,15,2,38,90,211,3.9
2746,Bam Bowman\bam-bowman-1,2017-18,Miami (OH),F,34,7,516,76,170,.447,57,104,.548,19,66,.288,40,52,.769,39,79,118,11,11,10,30,67,211,4.0
2747,Jordan Bruner\jordan-bruner-1,2016-17,Yale,F,25,0,559,78,151,.517,66,111,.595,12,40,.300,43,66,.652,42,97,139,31,9,51,38,48,211,7.8
2748,Shane Temara\shane-temara-1,2016-17,North Texas,F,30,13,594,82,190,.432,59,111,.532,23,79,.291,24,43,.558,46,93,139,6,6,27,25,45,211,5.0
2749,Orlando Coleman\orlando-coleman-1,2015-16,Texas Southern,F,33,29,819,75,199,.377,37,75,.493,38,124,.306,23,32,.719,38,95,133,24,16,13,29,47,211,4.5
2750,Donovon Jack\donovon-jack-1,2013-14,Penn State,F,34,27,672,81,180,.450,62,117,.530,19,63,.302,30,51,.588,47,81,128,27,14,53,16,113,211,5.1
2751,Stephen Hurt\stephen-hurt-1,2015-16,Kansas State,F,33,24,632,74,182,.407,58,129,.450,16,53,.302,47,63,.746,32,114,146,22,16,12,50,81,211,3.7
2752,Diago Quinn\diago-quinn-1,2017-18,Monmouth,F,31,27,552,77,151,.510,77,151,.510,0,0,,57,90,.633,48,84,132,5,6,19,35,93,211,4.3
2753,Dominique Lee\dominique-lee-1,2013-14,Northern Colorado,F,31,0,496,83,128,.648,79,119,.664,4,9,.444,41,74,.554,52,66,118,11,22,15,26,65,211,6.0
2754,Brian Williams\brian-williams-9,2013-14,Oklahoma State,F,34,26,793,79,162,.488,76,150,.507,3,12,.250,50,69,.725,31,84,115,25,36,11,26,51,211,5.4
2755,Deng Geu\deng-geu-1,2017-18,North Dakota State,F,32,0,467,86,138,.623,82,124,.661,4,14,.286,35,57,.614,33,72,105,15,7,17,32,62,211,4.9
2756,Chadrack Lufile\chadrack-lufile-1,2013-14,Wichita State,F,36,11,600,80,145,.552,80,145,.552,0,0,,51,86,.593,65,115,180,8,10,29,41,51,211,5.1
2757,Matisse Thybulle\matisse-thybulle-1,2015-16,Washington,F,34,34,819,71,179,.397,37,86,.430,34,93,.366,35,49,.714,38,71,109,55,39,32,47,111,211,4.9
2758,AJ Sumbry\aj-sumbry-1,2017-18,Wagner,F,33,32,639,72,157,.459,72,157,.459,0,0,,66,119,.555,90,124,214,15,12,58,48,112,210,5.4
2759,Reggie Upshaw\reggie-upshaw-1,2013-14,Middle Tennessee,F,33,20,676,83,181,.459,71,139,.511,12,42,.286,32,62,.516,38,78,116,39,25,15,29,73,210,4.8
2760,Dan Jech\dan-jech-1,2015-16,South Dakota,F,31,0,400,81,156,.519,69,118,.585,12,38,.316,36,58,.621,20,56,76,6,3,12,33,64,210,3.6
2761,Jake Kretzer\jake-kretzer-1,2013-14,Akron,F,28,7,683,67,175,.383,17,33,.515,50,142,.352,26,37,.703,26,55,81,31,18,4,24,45,210,5.2
2762,Jordan Bell\jordan-bell-1,2015-16,Oregon,F,31,4,636,91,158,.576,91,156,.583,0,2,.000,28,54,.519,46,117,163,38,34,52,50,78,210,6.7
2763,Nick Jacobs\nick-jacobs-1,2013-14,Alabama,F,25,10,501,93,179,.520,93,178,.522,0,1,.000,24,42,.571,30,57,87,7,4,15,26,48,210,5.1
2764,Brice Kofane\brice-kofane-1,2014-15,Monmouth,F,33,33,820,82,173,.474,82,173,.474,0,0,,46,75,.613,73,120,193,15,14,55,77,109,210,4.2
2765,Milik Yarbrough\milik-yarbrough-1,2015-16,Saint Louis,F,27,2,517,74,187,.396,59,145,.407,15,42,.357,46,77,.597,21,104,125,38,11,7,48,45,209,4.4
2766,Samuel Idowu\samuel-idowu-1,2016-17,Saint Peter's,F,36,0,421,82,156,.526,51,78,.654,31,78,.397,14,32,.438,34,63,97,8,11,21,22,70,209,4.2
2767,Mustafa Jones\mustafa-jones-1,2015-16,Central Connecticut State,F,28,17,580,90,191,.471,90,190,.474,0,1,.000,29,37,.784,34,71,105,28,17,22,32,58,209,5.4
2768,Terrence Thompson\terrence-thompson-1,2016-17,Marshall,F,23,22,513,70,136,.515,63,112,.563,7,24,.292,62,99,.626,49,101,150,13,18,8,23,50,209,7.9
2769,Trey Chapman\trey-chapman-1,2015-16,Virginia Military Institute,F,26,26,671,83,200,.415,66,149,.443,17,51,.333,26,46,.565,40,82,122,26,12,16,43,80,209,4.4
2770,Maxime Boursiquot\maxime-boursiquot-1,2017-18,Northeastern,F,33,32,648,87,168,.518,74,128,.578,13,40,.325,22,32,.688,35,91,126,42,25,7,47,85,209,4.6
2771,Ramone Snowden\ramone-snowden-1,2016-17,James Madison,F,33,27,905,64,134,.478,46,86,.535,18,48,.375,63,99,.636,54,101,155,60,26,12,54,81,209,5.6
2772,Cedric Blossom\cedric-blossom-1,2013-14,Morgan State,F,31,30,739,79,165,.479,78,158,.494,1,7,.143,50,79,.633,80,85,165,25,13,7,32,79,209,5.4
2773,Charles Mitchell\charles-mitchell-1,2013-14,Maryland,F,32,10,601,93,180,.517,93,180,.517,0,0,,23,70,.329,82,121,203,9,13,16,41,86,209,4.7
2774,Thomas Bruce\thomas-bruce-1,2016-17,Binghamton,F,30,23,780,76,170,.447,76,168,.452,0,2,.000,57,91,.626,42,108,150,35,14,30,44,80,209,5.1
2775,Logan Primerano\logan-primerano-1,2016-17,Massachusetts-Lowell,F,31,0,686,73,163,.448,57,120,.475,16,43,.372,47,58,.810,19,80,99,58,20,7,55,55,209,4.7
2776,T.J. Maston\tj-maston-1,2015-16,Baylor,F,34,0,412,78,137,.569,78,137,.569,0,0,,52,63,.825,30,54,84,14,16,12,32,54,208,4.6
2777,Brett Bailey\brett-bailey-1,2015-16,San Diego,F,30,26,723,80,214,.374,67,142,.472,13,72,.181,35,56,.625,48,95,143,38,15,11,35,63,208,4.4
2778,Leek Leek\leek-leek-1,2013-14,Campbell,F,32,32,831,66,163,.405,24,65,.369,42,98,.429,34,44,.773,22,72,94,40,13,41,29,70,208,5.2
2779,Christian Mekowulu\christian-mekowulu-1,2014-15,Tennessee State,F,26,21,631,64,160,.400,64,160,.400,0,0,,80,135,.593,39,99,138,10,16,18,52,90,208,4.0
2780,Andrew Eudy\andrew-eudy-1,2016-17,Campbell,F,37,37,927,88,166,.530,79,139,.568,9,27,.333,23,36,.639,60,134,194,60,22,70,39,116,208,6.3
2781,Saadiq Muhammad\saadiq-muhammad-1,2014-15,Savannah State,F,31,17,651,83,177,.469,83,176,.472,0,1,.000,42,82,.512,42,81,123,13,19,18,50,87,208,3.6
2782,Eric Katenda\eric-katenda-1,2015-16,North Texas,F,31,18,525,78,140,.557,77,139,.554,1,1,1.000,51,73,.699,45,66,111,7,15,22,37,92,208,4.7
2783,Najee Garvin\najee-garvin-1,2017-18,Charlotte,F,29,13,658,79,171,.462,79,167,.473,0,4,.000,50,77,.649,28,117,145,21,15,7,47,63,208,4.4
2784,Devin Haygood\devin-haygood-1,2016-17,Youngstown State,F,34,6,588,88,150,.587,88,150,.587,0,0,,32,80,.400,55,70,125,25,15,35,43,109,208,4.4
2785,Jordan Butler\jordan-butler-1,2016-17,Norfolk State,F,29,25,792,71,148,.480,71,148,.480,0,0,,66,109,.606,58,134,192,26,13,54,47,94,208,6.2
2786,Bobby Capobianco\bobby-capobianco-1,2013-14,Valparaiso,F,33,6,583,66,134,.493,44,79,.557,22,55,.400,53,74,.716,32,92,124,37,13,10,45,68,207,4.7
2787,Ed Drew\ed-drew-1,2015-16,Presbyterian,F,31,17,605,72,157,.459,70,147,.476,2,10,.200,61,73,.836,59,86,145,12,11,4,29,70,207,4.9
2788,Thomas Jacobs\thomas-jacobs-1,2014-15,San Diego,F,31,21,668,79,154,.513,77,139,.554,2,15,.133,47,63,.746,61,99,160,11,25,6,33,65,207,5.6
2789,Brock Gardner\brock-gardner-1,2016-17,Liberty,F,35,9,630,76,148,.514,55,89,.618,21,59,.356,34,52,.654,16,91,107,26,12,15,34,71,207,4.1
2790,Darryl Palmer\darryl-palmer-1,2013-14,South Carolina State,F,30,25,834,85,216,.394,78,179,.436,7,37,.189,30,48,.625,63,145,208,37,24,44,53,91,207,5.4
2791,Dontavious Sears\dontavious-sears-1,2014-15,Lamar,F,29,0,409,77,168,.458,44,71,.620,33,97,.340,20,30,.667,28,62,90,10,18,4,17,34,207,5.2
2792,James Dickey\james-dickey-1,2016-17,North Carolina-Greensboro,F,33,10,729,85,147,.578,85,146,.582,0,1,.000,37,69,.536,87,149,236,34,14,43,47,74,207,6.7
2793,Brian Bennett\brian-bennett-1,2013-14,Cal Poly,F,34,15,628,89,191,.466,89,189,.471,0,2,.000,29,41,.707,34,72,106,20,11,5,28,72,207,3.6
2794,Tevin Baskin\tevin-baskin-1,2013-14,Appalachian State,F,25,16,522,70,181,.387,64,159,.403,6,22,.273,61,87,.701,26,69,95,15,17,14,43,69,207,4.1
2795,Eddie Davis\eddie-davis-1,2016-17,Southern Mississippi,F,30,12,562,76,194,.392,62,133,.466,14,61,.230,41,56,.732,58,82,140,19,7,14,45,79,207,3.8
2796,Devonte Campbell\devonte-campbell-1,2017-18,Albany (NY),F,31,31,959,67,164,.409,60,114,.526,7,50,.140,66,85,.776,44,70,114,53,16,18,37,57,207,5.5
2797,Brandan Kearney\brandan-kearney-1,2014-15,Detroit Mercy,F,33,13,685,74,169,.438,48,97,.495,26,72,.361,33,46,.717,16,57,73,57,25,4,47,68,207,4.1
2798,James Demery\james-demery-1,2014-15,Saint Joseph's,F,31,29,752,78,213,.366,71,173,.410,7,40,.175,44,78,.564,53,57,110,32,23,13,44,56,207,3.8
2799,Tristin Walley\tristin-walley-1,2017-18,Arkansas State,F,30,26,656,70,173,.405,41,91,.451,29,82,.354,38,55,.691,47,84,131,16,26,20,43,59,207,5.0
2800,Cullen Russo\cullen-russo-1,2016-17,Fresno State,F,26,18,660,72,179,.402,62,129,.481,10,50,.200,53,95,.558,25,118,143,63,43,17,47,81,207,6.4
2801,Milija Cosic\milija-cosic-1,2017-18,St. Francis (NY),F,29,2,546,78,165,.473,65,131,.496,13,34,.382,38,51,.745,44,42,86,10,10,6,44,79,207,3.7
2802,Zach Coleman\zach-coleman-1,2017-18,Long Island University,F,32,14,726,76,185,.411,52,100,.520,24,85,.282,31,55,.564,67,137,204,29,19,32,54,89,207,5.0
2803,Brian Pearson\brian-pearson-1,2014-15,Savannah State,F,31,15,676,91,142,.641,91,142,.641,0,0,,25,63,.397,51,97,148,12,19,12,42,83,207,5.0
2804,Terrence Smith\terrence-smith-1,2015-16,NJIT,F,28,25,585,94,163,.577,94,163,.577,0,0,,19,39,.487,48,69,117,23,12,7,31,70,207,5.4
2805,Landen Lucas\landen-lucas-1,2015-16,Kansas,F,36,19,664,74,115,.643,74,114,.649,0,1,.000,59,89,.663,82,161,243,21,16,27,38,92,207,6.2
2806,Eddie Denard\eddie-denard-1,2013-14,Chicago State,F,32,32,693,80,189,.423,80,185,.432,0,4,.000,46,101,.455,43,71,114,19,22,9,49,114,206,2.6
2807,Aaron Rountree\aaron-roundtree-1,2015-16,Iona,F,33,10,875,82,168,.488,82,162,.506,0,6,.000,42,65,.646,42,128,170,87,45,58,51,92,206,7.2
2808,Chris Perry\chris-perry-1,2014-15,South Florida,F,19,18,496,85,173,.491,85,171,.497,0,2,.000,36,61,.590,37,98,135,12,15,24,41,56,206,7.4
2809,Aaron Tate\aaron-tate-1,2016-17,Robert Morris,F,33,32,897,82,147,.558,82,147,.558,0,0,,42,66,.636,91,126,217,16,21,12,40,60,206,6.2
2810,Khadeem Lattin\khadeem-lattin-1,2015-16,Oklahoma,F,37,37,815,88,158,.557,88,157,.561,0,1,.000,30,55,.545,76,120,196,23,32,77,30,112,206,6.4
2811,Nino Williams\nino-williams-1,2013-14,Kansas State,F,33,10,537,77,153,.503,77,153,.503,0,0,,52,72,.722,62,52,114,21,15,4,29,92,206,4.5
2812,Pierfrancesco Oliva\pierfrancesco-oliva-1,2017-18,Saint Joseph's,F,31,22,851,72,146,.493,53,88,.602,19,58,.328,43,86,.500,35,177,212,93,26,21,63,85,206,6.5
2813,Joell Hopkins\joell-hopkins-1,2014-15,Southern,F,32,9,599,75,141,.532,75,138,.543,0,3,.000,56,90,.622,42,59,101,9,19,15,36,65,206,4.5
2814,Ian Theisen\ian-theisen-1,2015-16,South Dakota State,F,34,34,588,71,135,.526,57,103,.553,14,32,.438,50,63,.794,39,78,117,18,6,21,35,99,206,4.2
2815,Alonzo Nelson-Ododa\alonzo-nelson-ododa-1,2013-14,Richmond,F,33,28,885,73,173,.422,60,129,.465,13,44,.295,47,86,.547,49,128,177,26,26,78,46,89,206,5.7
2816,Danny Herrera\danny-herrera-1,2013-14,Presbyterian,F,26,19,657,76,171,.444,57,113,.504,19,58,.328,35,50,.700,26,60,86,16,14,2,25,73,206,4.6
2817,JaShaun Smith\jashaun-smith-1,2017-18,Longwood,F,33,13,797,72,175,.411,44,97,.454,28,78,.359,33,56,.589,23,39,62,11,22,20,38,49,205,3.5
2818,Trey Moses\trey-moses-1,2015-16,Ball State,F,35,9,671,73,149,.490,70,141,.496,3,8,.375,56,105,.533,52,97,149,61,10,35,49,95,205,4.7
2819,Olaf Schaftenaar\olaf-schaftenaar-1,2015-16,Oregon State,F,32,32,759,65,166,.392,23,54,.426,42,112,.375,33,42,.786,22,71,93,51,13,5,26,79,205,4.5
2820,Seth Gearhart\seth-gearhart-1,2013-14,Rice,F,30,28,847,64,181,.354,25,60,.417,39,121,.322,38,55,.691,16,87,103,41,22,17,42,89,205,4.0
2821,Malik Martin\malik-price-martin-1,2017-18,South Florida,F,32,8,744,85,146,.582,76,127,.598,9,19,.474,26,46,.565,47,104,151,17,17,30,44,51,205,5.6
2822,Kevin Hill\kevin-hill-1,2013-14,New Orleans,F,26,18,543,78,154,.506,78,154,.506,0,0,,49,67,.731,77,102,179,16,15,25,50,65,205,6.7
2823,Dontavious Sears\dontavious-sears-1,2015-16,Lamar,F,29,6,418,77,175,.440,55,91,.604,22,84,.262,29,45,.644,40,94,134,18,19,15,23,38,205,5.8
2824,Maurice Jeffers\maurice-jeffers-2,2014-15,Delaware,F,30,29,706,85,149,.570,85,149,.570,0,0,,35,59,.593,63,82,145,28,10,28,49,70,205,5.5
2825,Darnell Dunn\darnell-dunn-1,2017-18,Pepperdine,F,32,6,522,67,156,.429,65,140,.464,2,16,.125,68,86,.791,37,45,82,20,9,8,37,39,204,4.1
2826,JaShaun Smith\jashaun-smith-1,2016-17,Longwood,F,29,21,786,81,175,.463,66,143,.462,15,32,.469,27,48,.563,33,74,107,23,17,31,32,54,204,5.2
2827,Lucas Siewert\lucas-siewert-1,2017-18,Colorado,F,30,1,551,66,136,.485,36,69,.522,30,67,.448,42,51,.824,28,62,90,22,8,13,27,64,204,5.0
2828,Landon Atterberry\landon-atterberry-1,2014-15,Long Island University,F,27,16,540,78,192,.406,59,136,.434,19,56,.339,29,42,.690,42,77,119,11,11,13,25,56,204,4.8
2829,Devin Haygood\devin-haygood-1,2017-18,Youngstown State,F,31,23,609,90,166,.542,90,165,.545,0,1,.000,24,46,.522,60,79,139,19,11,37,51,110,204,4.4
2830,Trey Chapman\trey-chapman-1,2014-15,Virginia Military Institute,F,30,16,634,72,170,.424,55,109,.505,17,61,.279,43,64,.672,40,68,108,33,28,14,65,76,204,4.0
2831,Jeremiah Hill\jeremiah-hill-1,2013-14,Savannah State,F,32,15,583,68,205,.332,27,72,.375,41,133,.308,27,35,.771,15,32,47,31,19,3,34,39,204,3.1
2832,Nura Zanna\nura-zanna-1,2015-16,Long Island University,F,31,30,672,77,147,.524,77,147,.524,0,0,,50,100,.500,75,105,180,10,19,9,55,107,204,4.2
2833,Lamont West\lamont-west-1,2016-17,West Virginia,F,37,1,441,66,165,.400,31,63,.492,35,102,.343,37,49,.755,25,43,68,16,10,8,13,58,204,3.5
2834,Lamar Wofford-Humphrey\lamar-wofford-humphrey-1,2017-18,Omaha,F,25,18,483,86,171,.503,75,145,.517,11,26,.423,21,35,.600,48,73,121,17,7,14,34,64,204,5.5
2835,Trey Porter\trey-porter-1,2016-17,Old Dominion,F,31,8,454,76,150,.507,76,150,.507,0,0,,52,81,.642,61,88,149,12,10,47,29,69,204,5.9
2836,Obediah Church\obediah-church-1,2016-17,Missouri State,F,31,26,794,81,126,.643,81,125,.648,0,1,.000,42,86,.488,71,108,179,42,16,74,43,71,204,7.7
2837,Khalil Kelley\khalil-kelley-1,2013-14,Pacific,F,34,34,682,73,147,.497,73,147,.497,0,0,,58,99,.586,71,88,159,23,5,15,52,111,204,3.7
2838,Cam Gregory\cam-gregory-1,2014-15,Loyola (MD),F,30,16,752,75,151,.497,75,146,.514,0,5,.000,54,91,.593,67,143,210,16,19,11,42,94,204,5.4
2839,Forrest Robinson\forrest-robinson-1,2014-15,DePaul,F,32,12,635,68,167,.407,22,41,.537,46,126,.365,22,25,.880,25,78,103,11,11,18,27,83,204,3.9
2840,Mike Morsell\mike-morsell-1,2014-15,Towson,F,32,13,610,72,154,.468,63,121,.521,9,33,.273,51,74,.689,24,48,72,25,14,18,37,86,204,3.7
2841,Reginald Johnson\reginald-johnson-1,2015-16,Alcorn State,F,30,0,516,82,184,.446,69,144,.479,13,40,.325,27,41,.659,39,44,83,14,6,3,25,32,204,4.1
2842,Basil Thompson\basil-thompson-1,2015-16,Saint Francis (PA),F,28,2,490,66,170,.388,64,150,.427,2,20,.100,70,93,.753,39,77,116,14,7,13,52,57,204,3.7
2843,Johnathan Williams\johnathan-williams-2,2013-14,Missouri,F,35,35,922,74,162,.457,70,151,.464,4,11,.364,52,92,.565,99,128,227,24,14,57,39,97,204,5.9
2844,Stephen Nwaukoni\stephen-nwaukoni-1,2013-14,Hofstra,F,33,17,748,60,125,.480,60,125,.480,0,0,,84,120,.700,112,178,290,20,14,19,44,86,204,6.7
2845,Obediah Church\obediah-church-1,2015-16,Missouri State,F,32,32,861,86,144,.597,86,141,.610,0,3,.000,31,76,.408,62,133,195,47,22,50,49,63,203,6.8
2846,Connor Lammert\connor-lammert-1,2013-14,Texas,F,35,4,724,80,163,.491,62,110,.564,18,53,.340,25,38,.658,59,124,183,30,10,17,25,64,203,5.3
2847,Ramone Snowden\ramone-snowden-1,2017-18,James Madison,F,32,32,927,66,152,.434,35,75,.467,31,77,.403,40,71,.563,30,94,124,84,41,9,54,107,203,5.3
2848,Isaiah Wilkins\isaiah-wilkins-1,2017-18,Virginia,F,34,34,936,83,171,.485,80,154,.519,3,17,.176,34,45,.756,70,141,211,53,40,49,29,76,203,7.5
2849,Dikembe Dixson\dikembe-dixson-1,2016-17,Illinois-Chicago,F,10,10,293,63,132,.477,52,102,.510,11,30,.367,66,84,.786,9,51,60,10,15,3,36,18,203,13.1
2850,Tyler Neal\tyler-neal-1,2013-14,Oklahoma,F,32,0,494,66,147,.449,33,67,.493,33,80,.413,38,54,.704,31,74,105,19,8,11,28,49,203,4.5
2851,Reggie Agbeko\reggie-agbeko-1,2015-16,Saint Louis,F,32,28,779,81,142,.570,81,142,.570,0,0,,41,65,.631,60,137,197,9,17,12,48,73,203,5.1
2852,Zafir Williams\zafir-williams-1,2017-18,Loyola Marymount,F,31,11,539,85,160,.531,77,148,.520,8,12,.667,25,33,.758,51,58,109,21,12,9,30,94,203,4.5
2853,Donta Hall\donta-hall-1,2016-17,Alabama,F,34,20,670,79,120,.658,79,120,.658,0,0,,45,75,.600,66,120,186,18,18,48,31,86,203,6.5
2854,Sam Neumann\sam-neumann-1,2016-17,Montana State,F,32,32,838,64,132,.485,42,74,.568,22,58,.379,53,77,.688,66,133,199,42,14,5,31,86,203,6.1
2855,Hassan Martin\hassan-martin-1,2013-14,Rhode Island,F,32,19,824,82,153,.536,81,142,.570,1,11,.091,38,71,.535,54,128,182,14,12,79,28,92,203,6.4
2856,Jarquez Smith\jarquez-smith-1,2014-15,Florida State,F,33,9,586,75,149,.503,67,118,.568,8,31,.258,45,60,.750,34,61,95,13,8,35,41,67,203,4.2
2857,Janarius Middleton\janarius-middleton-1,2014-15,Jackson State,F,25,10,470,87,171,.509,77,136,.566,10,35,.286,19,26,.731,59,63,122,20,13,11,26,45,203,6.6
2858,Terrell Brown\terrell-brown-3,2013-14,Montana State,F,31,15,617,64,162,.395,46,100,.460,18,62,.290,57,67,.851,19,54,73,18,24,2,16,57,203,4.5
2859,Alex Osborne\alex-osborne-1,2013-14,Loyola Marymount,F,32,22,654,81,159,.509,81,159,.509,0,0,,40,73,.548,60,111,171,15,38,16,32,101,202,5.4
2860,Simi Socks\simi-socks-1,2017-18,Incarnate Word,F,25,12,436,67,149,.450,58,121,.479,9,28,.321,59,74,.797,37,48,85,10,8,10,56,60,202,4.0
2861,Nick Harris\nick-harris-1,2016-17,College of Charleston,F,34,31,833,80,125,.640,80,125,.640,0,0,,42,67,.627,57,147,204,10,9,39,30,93,202,5.8
2862,MiKyle McIntosh\mikyle-mcintosh-1,2014-15,Illinois State,F,35,17,702,70,200,.350,62,160,.388,8,40,.200,54,97,.557,50,97,147,25,9,8,69,106,202,1.6
2863,Deshaun Sunderhaus\deshaun-sunderhaus-1,2013-14,Seattle,F,19,6,414,82,142,.577,82,142,.577,0,0,,38,63,.603,53,65,118,18,10,24,22,48,202,9.5
2864,Isaac Johnson\isaac-johnson-1,2016-17,Appalachian State,F,30,5,622,75,148,.507,71,124,.573,4,24,.167,48,81,.593,68,134,202,30,34,16,41,73,202,6.6
2865,Bryce Fowler\bryce-fowler-1,2017-18,Sacramento State,F,32,26,884,84,159,.528,68,119,.571,16,40,.400,18,31,.581,35,91,126,64,21,12,51,62,202,5.3
2866,Casey Oliverson\casey-oliverson-1,2013-14,Southern Utah,F,29,17,662,85,157,.541,84,156,.538,1,1,1.000,31,58,.534,61,94,155,20,14,16,35,79,202,5.5
2867,Juwan Gray\juwan-gray-1,2017-18,San Diego,F,34,3,683,73,151,.483,57,99,.576,16,52,.308,40,60,.667,30,81,111,20,16,26,19,62,202,4.9
2868,TySean Powell\tysean-powell-1,2014-15,Duquesne,F,29,7,413,77,133,.579,77,133,.579,0,0,,47,72,.653,32,62,94,8,11,15,34,64,201,4.7
2869,Nick King\nick-king-1,2014-15,Memphis,F,28,7,528,74,183,.404,68,159,.428,6,24,.250,47,74,.635,51,83,134,28,16,9,29,41,201,5.3
2870,Orlando Coleman\orlando-coleman-1,2014-15,Kennesaw State,F,32,18,783,93,219,.425,83,175,.474,10,44,.227,5,7,.714,46,117,163,30,24,13,60,48,201,3.9
2871,Zach Auguste\zach-auguste-1,2013-14,Notre Dame,F,30,13,489,86,169,.509,86,168,.512,0,1,.000,29,60,.483,55,74,129,8,11,11,23,58,201,4.8
2872,Derek Koch\derek-koch-1,2017-18,Bowling Green State,F,30,28,642,67,162,.414,54,125,.432,13,37,.351,54,65,.831,70,93,163,34,11,14,34,84,201,5.5
2873,C.J. Bobbitt\cj-bobbitt-1,2015-16,Denver,F,24,22,537,70,156,.449,63,125,.504,7,31,.226,54,82,.659,22,69,91,41,17,6,53,72,201,4.7
2874,Malik Fitts\malik-fitts-1,2016-17,South Florida,F,27,18,659,73,185,.395,46,105,.438,27,80,.338,28,52,.538,25,98,123,31,19,10,37,69,201,4.5
2875,John Mooney\john-mooney-1,2017-18,Notre Dame,F,36,7,554,72,150,.480,41,76,.539,31,74,.419,26,49,.531,37,104,141,18,11,14,12,56,201,4.8
2876,Ahmed Hamdy Mohamed\ahmed-hamdymohamed-1,2016-17,Virginia Commonwealth,F,34,9,447,71,149,.477,71,149,.477,0,0,,59,95,.621,43,86,129,8,12,19,41,83,201,3.6
2877,Brekkott Chapman\brekkott-chapman-1,2014-15,Utah,F,35,2,525,70,146,.479,51,103,.495,19,43,.442,42,55,.764,31,48,79,13,17,15,34,80,201,3.7
2878,Keenan Simmons\keenan-simmons-1,2016-17,Southern Illinois-Edwardsville,F,30,30,798,76,148,.514,76,148,.514,0,0,,49,77,.636,85,130,215,9,22,39,23,95,201,7.0
2879,Derek Cooke\derek-cooke-1,2013-14,Wyoming,F,33,32,746,83,132,.629,83,131,.634,0,1,.000,35,78,.449,41,152,193,32,22,29,28,64,201,6.4
2880,Ronnie Drinnon\ronnie-drinnon-1,2013-14,Saint Francis (PA),F,27,18,639,86,162,.531,82,151,.543,4,11,.364,25,46,.543,67,88,155,31,23,24,27,68,201,7.2
2881,Zach McCabe\zach-mccabe-1,2013-14,Iowa,F,33,1,520,67,172,.390,39,90,.433,28,82,.341,39,52,.750,32,64,96,41,17,1,26,83,201,4.0
2882,Myo Baxter-Bell\myo-baxter-bell-1,2017-18,Liberty,F,36,8,455,76,158,.481,75,151,.497,1,7,.143,48,59,.814,27,46,73,38,26,6,44,64,201,3.8
2883,Drick Bernstine\drick-bernstine-1,2017-18,Washington State,F,29,24,810,91,178,.511,91,178,.511,0,0,,19,35,.543,53,146,199,77,35,19,68,80,201,6.5
2884,Anfernee McLemore\anfernee-mclemore-1,2017-18,Auburn,F,27,21,525,74,139,.532,56,93,.602,18,46,.391,35,48,.729,49,93,142,14,20,73,24,70,201,8.1
2885,Kamari Murphy\kamari-murphy-1,2013-14,Oklahoma State,F,33,21,855,82,153,.536,82,153,.536,0,0,,36,63,.571,63,144,207,23,17,41,38,113,200,5.5
2886,Willie Clayton\willie-clayton-1,2016-17,Georgia State,F,33,23,694,88,137,.642,88,137,.642,0,0,,24,79,.304,97,140,237,16,14,25,58,97,200,5.2
2887,Mindaugas Kacinas\mindaugas-kacinas-1,2014-15,South Carolina,F,33,0,710,74,132,.561,65,103,.631,9,29,.310,43,59,.729,77,91,168,18,20,14,34,82,200,5.7
2888,Karim York\karim-york-1,2015-16,Prairie View,F,28,16,577,81,179,.453,79,157,.503,2,22,.091,36,60,.600,34,82,116,16,9,13,55,77,200,3.2
2889,De'Ron Davis\deron-davis-1,2016-17,Indiana,F,34,4,471,66,136,.485,66,136,.485,0,0,,68,90,.756,53,53,106,31,14,24,41,82,200,4.5
2890,Isaiah Brock\isaiah-brock-1,2016-17,Oakland,F,33,29,705,90,131,.687,90,131,.687,0,0,,20,31,.645,66,137,203,19,24,69,35,91,200,7.3
2891,Raymond Spalding\raymond-spalding-1,2016-17,Louisville,F,34,8,653,79,134,.590,79,131,.603,0,3,.000,42,77,.545,65,123,188,27,22,29,43,88,200,5.6
2892,Wayde Sims\wayde-sims-1,2016-17,Louisiana State,F,31,5,588,77,153,.503,63,119,.529,14,34,.412,32,43,.744,39,78,117,17,22,14,32,53,200,5.2
2893,Sterling Manley\sterling-manley-1,2017-18,North Carolina,F,37,0,369,73,129,.566,73,129,.566,0,0,,54,78,.692,49,84,133,11,2,24,32,44,200,4.5
2894,Eric Ferguson\eric-ferguson-2,2014-15,Georgia Southern,F,25,4,509,74,161,.460,56,107,.523,18,54,.333,34,68,.500,45,88,133,10,14,15,39,75,200,4.9
2895,Jeremiah Eason\jeremiah-eason-1,2013-14,Southern Mississippi,F,36,14,709,72,146,.493,72,146,.493,0,0,,56,103,.544,73,72,145,23,25,4,49,109,200,3.7
2896,Ken'Darrius Hamilton\kendarrius-hamilton-1,2016-17,Tennessee State,F,28,15,546,76,171,.444,53,104,.510,23,67,.343,25,36,.694,41,70,111,13,13,20,47,81,200,4.0
2897,Kevin Johnson\kevin-johnson-6,2015-16,Cincinnati,F,33,2,700,68,196,.347,28,66,.424,40,130,.308,24,32,.750,24,34,58,55,30,2,38,51,200,3.8
2898,Immanuel King\immanuel-king-1,2016-17,Texas State,F,36,23,777,82,145,.566,82,145,.566,0,0,,36,73,.493,71,95,166,25,16,38,43,89,200,4.9
2899,Martins Igbanu\martins-igbanu-1,2016-17,Tulsa,F,32,19,491,66,118,.559,61,109,.560,5,9,.556,63,107,.589,58,69,127,8,5,11,46,64,200,4.2
2900,Justin Smith\justin-smith-3,2017-18,Indiana,F,31,9,463,82,149,.550,79,139,.568,3,10,.300,33,49,.673,43,55,98,7,7,10,34,58,200,4.2
2901,Will Regan\will-regan-1,2014-15,Buffalo,F,33,19,755,64,177,.362,36,85,.424,28,92,.304,44,60,.733,46,89,135,17,12,16,16,58,200,4.5
2902,Quentin Bastian\quentin-bastian-1,2014-15,Florida A&M,F,25,20,581,79,187,.422,79,185,.427,0,2,.000,42,63,.667,39,73,112,11,5,8,35,74,200,3.8
2903,Dwight Tarwater\dwight-tarwater-1,2013-14,Cornell,F,28,28,730,69,187,.369,40,97,.412,29,90,.322,33,47,.702,56,99,155,28,9,15,22,72,200,5.3
2904,Jake Kitchell\jake-kitchell-1,2014-15,Indiana State,F,31,27,741,68,139,.489,55,97,.567,13,42,.310,50,70,.714,58,94,152,47,12,29,43,70,199,5.9
2905,Rashard Kelly\rashard-kelly-1,2016-17,Wichita State,F,36,8,605,74,150,.493,64,127,.504,10,23,.435,41,71,.577,63,110,173,43,19,9,37,62,199,5.1
2906,Joey van Zegeren\joey-van-zegeren-1,2013-14,Virginia Tech,F,31,24,683,84,168,.500,84,167,.503,0,1,.000,31,86,.360,69,86,155,10,12,53,44,92,199,4.6
2907,Mikael Hopkins\mikael-hopkins-1,2013-14,Georgetown,F,33,20,688,73,171,.427,71,163,.436,2,8,.250,51,81,.630,61,102,163,34,22,50,54,107,199,4.7
2908,Cliff Alexander\cliff-alexander-1,2014-15,Kansas,F,28,6,492,73,129,.566,73,129,.566,0,0,,53,79,.671,55,93,148,12,5,37,28,57,199,6.5
2909,Dom Uhl\dom-uhl-1,2015-16,Iowa,F,33,1,592,69,166,.416,42,106,.396,27,60,.450,34,58,.586,38,81,119,27,16,12,25,40,199,4.7
2910,Evan Bailey\evan-bailey-1,2015-16,College of Charleston,F,31,0,676,64,178,.360,20,51,.392,44,127,.346,27,38,.711,14,38,52,21,18,2,25,63,199,3.2
2911,Jordan Allen\jordan-allen-1,2013-14,Hofstra,F,30,30,848,67,149,.450,67,147,.456,0,2,.000,65,145,.448,56,89,145,61,33,13,61,118,199,4.4
2912,Francois Lewis\francois-lewis-1,2017-18,Presbyterian,F,16,14,344,74,146,.507,50,87,.575,24,59,.407,27,40,.675,19,57,76,16,9,2,18,48,199,8.5
2913,Deandre Davis\deandre-davis-2,2016-17,Alcorn State,F,23,22,565,76,142,.535,72,133,.541,4,9,.444,43,72,.597,45,75,120,23,17,21,32,65,199,7.1
2914,Tevin Prescott\tevin-prescott-1,2014-15,Winthrop,F,29,28,646,77,134,.575,77,134,.575,0,0,,45,81,.556,57,84,141,7,21,16,29,84,199,5.6
2915,Luther Page\luther-page-1,2014-15,Alabama State,F,29,3,601,67,124,.540,67,124,.540,0,0,,65,116,.560,68,92,160,20,21,14,54,66,199,5.5
2916,Cody Martin\cody-martin-1,2015-16,North Carolina State,F,33,16,855,78,167,.467,75,160,.469,3,7,.429,40,67,.597,57,87,144,75,40,14,46,69,199,6.0
2917,Gavin Schilling\gavin-schilling-1,2014-15,Michigan State,F,39,33,659,82,141,.582,82,141,.582,0,0,,35,73,.479,66,84,150,15,7,25,33,115,199,3.7
2918,Kyrin Galloway\kyrin-galloway-1,2017-18,North Carolina-Greensboro,F,35,3,679,79,146,.541,66,100,.660,13,46,.283,27,44,.614,51,104,155,11,10,20,31,65,198,4.6
2919,J.R. Holder\jr-holder-1,2013-14,Jacksonville,F,30,5,468,69,149,.463,54,95,.568,15,54,.278,45,78,.577,29,26,55,18,13,6,29,50,198,3.9
2920,Michael Carrera\michael-carrera-1,2013-14,South Carolina,F,33,20,649,64,169,.379,57,139,.410,7,30,.233,63,100,.630,76,110,186,17,26,32,38,87,198,5.0
2921,Aaron Jones\aaron-jones-1,2013-14,Mississippi,F,33,27,894,83,193,.430,81,181,.448,2,12,.167,30,42,.714,107,110,217,13,29,69,24,84,198,6.9
2922,J.T. Adenrele\john-adenrele-1,2014-15,UC-Davis,F,31,31,562,76,153,.497,75,152,.493,1,1,1.000,45,67,.672,47,75,122,20,14,16,44,90,198,4.1
2923,Aaron Bowen\aaron-bowen-1,2013-14,Georgetown,F,33,1,669,78,158,.494,65,108,.602,13,50,.260,29,59,.492,42,79,121,27,34,11,41,81,198,4.5
2924,Daquan Holiday\daquan-holiday-1,2014-15,NJIT,F,33,32,618,78,123,.634,78,123,.634,0,0,,42,71,.592,48,103,151,28,25,49,32,94,198,6.2
2925,Chris Hooper\chris-hooper-1,2014-15,St. Francis (NY),F,35,28,500,76,147,.517,76,147,.517,0,0,,46,79,.582,66,81,147,26,19,16,41,82,198,4.5
2926,Will Emery\will-emery-1,2017-18,Dartmouth,F,26,23,609,66,142,.465,64,123,.520,2,19,.105,64,99,.646,39,83,122,23,4,20,41,36,198,5.5
2927,Ioannis Dimakopoulos\ioannis-dimakopoulos-1,2015-16,UC-Irvine,F,38,2,561,81,177,.458,70,144,.486,11,33,.333,25,39,.641,22,77,99,24,8,34,34,63,198,3.4
2928,Jeff Coby\jeff-coby-1,2015-16,Columbia,F,34,7,524,67,141,.475,60,116,.517,7,25,.280,57,80,.713,54,109,163,19,14,14,21,74,198,5.1
2929,Christian Kirk\christian-kirk-1,2013-14,Missouri State,F,33,9,606,79,140,.564,79,140,.564,0,0,,40,61,.656,38,69,107,17,11,19,33,83,198,4.3
2930,Georgi Boyanov\georgi-boyanov-1,2014-15,South Alabama,F,33,6,582,72,145,.497,62,108,.574,10,37,.270,44,77,.571,47,107,154,18,22,11,32,69,198,4.8
2931,Jalen Chapman\jalen-chapman-1,2015-16,Western Illinois,F,27,11,472,77,155,.497,77,155,.497,0,0,,44,71,.620,28,66,94,13,23,20,31,80,198,4.9
2932,Randy Holmes\randy-holmes-2,2015-16,Bethune-Cookman,F,32,11,714,70,184,.380,54,125,.432,16,59,.271,42,53,.792,44,82,126,29,23,7,43,89,198,3.7
2933,Devarick Houston\devarick-houston-1,2014-15,Maryland-Baltimore County,F,30,24,974,77,156,.494,62,99,.626,15,57,.263,29,50,.580,35,112,147,54,49,36,72,92,198,5.8
2934,Mac Hoffman\mac-hoffman-1,2016-17,Army,F,32,32,692,75,138,.543,75,138,.543,0,0,,48,75,.640,62,148,210,26,7,12,42,100,198,5.0
2935,Ty Jones\ty-jones-3,2017-18,Charleston Southern,F,31,16,590,79,155,.510,77,144,.535,2,11,.182,37,49,.755,26,52,78,28,14,7,51,58,197,3.7
2936,James Lewis Jr.\james-lewisjr-1,2017-18,Chattanooga,F,27,21,700,67,132,.508,67,132,.508,0,0,,63,95,.663,60,85,145,19,8,6,57,67,197,4.7
2937,Derrell Taylor\derrell-taylor-1,2014-15,Jackson State,F,26,23,592,69,133,.519,69,133,.519,0,0,,59,78,.756,58,67,125,16,27,5,31,68,197,6.5
2938,Wesley Harris\wesley-harris-1,2017-18,West Virginia,F,37,37,764,61,166,.367,33,78,.423,28,88,.318,47,64,.734,44,90,134,15,22,15,36,91,197,3.4
2939,Michael Cobbins\mike-cobbins-1,2014-15,Oklahoma State,F,29,29,792,78,134,.582,78,134,.582,0,0,,41,72,.569,49,122,171,16,20,53,33,79,197,6.8
2940,Ryan Rhoomes\ryan-rhoomes-1,2014-15,Fordham,F,31,30,924,77,139,.554,77,139,.554,0,0,,43,64,.672,104,164,268,26,12,40,38,78,197,7.5
2941,BaeBae Daniels\baebae-daniels-1,2013-14,North Florida,F,32,1,606,69,172,.401,42,83,.506,27,89,.303,32,40,.800,51,73,124,24,15,20,27,80,197,4.5
2942,Rakeem Christmas\rakeem-christmas-1,2013-14,Syracuse,F,34,34,803,76,124,.613,76,124,.613,0,0,,45,62,.726,71,101,172,23,16,66,26,107,197,6.6
2943,Ezekiel Balogun\ezekiel-balogun-1,2016-17,Citadel,F,32,4,345,76,141,.539,61,98,.622,15,43,.349,30,55,.545,38,80,118,13,16,14,35,48,197,4.7
2944,Solomon Mangham\solomon-mangham-1,2013-14,Howard,F,32,16,668,66,182,.363,40,108,.370,26,74,.351,39,59,.661,38,62,100,1,14,9,33,90,197,2.7
2945,Zena Edosomwan\zena-edosomwan-1,2016-17,Harvard,F,28,7,479,82,142,.577,82,142,.577,0,0,,33,68,.485,62,114,176,4,18,48,31,75,197,6.7
2946,Orlando Parker\orlando-parker-1,2013-14,Wagner,F,28,17,703,81,176,.460,81,175,.463,0,1,.000,35,55,.636,64,129,193,13,18,26,34,90,197,5.6
2947,Jamarcus Hairston\jamarcus-hairston-1,2017-18,Cleveland State,F,35,14,724,79,161,.491,57,97,.588,22,64,.344,17,30,.567,42,86,128,26,22,15,24,52,197,4.9
2948,Francois Lewis\francois-lewis-1,2015-16,Florida A&M,F,29,20,643,76,171,.444,53,94,.564,23,77,.299,22,52,.423,28,75,103,11,16,8,31,82,197,3.6
2949,Austin Cooke\austin-cooke-1,2015-16,Abilene Christian,F,30,19,575,56,149,.376,20,50,.400,36,99,.364,49,59,.831,39,73,112,19,15,2,26,73,197,4.5
2950,Abrian Edwards\abrian-edwards-1,2017-18,Sam Houston State,F,32,19,685,70,139,.504,63,116,.543,7,23,.304,49,72,.681,38,79,117,74,22,2,53,62,196,5.2
2951,V.J. Beachem\vj-beachem-1,2014-15,Notre Dame,F,33,0,483,66,145,.455,24,44,.545,42,101,.416,22,29,.759,10,37,47,15,8,8,18,28,196,4.0
2952,Jalen Carethers\jalen-carethers-1,2014-15,Radford,F,34,1,531,77,153,.503,77,153,.503,0,0,,42,58,.724,57,81,138,23,19,23,22,84,196,5.1
2953,Michael Douglas\michael-douglas-1,2017-18,Florida International,F,31,6,678,64,172,.372,33,87,.379,31,85,.365,37,57,.649,28,76,104,10,23,4,18,67,196,4.0
2954,Jy'lan Washington\jylan-washington-1,2017-18,Louisiana Tech,F,33,14,619,66,158,.418,44,78,.564,22,80,.275,42,57,.737,42,73,115,19,16,10,25,52,196,4.5
2955,Gavin Skelly\gavin-skelly-1,2017-18,Northwestern,F,32,21,697,66,150,.440,42,92,.457,24,58,.414,40,56,.714,35,93,128,32,24,17,45,86,196,4.4
2956,Rakim Lubin\rakem-lubin-1,2016-17,Cal State Northridge,F,23,12,419,75,141,.532,75,140,.536,0,1,.000,46,77,.597,37,83,120,9,4,8,53,96,196,3.9
2957,Curtis Phillips\curtis-phillips-1,2016-17,Tennessee Tech,F,22,8,504,65,156,.417,47,98,.480,18,58,.310,48,63,.762,18,65,83,28,22,7,37,57,196,5.7
2958,Jack Hobbs\jack-hobbs-1,2016-17,Hartford,F,31,18,719,64,164,.390,11,25,.440,53,139,.381,15,23,.652,26,87,113,21,25,13,21,73,196,4.7
2959,Ryan Rhoomes\ryan-rhoomes-1,2013-14,Fordham,F,31,26,723,82,123,.667,82,123,.667,0,0,,32,57,.561,98,116,214,15,12,28,15,96,196,7.3
2960,Robert Franks\robert-franks-1,2016-17,Washington State,F,31,1,509,73,166,.440,54,105,.514,19,61,.311,30,41,.732,28,73,101,24,4,18,41,59,195,3.7
2961,Drew Urquhart\drew-urguhart-1,2015-16,Vermont,F,36,6,539,74,164,.451,73,160,.456,1,4,.250,46,70,.657,28,84,112,23,7,24,44,73,195,3.1
2962,Jonathan Kasibabu\jonathan-kasibabu-1,2015-16,Fairfield,F,33,32,633,73,142,.514,68,127,.535,5,15,.333,44,67,.657,69,112,181,31,15,38,53,116,195,4.9
2963,Marcanvis Hymon\marcanvis-hymon-1,2015-16,Mississippi,F,32,10,565,78,149,.523,78,149,.523,0,0,,39,73,.534,67,99,166,15,22,29,21,80,195,5.8
2964,DaQuan Jeffries\daquan-jeffries-1,2015-16,Oral Roberts,F,29,7,589,74,129,.574,63,101,.624,11,28,.393,36,46,.783,40,87,127,24,18,18,21,64,195,6.4
2965,Artem Tavakalyan\artem-tavakalyan-1,2016-17,Delaware State,F,32,10,475,66,164,.402,44,99,.444,22,65,.338,41,64,.641,16,63,79,27,16,8,35,48,195,3.6
2966,Ryan Manning\ryan-manning-1,2016-17,Air Force,F,31,4,434,71,160,.444,37,67,.552,34,93,.366,19,28,.679,20,38,58,17,11,1,19,26,195,4.1
2967,Mack Mercer\mack-mercer-1,2017-18,Belmont,F,30,9,462,75,138,.543,65,101,.644,10,37,.270,35,48,.729,28,60,88,21,12,14,35,86,195,4.3
2968,Justin Leathers\justin-leathers-1,2013-14,Texas-Rio Grande Valley,F,32,26,778,60,168,.357,34,92,.370,26,76,.342,49,60,.817,41,85,126,33,24,10,41,84,195,4.1
2969,Jermaine Sanders\jermaine-sanders-1,2013-14,Cincinnati,F,34,0,725,67,160,.419,32,67,.478,35,93,.376,26,38,.684,42,63,105,34,16,9,16,41,195,4.9
2970,Gabe Levin\gabe-levin-1,2016-17,Cal State Long Beach,F,16,16,433,74,160,.463,62,124,.500,12,36,.333,35,50,.700,35,64,99,16,17,12,35,42,195,8.4
2971,Jervon Pressley\jervon-pressley-1,2014-15,Hampton,F,32,29,688,70,158,.443,70,158,.443,0,0,,55,101,.545,62,92,154,21,12,44,62,95,195,3.8
2972,Nico Carvacho\nico-carvacho-1,2016-17,Colorado State,F,36,33,789,72,134,.537,71,131,.542,1,3,.333,50,84,.595,85,120,205,44,15,18,42,99,195,5.2
2973,Nick Harris\nick-harris-1,2017-18,College of Charleston,F,33,33,840,79,144,.549,79,144,.549,0,0,,37,60,.617,64,150,214,14,13,40,36,94,195,5.6
2974,Griffin Kinney\griffin-kinney-1,2015-16,Appalachian State,F,31,29,581,72,152,.474,72,150,.480,0,2,.000,50,75,.667,43,102,145,26,14,2,53,82,194,3.7
2975,Mark Williams\mark-williams-3,2016-17,Temple,F,32,6,509,75,190,.395,60,124,.484,15,66,.227,29,40,.725,20,70,90,38,6,8,34,82,194,2.9
2976,Andrew Chrabascz\andrew-chrabascz-1,2013-14,Butler,F,31,10,599,64,122,.525,59,111,.532,5,11,.455,61,80,.763,54,38,92,33,18,6,21,70,194,5.6
2977,Jeremy Verhagen\jeremy-verhagen-1,2015-16,Northern Colorado,F,31,25,628,70,134,.522,65,114,.570,5,20,.250,49,74,.662,43,74,117,9,9,21,44,77,194,4.1
2978,Vinny Zollo\vinny-zollo-1,2015-16,Cleveland State,F,29,24,642,69,191,.361,47,105,.448,22,86,.256,34,48,.708,52,112,164,32,14,12,44,74,194,4.3
2979,Tyler Livingston\tyler-livingston-1,2013-14,Massachusetts-Lowell,F,28,26,744,68,188,.362,21,48,.438,47,140,.336,11,17,.647,19,68,87,20,7,6,26,70,194,3.3
2980,Zach Mills\zach-mills-1,2013-14,Sacramento State,F,30,24,645,73,168,.435,44,96,.458,29,72,.403,19,22,.864,24,81,105,17,9,1,23,59,194,4.0
2981,Luke Maye\luke-maye-1,2016-17,North Carolina,F,35,1,495,78,163,.479,62,123,.504,16,40,.400,22,38,.579,58,80,138,41,15,7,30,63,194,4.6
2982,David Samuels\david-samuels-1,2013-14,Cal State Long Beach,F,32,29,767,78,191,.408,72,161,.447,6,30,.200,32,50,.640,68,105,173,23,12,10,40,73,194,4.0
2983,Gabe Bealer\gabe-bealer-1,2017-18,Utah,F,33,26,629,68,153,.444,18,31,.581,50,122,.410,8,12,.667,6,59,65,12,13,2,19,42,194,3.7
2984,Shamar Johnson\shamar-johnson-3,2016-17,Loyola Marymount,F,28,28,604,80,174,.460,80,173,.462,0,1,.000,34,62,.548,44,77,121,46,12,7,39,86,194,4.4
2985,Jacob Lampkin\jacob-lampkin-1,2015-16,Pacific,F,28,21,597,88,164,.537,88,163,.540,0,1,.000,18,38,.474,35,100,135,28,8,7,37,64,194,4.7
2986,Jonathan Kasibabu\jonathan-kasibabu-1,2016-17,Fairfield,F,31,12,595,76,130,.585,71,112,.634,5,18,.278,37,64,.578,47,104,151,36,17,44,45,101,194,5.6
2987,Darius Dawkins\darius-dawkins-1,2016-17,Jacksonville,F,27,1,408,64,145,.441,9,14,.643,55,131,.420,11,14,.786,5,35,40,10,11,2,7,33,194,4.8
2988,Tamenang Choh\tamenang-choh-1,2017-18,Brown,F,27,12,627,72,135,.533,71,129,.550,1,6,.167,49,77,.636,55,92,147,40,13,19,43,94,194,5.8
2989,Dallas Ennema\dallas-ennema-1,2016-17,Albany (NY),F,34,2,701,63,145,.434,21,46,.457,42,99,.424,26,34,.765,10,82,92,22,11,18,20,52,194,4.2
2990,Phillip Jones\phillip-jones-2,2013-14,Texas-San Antonio,F,27,23,600,62,143,.434,59,138,.428,3,5,.600,67,121,.554,56,111,167,27,29,20,56,64,194,5.6
2991,Marlin Mason\marlin-mason-1,2013-14,Cleveland State,F,33,33,666,71,129,.550,56,98,.571,15,31,.484,37,47,.787,45,92,137,36,22,34,45,99,194,5.3
2992,Zach Mills\zach-mills-1,2014-15,Sacramento State,F,33,2,656,73,157,.465,45,97,.464,28,60,.467,20,28,.714,29,76,105,22,19,2,20,50,194,4.5
2993,Taylor Bessick\taylor-bessick-1,2013-14,James Madison,F,31,29,687,80,160,.500,80,160,.500,0,0,,34,60,.567,49,98,147,13,15,20,41,95,194,4.1
2994,TyQuane Goard\tyquane-goard-1,2013-14,Marshall,F,31,16,787,71,133,.534,71,130,.546,0,3,.000,52,80,.650,62,85,147,24,27,22,28,74,194,6.1
2995,Anali Okoloji\anali-okoloji-1,2014-15,Eastern Michigan,F,35,24,588,67,172,.390,58,134,.433,9,38,.237,50,66,.758,46,86,132,22,31,11,33,41,193,4.4
2996,Jordan Jones\jordan-jones-1,2017-18,Kennesaw State,F,30,30,661,82,150,.547,82,149,.550,0,1,.000,29,45,.644,31,112,143,33,21,9,28,76,193,5.4
2997,Wassef Methnani\wassef-methnani-1,2017-18,Fairfield,F,30,4,414,75,156,.481,59,111,.532,16,45,.356,27,38,.711,41,67,108,25,11,25,47,88,193,4.1
2998,Elijah Pittman\elijah-pittman-1,2013-14,Marshall,F,9,9,249,65,136,.478,37,61,.607,28,75,.373,35,72,.486,13,27,40,4,9,5,13,15,193,13.6
2999,Elijah Cuffee\elijah-cuffee-1,2017-18,Liberty,F,37,19,892,70,175,.400,36,77,.468,34,98,.347,19,23,.826,9,74,83,68,33,12,52,80,193,3.5
3000,Daniel Ochefu\daniel-ochefu-1,2013-14,Villanova,F,34,31,737,76,128,.594,76,127,.598,0,1,.000,41,74,.554,64,144,208,47,24,52,63,95,193,5.9
3001,Sebastian Townes\sebastian-townes-1,2016-17,Bryant,F,31,9,389,70,137,.511,66,122,.541,4,15,.267,49,73,.671,33,29,62,18,8,1,32,62,193,3.6
3002,Zach Smith\zach-smith-1,2014-15,Texas Tech,F,31,30,858,68,144,.472,63,125,.504,5,19,.263,52,84,.619,50,103,153,42,18,45,36,67,193,6.1
3003,Keenan Simmons\keenan-simmons-1,2017-18,Southern Illinois-Edwardsville,F,30,30,754,84,142,.592,83,139,.597,1,3,.333,24,38,.632,68,89,157,10,4,31,26,96,193,5.5
3004,Travis Robinson\travis-robinson-2,2013-14,Boston University,F,35,6,665,63,183,.344,19,48,.396,44,135,.326,23,40,.575,19,57,76,21,26,7,31,60,193,3.0
3005,John Carroll\john-carroll-2,2014-15,Hartford,F,30,7,450,64,174,.368,58,154,.377,6,20,.300,59,88,.670,43,54,97,8,6,5,35,59,193,2.9
3006,Matt Jackson\matt-jackson-1,2015-16,Grand Canyon,F,33,11,638,73,174,.420,46,94,.489,27,80,.338,20,33,.606,25,91,116,34,10,14,26,63,193,4.0
3007,Sidney Umude\sidney-umude-1,2015-16,Youngstown State,F,27,18,469,76,173,.439,76,173,.439,0,0,,41,62,.661,33,50,83,20,17,12,33,74,193,4.0
3008,Tom Vodanovich\tom-vodanovich-1,2015-16,James Madison,F,31,31,767,76,145,.524,70,117,.598,6,28,.214,35,56,.625,40,97,137,28,7,6,46,95,193,3.8
3009,Kellen McCormick\kellen-mccormick-1,2015-16,Western Michigan,F,32,0,475,64,134,.478,15,27,.556,49,107,.458,15,22,.682,11,51,62,19,5,1,23,44,192,3.8
3010,Payton Henson\payton-henson-1,2014-15,Tulane,F,31,0,576,64,163,.393,53,107,.495,11,56,.196,53,79,.671,50,70,120,20,12,12,30,42,192,4.4
3011,Sean Sheldon\sean-sheldon-1,2014-15,William & Mary,F,31,29,702,82,127,.646,82,127,.646,0,0,,28,56,.500,49,84,133,67,10,15,31,63,192,6.3
3012,Marko Gujanicic\marko-gujanicic-1,2013-14,George Mason,F,31,13,587,64,156,.410,54,108,.500,10,48,.208,54,68,.794,28,70,98,26,12,5,46,60,192,3.5
3013,Kristijan Krajina\kristijan-krajina-1,2014-15,Mount St. Mary's,F,30,30,650,79,183,.432,76,158,.481,3,25,.120,31,51,.608,55,86,141,18,12,18,42,77,192,3.9
3014,Tristian Curtis\tristian-curtis-1,2015-16,Coastal Carolina,F,32,32,794,80,116,.690,80,116,.690,0,0,,32,57,.561,76,146,222,12,15,14,33,84,192,6.1
3015,Jonathan Gilling\jonathan-gilling-1,2014-15,Arizona State,F,34,2,703,62,142,.437,7,14,.500,55,128,.430,13,20,.650,6,72,78,35,11,5,39,55,192,3.5
3016,Vincent Eze\vincent-eze-1,2016-17,Maine,F,32,24,633,69,152,.454,69,152,.454,0,0,,54,106,.509,55,101,156,9,15,14,44,91,192,3.5
3017,Nick Allen\nick-allen-1,2016-17,Texas-San Antonio,F,33,20,686,73,171,.427,60,118,.508,13,53,.245,33,49,.673,41,99,140,25,9,16,54,89,192,3.1
3018,Sebastian Much\sebastian-much-1,2017-18,Princeton,F,27,19,528,73,162,.451,38,67,.567,35,95,.368,11,22,.500,24,50,74,36,9,7,46,49,192,4.0
3019,J.T. Adenrele\john-adenrele-1,2016-17,UC-Davis,F,34,33,690,76,153,.497,76,153,.497,0,0,,40,62,.645,59,118,177,17,29,25,46,100,192,4.6
3020,Josh Davenport\josh-davenport-1,2015-16,Winthrop,F,32,2,624,70,117,.598,66,107,.617,4,10,.400,48,71,.676,25,110,135,41,25,16,37,77,192,5.5
3021,Felipe Haase\felipe-haase-1,2017-18,South Carolina,F,33,0,647,71,186,.382,46,92,.500,25,94,.266,25,34,.735,35,93,128,32,16,5,34,61,192,3.7
3022,Tyler Rawson\tyler-rawson-1,2016-17,Utah,F,32,8,625,65,146,.445,46,82,.561,19,64,.297,43,63,.683,34,83,117,60,20,17,42,67,192,5.1
3023,Jordan Salley\jordan-salley-1,2013-14,Sacramento State,F,30,1,471,74,119,.622,74,119,.622,0,0,,44,67,.657,44,65,109,5,12,5,25,95,192,4.5
3024,Kyle Alexander\kyle-alexander-1,2017-18,Tennessee,F,34,34,690,77,113,.681,76,112,.679,1,1,1.000,37,52,.712,84,105,189,11,19,57,25,83,192,7.0
3025,Kaiser Gates\kaiser-gates-1,2016-17,Xavier,F,33,5,692,63,162,.389,23,44,.523,40,118,.339,26,36,.722,37,96,133,22,15,5,22,60,192,4.3
3026,Danrad Knowles\danrad-knowles-1,2015-16,Houston,F,32,12,566,77,136,.566,73,119,.613,4,17,.235,34,68,.500,63,55,118,7,9,28,31,79,192,4.5
3027,Aleem Ford\aleem-ford-1,2017-18,Wisconsin,F,33,20,805,60,150,.400,15,40,.375,45,110,.409,27,33,.818,20,71,91,30,11,6,25,64,192,3.9
3028,Ahmed Hamdy Mohamed\ahmed-hamdymohamed-1,2015-16,Virginia Commonwealth,F,36,0,423,77,154,.500,77,153,.503,0,1,.000,37,71,.521,53,66,119,6,8,19,30,70,191,3.5
3029,Will Yeguete\will-yeguete-1,2013-14,Florida,F,39,39,909,65,149,.436,61,128,.477,4,21,.190,57,86,.663,54,147,201,45,37,7,45,85,191,4.5
3030,Eric Terry\eric-terry-1,2017-18,Texas State,F,33,0,519,67,113,.593,67,113,.593,0,0,,57,78,.731,37,53,90,20,6,20,54,79,191,3.7
3031,Stefon Johnson\stefon-johnson-1,2013-14,Cal State Bakersfield,F,32,29,824,81,187,.433,70,153,.458,11,34,.324,18,31,.581,49,113,162,51,21,21,39,93,191,4.7
3032,Derek Roscoe\derek-roscoe-1,2016-17,Jackson State,F,32,12,551,76,188,.404,69,151,.457,7,37,.189,32,53,.604,37,91,128,20,10,28,49,91,191,2.9
3033,Shayok M. Shayok\shayok-m-shayok-1,2015-16,Missouri-Kansas City,F,26,22,611,82,150,.547,78,140,.557,4,10,.400,23,60,.383,46,89,135,10,17,12,28,76,191,5.3
3034,Corey Brown\corey-brown-4,2017-18,Northern Arizona,F,29,8,482,76,126,.603,76,125,.608,0,1,.000,39,70,.557,36,64,100,10,19,9,32,74,191,4.7
3035,Tahirou Diabate\tahirou-diabate-1,2017-18,Portland,F,30,22,593,80,142,.563,79,138,.572,1,4,.250,30,57,.526,43,82,125,4,19,24,34,73,191,4.8
3036,Hayden Farquhar\hayden-farquhar-1,2016-17,Abilene Christian,F,29,6,413,70,142,.493,34,64,.531,36,78,.462,15,24,.625,28,63,91,20,9,5,25,56,191,4.6
3037,Larry Toomey\larry-toomey-1,2015-16,Army,F,33,32,820,60,156,.385,36,83,.434,24,73,.329,47,66,.712,43,145,188,68,15,11,37,76,191,5.3
3038,Mindaugas Kacinas\mindaugas-kacinas-1,2013-14,South Carolina,F,34,27,818,70,126,.556,70,124,.565,0,2,.000,50,77,.649,80,95,175,12,31,21,53,103,190,4.8
3039,Ricky Doyle\ricky-doyle-1,2014-15,Michigan,F,31,19,564,74,121,.612,74,121,.612,0,0,,42,69,.609,46,52,98,8,7,12,18,57,190,4.9
3040,Cyril Langevine\cyril-langevine-1,2017-18,Rhode Island,F,31,3,561,73,114,.640,73,114,.640,0,0,,44,87,.506,74,106,180,10,11,38,30,90,190,5.9
3041,Brian White\brian-white-1,2016-17,Citadel,F,32,11,390,64,130,.492,38,70,.543,26,60,.433,36,41,.878,25,54,79,17,17,4,29,43,190,4.4
3042,Fabian White Jr.\fabian-whitejr-1,2017-18,Houston,F,35,0,579,75,134,.560,75,134,.560,0,0,,40,56,.714,54,81,135,26,15,32,40,95,190,4.6
3043,Jannson Williams\jannson-williams-1,2017-18,Marshall,F,35,9,587,66,134,.493,39,64,.609,27,70,.386,31,41,.756,32,87,119,8,16,29,20,63,190,4.7
3044,Javan Johnson\javan-johnson-1,2017-18,Troy,F,33,13,557,67,145,.462,32,65,.492,35,80,.438,21,34,.618,32,67,99,19,7,21,39,53,190,3.9
3045,Steve McClellan\steven-mcclellan-1,2013-14,Cal State Fullerton,F,31,22,682,75,127,.591,74,126,.587,1,1,1.000,39,52,.750,68,115,183,19,10,13,50,110,190,4.7
3046,Will Kelly\will-kelly-1,2014-15,Navy,F,31,11,633,70,131,.534,70,131,.534,0,0,,50,90,.556,47,84,131,24,7,57,41,83,190,5.1
3047,Adam Sledd\adam-sledd-1,2016-17,Western Carolina,F,30,23,582,80,162,.494,80,162,.494,0,0,,30,44,.682,55,72,127,8,12,11,33,74,190,4.2
3048,Johnathon Wilkins\jonathan-wilkins-1,2015-16,New Mexico State,F,31,28,700,80,149,.537,78,145,.538,2,4,.500,28,45,.622,47,63,110,36,6,15,41,67,190,4.4
3049,Pete Miller\pete-miller-1,2015-16,Princeton,F,29,28,608,83,160,.519,83,160,.519,0,0,,24,47,.511,57,120,177,44,12,35,38,63,190,6.3
3050,Kyle Kager\kyle-kager-1,2013-14,American,F,33,33,589,68,137,.496,57,95,.600,11,42,.262,43,57,.754,20,92,112,29,17,6,44,43,190,4.2
3051,Jonathan Fairell\jonathan-fairell-1,2014-15,Murray State,F,35,35,744,78,143,.545,78,143,.545,0,0,,34,76,.447,102,142,244,29,32,28,50,111,190,5.6
3052,Michel Nzege\michael-ofik-nzege-1,2014-15,East Carolina,F,33,32,608,85,138,.616,85,138,.616,0,0,,20,42,.476,58,96,154,20,16,12,36,61,190,5.0
3053,Ben Carter\ben-carter-1,2015-16,Nevada-Las Vegas,F,22,7,529,69,124,.556,69,122,.566,0,2,.000,52,69,.754,57,75,132,35,21,30,41,61,190,8.5
3054,Chris Miller\chris-miller-3,2017-18,Oral Roberts,F,32,15,395,84,137,.613,84,137,.613,0,0,,21,37,.568,41,35,76,6,8,10,36,92,189,3.3
3055,Reggie Spencer\reggie-spencer-1,2014-15,Northeastern,F,32,1,604,70,132,.530,70,132,.530,0,0,,49,61,.803,32,66,98,23,20,15,39,84,189,4.3
3056,Shawn Williams\shawn-williams-2,2013-14,Southern Methodist,F,37,36,680,82,157,.522,79,143,.552,3,14,.214,22,45,.489,55,64,119,24,20,10,18,78,189,4.2
3057,Chad Andrews-Fulton\chad-andrews-fulton-1,2017-18,Coppin State,F,29,14,616,66,144,.458,66,142,.465,0,2,.000,57,89,.640,59,84,143,25,21,11,49,96,189,4.4
3058,Nick Richards\nick-richards-2,2017-18,Kentucky,F,37,37,543,69,112,.616,69,112,.616,0,0,,51,71,.718,56,108,164,9,3,33,26,76,189,4.8
3059,Dayon Goodman\dayon-goodman-1,2015-16,Utah Valley,F,30,0,515,69,114,.605,69,110,.627,0,4,.000,51,76,.671,43,70,113,15,11,14,28,75,189,5.0
3060,Hayden Humes\hayden-humes-1,2013-14,Illinois-Chicago,F,27,19,717,63,165,.382,29,66,.439,34,99,.343,29,40,.725,25,70,95,24,10,5,34,79,189,3.6
3061,Alex Hicks\alex-hicks-1,2016-17,Troy,F,37,16,561,74,153,.484,72,138,.522,2,15,.133,39,53,.736,42,111,153,13,15,23,41,68,189,3.8
3062,Josh Nzeakor\josh-nzeakor-1,2015-16,Lamar,F,30,20,540,72,141,.511,72,141,.511,0,0,,45,77,.584,59,102,161,17,15,11,32,69,189,5.1
3063,David Skara\david-skara-1,2015-16,Valparaiso,F,29,13,571,68,154,.442,47,90,.522,21,64,.328,32,43,.744,36,53,89,44,10,8,39,60,189,4.4
3064,Gaellen Bewernick\gaellen-bewernick-1,2014-15,Northern Arizona,F,37,7,889,80,173,.462,73,138,.529,7,35,.200,22,34,.647,41,142,183,37,17,4,55,58,189,3.6
3065,Jaylen Key\jaylen-key-1,2015-16,Northern Illinois,F,34,26,626,76,169,.450,76,167,.455,0,2,.000,37,56,.661,41,82,123,23,19,16,37,88,189,3.6
3066,Connar Tava\connar-tava-1,2016-17,Boston College,F,32,27,809,65,136,.478,59,105,.562,6,31,.194,53,80,.663,46,128,174,67,22,10,70,85,189,4.7
3067,Kurt Steidl\kurt-steidl-1,2013-14,Vermont,F,32,2,459,62,141,.440,23,61,.377,39,80,.488,26,32,.813,19,44,63,15,8,6,24,48,189,3.7
3068,Tim Coleman\tim-coleman-2,2013-14,NJIT,F,24,11,489,61,147,.415,51,114,.447,10,33,.303,57,77,.740,30,87,117,30,28,29,38,79,189,6.2
3069,Sandy Cohen\sandy-cohen-1,2015-16,Marquette,F,32,15,745,61,139,.439,34,63,.540,27,76,.355,40,54,.741,9,94,103,57,24,14,35,83,189,4.7
3070,Cedrick Bowen\cedrick-bowen-1,2013-14,Charleston Southern,F,31,3,507,80,130,.615,80,128,.625,0,2,.000,29,50,.580,46,71,117,13,15,17,17,62,189,5.5
3071,Jake Kretzer\jake-kretzer-1,2014-15,Akron,F,34,12,810,57,143,.399,14,26,.538,43,117,.368,32,35,.914,41,96,137,38,28,2,22,77,189,5.0
3072,Ahmed Hamdy Mohamed\ahmed-hamdymohamed-1,2017-18,Texas Christian,F,32,0,422,70,140,.500,70,140,.500,0,0,,49,73,.671,38,58,96,7,8,9,28,69,189,3.7
3073,Devonta Walker\devonta-walker-1,2015-16,Louisiana,F,34,9,452,65,121,.537,65,119,.546,0,2,.000,59,84,.702,59,82,141,13,13,10,37,66,189,4.5
3074,Eric Curry\eric-curry-1,2016-17,Minnesota,F,34,2,681,69,160,.431,64,131,.489,5,29,.172,45,64,.703,53,124,177,42,15,23,35,69,188,4.9
3075,Steven Julian\steven-julian-1,2017-18,Cornell,F,28,28,834,70,137,.511,60,106,.566,10,31,.323,38,67,.567,38,123,161,33,32,40,28,81,188,7.0
3076,Amdy Fall\amdy-fall-1,2014-15,St. Francis (NY),F,29,7,676,56,116,.483,56,116,.483,0,0,,76,108,.704,55,89,144,19,22,80,38,83,188,7.0
3077,Steve Taylor\steve-taylor-2,2014-15,Marquette,F,32,14,707,80,166,.482,72,135,.533,8,31,.258,20,40,.500,62,99,161,14,17,5,29,46,188,4.7
3078,Michael Kessens\michael-kessens-1,2014-15,Alabama,F,32,10,677,73,146,.500,71,134,.530,2,12,.167,40,61,.656,54,111,165,26,17,13,56,95,188,4.0
3079,Mike Rowley\michael-rowley-1,2016-17,Albany (NY),F,35,35,1022,70,143,.490,70,142,.493,0,1,.000,48,59,.814,59,117,176,46,26,10,44,104,188,4.8
3080,Ross Travis\ross-travis-1,2014-15,Penn State,F,34,27,846,83,175,.474,80,161,.497,3,14,.214,19,57,.333,69,144,213,26,22,5,44,78,188,4.2
3081,Jimmie Taylor\jimmie-taylor-1,2014-15,Alabama,F,34,34,801,71,118,.602,71,118,.602,0,0,,46,93,.495,55,113,168,17,9,59,40,94,188,5.1
3082,Marko Vasic\marko-vasic-1,2014-15,American,F,33,6,671,78,150,.520,68,108,.630,10,42,.238,22,39,.564,21,97,118,45,23,2,29,58,188,4.7
3083,Jack Nunge\jack-nunge-1,2017-18,Iowa,F,33,14,517,66,149,.443,47,92,.511,19,57,.333,37,49,.755,35,56,91,34,21,25,32,38,188,4.9
3084,Matt Shrigley\matt-shrigley-1,2013-14,San Diego State,F,36,3,568,63,168,.375,23,55,.418,40,113,.354,22,33,.667,8,48,56,18,14,12,17,54,188,3.0
3085,Solomon Young\solomon-young-1,2017-18,Iowa State,F,26,26,708,71,146,.486,68,127,.535,3,19,.158,43,60,.717,51,103,154,18,22,19,24,76,188,6.4
3086,Jervon Pressley\jervon-pressley-1,2015-16,Hampton,F,28,13,576,66,145,.455,66,145,.455,0,0,,55,102,.539,59,110,169,17,3,47,60,92,187,4.2
3087,Jacoby Armstrong\jacoby-armstrong-1,2017-18,New Hampshire,F,29,16,583,69,146,.473,60,111,.541,9,35,.257,40,55,.727,45,74,119,35,8,8,33,92,187,4.4
3088,Dewan Hernandez\dewan-huell-1,2016-17,Miami (FL),F,32,15,557,77,145,.531,77,143,.538,0,2,.000,33,51,.647,45,54,99,6,13,25,30,61,187,4.3
3089,Nick Rakocevic\nick-rakocevic-1,2016-17,Southern California,F,36,8,538,67,119,.563,67,119,.563,0,0,,53,79,.671,60,74,134,16,9,23,31,89,187,4.3
3090,Luis Santos\luis-santos-1,2016-17,South Florida,F,30,11,512,73,133,.549,73,131,.557,0,2,.000,41,57,.719,52,72,124,5,14,25,39,62,187,4.9
3091,Stedman Allen\stedman-allen-1,2014-15,Wagner,F,29,22,563,65,162,.401,65,160,.406,0,2,.000,57,83,.687,62,65,127,6,24,13,34,67,187,4.4
3092,Matt Pile\matt-pile-1,2017-18,Omaha,F,31,9,529,83,128,.648,83,128,.648,0,0,,21,60,.350,48,83,131,24,8,32,33,69,187,5.2
3093,Merrill Holden\merrill-holden-1,2015-16,Louisiana Tech,F,23,16,539,65,126,.516,63,117,.538,2,9,.222,55,77,.714,47,68,115,2,9,26,32,78,187,5.9
3094,Xavier Lundy\xavier-lundy-1,2014-15,Rider,F,32,20,463,75,153,.490,59,105,.562,16,48,.333,21,30,.700,28,46,74,16,16,12,27,53,187,4.0
3095,Bernard Morena\benard-morena-1,2013-14,Kennesaw State,F,29,20,539,66,163,.405,50,117,.427,16,46,.348,39,68,.574,23,78,101,15,16,17,71,88,187,2.0
3096,Tanner Omlid\tanner-omlid-1,2013-14,Army,F,31,5,559,70,164,.427,44,76,.579,26,88,.295,21,31,.677,42,97,139,50,63,13,33,72,187,6.5
3097,Onzie Branch\onzie-branch-1,2013-14,Gardner-Webb,F,33,2,502,67,118,.568,67,114,.588,0,4,.000,53,78,.679,42,68,110,34,18,9,39,68,187,4.6
3098,Javier Martinez\javier-martinez-1,2014-15,Tennessee-Martin,F,33,15,509,78,111,.703,78,111,.703,0,0,,31,41,.756,59,67,126,6,8,6,18,67,187,5.1
3099,Kyle Ingram\kyle-ingram-2,2015-16,Idaho State,F,31,26,634,79,149,.530,78,148,.527,1,1,1.000,28,46,.609,45,98,143,34,9,34,37,94,187,4.8
3100,Dorian Chatman\dorian-chatman-1,2016-17,Lamar,F,32,1,459,71,146,.486,69,134,.515,2,12,.167,43,67,.642,45,49,94,24,18,20,44,90,187,3.7
3101,Reggie Scurry\reggie-scurry-1,2017-18,Missouri State,F,21,3,359,74,147,.503,72,138,.522,2,9,.222,36,54,.667,37,51,88,3,5,19,22,52,186,5.9
3102,Johnathon Wilkins\jonathan-wilkins-1,2016-17,New Mexico State,F,34,31,597,76,138,.551,65,107,.607,11,31,.355,23,38,.605,46,55,101,33,9,29,47,100,186,3.8
3103,Liam Thomas\liam-thomas-1,2014-15,Nicholls State,F,29,29,601,72,125,.576,65,104,.625,7,21,.333,35,62,.565,49,76,125,37,8,47,34,84,186,6.0
3104,Mark Flagg\mark-flagg-1,2017-18,Saint Francis (PA),F,31,10,545,70,140,.500,69,134,.515,1,6,.167,45,71,.634,56,71,127,19,20,23,34,72,186,4.9
3105,Ethan O'Day\ethan-oday-1,2013-14,Vermont,F,25,14,510,84,151,.556,84,151,.556,0,0,,18,31,.581,40,55,95,13,18,39,31,52,186,6.2
3106,David Syfax\david-syfax-1,2017-18,Morgan State,F,28,5,555,68,171,.398,56,135,.415,12,36,.333,38,60,.633,40,82,122,19,15,20,32,82,186,4.1
3107,Reggie Theus\reggie-theus-2,2017-18,Cal State Northridge,F,30,20,694,81,198,.409,76,188,.404,5,10,.500,19,39,.487,34,33,67,18,12,8,31,75,186,2.5
3108,Abdel Nader\abdel-nader-1,2014-15,Iowa State,F,32,0,524,69,170,.406,54,101,.535,15,69,.217,33,43,.767,22,71,93,23,12,16,37,50,186,3.4
3109,Richard Freeman\richard-freeman-1,2014-15,Grambling,F,27,8,645,63,182,.346,59,160,.369,4,22,.182,56,93,.602,32,105,137,26,15,10,58,51,186,3.1
3110,Nigel Pruitt\nigel-pruitt-1,2015-16,Kennesaw State,F,23,9,480,63,152,.414,43,92,.467,20,60,.333,40,53,.755,25,71,96,20,35,13,31,55,186,6.2
3111,Faith Pope\faith-pope-1,2016-17,Texas-Arlington,F,36,5,426,71,139,.511,59,100,.590,12,39,.308,32,53,.604,34,72,106,18,15,18,25,54,186,4.1
3112,Markis McDuffie\markis-mcduffie-1,2017-18,Wichita State,F,22,4,416,64,144,.444,44,85,.518,20,59,.339,38,52,.731,21,48,69,25,9,2,30,39,186,5.3
3113,Parker Ernsthausen\parker-ernsthausen-1,2017-18,Wright State,F,35,35,796,67,150,.447,60,116,.517,7,34,.206,45,61,.738,33,57,90,56,18,11,41,70,186,3.9
3114,James Johnson\james-johnson-5,2014-15,Liberty,F,32,23,569,79,148,.534,79,148,.534,0,0,,28,51,.549,35,62,97,9,7,10,65,89,186,2.1
3115,Deontae Hawkins\deontae-hawkins-1,2014-15,Illinois State,F,25,18,560,70,184,.380,40,91,.440,30,93,.323,16,21,.762,32,99,131,21,11,9,23,45,186,5.1
3116,Jordy Kuiper\jordy-kuiper-1,2016-17,North Carolina-Greensboro,F,35,25,698,78,147,.531,64,101,.634,14,46,.304,16,26,.615,63,91,154,26,10,3,35,70,186,4.3
3117,Tyler Livingston\tyler-livingston-1,2015-16,Massachusetts-Lowell,F,25,1,467,74,168,.440,51,85,.600,23,83,.277,15,19,.789,23,53,76,21,11,5,25,54,186,4.4
3118,Dominic Robb\dominic-robb-1,2015-16,Niagara,F,32,16,550,78,140,.557,78,140,.557,0,0,,30,45,.667,33,70,103,7,6,34,22,72,186,4.4
3119,Lacey James\lacey-james-1,2017-18,Northern Illinois,F,32,32,686,62,155,.400,62,154,.403,0,1,.000,62,89,.697,57,93,150,17,21,7,58,104,186,3.0
3120,Luke Meyer\luke-meyer-2,2016-17,Central Michigan,F,32,32,600,65,134,.485,47,81,.580,18,53,.340,38,46,.826,51,102,153,17,14,36,18,75,186,5.8
3121,T.J. Thomas\tj-thomas-2,2016-17,Drake,F,31,17,621,67,148,.453,64,136,.471,3,12,.250,48,78,.615,47,110,157,23,9,18,38,76,185,4.2
3122,Eric Norman\eric-norman-1,2014-15,Montana State,F,30,15,831,63,202,.312,35,97,.361,28,105,.267,31,44,.705,52,159,211,61,23,50,51,79,185,5.5
3123,Ezra Talbert\ezra-talbert-1,2015-16,Liberty,F,32,0,499,66,145,.455,41,86,.477,25,59,.424,28,35,.800,26,49,75,8,8,6,24,61,185,3.4
3124,Antravious Simmons\antravious-simmons-1,2016-17,Florida Gulf Coast,F,34,11,491,79,140,.564,78,139,.561,1,1,1.000,26,39,.667,42,75,117,13,10,6,35,80,185,3.6
3125,Malek Green\malek-green-1,2017-18,Morehead State,F,28,22,658,74,152,.487,70,139,.504,4,13,.308,33,54,.611,46,101,147,10,10,17,29,67,185,4.8
3126,Dom Hoffman\dom-hoffman-1,2015-16,Bucknell,F,30,19,562,70,141,.496,48,83,.578,22,58,.379,23,27,.852,38,100,138,49,21,10,29,72,185,5.8
3127,Michael Jacobson\michael-jacobson-1,2016-17,Nebraska,F,31,31,743,72,184,.391,68,161,.422,4,23,.174,37,57,.649,89,103,192,33,23,27,28,77,185,5.7
3128,Robert Martin\robert-martin-2,2017-18,Rice,F,31,14,618,61,143,.427,51,106,.481,10,37,.270,53,82,.646,25,68,93,28,17,2,52,56,185,3.2
3129,Evan Cummins\evan-cummins-1,2015-16,Harvard,F,30,29,712,84,137,.613,84,137,.613,0,0,,17,37,.459,45,97,142,65,14,44,43,76,185,6.4
3130,Kavin Gilder-Tilbury\kavin-gilder-tilbury-1,2013-14,Texas State,F,30,10,638,66,154,.429,38,79,.481,28,75,.373,25,44,.568,25,57,82,25,19,14,41,60,185,3.7
3131,Will Miller\will-miller-1,2013-14,Mount St. Mary's,F,33,6,517,59,150,.393,4,12,.333,55,138,.399,12,15,.800,11,33,44,17,4,0,14,36,185,3.3
3132,Tosin Mehinti\tosin-mehinti-1,2016-17,Alabama-Birmingham,F,33,16,618,69,141,.489,69,141,.489,0,0,,47,63,.746,53,85,138,30,10,33,58,82,185,4.0
3133,Kassoum Yakwe\kassoum-yakwe-1,2015-16,St. John's (NY),F,26,16,609,66,145,.455,66,145,.455,0,0,,53,102,.520,57,81,138,10,17,63,40,83,185,5.7
3134,Tyler Jones\tyler-jones-5,2016-17,Maryland-Eastern Shore,F,30,0,377,68,138,.493,51,87,.586,17,51,.333,32,45,.711,30,33,63,3,13,10,23,41,185,4.1
3135,Makur Puou\matthew-puou-1,2016-17,New Orleans,F,32,29,787,82,147,.558,82,146,.562,0,1,.000,21,43,.488,48,98,146,29,10,41,48,78,185,4.7
3136,Matt Ryan\matt-ryan-1,2015-16,Notre Dame,F,36,4,522,60,144,.417,14,21,.667,46,123,.374,19,24,.792,4,56,60,18,9,3,6,55,185,3.4
3137,Tashombe Riley\tashombe-riley-1,2014-15,South Carolina State,F,33,14,615,80,185,.432,79,181,.436,1,4,.250,24,38,.632,45,56,101,15,16,13,30,48,185,3.5
3138,Paul Rowley\paul-rowley-1,2017-18,William & Mary,F,30,4,584,63,144,.438,15,35,.429,48,109,.440,11,19,.579,8,63,71,31,11,21,27,81,185,4.0
3139,Jordan Swing\jordan-swing-1,2013-14,Alabama-Birmingham,F,31,22,675,62,166,.373,40,76,.526,22,90,.244,39,56,.696,19,88,107,63,22,6,30,56,185,4.7
3140,Aaron Epps\aaron-epps-1,2016-17,Louisiana State,F,30,19,515,71,144,.493,57,112,.509,14,32,.438,29,43,.674,55,78,133,13,5,11,41,85,185,3.9
3141,D.J. Porter\dj-porter-1,2017-18,St. Francis (NY),F,31,3,519,69,155,.445,59,108,.546,10,47,.213,37,47,.787,45,104,149,32,31,14,29,75,185,5.4
3142,Geoff Beans\geoff-beans-1,2015-16,Furman,F,34,2,562,55,135,.407,10,15,.667,45,120,.375,30,41,.732,16,57,73,23,10,7,28,72,185,3.3
3143,Rashard Kelly\rashard-kelly-1,2017-18,Wichita State,F,33,30,796,66,141,.468,64,123,.520,2,18,.111,51,86,.593,104,148,252,84,19,18,45,57,185,7.2
3144,Calen Coleman\calen-coleman-1,2013-14,Montana State,F,24,17,545,64,147,.435,26,45,.578,38,102,.373,18,26,.692,17,46,63,24,20,5,30,43,184,5.1
3145,Gabriel Aguirre\gabriel-aguirre-1,2014-15,Pacific,F,24,13,595,67,134,.500,67,134,.500,0,0,,50,90,.556,30,64,94,20,4,4,34,53,184,4.5
3146,Travon Harper\travon-harper-1,2016-17,Arkansas-Pine Bluff,F,32,18,549,67,167,.401,64,145,.441,3,22,.136,47,83,.566,39,68,107,15,17,6,55,100,184,2.0
3147,Alexis Dargenton\alexis-dargenton-1,2017-18,Utah State,F,29,18,522,59,108,.546,58,104,.558,1,4,.250,65,97,.670,36,58,94,28,12,15,43,61,184,4.7
3148,Josh Martin\josh-martin-2,2017-18,Cal Poly,F,25,11,498,65,177,.367,49,129,.380,16,48,.333,38,58,.655,23,103,126,32,9,14,51,46,184,3.9
3149,David Skara\david-skara-1,2014-15,Valparaiso,F,34,1,673,66,140,.471,52,92,.565,14,48,.292,38,47,.809,28,80,108,60,20,10,46,64,184,4.4
3150,Marquis Salmon\marquis-salmon-1,2017-18,Texas Southern,F,36,18,707,73,122,.598,72,119,.605,1,3,.333,37,64,.578,84,140,224,10,17,19,32,93,184,5.2
3151,Onno Steger\onno-steger-1,2016-17,Western Carolina,F,32,21,744,61,174,.351,22,76,.289,39,98,.398,23,35,.657,37,69,106,24,33,6,46,69,184,3.4
3152,Tosin Mehinti\tosin-mehinti-1,2015-16,Alabama-Birmingham,F,32,24,649,72,129,.558,72,129,.558,0,0,,40,76,.526,58,93,151,38,15,33,48,90,184,4.9
3153,Xavier Habersham\xavier-habersham-1,2016-17,Middle Tennessee,F,36,11,701,65,129,.504,26,43,.605,39,86,.453,15,21,.714,21,42,63,61,13,3,32,65,184,4.0
3154,Aaron Bowen\aaron-bowen-1,2014-15,Georgetown,F,33,0,496,74,140,.529,65,110,.591,9,30,.300,27,52,.519,26,41,67,32,28,8,36,51,184,4.1
3155,Isaiah Thomas\isaiah-thomas-2,2017-18,Northern Arizona,F,32,27,637,79,148,.534,79,148,.534,0,0,,26,45,.578,58,102,160,5,7,36,31,88,184,4.5
3156,Michael Weisner\michael-weisner-1,2014-15,Montana,F,28,7,640,59,156,.378,22,52,.423,37,104,.356,29,37,.784,10,55,65,42,24,7,35,75,184,4.0
3157,Jalen Tate\jalen-tate-1,2017-18,Northern Kentucky,F,32,32,732,71,151,.470,65,123,.528,6,28,.214,35,55,.636,9,63,72,65,44,19,37,102,183,4.6
3158,Matt Kamieniecki\matt-kamieniecki-1,2014-15,Ball State,F,22,22,466,60,123,.488,59,122,.484,1,1,1.000,62,112,.554,52,100,152,18,20,15,32,73,183,6.8
3159,Dantiel Daniels\dantiel-daniels-1,2014-15,Colorado State,F,32,32,659,66,105,.629,66,105,.629,0,0,,51,117,.436,74,80,154,28,12,15,30,56,183,5.5
3160,Amdy Fall\amdy-fall-1,2015-16,St. Francis (NY),F,32,32,786,59,129,.457,58,128,.453,1,1,1.000,64,101,.634,74,143,217,25,26,75,48,94,183,6.5
3161,Brandon Carroll\brandon-carroll-1,2017-18,Bryant,F,31,12,498,67,150,.447,60,119,.504,7,31,.226,42,63,.667,38,81,119,15,18,10,32,68,183,4.0
3162,Devonte Campbell\devonte-campbell-1,2016-17,Albany (NY),F,26,16,646,56,120,.467,44,84,.524,12,36,.333,59,77,.766,44,81,125,29,18,7,30,45,183,6.3
3163,Dimitri Spasojevic\dimitri-spasojevic-1,2017-18,East Carolina,F,30,25,717,82,145,.566,82,145,.566,0,0,,19,46,.413,41,80,121,20,10,13,47,66,183,3.9
3164,Josh Davenport\josh-davenport-1,2016-17,Winthrop,F,33,4,645,58,134,.433,57,124,.460,1,10,.100,66,89,.742,32,115,147,57,27,10,46,53,183,5.1
3165,Jaren Jeffery\jaren-jeffery-1,2013-14,Southern Utah,F,29,10,515,67,139,.482,58,111,.523,9,28,.321,40,70,.571,36,76,112,18,19,16,28,92,183,4.4
3166,B.J. Gladden\bj-gladden-1,2016-17,Georgia Southern,F,33,5,660,54,145,.372,43,93,.462,11,52,.212,64,118,.542,23,115,138,27,20,16,43,64,183,3.4
3167,Marvin Baynham\marvin-baynham-1,2013-14,Georgia Southern,F,34,29,819,70,111,.631,70,111,.631,0,0,,43,71,.606,71,119,190,11,22,13,54,106,183,4.4
3168,Ryan Mikesell\ryan-mikesell-1,2016-17,Dayton,F,32,23,665,65,143,.455,46,86,.535,19,57,.333,34,50,.680,37,88,125,28,20,17,34,77,183,4.4
3169,Reggie McAdams\reggie-mcadams-1,2013-14,Akron,F,29,14,547,60,129,.465,12,16,.750,48,113,.425,15,20,.750,19,42,61,12,11,7,7,39,183,4.9
3170,Brandon Rosser\brandon-rosser-1,2017-18,UC-Riverside,F,31,28,646,66,144,.458,52,100,.520,14,44,.318,37,54,.685,30,82,112,28,9,20,35,93,183,3.8
3171,DaJuan Coleman\dajuan-coleman-1,2015-16,Syracuse,F,37,37,649,68,124,.548,68,124,.548,0,0,,46,70,.657,68,103,171,15,27,33,41,102,182,4.6
3172,DeVon Barnett\devon-barnett-1,2017-18,Sacred Heart,F,22,5,420,79,151,.523,79,151,.523,0,0,,24,41,.585,28,70,98,11,5,8,35,53,182,4.7
3173,Sidney Umude\sidney-umude-1,2017-18,Southern,F,22,2,403,69,146,.473,69,144,.479,0,2,.000,44,66,.667,39,63,102,9,7,11,27,36,182,5.7
3174,Will Magarity\will-magarity-1,2017-18,Davidson,F,32,1,645,76,138,.551,55,83,.663,21,55,.382,9,15,.600,39,95,134,20,13,21,30,63,182,4.9
3175,Nathan Ekwu\nathan-ekwu-1,2015-16,Davidson,F,32,24,639,61,122,.500,60,113,.531,1,9,.111,59,90,.656,66,122,188,26,13,37,27,103,182,5.6
3176,Brandon Hollins\brandon-hollins-1,2016-17,Portland State,F,30,3,416,76,126,.603,75,114,.658,1,12,.083,29,69,.420,37,67,104,12,24,8,26,72,182,4.6
3177,Justin Gordon\justin-gordon-1,2013-14,Wofford,F,33,9,594,78,153,.510,78,151,.517,0,2,.000,26,58,.448,60,48,108,25,18,5,40,86,182,3.5
3178,Devon Brewer\devon-brewer-1,2017-18,Alcorn State,F,31,24,717,76,137,.555,76,137,.555,0,0,,30,65,.462,26,103,129,25,8,22,48,86,182,3.6
3179,Nick Smith\nick-smith-3,2015-16,Belmont,F,28,0,352,58,143,.406,12,15,.800,46,128,.359,20,29,.690,14,36,50,9,6,1,14,46,182,3.7
3180,Marcus Bryan\marcus-bryan-1,2017-18,North Carolina-Wilmington,F,32,32,877,72,163,.442,72,163,.442,0,0,,38,67,.567,81,139,220,34,13,17,31,67,182,5.5
3181,Oskar Michelsen\oskar-michelson-1,2017-18,Davidson,F,33,33,549,63,133,.474,26,39,.667,37,94,.394,19,26,.731,21,60,81,23,14,8,20,92,182,3.7
3182,Tory Stewart-Miller\tory-stewart-miller-1,2015-16,Colorado,F,33,4,520,69,147,.469,69,143,.483,0,4,.000,44,72,.611,64,87,151,6,10,12,35,53,182,4.0
3183,Wesley Gordon\wesley-gordon-1,2013-14,Colorado,F,31,27,779,67,141,.475,63,130,.485,4,11,.364,44,73,.603,76,110,186,29,13,41,49,55,182,5.7
3184,Justin Gray\justin-gray-2,2017-18,Texas Tech,F,36,36,772,66,142,.465,60,119,.504,6,23,.261,44,55,.800,42,96,138,38,30,21,28,88,182,4.7
3185,Terry Winn\terry-winn-1,2017-18,Texas-Rio Grande Valley,F,19,17,372,66,158,.418,64,151,.424,2,7,.286,48,63,.762,37,93,130,17,6,7,27,45,182,6.5
3186,Braxton Key\braxton-key-1,2017-18,Alabama,F,26,17,656,65,159,.409,49,95,.516,16,64,.250,36,54,.667,37,101,138,48,27,11,46,51,182,5.7
3187,Raynere Thornton\raynere-thornton-1,2017-18,Memphis,F,34,11,702,58,128,.453,38,75,.507,20,53,.377,46,84,.548,37,95,132,40,21,4,38,54,182,4.3
3188,Darius Leonard\darius-leonard-1,2014-15,Wake Forest,F,32,19,557,71,180,.394,42,84,.500,29,96,.302,11,23,.478,32,47,79,10,10,10,15,52,182,3.3
3189,V.J. King\vj-king-1,2016-17,Louisville,F,33,7,444,60,139,.432,44,101,.436,16,38,.421,46,56,.821,17,51,68,16,7,3,22,25,182,3.6
3190,Curtis Washington\curtis-washington-1,2014-15,Georgia State,F,35,21,599,70,125,.560,70,125,.560,0,0,,42,54,.778,60,87,147,7,11,44,30,75,182,4.9
3191,Brandon Parrish\brandon-parrish-1,2014-15,Texas Christian,F,33,15,618,64,160,.400,41,95,.432,23,65,.354,31,53,.585,19,37,56,17,20,14,31,49,182,3.1
3192,Mamadi Diakite\mamadi-diakite-1,2017-18,Virginia,F,34,0,532,75,130,.577,75,130,.577,0,0,,32,41,.780,31,70,101,5,15,16,26,74,182,3.9
3193,Nate Rucker\nate-rucker-1,2013-14,Kennesaw State,F,20,11,441,68,132,.515,68,130,.523,0,2,.000,46,79,.582,21,51,72,8,17,7,35,60,182,5.1
3194,Nathan Dieudonne\nathan-dieudonne-1,2013-14,Boston University,F,35,34,724,65,128,.508,53,87,.609,12,41,.293,40,51,.784,41,123,164,16,8,11,47,83,182,3.6
3195,Abdoulaye Gueye\abdoulaye-gueye-1,2017-18,Georgia Tech,F,31,23,672,71,152,.467,69,141,.489,2,11,.182,38,63,.603,54,83,137,33,20,33,44,88,182,4.6
3196,Cordell Pemsl\cordell-pemsl-1,2017-18,Iowa,F,32,0,525,65,115,.565,65,115,.565,0,0,,51,76,.671,38,106,144,47,7,10,45,53,181,4.9
3197,Rodney Williams\rodney-williams-5,2014-15,Drexel,F,22,14,672,71,164,.433,71,163,.436,0,1,.000,39,66,.591,55,99,154,28,8,34,37,64,181,6.4
3198,Theo Pinson\theo-pinson-1,2015-16,North Carolina,F,40,7,747,59,146,.404,41,83,.494,18,63,.286,45,67,.672,43,84,127,115,24,10,49,69,181,4.6
3199,Malik Garner\malik-garner-1,2013-14,Maryland-Baltimore County,F,30,19,652,69,159,.434,54,103,.524,15,56,.268,28,47,.596,35,47,82,35,15,5,30,49,181,4.1
3200,Jordan Robinson\jordan-robinson-1,2017-18,Duquesne,F,32,4,596,73,141,.518,73,140,.521,0,1,.000,35,57,.614,48,76,124,21,8,13,20,78,181,4.43201,
3201,Darion Clark\darion-clark-1,2014-15,Southern California,F,32,16,705,65,150,.433,65,149,.436,0,1,.000,51,94,.543,58,124,182,26,14,18,48,55,181,4.3
3202,Michael Zangari\michael-zangari-1,2015-16,East Carolina,F,31,17,662,59,147,.401,46,96,.479,13,51,.255,50,68,.735,47,72,119,23,10,6,28,85,181,3.8
3203,Justin Browning\justin-browning-1,2014-15,Western Carolina,F,31,12,775,64,116,.552,56,90,.622,8,26,.308,45,62,.726,44,94,138,49,45,27,48,117,181,5.8
3204,Tarik Black\tarik-black-1,2013-14,Kansas,F,33,15,446,74,107,.692,74,106,.698,0,1,.000,33,55,.600,41,87,128,9,10,17,23,93,181,4.5
3205,Reid Koenen\reid-koenen-1,2013-14,Texas State,F,30,20,568,60,147,.408,28,56,.500,32,91,.352,29,42,.690,18,49,67,20,9,6,26,36,181,3.7
3206,Nick Havener\nick-havener-1,2017-18,Boston University,F,27,11,406,78,145,.538,77,142,.542,1,3,.333,24,38,.632,39,63,102,26,21,24,44,78,181,4.9
3207,Chris Bryant\chris-bryant-2,2015-16,Miami (OH),F,31,18,556,67,130,.515,67,130,.515,0,0,,47,73,.644,46,71,117,6,17,10,30,63,181,4.3
3208,Obi Enechionyia\obi-enechionyia-1,2014-15,Temple,F,34,4,635,66,147,.449,54,104,.519,12,43,.279,37,47,.787,45,79,124,14,11,45,17,81,181,4.7
3209,Justin Leon\justin-leon-1,2015-16,Florida,F,34,11,506,72,146,.493,47,79,.595,25,67,.373,12,26,.462,46,61,107,11,10,5,21,52,181,3.9
3210,Mitchell Solomon\mitchell-solomon-1,2016-17,Oklahoma State,F,33,22,662,61,123,.496,61,119,.513,0,4,.000,58,75,.773,102,73,175,29,13,39,39,122,180,5.4
3211,Kamari Murphy\kamari-murphy-1,2015-16,Miami (FL),F,32,28,797,78,153,.510,78,146,.534,0,7,.000,24,43,.558,47,144,191,16,13,30,26,68,180,5.1
3212,Michal Cekovsky\michal-cekovsky-1,2017-18,Maryland,F,28,19,472,75,112,.670,75,111,.676,0,1,.000,30,47,.638,30,55,85,11,6,27,28,67,180,5.0
3213,Duje Dukan\duje-dukan-1,2014-15,Wisconsin,F,38,0,605,60,155,.387,31,64,.484,29,91,.319,31,46,.674,28,70,98,24,8,3,25,48,180,3.0
3214,Jarelle Reischel\jarelle-reischel-1,2013-14,Rhode Island,F,32,7,618,59,138,.428,46,100,.460,13,38,.342,49,82,.598,23,59,82,28,21,3,39,74,180,3.2
3215,Jeremy Watson\jeremy-watson-1,2014-15,Jacksonville State,F,31,9,646,50,128,.391,47,119,.395,3,9,.333,77,107,.720,62,96,158,9,10,7,27,37,180,4.8
3216,Tory Stewart-Miller\tory-stewart-miller-1,2016-17,Colorado,F,32,4,506,73,136,.537,72,133,.541,1,3,.333,33,62,.532,38,89,127,16,9,7,27,81,180,3.8
3217,Makinde London\makinde-london-1,2016-17,Chattanooga,F,30,9,460,66,149,.443,44,79,.557,22,70,.314,26,39,.667,22,82,104,22,21,17,45,62,180,3.8
3218,Quinton Stephens\quinton-stephens-1,2014-15,Georgia Tech,F,30,12,566,67,194,.345,35,87,.402,32,107,.299,14,19,.737,32,54,86,13,15,13,21,38,180,3.5
3219,Lew Evans\lew-evans-1,2013-14,Tulsa,F,34,22,699,63,183,.344,34,71,.479,29,112,.259,25,43,.581,33,107,140,21,11,5,38,112,180,2.1
3220,Trey Wade\trey-wade-1,2017-18,Texas-El Paso,F,25,6,444,77,160,.481,59,108,.546,18,52,.346,8,24,.333,29,75,104,9,10,23,18,40,180,5.3
3221,Jacara Cross\jacara-cross-1,2016-17,Jacksonville State,F,33,11,399,69,128,.539,69,128,.539,0,0,,42,59,.712,37,51,88,7,4,23,46,100,180,2.8
3222,Paul Gombwer\paul-gombwer-1,2013-14,Charleston Southern,F,31,27,659,69,153,.451,51,104,.490,18,49,.367,24,35,.686,74,130,204,26,18,2,35,75,180,5.1
3223,Tom Vodanovich\tom-vodanovich-1,2016-17,James Madison,F,29,18,591,69,146,.473,56,102,.549,13,44,.295,28,41,.683,29,78,107,32,16,7,55,77,179,3.5
3224,Coleman Johnson\coleman-johnson-1,2013-14,Fairfield,F,32,28,660,72,183,.393,72,182,.396,0,1,.000,35,54,.648,51,93,144,24,14,30,39,113,179,3.2
3225,Max Montana\max-montana-1,2017-18,San Diego State,F,26,0,426,59,152,.388,18,39,.462,41,113,.363,20,28,.714,19,58,77,20,9,4,19,47,179,4.3
3226,Logan Primerano\logan-primerano-1,2015-16,Massachusetts-Lowell,F,28,1,456,59,129,.457,47,93,.505,12,36,.333,49,63,.778,14,46,60,31,17,7,33,55,179,4.2
3227,Tyler Roberson\tyler-roberson-1,2016-17,Syracuse,F,34,6,692,77,136,.566,77,136,.566,0,0,,25,56,.446,65,102,167,30,18,27,37,70,179,5.0
3228,Clint Robinson\clint-robinson-1,2016-17,Illinois-Chicago,F,35,6,523,47,102,.461,47,102,.461,0,0,,85,119,.714,88,94,182,8,9,29,35,83,179,4.8
3229,Quinton Stephens\quinton-stephens-1,2015-16,Georgia Tech,F,36,14,725,63,172,.366,32,75,.427,31,97,.320,22,30,.733,38,97,135,39,10,15,32,54,179,3.6
3230,Milos Vranes\milos-vranes-1,2016-17,Southeast Missouri State,F,31,0,569,63,129,.488,35,53,.660,28,76,.368,25,39,.641,30,71,101,17,22,2,21,79,179,4.3
3231,Boo Milligan\michael-milligan-1,2014-15,Central Arkansas,F,25,11,590,62,159,.390,41,92,.446,21,67,.313,34,51,.667,23,58,81,36,36,1,50,68,179,4.2
3232,Maurice Jeffers\maurice-jeffers-2,2016-17,Boston College,F,32,31,651,75,151,.497,75,151,.497,0,0,,29,53,.547,63,117,180,16,12,17,45,89,179,4.0
3233,Alonzo Nelson-Ododa\alonzo-nelson-ododa-1,2014-15,Richmond,F,27,7,625,57,126,.452,47,89,.528,10,37,.270,55,68,.809,29,108,137,30,16,45,31,57,179,6.5
3234,Kahlil Thomas\kahlil-thomas-1,2013-14,Rider,F,31,20,600,72,150,.480,70,147,.476,2,3,.667,33,44,.750,40,64,104,25,23,26,38,89,179,4.2
3235,Franko House\franko-house-1,2013-14,Ball State,F,30,21,671,66,148,.446,60,126,.476,6,22,.273,41,67,.612,58,97,155,35,12,6,38,103,179,4.1
3236,Desmond Ringer\desmond-ringer-1,2015-16,Mercer,F,23,23,574,71,116,.612,71,116,.612,0,0,,37,46,.804,36,69,105,14,5,18,41,54,179,5.8
3237,Luke Petrasek\luke-petrasek-1,2013-14,Columbia,F,34,18,637,64,154,.416,47,87,.540,17,67,.254,34,48,.708,28,82,110,31,6,23,40,80,179,3.2
3238,Oskar Michelsen\oskar-michelson-1,2014-15,Davidson,F,32,5,570,60,156,.385,19,40,.475,41,116,.353,18,26,.692,12,48,60,27,10,5,16,47,179,3.5
3239,Bonzie Colson\bonzie-colson-1,2014-15,Notre Dame,F,32,1,386,66,111,.595,65,104,.625,1,7,.143,46,61,.754,27,59,86,13,19,22,14,42,179,5.3
3240,Brandon Perry\brandon-perry-2,2014-15,San Diego,F,29,6,382,64,125,.512,64,125,.512,0,0,,51,93,.548,50,48,98,7,6,7,32,72,179,3.6
3241,Nathan Adrian\nathan-adrian-1,2013-14,West Virginia,F,33,18,625,64,154,.416,25,45,.556,39,109,.358,12,18,.667,47,50,97,24,30,20,15,93,179,4.6
3242,Alfred Hollins\alfred-hollins-1,2017-18,Oregon State,F,31,7,429,60,123,.488,46,84,.548,14,39,.359,45,68,.662,23,59,82,14,18,9,25,67,179,4.0
3243,Bobby Planutis\bobby-planutis-1,2017-18,Mount St. Mary's,F,32,25,759,55,116,.474,22,49,.449,33,67,.493,36,40,.900,24,102,126,22,15,20,40,79,179,4.3
3244,Elijah Thomas\elijah-thomas-1,2016-17,Clemson,F,24,9,405,78,135,.578,78,134,.582,0,1,.000,23,48,.479,31,70,101,7,17,28,20,85,179,5.7
3245,Wesley Iwundu\wesley-iwundu-1,2014-15,Kansas State,F,31,24,780,63,156,.404,57,137,.416,6,19,.316,47,79,.595,34,74,108,61,23,20,62,65,179,3.9
3246,Wayde Sims\wayde-sims-1,2017-18,Louisiana State,F,32,10,557,73,142,.514,64,106,.604,9,36,.250,24,37,.649,33,61,94,12,15,21,22,60,179,4.3
3247,Nik Popovic\nik-popovic-1,2016-17,Boston College,F,29,1,401,78,159,.491,73,142,.514,5,17,.294,17,32,.531,32,69,101,13,3,9,30,71,178,3.3
3248,Sam Hughes\sam-hughes-1,2014-15,North Carolina-Asheville,F,29,17,564,70,161,.435,52,113,.460,18,48,.375,20,29,.690,26,80,106,24,25,4,48,71,178,3.5
3249,Kyle Zunic\kyle-zunic-1,2017-18,Winthrop,F,26,9,489,62,145,.428,30,59,.508,32,86,.372,22,29,.759,3,31,34,33,15,3,38,32,178,3.8
3250,Cedric Council Jr.\cedric-counciljr-1,2017-18,Coppin State,F,32,30,776,70,177,.395,54,117,.462,16,60,.267,22,37,.595,49,81,130,24,23,30,30,90,178,4.0
3251,Ty Egbert\ty-egbert-1,2015-16,Idaho,F,27,8,482,62,112,.554,62,112,.554,0,0,,54,80,.675,33,73,106,10,9,22,27,48,178,5.3
3252,Latrell Love\latrell-love-1,2014-15,Mississippi Valley State,F,30,13,498,59,137,.431,59,136,.434,0,1,.000,60,85,.706,27,37,64,14,8,5,28,48,178,3.3
3253,Dockery Walker\dockery-walker-1,2013-14,Brown,F,29,2,380,71,137,.518,71,136,.522,0,1,.000,36,68,.529,45,83,128,9,8,10,40,79,178,3.6
3254,Aaron Brennan\aaron-brennan-1,2014-15,IUPUI,F,28,24,585,71,136,.522,68,128,.531,3,8,.375,33,46,.717,36,52,88,27,21,7,44,72,178,4.2
3255,Eric Moreland\eric-moreland-1,2013-14,Oregon State,F,20,19,588,66,130,.508,65,128,.508,1,2,.500,45,81,.556,46,159,205,28,13,39,45,49,178,8.7
3256,Treshawn Bolden\treshawn-bolden-1,2014-15,Jackson State,F,32,30,658,63,174,.362,63,172,.366,0,2,.000,52,87,.598,32,94,126,28,11,17,75,80,178,1.7
3257,David Kadiri\david-kadiri-1,2016-17,Buffalo,F,31,19,503,80,128,.625,80,127,.630,0,1,.000,18,36,.500,51,77,128,8,8,22,16,84,178,4.9
3258,Juan Davis Jr.\juan-davisjr-1,2017-18,Troy,F,31,13,660,61,147,.415,28,57,.491,33,90,.367,23,33,.697,43,99,142,5,6,9,19,71,178,4.0
3259,Amanze Egekeze\amanze-egekeze-1,2014-15,Belmont,F,33,23,661,55,136,.404,28,56,.500,27,80,.338,41,49,.837,32,73,105,22,27,18,26,65,178,4.5
3260,Jalen Moore\jalen-moore-1,2013-14,Utah State,F,32,5,559,66,125,.528,52,89,.584,14,36,.389,32,45,.711,27,59,86,24,12,9,19,38,178,4.7
3261,Reggie Cameron\reggie-cameron-1,2015-16,Georgetown,F,32,6,555,57,142,.401,21,41,.512,36,101,.356,28,36,.778,14,51,65,39,5,3,27,46,178,3.5
3262,Mason Ramsey\mason-ramsay-1,2015-16,Tennessee Tech,F,31,1,507,65,130,.500,54,94,.574,11,36,.306,37,50,.740,25,50,75,14,17,10,18,88,178,3.9
3263,Shaheed Davis\shaheed-davis-1,2015-16,Central Florida,F,30,12,581,64,175,.366,43,97,.443,21,78,.269,29,53,.547,37,95,132,20,5,6,47,33,178,3.0
3264,Dallas Gary\dallas-gary-1,2013-14,Coppin State,F,30,7,485,54,123,.439,46,95,.484,8,28,.286,61,89,.685,19,60,79,21,8,1,37,33,177,3.5
3265,OG Anunoby\og-anunoby-1,2016-17,Indiana,F,16,10,402,68,122,.557,54,77,.701,14,45,.311,27,48,.563,28,59,87,23,21,21,26,33,177,10.0
3266,Lavelle Scottie\lavelle-scottie-1,2016-17,Air Force,F,33,4,473,61,138,.442,51,114,.447,10,24,.417,45,65,.692,22,82,104,30,13,11,28,45,177,4.0
3267,Christian Musoko\christian-musoko-1,2017-18,Southern Utah,F,29,14,471,71,124,.573,71,124,.573,0,0,,35,61,.574,36,84,120,11,5,16,29,95,177,4.0
3268,Jake Zuilhof\jake-zuilhof-1,2015-16,Central Arkansas,F,28,28,710,69,122,.566,69,122,.566,0,0,,39,76,.513,66,121,187,18,10,37,51,102,177,5.1
3269,Mitch Brewe\mitch-brewe-1,2015-16,UC-Santa Barbara,F,33,0,522,67,133,.504,65,119,.546,2,14,.143,41,55,.745,46,59,105,20,18,9,17,67,177,4.5
3270,Alec Wnuk\alec-wnuk-1,2017-18,North Carolina-Asheville,F,34,14,674,73,133,.549,70,117,.598,3,16,.188,28,44,.636,29,58,87,43,11,5,56,88,177,2.9
3271,Luke Meyer\luke-meyer-2,2014-15,Central Michigan,F,32,32,508,65,103,.631,58,84,.690,7,19,.368,40,52,.769,24,65,89,14,9,17,24,65,177,4.5
3272,Travin Thibodeaux\travin-thibodeaux-1,2015-16,New Orleans,F,30,20,603,71,140,.507,71,140,.507,0,0,,35,78,.449,58,114,172,33,32,14,57,101,177,4.4
3273,Milos Vranes\milos-vranes-1,2017-18,Southeast Missouri State,F,30,17,566,64,142,.451,31,57,.544,33,85,.388,16,30,.533,29,91,120,18,12,6,43,62,177,3.5
3274,Connor Schroeder\connor-schroeder-1,2015-16,Citadel,F,30,4,305,63,175,.360,25,45,.556,38,130,.292,13,21,.619,22,53,75,15,8,2,8,32,177,3.6
3275,Franz Rassman\will-rassman-1,2013-14,Loyola (MD),F,30,29,627,74,161,.460,65,137,.474,9,24,.375,20,29,.690,41,87,128,17,19,11,35,76,177,3.9
3276,Jamar Akoh\jamar-akoh-1,2015-16,Cal State Fullerton,F,29,27,762,61,157,.389,60,149,.403,1,8,.125,54,89,.607,58,125,183,43,13,9,54,68,177,4.3
3277,Matt Haarms\matt-haarms-1,2017-18,Purdue,F,37,2,634,72,123,.585,71,116,.612,1,7,.143,32,59,.542,35,83,118,23,11,79,30,93,177,4.7
3278,Darious Hall\darious-hall-1,2017-18,Arkansas,F,35,5,519,64,128,.500,51,96,.531,13,32,.406,36,64,.563,32,78,110,16,18,8,39,72,177,3.3
3279,Jordan Weethee\jordan-weethee-1,2014-15,Virginia Military Institute,F,30,23,549,57,160,.356,24,58,.414,33,102,.324,30,41,.732,33,83,116,30,18,2,38,55,177,3.7
3280,Montae Glenn\montae-glenn-1,2016-17,Georgia Southern,F,33,21,618,72,121,.595,72,121,.595,0,0,,33,60,.550,92,70,162,5,11,17,30,84,177,4.8
3281,Jordan Bell\jordan-bell-1,2014-15,Oregon,F,35,20,831,83,139,.597,83,139,.597,0,0,,11,22,.500,66,148,214,47,28,94,37,95,177,7.2
3282,Sam Jones\sam-jones-1,2014-15,Pennsylvania,F,28,4,455,61,151,.404,10,33,.303,51,118,.432,4,7,.571,8,49,57,13,10,5,15,35,177,3.9
3283,Ed Jones\edward-jones-1,2017-18,Alabama State,F,28,19,570,73,176,.415,64,137,.467,9,39,.231,22,30,.733,38,55,93,5,11,25,28,69,177,3.5
3284,Alex Reed\alex-reed-1,2017-18,Citadel,F,32,12,456,55,142,.387,23,47,.489,32,95,.337,34,48,.708,31,47,78,25,26,3,22,61,176,4.0
3285,Del'Vin Dickerson\delvin-dickerson-1,2014-15,Bowling Green State,F,31,5,473,67,171,.392,46,98,.469,21,73,.288,21,39,.538,18,56,74,12,11,5,21,92,176,2.3
3286,Ray Lester\ray-lester-1,2013-14,Southern Illinois-Edwardsville,F,31,29,558,64,137,.467,64,135,.474,0,2,.000,48,104,.462,47,78,125,11,23,6,48,90,176,2.9
3287,Thomas Bruce\thomas-bruce-1,2015-16,Binghamton,F,26,19,715,68,126,.540,68,126,.540,0,0,,40,84,.476,46,83,129,22,12,26,38,54,176,5.4
3288,Elmo Stephen\elmo-stephen-1,2015-16,Florida International,F,23,1,448,57,146,.390,19,45,.422,38,101,.376,24,38,.632,19,49,68,8,7,4,16,42,176,4.4
3289,Xavier Harris\xavier-harris-1,2014-15,Fairleigh Dickinson,F,28,11,543,72,146,.493,72,146,.493,0,0,,32,56,.571,55,84,139,19,15,30,38,90,176,4.7
3290,Pat Andree\pat-andree-1,2016-17,Lehigh,F,27,6,529,64,158,.405,24,55,.436,40,103,.388,8,15,.533,16,87,103,17,7,9,28,43,176,3.9
3291,Goodluck Okonoboh\goodluck-okonoboh-1,2014-15,Nevada-Las Vegas,F,31,29,827,75,144,.521,75,144,.521,0,0,,26,77,.338,57,83,140,21,15,90,29,87,176,5.8
3292,Rod Days\rod-days-1,2015-16,Campbell,F,30,12,600,61,119,.513,34,53,.642,27,66,.409,27,41,.659,24,81,105,21,22,10,29,59,176,4.8
3293,Henry Caruso\henry-caruso-1,2014-15,Princeton,F,29,6,402,50,95,.526,40,72,.556,10,23,.435,66,81,.815,22,62,84,18,6,0,33,43,176,4.3
3294,Zach Charles\zach-charles-1,2017-18,Eastern Kentucky,F,30,18,602,62,118,.525,54,103,.524,8,15,.533,44,66,.667,49,91,140,23,14,29,25,65,176,5.7
3295,Mitchell Hahn\mitchell-hahn-1,2017-18,Omaha,F,15,15,456,56,166,.337,33,85,.388,23,81,.284,41,55,.745,13,93,106,27,15,6,18,29,176,8.1
3296,Anas Mahmoud\anas-mahmoud-1,2016-17,Louisville,F,31,15,580,76,122,.623,76,122,.623,0,0,,24,52,.462,47,77,124,26,27,65,35,82,176,6.1
3297,Marvin Clark\marvin-clark-1,2014-15,Michigan State,F,39,7,437,64,127,.504,43,65,.662,21,62,.339,27,40,.675,30,56,86,11,9,12,29,67,176,2.9
3298,Mike Aaman\mike-aaman-2,2014-15,Wagner,F,17,9,394,65,165,.394,65,165,.394,0,0,,46,68,.676,75,83,158,5,10,16,21,40,176,8.4
3299,Jamel Artis\jamel-artis-1,2013-14,Pittsburgh,F,36,0,556,58,126,.460,50,99,.505,8,27,.296,51,72,.708,38,68,106,23,6,10,29,54,175,3.5
3300,Brett Roseboro\brett-roseboro-1,2013-14,Maryland-Baltimore County,F,29,20,484,65,141,.461,61,130,.469,4,11,.364,41,55,.745,43,86,129,10,15,22,50,81,175,3.7
3301,Brandon Conley\brandon-conley-1,2013-14,Oral Roberts,F,32,19,579,66,99,.667,66,99,.667,0,0,,43,73,.589,59,84,143,9,11,36,37,107,175,4.7
3302,Toby Hegner\toby-hegner-1,2016-17,Creighton,F,35,0,585,58,123,.472,26,52,.500,32,71,.451,27,42,.643,26,92,118,16,13,9,14,66,175,4.1
3303,Chris Wray\chris-wray-1,2015-16,Mount St. Mary's,F,30,24,505,80,143,.559,80,142,.563,0,1,.000,15,45,.333,70,53,123,17,32,32,27,61,175,5.8
3304,Marvin Smith\marvin-smith-1,2015-16,South Carolina Upstate,F,31,21,648,69,132,.523,68,129,.527,1,3,.333,36,55,.655,45,99,144,24,11,7,46,65,175,4.0
3305,Henry Brooks\henry-brooks-1,2015-16,Wagner,F,33,25,580,80,188,.426,80,187,.428,0,1,.000,15,26,.577,46,50,96,18,22,25,41,122,175,2.4
3306,Dwayne Morgan\dwayne-morgan-1,2014-15,Nevada-Las Vegas,F,33,4,560,66,172,.384,60,155,.387,6,17,.353,37,52,.712,41,57,98,13,19,9,33,90,175,2.6
3307,Ian Kinard\ian-kinard-1,2017-18,South Carolina State,F,32,25,612,45,122,.369,37,99,.374,8,23,.348,77,108,.713,36,90,126,14,8,18,39,97,175,3.1
3308,Tre Hale-Edmerson\tre-hale-edmerson-1,2014-15,Cal State Northridge,F,33,33,1044,77,167,.461,66,133,.496,11,34,.324,10,14,.714,20,156,176,83,39,44,62,114,175,5.1
3309,Danny Robison\danny-robison-1,2015-16,Montana State,F,31,18,677,56,126,.444,45,83,.542,11,43,.256,52,75,.693,63,59,122,14,14,8,31,102,175,3.9
3310,Quinn Taylor\quinn-taylor-1,2016-17,Utah State,F,32,8,595,74,134,.552,67,116,.578,7,18,.389,20,33,.606,50,81,131,30,13,6,26,83,175,4.5
3311,Devonnte Holland\devonnte-holland-1,2017-18,Radford,F,36,4,540,70,137,.511,70,136,.515,0,1,.000,35,55,.636,55,67,122,13,8,14,50,93,175,2.7
3312,Rod Mills\rod-mills-1,2015-16,Miami (OH),F,33,18,643,65,183,.355,37,92,.402,28,91,.308,17,24,.708,15,67,82,15,14,1,37,69,175,1.9
3313,Desi Rodriguez\desi-rodriguez-1,2014-15,Seton Hall,F,31,2,514,62,139,.446,61,127,.480,1,12,.083,50,83,.602,52,87,139,14,25,9,24,71,175,4.5
3314,Collin Hartman\collin-hartman-1,2015-16,Indiana,F,35,24,765,65,144,.451,36,63,.571,29,81,.358,16,19,.842,35,74,109,60,28,10,37,100,175,4.2
3315,Michel Enanga\michel-enanga-1,2013-14,Coastal Carolina,F,34,19,728,61,144,.424,49,95,.516,12,49,.245,41,73,.562,65,113,178,34,30,16,50,102,175,4.1
3316,Chris Shields\chris-shields-1,2016-17,Longwood,F,30,16,718,68,153,.444,45,96,.469,23,57,.404,16,23,.696,11,75,86,28,11,6,63,78,175,2.1
3317,Jarquez Smith\jarquez-smith-1,2015-16,Florida State,F,34,1,490,72,131,.550,70,119,.588,2,12,.167,29,41,.707,40,79,119,7,14,34,36,79,175,3.9
3318,Isaac Taylor\isaac-taylor-1,2016-17,Maryland-Eastern Shore,F,34,33,524,65,141,.461,65,141,.461,0,0,,45,60,.750,42,44,86,17,7,9,45,95,175,2.4
3319,Ryan Manning\ryan-manning-1,2017-18,Air Force,F,28,14,446,58,152,.382,28,53,.528,30,99,.303,29,38,.763,25,59,84,15,10,5,24,35,175,3.9
3320,Kosta Jankovic\kosta-jankovic-1,2017-18,Kennesaw State,F,25,12,525,68,148,.459,60,124,.484,8,24,.333,31,42,.738,23,58,81,39,4,4,33,38,175,4.5
3321,Will Miller\will-miller-1,2015-16,Mount St. Mary's,F,33,7,650,56,173,.324,7,19,.368,49,154,.318,13,15,.867,4,59,63,13,8,0,8,22,174,2.9
3322,Gerson Santo\gerson-santo-1,2013-14,Colorado State,F,31,30,729,64,109,.587,64,109,.587,0,0,,46,72,.639,61,67,128,13,15,17,22,79,174,5.1
3323,Pete Miller\pete-miller-1,2014-15,Princeton,F,30,23,557,73,134,.545,73,134,.545,0,0,,28,66,.424,18,56,74,36,14,35,43,68,174,3.9
3324,Philip Whittington\philip-whittington-1,2015-16,South Carolina Upstate,F,28,1,368,77,154,.500,77,153,.503,0,1,.000,20,30,.667,30,95,125,14,9,19,32,44,174,4.5
3325,Thaddeus Handley\thaddeus-handley-1,2014-15,Arkansas-Pine Bluff,F,31,17,557,69,147,.469,59,111,.532,10,36,.278,26,51,.510,36,56,92,21,23,4,40,58,174,3.5
3326,Kavon Waller\kavon-waller-1,2017-18,Delaware State,F,25,20,711,63,193,.326,26,67,.388,37,126,.294,11,18,.611,19,73,92,45,6,9,36,41,174,3.5
3327,Brandon Alston\brandon-alston-2,2017-18,Georgia Tech,F,32,19,758,56,150,.373,35,91,.385,21,59,.356,41,58,.707,18,39,57,50,11,1,36,48,174,3.1
3328,Iggy Nujic\igor-nujic-1,2013-14,UC-Davis,F,25,10,527,61,154,.396,40,88,.455,21,66,.318,31,45,.689,17,67,84,17,8,5,38,67,174,3.0
3329,Davonte Fitzgerald\davonte-fitzgerald-1,2013-14,Texas A&M,F,24,4,377,62,162,.383,44,99,.444,18,63,.286,32,54,.593,16,38,54,3,5,17,14,44,174,3.6
3330,Tommie McCune\tommie-mccune-1,2013-14,Oakland,F,31,19,467,62,152,.408,55,114,.482,7,38,.184,43,53,.811,28,57,85,19,13,6,39,78,174,2.8
3331,Charles Bain\charles-bain-1,2017-18,Robert Morris,F,33,9,564,62,166,.373,37,92,.402,25,74,.338,25,40,.625,46,51,97,9,17,5,56,65,174,2.1
3332,Dominic Green\dominic-green-2,2017-18,Washington,F,32,1,663,54,130,.415,13,35,.371,41,95,.432,25,37,.676,14,53,67,19,8,13,12,47,174,3.9
3333,Toby Hegner\toby-hegner-1,2015-16,Creighton,F,33,12,581,56,159,.352,14,37,.378,42,122,.344,20,32,.625,22,102,124,16,5,12,18,74,174,3.1
3334,Grant Fiorentinos\grant-fiorentinos-1,2015-16,Southern Illinois-Edwardsville,F,25,0,406,60,124,.484,60,124,.484,0,0,,54,74,.730,28,57,85,11,9,2,30,44,174,4.4
3335,Ivan Lukic\ivan-lukic-1,2016-17,James Madison,F,33,11,566,72,134,.537,64,104,.615,8,30,.267,22,36,.611,31,65,96,20,7,19,24,68,174,3.9
3336,Wenyen Gabriel\wenyen-gabriel-1,2016-17,Kentucky,F,38,23,672,60,148,.405,40,85,.471,20,63,.317,34,55,.618,61,123,184,26,11,33,29,91,174,4.0
3337,Nahziah Carter\nahziah-carter-1,2017-18,Washington,F,34,2,484,61,130,.469,43,86,.500,18,44,.409,34,55,.618,15,42,57,18,26,12,33,54,174,3.4
3338,Anfernee McLemore\anfernee-mclemore-1,2016-17,Auburn,F,32,1,482,69,101,.683,68,100,.680,1,1,1.000,35,58,.603,54,89,143,4,13,37,28,76,174,5.3
3339,Adam Ward\adam-ward-2,2015-16,Nicholls State,F,31,14,489,68,123,.553,68,123,.553,0,0,,38,74,.514,49,63,112,9,15,32,28,64,174,4.6
3340,Xavier Hill-Mais\xavier-hill-mais-1,2016-17,Oakland,F,34,0,471,72,141,.511,71,136,.522,1,5,.200,29,44,.659,22,74,96,24,15,32,49,65,174,3.4
3341,Khaliq Spicer\khaliq-spicer-1,2014-15,Kent State,F,35,33,792,68,132,.515,68,132,.515,0,0,,38,76,.500,81,128,209,11,13,53,30,78,174,5.3
3342,Mack Mercer\mack-mercer-1,2015-16,Belmont,F,23,0,256,63,122,.516,54,99,.545,9,23,.391,38,46,.826,26,44,70,9,6,15,15,46,173,5.7
3343,Jacob Schulte\jacob-schulte-1,2015-16,South Carolina Upstate,F,32,16,574,70,116,.603,70,116,.603,0,0,,33,70,.471,53,38,91,22,17,15,27,58,173,4.6
3344,Gerald Blackshear\gerald-blackshear-1,2016-17,Detroit Mercy,F,29,17,499,73,119,.613,73,119,.613,0,0,,27,56,.482,41,74,115,15,9,12,37,92,173,3.9
3345,Chris Silva\chris-silva-1,2015-16,South Carolina,F,32,6,425,53,110,.482,53,110,.482,0,0,,67,110,.609,56,87,143,6,14,28,34,100,173,4.0
3346,Reid Travis\reid-travis-1,2014-15,Stanford,F,28,12,646,67,137,.489,67,137,.489,0,0,,39,85,.459,62,94,156,12,24,7,27,60,173,5.1
3347,Omar Sherman\omar-sherman-1,2014-15,Miami (FL),F,36,9,593,67,156,.429,43,77,.558,24,79,.304,15,23,.652,22,60,82,18,8,20,12,59,173,3.3
3348,Xzavier Taylor\xzavier-taylor-1,2016-17,Purdue-Fort Wayne,F,33,0,499,63,131,.481,63,131,.481,0,0,,47,69,.681,31,49,80,12,5,14,37,95,173,2.5
3349,Zoran Talley\zoran-talley-1,2017-18,Iowa State,F,23,11,616,74,164,.451,67,139,.482,7,25,.280,18,31,.581,21,71,92,40,12,6,25,32,173,5.4
3350,Ty Greer\ty-greer-1,2016-17,Hofstra,F,31,16,549,63,158,.399,45,104,.433,18,54,.333,29,45,.644,45,84,129,27,13,7,39,53,173,3.7
3351,Malik Moore\malik-moore-2,2015-16,South Carolina Upstate,F,32,7,509,63,133,.474,43,76,.566,20,57,.351,27,54,.500,40,88,128,36,23,11,29,56,173,4.8
3352,Alex Larsson\alex-larsson-1,2016-17,UC-Riverside,F,28,27,544,70,135,.519,70,135,.519,0,0,,33,54,.611,43,71,114,9,3,12,42,80,173,3.3
3353,Kyle Washington\kyle-washington-2,2013-14,North Carolina State,F,36,25,718,73,168,.435,73,166,.440,0,2,.000,27,48,.563,29,110,139,16,6,21,35,77,173,2.7
3354,Alex Long\alex-long-1,2015-16,Norfolk State,F,34,16,574,66,152,.434,66,148,.446,0,4,.000,41,59,.695,47,80,127,15,11,35,41,80,173,3.4
3355,Jimmie Taylor\jimmie-taylor-1,2016-17,Alabama,F,34,14,612,71,123,.577,71,123,.577,0,0,,31,63,.492,41,85,126,20,15,46,38,85,173,4.3
3356,Oumar Barry\oumar-barry-1,2017-18,San Jose State,F,30,14,607,72,135,.533,69,121,.570,3,14,.214,26,61,.426,38,61,99,16,8,24,41,74,173,3.5
3357,Yalen Reed\yalen-reed-1,2017-18,Alcorn State,F,28,20,589,65,128,.508,60,106,.566,5,22,.227,37,59,.627,44,89,133,28,7,28,31,77,172,5.1
3358,Jared Sam\jared-sam-1,2014-15,Southern,F,33,22,686,59,108,.546,59,106,.557,0,2,.000,54,85,.635,62,115,177,11,34,24,30,82,172,5.5
3359,Amidou Bamba\amidou-bamba-1,2016-17,Coastal Carolina,F,37,11,596,72,132,.545,72,132,.545,0,0,,28,54,.519,43,101,144,13,3,27,28,71,172,3.6
3360,Nate Renfro\nate-renfro-1,2016-17,San Francisco,F,33,33,762,71,149,.477,65,111,.586,6,38,.158,24,59,.407,56,102,158,66,37,30,51,89,172,5.1
3361,Milos Supica\milos-supica-1,2017-18,Charlotte,F,28,8,568,71,143,.497,71,142,.500,0,1,.000,30,61,.492,61,75,136,10,8,11,37,47,172,4.3
3362,Shaq Thomas\shaquille-thomas-1,2015-16,Cincinnati,F,28,25,573,66,150,.440,55,115,.478,11,35,.314,29,49,.592,40,65,105,39,20,15,34,42,172,5.0
3363,Jimmie Taylor\jimmie-taylor-1,2015-16,Alabama,F,33,33,694,68,119,.571,68,119,.571,0,0,,36,97,.371,53,101,154,13,17,59,41,85,172,4.6
3364,Connor Lammert\connor-lammert-1,2014-15,Texas,F,34,26,750,59,148,.399,33,60,.550,26,88,.295,28,44,.636,43,139,182,43,16,15,29,65,172,4.7
3365,Trent Whiting\trent-whiting-2,2015-16,Arkansas-Pine Bluff,F,33,7,696,66,146,.452,55,109,.505,11,37,.297,29,46,.630,32,59,91,51,23,16,45,53,172,4.0
3366,Leslee Smith\leslee-smith-1,2013-14,Nebraska,F,32,1,537,67,129,.519,67,128,.523,0,1,.000,38,61,.623,59,95,154,12,29,20,45,82,172,4.5
3367,Jay Johnson\jay-johnson-1,2014-15,Marshall,F,32,0,508,61,179,.341,31,68,.456,30,111,.270,20,45,.444,37,80,117,18,14,9,34,72,172,2.5
3368,Caleb Martin\caleb-martin-1,2014-15,North Carolina State,F,36,1,598,53,149,.356,28,67,.418,25,82,.305,41,59,.695,26,77,103,26,11,12,24,40,172,3.4
3369,Dusan Perovic\dusan-perovic-1,2014-15,Binghamton,F,15,9,378,65,147,.442,41,94,.436,24,53,.453,18,30,.600,6,43,49,6,8,2,22,40,172,5.5
3370,Hassan Hussein\hassan-hussein-1,2017-18,Florida International,F,31,27,559,71,162,.438,70,156,.449,1,6,.167,29,38,.763,31,69,100,11,9,13,34,62,172,3.0
3371,Jermaine Crumpton\jermaine-crumpton-1,2014-15,Canisius,F,24,3,422,59,146,.404,42,93,.452,17,53,.321,37,52,.712,15,37,52,12,8,5,21,53,172,3.6
3372,Alex Fountain\alex-fountain-1,2015-16,Houston Baptist,F,33,5,529,54,132,.409,39,93,.419,15,39,.385,49,59,.831,23,66,89,22,11,14,16,53,172,4.0
3373,Isaiah Wilkins\isaiah-wilkins-1,2015-16,Virginia,F,37,21,792,72,139,.518,72,136,.529,0,3,.000,28,48,.583,55,97,152,55,28,31,27,73,172,5.3
3374,Johnny Williams\johnny-williams-1,2013-14,George Mason,F,31,17,617,67,139,.482,67,139,.482,0,0,,38,61,.623,42,70,112,17,11,17,37,71,172,3.6
3375,Dusan Perovic\dusan-perovic-1,2016-17,Binghamton,F,32,9,400,64,154,.416,41,80,.513,23,74,.311,20,34,.588,10,65,75,14,5,13,23,48,171,2.9
3376,Cody McDavis\cody-mcdavis-1,2014-15,Northern Colorado,F,29,10,516,71,151,.470,70,148,.473,1,3,.333,28,40,.700,21,57,78,8,8,3,23,65,171,3.0
3377,Nolan Taylor\nolan-taylor-1,2016-17,Pepperdine,F,24,20,501,70,152,.461,67,136,.493,3,16,.188,28,39,.718,30,58,88,17,13,4,18,66,171,4.6
3378,Skylar Spencer\skylar-spencer-1,2013-14,San Diego State,F,36,36,860,73,129,.566,73,129,.566,0,0,,25,52,.481,65,91,156,8,25,89,29,81,171,5.7
3379,Walter Foster\walter-foster-1,2014-15,Towson,F,30,27,749,74,166,.446,74,166,.446,0,0,,23,56,.411,66,102,168,20,11,29,38,84,171,4.1
3380,Jordan Scott\jordan-scott-2,2017-18,Idaho,F,31,31,925,58,122,.475,36,75,.480,22,47,.468,33,45,.733,57,103,160,51,9,18,40,78,171,5.2
3381,Nolan Gerrity\nolan-gerrity-1,2016-17,Maryland-Baltimore County,F,33,33,538,76,126,.603,76,126,.603,0,0,,19,36,.528,41,96,137,18,10,24,37,58,171,4.3
3382,Jericho Sims\jericho-sims-1,2017-18,Texas,F,34,11,628,71,117,.607,71,116,.612,0,1,.000,29,68,.426,39,94,133,7,11,18,26,60,171,4.0
3383,Phil Valenti\phil-valenti-1,2013-14,Canisius,F,34,4,624,66,130,.508,60,105,.571,6,25,.240,33,47,.702,56,75,131,31,19,9,41,70,171,4.1
3384,Erik Fromm\erik-fromm-1,2013-14,Butler,F,31,21,666,59,156,.378,41,85,.482,18,71,.254,35,57,.614,48,57,105,12,13,15,26,64,171,3.5
3385,Jacorey Williams\jacorey-williams-1,2014-15,Arkansas,F,36,7,582,73,179,.408,73,179,.408,0,0,,25,59,.424,32,69,101,39,24,15,33,64,171,3.0
3386,C.J. Barksdale\cj-barksdale-1,2013-14,Virginia Tech,F,21,9,418,65,127,.512,54,96,.563,11,31,.355,30,37,.811,32,57,89,12,7,14,19,28,171,6.7
3387,Ben Lawson\ben-lawson-1,2015-16,Western Kentucky,F,34,11,547,57,96,.594,56,95,.589,1,1,1.000,56,73,.767,37,75,112,13,11,65,37,91,171,4.7
3388,Nik Biberaj\nik-biberaj-1,2015-16,Old Dominion,F,36,1,705,66,166,.398,57,125,.456,9,41,.220,30,41,.732,46,74,120,38,13,26,16,79,171,3.9
3389,Shamar Johnson\shamar-johnson-3,2015-16,Loyola Marymount,F,31,29,648,65,135,.481,65,135,.481,0,0,,41,62,.661,58,73,131,30,20,5,45,100,171,3.7
3390,RaySean Scott Jr.\raysean-scottjr-1,2017-18,Florida Gulf Coast,F,26,9,400,70,106,.660,68,95,.716,2,11,.182,29,38,.763,41,76,117,16,9,13,19,67,171,6.0
3391,Dallas Walton\dallas-walton-1,2017-18,Colorado,F,30,25,557,70,152,.461,65,139,.468,5,13,.385,26,37,.703,27,75,102,21,7,34,28,59,171,4.1
3392,Matej Buovac\matej-buovac-1,2015-16,Sacred Heart,F,27,9,655,53,150,.353,17,43,.395,36,107,.336,29,34,.853,21,63,84,16,8,5,17,45,171,3.9
3393,Jeremiah Worthem\jeremiah-worthem-1,2013-14,Robert Morris,F,19,11,466,57,134,.425,45,107,.421,12,27,.444,44,61,.721,24,53,77,21,9,1,27,48,170,5.4
3394,Nick Duncan\nick-duncan-1,2013-14,Boise State,F,34,11,582,55,130,.423,14,30,.467,41,100,.410,19,27,.704,34,55,89,11,10,6,17,79,170,3.3
3395,Robert Sampson\robert-sampson-1,2014-15,Georgia Tech,F,31,14,664,63,160,.394,51,108,.472,12,52,.231,32,59,.542,66,134,200,17,19,25,40,82,170,4.3
3396,Abdulai Bundu\abdulai-bundu-1,2017-18,Quinnipiac,F,33,24,672,61,111,.550,61,111,.550,0,0,,48,72,.667,75,116,191,14,10,20,34,66,170,5.1
3397,David Syfax\david-syfax-1,2016-17,Morgan State,F,29,10,581,61,165,.370,51,110,.464,10,55,.182,38,68,.559,44,64,108,32,19,16,51,77,170,3.0
3398,Edward Alade\edward-alade-1,2014-15,Navy,F,32,22,608,73,124,.589,73,124,.589,0,0,,24,38,.632,37,72,109,27,4,16,34,70,170,4.0
3399,Sam Downey\sam-downey-1,2015-16,Yale,F,30,3,436,66,107,.617,62,97,.639,4,10,.400,34,41,.829,34,68,102,11,5,7,12,50,170,5.0
3400,Mohamed Conde\mohamed-conde-1,2014-15,Western Illinois,F,27,24,748,68,138,.493,68,138,.493,0,0,,34,57,.596,65,98,163,7,25,10,33,75,170,5.2
3401,Marko Pirovic\marko-pirovic-1,2016-17,Maine,F,28,6,536,58,144,.403,41,81,.506,17,63,.270,37,55,.673,32,75,107,20,22,0,25,56,170,4.2
3402,Amidou Bamba\amidou-bamba-1,2017-18,Coastal Carolina,F,30,3,425,73,115,.635,73,115,.635,0,0,,24,43,.558,41,59,100,12,4,18,21,46,170,4.8
3403,Roberts Blumbergs\roberts-blumbergs-1,2017-18,Grand Canyon,F,33,8,437,56,152,.368,39,74,.527,17,78,.218,41,55,.745,31,68,99,26,11,8,34,42,170,3.2
3404,Jalen Dupree\jalen-dupree-1,2017-18,Murray State,F,30,17,522,56,100,.560,56,100,.560,0,0,,58,88,.659,60,72,132,4,7,25,25,68,170,5.0
3405,Sam McBeath\sam-mcbeath-1,2013-14,Nicholls State,F,23,7,420,60,143,.420,33,66,.500,27,77,.351,23,41,.561,20,70,90,30,17,11,18,63,170,5.4
3406,Felix Von Hofe\felix-van-hofe-1,2014-15,Eastern Washington,F,33,4,511,58,141,.411,16,39,.410,42,102,.412,11,19,.579,11,36,47,20,9,10,17,43,169,3.2
3407,Norense Odiase\norense-odiase-1,2015-16,Texas Tech,F,20,17,379,72,140,.514,72,139,.518,0,1,.000,25,40,.625,32,52,84,19,6,14,34,57,169,5.2
3408,Raymond Spalding\raymond-spalding-1,2015-16,Louisville,F,30,6,525,70,125,.560,69,122,.566,1,3,.333,28,56,.500,50,80,130,16,28,20,27,66,169,5.2
3409,Will Miller\will-miller-1,2014-15,Mount St. Mary's,F,30,4,542,53,139,.381,5,18,.278,48,121,.397,15,21,.714,8,26,34,16,13,4,11,26,169,3.7
3410,Javis Howard\javis-howard-1,2017-18,Charleston Southern,F,31,13,626,71,139,.511,68,128,.531,3,11,.273,24,33,.727,54,74,128,15,12,6,32,36,169,4.4
3411,Tyler Flack\tyler-flack-1,2015-16,South Dakota,F,17,9,294,63,108,.583,61,100,.610,2,8,.250,41,48,.854,36,58,94,9,11,19,22,41,169,8.9
3412,Ryan Rosburg\ryan-rosburg-1,2013-14,Missouri,F,35,32,778,68,95,.716,68,95,.716,0,0,,33,58,.569,49,96,145,10,7,22,41,109,169,3.6
3413,Eddie Keith\eddie-keith-1,2016-17,Towson,F,33,13,741,60,125,.480,36,68,.529,24,57,.421,25,49,.510,33,83,116,41,16,19,33,72,169,4.2
3414,Jesse Chuku\jesse-chuku-1,2014-15,Lehigh,F,30,7,602,64,148,.432,36,69,.522,28,79,.354,13,28,.464,30,76,106,16,10,23,27,67,169,3.7
3415,Mikael Hopkins\mikael-hopkins-1,2014-15,Georgetown,F,33,24,733,53,121,.438,53,121,.438,0,0,,63,101,.624,75,116,191,42,33,52,63,110,169,5.1
3416,Ben Lawson\ben-lawson-1,2016-17,Western Kentucky,F,32,15,504,62,109,.569,62,107,.579,0,2,.000,45,70,.643,28,76,104,7,14,57,31,67,169,4.7
3417,Najeal Young\najeal-young-1,2015-16,Illinois-Chicago,F,27,16,622,67,150,.447,67,147,.456,0,3,.000,35,57,.614,50,120,170,23,21,4,41,50,169,4.9
3418,Michal Kozak\michal-kozak-1,2017-18,Weber State,F,31,30,812,55,130,.423,36,68,.529,19,62,.306,40,48,.833,35,116,151,31,12,17,42,73,169,4.2
3419,Eli Pepper\eli-pepper-1,2016-17,Lipscomb,F,31,29,643,60,140,.429,46,100,.460,14,40,.350,34,63,.540,51,178,229,42,14,12,43,87,168,4.7
3420,Hanner Mosquera-Perea\hanner-mosquera-perea-1,2014-15,Indiana,F,26,22,505,63,106,.594,63,106,.594,0,0,,42,73,.575,37,74,111,6,6,33,28,61,168,5.2
3421,Justyn Mutts\justyn-mutts-1,2017-18,High Point,F,28,19,568,71,132,.538,71,131,.542,0,1,.000,26,46,.565,38,74,112,39,30,32,42,86,168,5.3
3422,Zion Cousins\zion-cousins-1,2017-18,Howard,F,29,19,864,66,132,.500,66,129,.512,0,3,.000,36,65,.554,63,145,208,15,11,34,28,79,168,5.6
3423,Josh Cleveland\josh-cleveland-1,2013-14,Texas-Rio Grande Valley,F,31,20,625,70,129,.543,70,129,.543,0,0,,28,53,.528,46,60,106,20,12,9,32,93,168,3.5
3424,Greg Lewis\greg-lewis-5,2014-15,Rutgers,F,32,32,760,59,125,.472,59,125,.472,0,0,,50,78,.641,46,97,143,29,20,29,44,94,168,4.2
3425,Nate Lubick\nate-lubick-1,2013-14,Georgetown,F,33,32,825,71,122,.582,71,122,.582,0,0,,26,49,.531,40,139,179,55,24,20,40,103,168,5.1
3426,Brandon Miller\brandon-miller-5,2016-17,Gardner-Webb,F,31,3,538,62,116,.534,62,116,.534,0,0,,44,88,.500,54,72,126,9,16,16,23,82,168,4.2
3427,Lesley Varner Jr.\lesley-varnerjr-1,2017-18,Texas-Rio Grande Valley,F,33,5,558,52,139,.374,38,87,.437,14,52,.269,50,70,.714,44,63,107,20,33,10,25,63,168,4.2
3428,Demetrius Henry\demetrius-henry-1,2016-17,La Salle,F,29,18,552,61,100,.610,61,100,.610,0,0,,46,69,.667,44,70,114,20,9,17,43,83,168,4.3
3429,Tate Stensgaard\tate-stensgaard-1,2013-14,Western Illinois,F,27,17,545,65,113,.575,64,110,.582,1,3,.333,37,56,.661,25,72,97,22,10,3,51,89,168,3.2
3430,Jerome Desrosiers\jerome-desrosiers-1,2017-18,Princeton,F,27,10,416,56,126,.444,19,37,.514,37,89,.416,19,25,.760,21,52,73,26,6,1,19,27,168,4.6
3431,Ta'Jay Henry\tajay-henry-1,2015-16,Mississippi Valley State,F,34,26,699,66,144,.458,66,142,.465,0,2,.000,36,59,.610,64,78,142,21,20,11,35,94,168,3.6
3432,Sebastian Saiz\sebastian-saiz-1,2013-14,Mississippi,F,33,13,658,64,137,.467,64,137,.467,0,0,,40,61,.656,77,109,186,14,23,28,32,82,168,5.0
3433,Gabas Maldunas\gabas-maldunas-1,2013-14,Dartmouth,F,15,15,385,73,139,.525,73,139,.525,0,0,,22,43,.512,36,92,128,33,9,30,36,43,168,9.6
3434,Dom Hoffman\dom-hoffman-1,2013-14,Bucknell,F,30,8,489,70,151,.464,70,151,.464,0,0,,28,36,.778,40,80,120,19,3,7,20,53,168,4.0
3435,D'Andre Wright\dandre-wright-1,2015-16,Tulsa,F,32,20,567,65,132,.492,65,123,.528,0,9,.000,37,53,.698,36,70,106,10,6,9,35,97,167,2.7
3436,Jailen Gill\jailen-gill-1,2017-18,Tennessee-Martin,F,30,14,460,74,122,.607,74,122,.607,0,0,,19,31,.613,44,74,118,13,13,29,37,73,167,4.5
3437,Tarique Thompson\tarique-thompson-1,2014-15,High Point,F,33,12,556,63,136,.463,62,133,.466,1,3,.333,40,54,.741,34,53,87,28,14,9,20,50,167,4.0
3438,Bruce Moore\bruce-moore-1,2017-18,Bucknell,F,30,22,651,52,122,.426,30,55,.545,22,67,.328,41,55,.745,29,38,67,12,9,25,26,77,167,3.6
3439,Darious Moten\darious-moten-1,2013-14,Mercer,F,35,0,427,63,114,.553,56,88,.636,7,26,.269,34,54,.630,28,34,62,25,5,11,19,34,167,3.8
3440,Jacob Schulte\jacob-schulte-1,2014-15,South Carolina Upstate,F,36,13,644,70,109,.642,70,108,.648,0,1,.000,27,61,.443,61,61,122,12,10,38,24,70,167,4.4
3441,Jamari Traylor\jamari-traylor-1,2014-15,Kansas,F,35,18,714,67,138,.486,67,138,.486,0,0,,33,55,.600,54,76,130,33,28,37,53,79,167,4.0
3442,Arkim Robertson\arkim-robertson-1,2017-18,Cal State Fullerton,F,32,27,496,63,98,.643,63,98,.643,0,0,,41,63,.651,53,85,138,7,11,28,31,86,167,4.6
3443,Rashid Gaston\rashid-gaston-1,2013-14,Norfolk State,F,20,14,465,64,132,.485,64,132,.485,0,0,,39,75,.520,53,76,129,6,4,9,36,55,167,5.1
3444,Treshawn Bolden\treshawn-bolden-1,2013-14,Jackson State,F,31,27,574,61,147,.415,61,145,.421,0,2,.000,45,74,.608,53,75,128,30,13,11,66,104,167,2.3
3445,Nick Cook\nick-cook-1,2013-14,Jacksonville State,F,31,9,736,61,133,.459,61,133,.459,0,0,,45,91,.495,64,98,162,23,18,25,32,83,167,4.5
3446,Ivan Cruz Uceda\ivan-cruz-uceda-1,2015-16,Miami (FL),F,31,7,422,59,120,.492,20,33,.606,39,87,.448,10,10,1.000,16,64,80,6,6,7,19,55,167,3.6
3447,Shane Reybold\shane-reybold-1,2013-14,North Carolina-Wilmington,F,26,24,566,65,120,.542,65,120,.542,0,0,,37,61,.607,53,100,153,11,15,27,32,72,167,5.7
3448,Kyle Doyle\kyle-doyle-1,2013-14,Georgia Southern,F,30,5,634,69,143,.483,66,132,.500,3,11,.273,26,68,.382,63,101,164,12,20,10,42,90,167,3.7
3449,Matt Hubbard\matt-hubbard-1,2015-16,Santa Clara,F,29,13,587,62,169,.367,41,85,.482,21,84,.250,22,27,.815,18,55,73,25,9,11,31,61,167,2.7
3450,Donte Williams\donte-williams-1,2013-14,Georgia,F,34,32,745,64,119,.538,63,117,.538,1,2,.500,38,57,.667,64,110,174,17,9,40,20,99,167,5.0
3451,Paul Rowley\paul-rowley-1,2016-17,William & Mary,F,31,10,496,55,109,.505,17,31,.548,38,78,.487,19,22,.864,19,56,75,31,12,19,21,53,167,4.7
3452,Nick King\nick-king-1,2013-14,Memphis,F,34,0,377,59,114,.518,54,98,.551,5,16,.313,44,85,.518,47,65,112,12,18,10,18,35,167,4.4
3453,Dylan Sherwood\dylan-sherwood-1,2014-15,North Carolina-Wilmington,F,29,0,456,61,143,.427,24,47,.511,37,96,.385,8,10,.800,29,44,73,1,15,2,17,38,167,3.8
3454,Garrison Brooks\garrison-brooks-1,2017-18,North Carolina,F,37,16,541,65,123,.528,65,123,.528,0,0,,37,63,.587,61,67,128,20,11,11,33,68,167,3.6
3455,Amdy Fall\amdy-fall-1,2013-14,St. Francis (NY),F,32,2,539,57,125,.456,57,125,.456,0,0,,52,79,.658,46,79,125,6,10,55,35,73,166,4.2
3456,Adrian Fields\adrian-fields-1,2013-14,McNeese State,F,28,24,641,57,165,.345,34,83,.410,23,82,.280,29,41,.707,26,51,77,18,24,6,37,45,166,3.1
3457,Craig Hinton\craig-hinton-1,2017-18,Appalachian State,F,33,3,613,59,122,.484,26,35,.743,33,87,.379,15,24,.625,34,81,115,16,8,20,28,65,166,3.9
3458,Larry Brown\larry-brown-3,2013-14,Winthrop,F,33,28,658,70,143,.490,70,143,.490,0,0,,26,53,.491,61,88,149,17,31,33,43,111,166,4.0
3459,Rashaun Stimage\rashaun-stimage-1,2015-16,DePaul,F,29,17,514,64,111,.577,64,111,.577,0,0,,38,76,.500,57,64,121,2,10,42,31,80,166,4.7
3460,Noah Yates\noah-yates-1,2017-18,Yale,F,31,3,537,55,120,.458,21,31,.677,34,89,.382,22,28,.786,21,69,90,36,20,6,31,70,166,4.1
3461,T.J. Bell\tj-bell-1,2016-17,Indiana State,F,23,13,407,70,127,.551,70,127,.551,0,0,,26,35,.743,31,54,85,14,11,24,30,77,166,5.1
3462,Jeremy Hollowell\jeremy-hollowell-1,2013-14,Indiana,F,29,15,532,53,151,.351,46,119,.387,7,32,.219,53,68,.779,39,62,101,28,14,16,43,46,166,3.6
3463,Tariq Owens\tariq-owens-1,2016-17,St. John's (NY),F,32,8,601,65,129,.504,65,127,.512,0,2,.000,36,48,.750,59,105,164,15,19,69,29,103,166,5.5
3464,Arkadiy Mkrtychyan\arkadiy-mkrtychyan-1,2017-18,Idaho,F,26,1,459,63,127,.496,62,119,.521,1,8,.125,39,56,.696,29,64,93,26,8,2,36,66,166,3.9
3465,Donovon Jack\donovon-jack-1,2015-16,Penn State,F,32,4,443,58,117,.496,47,82,.573,11,35,.314,38,64,.594,26,67,93,5,4,18,24,82,165,3.0
3466,Daniel Camps\daniel-camps-1,2013-14,Northern Kentucky,F,27,8,424,61,123,.496,59,110,.536,2,13,.154,41,60,.683,28,43,71,25,19,1,35,63,165,3.9
3467,Nate Kratch\nate-kratch-1,2014-15,Santa Clara,F,32,19,673,64,121,.529,63,112,.563,1,9,.111,36,66,.545,71,75,146,11,16,21,31,112,165,4.0
3468,Esa Ahmad\esa-ahmad-1,2015-16,West Virginia,F,34,34,617,54,121,.446,50,103,.485,4,18,.222,53,85,.624,37,54,91,50,28,19,48,61,165,4.0
3469,Brandon Walters\brandon-walters-2,2016-17,Middle Tennessee,F,34,2,374,70,116,.603,70,115,.609,0,1,.000,25,33,.758,58,55,113,6,11,19,34,84,165,3.7
3470,Nick Banyard\nick-banyard-1,2015-16,Illinois State,F,32,7,636,61,154,.396,37,84,.440,24,70,.343,19,42,.452,34,105,139,19,16,10,41,64,165,3.0
3471,Luka Kamber\luka-kamber-1,2014-15,Nicholls State,F,29,1,539,56,144,.389,15,34,.441,41,110,.373,12,22,.545,12,48,60,26,14,5,35,50,165,3.0
3472,Devin Davis\devin-davis-1,2016-17,Houston,F,20,13,417,66,144,.458,65,140,.464,1,4,.250,32,56,.571,35,70,105,19,14,10,33,62,165,5.2
3473,Paul White\paul-white-1,2014-15,Georgetown,F,33,0,607,59,146,.404,36,85,.424,23,61,.377,24,34,.706,13,79,92,41,14,19,30,62,165,3.5
3474,Yohanny Dalembert\yohanny-dalembert-1,2016-17,James Madison,F,18,12,355,60,113,.531,60,113,.531,0,0,,45,75,.600,27,77,104,10,7,25,43,49,165,6.0
3475,Jordon Granger\jordon-granger-1,2014-15,Auburn,F,34,33,786,60,129,.465,33,56,.589,27,73,.370,18,31,.581,38,79,117,35,22,22,42,85,165,3.8
3476,Marvin Singleton\marvin-singleton-1,2014-15,Northern Iowa,F,35,35,874,67,127,.528,65,113,.575,2,14,.143,29,45,.644,72,100,172,23,10,5,33,60,165,4.3
3477,Hector Harold\hector-harold-1,2013-14,Vermont,F,33,1,507,57,143,.399,35,85,.412,22,58,.379,29,48,.604,10,55,65,15,17,10,38,76,165,2.1
3478,Tevin Prescott\tevin-prescott-1,2016-17,Winthrop,F,33,10,622,69,120,.575,69,119,.580,0,1,.000,27,43,.628,40,61,101,10,25,16,19,80,165,4.3
3479,OG Anunoby\og-anunoby-1,2015-16,Indiana,F,34,0,466,66,116,.569,53,87,.609,13,29,.448,20,42,.476,42,48,90,18,27,26,28,52,165,4.5
3480,Gavin Thurman\gavin-thurman-1,2013-14,Missouri State,F,29,1,395,55,153,.359,30,85,.353,25,68,.368,30,34,.882,10,48,58,12,4,7,19,38,165,2.9
3481,Jaleel Hogan\jaleel-hogan-1,2014-15,Detroit Mercy,F,33,4,481,62,100,.620,62,99,.626,0,1,.000,40,79,.506,35,47,82,8,9,8,25,92,164,3.0
3482,Jamari Traylor\jamari-traylor-1,2013-14,Kansas,F,34,0,549,62,92,.674,62,92,.674,0,0,,40,60,.667,46,93,139,26,14,28,40,80,164,4.6
3483,Deionte Simmons\deionte-simmons-1,2016-17,Chicago State,F,32,13,479,57,120,.475,57,118,.483,0,2,.000,50,80,.625,56,81,137,3,15,14,30,88,164,3.6
3484,Leron Black\leron-black-1,2014-15,Illinois,F,33,10,487,67,141,.475,67,138,.486,0,3,.000,30,44,.682,42,99,141,4,11,6,28,89,164,3.0
3485,Jacob Lawson\jacob-lawson-1,2015-16,Appalachian State,F,31,6,479,61,115,.530,61,115,.530,0,0,,42,56,.750,36,75,111,20,13,54,31,93,164,4.7
3486,Kentrall Brooks\kentrall-brooks-1,2016-17,Marist,F,32,14,493,60,108,.556,60,106,.566,0,2,.000,44,59,.746,39,80,119,22,11,21,47,87,164,3.7
3487,Jared Samuelson\jared-samuelson-1,2016-17,Montana,F,32,3,367,65,114,.570,64,111,.577,1,3,.333,33,49,.673,30,46,76,11,10,11,21,55,164,3.8
3488,Eddie Keith\eddie-keith-1,2015-16,Towson,F,32,0,716,55,142,.387,40,96,.417,15,46,.326,39,63,.619,25,62,87,51,31,17,30,92,164,3.9
3489,B.J. Duling\bj-duling-1,2017-18,Kent State,F,34,7,540,65,164,.396,53,125,.424,12,39,.308,22,50,.440,22,67,89,17,15,21,27,75,164,2.5
3490,Jordan Nobles\jordan-nobles-1,2017-18,Eastern Michigan,F,35,14,792,60,141,.426,22,41,.537,38,100,.380,6,9,.667,16,69,85,27,24,13,20,63,164,3.6
3491,Dominic Green\dominic-green-2,2016-17,Washington,F,30,2,648,57,180,.317,29,80,.363,28,100,.280,22,29,.759,21,42,63,21,12,12,29,56,164,2.3
3492,Trey Davis\trey-davis-2,2013-14,Richmond,F,33,22,968,62,143,.434,59,125,.472,3,18,.167,37,72,.514,51,176,227,57,27,10,34,99,164,5.0
3493,Brandon Conley\brandon-conley-1,2014-15,Oral Roberts,F,34,15,622,63,113,.558,63,113,.558,0,0,,38,59,.644,45,76,121,18,14,30,41,108,164,3.5
3494,Jayce Johnson\jayce-johnson-1,2017-18,Utah,F,30,1,504,59,113,.522,59,113,.522,0,0,,46,73,.630,50,113,163,6,9,28,31,72,164,4.7
3495,Spencer Franklin\spencer-franklin-1,2017-18,Longwood,F,28,14,576,53,108,.491,50,94,.532,3,14,.214,55,88,.625,40,63,103,13,13,11,39,98,164,3.4
3496,C.J. Neumann\cj-neumann-1,2015-16,Wofford,F,32,32,940,59,117,.504,59,115,.513,0,2,.000,46,64,.719,65,160,225,38,25,10,36,77,164,5.7
3497,Jibri Blount\jibri-blount-1,2015-16,Cleveland State,F,29,5,484,59,120,.492,57,116,.491,2,4,.500,44,71,.620,31,60,91,15,25,13,49,64,164,3.5
3498,Jack McVeigh\jack-mcveigh-1,2015-16,Nebraska,F,34,4,577,55,157,.350,21,57,.368,34,100,.340,20,29,.690,24,66,90,35,14,5,27,45,164,3.1
3499,Ahmad Wagner\ahmad-wagner-1,2016-17,Iowa,F,34,18,545,63,123,.512,63,121,.521,0,2,.000,38,82,.463,63,53,116,46,27,14,30,71,164,4.6
3500,Bernard Morena\benard-morena-1,2014-15,Kennesaw State,F,31,8,500,60,124,.484,56,114,.491,4,10,.400,40,69,.580,47,75,122,11,9,21,36,82,164,3.5
3501,Oto Osenieks\oto-osenieks-1,2013-14,Minnesota,F,31,23,570,63,140,.450,50,96,.521,13,44,.295,25,39,.641,26,61,87,25,19,10,26,54,164,3.8
3502,Charles Buggs\charles-buggs-1,2015-16,Minnesota,F,28,21,675,60,131,.458,37,59,.627,23,72,.319,20,26,.769,18,62,80,18,17,14,26,50,163,4.2
3503,Greg Calixte\greg-calixte-1,2017-18,George Mason,F,33,22,620,72,118,.610,72,118,.610,0,0,,19,44,.432,44,97,141,13,7,17,28,79,163,3.9
3504,Cornelius Hudson\cornelius-hudson-1,2015-16,Wake Forest,F,21,1,485,48,141,.340,26,58,.448,22,83,.265,45,63,.714,11,59,70,29,17,4,40,41,163,4.1
3505,Chris Kading\chris-kading-1,2014-15,North Dakota State,F,31,31,806,65,135,.481,55,91,.604,10,44,.227,23,46,.500,52,69,121,12,11,47,12,73,163,5.0
3506,Callum Barker\callum-barker-1,2015-16,Bradley,F,32,26,730,59,128,.461,56,104,.538,3,24,.125,42,69,.609,44,99,143,10,12,14,59,104,163,2.3
3507,Trey Davis\trey-davis-2,2015-16,Richmond,F,32,32,943,62,144,.431,49,100,.490,13,44,.295,26,57,.456,21,100,121,104,37,8,41,87,163,5.0
3508,Donovan Gilmore\donovan-gilmore-1,2014-15,College of Charleston,F,32,21,509,67,124,.540,66,120,.550,1,4,.250,28,43,.651,42,91,133,2,14,9,30,65,163,3.7
3509,TySean Powell\tysean-powell-1,2015-16,Duquesne,F,26,0,436,68,116,.586,66,113,.584,2,3,.667,25,43,.581,37,91,128,33,13,19,41,60,163,5.4
3510,Jito Kok\jito-kok-1,2013-14,San Diego,F,35,35,912,60,119,.504,60,118,.508,0,1,.000,43,90,.478,51,107,158,13,11,62,49,86,163,3.8
3511,Maxime Boursiquot\maxime-boursiquot-1,2016-17,Northeastern,F,31,4,625,62,127,.488,52,109,.477,10,18,.556,29,42,.690,39,91,130,20,10,6,43,64,163,3.5
3512,Alex Larsson\alex-larsson-1,2015-16,UC-Riverside,F,33,32,676,67,133,.504,67,133,.504,0,0,,29,65,.446,56,75,131,10,4,19,36,116,163,2.6
3513,James Kelly\james-kelly-1,2013-14,Miami (FL),F,27,11,482,65,134,.485,50,97,.515,15,37,.405,18,27,.667,26,75,101,15,11,11,18,42,163,4.7
3514,Marcus Heemstra\marcus-heemstra-1,2013-14,South Dakota State,F,32,7,532,62,122,.508,59,115,.513,3,7,.429,36,44,.818,48,56,104,32,9,14,34,65,163,4.1
3515,Rodney Williams\rodney-williams-5,2013-14,Drexel,F,30,18,625,58,112,.518,58,112,.518,0,0,,46,72,.639,45,104,149,12,6,35,28,107,162,4.2
3516,C.J. Blackwell\cj-blackwell-1,2013-14,Loyola Marymount,F,28,11,582,65,171,.380,41,87,.471,24,84,.286,8,11,.727,19,43,62,21,14,6,25,49,162,2.9
3517,Jordan Scott\jordan-scott-2,2016-17,Idaho,F,33,31,773,57,120,.475,49,94,.521,8,26,.308,40,62,.645,51,89,140,43,13,11,35,88,162,4.1
3518,Walter Foster\walter-foster-1,2015-16,Towson,F,29,5,632,59,144,.410,59,144,.410,0,0,,44,63,.698,67,76,143,12,14,44,36,70,162,4.7
3519,Trevor Berkeley\trevor-berkeley-1,2014-15,Drake,F,31,18,624,62,112,.554,50,87,.575,12,25,.480,26,36,.722,26,60,86,20,11,17,36,71,162,3.6
3520,Isaiah Brock\isaiah-brock-1,2017-18,Oakland,F,30,29,847,71,101,.703,71,101,.703,0,0,,20,31,.645,68,176,244,18,17,86,23,82,162,8.3
3521,Arnaldo Toro\arnaldo-toro-1,2016-17,George Washington,F,35,17,545,54,127,.425,48,108,.444,6,19,.316,48,76,.632,57,93,150,19,20,17,36,60,162,3.9
3522,Dusan Perovic\dusan-perovic-1,2015-16,Binghamton,F,30,11,482,57,190,.300,29,97,.299,28,93,.301,20,27,.741,10,60,70,23,4,4,26,51,162,1.7
3523,Manny Patterson\manny-patterson-1,2017-18,Green Bay,F,27,19,460,55,116,.474,55,116,.474,0,0,,52,69,.754,43,89,132,6,18,22,26,69,162,5.1
3524,Jaron Blossomgame\jaron-blossomgame-1,2013-14,Clemson,F,33,30,774,62,157,.395,52,107,.486,10,50,.200,28,47,.596,52,112,164,13,9,13,25,50,162,3.7
3525,Tonko Vuko\tonko-vuko-1,2015-16,Pacific,F,28,26,603,59,128,.461,51,93,.548,8,35,.229,36,50,.720,38,55,93,31,9,5,27,74,162,4.0
3526,Dionte Adams\dionte-adams-1,2015-16,Hampton,F,32,21,618,62,127,.488,62,124,.500,0,3,.000,38,60,.633,77,105,182,18,13,38,29,77,162,5.2
3527,BeeJay Anya\beejay-anya-1,2014-15,North Carolina State,F,36,11,698,64,105,.610,64,105,.610,0,0,,34,61,.557,57,98,155,8,4,91,40,97,162,4.6
3528,Nakye Sanders\nayke-sanders-1,2016-17,Duquesne,F,32,21,607,66,112,.589,66,112,.589,0,0,,30,66,.455,69,120,189,26,13,40,41,102,162,4.9
3529,Shore Adenekan\shore-adenekan-1,2013-14,Seattle,F,30,15,553,60,108,.556,60,108,.556,0,0,,42,69,.609,39,83,122,8,9,23,35,76,162,3.9
3530,Seth Berger\seth-berger-1,2015-16,Massachusetts,F,31,7,604,63,125,.504,49,82,.598,14,43,.326,22,38,.579,28,75,103,15,18,9,23,83,162,3.7
3531,Dan Garvin\dan-garvin-1,2013-14,Bryant,F,27,6,555,69,146,.473,65,124,.524,4,22,.182,20,37,.541,47,83,130,19,13,36,26,64,162,5.1
3532,Parker Ernsthausen\parker-ernsthausen-1,2016-17,Wright State,F,31,9,581,55,84,.655,55,83,.663,0,1,.000,52,71,.732,38,27,65,26,14,7,25,63,162,4.5
3533,Hershey Robinson\hershey-robinson-1,2013-14,Prairie View,F,33,16,600,59,149,.396,27,58,.466,32,91,.352,12,20,.600,40,43,83,18,11,6,30,60,162,2.8
3534,Eric Robertson\eric-robertson-2,2014-15,South Dakota,F,32,0,612,59,135,.437,54,120,.450,5,15,.333,39,56,.696,37,67,104,7,14,23,17,96,162,3.4
3535,Jake Krafka\jake-krafka-1,2017-18,Denver,F,30,23,688,54,135,.400,40,86,.465,14,49,.286,40,60,.667,36,130,166,62,6,9,36,86,162,4.4
3536,Amar Alibegovic\amar-alibegovic-1,2015-16,St. John's (NY),F,32,6,510,56,142,.394,30,56,.536,26,86,.302,24,39,.615,19,58,77,22,15,9,49,80,162,2.0
3537,Damonte Dodd\damonte-dodd-1,2016-17,Maryland,F,26,24,507,61,105,.581,61,105,.581,0,0,,39,74,.527,70,44,114,11,5,52,36,89,161,5.3
3538,Carlton Bragg Jr.\carlton-braggjr-1,2016-17,Kansas,F,31,5,429,67,132,.508,67,128,.523,0,4,.000,27,42,.643,55,73,128,14,11,17,28,74,161,4.0
3539,Stephan Hawkins\stephan-hawkins-1,2013-14,Robert Morris,F,35,21,687,71,154,.461,71,154,.461,0,0,,19,29,.655,43,59,102,9,8,23,27,96,161,2.6
3540,Bobby Hain\bobby-hain-1,2015-16,Youngstown State,F,13,13,368,63,136,.463,59,113,.522,4,23,.174,31,45,.689,25,57,82,32,6,6,23,30,161,9.0
3541,Tevin Prescott\tevin-prescott-1,2013-14,Winthrop,F,32,7,528,67,110,.609,67,110,.609,0,0,,27,50,.540,51,41,92,5,14,13,17,85,161,3.9
3542,Ben Dickinson\ben-dickinson-1,2013-14,Loyola Marymount,F,19,10,358,71,133,.534,71,131,.542,0,2,.000,19,29,.655,31,37,68,23,9,5,18,53,161,6.0
3543,Marcus Freeman\marcus-freeman-1,2015-16,Coastal Carolina,F,28,4,468,67,140,.479,67,140,.479,0,0,,27,45,.600,77,78,155,7,9,24,22,69,161,5.0
3544,Dallas Ennema\dallas-ennema-1,2014-15,Albany (NY),F,33,16,632,54,139,.388,26,53,.491,28,86,.326,25,37,.676,13,53,66,18,8,3,17,43,161,2.8
3545,Rodney Hawkins\rodney-hawkins-1,2015-16,Saint Peter's,F,30,16,559,68,155,.439,61,131,.466,7,24,.292,18,32,.563,52,88,140,24,10,13,44,72,161,3.3
3546,Adam Traore\adam-traore-1,2017-18,Coppin State,F,25,18,550,47,132,.356,40,99,.404,7,33,.212,60,76,.789,33,107,140,31,8,6,52,84,161,3.4
3547,Josh Warren\josh-warren-3,2016-17,Cornell,F,29,2,518,68,129,.527,68,128,.531,0,1,.000,25,48,.521,43,63,106,38,9,14,40,60,161,4.1
3548,Matt Townsend\matt-townsend-1,2013-14,Yale,F,33,22,671,59,123,.480,59,122,.484,0,1,.000,43,57,.754,52,53,105,24,15,4,33,70,161,3.6
3549,Jordan Naughton\jordan-naughton-1,2016-17,Wyoming,F,37,26,461,65,105,.619,65,105,.619,0,0,,31,56,.554,39,62,101,9,5,18,24,66,161,3.3
3550,Emanual Shepherd\emanual-shepherd-1,2016-17,Southern,F,32,14,513,68,110,.618,67,109,.615,1,1,1.000,24,49,.490,39,62,101,19,12,23,25,69,161,4.2
3551,Michael Obacha\michael-obacha-1,2013-14,Appalachian State,F,30,27,820,49,113,.434,49,113,.434,0,0,,63,126,.500,110,151,261,16,29,13,31,102,161,5.9
3552,Shay'rone Jett\shayrone-jett-1,2016-17,Prairie View,F,31,17,482,60,110,.545,50,78,.641,10,32,.313,31,46,.674,29,68,97,12,10,18,10,62,161,4.5
3553,Yante Maten\yante-maten-1,2014-15,Georgia,F,32,2,583,57,137,.416,57,136,.419,0,1,.000,46,71,.648,56,80,136,8,10,45,30,67,160,4.1
3554,Chip Rank\chip-rank-1,2013-14,Northern Iowa,F,31,15,566,52,141,.369,17,27,.630,35,114,.307,21,27,.778,19,59,78,13,9,1,9,35,160,3.4
3555,Ryan Luther\ryan-luther-1,2015-16,Pittsburgh,F,32,0,421,63,108,.583,55,90,.611,8,18,.444,26,39,.667,44,49,93,14,13,11,29,51,160,4.1
3556,Denzell Taylor\denzell-taylor-1,2015-16,Old Dominion,F,38,36,1004,70,118,.593,70,117,.598,0,1,.000,20,43,.465,153,121,274,40,34,24,50,117,160,5.8
3557,DeAndre Dishman\deandre-dishman-1,2016-17,Eastern Kentucky,F,27,7,498,64,104,.615,64,104,.615,0,0,,32,58,.552,41,80,121,20,19,12,33,53,160,5.3
3558,Sandi Marcius\sandi-marcius-1,2013-14,DePaul,F,33,24,615,60,100,.600,60,100,.600,0,0,,40,66,.606,71,82,153,5,9,32,43,95,160,4.0
3559,Jake Barnett\jake-barnett-1,2013-14,Saint Louis,F,34,26,822,50,152,.329,11,27,.407,39,125,.312,21,36,.583,10,86,96,38,28,8,35,85,160,2.7
3560,Abdulai Bundu\abdulai-bundu-1,2016-17,Quinnipiac,F,30,29,552,59,122,.484,59,121,.488,0,1,.000,42,79,.532,53,70,123,8,8,7,40,48,160,3.4
3561,Duke Ethridge\duke-ethridge-1,2014-15,Chattanooga,F,30,6,377,55,110,.500,46,78,.590,9,32,.281,41,62,.661,32,64,96,8,12,21,33,52,160,3.9
3562,Jordan Garnett\jordan-garnett-1,2016-17,Northern Kentucky,F,33,24,768,55,114,.482,38,75,.507,17,39,.436,33,44,.750,37,64,101,47,26,10,34,78,160,4.4
3563,Justin Hammonds\justin-hammonds-1,2014-15,Air Force,F,25,22,524,58,106,.547,53,94,.564,5,12,.417,39,64,.609,22,71,93,49,20,6,43,75,160,4.8
3564,Jake Flaggert\jake-flaggert-1,2016-17,Texas-El Paso,F,32,27,908,47,124,.379,2,8,.250,45,116,.388,21,27,.778,9,82,91,38,10,7,19,97,160,3.3
3565,D.J. MacLeay\dj-macleay-1,2015-16,Bucknell,F,31,0,381,62,98,.633,56,84,.667,6,14,.429,30,44,.682,48,64,112,18,15,14,34,71,160,4.5
3566,Horace Spencer\horace-spencer-1,2017-18,Auburn,F,34,13,589,58,111,.523,58,110,.527,0,1,.000,44,61,.721,49,118,167,28,38,43,37,99,160,5.3
3567,Justin Goldsborough\justin-goldsborough-1,2013-14,Lehigh,F,32,2,493,64,103,.621,64,103,.621,0,0,,32,46,.696,26,67,93,9,8,26,29,67,160,3.8
3568,Joshua Howard\joshua-howard-1,2017-18,Brown,F,27,16,481,59,120,.492,46,82,.561,13,38,.342,29,41,.707,34,53,87,25,20,13,29,60,160,4.7
3569,Jerekius Davis\jerekius-davis-1,2016-17,Louisiana,F,33,4,376,58,132,.439,47,85,.553,11,47,.234,33,42,.786,40,50,90,15,15,6,20,57,160,3.5
3570,T.J. Shipes\tj-shipes-1,2015-16,Georgia State,F,30,20,773,68,115,.591,68,115,.591,0,0,,24,54,.444,43,109,152,5,22,24,28,93,160,4.5
3571,Jalen Dupree\jalen-dupree-1,2016-17,Murray State,F,33,4,520,55,113,.487,55,113,.487,0,0,,50,86,.581,59,60,119,8,8,25,33,98,160,3.2
3572,Bobby King\bobby-king-1,2013-14,Florida A&M,F,32,18,609,70,126,.556,70,126,.556,0,0,,20,41,.488,75,98,173,13,22,33,34,97,160,4.8
3573,Taylor Adway\taylor-adway-1,2017-18,Toledo,F,34,32,504,57,117,.487,57,116,.491,0,1,.000,45,68,.662,33,91,124,14,11,22,36,87,159,3.1
3574,Basil Smotherman\basil-smotherman-1,2013-14,Purdue,F,32,16,604,65,112,.580,64,100,.640,1,12,.083,28,49,.571,46,75,121,21,15,4,17,67,159,4.4
3575,Horace Spencer\horace-spencer-1,2015-16,Auburn,F,31,18,562,63,150,.420,63,149,.423,0,1,.000,33,68,.485,65,88,153,15,14,65,43,115,159,3.8
3576,Terrance Banyard\terrance-banyard-1,2017-18,Arkansas-Pine Bluff,F,29,0,379,55,93,.591,54,91,.593,1,2,.500,48,79,.608,28,55,83,7,6,23,24,54,159,4.2
3577,Kavon Waller\kavon-waller-1,2015-16,Delaware State,F,28,6,539,54,123,.439,28,61,.459,26,62,.419,25,46,.543,30,46,76,19,7,10,40,50,159,3.2
3578,Jordan Nwora\jordan-nwora-1,2017-18,Louisville,F,28,0,336,52,112,.464,27,55,.491,25,57,.439,30,39,.769,15,47,62,11,17,3,23,35,159,4.0
3579,Patrick Muldoon\patrick-muldoon-1,2016-17,Eastern Illinois,F,29,11,573,66,144,.458,66,144,.458,0,0,,27,41,.659,48,78,126,28,15,15,34,103,159,3.7
3580,Laimonas Chatkevicius\laimonas-chatkevicius-1,2013-14,South Carolina,F,33,1,426,65,121,.537,65,120,.542,0,1,.000,29,42,.690,40,94,134,13,13,20,32,78,159,3.8
3581,Malik Pope\malik-pope-1,2014-15,San Diego State,F,31,0,459,56,123,.455,36,74,.486,20,49,.408,27,40,.675,25,59,84,19,8,24,25,30,159,4.1
3582,Michael Jacobson\michael-jacobson-1,2015-16,Nebraska,F,34,25,623,52,120,.433,49,104,.471,3,16,.188,52,67,.776,64,82,146,17,19,28,20,81,159,4.6
3583,Fabijan Krslovic\fabijan-krslovic-1,2014-15,Montana,F,33,26,829,62,119,.521,62,119,.521,0,0,,35,64,.547,58,98,156,35,36,19,33,83,159,5.0
3584,Denzell Taylor\denzell-taylor-1,2013-14,Old Dominion,F,36,36,959,68,130,.523,68,129,.527,0,1,.000,23,60,.383,104,109,213,24,25,31,47,117,159,4.3
3585,Stephen Ugochukwu\stephen-ugochukwu-1,2015-16,McNeese State,F,27,2,390,56,126,.444,51,113,.451,5,13,.385,42,66,.636,41,59,100,12,11,22,27,48,159,4.4
3586,Cam Gregory\cam-gregory-1,2015-16,Loyola (MD),F,30,2,544,59,101,.584,59,101,.584,0,0,,41,69,.594,43,117,160,16,12,8,34,64,159,4.5
3587,Stephon Jelks\stephon-jelks-1,2014-15,Mercer,F,31,1,397,61,116,.526,49,89,.551,12,27,.444,25,37,.676,39,62,101,14,14,6,16,34,159,4.6
3588,Nathan Adrian\nathan-adrian-1,2015-16,West Virginia,F,35,16,635,60,123,.488,38,69,.551,22,54,.407,17,30,.567,53,56,109,32,28,7,28,103,159,3.8
3589,Jason Perry-Murray\jason-perry-murray-1,2017-18,Grambling,F,28,25,528,66,108,.611,66,108,.611,0,0,,26,44,.591,64,72,136,4,13,26,32,83,158,4.9
3590,Lewis Sullivan\lewis-sullivan-1,2015-16,Alabama-Birmingham,F,33,1,409,58,96,.604,57,92,.620,1,4,.250,41,61,.672,29,55,84,25,11,10,23,51,158,4.1
3591,Marcus Bradley\marcus-bradley-1,2014-15,Idaho State,F,25,0,309,68,148,.459,63,122,.516,5,26,.192,17,32,.531,16,33,49,4,4,14,16,56,158,3.0
3592,Michael Gilmore\michael-gilmore-1,2017-18,Florida Gulf Coast,F,24,20,448,62,130,.477,49,92,.533,13,38,.342,21,32,.656,26,109,135,21,12,19,44,78,158,4.3
3593,Kevarrius Hayes\kevarrius-hayes-1,2017-18,Florida,F,33,25,767,62,109,.569,62,109,.569,0,0,,34,68,.500,77,88,165,14,32,67,33,83,158,5.9
3594,Jonathan Galloway\jonathan-galloway-1,2016-17,UC-Irvine,F,36,35,910,53,124,.427,53,124,.427,0,0,,52,80,.650,100,173,273,21,4,40,35,96,158,4.9
3595,Brekkott Chapman\brekkott-chapman-1,2015-16,Utah,F,36,1,484,56,129,.434,46,92,.500,10,37,.270,36,55,.655,38,64,102,36,14,20,28,70,158,3.5
3596,Nicholas Baer\nicholas-baer-1,2015-16,Iowa,F,33,0,477,61,123,.496,35,57,.614,26,66,.394,10,15,.667,38,47,85,17,23,19,17,49,158,4.4
3597,Eric McKnight\eric-mcknight-1,2013-14,Florida Gulf Coast,F,23,21,498,65,98,.663,65,97,.670,0,1,.000,28,55,.509,29,89,118,2,10,25,40,69,158,4.9
3598,Lamont Walker\lamont-walker-1,2017-18,Texas Southern,F,29,11,564,52,108,.481,40,79,.506,12,29,.414,41,64,.641,36,89,125,16,18,2,14,52,157,4.9
3599,Brandon Rosser\brandon-rosser-1,2016-17,UC-Riverside,F,29,17,593,57,146,.390,46,93,.495,11,53,.208,32,51,.627,31,74,105,23,4,18,42,96,157,2.3
3600,Collin Spickerman\collin-spickerman-1,2015-16,Portland State,F,27,23,506,71,138,.514,71,137,.518,0,1,.000,15,23,.652,42,58,100,26,19,45,25,68,157,5.5
3601,James Pegues\james-pegues-1,2013-14,Abilene Christian,F,31,0,445,55,125,.440,54,119,.454,1,6,.167,46,56,.821,32,69,101,16,22,3,46,71,157,3.0
3602,Matija Milin\matija-milin-1,2017-18,Fairfield,F,26,15,442,63,130,.485,49,85,.576,14,45,.311,17,29,.586,34,74,108,28,9,2,25,47,157,4.6
3603,Nemanja Mikic\nemanja-mikic-1,2013-14,George Washington,F,33,4,544,53,146,.363,13,34,.382,40,112,.357,11,21,.524,9,42,51,17,11,8,18,64,157,2.3
3604,Kienan Walter\kienan-walter-1,2017-18,North Dakota,F,32,2,500,56,121,.463,34,60,.567,22,61,.361,23,35,.657,18,55,73,18,21,5,32,85,157,2.8
3605,A.J. Turner\aj-turner-1,2015-16,Boston College,F,27,24,744,54,161,.335,29,65,.446,25,96,.260,24,35,.686,10,88,98,42,25,10,20,39,157,4.5
3606,Damontez Oliver\damontez-oliver-1,2017-18,Campbell,F,30,2,422,48,105,.457,16,32,.500,32,73,.438,29,43,.674,7,46,53,17,10,1,17,54,157,3.3
3607,Robert Montgomery\robert-montgomery-1,2016-17,St. Francis (NY),F,30,15,559,60,139,.432,58,133,.436,2,6,.333,35,60,.583,51,86,137,14,11,32,53,97,157,2.9
3608,Gavin Thurman\gavin-thurman-1,2014-15,Missouri State,F,26,1,455,65,180,.361,50,114,.439,15,66,.227,12,18,.667,9,53,62,20,7,4,25,28,157,2.5
3609,Elijah Macon\elijah-macon-1,2015-16,West Virginia,F,35,1,462,60,114,.526,60,114,.526,0,0,,37,80,.463,43,62,105,18,12,15,33,68,157,3.1
3610,Zach Haney\zach-haney-1,2016-17,Boise State,F,30,1,455,59,133,.444,50,100,.500,9,33,.273,29,46,.630,42,82,124,5,11,19,23,75,156,3.6
3611,Karachi Edo\karachi-edo-1,2013-14,Fresno State,F,39,8,587,63,127,.496,63,127,.496,0,0,,30,52,.577,52,75,127,5,3,32,15,68,156,3.3
3612,Ruben Arroyo-Felix\ruben-arroyo-felix-1,2016-17,Presbyterian,F,30,5,482,61,153,.399,53,122,.434,8,31,.258,26,36,.722,31,63,94,17,6,4,34,29,156,2.8
3613,BeeJay Anya\beejay-anya-1,2015-16,North Carolina State,F,33,17,771,61,106,.575,61,106,.575,0,0,,34,79,.430,65,110,175,16,17,73,36,108,156,5.1
3614,Shaquille Morris\shaquille-morris-1,2014-15,Wichita State,F,33,1,420,61,112,.545,61,111,.550,0,1,.000,34,53,.642,26,60,86,11,9,26,30,92,156,3.0
3615,Iman Johnson\iman-johnson-1,2015-16,Samford,F,33,24,688,60,127,.472,53,97,.546,7,30,.233,29,47,.617,45,105,150,40,43,13,42,87,156,4.6
3616,Nathan Taphorn\nathan-taphorn-1,2016-17,Northwestern,F,35,2,427,52,110,.473,13,27,.481,39,83,.470,13,16,.813,11,40,51,23,5,7,15,41,156,3.2
3617,Jaylen Johnson\jaylen-johnson-1,2015-16,Louisville,F,31,22,541,70,151,.464,68,141,.482,2,10,.200,14,26,.538,50,59,109,14,10,10,17,61,156,3.6
3618,Ivan Madunic\ivan-madunic-1,2016-17,Southern Utah,F,33,22,670,54,158,.342,23,58,.397,31,100,.310,17,26,.654,32,99,131,15,9,34,31,69,156,3.0
3619,James Farr\james-farr-1,2014-15,Xavier,F,37,26,578,64,150,.427,51,105,.486,13,45,.289,15,32,.469,49,148,197,15,13,29,39,64,156,3.5
3620,Keenan Simmons\keenan-simmons-1,2015-16,Southern Illinois-Edwardsville,F,28,21,602,68,126,.540,67,121,.554,1,5,.200,19,37,.514,59,63,122,6,7,34,20,92,156,4.5
3621,Jalen Robinson\jalen-robinson--1,2013-14,Dayton,F,36,4,457,52,126,.413,47,117,.402,5,9,.556,47,71,.662,39,62,101,9,12,13,31,52,156,2.8
3622,Tyrique Jones\tyrique-jones-1,2016-17,Xavier,F,37,14,406,68,113,.602,68,113,.602,0,0,,20,41,.488,58,56,114,11,9,16,27,74,156,3.4
3623,Jeff Coby\jeff-coby-1,2016-17,Columbia,F,25,18,410,58,133,.436,55,123,.447,3,10,.300,37,52,.712,51,63,114,15,15,16,26,68,156,4.7
3624,Eddie Davis\eddie-davis-1,2017-18,Southern Mississippi,F,31,20,471,59,103,.573,47,73,.644,12,30,.400,26,34,.765,34,30,64,14,7,8,27,70,156,3.4
3625,Jermaine Sanders\jermaine-sanders-1,2014-15,Cincinnati,F,34,13,711,55,144,.382,31,55,.564,24,89,.270,22,39,.564,32,70,102,29,16,3,19,37,156,3.5
3626,Jordan Jones\jordan-jones-2,2017-18,Charleston Southern,F,30,20,467,61,83,.735,61,83,.735,0,0,,34,58,.586,42,58,100,6,9,36,35,65,156,4.6
3627,Darion Clark\darion-clark-1,2016-17,Grand Canyon,F,20,17,380,60,115,.522,60,115,.522,0,0,,36,64,.563,39,93,132,5,16,6,29,64,156,5.6
3628,Jordan Whitehead\jordan-whitehead-1,2017-18,High Point,F,30,24,623,68,114,.596,68,112,.607,0,2,.000,20,42,.476,62,74,136,21,19,5,19,63,156,5.1
3629,James Farr\james-farr-1,2013-14,Xavier,F,34,1,420,63,122,.516,44,72,.611,19,50,.380,11,20,.550,44,89,133,6,12,23,17,62,156,4.1
3630,Tom Vodanovich\tom-vodanovich-1,2014-15,James Madison,F,29,21,662,59,109,.541,57,93,.613,2,16,.125,36,60,.600,27,89,116,13,16,12,37,74,156,3.7
3631,Aleer Leek\aleer-leek-1,2017-18,Missouri-Kansas City,F,32,31,717,53,154,.344,41,102,.402,12,52,.231,37,49,.755,30,97,127,5,11,31,48,97,155,2.0
3632,Jeff Roberson\jeff-roberson-1,2014-15,Vanderbilt,F,33,24,637,50,103,.485,35,70,.500,15,33,.455,40,64,.625,32,70,102,37,13,10,48,86,155,3.0
3633,Brandon Murphy\brandon-murphy-1,2015-16,Indiana State,F,32,30,531,55,116,.474,55,116,.474,0,0,,45,71,.634,64,70,134,2,5,5,34,88,155,2.9
3634,Kyle Clark\kyle-clark-1,2015-16,Saint Mary's (CA),F,34,1,592,48,108,.444,22,35,.629,26,73,.356,33,47,.702,17,61,78,12,8,6,28,63,155,2.7
3635,Aaron Falzon\aaron-falzon-1,2017-18,Northwestern,F,28,10,447,45,129,.349,9,33,.273,36,96,.375,29,34,.853,8,40,48,15,9,6,15,37,155,3.3
3636,Westley Hinton\westley-hinton-1,2013-14,Troy,F,28,12,444,56,141,.397,40,75,.533,16,66,.242,27,35,.771,24,67,91,7,17,17,26,51,155,3.6
3637,Dwayne Polee\dwayne-polee-2,2014-15,San Diego State,F,20,13,410,49,139,.353,29,71,.408,20,68,.294,37,58,.638,13,39,52,16,27,6,20,27,155,5.1
3638,Tanner Schmit\tanner-schmit-1,2017-18,Central Arkansas,F,35,6,433,69,163,.423,69,160,.431,0,3,.000,17,26,.654,26,41,67,10,4,10,13,84,155,1.9
3639,Joshua Meier\joshua-meier-1,2014-15,Chicago State,F,31,20,642,59,159,.371,58,158,.367,1,1,1.000,36,58,.621,66,58,124,19,19,17,58,77,155,2.5
3640,Rashaan Holloway\rashaan-holloway-1,2015-16,Massachusetts,F,30,14,350,66,111,.595,66,111,.595,0,0,,23,58,.397,42,50,92,7,6,18,34,81,155,3.0
3641,Trey Warren\trey-warren-1,2015-16,Florida A&M,F,28,13,441,59,122,.484,58,120,.483,1,2,.500,36,61,.590,45,70,115,1,4,5,49,70,155,2.4
3642,Alexis Dargenton\alexis-dargenton-1,2016-17,Utah State,F,32,22,615,57,139,.410,50,111,.450,7,28,.250,34,55,.618,53,103,156,31,11,35,35,84,155,4.0
3643,Aaron Adeoye\aaron-adeoye-1,2014-15,Southeast Missouri State,F,30,23,604,59,131,.450,56,118,.475,3,13,.231,34,49,.694,39,85,124,25,17,18,43,83,155,3.5
3644,Jamal Cain\jamal-cain-1,2017-18,Marquette,F,34,1,584,59,122,.484,33,67,.493,26,55,.473,11,23,.478,30,84,114,22,28,12,37,49,155,3.8
3645,Dainius Chatkevicius\dainius-chatkevicius-1,2017-18,Evansville,F,32,19,607,66,116,.569,66,116,.569,0,0,,22,41,.537,50,122,172,5,8,39,33,77,154,4.3
3646,Max Bielfeldt\max-bielfeldt-1,2014-15,Michigan,F,30,3,434,62,129,.481,54,99,.545,8,30,.267,22,32,.688,43,65,108,14,8,7,20,41,154,4.0
3647,Desmond Simmons\desmond-simmons-1,2014-15,Saint Mary's (CA),F,31,30,862,48,138,.348,19,55,.345,29,83,.349,29,39,.744,63,134,197,44,30,7,33,83,154,5.0
3648,Aaron Short\aaron-short-1,2013-14,Pacific,F,33,2,576,53,115,.461,24,58,.414,29,57,.509,19,21,.905,27,86,113,37,24,7,31,71,154,4.1
3649,Kendrec Ferrara\kendrec-ferrara-1,2015-16,Furman,F,35,6,448,64,115,.557,55,84,.655,9,31,.290,17,40,.425,35,53,88,11,7,25,31,50,154,3.2
3650,Jacob Lampkin\jacob-lampkin-1,2016-17,Pacific,F,24,15,420,60,120,.500,60,118,.508,0,2,.000,34,57,.596,39,73,112,21,5,6,25,51,154,4.7
3651,Jito Kok\jito-kok-1,2014-15,San Diego,F,30,25,696,55,129,.426,55,129,.426,0,0,,44,72,.611,33,72,105,11,12,75,37,75,154,4.1
3652,Aaron Clayborn\aaron-clayborn-1,2013-14,Texas Southern,F,34,2,539,61,118,.517,61,118,.517,0,0,,32,65,.492,51,69,120,17,4,8,28,51,154,3.3
3653,Collin Hartman\collin-hartman-1,2014-15,Indiana,F,32,12,631,51,102,.500,22,41,.537,29,61,.475,23,35,.657,46,52,98,26,16,19,22,70,154,4.5
3654,Brendan Casper\brendan-casper-1,2016-17,Saint Joseph's,F,31,3,567,60,138,.435,56,111,.505,4,27,.148,30,45,.667,26,68,94,42,28,1,28,76,154,3.7
3655,Erik Swoope\erik-swoope-1,2013-14,Miami (FL),F,31,10,571,55,107,.514,54,100,.540,1,7,.143,43,64,.672,30,55,85,16,11,11,13,47,154,4.1
3656,Ivan Bender\ivan-bender-1,2016-17,Maryland,F,32,5,456,63,95,.663,63,95,.663,0,0,,28,45,.622,32,70,102,28,5,12,29,75,154,3.9
3657,Angelo Chol\angelo-chol-1,2014-15,San Diego State,F,35,0,478,64,116,.552,64,116,.552,0,0,,26,53,.491,45,65,110,6,8,18,35,65,154,2.9
3658,Maurius Hill\maurius-hill-1,2014-15,Little Rock,F,25,9,421,59,145,.407,51,121,.421,8,24,.333,27,43,.628,37,72,109,23,10,4,34,36,153,3.9
3659,Cheikh Sane\cheikh-sane-1,2014-15,Marshall,F,32,19,574,52,124,.419,51,118,.432,1,6,.167,48,80,.600,58,83,141,24,17,16,45,93,153,3.2
3660,Jalen Henry\jalen-henry-1,2015-16,Southern Illinois-Edwardsville,F,28,7,447,53,138,.384,52,126,.413,1,12,.083,46,65,.708,33,61,94,13,7,24,48,78,153,2.3
3661,Austin Lewis\austin-lewis-1,2014-15,McNeese State,F,29,21,548,63,111,.568,63,111,.568,0,0,,27,43,.628,54,71,125,4,4,64,21,74,153,5.3
3662,Brandon Watkins\brandon-watkins-2,2016-17,West Virginia,F,36,9,429,64,112,.571,64,112,.571,0,0,,25,46,.543,38,62,100,8,13,21,23,63,153,3.4
3663,Staphon Blair\staphon-blair-1,2013-14,Central Florida,F,31,18,557,62,112,.554,62,112,.554,0,0,,29,50,.580,53,53,106,3,4,47,29,76,153,4.0
3664,T.J. Shipes\tj-shipes-1,2014-15,Georgia State,F,33,14,688,62,108,.574,62,108,.574,0,0,,29,59,.492,56,74,130,7,22,17,23,102,153,3.8
3665,Danilo Djuricic\danilo-djuricic-1,2017-18,Harvard,F,31,3,460,56,134,.418,34,63,.540,22,71,.310,19,27,.704,33,52,85,9,6,17,17,48,153,3.4
3666,Elston Jones\elston-jones-1,2017-18,UC-Irvine,F,34,4,534,69,122,.566,69,122,.566,0,0,,15,43,.349,74,115,189,18,8,30,39,95,153,4.0
3667,Nick Stover\nick-stover-1,2013-14,Loyola Marymount,F,32,14,533,54,127,.425,46,84,.548,8,43,.186,37,49,.755,25,40,65,26,16,6,21,71,153,3.1
3668,David Pekarek\david-pekarek-1,2015-16,Fordham,F,30,11,547,53,155,.342,23,52,.442,30,103,.291,17,25,.680,12,48,60,19,9,11,39,50,153,1.9
3669,Jordan Jones\jordan-jones-1,2016-17,Kennesaw State,F,30,30,614,68,143,.476,68,143,.476,0,0,,17,29,.586,46,100,146,34,6,21,30,72,153,4.1
3670,Garrison Goode\garrison-goode-1,2017-18,UC-Davis,F,32,32,905,58,121,.479,58,121,.479,0,0,,37,66,.561,49,70,119,24,23,14,41,88,153,3.4
3671,Matt Shrigley\matt-shrigley-1,2014-15,San Diego State,F,30,17,632,53,156,.340,12,30,.400,41,126,.325,6,6,1.000,6,43,49,31,24,9,26,38,153,3.1
3672,Garland Owens\garland-owens-1,2015-16,Boston College,F,32,23,700,58,131,.443,51,105,.486,7,26,.269,30,46,.652,40,66,106,41,15,9,40,89,153,3.1
3673,Clint Bozner\clint-bozner-1,2013-14,UC-Davis,F,30,7,496,57,104,.548,57,104,.548,0,0,,39,61,.639,45,43,88,10,7,7,37,81,153,2.9
3674,Chandler Rowe\chandler-rowe-1,2016-17,Tennessee-Martin,F,35,34,832,49,92,.533,40,70,.571,9,22,.409,46,74,.622,76,100,176,56,45,38,38,105,153,6.0
3675,Joseph Williams-Powell\joseph-williams-powell-1,2016-17,Coastal Carolina,F,32,4,409,56,120,.467,48,98,.490,8,22,.364,33,50,.660,28,59,87,11,7,3,39,63,153,2.3
3676,Johannes Nielsen\johannes-nielsen-1,2016-17,Kennesaw State,F,27,2,514,60,111,.541,60,109,.550,0,2,.000,33,43,.767,26,57,83,23,11,8,35,81,153,3.6
3677,Roland Brown\roland-brown-1,2013-14,Binghamton,F,29,15,453,61,117,.521,61,117,.521,0,0,,31,41,.756,37,44,81,11,8,12,37,64,153,3.2
3678,Jarquez Smith\jarquez-smith-1,2016-17,Florida State,F,35,3,460,60,115,.522,57,105,.543,3,10,.300,30,46,.652,34,65,99,17,8,30,25,84,153,3.3
3679,Marc Loving\marc-loving-1,2013-14,Ohio State,F,35,0,380,43,117,.368,28,59,.475,15,58,.259,52,68,.765,19,42,61,7,6,7,20,48,153,2.4
3680,Brooks DeBisschop\brooks-debisschop-1,2017-18,Northern Arizona,F,29,26,800,55,140,.393,46,106,.434,9,34,.265,33,63,.524,63,153,216,31,25,13,49,74,152,4.5
3681,Malik Martin\malik-price-martin-1,2014-15,Southern California,F,29,15,519,65,124,.524,59,102,.578,6,22,.273,16,44,.364,39,66,105,13,12,22,44,64,152,3.2
3682,Najee Garvin\najee-garvin-1,2016-17,Charlotte,F,29,12,482,63,126,.500,63,124,.508,0,2,.000,26,41,.634,23,84,107,12,0,9,33,65,152,2.8
3683,Jakeenan Gant\jakeenan-gant-1,2015-16,Missouri,F,30,4,468,60,133,.451,54,110,.491,6,23,.261,26,36,.722,40,73,113,7,12,29,21,60,152,4.0
3684,Mogga Lado\mogga-lado-1,2017-18,Campbell,F,34,3,572,55,97,.567,55,97,.567,0,0,,42,65,.646,36,82,118,39,15,24,33,54,152,4.4
3685,Tulio Da Silva\tulio-dasilva-1,2017-18,South Florida,F,19,12,442,55,136,.404,50,118,.424,5,18,.278,37,53,.698,25,81,106,16,10,10,37,42,152,4.7
3686,Dont'e Reynolds\donte-reynolds-1,2015-16,San Francisco,F,30,29,705,53,101,.525,53,98,.541,0,3,.000,46,72,.639,73,128,201,23,21,25,45,97,152,5.1
3687,Kenny Kaminski\kenny-kaminski-1,2013-14,Michigan State,F,31,3,378,53,104,.510,15,27,.556,38,77,.494,8,13,.615,20,26,46,11,9,8,7,40,152,3.9
3688,Phabian Glasco\phabian-glasco-1,2013-14,Central Arkansas,F,29,25,608,64,111,.577,64,110,.582,0,1,.000,24,53,.453,44,66,110,20,17,56,21,73,152,5.5
3689,Willie Jackson\willie-jackson-1,2017-18,Toledo,F,20,3,379,57,106,.538,56,102,.549,1,4,.250,37,63,.587,43,68,111,23,8,3,37,37,152,5.8
3690,Sagaba Konate\sagaba-konate-1,2016-17,West Virginia,F,37,2,403,62,110,.564,62,110,.564,0,0,,28,44,.636,44,60,104,10,14,53,33,77,152,3.7
3691,Amadi Ikpeze\amadi-ikpeze-1,2017-18,St. Bonaventure,F,34,11,484,62,125,.496,62,125,.496,0,0,,28,47,.596,37,69,106,7,8,16,18,83,152,3.0
3692,Drew Urquhart\drew-urguhart-1,2016-17,Vermont,F,33,11,463,62,107,.579,62,107,.579,0,0,,28,44,.636,47,62,109,19,3,21,36,60,152,3.6
3693,Kion Brown\kion-brown-1,2015-16,Radford,F,31,19,527,63,129,.488,63,129,.488,0,0,,26,46,.565,37,67,104,13,3,12,30,67,152,2.9
3694,Nedeljko Prijovic\nedeljko-prijovic-1,2016-17,Texas State,F,36,1,624,56,131,.427,49,88,.557,7,43,.163,32,47,.681,31,102,133,36,22,23,24,61,151,4.0
3695,Nick Osborne\nick-osborne-1,2013-14,Loyola (IL),F,28,17,495,57,113,.504,54,99,.545,3,14,.214,34,42,.810,29,83,112,19,10,10,31,90,151,3.6
3696,Vance Johnson\vance-johnson-1,2017-18,Milwaukee,F,33,7,481,56,112,.500,53,100,.530,3,12,.250,36,52,.692,41,79,120,8,7,12,36,62,151,3.1
3697,Tyler Rambo\tyler-rambo-1,2013-14,Murray State,F,34,0,553,51,103,.495,51,103,.495,0,0,,49,90,.544,31,32,63,23,15,5,24,34,151,3.3
3698,Braden Koelliker\braden-koelliker-1,2016-17,Colorado State,F,36,5,681,45,122,.369,35,78,.449,10,44,.227,51,63,.810,66,80,146,32,12,8,24,66,151,3.9
3699,Jordan Nobles\jordan-nobles-1,2016-17,Eastern Michigan,F,33,11,693,55,129,.426,33,69,.478,22,60,.367,19,26,.731,25,84,109,30,23,24,30,69,151,3.8
3700,Kennedy Edwards\kennedy-edwards-1,2016-17,Army,F,27,5,397,55,135,.407,41,74,.554,14,61,.230,27,47,.574,31,77,108,13,11,7,36,43,151,3.2
3701,Nick McGlynn\nick-mcglynn-1,2016-17,Drake,F,31,19,446,54,130,.415,50,108,.463,4,22,.182,39,49,.796,46,68,114,11,11,19,27,74,151,3.4
3702,Mike Miklusak\mike-miklusak-1,2013-14,Western Illinois,F,29,10,596,53,151,.351,17,43,.395,36,108,.333,9,15,.600,14,69,83,32,21,7,22,60,151,3.3
3703,Matt Shrigley\matt-shrigley-1,2016-17,San Diego State,F,29,4,591,48,149,.322,5,17,.294,43,132,.326,12,19,.632,13,47,60,19,19,9,16,36,151,3.3
3704,Kostas Antetokounmpo\kostas-antetokounmpo-1,2017-18,Dayton,F,29,6,438,58,101,.574,56,86,.651,2,15,.133,33,64,.516,24,59,83,13,7,31,39,66,151,3.4
3705,Will Kelly\will-kelly-1,2013-14,Navy,F,30,21,616,60,121,.496,60,121,.496,0,0,,31,54,.574,35,95,130,11,6,45,41,72,151,3.7
3706,Michael Hoffman\michael-hoffman-1,2017-18,Texas-Rio Grande Valley,F,31,1,452,52,133,.391,26,62,.419,26,71,.366,21,26,.808,24,55,79,17,14,12,14,65,151,3.4
3707,Larry Toomey\larry-toomey-1,2014-15,Army,F,30,27,651,54,133,.406,30,62,.484,24,71,.338,18,35,.514,38,87,125,38,21,8,32,79,150,3.8
3708,Shawn Valentine\shawn-valentine-1,2015-16,Rider,F,33,8,684,50,122,.410,33,72,.458,17,50,.340,33,51,.647,26,74,100,32,24,15,40,75,150,3.2
3709,Don MuepoKelly\dj-muepo-1,2015-16,South Alabama,F,32,7,509,62,142,.437,61,138,.442,1,4,.250,25,47,.532,48,76,124,14,30,28,33,72,150,3.8
3710,Simi Socks\simi-socks-1,2015-16,Incarnate Word,F,29,5,436,45,101,.446,44,94,.468,1,7,.143,59,69,.855,23,50,73,10,11,16,28,86,150,3.1
3711,Kalif Young\kalif-young-1,2017-18,Providence,F,35,25,582,60,111,.541,60,111,.541,0,0,,30,61,.492,49,93,142,22,14,21,30,71,150,3.8
3712,Jake Belford\jake-belford-1,2013-14,Davidson,F,25,0,385,56,97,.577,39,61,.639,17,36,.472,21,28,.750,20,34,54,10,8,3,30,57,150,3.6
3713,Nathaniel Mason\nathaniel-mason-1,2013-14,Sam Houston State,F,34,0,420,52,112,.464,41,84,.488,11,28,.393,35,51,.686,18,47,65,18,10,2,25,43,150,2.8
3714,Hayden Brown\hayden-brown-1,2017-18,Citadel,F,29,9,390,56,130,.431,44,87,.506,12,43,.279,26,37,.703,22,57,79,26,23,6,30,55,150,3.5
3715,Dominique Reid\dominique-reid-1,2017-18,North Carolina Central,F,33,0,366,60,104,.577,59,102,.578,1,2,.500,29,45,.644,32,76,108,13,3,7,41,58,150,2.8
3716,JR Coronado\jr-coronado-1,2013-14,Liberty,F,32,18,558,64,107,.598,64,107,.598,0,0,,22,48,.458,70,102,172,13,5,17,21,50,150,4.8
3717,Demetris Morant\demetris-morant-1,2014-15,Florida Gulf Coast,F,33,18,623,64,112,.571,64,112,.571,0,0,,22,44,.500,71,75,146,7,7,42,27,91,150,4.2
3718,Chris Reyes\chris-reyes-1,2014-15,Utah,F,35,33,549,58,125,.464,56,122,.459,2,3,.667,32,59,.542,41,87,128,16,9,22,25,48,150,3.5
3719,Brandon Jackson\brandon-jackson-3,2017-18,Southern Illinois-Edwardsville,F,30,3,470,62,123,.504,62,118,.525,0,5,.000,26,43,.605,31,38,69,8,5,8,32,61,150,2.5
3720,Maurice Jeffers\maurice-jeffers-2,2015-16,Delaware,F,29,16,660,47,117,.402,47,117,.402,0,0,,56,100,.560,53,87,140,15,7,32,58,71,150,3.0
3721,Sheldon Jeter\sheldon-jeter-1,2014-15,Pittsburgh,F,32,9,458,58,122,.475,48,95,.505,10,27,.370,24,39,.615,30,49,79,15,11,10,19,53,150,3.3
3722,Jakub Petras\jakub-petras-1,2017-18,Stony Brook,F,32,1,429,60,114,.526,59,113,.522,1,1,1.000,28,50,.560,43,40,83,15,13,14,24,54,149,3.6
3723,Justin Johnson\justin-johnson-7,2014-15,Western Kentucky,F,31,1,482,60,119,.504,60,116,.517,0,3,.000,29,67,.433,46,80,126,22,13,14,18,48,149,4.2
3724,Niels Bunschoten\niels-bunschoten-1,2016-17,Indiana State,F,31,7,478,54,145,.372,26,62,.419,28,83,.337,13,17,.765,6,38,44,15,5,18,23,63,149,2.0
3725,Kyle Noreen\kyle-noreen-1,2013-14,Radford,F,35,32,809,57,112,.509,41,68,.603,16,44,.364,19,31,.613,42,67,109,55,16,13,19,77,149,4.3
3726,Clay Mounce\clay-mounce-1,2017-18,Furman,F,30,1,383,59,105,.562,54,81,.667,5,24,.208,26,39,.667,36,51,87,12,19,8,13,47,149,4.5
3727,Tyrn Flowers\tyrn-flowers-1,2016-17,Massachusetts,F,33,6,441,54,147,.367,21,39,.538,33,108,.306,8,10,.800,15,70,85,24,9,15,22,51,149,2.8
3728,James Bourne\james-bourne-1,2013-14,Winthrop,F,30,11,585,47,91,.516,47,90,.522,0,1,.000,55,88,.625,42,71,113,6,10,7,26,59,149,3.7
3729,Hayden Howell\hayden-howell-1,2016-17,Abilene Christian,F,29,20,451,58,128,.453,57,124,.460,1,4,.250,32,57,.561,37,52,89,17,5,12,43,79,149,2.2
3730,Rod Mills\rod-mills-1,2017-18,Miami (OH),F,34,3,607,56,158,.354,34,88,.386,22,70,.314,15,19,.789,22,71,93,20,13,8,25,46,149,2.5
3731,Luke Worthington\luke-worthington-1,2017-18,Brigham Young,F,35,29,516,57,119,.479,57,119,.479,0,0,,35,59,.593,36,62,98,16,13,7,20,78,149,2.9
3732,Trevor Thompson\trevor-thompson-1,2013-14,Virginia Tech,F,30,11,486,50,122,.410,50,122,.410,0,0,,49,75,.653,42,98,140,6,8,28,44,76,149,3.0
3733,Rashaan Holloway\rashaan-holloway-1,2017-18,Massachusetts,F,15,13,270,63,101,.624,63,101,.624,0,0,,23,37,.622,26,47,73,4,5,26,27,49,149,7.3
3734,Dwayne Morgan\dwayne-morgan-1,2015-16,Nevada-Las Vegas,F,27,22,522,54,127,.425,50,115,.435,4,12,.333,37,50,.740,45,82,127,14,15,16,48,93,149,3.1
3735,Charles Wilson-Fisher\charle-wilson-fisher-1,2016-17,Hampton,F,29,9,489,58,122,.475,55,112,.491,3,10,.300,30,41,.732,53,78,131,10,5,22,32,92,149,3.5
3736,Tony Washington\tony-washington-1,2016-17,La Salle,F,30,12,478,62,106,.585,62,106,.585,0,0,,25,40,.625,40,81,121,15,5,10,39,83,149,3.2
3737,Clint Robinson\clint-robinson-1,2017-18,Illinois-Chicago,F,34,0,516,46,79,.582,46,76,.605,0,3,.000,57,73,.781,53,85,138,6,8,37,30,82,149,4.2
3738,Chris McCullough\chris-mccullough-1,2014-15,Syracuse,F,16,16,450,54,113,.478,53,112,.473,1,1,1.000,40,71,.563,36,74,110,18,27,33,35,41,149,8.6
3739,Tom Lacey\tom-lacey-1,2015-16,Navy,F,33,30,583,48,83,.578,48,83,.578,0,0,,53,92,.576,54,84,138,21,18,2,40,75,149,3.7
3740,Tre Drye\trevante-drye-1,2014-15,Tulane,F,31,31,750,51,114,.447,49,103,.476,2,11,.182,45,80,.563,61,91,152,23,20,6,43,81,149,3.6
3741,Jesse Hunt\jesse-hunt-1,2017-18,Eastern Washington,F,20,5,366,55,111,.495,41,73,.562,14,38,.368,25,31,.806,32,79,111,21,6,9,24,59,149,5.8
3742,Remu Raitanen\remu-raitanen-1,2016-17,San Francisco,F,33,3,633,51,127,.402,24,43,.558,27,84,.321,20,38,.526,34,84,118,22,12,3,17,63,149,3.3
3743,Riley Maye\riley-maye-1,2013-14,Norfolk State,F,33,10,425,64,116,.552,55,98,.561,9,18,.500,12,19,.632,13,24,37,13,2,8,23,69,149,2.2
3744,Ethan Mackey\ethan-mackey-1,2013-14,Maine,F,29,18,485,68,115,.591,68,115,.591,0,0,,13,26,.500,41,97,138,10,11,19,21,54,149,4.7
3745,Treg Setty\treg-setty-1,2014-15,Ohio,F,29,2,512,56,121,.463,45,88,.511,11,33,.333,25,41,.610,31,65,96,27,15,7,35,72,148,3.3
3746,Edward Alade\edward-alade-1,2016-17,Navy,F,32,20,533,67,113,.593,67,112,.598,0,1,.000,14,36,.389,61,54,115,20,18,13,30,71,148,4.0
3747,Angelo Chol\angelo-chol-1,2015-16,San Diego State,F,38,9,505,59,121,.488,59,121,.488,0,0,,30,42,.714,53,65,118,13,15,21,36,84,148,2.8
3748,Greg Kelley\greg-kelley-1,2014-15,Yale,F,32,5,418,52,126,.413,27,52,.519,25,74,.338,19,24,.792,28,52,80,15,9,12,17,69,148,3.0
3749,Tristian Curtis\tristian-curtis-1,2014-15,Coastal Carolina,F,33,28,713,57,106,.538,57,106,.538,0,0,,34,66,.515,82,121,203,6,8,24,28,72,148,4.5
3750,Joe Hanel\joe-hanel-1,2016-17,DePaul,F,32,32,823,61,94,.649,61,94,.649,0,0,,26,50,.520,67,87,154,24,14,13,40,110,148,3.9
3751,Brandon Alston\brandon-alston-2,2014-15,Lehigh,F,30,1,474,46,121,.380,32,82,.390,14,39,.359,42,57,.737,12,32,44,20,6,1,39,45,148,1.9
3752,Alex Foster\alex-foster-1,2017-18,Albany (NY),F,32,1,482,59,110,.536,59,109,.541,0,1,.000,30,58,.517,54,97,151,8,13,30,35,70,148,4.0
3753,Papa Ndao\papa-ndao-1,2015-16,Saint Joseph's,F,30,6,596,49,131,.374,12,27,.444,37,104,.356,13,19,.684,16,81,97,30,15,15,27,75,148,3.3
3754,John Carroll\john-carroll-2,2016-17,Hartford,F,23,17,488,55,147,.374,53,128,.414,2,19,.105,36,62,.581,31,71,102,39,9,10,45,74,148,3.0
3755,Josh Nebo\josh-nebo-1,2015-16,Saint Francis (PA),F,30,29,684,56,115,.487,56,115,.487,0,0,,36,69,.522,56,96,152,14,7,56,26,75,148,4.8
3756,Nigel Jackson\nigel-jackson-1,2017-18,Wagner,F,26,16,441,52,137,.380,22,49,.449,30,88,.341,14,17,.824,35,62,97,21,10,16,29,81,148,3.4
3757,Sean Mobley\sean-mobley-1,2017-18,Virginia Commonwealth,F,33,13,558,50,124,.403,20,45,.444,30,79,.380,18,20,.900,20,80,100,56,12,3,41,75,148,3.1
3758,Demontez Loman\demontez-loman-1,2014-15,Tennessee State,F,31,21,804,59,132,.447,59,131,.450,0,1,.000,30,60,.500,49,127,176,21,21,39,40,100,148,4.0
3759,Junior Saintel\junior-saintel-1,2016-17,Stony Brook,F,32,25,526,60,136,.441,57,114,.500,3,22,.136,25,35,.714,29,85,114,10,10,16,26,47,148,3.2
3760,Alex Olesinski\alex-olesinski-1,2017-18,UCLA,F,33,0,591,50,95,.526,34,51,.667,16,44,.364,32,45,.711,42,86,128,15,11,15,15,76,148,4.2
3761,Mark Donnal\mark-donnal-1,2016-17,Michigan,F,38,0,464,50,81,.617,41,63,.651,9,18,.500,39,50,.780,35,41,76,4,10,12,15,56,148,3.4
3762,Mike Edwards\mike-edwards-2,2016-17,Georgia,F,34,2,615,55,105,.524,55,104,.529,0,1,.000,38,61,.623,38,86,124,7,10,7,36,74,148,2.8
3763,Nate Reuvers\nate-reuvers-1,2017-18,Wisconsin,F,28,15,466,58,152,.382,46,105,.438,12,47,.255,20,24,.833,19,36,55,22,7,26,29,67,148,2.6
3764,Brandan Stith\brandan-stith-1,2013-14,East Carolina,F,33,0,645,51,103,.495,51,103,.495,0,0,,45,82,.549,86,123,209,21,20,39,25,82,147,5.5
3765,Henrik Jadersten\henrik-jadersten-1,2016-17,Santa Clara,F,32,8,447,57,137,.416,32,63,.508,25,74,.338,8,11,.727,16,64,80,8,9,11,26,91,147,2.0
3766,Nick Havener\nick-havener-1,2016-17,Boston University,F,28,7,468,63,98,.643,63,97,.649,0,1,.000,21,40,.525,46,106,152,33,16,15,35,67,147,5.3
3767,Colter Lasher\colter-lasher-1,2013-14,Houston Baptist,F,26,11,427,53,126,.421,31,72,.431,22,54,.407,19,27,.704,28,48,76,21,10,4,35,50,147,3.2
3768,Faith Pope\faith-pope-1,2015-16,Texas-Arlington,F,34,1,391,56,118,.475,47,82,.573,9,36,.250,26,39,.667,25,64,89,21,15,14,17,42,147,3.6
3769,Elijah Schmidt\elijah-schmidt-1,2017-18,Texas A&M-Corpus Christi,F,29,23,638,57,113,.504,55,100,.550,2,13,.154,31,52,.596,47,111,158,23,18,8,32,84,147,4.2
3770,Donovan Smith\donovan-smith-1,2016-17,Quinnipiac,F,21,0,379,53,119,.445,42,94,.447,11,25,.440,30,43,.698,46,67,113,16,13,30,21,62,147,6.3
3771,Mostafa Abdel Latif\mostafa-abdel-latif-1,2013-14,Sacred Heart,F,29,18,546,64,124,.516,64,124,.516,0,0,,19,35,.543,62,105,167,8,7,12,21,72,147,4.3
3772,Jordon Granger\jordon-granger-1,2015-16,Auburn,F,31,13,666,49,112,.438,22,29,.759,27,83,.325,22,34,.647,13,57,70,18,18,15,14,60,147,3.6
3773,Tanner Morgan\tanner-morgan-1,2015-16,Northern Colorado,F,31,19,598,55,149,.369,54,145,.372,1,4,.250,36,54,.667,41,93,134,23,11,7,31,68,147,2.8
3774,Derrick Griffin\derek-griffin-1,2016-17,Texas Southern,F,13,13,443,58,82,.707,57,79,.722,1,3,.333,30,57,.526,75,65,140,5,8,11,12,42,147,12.6
3775,Zach Brown\zach-brown-2,2017-18,Wichita State,F,32,28,650,46,113,.407,21,35,.600,25,78,.321,30,37,.811,29,69,98,57,20,6,38,76,147,3.8
3776,Loomis Gerring\loomis-gerring-1,2014-15,Missouri State,F,31,16,593,53,149,.356,50,131,.382,3,18,.167,38,55,.691,47,65,112,18,17,6,36,64,147,2.6
3777,Bira Seck\bira-seck-1,2013-14,Idaho,F,34,34,680,65,122,.533,65,122,.533,0,0,,17,40,.425,62,110,172,27,8,3,40,118,147,2.8
3778,Marcus Freeman\marcus-freeman-1,2014-15,Coastal Carolina,F,27,0,376,57,108,.528,57,108,.528,0,0,,32,55,.582,64,89,153,8,13,25,17,52,146,5.7
3779,Tanner Schmit\tanner-schmit-1,2016-17,Central Arkansas,F,32,25,595,66,158,.418,66,156,.423,0,2,.000,14,23,.609,33,79,112,15,10,16,22,81,146,2.6
3780,Fabijan Krslovic\fabijan-krslovic-1,2015-16,Montana,F,33,24,657,60,121,.496,60,119,.504,0,2,.000,26,54,.481,55,83,138,48,22,10,43,87,146,3.7
3781,Mohamed Sherif\mohamed-sherif-12,2017-18,Alabama A&M,F,22,20,555,60,143,.420,60,142,.423,0,1,.000,26,78,.333,36,53,89,17,4,9,50,66,146,1.6
3782,Jake White\jake-white-1,2014-15,Omaha,F,20,3,407,51,128,.398,47,106,.443,4,22,.182,40,59,.678,49,63,112,9,6,7,16,48,146,5.2
3783,Anton Waters\anton-waters-1,2015-16,Western Kentucky,F,33,19,480,58,111,.523,58,109,.532,0,2,.000,30,43,.698,57,74,131,7,3,10,26,65,146,3.4
3784,Errick Peck\errick-peck-1,2013-14,Purdue,F,32,10,591,61,127,.480,50,96,.521,11,31,.355,13,27,.481,55,87,142,23,11,15,32,55,146,3.9
3785,Tony Anderson II\tony-andersonii-1,2015-16,Southeast Missouri State,F,29,4,426,49,120,.408,42,100,.420,7,20,.350,41,55,.745,23,39,62,8,11,6,32,21,146,2.9
3786,Demajeo Wiggins\demajeo-wiggins-1,2015-16,Bowling Green State,F,32,7,499,62,110,.564,62,110,.564,0,0,,22,58,.379,42,98,140,3,6,17,27,56,146,3.4
3787,C.J. Neumann\cj-neumann-1,2013-14,Wofford,F,33,13,652,65,112,.580,64,109,.587,1,3,.333,15,30,.500,47,57,104,13,12,6,17,66,146,3.6
3788,Patrick Zeck\patrick-zeck-1,2017-18,Gardner-Webb,F,27,22,625,57,99,.576,53,87,.609,4,12,.333,28,37,.757,42,95,137,18,15,20,21,78,146,5.3
3789,Ryan Sawvell\ryan-sawvell-1,2015-16,Wofford,F,31,0,455,61,103,.592,59,96,.615,2,7,.286,22,29,.759,31,73,104,17,5,4,13,39,146,4.2
3790,Kelvin Penn\kelvin-penn-1,2014-15,Florida Atlantic,F,29,29,781,63,114,.553,63,114,.553,0,0,,20,38,.526,81,101,182,25,19,41,35,95,146,5.6
3791,Trey Davis\trey-davis-2,2014-15,Richmond,F,35,35,1071,59,123,.480,53,103,.515,6,20,.300,22,53,.415,32,137,169,81,43,9,51,93,146,4.4
3792,Chris Washburn\chris-washburn-2,2015-16,Texas Christian,F,22,17,535,48,137,.350,44,126,.349,4,11,.364,46,84,.548,28,66,94,39,27,21,51,68,146,3.8
3793,Skylar Spencer\skylar-spencer-1,2015-16,San Diego State,F,38,30,919,60,101,.594,60,101,.594,0,0,,25,54,.463,93,119,212,20,16,72,22,93,145,5.5
3794,Marcus Bryan\marcus-bryan-1,2015-16,North Carolina-Wilmington,F,32,11,517,55,128,.430,54,127,.425,1,1,1.000,34,59,.576,47,85,132,7,10,35,13,82,145,3.7
3795,Tyler Livingston\tyler-livingston-1,2014-15,Massachusetts-Lowell,F,29,0,425,54,152,.355,24,55,.436,30,97,.309,7,9,.778,21,44,65,13,11,6,21,50,145,2.4
3796,L.J. Livingston\lj-livingston-1,2015-16,Miami (OH),F,31,8,473,56,89,.629,56,89,.629,0,0,,33,49,.673,54,53,107,1,3,29,12,48,145,4.7
3797,Bobby Ahearn\bobby-ahearn-1,2014-15,Binghamton,F,31,18,613,61,117,.521,61,117,.521,0,0,,23,46,.500,55,71,126,11,17,9,35,88,145,3.2
3798,Chris Walker\chris-walker-6,2014-15,Florida,F,31,6,453,64,119,.538,64,116,.552,0,3,.000,17,44,.386,41,67,108,2,10,36,32,63,145,3.4
3799,Isaiah Omoregie\isaiah-omoregie-1,2015-16,Florida A&M,F,19,2,296,61,101,.604,61,100,.610,0,1,.000,23,56,.411,24,40,64,2,6,6,26,44,145,4.3
3800,Antwon Clayton\antwon-clayton-1,2015-16,Jacksonville,F,29,23,609,51,115,.443,50,112,.446,1,3,.333,42,68,.618,61,69,130,22,31,24,32,83,145,4.7
3801,Nicholas West\nicholas-west-1,2013-14,Alabama A&M,F,24,22,392,46,118,.390,30,65,.462,16,53,.302,37,59,.627,23,66,89,18,7,19,44,56,145,3.1
3802,Dan Kimasa\dan-kimasa-1,2017-18,Texas-Rio Grande Valley,F,33,17,460,63,135,.467,63,133,.474,0,2,.000,19,27,.704,26,50,76,7,6,14,20,71,145,2.4
3803,Sam Timmins\sam-timmins-1,2017-18,Washington,F,34,34,612,56,97,.577,56,97,.577,0,0,,33,59,.559,54,104,158,8,15,33,39,88,145,3.8
3804,Brandon Graham\brandon-graham-1,2014-15,Alabama State,F,29,3,511,49,117,.419,39,71,.549,10,46,.217,37,58,.638,30,59,89,20,14,23,28,74,145,3.4
3805,Alex Tiffin\alex-tiffin-1,2014-15,Sacramento State,F,33,4,518,58,120,.483,58,119,.487,0,1,.000,29,40,.725,32,63,95,9,8,9,28,80,145,2.5
3806,George Blagojevic\george-blagojevic-1,2017-18,Hartford,F,32,0,564,60,116,.517,58,105,.552,2,11,.182,23,40,.575,36,81,117,39,18,10,32,54,145,4.0
3807,Christian Musoko\christian-musoko-1,2016-17,Southern Utah,F,32,23,450,51,120,.425,51,119,.429,0,1,.000,43,71,.606,46,72,118,8,5,17,42,101,145,2.0
3808,Tafari Whittingham\tafari-whittingham-1,2015-16,South Alabama,F,30,18,552,55,133,.414,53,125,.424,2,8,.250,33,86,.384,37,72,109,6,13,22,38,78,145,2.1
3809,Jeff Coby\jeff-coby-1,2014-15,Columbia,F,27,10,459,49,131,.374,36,88,.409,13,43,.302,34,47,.723,37,53,90,14,6,19,37,61,145,2.9
3810,Dylan Carl\dylan-carl-1,2017-18,Purdue-Fort Wayne,F,32,1,465,57,131,.435,43,92,.467,14,39,.359,17,33,.515,33,60,93,20,6,27,27,55,145,3.1
3811,Gabe McCray\gabe-mccray-1,2014-15,South Carolina State,F,32,8,517,54,137,.394,51,114,.447,3,23,.130,33,62,.532,38,90,128,8,20,2,40,63,144,2.3
3812,Mitch Lightfoot\mitch-lightfoot-1,2017-18,Kansas,F,38,7,531,60,105,.571,54,88,.614,6,17,.353,18,25,.720,48,68,116,10,10,54,29,83,144,3.6
3813,Brian Pearson\brian-pearson-1,2015-16,Savannah State,F,32,20,753,55,123,.447,55,121,.455,0,2,.000,34,63,.540,56,109,165,23,12,15,44,90,144,3.1
3814,Jagos Lasic\jagos-lasic-1,2017-18,St. Francis (NY),F,31,27,564,51,117,.436,32,67,.478,19,50,.380,23,27,.852,33,66,99,22,27,5,34,58,144,3.6
3815,Ed Drew\ed-drew-1,2014-15,Presbyterian,F,32,9,586,59,125,.472,58,120,.483,1,5,.200,25,43,.581,44,61,105,13,15,18,28,56,144,3.4
3816,Carlton Bragg Jr.\carlton-braggjr-1,2015-16,Kansas,F,38,0,338,64,114,.561,60,107,.561,4,7,.571,12,18,.667,37,57,94,17,14,7,29,61,144,2.8
3817,Jonah Bolden\jonah-bolden-1,2015-16,UCLA,F,31,11,672,51,123,.415,42,87,.483,9,36,.250,33,45,.733,36,114,150,33,21,27,26,64,144,4.7
3818,De'Ron Davis\deron-davis-1,2017-18,Indiana,F,15,15,282,56,91,.615,56,91,.615,0,0,,32,64,.500,27,37,64,16,12,22,12,37,144,8.8
3819,Akoy Agau\akoy-agau-1,2016-17,Georgetown,F,32,8,479,42,84,.500,39,69,.565,3,15,.200,57,67,.851,34,102,136,28,7,28,50,71,144,3.8
3820,Adrease Jackson\adrease-jackson-1,2017-18,Dartmouth,F,26,2,324,55,103,.534,38,71,.535,17,32,.531,17,26,.654,23,76,99,9,5,7,20,40,144,4.2
3821,Baylee Steele\baylee-steele-1,2016-17,Eastern Michigan,F,33,22,643,62,127,.488,62,122,.508,0,5,.000,20,24,.833,42,93,135,11,26,27,24,98,144,3.8
3822,Bobby Ahearn\bobby-ahearn-1,2017-18,Binghamton,F,31,10,473,56,126,.444,46,97,.474,10,29,.345,22,31,.710,36,52,88,14,6,7,32,78,144,2.4
3823,Rashard Kelly\rashard-kelly-1,2015-16,Wichita State,F,35,6,564,54,126,.429,48,107,.449,6,19,.316,30,49,.612,48,79,127,26,17,6,25,67,144,3.3
3824,Kyndahl Hill\kyndahl-hill-1,2013-14,Weber State,F,31,2,566,51,101,.505,44,85,.518,7,16,.438,35,49,.714,42,65,107,14,7,15,27,92,144,3.2
3825,Darryl Reynolds\darryl-reynolds-1,2015-16,Villanova,F,40,7,685,48,76,.632,48,76,.632,0,0,,47,65,.723,48,131,179,14,16,21,28,88,143,3.8
3826,Cameron Wolter\cameron-wolter-1,2016-17,Massachusetts-Lowell,F,30,2,332,57,114,.500,55,104,.529,2,10,.200,27,38,.711,17,26,43,9,11,6,20,60,143,2.6
3827,Zach Smith\zach-smith-1,2017-18,Texas Tech,F,23,15,474,62,107,.579,61,101,.604,1,6,.167,18,42,.429,23,64,87,26,17,23,34,37,143,5.3
3828,Yauhen Massalski\yauhen-massalski-1,2017-18,San Diego,F,34,9,407,53,82,.646,53,81,.654,0,1,.000,37,76,.487,41,80,121,18,5,44,41,71,143,3.6
3829,Michael Nzei\michael-nzei-1,2016-17,Seton Hall,F,33,14,595,54,84,.643,54,83,.651,0,1,.000,35,59,.593,62,65,127,7,12,18,29,81,143,3.9
3830,Tyler Stone\tyler-stone-2,2016-17,Howard,F,33,4,534,43,102,.422,41,90,.456,2,12,.167,55,88,.625,34,86,120,15,9,40,20,64,143,3.9
3831,Kellen McCormick\kellen-mccormick-1,2014-15,Western Michigan,F,32,0,399,50,111,.450,19,33,.576,31,78,.397,12,17,.706,17,30,47,8,5,2,13,44,143,2.7
3832,Jesse Hill\jesse-hill-1,2015-16,Florida Atlantic,F,30,1,549,50,136,.368,32,82,.390,18,54,.333,25,41,.610,17,63,80,11,7,21,9,59,143,3.0
3833,Daniel Utomi\daniel-utomi-1,2016-17,Akron,F,30,2,289,45,101,.446,19,39,.487,26,62,.419,27,39,.692,5,31,36,8,9,2,19,31,143,2.8
3834,Craig Hinton\craig-hinton-1,2014-15,Virginia Military Institute,F,28,2,364,50,125,.400,21,43,.488,29,82,.354,14,21,.667,28,43,71,19,14,10,28,45,143,3.3
3835,Jeremy Combs\jeremy-combs-1,2016-17,North Texas,F,14,13,366,54,96,.563,54,94,.574,0,2,.000,35,69,.507,29,61,90,7,14,9,31,40,143,7.2
3836,Nahshon George\nahshon-george-1,2015-16,Idaho,F,33,16,450,51,118,.432,51,118,.432,0,0,,41,63,.651,48,88,136,14,12,4,53,87,143,2.1
3837,Trent Whiting\trent-whiting-2,2014-15,Arkansas-Pine Bluff,F,32,2,549,59,119,.496,57,105,.543,2,14,.143,23,34,.676,21,53,74,29,24,14,37,53,143,3.3
3838,Trevor Berkeley\trevor-berkeley-1,2013-14,Drake,F,31,19,573,51,99,.515,40,69,.580,11,30,.367,30,37,.811,28,50,78,14,19,12,27,58,143,3.6
3839,Markell Lodge\markell-lodge-1,2016-17,Saint Joseph's,F,31,31,550,63,85,.741,63,85,.741,0,0,,16,39,.410,53,76,129,3,7,29,11,63,142,4.9
3840,Taylor Bruninga\taylor-bruninga-1,2017-18,Illinois State,F,29,7,506,46,120,.383,11,20,.550,35,100,.350,15,21,.714,15,54,69,13,5,6,11,85,142,2.6
3841,Bola Olaniyan\bola-olaniyan-1,2014-15,Southern Illinois,F,31,12,507,55,123,.447,55,123,.447,0,0,,32,53,.604,63,75,138,16,21,7,42,73,142,3.3
3842,Joshua Oswald\joshua-oswald-1,2013-14,Miami (OH),F,31,19,515,56,140,.400,43,85,.506,13,55,.236,17,22,.773,30,58,88,17,11,9,25,48,142,2.8
3843,Shawn Kemp\shawn-kemp-1,2013-14,Washington,F,32,10,493,61,110,.555,61,110,.555,0,0,,20,28,.714,20,36,56,2,5,7,17,87,142,2.2
3844,David Wacker\david-wacker-1,2016-17,Boise State,F,29,28,510,48,78,.615,48,78,.615,0,0,,46,69,.667,50,71,121,12,6,14,24,68,142,4.4
3845,Greg Dotson\greg-dotson-1,2013-14,Morehead State,F,29,9,482,52,104,.500,52,94,.553,0,10,.000,38,57,.667,32,37,69,21,13,18,20,47,142,4.0
3846,Marcanvis Hymon\marcanvis-hymon-1,2017-18,Mississippi,F,32,23,622,60,107,.561,60,107,.561,0,0,,22,46,.478,58,101,159,25,14,26,24,94,142,4.4
3847,Dallas Ennema\dallas-ennema-1,2015-16,Albany (NY),F,32,2,466,50,126,.397,24,49,.490,26,77,.338,16,23,.696,16,61,77,13,10,6,14,45,142,2.9
3848,Norense Odiase\norense-odiase-1,2017-18,Texas Tech,F,37,29,549,51,98,.520,51,98,.520,0,0,,40,66,.606,67,98,165,25,20,15,43,92,142,3.5
3849,Daron Henson\daron-henson-1,2017-18,Utah State,F,33,2,413,46,133,.346,8,34,.235,38,99,.384,12,22,.545,20,44,64,7,1,2,13,50,142,2.0
3850,Junior Etou\junior-etou-1,2013-14,Rutgers,F,27,20,622,54,129,.419,43,86,.500,11,43,.256,23,36,.639,37,88,125,20,6,11,30,63,142,3.4
3851,Josh Carlton\josh-carlton-1,2017-18,Connecticut,F,32,17,485,57,111,.514,57,111,.514,0,0,,28,42,.667,55,63,118,10,10,24,31,79,142,3.4
3852,Frank Okeke\frank-okeke-1,2013-14,New Hampshire,F,26,12,578,43,124,.347,13,36,.361,30,88,.341,26,35,.743,14,57,71,21,9,12,27,53,142,3.1
3853,Stefan Lakic\stefan-lakic-1,2017-18,Samford,F,32,6,403,55,104,.529,38,60,.633,17,44,.386,15,18,.833,11,48,59,6,9,2,24,44,142,2.7
3854,Tyler Stone\tyler-stone-2,2013-14,Howard,F,33,16,646,49,108,.454,47,98,.480,2,10,.200,42,60,.700,41,91,132,7,9,31,39,99,142,2.8
3855,Nicholas Baer\nicholas-baer-1,2017-18,Iowa,F,27,17,578,53,132,.402,30,57,.526,23,75,.307,13,22,.591,51,83,134,49,27,23,29,54,142,5.7
3856,Niels Bunschoten\niels-bunschoten-1,2015-16,Indiana State,F,32,3,462,48,116,.414,28,45,.622,20,71,.282,26,31,.839,14,36,50,13,7,18,21,82,142,2.3
3857,Mikey Henn\mikey-henn-1,2016-17,UC-Davis,F,34,1,447,53,126,.421,39,90,.433,14,36,.389,21,38,.553,17,37,54,22,8,3,40,71,141,1.4
3858,Skye Johnson\skye-johnson-1,2017-18,Delaware,F,30,3,335,56,88,.636,56,88,.636,0,0,,29,41,.707,46,42,88,9,6,9,23,45,141,4.0
3859,Abdul-Malik Abu\abdul-malik-abu-1,2017-18,North Carolina State,F,27,14,402,57,122,.467,56,112,.500,1,10,.100,26,46,.565,34,57,91,12,10,13,28,73,141,3.0
3860,Ian Theisen\ian-theisen-1,2016-17,South Dakota State,F,28,5,428,50,88,.568,35,55,.636,15,33,.455,26,35,.743,22,55,77,20,5,8,22,50,141,3.9
3861,Kennedy Edwards\kennedy-edwards-1,2015-16,Army,F,30,0,432,54,133,.406,41,86,.477,13,47,.277,20,37,.541,40,61,101,17,16,12,24,50,141,3.4
3862,Durand Johnson\durand-johnson-1,2013-14,Pittsburgh,F,16,0,317,45,111,.405,23,46,.500,22,65,.338,29,34,.853,17,31,48,23,14,5,14,24,141,6.9
3863,Luka Kamber\luka-kamber-1,2015-16,Nicholls State,F,34,10,590,46,150,.307,10,23,.435,36,127,.283,13,15,.867,20,42,62,23,12,3,25,72,141,1.7
3864,David Pekarek\david-pekarek-1,2017-18,Fordham,F,27,5,466,49,145,.338,24,49,.490,25,96,.260,18,28,.643,14,70,84,13,11,12,26,41,141,2.7
3865,Brian Dawkins\brian-dawkins-1,2015-16,Elon,F,25,14,367,60,117,.513,54,88,.614,6,29,.207,15,29,.517,14,52,66,12,10,7,31,55,141,2.9
3866,Trey Chapman\trey-chapman-1,2013-14,Virginia Military Institute,F,35,3,603,42,131,.321,33,87,.379,9,44,.205,48,74,.649,38,68,106,31,14,13,31,66,141,2.6
3867,Jules Montgomery\jules-montgomery-1,2013-14,Prairie View,F,32,14,598,51,119,.429,44,98,.449,7,21,.333,32,45,.711,47,80,127,21,19,26,25,84,141,3.8
3868,Elijah Macon\elijah-macon-1,2014-15,West Virginia,F,33,0,433,55,120,.458,55,120,.458,0,0,,31,60,.517,42,46,88,25,10,16,41,63,141,2.5
3869,Treshawn Bolden\treshawn-bolden-1,2017-18,Jackson State,F,22,19,457,56,142,.394,48,117,.410,8,25,.320,21,38,.553,41,80,121,45,7,13,54,66,141,3.5
3870,Jonah Travis\jonah-travis-1,2014-15,Harvard,F,24,3,432,43,85,.506,43,84,.512,0,1,.000,55,72,.764,41,46,87,13,15,10,17,56,141,5.3
3871,Ian Theisen\ian-theisen-1,2017-18,South Dakota State,F,31,6,526,47,96,.490,29,43,.674,18,53,.340,29,41,.707,32,75,107,15,9,7,12,60,141,3.9
3872,Nate Hicks\nate-hicks-1,2013-14,Florida Gulf Coast,F,35,11,543,63,107,.589,63,107,.589,0,0,,15,28,.536,42,110,152,7,0,42,24,56,141,3.9
3873,Lasse Gummerus\lasse-gummerus-1,2017-18,Marist,F,29,15,416,47,109,.431,16,26,.615,31,83,.373,16,18,.889,7,61,68,13,5,1,12,14,141,3.6
3874,Lennard Freeman\lennard-freeman-1,2013-14,North Carolina State,F,35,11,811,55,107,.514,55,107,.514,0,0,,31,69,.449,72,127,199,21,16,9,17,61,141,4.5
3875,Kris Jenkins\kris-jenkins-1,2013-14,Villanova,F,34,1,399,44,118,.373,14,37,.378,30,81,.370,22,27,.815,17,43,60,21,6,9,12,47,140,2.8
3876,Brent Calhoun\brent-calhoun-1,2015-16,Purdue-Fort Wayne,F,34,34,535,63,133,.474,63,133,.474,0,0,,14,24,.583,42,95,137,28,8,40,55,97,140,2.6
3877,Ryghe Lyons\ryghe-lyons-1,2017-18,Nicholls State,F,28,22,507,63,111,.568,62,107,.579,1,4,.250,13,25,.520,45,57,102,38,18,44,49,69,140,4.6
3878,Filip Cvjeticanin\filip-cvjeticanin-1,2015-16,Florida Gulf Coast,F,32,12,466,47,132,.356,4,13,.308,43,119,.361,3,9,.333,7,47,54,12,7,2,13,25,140,2.4
3879,Mickey Mitchell\mickey-mitchell-1,2017-18,Arizona State,F,24,11,541,50,99,.505,43,79,.544,7,20,.350,33,49,.673,35,90,125,39,21,13,33,72,140,5.5
3880,Eyimofe Edukugho\eyimofe-edukugho-1,2015-16,Sacred Heart,F,27,0,334,59,112,.527,59,112,.527,0,0,,22,36,.611,31,43,74,8,7,9,32,68,140,2.7
3881,C.J. Neumann\cj-neumann-1,2014-15,Wofford,F,35,3,718,48,93,.516,48,93,.516,0,0,,44,67,.657,62,96,158,26,18,7,27,74,140,4.0
3882,Rokas Gustys\rokas-gustys-1,2014-15,Hofstra,F,27,5,446,59,103,.573,59,103,.573,0,0,,22,53,.415,73,80,153,21,21,12,30,83,140,5.0
3883,Darian Dixon\darian-dixon-1,2017-18,Northwestern State,F,29,5,461,46,81,.568,46,80,.575,0,1,.000,48,76,.632,43,45,88,8,12,12,28,54,140,3.8
3884,Jacob Calloway\jacob-calloway-1,2017-18,Southern Utah,F,30,9,482,43,131,.328,19,58,.328,24,73,.329,30,41,.732,34,73,107,25,14,8,23,53,140,3.3
3885,Jaylon Moore\jaylon-moore-1,2014-15,Evansville,F,34,6,367,56,76,.737,56,76,.737,0,0,,28,52,.538,19,38,57,4,8,5,14,45,140,3.1
3886,Bobby Ahearn\bobby-ahearn-1,2015-16,Binghamton,F,29,10,472,55,112,.491,55,112,.491,0,0,,30,40,.750,31,71,102,17,6,5,30,72,140,2.9
3887,Marvin King-Davis\marvin-king-davis-1,2013-14,Delaware,F,27,19,440,50,102,.490,50,102,.490,0,0,,39,58,.672,46,54,100,2,3,22,14,72,139,3.9
3888,Dalton Nixon\dalton-nixon-1,2017-18,Brigham Young,F,23,0,399,49,93,.527,44,72,.611,5,21,.238,36,50,.720,27,42,69,30,14,5,19,42,139,5.3
3889,Christian Mekowulu\christian-mekowulu-1,2016-17,Tennessee State,F,30,16,554,47,94,.500,47,93,.505,0,1,.000,45,70,.643,37,75,112,11,16,21,44,82,139,3.1
3890,Darryl Reynolds\darryl-reynolds-1,2016-17,Villanova,F,31,30,738,55,80,.688,55,80,.688,0,0,,29,43,.674,63,104,167,18,16,29,35,53,139,5.4
3891,Breaon Brady\breaon-brady-1,2017-18,Houston,F,33,31,412,59,107,.551,59,107,.551,0,0,,21,32,.656,47,88,135,7,6,10,44,100,139,2.3
3892,Damonte Dodd\damonte-dodd-1,2014-15,Maryland,F,35,31,555,51,84,.607,51,84,.607,0,0,,37,59,.627,47,85,132,22,7,51,35,93,139,3.9
3893,Anthony Longpre\anthony-longpr-1,2017-18,Saint Joseph's,F,32,20,552,49,142,.345,23,73,.315,26,69,.377,15,23,.652,21,71,92,32,11,8,23,48,139,2.8
3894,Eddie Keith\eddie-keith-1,2014-15,Towson,F,30,7,545,41,111,.369,38,93,.409,3,18,.167,54,94,.574,21,52,73,43,11,16,54,74,139,2.0
3895,Antwan Space\antwan-space-1,2015-16,Massachusetts,F,22,14,537,55,149,.369,46,109,.422,9,40,.225,20,45,.444,31,86,117,38,15,18,41,68,139,3.6
3896,Travion Leonard\travion-leonard-1,2013-14,Fordham,F,31,1,484,58,124,.468,58,123,.472,0,1,.000,23,45,.511,59,72,131,9,22,22,31,97,139,3.3
3897,Matt Killian\matt-killian-1,2014-15,Northwestern State,F,32,15,568,52,119,.437,36,78,.462,16,41,.390,19,29,.655,34,50,84,13,21,8,31,50,139,3.0
3898,Marlon Adams\marlon-adams-1,2016-17,Eastern Kentucky,F,31,11,540,59,112,.527,55,99,.556,4,13,.308,17,48,.354,44,82,126,12,10,10,37,76,139,2.7
3899,Jervon Pressley\jervon-pressley-1,2013-14,Hampton,F,21,18,405,49,112,.438,49,112,.438,0,0,,41,72,.569,39,69,108,14,5,23,32,60,139,4.3
3900,Demontez Loman\demontez-loman-1,2015-16,Tennessee State,F,31,31,725,58,106,.547,58,106,.547,0,0,,23,42,.548,63,109,172,12,36,31,28,95,139,5.1
3901,Dartaye Ruffin\dartaye-ruffin-1,2013-14,Drexel,F,28,26,828,61,105,.581,61,105,.581,0,0,,17,30,.567,69,147,216,17,23,20,24,108,139,5.7
3902,Renan Lenz\renan-lenz-1,2013-14,Utah,F,30,14,340,54,98,.551,54,97,.557,0,1,.000,31,42,.738,22,44,66,11,8,28,14,52,139,3.9
3903,Janarius Middleton\janarius-middleton-1,2013-14,Jackson State,F,31,11,471,63,127,.496,59,112,.527,4,15,.267,9,15,.600,36,51,87,4,6,3,21,61,139,2.5
3904,Anthony Wilson\anthony-wilson-2,2017-18,Kennesaw State,F,20,0,359,51,103,.495,50,97,.515,1,6,.167,36,46,.783,36,68,104,35,21,12,23,47,139,7.1
3905,Casey Schlatter\casey-schlatter-1,2017-18,Drake,F,34,3,483,56,117,.479,51,106,.481,5,11,.455,22,33,.667,34,79,113,36,9,10,30,62,139,3.2
3906,Ilias Theodorou\ilias-theodorou-1,2015-16,Pacific,F,28,2,361,49,108,.454,21,41,.512,28,67,.418,12,18,.667,18,48,66,12,4,9,24,48,138,2.9
3907,Denton Koon\denton-koon-1,2013-14,Princeton,F,18,3,411,49,122,.402,41,91,.451,8,31,.258,32,50,.640,23,40,63,20,13,5,22,37,138,4.8
3908,Josh Piper\josh-piper-1,2014-15,Eastern Illinois,F,33,18,535,51,132,.386,25,54,.463,26,78,.333,10,15,.667,19,75,94,27,6,11,15,42,138,3.0
3909,Calvin Godfrey\calvin-godfrey-1,2014-15,Memphis,F,31,9,438,50,115,.435,50,115,.435,0,0,,38,60,.633,45,66,111,10,18,24,23,67,138,3.6
3910,Stephan Bennett\stephan-bennett-1,2014-15,Robert Morris,F,32,7,589,54,133,.406,50,123,.407,4,10,.400,26,43,.605,27,37,64,15,12,14,27,81,138,2.0
3911,Keegan McDowell\keegan-mcdowell-1,2017-18,Liberty,F,37,3,500,44,116,.379,18,46,.391,26,70,.371,24,26,.923,5,37,42,21,6,2,21,39,138,2.0
3912,Brenden Evans\brenden-evans-1,2014-15,Utah Valley,F,27,13,527,53,128,.414,51,123,.415,2,5,.400,30,46,.652,46,53,99,26,11,4,31,79,138,3.0
3913,Killian Tillie\killian-tillie-1,2016-17,Gonzaga,F,33,0,404,46,90,.511,35,67,.522,11,23,.478,35,45,.778,26,81,107,21,24,10,21,60,138,4.0
3914,Jack Hobbs\jack-hobbs-1,2017-18,Hartford,F,33,9,612,45,144,.313,14,25,.560,31,119,.261,17,21,.810,23,77,100,18,18,10,22,57,138,2.6
3915,Benson Osayande\benson-osayande-1,2016-17,Montana State,F,31,0,402,49,90,.544,49,90,.544,0,0,,39,55,.709,35,48,83,6,9,9,21,80,137,3.0
3916,Jernard Jarreau\jernard-jarreau-1,2015-16,Tulane,F,18,11,402,51,113,.451,45,95,.474,6,18,.333,29,52,.558,26,74,100,28,10,31,36,39,137,6.1
3917,Mason Peatling\mason-peatling-1,2016-17,Eastern Washington,F,34,17,525,56,103,.544,45,73,.616,11,30,.367,14,25,.560,31,71,102,23,12,13,20,67,137,3.4
3918,Kaleb Bishop\kaleb-bishop-1,2016-17,Fairleigh Dickinson,F,29,14,517,49,102,.480,42,77,.545,7,25,.280,32,43,.744,34,77,111,18,15,9,32,67,137,3.5
3919,Jaleel Hogan\jaleel-hogan-1,2017-18,Detroit Mercy,F,17,10,283,56,96,.583,56,96,.583,0,0,,25,51,.490,21,36,57,12,5,6,25,55,137,4.6
3920,Deion Taylor\deion-taylor-1,2013-14,Richmond,F,33,12,730,48,120,.400,31,53,.585,17,67,.254,24,50,.480,28,72,100,22,18,15,26,74,137,2.8
3921,Reuben King\reuben-king-1,2015-16,Charleston Southern,F,30,8,459,58,120,.483,55,102,.539,3,18,.167,18,31,.581,42,76,118,27,15,6,21,58,137,3.9
3922,Brandon Swannegan\brandon-swannegan-1,2013-14,Tulsa,F,34,0,452,53,108,.491,53,108,.491,0,0,,31,57,.544,44,59,103,8,6,52,23,93,137,3.2
3923,George Blagojevic\george-blagojevic-1,2016-17,Hartford,F,31,9,555,60,151,.397,58,115,.504,2,36,.056,15,30,.500,27,65,92,21,18,6,39,40,137,2.2
3924,Ricky Doyle\ricky-doyle-1,2015-16,Michigan,F,36,11,438,52,81,.642,52,81,.642,0,0,,33,52,.635,32,39,71,2,3,7,22,64,137,2.5
3925,Traylin Farris\traylin-farris-1,2017-18,Portland State,F,23,10,341,53,106,.500,52,105,.495,1,1,1.000,30,50,.600,35,41,76,14,20,15,11,65,137,5.0
3926,Isaiah Livers\isaiah-livers-1,2017-18,Michigan,F,40,22,604,54,114,.474,33,56,.589,21,58,.362,8,12,.667,36,57,93,16,12,11,23,44,137,2.7
3927,Shaquille Duncan\shaquille-duncan-1,2013-14,Morgan State,F,30,0,452,55,118,.466,55,116,.474,0,2,.000,27,53,.509,33,56,89,17,8,29,31,76,137,2.8
3928,Ike Anigbogu\ike-anigbogu-1,2016-17,UCLA,F,29,0,377,57,101,.564,57,101,.564,0,0,,23,43,.535,41,76,117,6,5,35,24,72,137,3.9
3929,Kassoum Yakwe\kassoum-yakwe-1,2016-17,St. John's (NY),F,33,30,675,51,120,.425,51,120,.425,0,0,,35,59,.593,35,72,107,25,8,64,29,94,137,3.4
3930,Marshall Guilmette\marshall-guilmette-1,2014-15,East Carolina,F,22,17,451,50,122,.410,39,85,.459,11,37,.297,26,38,.684,24,50,74,24,5,9,33,66,137,3.1
3931,Lukas Meisner\lukas-meisner-1,2015-16,Columbia,F,33,7,477,47,109,.431,20,39,.513,27,70,.386,16,25,.640,33,76,109,22,9,16,24,60,137,3.3
3932,Patson Siame\patson-siame-1,2014-15,Loyola Marymount,F,24,11,481,63,139,.453,63,138,.457,0,1,.000,11,28,.393,29,67,96,6,5,25,33,68,137,2.7
3933,Terrell Brown\terrell-brown-5,2017-18,Pittsburgh,F,31,17,535,56,134,.418,53,116,.457,3,18,.167,22,35,.629,39,65,104,17,7,46,30,69,137,3.2
3934,Delino Dear\delino-dear-1,2014-15,Bethune-Cookman,F,31,18,574,51,90,.567,51,90,.567,0,0,,35,49,.714,51,74,125,9,10,22,31,63,137,3.9
3935,Alhaji Fullah\allie-fullah-1,2013-14,Charleston Southern,F,31,27,413,59,89,.663,59,87,.678,0,2,.000,19,29,.655,44,68,112,10,8,23,13,50,137,4.6
3936,Aaron Brennan\aaron-brennan-1,2015-16,IUPUI,F,32,10,569,55,144,.382,54,135,.400,1,9,.111,26,31,.839,37,78,115,33,12,11,31,68,137,2.8
3937,Antwan Maxwell\antwan-maxwell-1,2016-17,Charleston Southern,F,28,14,439,54,144,.375,41,96,.427,13,48,.271,16,27,.593,22,67,89,20,12,20,34,55,137,2.6
3938,Matt Costello\matt-costello-1,2013-14,Michigan State,F,34,21,501,52,87,.598,52,87,.598,0,0,,33,50,.660,47,66,113,27,9,43,22,70,137,4.4
3939,Jaylon Moore\jaylon-moore-1,2013-14,Evansville,F,33,0,455,57,99,.576,57,99,.576,0,0,,23,43,.535,21,40,61,8,11,14,14,56,137,3.0
3940,Jonah Travis\jonah-travis-1,2013-14,Harvard,F,30,0,385,42,75,.560,42,75,.560,0,0,,53,72,.736,47,47,94,8,16,7,16,51,137,4.4
3941,Johnny McCants\johnny-mccants-1,2017-18,New Mexico State,F,34,1,521,61,107,.570,61,103,.592,0,4,.000,14,38,.368,57,89,146,14,13,24,22,56,136,4.1
3942,Anthony Lawrence Jr.\anthony-lawrencejr-1,2015-16,Miami (FL),F,33,0,397,47,92,.511,29,50,.580,18,42,.429,24,40,.600,29,34,63,27,17,11,13,39,136,3.9
3943,Rasheed Worrell\rasheed-worrell-1,2016-17,Bowling Green State,F,31,0,482,53,119,.445,52,112,.464,1,7,.143,29,53,.547,49,68,117,11,13,20,24,87,136,3.1
3944,John Jones\john-jones-1,2013-14,Illinois State,F,23,13,409,50,100,.500,50,100,.500,0,0,,36,60,.600,35,55,90,2,8,16,18,62,136,4.1
3945,Kentan Facey\kentan-facey-1,2014-15,Connecticut,F,31,22,665,57,105,.543,56,104,.538,1,1,1.000,21,29,.724,60,102,162,12,7,12,19,67,136,4.3
3946,Christian Lutete\christian-lutete-1,2016-17,Radford,F,30,4,422,46,122,.377,21,48,.438,25,74,.338,19,30,.633,18,53,71,18,5,2,19,26,136,2.8
3947,Maurice Kirby\maurice-kirby-1,2017-18,IUPUI,F,30,2,451,56,114,.491,56,113,.496,0,1,.000,24,40,.600,39,78,117,13,9,8,28,62,136,3.1
3948,Patrick Onwenu\patrick-onwenu-1,2013-14,Detroit Mercy,F,32,1,485,44,111,.396,44,101,.436,0,10,.000,48,64,.750,61,67,128,14,14,27,41,76,136,3.2
3949,Kerwin Smith\kerwin-smith-1,2016-17,Grand Canyon,F,31,7,450,55,82,.671,55,82,.671,0,0,,26,70,.371,41,71,112,1,7,4,31,48,136,3.0
3950,Christian Behrens\christian-behrens-1,2014-15,University of California,F,30,17,513,53,108,.491,53,108,.491,0,0,,30,53,.566,35,63,98,10,6,11,22,78,136,2.8
3951,Mamadou Ndaiye\mamadou-ndaiye-1,2017-18,Saint Peter's,F,31,1,362,49,95,.516,41,78,.526,8,17,.471,30,53,.566,40,61,101,10,5,7,20,56,136,3.2
3952,Che Bob\che-bob-1,2016-17,Colorado State,F,16,2,292,47,95,.495,40,77,.519,7,18,.389,35,51,.686,23,52,75,12,10,17,21,33,136,6.9
3953,Oskar Michelsen\oskar-michelson-1,2015-16,Davidson,F,32,16,569,40,117,.342,9,19,.474,31,98,.316,25,32,.781,11,50,61,34,7,8,19,49,136,2.7
3954,Ako Kaluna\ako-kaluna-1,2013-14,Northern Arizona,F,32,2,381,52,114,.456,47,86,.547,5,28,.179,27,38,.711,28,48,76,8,8,7,20,57,136,2.6
3955,Tre' McLean\tre-mclean-1,2014-15,Chattanooga,F,32,15,702,47,136,.346,35,74,.473,12,62,.194,30,46,.652,20,77,97,36,25,5,34,70,136,2.6
3956,Prokop Slanina\prokop-slanina-1,2016-17,Fordham,F,23,11,410,51,109,.468,36,59,.610,15,50,.300,19,29,.655,32,42,74,14,15,17,25,67,136,4.2
3957,Albert Almanza\albert-almanza-1,2016-17,Sam Houston State,F,34,1,439,45,106,.425,18,40,.450,27,66,.409,19,25,.760,18,48,66,15,15,4,13,61,136,2.8
3958,Khalil Iverson\khalil-iverson-1,2016-17,Wisconsin,F,35,0,531,50,94,.532,46,81,.568,4,13,.308,32,57,.561,45,71,116,22,18,20,33,37,136,3.8
3959,Tafari Whittingham\tafari-whittingham-1,2016-17,Central Connecticut State,F,22,4,409,52,125,.416,51,123,.415,1,2,.500,31,49,.633,38,61,99,7,9,16,46,70,136,2.6
3960,L.J. Livingston\lj-livingston-1,2014-15,Miami (OH),F,31,12,449,55,84,.655,55,84,.655,0,0,,25,44,.568,38,52,90,3,4,29,17,42,135,4.0
3961,TK Edogi\edogi-tk-1,2016-17,Tulsa,F,32,5,368,49,80,.613,49,79,.620,0,1,.000,37,52,.712,51,66,117,8,8,13,22,50,135,4.0
3962,Akoy Agau\akoy-agau-1,2017-18,Southern Methodist,F,27,9,436,44,86,.512,39,71,.549,5,15,.333,42,60,.700,36,60,96,17,7,12,33,48,135,3.8
3963,Christian Wood\christian-wood-1,2013-14,Nevada-Las Vegas,F,30,2,390,48,117,.410,37,67,.552,11,50,.220,28,35,.800,26,71,97,10,10,29,16,46,135,3.7
3964,Japhet Kadji\japhet-kadji-1,2017-18,North Carolina A&T,F,28,13,409,45,112,.402,26,54,.481,19,58,.328,26,33,.788,17,82,99,14,10,4,24,42,135,3.2
3965,Aamir Simms\aamir-simms-1,2017-18,Clemson,F,34,12,525,53,112,.473,39,69,.565,14,43,.326,15,26,.577,26,82,108,21,8,29,20,45,135,3.6
3966,Patrick Muldoon\patrick-muldoon-1,2015-16,Eastern Illinois,F,30,9,497,58,117,.496,58,116,.500,0,1,.000,19,36,.528,27,63,90,16,12,2,30,96,135,2.1
3967,Omar El Manasterly\omar-el-manasterly-1,2016-17,Jacksonville,F,32,22,495,54,100,.540,54,100,.540,0,0,,27,40,.675,37,73,110,14,17,4,27,70,135,3.2
3968,Cameron Bowles\cameron-bowles-1,2017-18,Chicago State,F,29,12,570,48,120,.400,45,101,.446,3,19,.158,36,44,.818,22,56,78,18,19,26,36,81,135,2.8
3969,Demetrius Henry\demetrius-henry-1,2013-14,South Carolina,F,34,29,611,63,152,.414,63,151,.417,0,1,.000,9,37,.243,55,59,114,13,16,20,28,118,135,1.8
3970,Chris Thompson\christian-thompson-1,2015-16,Southern Utah,F,29,1,369,44,127,.346,21,57,.368,23,70,.329,23,32,.719,10,65,75,14,7,7,23,20,134,2.6
3971,Ozante Fields\ozante-fields-1,2017-18,South Carolina State,F,27,7,410,56,104,.538,56,104,.538,0,0,,22,41,.537,44,63,107,10,5,10,29,73,134,3.2
3972,Rakwan Kelly\rakwan-kelly-1,2014-15,Mississippi Valley State,F,32,12,577,47,118,.398,46,116,.397,1,2,.500,39,66,.591,49,52,101,27,31,5,31,57,134,3.4
3973,Kyle Thomas\kyle-thomas-3,2014-15,Morgan State,F,31,2,344,51,154,.331,33,90,.367,18,64,.281,14,26,.538,20,43,63,7,7,15,21,56,134,1.5
3974,Kevin Panzer\kevin-panzer-1,2014-15,American,F,21,15,508,44,130,.338,29,82,.354,15,48,.313,31,54,.574,10,53,63,47,7,17,39,58,134,3.0
3975,Joel Awich\joel-awich-1,2013-14,Cal Poly,F,33,17,562,53,120,.442,47,89,.528,6,31,.194,22,28,.786,36,53,89,8,10,31,23,62,134,3.0
3976,Jason Carter\jason-carter-4,2014-15,Texas Southern,F,25,2,375,51,134,.381,38,88,.432,13,46,.283,19,39,.487,13,40,53,3,14,11,32,63,134,1.6
3977,Deshon Bayless\deshon-bayless-1,2016-17,Arkansas-Pine Bluff,F,23,11,357,54,120,.450,44,91,.484,10,29,.345,16,31,.516,25,37,62,10,20,5,47,47,134,2.6
3978,Nick Harris\nick-harris-1,2015-16,College of Charleston,F,30,24,588,53,99,.535,53,98,.541,0,1,.000,28,52,.538,44,80,124,10,15,22,24,91,134,3.6
3979,Kai Edwards\kai-edwards-1,2016-17,Northern Colorado,F,29,11,469,58,85,.682,58,85,.682,0,0,,18,50,.360,51,98,149,9,8,2,22,72,134,4.0
3980,Matt Faw\matt-faw-1,2017-18,Holy Cross,F,31,0,330,47,95,.495,26,51,.510,21,44,.477,19,25,.760,5,47,52,12,9,13,25,70,134,2.4
3981,Evan Bailey\evan-bailey-1,2014-15,College of Charleston,F,32,6,514,46,129,.357,18,40,.450,28,89,.315,14,22,.636,21,45,66,12,11,2,12,57,134,2.3
3982,Paulius Satkus\paulius-satkus-1,2014-15,James Madison,F,33,12,523,44,81,.543,40,70,.571,4,11,.364,42,61,.689,26,61,87,32,12,6,43,75,134,2.7
3983,Oliver Black\oliver-black-1,2016-17,Little Rock,F,32,11,587,54,98,.551,54,98,.551,0,0,,25,44,.568,44,61,105,24,5,16,43,98,133,2.4
3984,Skylar Spencer\skylar-spencer-1,2014-15,San Diego State,F,36,36,841,50,94,.532,50,94,.532,0,0,,33,69,.478,71,113,184,11,19,91,25,66,133,5.4
3985,Solomon Young\solomon-young-1,2016-17,Iowa State,F,30,12,524,54,84,.643,53,81,.654,1,3,.333,24,40,.600,41,58,99,1,11,24,24,68,133,3.8
3986,Vacha Vaughn\vacha-vaughn-1,2015-16,Mississippi Valley State,F,35,25,686,52,127,.409,52,118,.441,0,9,.000,29,43,.674,44,106,150,39,21,1,34,88,133,2.9
3987,Nolan Taylor\nolan-taylor-1,2017-18,Pepperdine,F,15,7,299,52,105,.495,51,97,.526,1,8,.125,28,47,.596,26,34,60,13,3,4,10,36,133,6.1
3988,Larry Toomey\larry-toomey-1,2013-14,Army,F,31,9,543,45,136,.331,32,78,.410,13,58,.224,30,46,.652,36,76,112,41,16,9,35,55,133,2.9
3989,Mangok Mathiang\mangok-mathiang-1,2013-14,Louisville,F,37,14,545,47,89,.528,47,89,.528,0,0,,39,63,.619,68,64,132,15,13,51,24,64,133,4.2
3990,Chase Foster\chase-foster-1,2015-16,San Francisco,F,30,13,526,45,117,.385,18,41,.439,27,76,.355,16,24,.667,10,43,53,25,9,1,17,53,133,2.5
3991,Gus Leeper\gus-leeper-1,2013-14,Little Rock,F,32,4,510,46,117,.393,46,117,.393,0,0,,41,52,.788,45,45,90,7,8,22,40,90,133,2.0
3992,Phillip Nolan\phillip-nolan-1,2013-14,Connecticut,F,40,19,566,51,97,.526,51,97,.526,0,0,,31,40,.775,37,58,95,8,8,18,22,99,133,2.2
3993,Michael Nzei\michael-nzei-1,2017-18,Seton Hall,F,34,17,565,53,92,.576,53,92,.576,0,0,,27,47,.574,50,82,132,17,9,8,23,49,133,3.7
3994,Mogga Lado\mogga-lado-1,2016-17,Campbell,F,37,0,581,53,89,.596,53,89,.596,0,0,,27,49,.551,52,92,144,23,13,14,37,75,133,3.2
3995,Tarique Thompson\tarique-thompson-1,2015-16,High Point,F,28,0,338,56,110,.509,55,107,.514,1,3,.333,20,26,.769,35,43,78,9,13,5,18,41,133,3.6
3996,Pierfrancesco Oliva\pierfrancesco-oliva-1,2015-16,Saint Joseph's,F,33,30,546,47,121,.388,31,68,.456,16,53,.302,23,45,.511,32,89,121,56,21,20,25,60,133,4.0
3997,Casey Schlatter\casey-schlatter-1,2016-17,Drake,F,30,3,427,46,91,.505,38,68,.559,8,23,.348,33,39,.846,31,61,92,35,16,9,30,43,133,4.2
3998,Tope Arikawe\tope-arikawe-1,2017-18,North Texas,F,33,4,381,50,96,.521,50,96,.521,0,0,,32,50,.640,51,69,120,3,11,14,26,60,132,3.2
3999,Nate Grimes\nate-grimes-1,2017-18,Fresno State,F,29,0,363,57,90,.633,57,90,.633,0,0,,18,40,.450,64,94,158,5,7,32,17,54,132,5.2
4000,Mason Riggins\mason-riggins-1,2017-18,Cal State Long Beach,F,30,15,565,53,85,.624,53,85,.624,0,0,,26,46,.565,43,75,118,19,13,20,22,49,132,4.6
4001,Mikel Tyson\mikel-tyson-1,2016-17,Alabama State,F,30,10,419,54,96,.563,54,94,.574,0,2,.000,24,50,.480,44,55,99,10,7,17,27,57,132,3.3
4002,Dylan Sherwood\dylan-sherwood-1,2015-16,North Carolina-Wilmington,F,32,9,388,50,115,.435,29,42,.690,21,73,.288,11,15,.733,26,47,73,12,12,8,17,46,132,2.9
4003,Ilija Stojiljkovic\ilija-stojiljkovic-1,2017-18,Maine,F,31,24,623,51,107,.477,38,72,.528,13,35,.371,17,40,.425,35,123,158,28,19,9,39,73,132,3.4
4004,Nate Austin\nate-austin-1,2013-14,Brigham Young,F,35,34,934,48,88,.545,46,83,.554,2,5,.400,34,52,.654,90,188,278,32,26,31,37,119,132,5.4
4005,Josh Piper\josh-piper-1,2013-14,Eastern Illinois,F,30,15,534,50,126,.397,31,66,.470,19,60,.317,13,17,.765,34,53,87,35,8,19,28,62,132,3.2
4006,Matt Christiansen\matt-christiansen-1,2014-15,San Francisco,F,31,14,552,58,107,.542,58,107,.542,0,0,,16,26,.615,31,74,105,25,7,11,30,77,132,3.0
4007,Brayden Holker\brayden-holker-1,2016-17,Southern Utah,F,33,1,486,49,88,.557,49,88,.557,0,0,,34,54,.630,41,42,83,4,7,8,24,79,132,2.5
4008,Amos Given\amos-given-1,2016-17,Mississippi Valley State,F,26,9,383,60,131,.458,60,131,.458,0,0,,11,25,.440,34,33,67,9,15,0,34,51,131,2.2
4009,Ian Kinard\ian-kinard-1,2016-17,South Carolina State,F,30,20,550,43,107,.402,42,98,.429,1,9,.111,44,65,.677,40,64,104,13,6,10,32,84,131,2.3
4010,Hunter Sabety\hunter-sabety-1,2016-17,Hofstra,F,32,4,394,49,71,.690,49,71,.690,0,0,,33,62,.532,59,85,144,5,6,40,22,75,131,4.4
4011,Charles Waters\charles-waters-1,2015-16,Arkansas State,F,31,17,424,51,128,.398,51,127,.402,0,1,.000,29,40,.725,35,80,115,11,17,33,26,85,131,3.0
4012,Matt Ryan\matt-ryan-1,2016-17,Notre Dame,F,36,0,286,43,99,.434,7,16,.438,36,83,.434,9,10,.900,6,26,32,14,6,1,13,29,131,2.3
4013,Ethan Lee\ethan-lee-1,2017-18,Central Arkansas,F,30,17,472,54,102,.529,54,102,.529,0,0,,23,43,.535,45,62,107,27,15,9,27,59,131,3.8
4014,Jeff Beverly\jeff-beverly-2,2017-18,Iowa State,F,28,18,484,51,117,.436,42,79,.532,9,38,.237,20,29,.690,41,42,83,15,12,3,24,56,131,3.1
4015,Mason Riggins\mason-riggins-1,2015-16,Cal State Long Beach,F,35,23,504,55,108,.509,55,108,.509,0,0,,21,58,.362,40,52,92,11,13,15,23,62,131,2.6
4016,Elston Jones\elston-jones-1,2015-16,Utah State,F,31,10,457,51,100,.510,51,100,.510,0,0,,29,56,.518,55,61,116,18,15,20,34,77,131,3.4
4017,Spencer Eliason\spencer-eliason-1,2017-18,North Dakota State,F,32,28,571,57,102,.559,57,102,.559,0,0,,17,37,.459,49,59,108,17,10,12,29,83,131,3.0
4018,Cory Kilby\cory-kilby-1,2017-18,Mercer,F,33,1,499,45,100,.450,22,39,.564,23,61,.377,18,27,.667,17,59,76,22,8,7,16,41,131,3.1
4019,Ty Groce\ty-groce-1,2017-18,Eastern Michigan,F,34,9,506,46,118,.390,31,70,.443,15,48,.313,24,39,.615,22,66,88,22,22,17,34,66,131,2.5
4020,Demetris Morant\demetris-morant-1,2015-16,Florida Gulf Coast,F,23,18,423,53,92,.576,53,92,.576,0,0,,25,53,.472,40,81,121,7,3,32,26,74,131,4.5
4021,Nolan Long\nolan-long-1,2014-15,Wagner,F,30,5,335,51,89,.573,51,89,.573,0,0,,29,39,.744,38,54,92,1,6,14,28,73,131,2.9
4022,Ibrahim Sylla\ibrahim-sylla-1,2015-16,Northern Colorado,F,28,4,420,51,96,.531,51,96,.531,0,0,,29,61,.475,46,65,111,5,18,14,32,82,131,3.2
4023,Tim Rowe\tim-rowe-1,2017-18,Southern Mississippi,F,31,16,507,54,110,.491,51,94,.543,3,16,.188,20,36,.556,19,66,85,11,8,17,20,72,131,2.6
4024,Nate Sikma\nate-sikma-1,2013-14,Hartford,F,22,7,473,46,113,.407,29,54,.537,17,59,.288,22,31,.710,26,71,97,38,11,6,28,49,131,4.6
4025,Cameron Lewis\cameron-lewis-2,2017-18,Howard,F,33,23,645,51,98,.520,50,96,.521,1,2,.500,28,40,.700,52,68,120,33,13,15,41,97,131,3.1
4026,Jackson Davis\jackson-davis-1,2017-18,Eastern Kentucky,F,16,9,288,48,105,.457,44,87,.506,4,18,.222,31,40,.775,23,52,75,7,18,6,22,35,131,6.0
4027,Austin Awad\austin-awad-1,2017-18,Winthrop,F,30,1,311,43,119,.361,7,13,.538,36,106,.340,8,10,.800,16,45,61,5,5,2,12,34,130,2.4
4028,Joseph Lewis\joseph-lewis-1,2015-16,Delaware State,F,29,10,401,51,121,.421,44,99,.444,7,22,.318,21,40,.525,21,70,91,23,18,8,32,61,130,2.7
4029,Noah McCarty\noah-mccarty-1,2017-18,Northern Illinois,F,32,0,531,48,116,.414,40,83,.482,8,33,.242,26,43,.605,36,66,102,18,17,10,32,70,130,2.6
4030,Sam Neumann\sam-neumann-1,2017-18,Montana State,F,32,31,630,40,74,.541,30,46,.652,10,28,.357,40,55,.727,46,97,143,27,12,1,21,86,130,3.9
4031,Matt O'Leary\matt-oleary-1,2013-14,Loyola (IL),F,31,5,624,47,108,.435,39,71,.549,8,37,.216,28,49,.571,28,65,93,59,21,15,54,67,130,3.1
4032,Freddie McSwain\freddie-mcswain-1,2017-18,Indiana,F,31,8,453,45,101,.446,45,100,.450,0,1,.000,40,70,.571,60,80,140,16,10,18,28,59,130,3.7
4033,Nicolas Claxton\nicolas-claxton-1,2017-18,Georgia,F,33,5,485,44,98,.449,36,76,.474,8,22,.364,34,65,.523,55,74,129,6,5,42,23,57,130,3.6
4034,Scott Ulaneo\scott-ulaneo-1,2016-17,Seattle,F,30,0,456,46,101,.455,38,71,.535,8,30,.267,30,61,.492,29,68,97,27,13,7,34,73,130,2.7
4035,Erik Kinney\erik-kinney-1,2013-14,Cal State Bakersfield,F,30,11,563,41,105,.390,41,100,.410,0,5,.000,48,77,.623,49,69,118,25,18,19,43,69,130,3.2
4036,Brett Boese\brett-boese-1,2014-15,Washington State,F,30,0,494,46,122,.377,11,25,.440,35,97,.361,3,6,.500,12,24,36,32,7,2,15,33,130,2.7
4037,Dom Hoffman\dom-hoffman-1,2014-15,Bucknell,F,28,13,436,54,122,.443,53,117,.453,1,5,.200,21,31,.677,38,48,86,22,1,7,30,37,130,2.8
4038,Antonio Campbell\antonio-campbell-1,2013-14,Ohio,F,34,9,327,52,90,.578,51,81,.630,1,9,.111,25,46,.543,28,61,89,11,7,13,23,62,130,2.7
4039,Lesley Varner Jr.\lesley-varnerjr-1,2016-17,Texas-Rio Grande Valley,F,32,3,473,46,129,.357,30,71,.423,16,58,.276,22,34,.647,30,41,71,28,26,5,26,61,130,2.7
4040,Tanner Clayton\tanner-clayton-1,2014-15,Stephen F. Austin,F,32,9,508,53,109,.486,46,92,.500,7,17,.412,17,24,.708,45,64,109,21,12,49,13,68,130,4.5
4041,Jeffery McClendon\jeffery-mcclendon-1,2017-18,Loyola Marymount,F,31,13,749,48,139,.345,31,75,.413,17,64,.266,17,23,.739,35,52,87,54,65,5,41,93,130,3.8
4042,Kelvin Penn\kelvin-penn-1,2013-14,Florida Atlantic,F,31,24,812,58,92,.630,58,92,.630,0,0,,14,37,.378,90,89,179,20,24,71,36,97,130,5.9
4043,Eugene McCrory\eugene-mccrory-1,2013-14,Central Florida,F,26,6,371,46,90,.511,46,90,.511,0,0,,38,61,.623,43,32,75,8,5,15,13,48,130,4.0
4044,Grandy Glaze\grandy-glaze-1,2013-14,Saint Louis,F,34,6,439,53,110,.482,53,110,.482,0,0,,24,34,.706,42,111,153,11,14,10,29,45,130,3.4
4045,Giacomo Zilli\giacomo-zilli-1,2014-15,North Carolina-Asheville,F,24,18,341,49,89,.551,49,89,.551,0,0,,32,51,.627,45,58,103,16,6,18,26,44,130,4.8
4046,Gyorgy Goloman\gyorgy-goloman-1,2016-17,UCLA,F,35,5,401,54,93,.581,53,83,.639,1,10,.100,21,33,.636,26,59,85,23,21,29,23,69,130,3.6
4047,Jordan Session\jordan-session-1,2016-17,Georgia State,F,32,11,494,50,119,.420,41,84,.488,9,35,.257,21,42,.500,35,61,96,13,8,17,22,83,130,2.3
4048,Armani Flannigan\armani-flannigan-1,2014-15,North Texas,F,29,5,428,50,95,.526,50,95,.526,0,0,,29,51,.569,36,41,77,5,17,17,18,41,129,3.8
4049,Corey Stern\corey-stern-2,2013-14,Texas State,F,28,6,410,43,93,.462,43,91,.473,0,2,.000,43,66,.652,40,58,98,15,4,10,27,45,129,3.4
4050,Khaliq Spicer\khaliq-spicer-1,2013-14,Kent State,F,32,9,458,56,99,.566,56,99,.566,0,0,,17,48,.354,39,81,120,4,8,45,22,57,129,3.7
4051,Josh Martin\josh-martin-2,2015-16,Cal Poly,F,21,8,335,45,119,.378,39,96,.406,6,23,.261,33,57,.579,30,52,82,13,7,13,29,49,129,3.2
4052,Darius George\darius-george-1,2017-18,Marshall,F,28,1,403,49,97,.505,35,54,.648,14,43,.326,17,38,.447,26,60,86,8,18,10,19,55,129,3.5
4053,Blake Ralling\blake-ralling-1,2013-14,Mississippi Valley State,F,29,6,407,44,104,.423,29,62,.468,15,42,.357,26,36,.722,21,48,69,10,9,3,22,75,129,2.2
4054,Adrion Webber\adrion-webber-1,2014-15,Oral Roberts,F,34,7,478,37,100,.370,16,31,.516,21,69,.304,34,39,.872,26,58,84,14,12,1,12,35,129,3.1
4055,Michal Cekovsky\michal-cekovsky-1,2016-17,Maryland,F,17,4,224,55,82,.671,55,82,.671,0,0,,19,37,.514,21,27,48,8,2,20,16,43,129,5.7
4056,Ricky Doyle\ricky-doyle-1,2017-18,Florida Gulf Coast,F,26,13,400,53,95,.558,53,93,.570,0,2,.000,23,37,.622,29,62,91,21,11,20,29,58,129,4.0
4057,Kavon Waller\kavon-waller-1,2014-15,Delaware State,F,36,9,491,46,85,.541,29,46,.630,17,39,.436,20,26,.769,27,37,64,16,3,5,24,54,129,2.4
4058,Zacarry Douglas\zacarry-douglas-1,2017-18,North Carolina Central,F,31,27,414,49,103,.476,37,68,.544,12,35,.343,19,28,.679,36,99,135,19,4,12,27,48,129,3.5
4059,Dan Garvin\dan-garvin-1,2016-17,Bryant,F,25,10,479,54,93,.581,54,93,.581,0,0,,21,40,.525,41,88,129,9,12,29,28,72,129,4.6
4060,Malte Kramer\malte-kramer-1,2013-14,Pepperdine,F,28,9,389,43,92,.467,13,25,.520,30,67,.448,13,22,.591,4,35,39,22,3,4,16,39,129,2.9
4061,Kenneth Lowe\kenneth-lowe-1,2013-14,Green Bay,F,31,0,499,52,86,.605,52,86,.605,0,0,,25,43,.581,39,69,108,24,14,28,35,48,129,4.1
4062,Collin Spickerman\collin-spickerman-1,2014-15,Portland State,F,29,18,604,57,122,.467,55,115,.478,2,7,.286,13,18,.722,51,73,124,20,18,72,28,68,129,5.1
4063,Michel Nzege\michael-ofik-nzege-1,2015-16,East Carolina,F,29,15,521,48,93,.516,48,93,.516,0,0,,33,41,.805,48,58,106,17,10,12,30,52,129,3.8
4064,Max Curran\max-curran-1,2017-18,Maryland-Baltimore County,F,28,10,335,48,110,.436,34,54,.630,14,56,.250,19,36,.528,23,63,86,8,2,7,17,54,129,2.6
4065,Mario Matasovic\mario-matasovic-1,2016-17,Sacred Heart,F,22,5,378,42,96,.438,31,61,.508,11,35,.314,34,43,.791,25,50,75,10,11,13,21,61,129,4.1
4066,Karl Gamble\karl-gamble-1,2017-18,Middle Tennessee,F,33,10,477,52,99,.525,50,91,.549,2,8,.250,23,38,.605,43,62,105,8,9,13,26,59,129,2.9
4067,Daniel Gomis\daniel-gomis-1,2014-15,Oregon State,F,30,25,642,44,96,.458,44,96,.458,0,0,,41,70,.586,48,68,116,16,14,41,39,93,129,3.3
4068,Brandon Swannegan\brandon-swannegan-1,2014-15,Tulsa,F,34,10,569,44,96,.458,44,96,.458,0,0,,41,74,.554,64,72,136,4,19,49,28,84,129,3.7
4069,Malcolm Moore\malcolm-moore-1,2013-14,Milwaukee,F,34,1,444,47,109,.431,38,79,.481,9,30,.300,25,39,.641,41,60,101,19,8,15,29,62,128,2.6
4070,Theo John\theo-john-2,2017-18,Marquette,F,33,1,391,55,96,.573,55,96,.573,0,0,,18,36,.500,26,50,76,8,11,26,37,83,128,2.2
4071,Matt Smith\matt-smith-6,2013-14,Toledo,F,34,1,375,43,108,.398,16,32,.500,27,76,.355,15,21,.714,17,44,61,7,6,6,13,36,128,2.4
4072,Karachi Edo\karachi-edo-1,2016-17,Fresno State,F,17,6,382,46,98,.469,41,79,.519,5,19,.263,31,54,.574,32,62,94,13,9,22,10,33,128,7.1
4073,Anthony Walker\anthony-walker-3,2014-15,Texas-Arlington,F,29,11,368,54,84,.643,54,84,.643,0,0,,20,31,.645,20,63,83,4,10,25,21,57,128,3.6
4074,Jacob Lawson\jacob-lawson-1,2014-15,Appalachian State,F,27,0,355,50,109,.459,50,108,.463,0,1,.000,28,41,.683,20,52,72,5,14,28,27,60,128,3.0
4075,Logan McLane\logan-mclane-1,2014-15,Miami (OH),F,32,17,457,52,102,.510,43,77,.558,9,25,.360,15,27,.556,27,56,83,18,17,6,25,61,128,2.9
4076,Ioannis Dimakopoulos\ioannis-dimakopoulos-1,2014-15,UC-Irvine,F,34,2,369,57,126,.452,51,105,.486,6,21,.286,8,13,.615,15,41,56,14,4,23,19,48,128,2.2
4077,Devarick Houston\devarick-houston-1,2013-14,Maryland-Baltimore County,F,29,26,736,47,137,.343,35,85,.412,12,52,.231,22,38,.579,45,93,138,31,44,27,42,93,128,3.8
4078,Strahinja Gavrilovic\strahinja-gavrilovic-1,2014-15,Southern California,F,26,0,356,40,94,.426,38,86,.442,2,8,.250,46,65,.708,34,35,69,6,10,2,20,42,128,3.2
4079,Marko Vasic\marko-vasic-1,2015-16,American,F,31,21,787,50,120,.417,43,91,.473,7,29,.241,21,29,.724,27,110,137,68,27,6,36,68,128,4.1
4080,Jalen Chapman\jalen-chapman-1,2014-15,Western Illinois,F,26,7,452,51,121,.421,51,121,.421,0,0,,26,50,.520,33,78,111,12,25,18,43,58,128,3.1
4081,Terrell Allen\terrell-allen-1,2013-14,Central Connecticut State,F,29,1,440,45,126,.357,33,78,.423,12,48,.250,26,41,.634,31,54,85,11,5,22,22,43,128,2.7
4082,Theo Pinson\theo-pinson-1,2016-17,North Carolina,F,21,13,500,43,113,.381,34,75,.453,9,38,.237,33,47,.702,28,69,97,77,18,4,31,37,128,6.2
4083,Chris Bryant\chris-bryant-2,2014-15,Miami (OH),F,29,14,494,44,93,.473,43,89,.483,1,4,.250,39,61,.639,36,58,94,14,13,9,27,71,128,3.0
4084,P.J. Horne\pj-horne-1,2017-18,Virginia Tech,F,28,1,327,49,83,.590,47,77,.610,2,6,.333,28,42,.667,31,36,67,2,4,7,18,40,128,3.3
4085,Lorenzo Hunt\lorenzo-hunt-1,2017-18,Mississippi Valley State,F,31,13,506,50,127,.394,44,108,.407,6,19,.316,22,35,.629,25,45,70,18,18,7,31,51,128,2.2
4086,Evan Smotrycz\evan-smotrycz-1,2014-15,Maryland,F,27,2,533,39,121,.322,21,59,.356,18,62,.290,32,42,.762,24,88,112,34,14,10,29,53,128,3.4
4087,Alex Reese\alex-reese-1,2017-18,Alabama,F,32,1,370,46,118,.390,22,44,.500,24,74,.324,11,14,.786,22,67,89,9,15,7,21,33,127,2.8
4088,Christian Kirk\christian-kirk-1,2014-15,Missouri State,F,29,6,448,51,98,.520,51,98,.520,0,0,,25,40,.625,33,53,86,12,9,16,30,54,127,3.1
4089,Jonathan Galloway\jonathan-galloway-1,2017-18,UC-Irvine,F,35,35,893,51,108,.472,51,108,.472,0,0,,25,43,.581,78,186,264,18,17,47,45,104,127,4.3
4090,Kale Abrahamson\kale-abrahamson-1,2013-14,Northwestern,F,33,11,509,40,112,.357,12,31,.387,28,81,.346,19,34,.559,9,52,61,12,5,5,14,36,127,2.1
4091,Justin Tillman\justin-tillman-1,2014-15,Virginia Commonwealth,F,35,1,431,56,104,.538,56,103,.544,0,1,.000,15,31,.484,38,50,88,2,12,34,14,57,127,3.2
4092,Ryan Luther\ryan-luther-1,2017-18,Pittsburgh,F,10,10,325,48,105,.457,36,74,.486,12,31,.387,19,29,.655,36,65,101,28,16,7,19,28,127,12.4
4093,Ami Lakoju\ami-lakoju-1,2017-18,UC-Santa Barbara,F,32,8,384,58,99,.586,58,99,.586,0,0,,11,24,.458,51,55,106,2,2,19,30,67,127,2.7
4094,Josh Ayeni\josh-ayeni-1,2017-18,St. Bonaventure,F,24,18,351,53,120,.442,52,116,.448,1,4,.250,20,32,.625,30,37,67,7,5,3,21,74,127,2.2
4095,Khadim Sy\khadim-sy-1,2016-17,Virginia Tech,F,32,28,364,55,97,.567,54,96,.563,1,1,1.000,16,27,.593,28,58,86,6,3,20,24,45,127,2.9
4096,Tony Nunn\tony-nunn-1,2015-16,Southern,F,35,3,416,55,101,.545,55,101,.545,0,0,,17,42,.405,40,60,100,3,4,40,28,79,127,2.5
4097,Olalekan Ajayi\lekan-ajayi-1,2015-16,Cal State Northridge,F,26,25,654,47,95,.495,47,95,.495,0,0,,33,51,.647,59,137,196,11,20,13,44,76,127,4.5
4098,Derrick Williams\derrick-williams-3,2013-14,Richmond,F,22,21,453,40,83,.482,32,58,.552,8,25,.320,39,54,.722,19,63,82,16,4,9,22,55,127,4.0
4099,Kyle Guice\kyle-guice-1,2016-17,Illinois-Chicago,F,36,3,508,41,106,.387,2,4,.500,39,102,.382,6,9,.667,8,70,78,32,7,8,19,48,127,2.5
4100,AJ Sumbry\aj-sumbry-1,2016-17,Wagner,F,30,9,445,48,93,.516,48,93,.516,0,0,,31,52,.596,50,71,121,8,5,38,37,85,127,3.2
4101,Brandon Nazione\brandon-nazione-1,2014-15,Eastern Michigan,F,35,13,538,44,111,.396,42,96,.438,2,15,.133,37,54,.685,42,82,124,16,19,12,32,68,127,2.7
4102,Nick Allen\nick-allen-1,2015-16,Texas-San Antonio,F,31,14,501,50,110,.455,43,84,.512,7,26,.269,20,31,.645,22,69,91,24,12,10,45,84,127,1.9
4103,Tyrone O'Garro\tyrone-ogarro-1,2013-14,Monmouth,F,32,20,757,49,108,.454,49,108,.454,0,0,,29,72,.403,72,121,193,33,18,3,45,82,127,3.3
4104,Joey van Zegeren\joey-van-zegeren-1,2014-15,Virginia Tech,F,13,3,265,57,95,.600,57,94,.606,0,1,.000,13,41,.317,30,39,69,3,5,18,15,33,127,7.4
4105,Jayce Johnson\jayce-johnson-1,2016-17,Utah,F,32,6,393,52,92,.565,52,92,.565,0,0,,23,53,.434,43,95,138,4,4,20,28,67,127,3.0
4106,Demetrius Henry\demetrius-henry-1,2014-15,South Carolina,F,21,19,410,52,102,.510,51,99,.515,1,3,.333,22,35,.629,27,49,76,6,7,19,34,69,127,3.2
4107,Jack Flournoy\jack-flournoy-1,2013-14,Northern Kentucky,F,29,4,358,46,113,.407,17,34,.500,29,79,.367,6,7,.857,9,26,35,9,3,3,12,32,127,2.3
4108,Tom Vodanovich\tom-vodanovich-1,2013-14,James Madison,F,31,13,654,46,120,.383,34,70,.486,12,50,.240,23,38,.605,36,92,128,13,17,9,43,84,127,2.1
4109,Aaron Tate\aaron-tate-1,2014-15,Robert Morris,F,33,30,791,55,110,.500,55,110,.500,0,0,,16,33,.485,57,88,145,13,15,9,29,56,126,3.3
4110,Lance Stokes\lance-stokes-1,2013-14,Chattanooga,F,32,18,778,41,80,.513,41,80,.513,0,0,,44,80,.550,43,74,117,18,24,11,32,76,126,3.3
4111,Jeriah Horne\jeriah-horne-1,2016-17,Nebraska,F,29,0,341,47,116,.405,25,50,.500,22,66,.333,10,15,.667,9,46,55,11,7,3,23,27,126,2.2
4112,Ethan Lee\ethan-lee-1,2013-14,Central Arkansas,F,29,8,464,45,97,.464,45,92,.489,0,5,.000,36,64,.563,37,39,76,5,10,10,14,84,126,2.6
4113,Dante Buford\dante-buford-1,2015-16,Oklahoma,F,36,0,442,39,112,.348,26,72,.361,13,40,.325,35,48,.729,20,45,65,20,9,10,26,38,126,2.1
4114,Leo Goodman\leo-goodman-1,2017-18,Stetson,F,24,0,342,46,111,.414,21,52,.404,25,59,.424,9,10,.900,18,37,55,10,13,3,14,39,126,3.4
4115,Adrio Bailey\adrio-bailey-1,2017-18,Arkansas,F,31,16,439,53,98,.541,53,98,.541,0,0,,20,33,.606,29,50,79,17,15,23,18,59,126,3.6
4116,Kaiden Rice\kaiden-rice-1,2017-18,Citadel,F,23,1,214,44,130,.338,12,28,.429,32,102,.314,6,8,.750,11,20,31,9,9,0,10,9,126,2.9
4117,Lennard Freeman\lennard-freeman-1,2014-15,North Carolina State,F,35,21,681,51,114,.447,51,114,.447,0,0,,24,48,.500,70,127,197,19,9,7,23,63,126,3.5
4118,Daniel Akin\daniel-akin-1,2017-18,Maryland-Baltimore County,F,36,20,608,48,74,.649,48,74,.649,0,0,,30,74,.405,48,73,121,12,12,8,36,79,126,2.5
4119,Gerald Blackshear\gerald-blackshear-1,2015-16,Detroit Mercy,F,31,2,469,48,87,.552,48,87,.552,0,0,,30,54,.556,54,71,125,9,10,16,26,80,126,3.3
4120,David Pellom\david-pellom-2,2013-14,Memphis,F,30,0,406,55,81,.679,55,81,.679,0,0,,16,31,.516,38,49,87,18,11,6,18,42,126,4.0
4121,Mark Donnal\mark-donnal-1,2017-18,Clemson,F,34,3,425,46,88,.523,26,46,.565,20,42,.476,14,19,.737,17,38,55,10,7,10,14,60,126,2.6
4122,Shawn Valentine\shawn-valentine-1,2014-15,Rider,F,32,0,578,43,120,.358,22,54,.407,21,66,.318,19,37,.514,30,36,66,31,17,5,31,52,126,2.3
4123,Jack Salt\jack-salt-1,2016-17,Virginia,F,34,34,627,52,93,.559,52,93,.559,0,0,,22,45,.489,53,84,137,13,11,22,21,88,126,3.4
4124,Larry Dennis\larry-dennis-1,2016-17,Stetson,F,32,19,414,51,117,.436,51,116,.440,0,1,.000,24,65,.369,27,68,95,4,6,25,25,94,126,1.6
4125,Josh Boutte\josh-boutte-1,2017-18,Sam Houston State,F,23,21,316,53,86,.616,53,86,.616,0,0,,20,30,.667,36,41,77,5,2,7,17,50,126,4.1
4126,Vacha Vaughn\vacha-vaughn-1,2014-15,Mississippi Valley State,F,32,19,561,51,110,.464,50,104,.481,1,6,.167,22,39,.564,41,82,123,20,25,2,30,78,125,2.9
4127,Thaddeus Handley\thaddeus-handley-1,2015-16,Arkansas-Pine Bluff,F,22,17,334,50,112,.446,38,80,.475,12,32,.375,13,21,.619,18,51,69,8,17,3,34,37,125,3.1
4128,Brent Holcombe\brent-holcombe-1,2017-18,Loyola (MD),F,26,2,396,47,119,.395,31,65,.477,16,54,.296,15,25,.600,23,77,100,11,7,18,26,52,125,2.9
4129,Eddie Odio\eddie-odio-1,2013-14,Boston College,F,31,15,649,45,90,.500,29,53,.547,16,37,.432,19,30,.633,23,68,91,22,8,24,26,85,125,3.0
4130,Marcanvis Hymon\marcanvis-hymon-1,2016-17,Mississippi,F,36,25,784,51,100,.510,51,99,.515,0,1,.000,23,57,.404,64,116,180,20,26,37,40,105,125,3.5
4131,Devonta Abron\devonta-abron-1,2015-16,Texas Christian,F,26,6,318,39,90,.433,39,90,.433,0,0,,47,72,.653,46,54,100,6,15,7,23,60,125,3.6
4132,Tony Armstrong\tony-armstrong-1,2013-14,Alabama State,F,23,7,347,52,96,.542,52,96,.542,0,0,,21,40,.525,25,48,73,11,7,9,20,48,125,3.7
4133,Clevon Brown\clevon-brown-1,2017-18,Vanderbilt,F,32,4,543,51,112,.455,40,66,.606,11,46,.239,12,26,.462,42,56,98,7,9,42,27,67,125,3.0
4134,Keita Bates-Diop\keita-bates-diop-1,2014-15,Ohio State,F,33,0,327,44,93,.473,26,54,.481,18,39,.462,19,28,.679,13,55,68,17,11,19,13,24,125,3.4
4135,Quinn Taylor\quinn-taylor-1,2015-16,Utah State,F,30,12,439,51,80,.638,47,74,.635,4,6,.667,19,33,.576,36,75,111,26,10,4,15,62,125,4.1
4136,Bruce Moore\bruce-moore-1,2016-17,Bucknell,F,35,0,440,40,94,.426,27,56,.482,13,38,.342,32,43,.744,26,30,56,11,5,14,20,62,125,2.2
4137,Jake Newton\jake-newton-1,2014-15,Southern Illinois-Edwardsville,F,28,2,425,38,117,.325,12,53,.226,26,64,.406,23,31,.742,14,36,50,19,13,3,32,43,125,2.0
4138,Jake Wiegand\jake-wiegand-1,2015-16,Illinois-Chicago,F,27,9,365,43,91,.473,43,86,.500,0,5,.000,39,57,.684,38,49,87,9,8,0,31,62,125,2.6
4139,Nate Sikma\nate-sikma-1,2014-15,Hartford,F,30,23,553,45,131,.344,28,61,.459,17,70,.243,18,28,.643,27,75,102,58,19,12,39,63,125,3.1
4140,Daniel Hurtt\daniel-hurtt-1,2013-14,Mississippi Valley State,F,31,8,365,52,117,.444,45,94,.479,7,23,.304,14,27,.519,21,41,62,9,8,6,13,41,125,2.4
4141,E.J. Anosike\ej-anosike-1,2017-18,Sacred Heart,F,30,0,414,42,110,.382,42,105,.400,0,5,.000,41,58,.707,43,73,116,12,6,14,35,51,125,2.6
4142,DeMondre Harvey\demondre-harvey-1,2014-15,Louisiana-Monroe,F,38,5,547,51,84,.607,51,84,.607,0,0,,23,43,.535,60,74,134,13,8,13,21,43,125,3.4
4143,Mark Williams\mark-williams-3,2013-14,Temple,F,30,11,563,43,136,.316,33,93,.355,10,43,.233,29,43,.674,61,55,116,29,9,9,29,74,125,2.6
4144,Josh Davenport\josh-davenport-1,2013-14,Winthrop,F,32,0,400,47,106,.443,39,85,.459,8,21,.381,23,40,.575,18,46,64,33,16,6,31,30,125,2.8
4145,Mike Rowley\michael-rowley-1,2014-15,Albany (NY),F,33,10,787,46,106,.434,45,99,.455,1,7,.143,32,45,.711,62,84,146,23,23,4,31,86,125,3.3
4146,Alex Larsson\alex-larsson-1,2014-15,UC-Riverside,F,31,30,643,52,111,.468,52,111,.468,0,0,,21,52,.404,72,76,148,12,7,22,33,96,125,2.8
4147,Luuk van Bree\luke-vanbree-1,2017-18,Bradley,F,26,1,330,47,103,.456,26,53,.491,21,50,.420,10,15,.667,14,49,63,7,11,11,16,39,125,3.3
4148,Joshua Spiers\joshua-spiers-1,2015-16,Loyola Marymount,F,28,12,372,41,99,.414,10,20,.500,31,79,.392,12,13,.923,7,34,41,19,12,3,14,32,125,3.1
4149,Marko Vasic\marko-vasic-1,2013-14,American,F,32,0,497,51,107,.477,39,61,.639,12,46,.261,10,22,.455,18,59,77,40,7,5,26,59,124,2.6
4150,Dhamir Cosby-Roundtree\dhamir-cosby-roundtree-1,2017-18,Villanova,F,40,1,453,53,68,.779,53,68,.779,0,0,,18,28,.643,38,57,95,3,10,15,19,70,124,2.8
4151,Cameron Forte\cameron-forte-1,2014-15,Georgia,F,31,1,401,51,90,.567,51,89,.573,0,1,.000,22,39,.564,36,51,87,23,10,7,24,22,124,3.7
4152,Martin Smith\martin-smith-2,2014-15,Lipscomb,F,14,8,346,39,106,.368,27,59,.458,12,47,.255,34,44,.773,11,33,44,27,14,2,19,19,124,6.2
4153,Ruben Arroyo-Felix\ruben-arroyo-felix-1,2017-18,Presbyterian,F,29,9,464,52,95,.547,45,71,.634,7,24,.292,13,34,.382,33,51,84,10,6,10,17,34,124,3.4
4154,Josiah Coleman\josiah-coleman-1,2014-15,North Dakota,F,29,6,397,43,110,.391,24,47,.511,19,63,.302,19,25,.760,22,55,77,13,17,1,24,62,124,2.5
4155,Matt McMullen\matt-mcmullen-1,2013-14,Colgate,F,31,0,448,41,116,.353,25,71,.352,16,45,.356,26,33,.788,26,69,95,22,6,9,24,44,124,2.6
4156,Jack Hobbs\jack-hobbs-1,2015-16,Hartford,F,33,7,467,47,111,.423,29,47,.617,18,64,.281,12,26,.462,24,61,85,15,11,8,15,69,124,2.4
4157,Mike McFadden\mike-mcfadden-1,2013-14,Robert Morris,F,16,14,340,48,110,.436,48,110,.436,0,0,,28,47,.596,20,41,61,12,8,8,25,62,124,3.6
4158,Zach Gunn\zach-gunn-1,2017-18,Ball State,F,25,0,352,40,110,.364,17,38,.447,23,72,.319,21,27,.778,12,58,70,18,5,9,24,53,124,2.6
4159,Tai Odiase\tai-odiase-1,2014-15,Illinois-Chicago,F,28,15,523,47,101,.465,47,101,.465,0,0,,30,70,.429,40,62,102,7,8,48,11,64,124,4.0
4160,Nedeljko Prijovic\nedeljko-prijovic-1,2017-18,Texas State,F,30,7,490,50,110,.455,41,78,.526,9,32,.281,15,24,.625,30,72,102,25,4,11,20,43,124,3.3
4161,Jamie Orme\jamie-orme-1,2017-18,Portland State,F,31,1,405,42,109,.385,32,77,.416,10,32,.313,30,49,.612,39,58,97,9,28,19,21,86,124,3.0
4162,Will Magnay\will-magnay-1,2016-17,Tulsa,F,32,12,449,48,83,.578,48,82,.585,0,1,.000,28,49,.571,33,62,95,7,2,29,33,62,124,2.7
4163,Carson Desrosiers\carson-desrosiers-1,2013-14,Providence,F,34,0,676,46,102,.451,45,98,.459,1,4,.250,31,46,.674,47,117,164,20,15,82,25,96,124,4.6
4164,Duran Porter\duran-porter-1,2014-15,Abilene Christian,F,31,3,420,52,104,.500,52,104,.500,0,0,,20,40,.500,29,42,71,10,5,13,29,73,124,1.9
4165,Antwon Oliver\antwon-oliver-1,2013-14,Campbell,F,31,1,495,45,122,.369,27,44,.614,18,78,.231,15,24,.625,21,46,67,29,23,22,22,64,123,3.0
4166,Elijah Ray\elijah-ray-1,2014-15,IUPUI,F,27,2,302,46,96,.479,38,72,.528,8,24,.333,23,33,.697,18,51,69,6,7,0,29,38,123,2.4
4167,Maxwell Kupchak\maxwell-kupchak-1,2015-16,UC-Santa Barbara,F,33,17,509,43,113,.381,36,84,.429,7,29,.241,30,43,.698,8,78,86,31,6,8,33,58,123,1.9
4168,Oren Faulk\oren-faulk-1,2013-14,Hartford,F,33,17,481,52,94,.553,52,89,.584,0,5,.000,19,40,.475,27,47,74,39,13,15,43,71,123,2.5
4169,Keith Stone\keith-stone-1,2016-17,Florida,F,34,0,410,44,104,.423,29,58,.500,15,46,.326,20,31,.645,28,45,73,18,11,7,23,46,123,2.5
4170,Stephen Hurt\stephen-hurt-1,2014-15,Kansas State,F,29,5,388,46,102,.451,42,88,.477,4,14,.286,27,39,.692,32,49,81,12,7,7,31,54,123,2.4
4171,Greg Lewis\greg-lewis-5,2015-16,Rutgers,F,31,31,654,52,145,.359,52,145,.359,0,0,,19,43,.442,56,102,158,20,11,33,35,78,123,2.7
4172,Fausto Pichardo\fausto-pichardo-1,2017-18,Alabama State,F,28,12,423,46,103,.447,45,97,.464,1,6,.167,30,46,.652,29,77,106,12,14,20,34,81,123,2.7
4173,Ben Lawson\ben-lawson-1,2014-15,Western Kentucky,F,32,8,601,49,84,.583,49,84,.583,0,0,,25,51,.490,35,68,103,21,14,53,27,71,123,4.0
4174,Vinny Zollo\vinny-zollo-1,2014-15,Cleveland State,F,34,5,441,41,124,.331,21,58,.362,20,66,.303,21,30,.700,28,65,93,22,5,11,23,50,123,2.2
4175,Corvon Butler\corvon-butler-1,2016-17,Alabama State,F,20,5,342,47,100,.470,47,85,.553,0,15,.000,29,35,.829,30,31,61,8,13,4,18,35,123,4.5
4176,Reggie Cameron\reggie-cameron-1,2013-14,Georgetown,F,32,12,427,42,116,.362,17,38,.447,25,78,.321,14,18,.778,6,37,43,13,5,2,15,27,123,1.9
4177,Jarred Reuter\jarred-reuter-1,2016-17,Virginia,F,32,0,344,52,89,.584,52,89,.584,0,0,,19,25,.760,26,43,69,20,7,2,27,44,123,2.8
4178,Remu Raitanen\remu-raitanen-1,2017-18,San Francisco,F,33,3,479,37,115,.322,15,36,.417,22,79,.278,27,33,.818,25,57,82,16,9,3,18,39,123,2.4
4179,Kevin Johnson\kevin-johnson-6,2013-14,Cincinnati,F,33,0,338,41,103,.398,26,55,.473,15,48,.313,26,30,.867,14,19,33,21,13,4,17,42,123,2.4
4180,Dave Krmpotich\dave-krmpotich-1,2015-16,Colgate,F,28,5,379,48,113,.425,48,111,.432,0,2,.000,27,48,.563,18,39,57,6,7,12,32,54,123,1.6
4181,Felix Rivera-Vega\felix-rivera-vega-1,2015-16,Northern Arizona,F,27,6,400,44,97,.454,30,60,.500,14,37,.378,20,41,.488,34,70,104,6,12,2,21,49,122,3.2
4182,Aurimas Majauskas\aurimas-majauskas-1,2013-14,Sam Houston State,F,26,0,238,41,71,.577,39,65,.600,2,6,.333,38,52,.731,37,30,67,11,11,3,17,54,122,3.9
4183,Alex Davis\alex-davis-3,2014-15,Fresno State,F,25,13,600,42,90,.467,42,87,.483,0,3,.000,38,54,.704,34,64,98,13,17,22,34,79,122,3.5
4184,Ed Morrow\edward-morrow-1,2015-16,Nebraska,F,30,1,411,53,83,.639,53,83,.639,0,0,,16,28,.571,46,53,99,3,0,21,31,67,122,2.9
4185,Lamontray Harris\lamontray-harris-1,2015-16,Morehead State,F,34,0,338,44,107,.411,30,73,.411,14,34,.412,20,31,.645,14,45,59,13,5,8,16,35,122,2.2
4186,Greg Louis\greg-louis-1,2014-15,Pennsylvania,F,27,25,514,53,95,.558,53,94,.564,0,1,.000,16,32,.500,39,70,109,15,16,15,33,74,122,3.4
4187,C.J. Bray\cj-bray-1,2014-15,Citadel,F,30,6,442,47,108,.435,37,76,.487,10,32,.313,18,27,.667,29,79,108,12,9,5,20,51,122,2.9
4188,Mike Miklusak\mike-miklusak-1,2015-16,Western Illinois,F,23,0,398,41,88,.466,15,31,.484,26,57,.456,14,22,.636,15,60,75,21,10,6,21,36,122,4.2
4189,Darrious Hamilton\darrious-hamilton-2,2015-16,Utah Valley,F,25,4,288,50,83,.602,50,83,.602,0,0,,22,34,.647,21,36,57,2,6,14,19,56,122,3.2
4190,Joe Mvuezolo Jr.\joe-mvuezolojr-1,2016-17,Montana State,F,24,0,420,41,122,.336,23,73,.315,18,49,.367,22,27,.815,9,44,53,23,11,12,35,31,122,2.4
4191,Andy Smeathers\andy-smeathers-1,2014-15,Mount St. Mary's,F,14,8,318,37,109,.339,10,25,.400,27,84,.321,21,25,.840,13,43,56,14,9,6,28,31,122,4.5
4192,Hayden Howell\hayden-howell-1,2017-18,Abilene Christian,F,32,3,326,50,95,.526,46,83,.554,4,12,.333,18,30,.600,22,41,63,9,7,4,27,58,122,2.0
4193,Steven Danridge\steven-danridge-1,2013-14,Grambling,F,28,23,556,50,93,.538,50,93,.538,0,0,,22,42,.524,52,48,100,11,10,20,36,100,122,2.7
4194,Elridge Moore\elridge-moore-1,2013-14,Louisiana,F,30,27,707,47,110,.427,47,104,.452,0,6,.000,28,50,.560,47,69,116,34,18,15,36,80,122,3.1
4195,Gus Leeper\gus-leeper-1,2014-15,Little Rock,F,30,9,485,54,112,.482,54,112,.482,0,0,,14,20,.700,36,49,85,2,3,14,17,64,122,2.5
4196,Adrian Edwards\adrian-edwards-1,2016-17,Alabama A&M,F,17,12,378,44,87,.506,44,85,.518,0,2,.000,34,50,.680,28,51,79,17,5,11,15,44,122,5.8
4197,Michael Kessens\michael-kessens-1,2015-16,Alabama,F,33,21,547,48,86,.558,47,81,.580,1,5,.200,25,46,.543,50,67,117,19,15,14,29,77,122,3.2
4198,Zacarry Douglas\zacarry-douglas-1,2015-16,Cal State Northridge,F,24,1,417,45,98,.459,42,86,.488,3,12,.250,29,44,.659,29,61,90,13,13,7,23,37,122,3.9
4199,Jahmel Bodrick\jahmel-bodrick-1,2016-17,St. Francis (NY),F,31,7,454,49,129,.380,48,120,.400,1,9,.111,22,38,.579,29,50,79,7,8,4,37,94,121,0.7
4200,Tres Tinkle\tres-tinkle-1,2016-17,Oregon State,F,6,6,209,36,81,.444,32,56,.571,4,25,.160,45,58,.776,4,46,50,14,13,5,19,12,121,15.4
4201,D.J. Foreman\dj-foreman-1,2014-15,Rutgers,F,32,2,486,48,110,.436,45,101,.446,3,9,.333,22,49,.449,35,51,86,16,6,5,31,52,121,1.9
4202,Mamadi Diakite\mamadi-diakite-1,2016-17,Virginia,F,32,0,449,50,92,.543,47,81,.580,3,11,.273,18,33,.545,28,54,82,6,8,39,13,75,121,3.2
4203,Luke Hager\luke-hager-1,2013-14,North Carolina-Wilmington,F,28,2,406,46,115,.400,39,86,.453,7,29,.241,22,36,.611,25,57,82,10,5,4,24,39,121,2.3
4204,Isaac Banks\isaac-banks-1,2016-17,East Tennessee State,F,35,2,556,53,86,.616,53,86,.616,0,0,,15,39,.385,40,84,124,13,15,20,28,68,121,3.1
4205,Terrell Brown\terrell-brown-2,2013-14,Central Arkansas,F,20,9,353,54,88,.614,54,88,.614,0,0,,13,20,.650,38,54,92,16,19,13,23,59,121,5.7
4206,Brandon Murphy\brandon-murphy-1,2016-17,Indiana State,F,29,10,401,38,79,.481,38,79,.481,0,0,,45,81,.556,40,61,101,5,6,16,27,71,121,2.7
4207,Antonio Jenifer\antonio-jenifer-1,2014-15,St. Francis (NY),F,32,0,327,45,129,.349,29,82,.354,16,47,.340,15,31,.484,37,53,90,8,7,11,21,40,121,2.1
4208,Kris Bankston\kris-bankston-1,2017-18,Little Rock,F,30,15,450,48,77,.623,48,76,.632,0,1,.000,25,55,.455,33,86,119,16,8,30,26,67,121,3.7
4209,Elyjah Williams\elyjah-williams-1,2017-18,Fairleigh Dickinson,F,30,6,453,51,79,.646,49,76,.645,2,3,.667,17,33,.515,48,65,113,27,23,18,37,59,121,4.2
4210,Mitch Brewe\mitch-brewe-1,2014-15,UC-Santa Barbara,F,31,14,488,45,103,.437,36,79,.456,9,24,.375,22,36,.611,42,38,80,16,8,7,22,49,121,2.7
4211,Keanau Post\keanau-post-1,2014-15,Missouri,F,30,9,424,51,89,.573,51,89,.573,0,0,,19,31,.613,42,65,107,4,9,14,24,70,121,3.1
4212,Ibrahim Sylla\ibrahim-sylla-1,2016-17,Northern Colorado,F,20,17,305,49,93,.527,49,93,.527,0,0,,22,43,.512,35,55,90,6,8,17,26,54,120,4.2
4213,Evan Hall\evan-hall-1,2015-16,IUPUI,F,23,11,383,50,97,.515,49,96,.510,1,1,1.000,19,47,.404,41,50,91,14,10,7,17,67,120,3.7
4214,Rocky Kreuser\rocky-kreuser-1,2017-18,North Dakota State,F,32,0,412,44,103,.427,27,53,.509,17,50,.340,15,21,.714,26,37,63,12,3,7,17,48,120,2.3
4215,Alex Thomas\alex-thomas-1,2016-17,Towson,F,32,31,527,48,98,.490,48,98,.490,0,0,,24,41,.585,64,76,140,14,9,24,30,89,120,3.2
4216,Cameron McGriff\cameron-mcgriff-1,2016-17,Oklahoma State,F,32,1,502,30,74,.405,24,53,.453,6,21,.286,54,74,.730,38,60,98,20,16,8,35,69,120,2.8
4217,Charles Buggs\charles-buggs-1,2014-15,Minnesota,F,33,7,437,45,103,.437,29,53,.547,16,50,.320,14,28,.500,25,41,66,17,9,6,9,46,120,2.7
4218,Cal Hanks\cal-hanks-1,2014-15,Southern Utah,F,29,2,259,40,82,.488,40,81,.494,0,1,.000,40,68,.588,8,50,58,5,8,14,25,46,120,2.3
4219,Geoff Beans\geoff-beans-1,2017-18,Furman,F,33,3,374,34,112,.304,3,9,.333,31,103,.301,21,26,.808,10,32,42,15,5,3,12,43,120,1.8
4220,Melik Martin\melik-martin-1,2017-18,Monmouth,F,31,9,552,44,104,.423,33,70,.471,11,34,.324,21,33,.636,24,67,91,27,14,12,31,61,120,2.7
4221,David Watkins\david-watkins-1,2016-17,New Hampshire,F,31,6,432,40,101,.396,15,30,.500,25,71,.352,15,23,.652,18,75,93,10,4,2,22,49,120,2.2
4222,Japhet Kadji\japhet-kadji-1,2015-16,Wagner,F,27,9,398,44,124,.355,22,55,.400,22,69,.319,10,14,.714,19,41,60,7,13,6,20,63,120,1.9
4223,Mike Auger\mike-auger-1,2014-15,Pennsylvania,F,22,2,420,40,72,.556,40,71,.563,0,1,.000,40,52,.769,28,68,96,10,7,1,37,62,120,3.4
4224,Richard Henderson\richard-henderson-1,2017-18,Austin Peay,F,32,0,334,49,89,.551,49,89,.551,0,0,,22,52,.423,26,51,77,5,7,13,21,44,120,2.5
4225,Christian Cunningham\christian-cunningham-2,2015-16,Jacksonville State,F,25,17,478,48,86,.558,48,86,.558,0,0,,24,40,.600,48,62,110,8,8,45,15,75,120,5.0
4226,Ryan Luther\ryan-luther-1,2016-17,Pittsburgh,F,21,2,406,42,78,.538,33,56,.589,9,22,.409,27,36,.750,25,57,82,15,5,14,33,48,120,4.1
4227,Diago Quinn\diago-quinn-1,2016-17,Monmouth,F,34,0,391,45,94,.479,45,93,.484,0,1,.000,29,48,.604,41,52,93,1,6,19,32,89,119,1.8
4228,Alex Tiffin\alex-tiffin-1,2013-14,Sacramento State,F,30,29,448,50,103,.485,50,102,.490,0,1,.000,19,45,.422,27,67,94,12,7,2,27,75,119,1.8
4229,Jordan Aaberg\jordan-aaberg-1,2013-14,North Dakota State,F,33,0,382,51,84,.607,51,84,.607,0,0,,17,23,.739,24,37,61,11,4,22,16,51,119,2.9
4230,Max Rothschild\max-rothschild-1,2015-16,Pennsylvania,F,24,2,367,50,97,.515,49,96,.510,1,1,1.000,18,31,.581,30,56,86,14,5,0,34,46,119,2.8
4231,Nate Kratch\nate-kratch-1,2013-14,Santa Clara,F,33,5,455,42,98,.429,22,41,.537,20,57,.351,15,23,.652,25,67,92,19,10,20,16,72,119,2.9
4232,Malcolm Regisford\malcolm-regisford-1,2015-16,Colgate,F,21,19,428,43,94,.457,43,93,.462,0,1,.000,33,57,.579,28,96,124,11,4,12,25,50,119,4.0
4233,Eric Thompson\eric-thompson-2,2015-16,Pacific,F,12,7,241,38,66,.576,38,66,.576,0,0,,43,69,.623,34,57,91,5,4,13,20,43,119,8.2
4234,Julian Moore\julian-moore-1,2015-16,Penn State,F,31,12,479,41,92,.446,41,90,.456,0,2,.000,37,55,.673,30,72,102,7,8,17,19,53,119,2.9
4235,Donovon Jack\donovon-jack-1,2014-15,Penn State,F,34,12,444,43,95,.453,40,77,.519,3,18,.167,30,40,.750,36,57,93,10,15,26,22,97,119,2.6
4236,Hayden Howell\hayden-howell-1,2015-16,Abilene Christian,F,31,3,354,42,92,.457,42,92,.457,0,0,,35,52,.673,36,31,67,7,5,13,36,56,119,1.9
4237,Jacob Lampkin\jacob-lampkin-1,2014-15,Pacific,F,31,3,573,47,94,.500,47,94,.500,0,0,,25,43,.581,48,92,140,25,5,11,37,67,119,3.0
4238,Paulius Satkus\paulius-satkus-1,2015-16,James Madison,F,32,4,516,38,75,.507,35,65,.538,3,10,.300,40,61,.656,37,78,115,24,12,5,40,75,119,2.7
4239,Damian Goodwin\damien-goodwin-1,2013-14,Southern,F,29,3,476,46,102,.451,45,96,.469,1,6,.167,26,55,.473,25,68,93,26,15,13,34,72,119,2.5
4240,Jordan Goodman\jordan-goodman-1,2014-15,New Mexico,F,19,0,255,45,123,.366,35,85,.412,10,38,.263,19,31,.613,11,32,43,17,8,1,15,19,119,3.2
4241,Arinze Anakwenze\arinze-anakwenze-1,2017-18,Mississippi Valley State,F,32,20,525,52,108,.481,52,104,.500,0,4,.000,15,32,.469,36,58,94,15,13,16,32,76,119,2.3
4242,Devon Scott\devon-scott-1,2013-14,Dayton,F,35,7,441,44,78,.564,44,78,.564,0,0,,31,51,.608,24,70,94,15,8,10,38,76,119,2.0
4243,George Thomas\george-thomas-1,2014-15,Alcorn State,F,32,8,596,37,115,.322,18,44,.409,19,71,.268,26,42,.619,34,78,112,16,24,13,28,72,119,2.6
4244,Tim Rowe\tim-rowe-1,2015-16,Southern Mississippi,F,29,4,453,41,96,.427,39,88,.443,2,8,.250,35,59,.593,33,53,86,6,8,25,36,47,119,2.5
4245,Devin Thornton\devin-thornton-1,2016-17,Southern Illinois-Edwardsville,F,29,1,358,39,86,.453,28,57,.491,11,29,.379,29,39,.744,23,45,68,14,11,1,21,46,118,2.8
4246,Kyle Noreen\kyle-noreen-1,2014-15,Radford,F,34,34,744,47,102,.461,35,58,.603,12,44,.273,12,26,.462,36,51,87,54,12,12,20,79,118,3.1
4247,Glenn Feidanga\glenn-feidanga-1,2013-14,Long Island University,F,29,6,473,41,94,.436,41,94,.436,0,0,,36,54,.667,47,62,109,7,5,5,15,88,118,2.6
4248,Malcolm Regisford\malcolm-regisford-1,2017-18,Colgate,F,24,0,352,48,75,.640,48,75,.640,0,0,,22,34,.647,33,67,100,12,3,14,23,34,118,4.5
4249,Issa Thiam\issa-thiam-1,2016-17,Rutgers,F,31,21,570,42,127,.331,12,29,.414,30,98,.306,4,8,.500,11,43,54,10,12,2,24,33,118,1.6
4250,Phillip Anglade\phillip-anglade-1,2013-14,Virginia Military Institute,F,35,20,537,53,97,.546,53,97,.546,0,0,,12,38,.316,73,76,149,11,25,41,13,87,118,4.2
4251,Treshawn Bolden\treshawn-bolden-1,2015-16,Jackson State,F,34,25,557,48,120,.400,47,118,.398,1,2,.500,21,43,.488,38,83,121,28,5,19,51,104,118,1.2
4252,Matt Hagerbaumer\matt-hagerbaumer-1,2013-14,Omaha,F,32,1,639,51,71,.718,51,71,.718,0,0,,16,26,.615,33,132,165,16,19,31,16,60,118,5.0
4253,Carson Smith\carson-smith-1,2017-18,South Carolina Upstate,F,31,15,478,50,104,.481,40,67,.597,10,37,.270,8,11,.727,28,45,73,33,11,1,18,66,118,2.8
4254,Max Mahoney\max-mahoney-1,2016-17,Boston University,F,22,0,264,50,84,.595,50,84,.595,0,0,,18,38,.474,26,47,73,12,11,3,26,48,118,3.6
4255,Denzell Taylor\denzell-taylor-1,2016-17,Old Dominion,F,31,31,914,46,79,.582,46,79,.582,0,0,,26,65,.400,109,123,232,43,30,17,44,100,118,5.4
4256,Christian Griggs-Williams\christian-griggs-williams-1,2015-16,Tennessee State,F,30,7,457,46,93,.495,33,66,.500,13,27,.481,13,24,.542,32,49,81,7,8,4,29,41,118,2.5
4257,Tyler Carter\tyler-carter-1,2017-18,Alcorn State,F,32,13,505,37,98,.378,32,79,.405,5,19,.263,39,53,.736,43,69,112,22,20,2,31,81,118,2.6
4258,Torrion Brummitt\torrion-brummitt-1,2013-14,Western Carolina,F,33,0,375,44,100,.440,44,97,.454,0,3,.000,30,60,.500,23,66,89,17,11,13,21,91,118,1.9
4259,Kenny Goins\kenny-goins-1,2016-17,Michigan State,F,35,14,639,48,83,.578,48,83,.578,0,0,,22,33,.667,38,121,159,21,8,21,37,92,118,2.9
4260,Michael Nzei\michael-nzei-1,2015-16,Seton Hall,F,34,3,458,50,79,.633,50,79,.633,0,0,,18,37,.486,51,50,101,6,6,19,23,59,118,3.0
4261,Jalen Reynolds\jalen-reynolds-1,2013-14,Xavier,F,31,3,401,49,92,.533,49,92,.533,0,0,,20,32,.625,51,68,119,4,7,15,17,76,118,3.1
4262,Jabari Craig\jabari-craig-1,2017-18,East Carolina,F,22,22,496,45,111,.405,45,110,.409,0,1,.000,28,52,.538,47,86,133,11,4,24,34,66,118,3.4
4263,Dane Pineau\dane-pineau-1,2014-15,Saint Mary's (CA),F,31,5,444,50,90,.556,44,65,.677,6,25,.240,12,19,.632,34,81,115,27,10,15,23,41,118,3.9
4264,Nick Pallas\nick-pallas-1,2015-16,Texas-Arlington,F,35,0,455,42,99,.424,42,97,.433,0,2,.000,34,55,.618,42,60,102,32,17,15,45,61,118,2.4
4265,Sam Miller\sam-miller-1,2016-17,Dayton,F,26,6,316,39,92,.424,24,50,.480,15,42,.357,25,36,.694,20,39,59,10,6,11,23,38,118,2.8
4266,Mo Alie-Cox\mo-alie-cox-1,2013-14,Virginia Commonwealth,F,35,4,505,41,79,.519,40,78,.513,1,1,1.000,34,57,.596,61,65,126,11,11,48,17,63,117,4.0
4267,Nate Hicks\nate-hicks-1,2014-15,Florida Gulf Coast,F,31,22,479,40,73,.548,40,72,.556,0,1,.000,37,54,.685,41,94,135,8,5,25,13,42,117,4.2
4268,Nehemiah Mabson\nehemiah-mabson-1,2014-15,Campbell,F,31,0,365,42,102,.412,31,67,.463,11,35,.314,22,45,.489,22,32,54,22,10,4,38,72,117,1.3
4269,Alex Murphy\alex-murphy-1,2014-15,Florida,F,23,4,327,42,92,.457,36,59,.610,6,33,.182,27,44,.614,11,35,46,6,9,6,21,34,117,2.8
4270,Trey Thompson\trey-thompson-1,2017-18,Arkansas,F,35,9,629,50,98,.510,50,98,.510,0,0,,17,28,.607,39,98,137,53,23,29,34,76,117,3.9
4271,Xavier Harris\xavier-harris-1,2013-14,Fairleigh Dickinson,F,27,3,357,50,90,.556,50,90,.556,0,0,,17,32,.531,38,50,88,6,2,12,22,68,117,2.8
4272,Nathan Taphorn\nathan-taphorn-1,2015-16,Northwestern,F,24,0,282,39,87,.448,12,20,.600,27,67,.403,12,19,.632,12,42,54,16,4,8,17,37,117,3.3
4273,Jordan Madrid-Andrews\jordan-madrid-andrews-1,2015-16,Chicago State,F,31,13,461,46,91,.505,45,87,.517,1,4,.250,24,46,.522,46,67,113,10,11,7,37,82,117,2.2
4274,Mohamed Bah\mohamed-bah-1,2014-15,Drexel,F,30,30,656,42,77,.545,42,75,.560,0,2,.000,33,41,.805,47,92,139,14,14,19,24,86,117,3.9
4275,Christian Albright\christian-albright-1,2016-17,Lamar,F,33,1,411,45,110,.409,29,54,.537,16,56,.286,11,18,.611,16,56,72,20,13,7,24,62,117,2.0
4276,Jeff Garrett\jeff-garrett-1,2016-17,Northern Kentucky,F,34,12,479,46,117,.393,41,89,.461,5,28,.179,20,41,.488,43,106,149,20,19,11,28,56,117,2.9
4277,Reggie Agbeko\reggie-agbeko-1,2014-15,Saint Louis,F,32,9,455,43,82,.524,43,82,.524,0,0,,31,51,.608,38,74,112,2,7,0,30,46,117,2.4
4278,Tyrell Johnson\tyrell-johnson-1,2015-16,Appalachian State,F,30,21,520,45,114,.395,42,100,.420,3,14,.214,24,45,.533,41,82,123,8,14,21,40,66,117,2.3
4279,Allan Dempster\allan-dempster-1,2013-14,Bethune-Cookman,F,30,3,378,47,92,.511,47,92,.511,0,0,,23,36,.639,44,43,87,3,14,9,20,75,117,2.7
4280,Derek Ogbeide\derek-ogbeide-1,2015-16,Georgia,F,29,15,435,50,106,.472,50,106,.472,0,0,,17,36,.472,53,97,150,13,3,23,34,50,117,3.3
4281,Payton Henson\payton-henson-1,2013-14,Tulane,F,34,0,540,36,107,.336,22,55,.400,14,52,.269,31,41,.756,35,58,93,16,13,6,23,54,117,2.3
4282,Maurius Hill\maurius-hill-1,2015-16,Little Rock,F,35,17,474,44,103,.427,37,84,.440,7,19,.368,22,32,.688,33,74,107,13,15,5,33,35,117,2.4
4283,Evan Phoenix\evan-phoenix-1,2015-16,Central Connecticut State,F,28,6,409,46,110,.418,46,110,.418,0,0,,25,40,.625,43,59,102,11,9,12,34,61,117,2.4
4284,Jack Salt\jack-salt-1,2017-18,Virginia,F,34,34,673,52,81,.642,52,81,.642,0,0,,13,34,.382,50,86,136,9,11,22,21,62,117,3.5
4285,Sandy Cohen\sandy-cohen-1,2014-15,Marquette,F,31,7,465,39,105,.371,17,39,.436,22,66,.333,17,28,.607,5,44,49,26,16,7,22,48,117,2.2
4286,Austin Lewis\austin-lewis-1,2015-16,McNeese State,F,28,14,405,48,91,.527,48,91,.527,0,0,,20,34,.588,52,77,129,4,9,36,21,70,116,4.1
4287,Blake Hibbitts\blake-hibbitts-1,2014-15,Central Michigan,F,32,0,486,39,114,.342,11,23,.478,28,91,.308,10,16,.625,23,57,80,10,10,6,11,45,116,2.3
4288,Henry Brooks\henry-brooks-1,2013-14,Pennsylvania,F,28,2,467,53,115,.461,53,114,.465,0,1,.000,10,16,.625,32,47,79,15,16,15,31,94,116,2.1
4289,Jason McClellan\jason-mcclellan-1,2014-15,Illinois-Chicago,F,25,11,419,44,114,.386,32,69,.464,12,45,.267,16,20,.800,36,63,99,9,11,17,14,59,116,3.5
4290,Emmanuel Addo\emmanuel-addo-1,2013-14,Missouri State,F,27,18,288,40,87,.460,33,66,.500,7,21,.333,29,36,.806,20,32,52,5,3,1,22,62,116,1.9
4291,Patrick Robinson\patrick-robinson-1,2013-14,Northwestern State,F,30,23,513,40,85,.471,37,74,.500,3,11,.273,33,50,.660,37,57,94,33,23,9,29,82,116,3.3
4292,Caleb Johnson\caleb-johnson-1,2013-14,Missouri-Kansas City,F,30,4,474,38,86,.442,21,54,.389,17,32,.531,23,33,.697,11,41,52,14,13,14,20,55,116,2.6
4293,Ty'Quan Bitting\tyquan-bitting-1,2016-17,Morehead State,F,26,1,262,49,72,.681,49,72,.681,0,0,,18,39,.462,29,38,67,9,5,18,23,41,116,3.6
4294,Jy'lan Washington\jylan-washington-1,2016-17,Louisiana Tech,F,32,0,434,38,67,.567,19,32,.594,19,35,.543,21,34,.618,15,34,49,17,10,12,16,34,116,3.1
4295,Michael Gbinije\michael-gbinije-1,2013-14,Syracuse,F,34,0,497,35,92,.380,20,49,.408,15,43,.349,31,48,.646,21,39,60,41,25,7,17,56,116,3.1
4296,Jaron Faulds\jaron-faulds-1,2017-18,Columbia,F,26,1,369,53,89,.596,53,89,.596,0,0,,10,23,.435,33,51,84,10,8,26,21,44,116,4.0
4297,Xavier Ford\xavier-ford-1,2013-14,Buffalo,F,29,17,391,42,97,.433,42,97,.433,0,0,,32,43,.744,31,62,93,11,15,8,18,48,116,3.2
4298,Aaron Adeoye\aaron-adeoye-1,2013-14,Western Kentucky,F,32,15,486,46,119,.387,43,107,.402,3,12,.250,21,35,.600,44,93,137,13,10,15,33,67,116,2.3
4299,Chyree Walker\chyree-walker-1,2017-18,Delaware,F,30,14,486,50,122,.410,45,101,.446,5,21,.238,11,31,.355,30,42,72,17,13,1,25,51,116,1.9
4300,Doug Taylor\doug-taylor-1,2016-17,Ohio,F,31,2,417,43,82,.524,43,81,.531,0,1,.000,30,57,.526,48,99,147,7,10,23,22,72,116,3.5
4301,Jeff Garrett\jeff-garrett-1,2017-18,Northern Kentucky,F,27,1,246,51,82,.622,51,79,.646,0,3,.000,14,25,.560,39,49,88,4,9,13,19,22,116,4.1
4302,Andrija Matic\andrija-matic-1,2015-16,American,F,30,0,438,42,96,.438,33,66,.500,9,30,.300,23,36,.639,27,37,64,26,4,9,45,59,116,1.7
4303,Demetrius Moore\demetrius-moore-1,2013-14,Indiana State,F,34,13,402,50,88,.568,49,86,.570,1,2,.500,15,24,.625,33,53,86,10,4,5,26,69,116,2.1
4304,Jarad Scott\jarad-scott-1,2014-15,Winthrop,F,27,8,353,42,84,.500,25,44,.568,17,40,.425,15,18,.833,30,46,76,10,11,8,21,57,116,3.2
4305,A.J. Wilson\aj-wilson-2,2017-18,George Mason,F,31,1,359,42,88,.477,38,75,.507,4,13,.308,28,50,.560,37,53,90,3,9,34,19,58,116,3.1
4306,Marvin Clark\marvin-clark-1,2015-16,Michigan State,F,30,1,292,45,83,.542,34,57,.596,11,26,.423,15,20,.750,22,53,75,10,8,11,19,48,116,3.0
4307,Brett Bailey\brett-bailey-1,2013-14,San Diego,F,35,10,463,43,105,.410,35,81,.432,8,24,.333,21,47,.447,20,51,71,12,9,5,16,44,115,1.9
4308,Billy Giles\billy-giles-1,2016-17,Robert Morris,F,27,3,370,51,88,.580,51,88,.580,0,0,,13,30,.433,36,47,83,5,8,9,13,45,115,3.4
4309,Malik London\malik-london-1,2016-17,Tennessee-Martin,F,33,4,297,48,70,.686,48,70,.686,0,0,,19,32,.594,30,55,85,7,6,25,16,49,115,3.3
4310,D.J. Johnson\dj-johnson-2,2013-14,Kansas State,F,33,5,459,45,89,.506,45,88,.511,0,1,.000,25,49,.510,52,64,116,3,10,18,25,77,115,2.6
4311,Iman Johnson\iman-johnson-1,2014-15,Maryland-Eastern Shore,F,31,14,549,46,104,.442,45,103,.437,1,1,1.000,22,40,.550,38,61,99,29,23,4,35,65,115,2.7
4312,Zena Edosomwan\zena-edosomwan-1,2014-15,Harvard,F,29,16,350,43,109,.394,43,109,.394,0,0,,29,48,.604,35,56,91,7,6,19,29,53,115,2.2
4313,Yevgen Sakhniuk\yevgen-sakhniuk-1,2015-16,La Salle,F,19,0,257,50,77,.649,49,71,.690,1,6,.167,14,37,.378,15,25,40,17,9,9,32,45,115,3.5
4314,L.G. Gill\lg-gill-1,2016-17,Maryland,F,33,2,419,37,82,.451,34,72,.472,3,10,.300,38,59,.644,26,42,68,9,5,5,11,52,115,2.4
4315,Kazembe Abif\kazembe-abif-1,2013-14,Drexel,F,16,12,489,36,77,.468,35,75,.467,1,2,.500,42,56,.750,41,65,106,6,11,6,14,52,115,6.4
4316,Trevor Manuel\trevor-manuel-1,2016-17,Loyola Marymount,F,21,0,309,37,84,.440,27,54,.500,10,30,.333,31,45,.689,12,43,55,14,10,22,21,52,115,3.8
4317,Cyril Langevine\cyril-langevine-1,2016-17,Rhode Island,F,35,6,463,44,93,.473,44,93,.473,0,0,,27,55,.491,68,88,156,10,16,26,22,85,115,3.3
4318,Josh Warren\josh-warren-3,2017-18,Cornell,F,28,4,436,46,105,.438,42,87,.483,4,18,.222,19,24,.792,18,66,84,45,5,9,45,70,115,2.1
4319,Mitchell Solomon\mitchell-solomon-1,2015-16,Oklahoma State,F,31,26,570,40,85,.471,37,66,.561,3,19,.158,32,46,.696,53,68,121,14,11,17,43,106,115,2.3
4320,Zach Nelson\zach-nelson-2,2017-18,Utah Valley,F,27,5,328,40,68,.588,35,62,.565,5,6,.833,30,41,.732,25,54,79,31,5,3,23,30,115,3.9
4321,Kahlil Thomas\kahlil-thomas-1,2014-15,Rider,F,20,15,368,45,93,.484,42,81,.519,3,12,.250,22,45,.489,26,51,77,15,6,13,23,47,115,3.8
4322,Matt Holba\matt-holba-1,2016-17,Lehigh,F,31,16,601,44,82,.537,36,61,.590,8,21,.381,19,27,.704,35,89,124,30,15,16,34,76,115,3.4
4323,Shawn Valentine\shawn-valentine-1,2013-14,Rider,F,29,2,554,40,105,.381,28,67,.418,12,38,.316,23,31,.742,23,57,80,45,25,10,34,66,115,3.1
4324,Cole Long\cole-long-1,2017-18,Detroit Mercy,F,30,15,501,40,106,.377,23,55,.418,17,51,.333,18,26,.692,24,54,78,41,8,21,26,50,115,3.1
4325,Brandon Suggs\brandon-suggs-1,2016-17,Bethune-Cookman,F,30,14,601,49,81,.605,49,81,.605,0,0,,17,30,.567,50,56,106,10,18,16,19,81,115,3.6
4326,Terrell Brown\terrell-brown-3,2014-15,Montana State,F,28,13,472,38,107,.355,27,80,.338,11,27,.407,28,32,.875,18,39,57,20,7,2,30,54,115,1.7
4327,Chris Ortiz\chris-ortiz-1,2013-14,Kent State,F,32,14,461,46,111,.414,39,82,.476,7,29,.241,16,28,.571,36,69,105,9,13,16,26,51,115,2.5
4328,Mike Best\mike-best-1,2014-15,UC-Irvine,F,34,3,399,46,99,.465,46,98,.469,0,1,.000,23,34,.676,23,53,76,9,8,21,10,62,115,2.5
4329,Cam Martin\cam-martin-1,2017-18,Jacksonville State,F,28,0,273,38,74,.514,27,48,.563,11,26,.423,28,45,.622,17,56,73,20,3,4,21,48,115,2.9
4330,Desmond Simmons\desmond-simmons-1,2013-14,Washington,F,22,10,461,41,94,.436,39,85,.459,2,9,.222,31,41,.756,38,64,102,13,13,2,20,52,115,4.1
4331,Temidayo Yussuf\temidayo-yussuf-1,2014-15,Cal State Long Beach,F,33,10,435,38,78,.487,38,78,.487,0,0,,39,75,.520,39,48,87,16,9,11,30,72,115,2.2
4332,Jay Hedgeman\jay-hedgeman-1,2015-16,Louisiana,F,24,4,326,32,81,.395,26,52,.500,6,29,.207,44,63,.698,18,47,65,26,17,3,18,51,114,3.7
4333,Joseph Lewis\joseph-lewis-1,2017-18,Delaware State,F,27,15,446,47,130,.362,42,109,.385,5,21,.238,15,30,.500,8,67,75,25,6,9,50,54,114,0.7
4334,Davonte Fitzgerald\davonte-fitzgerald-1,2017-18,Minnesota,F,31,4,413,43,108,.398,28,64,.438,15,44,.341,13,24,.542,14,61,75,10,9,12,13,49,114,2.3
4335,Roschon Prince\roschon-prince-1,2013-14,Southern California,F,27,2,299,37,85,.435,37,80,.463,0,5,.000,40,75,.533,32,42,74,6,15,4,16,48,114,2.9
4336,Quinton Stephens\quinton-stephens-1,2013-14,Georgia Tech,F,32,0,408,43,114,.377,28,67,.418,15,47,.319,13,16,.813,24,44,68,25,9,8,20,44,114,2.3
4337,Zachary Lee\zachary-lee-1,2014-15,Tennessee State,F,31,14,593,44,105,.419,44,103,.427,0,2,.000,26,44,.591,34,57,91,13,13,15,33,68,114,2.1
4338,Adonis Rwabigwi\adonis-rwabigwi-1,2013-14,Furman,F,24,19,508,44,80,.550,44,80,.550,0,0,,26,46,.565,30,52,82,9,7,24,39,69,114,2.8
4339,Brandon Miller\brandon-miller-5,2015-16,Gardner-Webb,F,33,0,452,42,76,.553,42,76,.553,0,0,,30,55,.545,39,55,94,8,8,16,23,95,114,2.3
4340,Jakub Petras\jakub-petras-1,2016-17,Stony Brook,F,32,0,477,45,90,.500,45,90,.500,0,0,,24,43,.558,50,54,104,17,10,12,15,56,114,3.3
4341,Brion Sanchious\brion-sanchious-1,2016-17,Murray State,F,33,29,775,46,72,.639,46,72,.639,0,0,,22,50,.440,46,82,128,15,8,19,28,86,114,2.9
4342,Ryan Winters\ryan-winters-1,2014-15,Elon,F,20,20,487,43,99,.434,43,99,.434,0,0,,28,40,.700,42,54,96,14,4,2,22,57,114,3.7
4343,Cody Schwartz\cody-schwartz-1,2016-17,San Jose State,F,30,7,385,37,106,.349,3,17,.176,34,89,.382,6,10,.600,9,28,37,17,2,3,17,38,114,1.7
4344,Albert Almanza\albert-almanza-1,2017-18,Sam Houston State,F,22,2,380,40,112,.357,10,27,.370,30,85,.353,4,9,.444,12,35,47,14,12,3,11,46,114,2.9
4345,Brandon Hutton\brandon-hutton-2,2017-18,Northwestern State,F,28,16,477,39,115,.339,34,95,.358,5,20,.250,31,52,.596,33,40,73,21,16,13,50,72,114,1.3
4346,Cadarian Raines\cadarian-raines-1,2013-14,Virginia Tech,F,22,7,350,44,92,.478,44,92,.478,0,0,,26,40,.650,31,39,70,12,6,15,23,43,114,3.6
4347,Zach McRoberts\zach-mcroberts-1,2014-15,Vermont,F,27,3,541,42,86,.488,36,69,.522,6,17,.353,24,40,.600,37,82,119,24,17,9,18,54,114,4.3
4348,Deion Taylor\deion-taylor-1,2015-16,Richmond,F,30,26,650,46,82,.561,37,52,.712,9,30,.300,13,27,.481,17,85,102,48,17,20,26,75,114,3.8
4349,Anthony Smith\anthony-smith-915,2017-18,Murray State,F,32,0,463,31,59,.525,30,57,.526,1,2,.500,51,74,.689,48,64,112,9,19,18,38,93,114,2.9
4350,Henrik Jadersten\henrik-jadersten-1,2015-16,Santa Clara,F,31,1,377,40,114,.351,17,42,.405,23,72,.319,10,14,.714,17,52,69,13,5,13,15,61,113,1.9
4351,Wesley Dickinson\wesley-dickinson-1,2016-17,Dartmouth,F,27,15,461,47,74,.635,47,74,.635,0,0,,19,37,.514,39,32,71,12,8,13,27,49,113,3.3
4352,Brandon Smith\brandon-smith-9,2016-17,UC-Irvine,F,36,35,770,38,118,.322,23,71,.324,15,47,.319,22,38,.579,18,96,114,30,27,23,35,92,113,2.0
4353,Jordan Abdur-Ra'oof\jordan-abdur-raoof-1,2015-16,Cornell,F,28,25,534,42,134,.313,25,66,.379,17,68,.250,12,24,.500,27,65,92,20,22,7,21,58,113,2.4
4354,Cory Starkey\cory-starkey-1,2014-15,Bucknell,F,31,12,563,45,94,.479,45,94,.479,0,0,,23,32,.719,44,100,144,39,6,7,35,45,113,3.5
4355,Dwight Tarwater\dwight-tarwater-1,2014-15,University of California,F,33,13,619,42,110,.382,18,31,.581,24,79,.304,5,6,.833,26,70,96,16,6,4,17,49,113,2.3
4356,Ervins Meznieks\ervin-meznieks-1,2015-16,Boston College,F,32,10,608,38,114,.333,13,33,.394,25,81,.309,12,22,.545,17,47,64,31,16,3,23,61,113,2.0
4357,Zach Hanson\zach-hanson-1,2014-15,Creighton,F,30,8,344,47,86,.547,47,86,.547,0,0,,19,30,.633,30,42,72,4,10,10,33,51,113,2.2
4358,Hunter Sabety\hunter-sabety-1,2017-18,Hofstra,F,31,2,287,53,73,.726,53,73,.726,0,0,,7,18,.389,31,51,82,11,6,23,13,57,113,3.5
4359,Greg Senat\greg-senat-1,2014-15,Wagner,F,29,17,474,46,93,.495,46,93,.495,0,0,,21,39,.538,56,69,125,5,14,14,25,100,113,2.8
4360,Ikenna Smart\ikenna-smart-1,2015-16,Buffalo,F,35,30,546,46,85,.541,46,85,.541,0,0,,21,36,.583,63,88,151,5,9,20,31,113,113,2.5
4361,Vincent Dillard\vincent-dillard-1,2013-14,Texas-Arlington,F,28,8,342,36,100,.360,25,61,.410,11,39,.282,30,60,.500,24,35,59,6,14,2,30,34,113,1.7
4362,Matt Rafferty\matt-rafferty-1,2016-17,Furman,F,16,0,336,44,77,.571,42,66,.636,2,11,.182,23,33,.697,31,54,85,15,13,11,21,37,113,6.6
4363,Dom Uhl\dom-uhl-1,2016-17,Iowa,F,32,7,467,34,97,.351,24,55,.436,10,42,.238,35,52,.673,30,72,102,38,5,9,31,31,113,2.8
4364,Tommy Carpenter\tommy-carpenter-1,2014-15,Dartmouth,F,29,3,404,46,82,.561,45,76,.592,1,6,.167,20,40,.500,20,65,85,32,14,9,31,46,113,3.2
4365,Matthew Moyer\matthew-moyer-1,2017-18,Syracuse,F,35,20,587,45,85,.529,44,76,.579,1,9,.111,22,41,.537,38,82,120,16,13,11,25,52,113,2.9
4366,Ted Kapita\ted-kapita-1,2016-17,North Carolina State,F,26,3,328,45,74,.608,45,74,.608,0,0,,23,28,.821,29,59,88,9,2,8,25,50,113,3.2
4367,Jibri Blount\jibri-blount-1,2016-17,Cleveland State,F,30,10,449,43,105,.410,32,67,.478,11,38,.289,16,24,.667,21,46,67,16,21,5,30,55,113,2.2
4368,Aaron Tate\aaron-tate-1,2013-14,Robert Morris,F,36,12,669,47,101,.465,47,101,.465,0,0,,19,38,.500,54,104,158,20,24,3,30,54,113,3.1
4369,Michael Diggins\michael-diggins-1,2017-18,Illinois-Chicago,F,36,0,465,39,73,.534,21,38,.553,18,35,.514,17,24,.708,21,75,96,19,11,9,25,42,113,2.8
4370,David Taylor\david-taylor-2,2016-17,Pacific,F,24,14,437,35,114,.307,15,47,.319,20,67,.299,23,29,.793,4,36,40,21,11,0,20,41,113,2.0
4371,Scott Plaisance\scott-plaisance-1,2017-18,New Orleans,F,25,7,365,47,114,.412,46,108,.426,1,6,.167,18,28,.643,25,41,66,11,16,17,33,63,113,2.2
4372,Aleksej Rostov\aleksejs-rostov-1,2015-16,Western Kentucky,F,33,10,345,43,85,.506,38,64,.594,5,21,.238,22,39,.564,30,42,72,16,1,11,17,62,113,2.3
4373,Jacquez Rozier\jacquez-rozier-1,2013-14,Middle Tennessee,F,33,2,497,41,84,.488,41,83,.494,0,1,.000,31,56,.554,51,69,120,15,15,19,31,75,113,2.9
4374,Jakeenan Gant\jakeenan-gant-1,2014-15,Missouri,F,23,6,324,47,91,.516,46,77,.597,1,14,.071,18,25,.720,20,30,50,7,9,14,16,33,113,3.6
4375,Montae Glenn\montae-glenn-1,2015-16,Georgia Southern,F,25,9,327,46,78,.590,46,77,.597,0,1,.000,21,28,.750,40,53,93,5,7,8,15,60,113,3.8
4376,Arkim Robertson\arkim-robertson-1,2016-17,Cal State Fullerton,F,29,8,419,43,71,.606,43,71,.606,0,0,,27,52,.519,44,83,127,6,17,25,35,80,113,3.4
4377,Albert Christensson\albert-christensson-1,2014-15,Central Arkansas,F,27,5,341,40,96,.417,29,65,.446,11,31,.355,21,45,.467,21,34,55,10,4,1,39,46,112,1.1
4378,Michael Hoffman\michael-hoffman-1,2013-14,Lafayette,F,29,9,394,43,78,.551,33,62,.532,10,16,.625,16,25,.640,19,38,57,9,4,19,14,59,112,2.8
4379,Jaylen McManus\jaylen-mcmanus-1,2017-18,College of Charleston,F,34,13,514,36,105,.343,13,34,.382,23,71,.324,17,28,.607,20,67,87,14,4,14,12,47,112,2.2
4380,Marshall Wood\marshall-wood-1,2016-17,Richmond,F,31,12,417,39,105,.371,15,32,.469,24,73,.329,10,16,.625,11,46,57,4,11,5,24,45,112,1.6
4381,Javin DeLaurier\javin-delaurier-1,2017-18,Duke,F,33,5,423,45,70,.643,44,62,.710,1,8,.125,21,38,.553,54,77,131,16,21,19,23,74,112,3.9
4382,Jordan Garnett\jordan-garnett-1,2015-16,Northern Kentucky,F,30,26,593,39,92,.424,32,70,.457,7,22,.318,27,38,.711,37,46,83,31,15,8,24,70,112,3.0
4383,Mohamed Bendary\mohamed-bendary-1,2017-18,NJIT,F,29,2,345,54,76,.711,54,76,.711,0,0,,4,10,.400,37,51,88,26,10,13,25,53,112,3.8
4384,Austin Etherington\austin-etherington-1,2015-16,Butler,F,30,2,366,36,68,.529,14,18,.778,22,50,.440,18,28,.643,11,43,54,15,18,3,20,60,112,2.7
4385,Sacha Killeya-Jones\sacha-killeya-jones-1,2017-18,Kentucky,F,34,0,467,45,77,.584,45,76,.592,0,1,.000,22,39,.564,43,56,99,8,7,19,23,72,112,2.7
4386,Lucas Devenny\lucas-devenny-1,2013-14,UC-Riverside,F,31,12,457,45,73,.616,45,73,.616,0,0,,22,31,.710,45,70,115,10,10,10,13,56,112,3.8
4387,LaBarrius Hill\labarrius-hill-1,2017-18,McNeese State,F,27,6,473,46,77,.597,45,73,.616,1,4,.250,19,27,.704,40,63,103,16,11,43,18,73,112,4.6
4388,Odera Nweke\odera-nweke-1,2014-15,NJIT,F,33,2,562,41,88,.466,41,87,.471,0,1,.000,30,52,.577,35,59,94,33,10,21,34,65,112,2.7
4389,Lukas Jarrett\lukas-jarrett-1,2016-17,Lafayette,F,30,16,542,45,101,.446,39,79,.494,6,22,.273,16,21,.762,26,75,101,23,17,26,36,43,112,3.2
4390,Landen Lucas\landen-lucas-1,2014-15,Kansas,F,32,14,485,41,77,.532,41,77,.532,0,0,,30,45,.667,51,88,139,12,9,18,31,70,112,3.2
4391,Jay Simpson\jay-simpson-1,2013-14,Purdue,F,26,7,312,47,109,.431,46,102,.451,1,7,.143,17,33,.515,36,57,93,15,12,8,24,46,112,2.9
4392,John Gage\john-gage-1,2013-14,Stanford,F,34,1,390,35,98,.357,9,21,.429,26,77,.338,16,17,.941,14,39,53,11,12,11,15,54,112,2.0
4393,Jorge Bilbao\jorge-bilbao-1,2014-15,Texas-Arlington,F,30,20,470,46,74,.622,46,72,.639,0,2,.000,20,37,.541,39,58,97,19,15,9,24,75,112,3.2
4394,David Kadiri\david-kadiri-1,2015-16,Buffalo,F,30,4,354,42,71,.592,42,71,.592,0,0,,28,42,.667,33,31,64,2,2,20,13,65,112,2.8
4395,Mark Williams\mark-williams-3,2015-16,Temple,F,31,1,292,42,96,.438,31,62,.500,11,34,.324,17,25,.680,24,30,54,18,1,4,19,43,112,2.1
4396,Nate Renfro\nate-renfro-1,2015-16,San Francisco,F,29,10,427,43,85,.506,38,66,.576,5,19,.263,20,46,.435,33,49,82,12,14,19,28,75,111,2.5
4397,Duane Clark\duane-clark-1,2016-17,Missouri-Kansas City,F,32,1,349,50,102,.490,50,102,.490,0,0,,11,31,.355,23,40,63,14,7,14,37,58,111,1.4
4398,Aaron Epps\aaron-epps-1,2015-16,Louisiana State,F,29,2,265,49,90,.544,43,70,.614,6,20,.300,7,9,.778,22,31,53,6,5,9,14,55,111,2.4
4399,Darion Atkins\darion-atkins-1,2013-14,Virginia,F,37,3,386,45,93,.484,45,93,.484,0,0,,21,36,.583,34,48,82,11,6,19,25,47,111,2.1
4400,Larry Dennis\larry-dennis-1,2017-18,Stetson,F,32,27,478,50,124,.403,50,124,.403,0,0,,11,32,.344,21,83,104,7,10,24,41,74,111,1.1
4401,Cheickna Dembele\cheickna-dembele-1,2016-17,Nevada-Las Vegas,F,28,17,537,42,92,.457,42,92,.457,0,0,,27,56,.482,53,70,123,7,4,35,47,71,111,2.4
4402,Kavell Bigby-Williams\kavell-bigby-williams-1,2016-17,Oregon,F,37,1,363,35,77,.455,35,77,.455,0,0,,41,66,.621,33,70,103,7,3,26,22,54,111,2.4
4403,John McArthur\john-mcarthur-1,2013-14,Santa Clara,F,28,21,632,48,129,.372,43,106,.406,5,23,.217,10,12,.833,34,58,92,25,16,15,10,77,111,3.0
4404,Jake Newton\jake-newton-1,2015-16,Southern Illinois-Edwardsville,F,25,0,356,38,119,.319,7,32,.219,31,87,.356,4,9,.444,8,33,41,17,10,2,16,38,111,1.9
4405,Patrick Tape\patrick-tape-1,2017-18,Columbia,F,25,25,430,48,89,.539,48,89,.539,0,0,,15,28,.536,58,70,128,12,16,31,35,78,111,4.2
4406,Kenneth Lowe\kenneth-lowe-1,2014-15,Green Bay,F,33,13,638,48,92,.522,48,92,.522,0,0,,15,45,.333,29,56,85,24,18,19,31,71,111,2.4
4407,Jalen Jones\jalen-jones-3,2017-18,Howard,F,33,24,721,44,75,.587,43,73,.589,1,2,.500,22,44,.500,58,103,161,30,20,16,40,92,111,3.5
4408,Cameron Forte\cameron-forte-1,2013-14,Georgia,F,33,6,292,52,88,.591,52,87,.598,0,1,.000,7,23,.304,24,42,66,25,6,7,26,12,111,2.8
4409,Zach LeDay\zach-leday-1,2013-14,South Florida,F,32,16,481,35,85,.412,32,74,.432,3,11,.273,38,50,.760,33,49,82,12,9,7,22,55,111,2.4
4410,Jay Canty\jay-canty-1,2013-14,Appalachian State,F,9,5,230,40,76,.526,36,64,.563,4,12,.333,27,39,.692,9,25,34,13,12,3,22,19,111,8.5
4411,Joe Thomas\joe-thomas-1,2013-14,Niagara,F,33,10,452,51,93,.548,51,93,.548,0,0,,9,35,.257,37,50,87,14,7,27,23,80,111,2.3
4412,Chris Coalmon\chris-coalmon-1,2017-18,Robert Morris,F,33,2,496,43,99,.434,28,54,.519,15,45,.333,10,16,.625,18,30,48,11,10,7,26,66,111,1.5
4413,Shawn O'Connell\shawn-oconnell-1,2016-17,Georgia Southern,F,29,10,365,44,77,.571,41,68,.603,3,9,.333,19,27,.704,30,51,81,1,7,13,13,66,110,2.9
4414,Montell McRae\montell-mcrae-1,2017-18,Buffalo,F,36,5,471,43,92,.467,30,46,.652,13,46,.283,11,24,.458,35,52,87,12,9,12,23,77,110,1.9
4415,Petr Herman\petr-herman-1,2015-16,Loyola Marymount,F,30,2,342,45,94,.479,45,94,.479,0,0,,20,32,.625,32,51,83,16,16,12,24,50,110,2.9
4416,Tre Scott\tre-scott-1,2017-18,Cincinnati,F,36,0,449,41,74,.554,41,73,.562,0,1,.000,28,47,.596,50,78,128,32,15,7,22,38,110,3.6
4417,Malik Dime\malik-dime-1,2016-17,Washington,F,20,13,429,42,82,.512,42,82,.512,0,0,,26,43,.605,44,65,109,16,9,49,22,57,110,6.1
4418,Elias Desport\elias-desport-1,2015-16,Saint Peter's,F,30,14,502,38,97,.392,38,97,.392,0,0,,34,54,.630,45,51,96,12,10,3,35,73,110,1.7
4419,Mitch Brewe\mitch-brewe-1,2013-14,UC-Santa Barbara,F,27,24,463,38,78,.487,28,59,.475,10,19,.526,24,28,.857,33,58,91,10,11,9,15,54,110,3.6
4420,Tyler Hagedorn\tyler-hagedorn-1,2016-17,South Dakota,F,22,0,269,34,80,.425,17,39,.436,17,41,.415,25,33,.758,12,44,56,8,7,14,9,35,110,3.9
4421,Hayden Farquhar\hayden-farquhar-1,2017-18,Abilene Christian,F,31,1,300,42,111,.378,26,41,.634,16,70,.229,10,17,.588,16,61,77,11,13,9,18,40,110,2.2
4422,Malik Hines\malik-hines-1,2016-17,Massachusetts,F,31,6,357,47,78,.603,47,78,.603,0,0,,16,30,.533,33,60,93,13,10,17,25,62,110,2.9
4423,Garland Owens\garland-owens-1,2013-14,Boston College,F,30,3,460,42,82,.512,28,46,.609,14,36,.389,12,23,.522,18,35,53,13,7,4,12,62,110,2.3
4424,Hari Hall\hari-hall-1,2014-15,James Madison,F,19,0,283,40,96,.417,28,62,.452,12,34,.353,18,26,.692,13,38,51,6,6,2,22,18,110,3.1
4425,Garland Owens\garland-owens-1,2014-15,Boston College,F,32,2,530,47,92,.511,44,79,.557,3,13,.231,13,21,.619,24,39,63,17,6,5,25,53,110,2.0
4426,Coye Simmons\coye-simmons-1,2015-16,Georgia Southern,F,31,20,471,43,98,.439,43,98,.439,0,0,,24,47,.511,65,105,170,3,4,7,21,69,110,2.9
4427,Lew Evans\lew-evans-1,2016-17,Tennessee,F,32,4,475,30,87,.345,17,43,.395,13,44,.295,37,54,.685,35,56,91,30,10,7,26,74,110,2.4
4428,Erik Copes\erik-copes-1,2013-14,George Mason,F,25,14,516,50,86,.581,50,86,.581,0,0,,10,27,.370,46,93,139,8,12,28,30,85,110,3.9
4429,Leland King\leland-king-1,2016-17,Nevada,F,30,2,302,43,100,.430,37,73,.507,6,27,.222,18,27,.667,27,50,77,14,6,4,17,39,110,2.5
4430,Riley Payne\riley-payne-1,2013-14,Abilene Christian,F,31,20,584,39,82,.476,39,82,.476,0,0,,32,44,.727,30,48,78,24,18,3,33,88,110,2.2
4431,Hayden Dalton\hayden-dalton-1,2015-16,Wyoming,F,29,1,428,32,76,.421,22,40,.550,10,36,.278,36,46,.783,14,81,95,29,8,13,25,51,110,3.2
4432,Kellon Taylor\kellon-taylor-1,2017-18,Duquesne,F,29,2,562,44,71,.620,42,64,.656,2,7,.286,19,30,.633,44,67,111,26,13,7,30,54,109,3.7
4433,Terrence Thompson\terrence-thompson-1,2015-16,Marshall,F,32,0,360,38,78,.487,36,72,.500,2,6,.333,31,57,.544,40,73,113,11,14,5,18,54,109,3.0
4434,Deontae Cole\deontae-cole-1,2014-15,Northern Kentucky,F,27,19,384,37,93,.398,5,12,.417,32,81,.395,3,6,.500,8,25,33,9,4,5,6,19,109,2.6
4435,Will Joyce\will-joyce-1,2016-17,Southern Utah,F,28,10,398,46,81,.568,46,79,.582,0,2,.000,17,30,.567,41,63,104,6,13,12,20,59,109,3.4
4436,Chris Harriel\chris-harriel-1,2013-14,UC-Riverside,F,27,11,437,36,118,.305,24,62,.387,12,56,.214,25,53,.472,16,37,53,19,12,6,25,31,109,1.6
4437,Miles Bowman\miles-bowman-1,2015-16,High Point,F,15,5,220,38,65,.585,34,54,.630,4,11,.364,29,32,.906,21,42,63,8,3,3,10,23,109,6.4
4438,Kentan Facey\kentan-facey-1,2015-16,Connecticut,F,35,5,444,47,82,.573,47,82,.573,0,0,,15,23,.652,60,67,127,10,8,30,27,74,109,3.1
4439,Corey Brown\corey-brown-4,2015-16,Northern Arizona,F,30,14,362,45,74,.608,45,74,.608,0,0,,19,37,.514,33,43,76,2,7,8,22,82,109,2.1
4440,Billy Wampler\billy-wampler-1,2015-16,Drake,F,29,0,289,39,94,.415,12,34,.353,27,60,.450,4,8,.500,1,25,26,12,5,4,15,37,109,1.8
4441,Zach Gordon\zach-gordon-1,2015-16,Cal Poly,F,30,14,399,42,75,.560,42,75,.560,0,0,,25,45,.556,40,57,97,5,7,11,19,86,109,2.5
4442,Zachary Hamilton\zachary-hamilton-1,2014-15,Prairie View,F,32,5,408,43,100,.430,42,94,.447,1,6,.167,22,27,.815,27,33,60,11,16,3,20,49,109,2.2
4443,Ivan Cruz Uceda\ivan-cruz-uceda-1,2014-15,Miami (FL),F,21,6,360,37,99,.374,16,37,.432,21,62,.339,14,17,.824,18,56,74,4,8,5,13,19,109,3.6
4444,Jamari Traylor\jamari-traylor-1,2015-16,Kansas,F,37,8,503,41,77,.532,41,77,.532,0,0,,27,40,.675,40,79,119,19,23,33,41,90,109,2.7
4445,Kelvin Downs\kelvin-downs-1,2014-15,Arkansas State,F,28,8,502,42,111,.378,41,106,.387,1,5,.200,24,37,.649,23,54,77,5,4,16,34,75,109,1.1
4446,Mrdjan Gasevic\mrdjan-gasevic-1,2016-17,Delaware State,F,30,3,344,43,92,.467,43,91,.473,0,1,.000,23,37,.622,29,43,72,16,8,5,25,38,109,2.4
4447,Mark Williams\mark-williams-3,2014-15,Temple,F,31,9,410,37,114,.325,25,71,.352,12,43,.279,23,37,.622,27,55,82,22,2,5,28,48,109,1.5
4448,Kerem Kanter\kerem-kanter-1,2015-16,Green Bay,F,28,0,266,42,92,.457,37,67,.552,5,25,.200,20,29,.690,22,39,61,6,1,2,10,38,109,2.4
4449,Marcus Bryan\marcus-bryan-1,2013-14,Charlotte,F,31,0,384,45,98,.459,45,98,.459,0,0,,19,29,.655,27,50,77,14,6,4,26,37,109,2.1
4450,Sean Sheldon\sean-sheldon-1,2013-14,William & Mary,F,32,2,470,42,71,.592,42,71,.592,0,0,,25,45,.556,41,54,95,27,6,9,20,54,109,3.2
4451,Rod Days\rod-days-1,2014-15,Campbell,F,32,13,550,36,118,.305,21,58,.362,15,60,.250,22,39,.564,27,42,69,23,15,12,25,46,109,1.9
4452,Justin Moss\justin-moss--1,2013-14,Buffalo,F,29,0,264,41,72,.569,41,72,.569,0,0,,27,53,.509,34,59,93,3,6,4,19,53,109,2.6
4453,Lowell Ulmer\lowell-ullmer-1,2014-15,St. Francis (NY),F,35,21,542,38,91,.418,31,68,.456,7,23,.304,26,47,.553,35,39,74,28,22,10,28,84,109,2.2
4454,Zach Hanson\zach-hanson-1,2016-17,Creighton,F,20,1,204,48,75,.640,48,75,.640,0,0,,12,27,.444,16,29,45,5,6,1,11,26,108,3.9
4455,Chris McComber\chris-mccomber-1,2014-15,Columbia,F,28,17,510,35,113,.310,6,16,.375,29,97,.299,9,12,.750,18,27,45,9,6,5,11,49,108,1.7
4456,John Golden\john-golden-1,2014-15,Dartmouth,F,22,21,544,42,109,.385,34,76,.447,8,33,.242,16,26,.615,16,48,64,33,19,5,23,40,108,3.5
4457,Antwon Clayton\antwon-clayton-1,2014-15,Jacksonville,F,29,18,625,40,90,.444,40,86,.465,0,4,.000,28,58,.483,63,87,150,19,25,33,32,86,108,3.9
4458,Aaron Ross\aaron-ross-1,2013-14,Texas Tech,F,29,0,283,36,74,.486,28,53,.528,8,21,.381,28,35,.800,15,40,55,11,2,4,12,42,108,2.6
4459,Jernard Jarreau\jernard-jarreau-1,2014-15,Washington,F,21,21,510,43,102,.422,37,91,.407,6,11,.545,16,27,.593,20,79,99,23,11,15,28,62,108,3.4
4460,Keon Williams\keon-williams-2,2016-17,St. Francis (NY),F,31,22,673,37,131,.282,27,76,.355,10,55,.182,24,40,.600,39,95,134,17,23,8,21,53,108,2.5
4461,Ulmer Manzie\ulmer-manzie-1,2016-17,Bethune-Cookman,F,32,19,565,40,95,.421,40,95,.421,0,0,,28,52,.538,52,54,106,20,20,32,36,97,108,2.6
4462,Xzavier Taylor\xzavier-taylor-1,2013-14,Bradley,F,32,18,473,39,75,.520,39,75,.520,0,0,,30,60,.500,50,51,101,8,10,23,24,108,108,2.3
4463,Mitchell Hahn\mitchell-hahn-1,2014-15,Holy Cross,F,23,0,303,34,76,.447,15,25,.600,19,51,.373,21,27,.778,11,39,50,23,4,13,21,27,108,3.6
4464,Justin Pierce\justin-pierce-1,2016-17,William & Mary,F,29,0,310,42,92,.457,35,57,.614,7,35,.200,17,27,.630,19,40,59,15,14,11,22,24,108,2.8
4465,Paul Gombwer\paul-gombwer-1,2014-15,Charleston Southern,F,31,31,644,39,102,.382,29,61,.475,10,41,.244,20,33,.606,63,132,195,25,23,5,34,72,108,3.6
4466,Justin Jackson\justin-jackson-5,2017-18,Maryland,F,11,10,321,37,101,.366,27,61,.443,10,40,.250,24,29,.828,27,62,89,21,9,9,32,15,108,7.2
4467,Connor MacDougall\connor-macdougall-1,2016-17,New Mexico,F,27,0,269,32,68,.471,32,68,.471,0,0,,44,54,.815,26,26,52,2,1,6,20,58,108,2.2
4468,Elyjah Goss\elyjah-goss-1,2017-18,IUPUI,F,30,1,414,41,93,.441,37,80,.463,4,13,.308,22,29,.759,38,68,106,12,12,11,20,46,108,3.1
4469,Anthony Criswell\anthony-criswell-1,2013-14,Missouri,F,28,0,388,39,91,.429,34,72,.472,5,19,.263,25,30,.833,27,68,95,6,5,2,21,68,108,2.1
4470,Jordan Jones\jordan-jones-1,2015-16,Kennesaw State,F,31,30,590,46,112,.411,46,112,.411,0,0,,16,28,.571,25,79,104,28,9,23,19,74,108,2.6
4471,Tevin Falzon\tevin-falzon-1,2013-14,Sacred Heart,F,29,0,452,35,124,.282,34,106,.321,1,18,.056,37,48,.771,52,67,119,14,12,9,21,58,108,2.5
4472,Shawn O'Connell\shawn-oconnell-1,2017-18,Georgia Southern,F,32,2,396,45,63,.714,45,62,.726,0,1,.000,17,33,.515,39,58,97,5,15,14,16,54,107,3.4
4473,Volodymyr Gerun\volodymyr-gerun-1,2013-14,Portland,F,31,0,346,40,92,.435,37,82,.451,3,10,.300,24,37,.649,20,43,63,8,11,10,27,42,107,1.9
4474,A.J. Cockrell\aj-cockrell-1,2015-16,Texas-San Antonio,F,32,0,421,42,90,.467,42,89,.472,0,1,.000,23,40,.575,33,36,69,8,8,8,19,74,107,1.8
4475,Craig Hinton\craig-hinton-1,2016-17,Appalachian State,F,29,7,407,37,75,.493,17,26,.654,20,49,.408,13,19,.684,20,71,91,18,11,6,16,48,107,3.3
4476,Donaven Dorsey\donaven-dorsey-1,2014-15,Washington,F,28,8,412,34,100,.340,4,11,.364,30,89,.337,9,15,.600,8,39,47,7,3,3,12,61,107,1.4
4477,Zach Coleman\zach-coleman-1,2015-16,Massachusetts,F,27,11,480,34,106,.321,25,59,.424,9,47,.191,30,54,.556,36,84,120,31,18,8,21,54,107,3.3
4478,Duje Dukan\duje-dukan-1,2013-14,Wisconsin,F,38,0,309,41,82,.500,26,41,.634,15,41,.366,10,14,.714,19,38,57,11,3,1,8,32,107,2.1
4479,Tre Scott\tre-scott-1,2016-17,Cincinnati,F,34,0,356,45,90,.500,44,87,.506,1,3,.333,16,32,.500,24,64,88,20,17,15,16,24,107,3.2
4480,Treg Setty\treg-setty-1,2013-14,Ohio,F,36,0,416,32,83,.386,28,64,.438,4,19,.211,39,65,.600,17,60,77,28,13,7,32,61,107,1.7
4481,Juwan Newmen\juwan-newmen-1,2013-14,Central Connecticut State,F,28,2,338,38,87,.437,38,86,.442,0,1,.000,31,46,.674,37,52,89,4,10,13,31,53,107,2.4
4482,Solomon Mangham\solomon-mangham-1,2015-16,Howard,F,14,7,338,40,99,.404,29,64,.453,11,35,.314,16,26,.615,33,45,78,2,5,5,13,38,107,4.9
4483,Arinze Chidom\arinze-chidom-1,2017-18,Washington State,F,28,4,280,37,86,.430,20,47,.426,17,39,.436,16,21,.762,14,48,62,11,15,3,17,47,107,2.6
4484,Nolan Narain\nolan-narain-1,2017-18,San Diego State,F,23,1,248,44,64,.688,40,53,.755,4,11,.364,15,23,.652,21,25,46,7,5,3,18,37,107,3.4
4485,Taylor Bessick\taylor-bessick-1,2016-17,Iona,F,34,9,497,44,86,.512,44,86,.512,0,0,,19,29,.655,60,89,149,11,10,45,25,95,107,3.4
4486,J.J. Panoske\jj-panoske-1,2013-14,Milwaukee,F,33,6,342,39,101,.386,29,61,.475,10,40,.250,19,23,.826,23,60,83,14,3,28,24,34,107,2.4
4487,Lennard Freeman\lennard-freeman-1,2015-16,North Carolina State,F,33,15,639,41,78,.526,41,78,.526,0,0,,25,50,.500,67,99,166,33,12,7,25,61,107,3.8
4488,Kem Ubaru\kem-ubaru-1,2014-15,North Carolina-Asheville,F,13,7,242,37,85,.435,33,77,.429,4,8,.500,29,44,.659,19,42,61,8,10,0,34,30,107,4.0
4489,Robert Gilchrist\robert-gilchrist-1,2013-14,Florida State,F,36,24,474,47,104,.452,44,95,.463,3,9,.333,10,26,.385,27,39,66,8,11,20,30,47,107,1.6
4490,Coleman Johnson\coleman-johnson-1,2014-15,Fairfield,F,28,7,541,38,108,.352,38,108,.352,0,0,,31,40,.775,41,61,102,19,15,41,27,91,107,3.0
4491,Devin Wyatt\devin-wyatt-1,2016-17,Incarnate Word,F,23,17,418,41,76,.539,41,76,.539,0,0,,25,47,.532,29,43,72,4,9,52,16,77,107,4.2
4492,Khary Doby\khary-doby-1,2013-14,North Carolina A&T,F,32,6,486,39,114,.342,22,63,.349,17,51,.333,12,30,.400,17,62,79,8,4,11,17,60,107,1.3
4493,Martinas Geben\martinas-geben-1,2016-17,Notre Dame,F,34,23,421,42,65,.646,42,65,.646,0,0,,23,30,.767,42,73,115,25,13,11,22,66,107,3.4
4494,Justin Gray\justin-gray-2,2014-15,Texas Tech,F,16,13,301,37,75,.493,37,67,.552,0,8,.000,33,46,.717,17,28,45,8,10,9,14,25,107,5.1
4495,Kentrall Brooks\kentrall-brooks-1,2015-16,Marist,F,28,11,446,39,90,.433,39,88,.443,0,2,.000,29,37,.784,30,82,112,29,5,22,40,85,107,2.5
4496,Marshawn Blackmon\marshawn-blackmon-1,2015-16,Eastern Illinois,F,30,0,357,48,78,.615,47,75,.627,1,3,.333,10,36,.278,37,49,86,10,17,6,22,33,107,3.2
4497,Aaron Horne\aaron-horne-1,2016-17,North Florida,F,27,0,413,40,92,.435,24,38,.632,16,54,.296,11,15,.733,25,56,81,26,14,1,31,43,107,2.8
4498,Aaron Foster-Smith\aaron-foster-smith-1,2015-16,Detroit Mercy,F,30,1,321,43,80,.538,31,50,.620,12,30,.400,9,17,.529,19,36,55,8,5,9,14,48,107,2.4
4499,Justin Goldsborough\justin-goldsborough-1,2015-16,Lehigh,F,32,1,477,46,86,.535,46,86,.535,0,0,,15,31,.484,42,62,104,8,9,16,34,74,107,2.2
4500,Payton Dastrup\payton-dastrup-1,2017-18,Brigham Young,F,32,0,252,39,75,.520,26,45,.578,13,30,.433,16,24,.667,10,48,58,14,10,14,20,31,107,2.7
4501,Terrence Thompson\terrence-thompson-1,2017-18,Wake Forest,F,31,31,506,37,105,.352,29,88,.330,8,17,.471,25,45,.556,52,69,121,8,20,2,26,50,107,2.5
4502,Lukas Meisner\lukas-meisner-1,2016-17,Columbia,F,17,7,360,40,84,.476,24,39,.615,16,45,.356,11,24,.458,21,82,103,16,3,10,23,40,107,4.7
4503,Marc Gosselin\marc-gosselin-1,2015-16,Western Carolina,F,33,22,625,39,86,.453,33,64,.516,6,22,.273,23,35,.657,51,80,131,31,13,5,29,81,107,2.9
4504,D.J. MacLeay\dj-macleay-1,2014-15,Bucknell,F,30,0,353,39,89,.438,39,85,.459,0,4,.000,29,47,.617,37,58,95,17,13,6,15,54,107,3.0
4505,Brennan Gillis\brennan-gillis-1,2016-17,Northern Kentucky,F,35,2,318,42,80,.525,34,61,.557,8,19,.421,14,25,.560,27,38,65,21,6,9,32,59,106,1.8
4506,Jordan Weethee\jordan-weethee-1,2015-16,Virginia Military Institute,F,29,6,411,35,92,.380,7,13,.538,28,79,.354,8,8,1.000,7,50,57,15,7,2,16,55,106,1.9
4507,Petr Herman\petr-herman-1,2016-17,Loyola Marymount,F,25,12,301,44,81,.543,44,81,.543,0,0,,18,35,.514,26,49,75,12,13,22,16,35,106,4.0
4508,Trey Porter\trey-porter-1,2014-15,George Mason,F,30,7,423,37,79,.468,37,77,.481,0,2,.000,32,55,.582,19,59,78,5,11,33,20,75,106,2.5
4509,Shaheed Davis\shaheed-davis-1,2014-15,Central Florida,F,24,6,333,37,101,.366,28,73,.384,9,28,.321,23,47,.489,22,49,71,8,10,14,33,29,106,2.1
4510,Brandon McDonnell\brandon-mcdonnell-1,2013-14,Dartmouth,F,27,8,375,41,79,.519,40,74,.541,1,5,.200,23,31,.742,15,59,74,14,8,20,18,46,106,3.2
4511,Cal Hanks\cal-hanks-1,2013-14,Southern Utah,F,28,18,401,38,97,.392,38,97,.392,0,0,,30,48,.625,16,55,71,7,3,16,34,86,106,0.9
4512,Tanksley Efianayi\tanksley-efianayi-1,2015-16,Central Florida,F,28,4,381,33,100,.330,24,56,.429,9,44,.205,31,43,.721,16,29,45,15,14,3,13,28,106,2.4
4513,Chas Brown\chas-brown-1,2017-18,Duquesne,F,27,27,454,45,112,.402,43,110,.391,2,2,1.000,14,35,.400,55,59,114,14,13,16,44,87,106,1.8
4514,Damir Hadzic\damir-hadzic-1,2017-18,Little Rock,F,26,12,349,36,95,.379,20,38,.526,16,57,.281,18,26,.692,18,35,53,23,6,4,25,50,106,2.1
4515,J.J. Richardson\jj-richardson-1,2013-14,Houston,F,24,5,309,43,79,.544,43,79,.544,0,0,,20,37,.541,27,36,63,8,10,2,32,61,106,2.1
4516,Adam Roe\adam-roe-1,2015-16,Army,F,33,0,294,34,97,.351,9,30,.300,25,67,.373,13,21,.619,16,23,39,11,8,2,14,32,106,1.7
4517,Derrick Woods\derrick-woods-1,2015-16,St. Bonaventure,F,30,22,394,42,74,.568,42,73,.575,0,1,.000,22,31,.710,25,46,71,3,4,17,29,68,106,2.0
4518,Karl Nicholas\karl-nicholas-1,2017-18,Montana,F,30,0,287,47,78,.603,47,78,.603,0,0,,12,36,.333,31,37,68,5,6,12,29,70,106,1.8
4519,Stephan Van Treese\stephan-van-treese-1,2013-14,Louisville,F,37,21,800,44,69,.638,43,67,.642,1,2,.500,17,29,.586,102,110,212,27,37,30,22,83,106,5.3
4520,Marvin Smith\marvin-smith-1,2014-15,South Carolina Upstate,F,35,4,435,41,86,.477,38,73,.521,3,13,.231,21,35,.600,33,51,84,19,4,7,20,32,106,2.4
4521,David Kadiri\david-kadiri-1,2013-14,Maryland-Baltimore County,F,27,10,383,42,85,.494,42,85,.494,0,0,,22,46,.478,30,35,65,4,9,14,20,74,106,2.1
4522,D'Angelo Allen\dangelo-allen-1,2014-15,Missouri,F,32,7,544,40,98,.408,31,78,.397,9,20,.450,17,28,.607,37,63,100,21,11,7,18,62,106,2.6
4523,Stafford Trueheart\stafford-trueheart-1,2017-18,Hofstra,F,28,14,404,35,78,.449,21,36,.583,14,42,.333,22,30,.733,17,55,72,4,11,24,14,52,106,3.1
4524,Aaron Moore\aaron-moore-1,2013-14,Portland State,F,9,9,268,43,89,.483,43,89,.483,0,0,,20,30,.667,15,37,52,14,7,5,17,34,106,7.6
4525,Brandon Goldsmith\brandon-goldsmith-1,2017-18,North Carolina Central,F,26,20,425,39,99,.394,35,80,.438,4,19,.211,24,38,.632,15,53,68,20,17,5,34,44,106,2.2
4526,Davon Clare\davon-clare-1,2017-18,Cal State Fullerton,F,32,3,554,40,95,.421,33,67,.493,7,28,.250,19,27,.704,31,78,109,35,15,11,37,46,106,2.8
4527,Damonte Dodd\damonte-dodd-1,2015-16,Maryland,F,36,13,569,41,65,.631,41,65,.631,0,0,,24,36,.667,36,63,99,12,3,29,33,88,106,2.2
4528,Xavier Habersham\xavier-habersham-1,2015-16,Middle Tennessee,F,34,2,381,37,105,.352,15,41,.366,22,64,.344,9,17,.529,12,40,52,9,3,5,13,44,105,1.3
4529,Dylan Sherwood\dylan-sherwood-1,2013-14,North Carolina-Wilmington,F,30,2,293,38,92,.413,25,52,.481,13,40,.325,16,25,.640,25,47,72,9,4,5,8,36,105,2.5
4530,Travin Thibodeaux\travin-thibodeaux-1,2014-15,New Orleans,F,29,10,539,40,78,.513,40,77,.519,0,1,.000,25,40,.625,35,87,122,10,17,29,25,81,105,3.4
4531,Nick Smith\nick-smith-3,2013-14,Belmont,F,35,0,279,37,71,.521,17,25,.680,20,46,.435,11,14,.786,14,26,40,5,3,5,12,49,105,1.9
4532,Isaac Humphries\isaac-humphries-1,2016-17,Kentucky,F,38,1,315,45,88,.511,45,88,.511,0,0,,15,25,.600,51,55,106,9,8,18,16,58,105,2.6
4533,Kyle Alexander\kyle-alexander-1,2016-17,Tennessee,F,32,23,447,41,88,.466,40,82,.488,1,6,.167,22,44,.500,57,72,129,6,6,31,15,53,105,3.4
4534,Lonnie Rivera\lonnie-rivera-1,2016-17,American,F,21,9,364,38,79,.481,26,51,.510,12,28,.429,17,19,.895,5,37,42,10,6,4,22,32,105,2.8
4535,Tom Knight\tom-knight-1,2013-14,Notre Dame,F,27,7,384,45,84,.536,45,84,.536,0,0,,15,22,.682,34,51,85,11,9,16,19,49,105,3.3
4536,Tirus Smith\tirus-smith-1,2017-18,Texas-El Paso,F,24,7,327,38,82,.463,37,78,.474,1,4,.250,28,47,.596,27,48,75,4,2,11,29,69,105,1.9
4537,Kalif Young\kalif-young-1,2016-17,Providence,F,33,5,432,44,85,.518,44,84,.524,0,1,.000,17,46,.370,46,60,106,13,12,17,33,56,105,2.4
4538,Muhammed Ahmed\muhammed-ahmed-1,2014-15,North Texas,F,28,1,288,40,112,.357,37,90,.411,3,22,.136,22,44,.500,31,38,69,2,9,12,16,22,105,2.2
4539,Tyrel Hunt\tyrel-hunt-1,2015-16,Alcorn State,F,29,5,425,29,77,.377,25,65,.385,4,12,.333,43,61,.705,19,35,54,16,10,2,25,36,105,2.2
4540,Bernard Sullivan\bernard-sullivan-1,2015-16,Charlotte,F,10,9,250,42,105,.400,42,101,.416,0,4,.000,21,36,.583,22,34,56,16,3,9,18,25,105,6.0
4541,Emmitt Holt\emmitt-holt-1,2014-15,Indiana,F,29,0,332,39,60,.650,39,60,.650,0,0,,27,50,.540,38,48,86,5,7,21,11,48,105,3.6
4542,Eric Norman\eric-norman-1,2013-14,Montana State,F,25,8,430,39,72,.542,25,41,.610,14,31,.452,13,19,.684,30,81,111,19,13,18,30,45,105,4.2
4543,Greg McClinton\greg-mcclinton-1,2014-15,Wake Forest,F,31,14,454,39,91,.429,39,87,.448,0,4,.000,27,43,.628,41,48,89,26,13,9,30,48,105,2.6
4544,L.G. Gill\lg-gill-1,2013-14,Duquesne,F,29,0,353,37,97,.381,15,31,.484,22,66,.333,9,11,.818,23,34,57,8,5,6,12,49,105,2.1
4545,Luke Morrison\luke-morrison-1,2015-16,Army,F,21,0,218,38,99,.384,17,45,.378,21,54,.389,8,9,.889,21,22,43,5,12,0,18,30,105,2.7
4546,John Jones\john-jones-1,2014-15,Illinois State,F,34,5,445,47,87,.540,47,86,.547,0,1,.000,11,28,.393,40,67,107,9,12,21,29,72,105,2.3
4547,Isaiah Massey\isaiah-massey-1,2013-14,Louisiana Tech,F,31,3,400,38,70,.543,37,69,.536,1,1,1.000,27,38,.711,24,76,100,5,8,15,14,70,104,2.8
4548,Mohamed Bah\mohamed-bah-1,2016-17,Drexel,F,24,5,301,42,72,.583,42,71,.592,0,1,.000,20,34,.588,33,56,89,7,4,4,16,32,104,3.7
4549,Uros Ljeskovic\uros-ljeskovic-1,2013-14,Coastal Carolina,F,32,3,380,39,74,.527,39,74,.527,0,0,,26,55,.473,50,37,87,2,9,3,32,62,104,1.8
4550,Chinanu Onuaku\chinanu-onuaku-1,2014-15,Louisville,F,35,26,623,45,73,.616,45,73,.616,0,0,,14,30,.467,69,91,160,19,26,42,44,83,104,3.8
4551,Ralph Hill\ralph-hill-1,2014-15,Oakland,F,32,4,299,33,77,.429,9,12,.750,24,65,.369,14,16,.875,5,27,32,16,7,3,8,33,104,2.3
4552,Dimitrije Cabarkapa\dimitrije-cabarkapa-1,2016-17,James Madison,F,28,2,285,38,103,.369,24,63,.381,14,40,.350,14,18,.778,14,55,69,3,4,2,20,24,104,1.8
4553,Kamryn Williams\kamryn-williams-1,2014-15,Air Force,F,11,11,310,38,78,.487,36,63,.571,2,15,.133,26,35,.743,25,41,66,30,17,9,25,29,104,9.0
4554,Andrew McAuliffe\andrew-mcauliffe-1,2015-16,Davidson,F,32,0,389,49,88,.557,48,81,.593,1,7,.143,5,17,.294,25,56,81,18,7,7,23,61,104,2.1
4555,B.J. Johnson\bj-johnson-2,2014-15,Syracuse,F,25,4,366,35,114,.307,19,53,.358,16,61,.262,18,25,.720,26,53,79,12,14,5,17,26,104,2.7
4556,Marshall Wood\marshall-wood-1,2013-14,Virginia Tech,F,26,11,409,34,95,.358,17,46,.370,17,49,.347,19,24,.792,24,67,91,11,2,7,26,30,104,2.4
4557,Ikenna Smart\ikenna-smart-1,2016-17,Buffalo,F,31,19,398,42,64,.656,42,64,.656,0,0,,20,32,.625,49,63,112,8,4,10,20,72,104,3.0
4558,Shore Adenekan\shore-adenekan-1,2014-15,Seattle,F,26,1,412,42,74,.568,42,74,.568,0,0,,20,43,.465,30,51,81,9,7,14,18,45,104,3.2
4559,Jonathan Galloway\jonathan-galloway-1,2015-16,UC-Irvine,F,38,2,546,41,74,.554,41,74,.554,0,0,,22,46,.478,54,86,140,7,12,24,26,65,104,2.7
4560,Justus Stanback\justus-stanback-1,2013-14,IUPUI,F,32,12,484,43,114,.377,38,94,.404,5,20,.250,13,21,.619,20,49,69,9,15,6,29,72,104,1.1
4561,Treshaad Williams\treshaad-williams-1,2015-16,Morehead State,F,36,0,356,37,57,.649,37,57,.649,0,0,,29,42,.690,40,36,76,10,12,1,15,47,103,2.7
4562,Alston Jones\alston-jones-1,2017-18,North Carolina Central,F,23,2,316,38,84,.452,32,76,.421,6,8,.750,21,25,.840,4,21,25,45,3,1,41,39,103,2.0
4563,Frank Okeke\frank-okeke-1,2014-15,New Hampshire,F,31,0,487,34,100,.340,12,24,.500,22,76,.289,13,24,.542,8,38,46,20,2,10,18,28,103,1.7
4564,Terrance Syon\terrance-syon-1,2013-14,New Orleans,F,26,0,444,35,80,.438,35,79,.443,0,1,.000,33,67,.493,48,63,111,13,13,17,24,68,103,3.2
4565,Kipper Nichols\kipper-nichols-1,2016-17,Illinois,F,21,1,286,39,86,.453,27,59,.458,12,27,.444,13,21,.619,19,41,60,2,7,7,15,47,103,2.9
4566,Brandon Horvath\brandon-horvath-1,2017-18,Maryland-Baltimore County,F,31,3,311,38,88,.432,22,33,.667,16,55,.291,11,27,.407,17,47,64,12,8,5,11,18,103,2.5
4567,Jordan Scott\jordan-scott-2,2015-16,Idaho,F,34,9,545,42,111,.378,37,88,.420,5,23,.217,14,32,.438,39,70,109,30,6,11,29,61,103,1.9
4568,Denzell Taylor\denzell-taylor-1,2014-15,Old Dominion,F,35,9,847,44,80,.550,44,80,.550,0,0,,15,34,.441,125,84,209,46,37,23,44,97,103,4.9
4569,Brandon Mitchell\brandon-mitchell-2,2014-15,San Jose State,F,28,10,547,33,108,.306,27,80,.338,6,28,.214,31,58,.534,48,91,139,8,22,11,29,64,103,2.6
4570,Jake Krafka\jake-krafka-1,2016-17,Denver,F,26,1,327,36,81,.444,24,45,.533,12,36,.333,19,30,.633,12,57,69,18,5,6,13,37,103,2.9
4571,Junior Longrus\junior-longrus-1,2013-14,Washington State,F,31,7,621,43,93,.462,43,91,.473,0,2,.000,17,33,.515,51,56,107,31,20,23,23,81,103,3.3
4572,Johnathon Wilkins\jonathan-wilkins-1,2014-15,New Mexico State,F,34,10,589,40,84,.476,40,83,.482,0,1,.000,23,43,.535,44,40,84,22,9,11,33,61,103,2.1
4573,Richard Polanco\richard-polanco-1,2017-18,Eastern Washington,F,27,0,227,38,83,.458,29,53,.547,9,30,.300,18,25,.720,9,34,43,10,5,5,29,60,103,1.3
4574,Kyle Broekhuis\kyle-broekhuis-1,2015-16,Air Force,F,31,15,501,33,83,.398,23,50,.460,10,33,.303,27,40,.675,25,63,88,21,6,2,29,49,103,2.0
4575,Frank Ryder\frank-ryder-1,2016-17,San Diego,F,25,1,339,38,80,.475,38,80,.475,0,0,,27,37,.730,19,23,42,15,4,4,17,59,103,2.2
4576,Michael Hurt\michael-hurt-1,2017-18,Minnesota,F,32,14,608,35,79,.443,26,58,.448,9,21,.429,24,36,.667,10,71,81,30,9,14,23,30,103,2.8
4577,Cameron Neubauer\cameron-neubauer-1,2015-16,San Diego,F,21,8,316,33,77,.429,13,27,.481,20,50,.400,17,24,.708,8,33,41,15,4,1,13,51,103,2.7
4578,Joel Angus III\joel-angusiii-1,2017-18,Hofstra,F,21,17,360,42,87,.483,42,87,.483,0,0,,19,23,.826,31,47,78,8,8,5,10,33,103,4.1
4579,Zach Gordon\zach-gordon-1,2016-17,Cal Poly,F,30,9,511,31,74,.419,31,73,.425,0,1,.000,41,62,.661,65,88,153,7,10,41,24,88,103,3.7
4580,Amile Jefferson\amile-jefferson-1,2015-16,Duke,F,9,9,273,41,60,.683,41,60,.683,0,0,,21,38,.553,43,50,93,13,9,10,15,23,103,13.0
4581,Ed Drew\ed-drew-1,2013-14,Presbyterian,F,31,12,506,45,108,.417,45,107,.421,0,1,.000,13,26,.500,32,59,91,8,7,19,24,62,103,1.9
4582,Nicola Akele\nicola-akele-1,2016-17,Rhode Island,F,35,1,443,37,75,.493,26,48,.542,11,27,.407,18,23,.783,28,56,84,29,16,14,14,62,103,3.1
4583,Max Rothschild\max-rothschild-1,2016-17,Pennsylvania,F,27,1,326,42,77,.545,42,76,.553,0,1,.000,19,36,.528,26,54,80,27,11,7,38,45,103,2.7
4584,Blake Paul\blake-paul-1,2017-18,Tulane,F,31,28,469,42,80,.525,42,80,.525,0,0,,19,31,.613,32,63,95,25,5,39,40,76,103,2.6
4585,Kyle Kuzma\kyle-kuzma-1,2014-15,Utah,F,31,0,252,36,79,.456,25,45,.556,11,34,.324,20,36,.556,10,45,55,19,1,5,18,32,103,2.0
4586,Sean O'Mara\sean-omara-1,2015-16,Xavier,F,32,0,225,39,64,.609,39,64,.609,0,0,,24,40,.600,18,42,60,8,6,7,18,37,102,2.4
4587,Mileek McMillan\mileek-mcmillan-1,2017-18,Valparaiso,F,32,18,338,36,87,.414,20,43,.465,16,44,.364,14,18,.778,8,38,46,11,5,7,36,64,102,0.8
4588,Ruben Arroyo-Felix\ruben-arroyo-felix-1,2014-15,Presbyterian,F,32,5,387,46,106,.434,39,80,.488,7,26,.269,3,9,.333,16,27,43,4,9,4,19,34,102,1.4
4589,Vaughn Gray\vaughn-gray-1,2014-15,George Mason,F,28,9,411,37,115,.322,18,47,.383,19,68,.279,9,23,.391,16,21,37,10,13,3,11,33,102,1.6
4590,Chuck Ester\chuck-ester-1,2014-15,Chattanooga,F,30,6,405,40,89,.449,36,78,.462,4,11,.364,18,36,.500,25,62,87,15,12,10,30,57,102,2.0
4591,Reid Travis\reid-travis-1,2015-16,Stanford,F,8,8,262,39,70,.557,39,70,.557,0,0,,24,50,.480,26,31,57,6,6,5,17,19,102,9.4
4592,Adrian Edwards\adrian-edwards-1,2014-15,Alabama A&M,F,29,4,435,43,98,.439,43,96,.448,0,2,.000,16,36,.444,37,41,78,5,7,9,35,57,102,1.4
4593,Dre' Clayton\dre-clayton-1,2016-17,Austin Peay,F,29,6,452,40,96,.417,30,59,.508,10,37,.270,12,24,.500,14,64,78,16,8,6,24,77,102,1.5
4594,Marcus Lee\marcus-lee-2,2014-15,Kentucky,F,39,0,425,47,73,.644,47,73,.644,0,0,,8,25,.320,47,60,107,12,3,27,18,61,102,2.6
4595,Ralueke Orizu\ralueke-orizu-1,2017-18,Savannah State,F,26,1,301,38,70,.543,38,69,.551,0,1,.000,26,46,.565,29,52,81,4,8,18,22,40,102,3.1
4596,J.P. Moorman\jp-moorman-1,2017-18,Temple,F,27,0,321,35,82,.427,22,43,.512,13,39,.333,19,25,.760,25,65,90,19,17,4,16,46,102,3.4
4597,Matt Jackson\matt-jackson-1,2017-18,Grand Canyon,F,32,1,420,39,99,.394,29,62,.468,10,37,.270,14,23,.609,23,68,91,29,14,4,25,41,102,2.4
4598,Harry Giles\harry-giles-1,2016-17,Duke,F,26,6,300,45,78,.577,45,78,.577,0,0,,12,24,.500,41,59,100,9,9,17,18,58,102,3.6
4599,Arlando Cook\arlando-cook-1,2016-17,Arkansas,F,36,7,405,39,89,.438,39,89,.438,0,0,,24,37,.649,29,54,83,12,10,14,23,63,102,1.9
4600,Bola Olaniyan\bola-olaniyan-1,2016-17,Alabama,F,33,22,530,39,76,.513,39,76,.513,0,0,,24,40,.600,89,123,212,13,23,1,43,69,102,3.6
4601,Michael Akuchie\michael-akuchie-1,2017-18,Youngstown State,F,29,5,266,34,92,.370,19,33,.576,15,59,.254,19,20,.950,23,36,59,4,6,8,25,41,102,1.7
4602,Wadly Mompremier\wadly-mompremier-1,2017-18,Little Rock,F,24,2,329,37,76,.487,28,47,.596,9,29,.310,19,29,.655,22,53,75,7,6,19,37,47,102,2.5
4603,Matt Klinewski\matt-klinewski-1,2014-15,Lafayette,F,33,1,296,40,86,.465,40,85,.471,0,1,.000,22,35,.629,27,32,59,6,8,12,19,48,102,1.9
4604,Gabe Bealer\gabe-bealer-1,2016-17,Utah,F,28,6,338,36,84,.429,15,28,.536,21,56,.375,9,12,.750,7,44,51,13,9,2,16,22,102,2.5
4605,Jalen Canty\jalen-canty-1,2016-17,UC-Santa Barbara,F,10,10,264,43,78,.551,43,78,.551,0,0,,16,36,.444,31,39,70,15,4,6,14,29,102,8.3
4606,Elijah Foster\elijah-foster-1,2015-16,Nevada,F,36,32,584,39,84,.464,39,84,.464,0,0,,24,37,.649,37,96,133,25,10,11,33,82,102,2.2
4607,Tom Schalk\tom-schalk-1,2014-15,William & Mary,F,22,4,328,42,65,.646,41,62,.661,1,3,.333,17,21,.810,22,38,60,26,11,19,13,38,102,5.1
4608,Marcus Santos-Silva\marcus-santos-silva-1,2017-18,Virginia Commonwealth,F,33,0,323,46,86,.535,46,86,.535,0,0,,10,25,.400,34,66,100,9,3,17,26,52,102,2.2
4609,Patrick Kirksey\patrick-kirksey-1,2014-15,South Carolina State,F,33,19,601,41,95,.432,41,94,.436,0,1,.000,20,72,.278,44,86,130,15,21,4,29,58,102,2.1
4610,Bola Olaniyan\bola-olaniyan-1,2013-14,Southern Illinois,F,30,12,471,34,66,.515,34,66,.515,0,0,,34,56,.607,63,84,147,10,13,4,31,76,102,3.0
4611,Rashard Kelly\rashard-kelly-1,2014-15,Wichita State,F,35,5,483,38,77,.494,34,68,.500,4,9,.444,22,42,.524,45,56,101,14,13,11,36,44,102,2.3
4612,Mohamed Sherif\mohamed-sherif-1,2016-17,Alabama A&M,F,20,2,311,37,63,.587,37,63,.587,0,0,,28,66,.424,32,40,72,4,2,7,19,53,102,3.1
4613,Alex Majewski\alex-majewski-1,2013-14,Texas-Rio Grande Valley,F,32,4,328,32,86,.372,10,23,.435,22,63,.349,15,22,.682,17,23,40,8,5,2,18,33,101,1.6
4614,Chris Freeman\chris-freeman-1,2013-14,Austin Peay,F,29,1,280,42,68,.618,42,68,.618,0,0,,17,29,.586,22,40,62,7,7,13,24,43,101,2.5
4615,Rocco Belcaster\rocco-belcaster-1,2014-15,Ball State,F,30,1,518,33,110,.300,8,20,.400,25,90,.278,10,19,.526,24,39,63,30,10,4,34,55,101,1.3
4616,Candido Sa\candido-sa-1,2016-17,Rutgers,F,32,2,431,38,96,.396,34,77,.442,4,19,.211,21,46,.457,42,47,89,9,9,29,26,56,101,2.2
4617,Jermaine Lawrence\jermaine-lawrence-1,2014-15,Manhattan,F,21,8,276,41,99,.414,39,83,.470,2,16,.125,17,34,.500,11,25,36,2,9,16,30,34,101,1.6
4618,Justas Furmanavicius\justas-furmanavicius-1,2017-18,Mississippi,F,32,7,538,33,77,.429,18,38,.474,15,39,.385,20,28,.714,45,52,97,12,15,22,14,59,101,3.3
4619,Rudy Stradnieks\rudy-stradnieks-1,2017-18,Southern Illinois,F,31,1,321,43,87,.494,40,67,.597,3,20,.150,12,18,.667,16,36,52,13,3,2,25,51,101,1.5
4620,D'Arian Allen\darian-allen-1,2015-16,Southern,F,28,18,307,42,71,.592,41,70,.586,1,1,1.000,16,35,.457,33,42,75,4,6,9,24,67,101,2.2
4621,Shane Whitfield\shane-whitfield-1,2013-14,Lehigh,F,32,9,471,35,81,.432,34,77,.442,1,4,.250,30,54,.556,13,52,65,25,5,2,28,59,101,1.4
4622,Darren Payen\darren-payen-1,2013-14,Hofstra,F,33,0,339,37,68,.544,33,45,.733,4,23,.174,23,30,.767,22,50,72,2,7,15,17,34,101,2.5
4623,Devontae Watson\devontae-watson-1,2014-15,Temple,F,37,30,520,46,100,.460,46,100,.460,0,0,,9,19,.474,30,89,119,1,9,37,11,62,101,2.5
4624,Tanner Clayton\tanner-clayton-1,2013-14,Stephen F. Austin,F,35,0,494,43,80,.538,43,80,.538,0,0,,15,23,.652,52,66,118,15,11,46,19,65,101,3.5
4625,Nick Madray\nick-madray-1,2014-15,Binghamton,F,13,10,286,39,104,.375,25,59,.424,14,45,.311,9,10,.900,9,36,45,4,3,11,15,21,101,3.9
4626,Tonko Vuko\tonko-vuko-1,2016-17,Pacific,F,26,18,444,36,66,.545,31,52,.596,5,14,.357,24,32,.750,39,69,108,5,5,1,14,68,101,3.2
4627,DeVaughn Mallory\devaughn-mallory-1,2015-16,Delaware State,F,29,11,389,44,100,.440,43,92,.467,1,8,.125,12,19,.632,34,37,71,6,4,8,27,54,101,1.6
4628,Zane Waterman\zane-waterman-1,2014-15,Manhattan,F,28,0,232,32,87,.368,14,35,.400,18,52,.346,19,29,.655,19,23,42,4,6,7,15,59,101,1.6
4629,Brandon Mitchell\brandon-mitchell-2,2016-17,San Jose State,F,29,2,387,38,82,.463,33,68,.485,5,14,.357,20,30,.667,31,66,97,10,16,19,23,66,101,2.9
4630,Daddy Ugbede\daddy-ugbede-1,2013-14,Drake,F,27,1,275,37,70,.529,37,70,.529,0,0,,27,39,.692,18,42,60,4,5,1,21,51,101,2.0
4631,Jake Kitchell\jake-kitchell-1,2013-14,Indiana State,F,33,17,447,37,72,.514,29,60,.483,8,12,.667,19,32,.594,32,67,99,12,8,19,19,52,101,2.8
4632,Len Springs\len-springs-1,2014-15,Northern Arizona,F,38,23,621,41,88,.466,41,88,.466,0,0,,19,33,.576,86,99,185,7,8,72,37,79,101,3.5
4633,Ilija Stojiljkovic\ilija-stojiljkovic-1,2015-16,Maine,F,28,22,507,38,97,.392,22,48,.458,16,49,.327,9,19,.474,29,74,103,45,25,7,47,89,101,2.3
4634,DeShawn Freeman\deshawn-freeman-1,2015-16,Rutgers,F,8,5,216,39,72,.542,39,70,.557,0,2,.000,23,34,.676,15,24,39,9,11,8,14,19,101,10.1
4635,Tyler Rambo\tyler-rambo-1,2014-15,Murray State,F,30,0,342,34,56,.607,34,56,.607,0,0,,33,51,.647,17,28,45,16,11,3,19,25,101,2.8
4636,Stephan Bennett\stephan-bennett-1,2016-17,Texas Southern,F,26,3,375,37,68,.544,37,67,.552,0,1,.000,27,53,.509,40,56,96,9,8,17,13,47,101,3.7
4637,Connor Bennett\connor-bennett-1,2017-18,Massachusetts-Lowell,F,25,3,285,41,61,.672,41,61,.672,0,0,,19,25,.760,27,29,56,9,4,9,11,31,101,3.7
4638,Evan Nolte\evan-nolte-1,2014-15,Virginia,F,33,11,590,35,99,.354,14,23,.609,21,76,.276,10,16,.625,8,43,51,23,19,5,15,46,101,2.0
4639,Tyrell Sturdivant\tyrell-sturdivant-1,2015-16,Stony Brook,F,33,1,390,41,90,.456,40,89,.449,1,1,1.000,18,27,.667,53,66,119,19,19,9,19,60,101,3.1
4640,Junior Fortunat\junior-fortunat-1,2013-14,Rider,F,30,11,352,35,78,.449,35,78,.449,0,0,,31,64,.484,27,42,69,5,3,12,30,67,101,1.2
4641,Chris Baldwin\chris-baldwin-1,2017-18,Massachusetts,F,21,6,350,39,94,.415,23,46,.500,16,48,.333,7,11,.636,23,64,87,13,7,10,22,54,101,3.0
4642,Ryden Hines\ryden-hines-1,2014-15,Iona,F,35,13,528,37,74,.500,21,34,.618,16,40,.400,11,21,.524,34,70,104,13,7,8,10,64,101,2.6
4643,Corey Hall\corey-hall-1,2013-14,Cal State Bakersfield,F,27,1,326,35,73,.479,28,51,.549,7,22,.318,24,38,.632,26,47,73,5,13,8,25,54,101,2.4
4644,Steven Davis\steven-davis-2,2014-15,Wright State,F,14,7,287,36,80,.450,29,48,.604,7,32,.219,21,32,.656,15,31,46,10,11,3,24,45,100,3.7
4645,Gage Loy\gage-loy-1,2016-17,Texas-Rio Grande Valley,F,32,13,414,35,104,.337,26,72,.361,9,32,.281,21,32,.656,34,60,94,26,15,6,27,57,100,2.1
4646,Paul Reed\paul-reed-5,2017-18,DePaul,F,28,1,284,43,83,.518,40,69,.580,3,14,.214,11,19,.579,27,59,86,10,15,13,15,49,100,3.2
4647,Will Miller\will-miller-1,2016-17,Mount St. Mary's,F,31,3,402,32,110,.291,2,4,.500,30,106,.283,6,10,.600,3,38,41,8,7,0,11,20,100,1.3
4648,Markus Crider\markus-crider-1,2013-14,Georgia State,F,33,2,564,42,85,.494,42,85,.494,0,0,,16,27,.593,46,68,114,13,21,12,19,84,100,2.8
4649,Phillip Jones\phillip-jones-2,2015-16,Texas-San Antonio,F,20,6,314,36,84,.429,36,80,.450,0,4,.000,28,54,.519,40,47,87,10,13,7,22,44,100,3.6
4650,Tydus Verhoeven\tydus-verhoeven-1,2017-18,Duquesne,F,32,27,625,40,77,.519,40,77,.519,0,0,,20,37,.541,44,62,106,28,7,71,24,94,100,3.7
4651,Jabari McGhee\jabari-mcghee-1,2016-17,Western Kentucky,F,21,0,274,35,74,.473,35,74,.473,0,0,,30,43,.698,32,52,84,5,12,6,21,44,100,3.6
4652,Michael Obacha\michael-obacha-1,2015-16,Appalachian State,F,30,6,508,31,54,.574,31,54,.574,0,0,,38,70,.543,55,55,110,11,8,11,29,80,100,2.6
4653,Gavin Schilling\gavin-schilling-1,2017-18,Michigan State,F,34,1,329,36,51,.706,36,51,.706,0,0,,28,48,.583,40,76,116,12,8,12,22,51,100,3.1
4654,Branden Aughburns\branden-aughburns-1,2016-17,Hampton,F,25,2,300,40,78,.513,40,77,.519,0,1,.000,20,36,.556,26,32,58,3,3,16,21,43,100,2.4
4655,Nuni Omot\nuni-omot-1,2016-17,Baylor,F,25,0,281,33,83,.398,20,41,.488,13,42,.310,21,26,.808,21,27,48,8,4,6,17,37,100,2.3
4656,Nolan Gerrity\nolan-gerrity-1,2017-18,Maryland-Baltimore County,F,35,16,436,46,94,.489,46,94,.489,0,0,,8,27,.296,41,65,106,23,9,16,23,55,100,2.4
4657,Xavier Tillman\xavier-tillman-1,2017-18,Michigan State,F,35,0,305,39,60,.650,39,60,.650,0,0,,21,32,.656,35,57,92,10,9,23,16,35,99,3.2
4658,Damian Goodwin\damien-goodwin-1,2014-15,South Carolina Upstate,F,15,3,248,33,98,.337,24,60,.400,9,38,.237,24,43,.558,18,23,41,18,11,7,11,29,99,4.1
4659,Stephen Lennox\stephen-lennox-1,2016-17,Idaho State,F,31,6,462,29,65,.446,26,45,.578,3,20,.150,38,52,.731,12,56,68,15,7,11,25,56,99,2.0
4660,Chris Kading\chris-kading-1,2015-16,North Dakota State,F,31,8,455,41,76,.539,35,52,.673,6,24,.250,11,22,.500,40,50,90,4,9,19,7,53,99,3.2
4661,Philip McKenzie\philip-mckenzie-1,2017-18,Houston Baptist,F,31,5,503,40,95,.421,35,73,.479,5,22,.227,14,33,.424,50,53,103,14,9,6,25,54,99,2.2
4662,Anthony Elechi\anthony-elechi-1,2014-15,Morehead State,F,29,1,331,43,82,.524,42,78,.538,1,4,.250,12,17,.706,41,48,89,7,9,10,21,79,99,2.4
4663,Gavin Skelly\gavin-skelly-1,2015-16,Northwestern,F,30,0,381,33,54,.611,29,45,.644,4,9,.444,29,45,.644,35,57,92,16,7,14,25,58,99,3.0
4664,Ryan Rosburg\ryan-rosburg-1,2014-15,Missouri,F,30,17,501,42,84,.500,42,84,.500,0,0,,15,45,.333,37,41,78,8,6,18,19,56,99,2.2
4665,DaRohn Scott\darohn-scott-1,2016-17,Central Michigan,F,32,1,449,40,58,.690,40,58,.690,0,0,,19,33,.576,45,104,149,2,10,39,21,99,99,3.4
4666,KaVaughn Scott\kavaughn-scott-1,2017-18,Loyola (MD),F,26,5,370,32,64,.500,32,64,.500,0,0,,35,65,.538,37,62,99,7,11,14,26,64,99,2.8
4667,Maurice Taylor\maurice-taylor-4,2016-17,Niagara,F,33,4,451,36,65,.554,35,63,.556,1,2,.500,26,52,.500,56,85,141,7,11,10,34,89,99,2.3
4668,Satchel Pierce\satchel-pierce-1,2014-15,Virginia Tech,F,31,7,428,39,81,.481,39,81,.481,0,0,,21,33,.636,35,39,74,14,6,23,39,84,99,1.6
4669,Marek Nelson\marek-nelson-1,2017-18,Western Kentucky,F,38,2,351,38,71,.535,33,57,.579,5,14,.357,18,35,.514,16,44,60,8,8,9,25,43,99,1.6
4670,Yannick Atanga\yannick-atanga-1,2013-14,Santa Clara,F,33,21,553,38,84,.452,38,83,.458,0,1,.000,23,45,.511,62,104,166,5,16,30,20,94,99,3.2
4671,Troy Baxter\troy-baxter-1,2016-17,Nevada-Las Vegas,F,23,1,315,39,94,.415,32,67,.478,7,27,.259,14,26,.538,21,32,53,11,5,11,15,43,99,2.5
4672,David Taylor\david-taylor-2,2015-16,Pacific,F,27,7,427,34,105,.324,13,30,.433,21,75,.280,10,17,.588,4,32,36,24,3,1,25,38,99,1.1
4673,Nate Rohrer\nate-rohrer-1,2015-16,Vermont,F,33,8,452,40,69,.580,34,50,.680,6,19,.316,13,22,.591,22,34,56,16,12,4,7,48,99,2.7
4674,Mark Donnal\mark-donnal-1,2014-15,Michigan,F,29,9,309,35,67,.522,28,48,.583,7,19,.368,22,31,.710,26,36,62,4,4,10,9,45,99,2.7
4675,Rayshaun McGrew\rayshaun-mcgrew-1,2013-14,Stony Brook,F,29,0,270,40,73,.548,40,73,.548,0,0,,19,35,.543,21,35,56,4,7,1,14,25,99,2.4
4676,Steven Cook\steven-cook-1,2013-14,Princeton,F,22,13,368,38,76,.500,25,48,.521,13,28,.464,10,16,.625,26,28,54,14,12,12,17,35,99,3.8
4677,DaRohn Scott\darohn-scott-1,2015-16,Central Michigan,F,33,1,381,41,63,.651,41,63,.651,0,0,,17,42,.405,41,62,103,2,4,31,22,80,99,2.5
4678,Mike Best\mike-best-1,2013-14,UC-Irvine,F,34,2,359,41,91,.451,39,83,.470,2,8,.250,15,19,.789,16,66,82,7,6,18,19,40,99,2.0
4679,LeAndre Thomas\leandre-thomas-1,2017-18,Maryland-Eastern Shore,F,32,11,453,39,102,.382,39,102,.382,0,0,,21,41,.512,43,58,101,3,7,15,27,98,99,1.1
4680,T.J. Hallice\tj-hallice-1,2013-14,Mercer,F,36,0,414,41,70,.586,40,64,.625,1,6,.167,16,31,.516,39,46,85,9,11,13,18,45,99,2.6
4681,Deontae Hawkins\deontae-hawkins-1,2017-18,Boston College,F,8,8,225,39,84,.464,31,61,.508,8,23,.348,13,16,.813,21,52,73,8,2,2,18,21,99,8.4
4682,Anthony Walker\anthony-walker-3,2013-14,Texas-Arlington,F,28,7,416,43,60,.717,43,60,.717,0,0,,12,23,.522,34,61,95,6,6,22,16,70,98,3.3
4683,Steven Enoch\steven-enoch-1,2016-17,Connecticut,F,29,3,352,34,83,.410,34,82,.415,0,1,.000,30,44,.682,26,40,66,4,7,16,32,54,98,1.6
4684,Julius Van Sauers\julius-vansauers-1,2016-17,Long Island University,F,32,8,501,26,69,.377,14,35,.400,12,34,.353,34,37,.919,39,56,95,21,12,5,30,70,98,2.4
4685,Brandon McDonnell\brandon-mcdonnell-1,2015-16,Dartmouth,F,27,0,224,36,77,.468,34,69,.493,2,8,.250,24,28,.857,14,31,45,7,6,4,14,27,98,2.4
4686,Sam Timmins\sam-timmins-1,2016-17,Washington,F,31,18,450,45,92,.489,43,85,.506,2,7,.286,6,16,.375,40,79,119,9,11,19,37,50,98,2.4
4687,Nathan Adrian\nathan-adrian-1,2014-15,West Virginia,F,35,4,539,35,114,.307,24,52,.462,11,62,.177,17,26,.654,51,37,88,34,28,14,26,83,98,2.2
4688,Javan White\javan-white-1,2015-16,Oral Roberts,F,23,5,300,41,85,.482,41,84,.488,0,1,.000,16,24,.667,29,57,86,12,6,22,21,58,98,3.2
4689,Ikenna Smart\ikenna-smart-1,2017-18,Buffalo,F,27,25,330,42,62,.677,42,61,.689,0,1,.000,14,29,.483,34,60,94,3,5,11,21,67,98,2.7
4690,Octavious Green\octavious-green-1,2013-14,Lamar,F,25,1,325,35,82,.427,16,28,.571,19,54,.352,9,20,.450,22,49,71,10,7,5,18,39,98,2.6
4691,John Majors II\john-majorsii-1,2015-16,Presbyterian,F,23,3,297,40,78,.513,40,78,.513,0,0,,18,39,.462,24,49,73,4,5,1,25,42,98,2.1
4692,Cheikh Sane\cheikh-sane-1,2013-14,Marshall,F,31,20,549,37,79,.468,37,79,.468,0,0,,24,52,.462,59,97,156,10,22,27,27,79,98,3.4
4693,Emanuel Pellot\emanuel-pellot-1,2014-15,Florida A&M,F,29,14,752,40,121,.331,40,120,.333,0,1,.000,18,32,.563,27,77,104,29,6,22,40,52,98,1.6
4694,Sukhjot Bains\sukhjot-bains-1,2017-18,Green Bay,F,33,3,517,38,88,.432,31,59,.525,7,29,.241,15,33,.455,31,59,90,38,17,9,22,55,98,2.7
4695,Ty Egbert\ty-egbert-1,2016-17,Idaho,F,27,1,280,39,76,.513,39,76,.513,0,0,,20,31,.645,16,37,53,10,1,7,21,38,98,2.0
4696,Jeff Pollard\jeff-pollard-1,2017-18,Washington State,F,27,4,312,40,72,.556,40,68,.588,0,4,.000,18,27,.667,15,32,47,10,3,3,17,21,98,2.5
4697,Michael O'Donnell\michael-odonnell-1,2015-16,Southern Mississippi,F,19,6,392,34,79,.430,16,37,.432,18,42,.429,12,22,.545,20,40,60,19,7,7,21,47,98,3.4
4698,Brandon Williams\brandon-williams-7,2014-15,Texas-Arlington,F,31,3,382,39,70,.557,39,69,.565,0,1,.000,20,38,.526,29,63,92,6,11,30,14,40,98,3.3
4699,Derrien King\derrien-king-1,2015-16,Washington State,F,26,0,325,33,96,.344,17,54,.315,16,42,.381,16,23,.696,8,40,48,16,5,4,21,37,98,1.6
4700,Josh James\josh-james-1,2014-15,IUPUI,F,31,13,396,38,80,.475,38,80,.475,0,0,,22,32,.688,29,58,87,12,9,16,32,63,98,2.0
4701,Reginald Johnson\reginald-johnson-1,2017-18,Alcorn State,F,8,7,184,39,86,.453,29,59,.492,10,27,.370,10,16,.625,16,18,34,9,7,1,8,12,98,8.6
4702,Nathan Taphorn\nathan-taphorn-1,2014-15,Northwestern,F,24,0,264,37,70,.529,17,30,.567,20,40,.500,4,6,.667,9,17,26,12,5,1,12,25,98,2.8
4703,Dante Buford\dante-buford-1,2016-17,Oklahoma,F,26,4,284,32,83,.386,16,39,.410,16,44,.364,18,27,.667,15,25,40,5,7,5,15,17,98,2.3
4704,Juan Anderson\juan-anderson-1,2013-14,Marquette,F,31,19,417,37,98,.378,32,72,.444,5,26,.192,19,26,.731,37,64,101,32,31,6,31,59,98,2.9
4705,Johnny Zuppardo\johnny-zuppardo-1,2015-16,Mississippi State,F,31,1,358,38,93,.409,20,44,.455,18,49,.367,4,6,.667,16,52,68,7,14,5,13,60,98,1.9
4706,Kevarrius Hayes\kevarrius-hayes-1,2015-16,Florida,F,35,6,402,35,50,.700,35,50,.700,0,0,,28,59,.475,45,47,92,7,11,20,17,64,98,2.8
4707,Dockery Walker\dockery-walker-1,2014-15,Brown,F,25,1,274,37,77,.481,37,77,.481,0,0,,24,48,.500,23,58,81,7,7,2,28,66,98,1.7
4708,Ivan Madunic\ivan-madunic-1,2017-18,Southern Utah,F,30,5,397,32,76,.421,13,27,.481,19,49,.388,14,24,.583,33,73,106,10,11,29,24,52,97,3.0
4709,Saadiq Muhammad\saadiq-muhammad-1,2013-14,Savannah State,F,32,14,504,35,70,.500,35,69,.507,0,1,.000,27,54,.500,30,62,92,2,12,17,23,73,97,2.0
4710,Nick Marshall\nick-marshall-1,2015-16,Memphis,F,31,1,274,43,79,.544,43,79,.544,0,0,,11,20,.550,35,49,84,7,7,13,13,36,97,2.8
4711,Stavian Allen\stavian-allen-1,2017-18,Norfolk State,F,28,2,291,38,89,.427,33,64,.516,5,25,.200,16,24,.667,28,48,76,9,13,12,19,42,97,2.6
4712,Deng Geu\deng-geu-1,2016-17,North Dakota State,F,30,2,277,37,82,.451,33,63,.524,4,19,.211,19,37,.514,22,35,57,7,3,14,22,42,97,1.7
4713,D.J. MacLeay\dj-macleay-1,2016-17,Bucknell,F,33,1,288,39,80,.488,36,67,.537,3,13,.231,16,29,.552,32,68,100,10,14,4,31,49,97,2.0
4714,Abednego Lufile\abednego-lufile-1,2015-16,East Tennessee State,F,29,8,315,37,80,.463,37,74,.500,0,6,.000,23,34,.676,25,62,87,9,7,6,19,20,97,2.7
4715,Devontae Cacok\devontae-cacok-1,2015-16,North Carolina-Wilmington,F,29,4,264,43,66,.652,43,66,.652,0,0,,11,27,.407,31,52,83,2,11,7,14,58,97,2.7
4716,Jaelyn Johnson-Coston\jaelyn-johnson-coston-1,2014-15,Weber State,F,30,0,304,36,71,.507,36,70,.514,0,1,.000,25,40,.625,20,36,56,8,12,6,27,40,97,2.0
4717,Damontez Oliver\damontez-oliver-1,2016-17,Campbell,F,35,11,546,34,96,.354,12,29,.414,22,67,.328,7,11,.636,12,51,63,27,10,6,36,56,97,1.1
4718,Gabe Taylor\gabe-taylor-1,2014-15,Portland,F,29,1,312,43,76,.566,43,76,.566,0,0,,11,16,.688,16,38,54,7,5,10,14,33,97,2.5
4719,Tucker Thompson\tucker-thompson-1,2014-15,Western Carolina,F,32,15,471,36,77,.468,36,76,.474,0,1,.000,25,38,.658,38,53,91,17,14,13,20,47,97,2.8
4720,Nura Zanna\nura-zanna-1,2017-18,Houston,F,35,3,515,37,67,.552,37,67,.552,0,0,,23,47,.489,59,77,136,6,11,3,30,102,97,1.9
4721,Zach Jacobs\zach-jacobs-1,2017-18,James Madison,F,32,2,409,38,92,.413,30,61,.492,8,31,.258,13,18,.722,40,59,99,9,5,9,13,56,97,2.3
4722,Griffin Kinney\griffin-kinney-1,2014-15,Appalachian State,F,28,0,421,38,95,.400,38,94,.404,0,1,.000,21,35,.600,22,53,75,12,4,3,42,71,97,0.6
4723,Edward Alade\edward-alade-1,2015-16,Navy,F,33,0,393,46,75,.613,46,75,.613,0,0,,5,19,.263,39,45,84,15,7,11,21,50,97,2.5
4724,Trhae Mitchell\trhae-mitchell-1,2016-17,South Alabama,F,28,11,405,38,61,.623,31,50,.620,7,11,.636,14,27,.519,22,52,74,28,10,22,18,38,97,3.8
4725,Austin Meyer\austin-meyer-1,2017-18,Rice,F,22,6,259,40,54,.741,40,54,.741,0,0,,17,32,.531,16,33,49,3,3,13,27,50,97,2.6
4726,Jeylani Dublin\jeyani-dubin-1,2014-15,Iona,F,33,3,234,43,63,.683,43,63,.683,0,0,,11,24,.458,14,31,45,2,10,9,9,31,97,2.4
4727,Tim Harrison\tim-harrison-1,2017-18,Rice,F,31,2,329,37,96,.385,24,45,.533,13,51,.255,10,19,.526,18,47,65,5,5,6,26,42,97,1.2
4728,Andre Wesson\andre-wesson-1,2017-18,Ohio State,F,34,5,629,33,87,.379,17,31,.548,16,56,.286,15,20,.750,21,41,62,37,11,5,37,79,97,1.4
4729,Jimmie Taylor\jimmie-taylor-1,2013-14,Alabama,F,32,18,542,38,62,.613,38,62,.613,0,0,,21,52,.404,40,65,105,5,5,40,15,73,97,3.0
4730,Mike Miklusak\mike-miklusak-1,2014-15,Western Illinois,F,15,11,316,33,94,.351,19,44,.432,14,50,.280,17,21,.810,12,48,60,14,7,3,15,34,97,3.7
4731,Collin Hartman\collin-hartman-1,2017-18,Indiana,F,23,0,354,35,95,.368,19,29,.655,16,66,.242,11,16,.688,19,43,62,23,9,4,11,44,97,3.0
4732,Angus Riley\angus-riley-1,2015-16,Bryant,F,27,6,299,33,91,.363,17,38,.447,16,53,.302,14,17,.824,14,30,44,10,5,4,14,45,96,1.7
4733,Mamadou Doucoure\mamadou-doucoure-1,2017-18,Rutgers,F,34,29,444,38,105,.362,38,105,.362,0,0,,20,33,.606,43,66,109,4,10,10,24,81,96,1.3
4734,Diago Quinn\diago-quinn-1,2015-16,Monmouth,F,36,2,346,33,61,.541,33,61,.541,0,0,,30,36,.833,32,51,83,6,7,9,14,94,96,1.9
4735,Jacorey Williams\jacorey-williams-1,2013-14,Arkansas,F,30,0,277,41,103,.398,40,100,.400,1,3,.333,13,19,.684,18,45,63,16,10,6,24,39,96,1.7
4736,William Pfister\william-pfister-1,2017-18,Florida Atlantic,F,31,31,794,41,82,.500,41,82,.500,0,0,,14,21,.667,76,140,216,31,22,12,38,106,96,3.8
4737,Ronnie Gombe\ronnie-gombe-1,2017-18,Robert Morris,F,27,13,362,44,90,.489,44,90,.489,0,0,,8,25,.320,45,53,98,0,17,22,27,57,96,2.7
4738,Ryan Kriener\ryan-kriener-1,2017-18,Iowa,F,27,0,280,43,78,.551,41,68,.603,2,10,.200,8,21,.381,19,33,52,26,13,7,20,48,96,2.7
4739,Keynan Pittman\keynan-pittman-1,2014-15,Alcorn State,F,30,24,433,42,75,.560,42,75,.560,0,0,,12,33,.364,27,48,75,3,9,12,20,75,96,1.8
4740,Brooks DeBisschop\brooks-debisschop-1,2016-17,Northern Arizona,F,28,1,374,33,75,.440,28,59,.475,5,16,.313,25,43,.581,33,43,76,21,8,13,22,49,96,2.7
4741,Thomas Jacobs\thomas-jacobs-1,2013-14,San Diego,F,35,0,466,33,73,.452,32,72,.444,1,1,1.000,29,44,.659,41,67,108,11,17,9,15,65,96,2.6
4742,DaJuan Coleman\dajuan-coleman-1,2016-17,Syracuse,F,17,13,265,38,70,.543,38,69,.551,0,1,.000,20,35,.571,31,50,81,3,7,9,23,37,96,4.1
4743,Andrew Osemhen\andrew-osemhen-1,2013-14,Kennesaw State,F,30,12,526,32,83,.386,32,83,.386,0,0,,32,53,.604,32,48,80,7,5,9,31,77,96,1.1
4744,Strahinja Gavrilovic\strahinja-gavrilovic-1,2013-14,Southern California,F,30,5,360,38,88,.432,34,71,.479,4,17,.235,16,33,.485,23,33,56,2,3,1,16,40,96,1.4
4745,Jarelle Reischel\jarelle-reischel-1,2014-15,Rhode Island,F,32,0,290,37,78,.474,31,55,.564,6,23,.261,16,33,.485,25,36,61,12,9,2,22,44,96,1.8
4746,Kaiser Gates\kaiser-gates-1,2015-16,Xavier,F,30,0,311,29,67,.433,16,28,.571,13,39,.333,25,44,.568,23,55,78,5,11,7,13,51,96,2.4
4747,Ruben Arroyo-Felix\ruben-arroyo-felix-1,2015-16,Presbyterian,F,31,1,284,36,96,.375,20,39,.513,16,57,.281,8,14,.571,4,24,28,9,2,0,16,15,96,1.2
4748,Luke Petrasek\luke-petrasek-1,2014-15,Columbia,F,19,5,322,35,87,.402,20,41,.488,15,46,.326,11,20,.550,16,40,56,18,2,12,17,40,96,3.1
4749,Michael Gilmore\michael-gilmore-1,2015-16,Virginia Commonwealth,F,30,18,346,37,78,.474,24,45,.533,13,33,.394,9,17,.529,20,64,84,12,12,7,21,52,96,2.3
4750,Chaise Daniels\chaise-daniels-1,2014-15,Quinnipiac,F,30,16,431,42,89,.472,42,89,.472,0,0,,12,20,.600,31,49,80,7,7,29,28,74,96,1.9
4751,Ethan Lee\ethan-lee-1,2016-17,Central Arkansas,F,30,18,416,35,85,.412,35,84,.417,0,1,.000,26,53,.491,28,56,84,18,11,6,30,47,96,1.8
4752,LaBarrius Hill\labarrius-hill-1,2016-17,McNeese State,F,29,14,487,35,68,.515,35,68,.515,0,0,,26,40,.650,26,62,88,10,5,26,30,79,96,2.1
4753,Scott King\scott-king-1,2013-14,Stony Brook,F,30,1,300,34,75,.453,14,24,.583,20,51,.392,8,11,.727,10,29,39,8,5,4,18,48,96,1.6
4754,Scottie James\scottie-james-1,2015-16,Bradley,F,30,3,298,31,79,.392,22,44,.500,9,35,.257,25,36,.694,31,48,79,7,3,11,17,41,96,2.2
4755,Christian Beyer\christian-beyer-1,2014-15,Virginia Tech,F,25,7,348,41,64,.641,39,62,.629,2,2,1.000,12,19,.632,25,56,81,10,9,3,14,32,96,3.6
4756,Jon Doss\jon-doss-1,2015-16,St. Francis (NY),F,24,1,344,34,97,.351,11,21,.524,23,76,.303,5,11,.455,12,37,49,13,7,2,11,31,96,2.2
4757,Kale Abrahamson\kale-abrahamson-1,2016-17,Duquesne,F,23,0,260,31,83,.373,15,28,.536,16,55,.291,17,33,.515,11,22,33,10,2,1,16,27,95,1.7
4758,Roland Griffin\roland-griffin-1,2015-16,Illinois State,F,16,4,351,37,79,.468,26,51,.510,11,28,.393,10,21,.476,9,34,43,17,8,5,19,26,95,3.8
4759,Adrion Webber\adrion-webber-1,2013-14,Oral Roberts,F,32,1,328,27,87,.310,10,27,.370,17,60,.283,24,27,.889,11,28,39,6,9,1,12,28,95,1.6
4760,Tyler Gaskins\tyler-gaskins-1,2013-14,Saint Peter's,F,28,0,387,38,108,.352,28,64,.438,10,44,.227,9,15,.600,8,36,44,19,15,3,25,33,95,1.5
4761,Hank Hollingsworth\hank-hollingsworth-1,2017-18,Cal Poly,F,31,22,591,41,65,.631,41,65,.631,0,0,,13,37,.351,37,67,104,7,7,52,28,67,95,3.1
4762,Matt Killian\matt-killian-1,2015-16,Northwestern State,F,28,11,468,33,88,.375,22,55,.400,11,33,.333,18,27,.667,20,41,61,10,18,7,23,33,95,2.3
4763,Eli Harrison\eli-harrison-1,2013-14,Dartmouth,F,23,0,155,32,77,.416,6,16,.375,26,61,.426,5,9,.556,8,10,18,1,4,0,7,19,95,2.2
4764,Myles Cherry\myles-cherry-1,2016-17,Lafayette,F,30,3,444,38,73,.521,38,72,.528,0,1,.000,19,36,.528,28,73,101,16,15,14,23,46,95,2.9
4765,Patrick Szpir\patrick-szpir-1,2016-17,Chicago State,F,28,14,498,35,83,.422,35,82,.427,0,1,.000,25,37,.676,30,75,105,17,8,10,31,64,95,2.1
4766,Jibreel Faulkner\jibreel-faulkner-1,2017-18,Canisius,F,17,1,248,37,80,.463,27,49,.551,10,31,.323,11,21,.524,13,24,37,14,8,2,12,14,95,4.0
4767,Xavier Hill-Mais\xavier-hill-mais-1,2015-16,Oakland,F,32,0,290,31,57,.544,31,56,.554,0,1,.000,33,47,.702,19,47,66,4,9,9,17,57,95,2.1
4768,Javier Lacunza\javier-lacunza-1,2014-15,Florida Atlantic,F,28,0,358,32,81,.395,20,32,.625,12,49,.245,19,26,.731,15,35,50,3,5,1,15,42,95,1.6
4769,Devin Berry\devin-berry-1,2015-16,Arkansas-Pine Bluff,F,28,11,365,34,79,.430,34,79,.430,0,0,,27,53,.509,44,44,88,13,9,11,37,74,95,1.6
4770,T.J. Bell\tj-bell-1,2014-15,Indiana State,F,31,5,388,34,68,.500,34,68,.500,0,0,,27,42,.643,26,54,80,10,7,15,29,74,95,1.8
4771,Tavario Miller\tavario-miller-1,2016-17,Texas A&M,F,31,3,324,38,80,.475,38,79,.481,0,1,.000,19,39,.487,31,53,84,6,4,4,19,44,95,1.9
4772,Gordon Ball\gordon-ball-1,2013-14,Texas State,F,27,1,283,41,67,.612,41,66,.621,0,1,.000,13,19,.684,20,59,79,17,8,3,18,43,95,3.0
4773,Willie Carmichael\willie-carmichael-1,2014-15,Tennessee,F,32,19,475,40,77,.519,40,77,.519,0,0,,15,24,.625,44,31,75,11,6,13,29,101,95,1.5
4774,Clarence Williams\clarence-williams-1,2015-16,East Carolina,F,31,14,401,42,94,.447,38,79,.481,4,15,.267,7,10,.700,23,62,85,13,13,10,34,48,95,1.8
4775,John Grant Jr.\john-grantjr-1,2017-18,Savannah State,F,26,1,185,33,87,.379,9,23,.391,24,64,.375,4,11,.364,6,26,32,4,4,2,14,20,94,1.6
4776,Mohamed Bendary\mohamed-bendary-1,2015-16,NJIT,F,34,1,408,42,64,.656,42,64,.656,0,0,,10,19,.526,42,65,107,20,6,18,26,85,94,2.5
4777,Isaiah Roby\isaiah-roby-1,2016-17,Nebraska,F,30,4,457,37,94,.394,33,74,.446,4,20,.200,16,21,.762,36,52,88,22,16,25,36,58,94,2.4
4778,Nenad Tomic\nenad-tomic-1,2013-14,Cornell,F,27,0,223,37,71,.521,37,70,.529,0,1,.000,20,24,.833,18,32,50,3,2,5,12,34,94,2.3
4779,Javon Bess\javon-bess-1,2015-16,Michigan State,F,32,13,351,31,72,.431,30,63,.476,1,9,.111,31,54,.574,23,51,74,22,9,7,13,39,94,2.5
4780,Will Ransom\will-ransom-1,2016-17,North Carolina Central,F,32,17,542,43,74,.581,43,74,.581,0,0,,8,20,.400,60,78,138,3,14,30,27,75,94,3.1
4781,Garrett Jackson\garrett-jackson-1,2013-14,Saint Mary's (CA),F,24,1,291,35,93,.376,30,75,.400,5,18,.278,19,27,.704,39,47,86,12,10,8,19,53,94,2.7
4782,Phil Cofer\phil-cofer-1,2016-17,Florida State,F,32,2,399,38,84,.452,32,68,.471,6,16,.375,12,20,.600,21,41,62,7,4,3,25,32,94,1.5
4783,Johncarlos Reyes\johncarlos-reyes-1,2017-18,Boston College,F,34,2,355,42,79,.532,42,79,.532,0,0,,10,21,.476,29,48,77,6,3,11,24,63,94,1.5
4784,Alan Herndon\alan-herndon-1,2014-15,Wyoming,F,31,2,477,37,78,.474,33,55,.600,4,23,.174,16,27,.593,15,54,69,16,7,12,18,29,94,2.4
4785,Tracy Burnett\tracy-burnett-1,2017-18,Alabama A&M,F,25,5,304,43,102,.422,43,101,.426,0,1,.000,8,15,.533,21,31,52,7,1,5,19,20,94,1.7
4786,Nick Blair\nick-blair-1,2015-16,Idaho,F,28,1,275,41,85,.482,35,65,.538,6,20,.300,6,16,.375,20,43,63,13,6,6,17,28,94,2.3
4787,Frank Rogers\frank-rogers-1,2014-15,San Jose State,F,9,6,217,36,84,.429,27,59,.458,9,25,.360,13,24,.542,17,38,55,10,5,6,20,33,94,5.7
4788,De'Vondre Perry\devondre-perry-1,2017-18,Temple,F,31,1,367,34,87,.391,20,37,.541,14,50,.280,12,19,.632,14,42,56,13,13,12,16,69,94,1.7
4789,Jeremy Verhagen\jeremy-verhagen-1,2014-15,Northern Colorado,F,30,16,417,41,69,.594,41,64,.641,0,5,.000,12,23,.522,34,27,61,10,7,9,23,61,94,2.1
4790,Emmanuel Olojakpoke\emmanuel-olojakpoke-1,2017-18,Akron,F,15,14,296,40,65,.615,40,64,.625,0,1,.000,14,29,.483,28,33,61,6,7,25,11,49,94,5.7
4791,Nathan Ekwu\nathan-ekwu-1,2014-15,Davidson,F,31,12,364,38,85,.447,35,77,.455,3,8,.375,15,37,.405,28,68,96,11,13,16,28,78,94,1.7
4792,Joel James\joel-james-1,2014-15,North Carolina,F,38,3,382,41,91,.451,41,91,.451,0,0,,12,18,.667,25,47,72,6,4,9,20,52,94,1.3
4793,Jordyn Martin\jordyn-martin-1,2013-14,Northern Arizona,F,32,21,622,43,66,.652,43,66,.652,0,0,,8,20,.400,57,80,137,30,10,7,26,74,94,3.3
4794,Chris Miller\chris-miller-3,2016-17,Oral Roberts,F,28,3,291,41,88,.466,41,88,.466,0,0,,12,17,.706,25,44,69,6,1,9,35,71,94,0.9
4795,Michael Humphrey\michael-humphrey-1,2014-15,Stanford,F,30,6,338,41,74,.554,41,72,.569,0,2,.000,11,22,.500,35,46,81,13,11,23,15,76,93,2.7
4796,Eric McKnight\eric-mcknight-1,2014-15,Cal State Long Beach,F,32,17,463,41,69,.594,41,69,.594,0,0,,11,28,.393,26,55,81,10,9,20,23,61,93,2.2
4797,Austin Weiher\austin-weiher-1,2015-16,Southern Illinois,F,31,0,333,40,78,.513,34,59,.576,6,19,.316,7,13,.538,13,31,44,8,10,0,17,37,93,1.7
4798,Shawn O'Connell\shawn-oconnell-1,2015-16,Georgia Southern,F,31,5,440,30,55,.545,30,54,.556,0,1,.000,33,51,.647,46,56,102,12,11,14,13,97,93,2.8
4799,Galin Smith\galin-smith-1,2017-18,Alabama,F,33,3,398,42,67,.627,42,67,.627,0,0,,9,32,.281,29,38,67,3,2,24,23,54,93,1.9
4800,Raheem Johnson\raheem-johnson-1,2014-15,Buffalo,F,33,0,388,36,67,.537,36,67,.537,0,0,,21,34,.618,35,47,82,3,11,37,24,78,93,2.4
4801,Aleksej Rostov\aleksejs-rostov-1,2013-14,Western Kentucky,F,20,9,346,30,82,.366,23,56,.411,7,26,.269,26,38,.684,24,42,66,7,4,7,27,60,93,1.8
4802,Demontrez Austin\demontrez-austin-1,2016-17,Jacksonville,F,32,4,519,35,65,.538,35,65,.538,0,0,,23,27,.852,40,96,136,8,7,7,18,57,93,2.9
4803,Samuli Nieminen\samuli-nieminen-1,2017-18,Stephen F. Austin,F,35,2,448,31,60,.517,22,41,.537,9,19,.474,22,28,.786,21,32,53,8,9,5,39,76,93,1.0
4804,Roydell Brown\roydell-brown-1,2016-17,Louisiana,F,32,10,319,39,72,.542,36,59,.610,3,13,.231,12,27,.444,21,28,49,10,9,9,22,37,93,1.9
4805,Derek Sloan\derek-sloan-1,2016-17,Cleveland State,F,31,23,373,36,64,.563,36,61,.590,0,3,.000,21,38,.553,33,44,77,9,20,19,18,87,93,2.5
4806,Cliff Cornish\cliff-cornish-1,2014-15,Morgan State,F,30,3,403,34,91,.374,34,90,.378,0,1,.000,25,40,.625,37,51,88,11,7,11,22,64,93,1.8
4807,Jordan Hunter\jordan-hunter-2,2017-18,Saint Mary's (CA),F,32,0,231,40,68,.588,40,68,.588,0,0,,13,23,.565,28,45,73,8,4,17,18,41,93,2.4
4808,Jack Williams\jack-williams-1,2014-15,Cal State Long Beach,F,32,5,415,30,93,.323,17,56,.304,13,37,.351,20,28,.714,35,43,78,14,8,4,25,44,93,1.6
4809,Donta Hall\donta-hall-1,2015-16,Alabama,F,33,0,421,37,61,.607,37,61,.607,0,0,,19,44,.432,46,96,142,7,15,55,16,83,93,3.8
4810,Cory Kilby\cory-kilby-1,2016-17,Mercer,F,27,0,349,31,72,.431,20,41,.488,11,31,.355,20,27,.741,22,46,68,14,6,4,23,25,93,2.5
4811,Brion Sanchious\brion-sanchious-1,2017-18,Murray State,F,32,15,553,43,70,.614,43,70,.614,0,0,,7,25,.280,33,56,89,9,19,12,23,65,93,2.5
4812,Kevin Morris\kevin-morris-2,2017-18,South Alabama,F,27,6,274,44,78,.564,44,78,.564,0,0,,5,15,.333,31,39,70,4,10,7,18,58,93,2.3
4813,Nate Austin\nate-austin-1,2015-16,Brigham Young,F,37,12,568,38,66,.576,38,65,.585,0,1,.000,17,32,.531,54,107,161,20,14,18,18,97,93,3.0
4814,Brison Gresham\brison-gresham-1,2016-17,Massachusetts,F,28,13,337,43,69,.623,43,69,.623,0,0,,7,26,.269,31,58,89,9,4,28,15,58,93,3.0
4815,Javier Martinez\javier-martinez-1,2013-14,Tennessee-Martin,F,26,13,306,38,61,.623,38,61,.623,0,0,,17,25,.680,34,36,70,4,5,7,10,41,93,3.2
4816,Dan Kimasa\dan-kimasa-1,2016-17,Texas-Rio Grande Valley,F,28,16,368,39,87,.448,37,76,.487,2,11,.182,13,22,.591,29,62,91,17,3,12,24,74,93,1.9
4817,Taylor Abt\taylor-abt-1,2014-15,Holy Cross,F,30,14,460,40,70,.571,40,66,.606,0,4,.000,13,33,.394,46,40,86,4,9,23,11,78,93,2.7
4818,Tyler Hagedorn\tyler-hagedorn-1,2015-16,South Dakota,F,31,1,368,30,97,.309,13,37,.351,17,60,.283,16,23,.696,12,52,64,29,10,11,23,61,93,1.6
4819,ShunQuez Stephens\shunquez-stephens-1,2013-14,South Carolina Upstate,F,32,0,431,33,83,.398,26,48,.542,7,35,.200,19,32,.594,31,78,109,15,15,7,19,57,92,2.4
4820,Nick Shepherd\nick-shepherd-1,2014-15,Texas Southern,F,34,28,558,31,62,.500,31,62,.500,0,0,,30,54,.556,43,41,84,7,8,56,14,86,92,2.9
4821,Chris Shields\chris-shields-1,2015-16,Longwood,F,14,0,294,37,78,.474,27,49,.551,10,29,.345,8,10,.800,10,27,37,19,5,2,15,39,92,4.0
4822,Darien Williams\darien-williams-1,2016-17,St. John's (NY),F,24,0,285,34,63,.540,34,62,.548,0,1,.000,24,33,.727,19,43,62,4,10,11,15,52,92,2.9
4823,Seth Berger\seth-berger-1,2017-18,Oregon State,F,31,20,408,38,80,.475,35,65,.538,3,15,.200,13,24,.542,32,40,72,29,18,2,22,58,92,2.4
4824,Tyrell Sturdivant\tyrell-sturdivant-1,2014-15,Stony Brook,F,33,0,376,35,86,.407,35,86,.407,0,0,,22,44,.500,46,64,110,10,13,11,19,40,92,2.5
4825,Trent Whiting\trent-whiting-2,2013-14,Arkansas-Pine Bluff,F,31,7,400,31,71,.437,22,51,.431,9,20,.450,21,40,.525,17,42,59,9,13,12,16,30,92,2.3
4826,Isaac Mbuyamba\isaac-mbuyamba-1,2017-18,Kennesaw State,F,30,16,524,35,73,.479,35,72,.486,0,1,.000,22,64,.344,62,69,131,8,7,26,19,58,92,3.0
4827,Mack Mercer\mack-mercer-1,2014-15,Belmont,F,28,0,186,34,68,.500,33,57,.579,1,11,.091,23,31,.742,14,25,39,13,1,12,16,38,92,2.1
4828,LeAntwan Luckett\leantwan-luckett-1,2015-16,Louisiana Tech,F,29,5,312,33,102,.324,27,63,.429,6,39,.154,20,36,.556,15,19,34,13,9,3,17,49,92,0.9
4829,Khary Doby\khary-doby-1,2015-16,North Carolina A&T,F,27,4,282,39,92,.424,31,63,.492,8,29,.276,6,12,.500,11,33,44,5,2,3,12,44,92,1.3
4830,Jonathan Laurent\jonathan-laurent-1,2016-17,Rutgers,F,31,11,413,34,80,.425,30,65,.462,4,15,.267,20,28,.714,18,57,75,12,15,5,32,41,92,1.8
4831,Josh Davenport\josh-davenport-1,2014-15,Winthrop,F,32,3,437,33,98,.337,31,84,.369,2,14,.143,24,37,.649,20,42,62,34,27,4,30,39,92,2.1
4832,Basil Smotherman\basil-smotherman-1,2014-15,Purdue,F,34,3,438,39,83,.470,35,62,.565,4,21,.190,10,17,.588,20,41,61,31,17,6,17,46,92,2.4
4833,Zach Haney\zach-haney-1,2015-16,Boise State,F,30,1,268,39,81,.481,34,67,.507,5,14,.357,9,18,.500,26,35,61,2,8,7,14,39,92,2.0
4834,Jesse Hunt\jesse-hunt-1,2016-17,Eastern Washington,F,33,5,351,33,86,.384,23,43,.535,10,43,.233,16,25,.640,22,46,68,12,3,12,15,68,92,1.5
4835,Keaton Miles\keaton-miles-1,2015-16,Arkansas,F,32,24,480,35,103,.340,34,99,.343,1,4,.250,21,48,.438,35,56,91,29,20,23,34,82,92,1.7
4836,Andrew Hampton\andrew-hampton-1,2014-15,Morgan State,F,14,0,202,33,76,.434,10,23,.435,23,53,.434,3,5,.600,4,17,21,5,6,1,2,19,92,4.3
4837,Sam Jones\sam-jones-1,2016-17,Pennsylvania,F,24,2,242,27,71,.380,3,6,.500,24,65,.369,14,17,.824,3,16,19,10,1,1,6,14,92,2.3
4838,Drew Urquhart\drew-urguhart-1,2014-15,Vermont,F,30,0,244,34,81,.420,33,73,.452,1,8,.125,23,32,.719,16,38,54,8,2,4,20,43,92,1.4
4839,Horace Spencer\horace-spencer-1,2016-17,Auburn,F,19,12,309,37,66,.561,37,65,.569,0,1,.000,18,36,.500,23,42,65,10,14,28,18,58,92,4.3
4840,J.D. Slajchert\jd-slajchert-1,2016-17,UC-Santa Barbara,F,22,3,339,38,93,.409,38,93,.409,0,0,,16,22,.727,35,52,87,8,3,0,19,29,92,2.6
4841,Willie Atwood\willie-atwood-1,2014-15,Arizona State,F,31,11,359,25,73,.342,14,42,.333,11,31,.355,31,50,.620,20,34,54,11,5,2,16,51,92,1.5
4842,Quaran Jones\quaran-jones-1,2016-17,Eastern Michigan,F,24,5,180,31,48,.646,31,48,.646,0,0,,29,41,.707,16,18,34,7,13,6,8,27,91,3.5
4843,Chane Behanan\chane-behanan-1,2013-14,Louisville,F,12,0,223,35,55,.636,35,55,.636,0,0,,21,47,.447,36,39,75,12,11,3,16,22,91,7.5
4844,Moses Wright\moses-wright-1,2017-18,Georgia Tech,F,25,10,413,35,114,.307,33,83,.398,2,31,.065,19,35,.543,25,60,85,17,16,13,29,42,91,1.8
4845,Giacomo Zilli\giacomo-zilli-1,2016-17,North Carolina-Asheville,F,23,13,216,33,69,.478,33,69,.478,0,0,,25,35,.714,16,25,41,11,7,14,18,34,91,2.8
4846,Ja'Dante' Frye\jadante-frye-1,2013-14,Nicholls State,F,29,0,422,36,74,.486,32,59,.542,4,15,.267,15,23,.652,31,52,83,12,11,6,17,49,91,2.6
4847,Mason Riggins\mason-riggins-1,2016-17,Cal State Long Beach,F,34,4,420,36,66,.545,36,66,.545,0,0,,19,41,.463,41,42,83,10,7,16,19,61,91,2.2
4848,LaTre'e Russell\latree-russell-1,2014-15,Norfolk State,F,30,12,480,33,80,.413,33,78,.423,0,2,.000,25,33,.758,24,41,65,20,10,12,42,83,91,1.0
4849,John Hall\john-hall-2,2017-18,Evansville,F,32,7,439,37,104,.356,36,98,.367,1,6,.167,16,22,.727,24,62,86,14,7,7,20,58,91,1.4
4850,Lowell Ulmer\lowell-ullmer-1,2013-14,St. Francis (NY),F,26,3,364,34,81,.420,31,62,.500,3,19,.158,20,39,.513,22,42,64,14,15,9,21,55,91,2.2
4851,Craig LeCesne\craig-lecesne-1,2016-17,Pepperdine,F,26,1,318,36,79,.456,33,71,.465,3,8,.375,16,22,.727,24,46,70,20,5,3,24,41,91,2.3
4852,Elijah Ray\elijah-ray-1,2013-14,IUPUI,F,18,4,259,31,69,.449,24,45,.533,7,24,.292,22,27,.815,15,32,47,6,2,0,18,19,91,3.0
4853,Ian Theisen\ian-theisen-1,2014-15,South Dakota State,F,35,0,300,29,55,.527,25,47,.532,4,8,.500,29,41,.707,21,44,65,8,7,9,18,76,91,1.6
4854,Anthony Allen\anthony-allen-1,2015-16,Oklahoma State,F,31,12,345,33,66,.500,33,66,.500,0,0,,25,43,.581,26,48,74,14,1,35,34,54,91,2.0
4855,Joey van Zegeren\joey-van-zegeren-1,2015-16,Northwestern,F,25,9,286,34,55,.618,34,55,.618,0,0,,23,51,.451,35,39,74,4,7,20,23,59,91,2.7
4856,Greg Kelley\greg-kelley-1,2013-14,Yale,F,30,0,251,32,84,.381,12,19,.632,20,65,.308,7,10,.700,11,28,39,6,2,2,7,36,91,1.5
4857,Isaiah Maurice\isaiah-maurice-1,2016-17,Kansas State,F,30,0,265,41,70,.586,41,67,.612,0,3,.000,9,24,.375,18,41,59,6,1,17,23,58,91,1.6
4858,Joseph Lewis\joseph-lewis-1,2016-17,Delaware State,F,29,2,381,37,117,.316,34,99,.343,3,18,.167,14,21,.667,21,65,86,23,11,16,41,56,91,1.0
4859,DeLovell Earls\delovell-earls-1,2013-14,Air Force,F,20,7,391,31,83,.373,27,57,.474,4,26,.154,25,43,.581,17,47,64,34,13,4,32,54,91,2.5
4860,Waylan Siverand\waylan-siverand-1,2013-14,North Carolina A&T,F,29,5,384,31,61,.508,31,61,.508,0,0,,28,50,.560,28,33,61,5,8,16,25,68,90,1.8
4861,Trevone Williams\trevone-williams-1,2013-14,Cal State Northridge,F,34,0,334,36,80,.450,31,62,.500,5,18,.278,13,17,.765,11,31,42,11,10,1,14,29,90,1.7
4862,Gavin Schilling\gavin-schilling-1,2015-16,Michigan State,F,24,4,301,33,66,.500,33,66,.500,0,0,,24,39,.615,25,50,75,15,8,8,21,43,90,2.9
4863,Joshua Patton\joshua-patton-1,2016-17,Sacramento State,F,31,1,295,34,62,.548,34,62,.548,0,0,,22,36,.611,19,38,57,1,6,33,18,66,90,2.1
4864,Reggie Theus\reggie-theus-2,2016-17,Cal State Northridge,F,30,2,370,33,82,.402,31,72,.431,2,10,.200,22,38,.579,12,22,34,15,8,3,19,34,90,1.4
4865,Evan Wiley\evan-wiley-2,2016-17,Alabama A&M,F,27,22,354,37,78,.474,31,61,.508,6,17,.353,10,12,.833,19,31,50,7,6,4,16,35,90,2.1
4866,Brandon Jackson\brandon-jackson-3,2016-17,Southern Illinois-Edwardsville,F,30,0,376,37,85,.435,37,83,.446,0,2,.000,16,24,.667,30,46,76,2,9,9,35,70,90,1.0
4867,Xeyrius Williams\xeryius-williams-1,2017-18,Dayton,F,18,4,334,33,95,.347,16,33,.485,17,62,.274,7,8,.875,10,45,55,26,8,10,17,23,90,3.5
4868,Kenny Paul Geno\kenny-paul-geno-1,2015-16,Georgia,F,34,10,657,34,93,.366,20,44,.455,14,49,.286,8,14,.571,26,70,96,48,18,14,21,61,90,2.7
4869,Daniel Meyer\daniel-meyer-2,2016-17,Omaha,F,32,12,408,35,76,.461,35,75,.467,0,1,.000,20,45,.444,43,55,98,5,4,14,16,58,90,2.0
4870,Jett Raines\jett-raines-1,2013-14,Pepperdine,F,23,8,270,36,63,.571,36,62,.581,0,1,.000,18,30,.600,28,23,51,1,3,3,11,36,90,2.7
4871,Chris Reyes\chris-reyes-1,2015-16,Utah,F,35,0,294,30,57,.526,30,53,.566,0,4,.000,30,43,.698,26,53,79,8,7,7,19,29,90,2.2
4872,Lyonell Gaines\lyonell-gaines-1,2014-15,Morehead State,F,15,7,313,40,72,.556,39,65,.600,1,7,.143,9,19,.474,28,35,63,12,2,3,6,22,90,5.3
4873,Junior Fortunat\junior-fortunat-1,2014-15,Rider,F,30,3,297,35,58,.603,35,58,.603,0,0,,20,53,.377,23,24,47,3,4,16,20,49,90,1.7
4874,Marcus Holt\marcus-holt-1,2013-14,Colorado State,F,30,1,368,33,56,.589,33,56,.589,0,0,,24,51,.471,38,44,82,0,5,21,12,60,90,2.6
4875,Zach Brown\zach-brown-2,2014-15,Wichita State,F,27,0,284,29,56,.518,18,30,.600,11,26,.423,21,29,.724,18,19,37,7,9,10,12,29,90,2.8
4876,Greg McClinton\greg-mcclinton-1,2015-16,Wake Forest,F,28,11,301,37,68,.544,37,67,.552,0,1,.000,16,28,.571,25,41,66,7,6,4,17,37,90,2.3
4877,Trey Thompson\trey-thompson-1,2015-16,Arkansas,F,29,1,503,37,61,.607,37,61,.607,0,0,,16,31,.516,28,96,124,36,13,27,32,88,90,3.3
4878,Roderick Perkins\roderick-perkins-1,2015-16,Winthrop,F,15,6,264,32,97,.330,18,46,.391,14,51,.275,12,16,.750,14,26,40,14,7,6,13,25,90,3.3
4879,Darius Stokes\darius-stokes-1,2014-15,Fairleigh Dickinson,F,29,28,548,40,78,.513,40,78,.513,0,0,,10,31,.323,36,60,96,5,11,34,12,90,90,2.6
4880,Casey Schlatter\casey-schlatter-1,2015-16,Drake,F,31,7,404,34,89,.382,31,77,.403,3,12,.250,18,35,.514,29,47,76,36,5,4,19,41,89,2.1
4881,Tosin Mehinti\tosin-mehinti-1,2013-14,Alabama-Birmingham,F,31,0,387,35,75,.467,35,75,.467,0,0,,19,30,.633,49,55,104,4,9,35,22,72,89,2.7
4882,Antwan Space\antwan-space-1,2014-15,Texas A&M,F,21,2,261,33,71,.465,29,54,.537,4,17,.235,19,32,.594,19,41,60,6,4,9,18,37,89,2.6
4883,Tyrone O'Garro\tyrone-ogarro-1,2015-16,Fairleigh Dickinson,F,27,5,369,39,69,.565,39,69,.565,0,0,,11,27,.407,33,48,81,18,14,10,24,72,89,2.5
4884,Devin Berry\devin-berry-1,2016-17,Arkansas-Pine Bluff,F,29,22,395,30,76,.395,30,76,.395,0,0,,29,44,.659,36,50,86,12,6,25,32,76,89,1.8
4885,Dallas Ennema\dallas-ennema-1,2013-14,Albany (NY),F,23,0,279,28,59,.475,8,15,.533,20,44,.455,13,22,.591,13,34,47,16,5,1,15,34,89,2.7
4886,Demetrius Houston\demetrius-houston-1,2014-15,Mississippi State,F,29,0,378,31,102,.304,28,89,.315,3,13,.231,24,45,.533,16,50,66,11,15,5,35,42,89,0.8
4887,Bryce Nickels\bryce-nickels-1,2015-16,Youngstown State,F,23,1,319,36,79,.456,36,77,.468,0,2,.000,17,38,.447,24,53,77,11,11,17,28,41,89,2.5
4888,Julian Moore\julian-moore-1,2016-17,Penn State,F,32,9,476,35,76,.461,35,76,.461,0,0,,19,27,.704,38,56,94,11,8,24,28,63,89,2.2
4889,Wyatt Sikora\wyatt-sikora-1,2014-15,Stetson,F,31,1,365,33,72,.458,31,58,.534,2,14,.143,21,32,.656,23,41,64,5,2,21,15,29,89,2.2
4890,Pete Miller\pete-miller-1,2016-17,Princeton,F,30,25,443,36,65,.554,35,64,.547,1,1,1.000,16,22,.727,36,69,105,36,7,10,18,56,89,3.3
4891,Antwon Clayton\antwon-clayton-1,2016-17,Jacksonville,F,26,10,481,37,82,.451,37,78,.474,0,4,.000,15,29,.517,40,63,103,33,20,16,22,79,89,3.4
4892,Tory Stewart-Miller\tory-stewart-miller-1,2014-15,Colorado,F,30,1,258,31,66,.470,31,66,.470,0,0,,27,36,.750,20,45,65,4,4,5,25,41,89,1.6
4893,Tim Gill\tim-gill-2,2014-15,Jacksonville,F,23,23,369,28,74,.378,28,73,.384,0,1,.000,33,55,.600,36,27,63,5,5,5,18,51,89,2.0
4894,Andrew McAuliffe\andrew-mcauliffe-1,2014-15,Davidson,F,32,1,404,40,70,.571,40,70,.571,0,0,,9,23,.391,31,61,92,12,12,7,14,54,89,2.5
4895,Austin Phyfe\austin-phyfe-1,2017-18,Northern Iowa,F,28,8,274,32,52,.615,29,46,.630,3,6,.500,22,30,.733,19,26,45,7,1,4,12,41,89,2.3
4896,Javonte Douglas\javonte-douglas-1,2014-15,Old Dominion,F,25,1,255,33,74,.446,31,67,.463,2,7,.286,21,38,.553,18,48,66,19,5,5,17,36,89,2.4
4897,Chris Kading\chris-kading-1,2013-14,North Dakota State,F,33,0,512,34,69,.493,30,46,.652,4,23,.174,17,20,.850,27,60,87,10,7,20,10,60,89,2.5
4898,Salif Boudie\salif-boudie-1,2017-18,Arkansas State,F,25,7,354,34,48,.708,34,48,.708,0,0,,21,37,.568,36,68,104,4,8,22,20,53,89,3.7
4899,Kerwin Smith\kerwin-smith-1,2014-15,Grand Canyon,F,32,25,400,36,75,.480,36,75,.480,0,0,,17,35,.486,23,50,73,0,5,15,29,74,89,1.0
4900,Chris Shields\chris-shields-1,2017-18,Longwood,F,22,14,456,35,104,.337,26,59,.441,9,45,.200,10,15,.667,20,83,103,10,9,3,36,43,89,1.5
4901,Karlos Odum\karlos-odum-1,2016-17,North Florida,F,26,0,296,24,49,.490,24,48,.500,0,1,.000,41,64,.641,16,28,44,12,6,12,16,35,89,2.6
4902,Michel Enanga\michel-enanga-1,2014-15,Coastal Carolina,F,34,0,532,31,79,.392,20,46,.435,11,33,.333,16,31,.516,43,80,123,31,19,8,33,61,89,2.4
4903,Dimitrije Cabarkapa\dimitrije-cabarkapa-1,2014-15,James Madison,F,19,0,185,31,75,.413,15,35,.429,16,40,.400,11,11,1.000,15,26,41,3,2,0,6,19,89,3.0
4904,Marin Mornar\marin-mornar-1,2013-14,Loyola Marymount,F,32,3,478,35,60,.583,33,51,.647,2,9,.222,17,23,.739,33,61,94,13,7,36,18,60,89,3.1
4905,Nicola Akele\nicola-akele-1,2015-16,Rhode Island,F,32,6,434,35,77,.455,21,43,.488,14,34,.412,5,18,.278,27,44,71,12,10,9,10,55,89,2.1
4906,Osasumwen Osaghae\osasumwen-osaghae-1,2017-18,Florida International,F,27,2,321,32,51,.627,32,51,.627,0,0,,25,46,.543,30,60,90,1,7,33,13,53,89,3.5
4907,Deng Adel\deng-adel-1,2015-16,Louisville,F,22,8,267,31,68,.456,24,48,.500,7,20,.350,20,27,.741,10,36,46,14,6,1,26,23,89,2.3
4908,Brandon Williams\brandon-williams-7,2013-14,Texas-Arlington,F,31,7,379,38,63,.603,38,61,.623,0,2,.000,12,22,.545,32,74,106,2,9,16,17,53,88,2.7
4909,Myles Lewis\myles-lewis-1,2017-18,Virginia Military Institute,F,25,0,236,32,70,.457,30,61,.492,2,9,.222,22,30,.733,16,30,46,5,3,6,18,26,88,2.0
4910,Stokley Chaffee\stokley-chaffee-1,2017-18,Tennessee State,F,28,3,476,33,50,.660,32,48,.667,1,2,.500,21,39,.538,41,67,108,8,21,11,16,51,88,3.8
4911,Justin Gorham\justin-gorham-1,2016-17,Towson,F,32,3,331,37,71,.521,37,71,.521,0,0,,14,31,.452,40,51,91,10,6,1,18,59,88,1.9
4912,D.J. Bennett\dj-bennett-1,2013-14,Oklahoma,F,32,0,291,33,58,.569,33,58,.569,0,0,,22,31,.710,22,42,64,2,6,25,17,52,88,2.3
4913,Matthew Temple\matthew-temple-1,2015-16,Texas Tech,F,25,16,314,36,73,.493,33,68,.485,3,5,.600,13,25,.520,18,25,43,17,6,9,19,66,88,1.8
4914,Kyle Davis\kyle-davis-2,2016-17,Brigham Young,F,11,6,186,36,61,.590,36,61,.590,0,0,,16,23,.696,8,32,40,9,5,9,18,25,88,5.6
4915,Davonte Fitzgerald\davonte-fitzgerald-1,2014-15,Texas A&M,F,25,2,240,29,89,.326,13,36,.361,16,53,.302,14,21,.667,11,29,40,4,3,5,16,22,88,1.4
4916,Kashaun Hicks\kashaun-hicks-1,2017-18,Central Connecticut State,F,20,0,221,28,76,.368,13,36,.361,15,40,.375,17,24,.708,7,21,28,6,3,4,24,17,88,1.7
4917,Jakub Niziol\jakub-niziol-1,2016-17,Cal Poly,F,22,2,286,25,88,.284,6,21,.286,19,67,.284,19,24,.792,7,44,51,9,2,3,13,26,88,1.8
4918,Dylan Haines\dylan-haines-1,2015-16,Boston University,F,28,8,310,35,76,.461,24,47,.511,11,29,.379,7,11,.636,16,60,76,13,5,20,28,42,88,2.1
4919,Danny Pippen\danny-pippen-1,2016-17,Kent State,F,29,12,289,31,78,.397,24,51,.471,7,27,.259,19,32,.594,33,44,77,7,7,18,19,52,88,2.1
4920,Jamar Martin\jamar-martin-1,2016-17,Charleston Southern,F,21,4,288,30,67,.448,12,23,.522,18,44,.409,10,14,.714,23,40,63,12,12,4,17,48,88,3.2
4921,Kyle Clark\kyle-clark-1,2016-17,Saint Mary's (CA),F,33,0,328,27,63,.429,9,15,.600,18,48,.375,16,19,.842,19,30,49,13,8,4,15,31,88,2.1
4922,Deion Taylor\deion-taylor-1,2014-15,Richmond,F,35,29,822,27,89,.303,21,48,.438,6,41,.146,28,60,.467,33,99,132,47,35,25,27,103,88,2.7
4923,Evan Nolte\evan-nolte-1,2013-14,Virginia,F,32,0,297,26,66,.394,9,15,.600,17,51,.333,19,26,.731,7,20,27,8,7,3,10,27,88,1.7
4924,Donovan Gilmore\donovan-gilmore-1,2017-18,North Carolina-Asheville,F,28,2,284,33,61,.541,33,61,.541,0,0,,22,36,.611,19,61,80,7,9,9,19,50,88,2.3
4925,Blake Paul\blake-paul-1,2016-17,Tulane,F,30,2,334,31,74,.419,31,74,.419,0,0,,26,39,.667,20,47,67,13,8,12,18,44,88,2.0
4926,Karolis Kundrotas\karolis-kundrotas-1,2016-17,Elon,F,32,2,308,33,78,.423,26,58,.448,7,20,.350,15,28,.536,19,51,70,9,3,3,22,46,88,1.3
4927,K.J. Lawson\kj-lawson-1,2015-16,Memphis,F,10,2,197,26,71,.366,24,62,.387,2,9,.222,34,51,.667,10,25,35,11,6,6,19,26,88,4.5
4928,Robert Boezeman\robert-boezeman-1,2015-16,UC-Riverside,F,28,9,338,30,79,.380,10,23,.435,20,56,.357,8,16,.500,10,45,55,9,6,7,17,46,88,1.6
4929,Mangok Mathiang\mangok-mathiang-1,2014-15,Louisville,F,34,9,635,31,80,.388,31,80,.388,0,0,,26,54,.481,80,79,159,16,19,46,26,82,88,3.4
4930,Iwin Ellis\iwin-ellis-1,2017-18,Prairie View,F,34,27,549,39,55,.709,39,55,.709,0,0,,10,25,.400,33,62,95,10,15,10,18,73,88,2.4
4931,Artem Tavakalyan\artem-tavakalyan-1,2015-16,Delaware State,F,29,6,333,34,96,.354,27,69,.391,7,27,.259,13,23,.565,13,36,49,26,10,2,21,47,88,1.4
4932,Bill Edwards\bill-edwards-2,2013-14,Miami (OH),F,12,0,224,33,87,.379,23,52,.442,10,35,.286,12,12,1.000,10,30,40,14,1,3,11,25,88,4.0
4933,Sam Downey\sam-downey-1,2014-15,Yale,F,25,0,276,38,79,.481,38,79,.481,0,0,,11,16,.688,23,25,48,1,9,5,11,34,87,2.3
4934,Joe Furstinger\joe-furstinger-1,2016-17,New Mexico,F,26,5,341,28,53,.528,28,53,.528,0,0,,31,43,.721,32,44,76,15,9,20,19,59,87,3.2
4935,Alvin Ellis\alvin-ellis-1,2015-16,Michigan State,F,33,0,251,28,66,.424,14,31,.452,14,35,.400,17,24,.708,11,37,48,35,13,4,14,27,87,2.5
4936,Jay Knuth\jay-knuth-1,2014-15,Loyola (IL),F,32,0,289,23,63,.365,12,37,.324,11,26,.423,30,34,.882,13,19,32,8,7,1,19,32,87,1.5
4937,Kanu Aja\kanu-aja-1,2015-16,East Carolina,F,30,17,397,36,77,.468,36,76,.474,0,1,.000,15,41,.366,29,58,87,9,1,7,16,52,87,1.7
4938,Mohamed Conde\mohamed-conde-1,2013-14,Western Illinois,F,24,7,472,32,80,.400,32,79,.405,0,1,.000,23,39,.590,30,39,69,17,19,7,19,49,87,2.8
4939,Keita Bates-Diop\keita-bates-diop-1,2016-17,Ohio State,F,9,3,210,37,74,.500,34,59,.576,3,15,.200,10,14,.714,12,35,47,12,2,12,14,13,87,7.4
4940,Mike Edwards\mike-edwards-2,2015-16,Georgia,F,34,1,561,38,85,.447,38,85,.447,0,0,,11,37,.297,41,71,112,11,4,17,32,79,87,1.2
4941,Dennis Tunstall\dennis-tunstall-1,2017-18,Towson,F,32,0,481,41,56,.732,41,56,.732,0,0,,5,11,.455,50,80,130,8,18,35,15,59,87,4.1
4942,Damani Applewhite\damani-applewhite-1,2016-17,South Carolina State,F,30,12,445,33,73,.452,33,70,.471,0,3,.000,21,35,.600,23,65,88,11,8,6,16,54,87,2.0
4943,Khalil Iverson\khalil-iverson-1,2015-16,Wisconsin,F,34,0,443,33,70,.471,31,58,.534,2,12,.167,19,36,.528,24,39,63,21,12,20,31,30,87,2.1
4944,Sam Miller\sam-miller-1,2015-16,Dayton,F,27,3,267,28,62,.452,18,29,.621,10,33,.303,21,26,.808,14,23,37,7,7,7,30,52,87,1.3
4945,Sandro Mamukelashvili\sandro-mamukelashvili-1,2017-18,Seton Hall,F,34,0,325,32,68,.471,24,41,.585,8,27,.296,15,25,.600,27,36,63,16,8,16,14,51,87,2.2
4946,Shannon Hale\shannon-hale-1,2016-17,Alabama,F,21,1,245,24,76,.316,16,35,.457,8,41,.195,31,44,.705,6,25,31,6,5,6,22,29,87,1.4
4947,David Taylor\david-taylor-2,2013-14,Pacific,F,27,0,253,32,73,.438,18,29,.621,14,44,.318,9,14,.643,3,16,19,18,12,0,24,22,87,1.7
4948,Ramon Vila\ramon-vila-1,2016-17,Arizona State,F,33,4,407,33,51,.647,33,48,.688,0,3,.000,21,33,.636,38,28,66,2,5,8,11,86,87,1.9
4949,Alex Floresca\alex-floresca-1,2017-18,San Diego,F,34,7,386,29,65,.446,25,57,.439,4,8,.500,25,42,.595,20,45,65,20,7,2,34,87,87,0.8
4950,Donovan Mitchell\donovan-mitchell-2,2017-18,Wake Forest,F,30,0,338,31,64,.484,16,29,.552,15,35,.429,10,13,.769,14,53,67,6,9,8,19,60,87,1.8
4951,Pape Diatta\pape-diatta-1,2016-17,Georgia,F,33,1,357,28,69,.406,20,42,.476,8,27,.296,23,31,.742,9,53,62,18,5,4,25,38,87,1.5
4952,Tyler Polley\tyler-polley-1,2017-18,Connecticut,F,32,10,425,24,75,.320,9,39,.231,15,36,.417,24,32,.750,8,28,36,5,3,5,18,33,87,1.1
4953,Jarmal Reid\jarmal-reid-1,2015-16,Oregon State,F,21,0,311,30,77,.390,30,77,.390,0,0,,27,42,.643,14,30,44,11,12,5,25,57,87,1.6
4954,Jy'lan Washington\jylan-washington-1,2015-16,Louisiana Tech,F,32,3,374,30,75,.400,26,51,.510,4,24,.167,23,46,.500,24,50,74,7,14,28,19,43,87,2.2
4955,Kellen McCormick\kellen-mccormick-1,2013-14,Western Michigan,F,31,2,263,30,74,.405,8,16,.500,22,58,.379,5,5,1.000,8,22,30,6,2,6,7,30,87,1.6
4956,Trey Thompson\trey-thompson-1,2016-17,Arkansas,F,36,0,503,34,54,.630,34,53,.642,0,1,.000,19,29,.655,30,87,117,56,23,28,22,79,87,3.7
4957,Malcolm Henderson\malcolm-henderson-1,2015-16,Cal State Fullerton,F,30,13,453,33,63,.524,33,63,.524,0,0,,21,40,.525,40,52,92,4,6,4,17,63,87,2.1
4958,Mikel Tyson\mikel-tyson-1,2015-16,Alabama State,F,25,0,258,34,54,.630,34,54,.630,0,0,,19,32,.594,31,43,74,4,4,11,18,49,87,2.8
4959,Devonnte Holland\devonnte-holland-1,2016-17,Radford,F,27,2,263,35,62,.565,35,62,.565,0,0,,17,36,.472,31,50,81,7,3,6,26,34,87,2.2
4960,Michel Nzege\michael-ofik-nzege-1,2016-17,East Carolina,F,26,1,376,34,75,.453,32,67,.478,2,8,.250,17,22,.773,35,44,79,11,3,2,17,42,87,2.4
4961,Alex Thomas\alex-thomas-1,2017-18,Towson,F,32,27,512,34,75,.453,34,74,.459,0,1,.000,18,34,.529,49,76,125,12,9,26,20,81,86,2.5
4962,Ryan Kriener\ryan-kriener-1,2016-17,Iowa,F,28,0,235,38,69,.551,37,64,.578,1,5,.200,9,15,.600,16,45,61,11,6,9,18,39,86,2.2
4963,Lucas Siewert\lucas-siewert-1,2016-17,Colorado,F,32,4,369,30,95,.316,13,49,.265,17,46,.370,9,14,.643,23,44,67,15,5,4,16,28,86,1.6
4964,Mike Kobani\mike-kobani-1,2013-14,Appalachian State,F,20,0,187,39,64,.609,39,64,.609,0,0,,8,26,.308,22,30,52,1,2,2,11,39,86,2.6
4965,Jalen Morgan\jalen-morgan-1,2017-18,Western Illinois,F,27,1,322,30,61,.492,30,59,.508,0,2,.000,26,31,.839,17,42,59,11,2,10,22,38,86,2.1
4966,Lamont Walker\lamont-walker-1,2016-17,Texas Southern,F,24,5,342,31,72,.431,29,56,.518,2,16,.125,22,31,.710,24,61,85,7,9,2,17,43,86,2.5
4967,Mason Ramsey\mason-ramsay-1,2014-15,Tennessee Tech,F,26,0,242,32,71,.451,23,38,.605,9,33,.273,13,19,.684,25,35,60,10,8,1,13,48,86,2.2
4968,Mustapha Traore\mustapha-traore-1,2017-18,Monmouth,F,29,18,417,35,75,.467,35,74,.473,0,1,.000,16,32,.500,31,77,108,19,7,6,22,47,86,2.4
4969,Bronson Kessinger\bronson-kessinger-1,2017-18,Indiana State,F,29,10,351,35,82,.427,31,62,.500,4,20,.200,12,22,.545,26,39,65,11,9,7,12,40,86,2.1
4970,Jordan Robinson\jordan-robinson-1,2014-15,Duquesne,F,22,3,217,30,48,.625,30,48,.625,0,0,,26,46,.565,18,29,47,2,0,12,18,33,86,2.6
4971,Keith Coleman\keith-coleman-1,2013-14,North Texas,F,29,16,418,38,92,.413,38,92,.413,0,0,,10,26,.385,25,73,98,4,5,27,43,63,86,1.0
4972,Devin Berry\devin-berry-1,2014-15,Arkansas-Pine Bluff,F,31,15,452,35,74,.473,35,74,.473,0,0,,16,29,.552,47,38,85,7,10,16,16,80,86,2.1
4973,Jabari Alex\jabari-alex-1,2015-16,Mississippi Valley State,F,35,9,371,42,63,.667,42,62,.677,0,1,.000,2,4,.500,25,36,61,7,12,8,15,38,86,2.2
4974,Max Portmann\max-portmann-1,2017-18,Maryland-Baltimore County,F,21,0,229,33,68,.485,31,63,.492,2,5,.400,18,28,.643,18,21,39,3,3,7,16,39,86,2.1
4975,Austin Meyer\austin-meyer-1,2016-17,Rice,F,34,11,355,36,59,.610,36,59,.610,0,0,,14,22,.636,31,42,73,6,8,20,15,57,86,2.3
4976,Magnus Richards\magnus-richards-1,2013-14,Binghamton,F,29,14,572,33,100,.330,33,100,.330,0,0,,20,32,.625,33,66,99,20,11,6,51,88,86,0.4
4977,Braxton Tucker\braxton-tucker-1,2017-18,Portland State,F,18,0,193,33,69,.478,33,65,.508,0,4,.000,20,26,.769,16,13,29,3,6,1,9,36,86,2.7
4978,Moritz Wagner\moritz-wagner-1,2015-16,Michigan,F,30,0,258,37,61,.607,35,49,.714,2,12,.167,10,18,.556,20,28,48,4,6,6,16,47,86,1.9
4979,Will Magarity\will-magarity-1,2014-15,Boston College,F,22,3,345,31,78,.397,22,49,.449,9,29,.310,15,26,.577,26,36,62,12,8,9,22,55,86,2.1
4980,Keenen Anderson\keenan-anderson-1,2013-14,Eastern Illinois,F,28,12,322,33,45,.733,33,45,.733,0,0,,19,37,.514,37,33,70,8,5,15,22,60,85,2.5
4981,Michael Douglas\michael-douglas-1,2016-17,Florida International,F,30,4,350,29,87,.333,10,25,.400,19,62,.306,8,10,.800,7,30,37,9,12,3,15,29,85,1.4
4982,Antwon Clayton\antwon-clayton-1,2017-18,Jacksonville,F,16,16,396,33,65,.508,30,55,.545,3,10,.300,16,37,.432,22,60,82,27,14,20,32,41,85,4.8
4983,Trey Warren\trey-warren-1,2016-17,Florida A&M,F,18,7,229,32,64,.500,32,63,.508,0,1,.000,21,34,.618,25,26,51,5,2,3,21,46,85,2.3
4984,Cameron Smith\cameron-smith-2,2015-16,Florida International,F,28,3,358,34,60,.567,34,60,.567,0,0,,17,28,.607,20,64,84,6,6,15,15,57,85,2.4
4985,Khadre Lane\khadre-lane-1,2015-16,Campbell,F,20,0,263,25,65,.385,16,32,.500,9,33,.273,26,38,.684,16,13,29,13,6,8,10,31,85,2.9
4986,Windale Glinton\windale-glinton-1,2013-14,Grambling,F,27,5,385,36,77,.468,36,75,.480,0,2,.000,13,19,.684,28,39,67,5,11,10,20,84,85,1.6
4987,Jerekius Davis\jerekius-davis-1,2017-18,Louisiana,F,24,0,171,35,78,.449,26,46,.565,9,32,.281,6,11,.545,12,21,33,6,5,2,8,15,85,2.2
4988,Charles Wilson-Fisher\charle-wilson-fisher-1,2015-16,Hampton,F,32,4,325,34,71,.479,31,61,.508,3,10,.300,14,20,.700,30,49,79,6,11,6,26,50,85,1.7
4989,Skye Johnson\skye-johnson-1,2016-17,Delaware,F,26,0,258,38,67,.567,38,67,.567,0,0,,9,19,.474,25,31,56,7,10,7,31,44,85,1.8
4990,Julian Moore\julian-moore-1,2017-18,Penn State,F,38,4,455,32,59,.542,32,59,.542,0,0,,21,33,.636,34,38,72,12,8,29,14,58,85,2.3
4991,Eddie Davis\eddie-davis-1,2015-16,Southern Mississippi,F,9,6,192,31,66,.470,22,42,.524,9,24,.375,14,24,.583,17,34,51,7,5,2,10,19,85,7.0
4992,Dontavious Smith\dontavious-smith-1,2015-16,Massachusetts-Lowell,F,24,1,273,38,75,.507,38,74,.514,0,1,.000,9,18,.500,24,54,78,20,14,17,34,43,85,2.7
4993,David Skara\david-skara-1,2017-18,Clemson,F,26,7,502,30,71,.423,25,49,.510,5,22,.227,20,34,.588,24,50,74,11,16,13,25,59,85,2.2
4994,Raheem Johnson\raheem-johnson-1,2016-17,Buffalo,F,26,3,252,38,59,.644,38,59,.644,0,0,,9,11,.818,32,43,75,0,3,21,17,50,85,2.9
4995,Tate Stensgaard\tate-stensgaard-1,2014-15,Western Illinois,F,20,20,423,32,57,.561,32,56,.571,0,1,.000,21,31,.677,20,70,90,17,9,6,20,68,85,3.3
4996,Hameir Wright\hameir-wright-1,2017-18,Washington,F,33,1,491,31,84,.369,21,47,.447,10,37,.270,13,32,.406,19,70,89,21,14,36,25,67,85,2.0
4997,Enoch Hood\enoch-hood-1,2015-16,North Carolina Central,F,30,21,369,34,54,.630,34,54,.630,0,0,,17,26,.654,33,65,98,2,8,6,12,58,85,2.6
4998,Brandon Watkins\brandon-watkins-2,2013-14,West Virginia,F,32,1,361,38,83,.458,38,83,.458,0,0,,9,25,.360,38,51,89,10,11,24,10,78,85,2.2
4999,Ameer Bennett\ameer-bennett-1,2017-18,Delaware State,F,29,4,310,28,67,.418,28,67,.418,0,0,,29,47,.617,26,29,55,7,7,4,35,41,85,1.1
5000,Evan Cummins\evan-cummins-1,2013-14,Harvard,F,30,0,303,34,61,.557,34,61,.557,0,0,,17,24,.708,17,41,58,12,10,21,21,43,85,2.4
5001,Devin Thomas\devin-thomas-2,2017-18,Indiana State,F,25,11,318,23,67,.343,14,40,.350,9,27,.333,30,40,.750,24,43,67,12,6,10,26,33,85,2.2
5002,Joseph Lopez\joseph-lopez-1,2014-15,Winthrop,F,28,2,278,35,59,.593,35,58,.603,0,1,.000,14,25,.560,23,46,69,5,8,4,19,37,84,2.2
5003,Robert Boezeman\robert-boezeman-1,2014-15,UC-Riverside,F,30,0,342,31,60,.517,24,48,.500,7,12,.583,15,22,.682,24,27,51,4,5,5,18,49,84,1.7
5004,Craig Victor\craig-victor-1,2016-17,Louisiana State,F,8,5,202,32,79,.405,32,77,.416,0,2,.000,20,30,.667,23,38,61,8,10,5,12,22,84,7.9
5005,Iba Camara\iba-camara-1,2014-15,New Hampshire,F,27,8,285,35,78,.449,35,78,.449,0,0,,14,33,.424,33,74,107,10,5,5,27,69,84,1.6
5006,Deontae Cole\deontae-cole-1,2015-16,Northern Kentucky,F,27,3,387,30,77,.390,6,9,.667,24,68,.353,0,0,,5,21,26,23,3,3,4,22,84,2.2
5007,Roger Moute a Bidias\roger-moute-a-bidias-1,2016-17,University of California,F,30,8,358,22,71,.310,13,36,.361,9,35,.257,31,36,.861,18,36,54,9,5,4,18,38,84,1.5
5008,Pierre Sarr\pierre-sarr-1,2016-17,Monmouth,F,31,4,299,24,46,.522,21,35,.600,3,11,.273,33,43,.767,21,67,88,6,12,4,24,51,84,2.2
5009,Sam Beeler\sam-beeler-1,2013-14,UC-Santa Barbara,F,30,3,329,27,54,.500,27,54,.500,0,0,,30,50,.600,20,44,64,3,5,21,21,67,84,1.7
5010,Julian Harris\julian-harris-2,2017-18,Texas-Arlington,F,23,7,323,26,59,.441,26,57,.456,0,2,.000,32,46,.696,17,45,62,8,6,6,26,46,84,1.9
5011,Jerome Hunter\jerome-hunter-1,2013-14,Alabama A&M,F,29,16,383,32,74,.432,32,74,.432,0,0,,20,27,.741,16,54,70,16,17,10,25,63,84,1.9
5012,Chris Kemp\chris-kemp-2,2014-15,Montana,F,28,4,249,35,61,.574,35,61,.574,0,0,,14,28,.500,19,29,48,2,3,1,15,43,84,1.6
5013,Tomasz Gielo\tomasz-gielo-1,2014-15,Liberty,F,7,7,216,24,60,.400,13,33,.394,11,27,.407,25,31,.806,7,37,44,9,6,1,16,14,84,8.1
5014,Daniel Meyer\daniel-meyer-2,2015-16,Omaha,F,32,0,263,36,68,.529,36,67,.537,0,1,.000,12,26,.462,23,25,48,7,3,8,16,33,84,1.7
5015,Freddie McSwain\freddie-mcswain-1,2016-17,Indiana,F,31,1,251,32,58,.552,32,55,.582,0,3,.000,20,32,.625,35,42,77,4,10,3,23,41,84,2.1
5016,Elijah Foster\elijah-foster-1,2016-17,Nevada,F,7,7,225,32,52,.615,32,52,.615,0,0,,20,24,.833,17,35,52,7,3,1,10,22,84,10.1
5017,Isaiah Miles\isaiah-miles-1,2013-14,Saint Joseph's,F,28,0,260,27,69,.391,13,25,.520,14,44,.318,16,19,.842,20,27,47,8,4,9,19,33,84,1.8
5018,DeMondre Harvey\demondre-harvey-1,2013-14,Louisiana-Monroe,F,27,4,385,34,64,.531,34,64,.531,0,0,,16,30,.533,34,59,93,14,13,13,17,54,84,3.0
5019,Kenneth Hall\kenny-hall-2,2013-14,Western Carolina,F,34,27,531,32,62,.516,32,62,.516,0,0,,20,36,.556,51,67,118,26,10,59,27,105,84,3.0
5020,Keve Aluma\keve-aluma-1,2017-18,Wofford,F,33,3,439,30,53,.566,30,53,.566,0,0,,24,42,.571,45,68,113,18,6,13,20,63,84,2.6
5021,Angel Nunez\angel-nunez-1,2013-14,Gonzaga,F,24,0,176,26,60,.433,25,52,.481,1,8,.125,31,38,.816,10,39,49,0,2,9,14,26,84,2.2
5022,Braxton Tucker\braxton-tucker-1,2016-17,Portland State,F,5,5,147,35,71,.493,32,62,.516,3,9,.333,11,16,.688,16,13,29,8,4,0,7,7,84,12.2
5023,Taylor Bessick\taylor-bessick-1,2015-16,Iona,F,24,7,284,35,66,.530,35,66,.530,0,0,,14,22,.636,31,48,79,1,7,16,19,62,84,2.5
5024,Richard Freeman\richard-freeman-1,2013-14,Grambling,F,29,10,391,27,87,.310,21,59,.356,6,28,.214,24,48,.500,12,49,61,7,7,8,29,34,84,0.8
5025,RaySean Scott Jr.\raysean-scottjr-1,2016-17,Florida Gulf Coast,F,25,5,233,32,72,.444,24,42,.571,8,30,.267,12,19,.632,9,43,52,9,4,3,17,45,84,1.6
5026,Kion Brown\kion-brown-1,2014-15,Radford,F,33,0,360,29,66,.439,29,66,.439,0,0,,26,40,.650,19,40,59,7,3,6,33,47,84,0.9
5027,Austin Burgett\austin-burgett-1,2013-14,Notre Dame,F,28,5,413,29,68,.426,21,31,.677,8,37,.216,17,22,.773,12,39,51,18,12,16,19,60,83,2.1
5028,Clayton Graham\clayton-graham-1,2013-14,Colgate,F,31,1,438,36,54,.667,36,54,.667,0,0,,11,19,.579,24,58,82,29,9,8,19,67,83,2.6
5029,Daquan Holiday\daquan-holiday-1,2013-14,NJIT,F,29,0,414,35,74,.473,35,74,.473,0,0,,13,22,.591,43,55,98,11,18,31,24,63,83,3.0
5030,Clay Verk\clay-verk-1,2016-17,Stetson,F,28,0,307,31,85,.365,28,72,.389,3,13,.231,18,41,.439,28,34,62,6,3,2,24,50,83,0.8
5031,Ryan Pierson\ryan-pierson-1,2014-15,Vermont,F,26,2,267,32,72,.444,32,71,.451,0,1,.000,19,22,.864,18,29,47,9,2,3,21,31,83,1.6
5032,Ahmad Wagner\ahmad-wagner-1,2015-16,Iowa,F,32,0,323,32,47,.681,32,46,.696,0,1,.000,19,37,.514,32,52,84,6,9,13,11,49,83,2.7
5033,Kendall Pollard\kendall-pollard-1,2013-14,Dayton,F,37,0,316,34,62,.548,34,60,.567,0,2,.000,15,46,.326,15,32,47,9,11,11,21,52,83,1.2
5034,Alex Ennis\alex-ennis-1,2016-17,Morgan State,F,30,22,526,34,72,.472,34,72,.472,0,0,,15,25,.600,55,76,131,3,10,13,23,57,83,2.6
5035,Chris Washburn\chris-washburn-2,2016-17,Texas Christian,F,35,0,247,27,51,.529,27,50,.540,0,1,.000,29,54,.537,26,27,53,17,13,5,23,57,83,1.6
5036,Mamadou Diarra\mamadou-diarra-2,2017-18,Connecticut,F,31,5,314,34,62,.548,34,62,.548,0,0,,15,30,.500,32,47,79,0,4,22,14,70,83,2.0
5037,Jehyve Floyd\jehyve-floyd-1,2015-16,Holy Cross,F,29,0,272,38,59,.644,38,59,.644,0,0,,7,22,.318,17,28,45,13,10,21,21,58,83,2.1
5038,Cody McDavis\cody-mcdavis-1,2013-14,Northern Colorado,F,25,1,338,35,58,.603,35,58,.603,0,0,,13,17,.765,17,38,55,3,5,0,14,48,83,2.1
5039,Jimmy Boeheim\jimmy-boeheim-1,2017-18,Cornell,F,26,3,310,32,98,.327,26,58,.448,6,40,.150,13,21,.619,18,40,58,13,1,6,10,28,83,1.6
5040,Luke Morrison\luke-morrison-1,2014-15,Army,F,19,0,188,31,76,.408,15,27,.556,16,49,.327,5,12,.417,10,29,39,11,6,5,13,28,83,2.5
5041,Staphon Blair\staphon-blair-1,2015-16,Central Florida,F,28,1,263,35,64,.547,35,64,.547,0,0,,13,31,.419,26,48,74,1,5,13,18,36,83,2.1
5042,Rashaun Stimage\rashaun-stimage-1,2014-15,DePaul,F,17,5,264,31,65,.477,30,59,.508,1,6,.167,20,38,.526,26,27,53,0,8,22,7,36,83,4.2
5043,Daniel Camps\daniel-camps-1,2014-15,Northern Kentucky,F,18,3,214,34,55,.618,32,49,.653,2,6,.333,13,22,.591,16,32,48,12,10,0,11,24,83,4.1
5044,Seth Berger\seth-berger-1,2016-17,Massachusetts,F,32,16,327,32,63,.508,28,44,.636,4,19,.211,15,24,.625,22,52,74,10,17,5,17,51,83,2.2
5045,Vacha Vaughn\vacha-vaughn-1,2016-17,Mississippi Valley State,F,29,4,343,31,65,.477,25,53,.472,6,12,.500,15,23,.652,18,39,57,25,8,3,19,54,83,2.0
5046,Christian Albright\christian-albright-1,2014-15,Abilene Christian,F,20,11,269,36,84,.429,36,82,.439,0,2,.000,11,17,.647,21,44,65,20,6,9,26,37,83,2.5
5047,Matt DeWolf\matt-dewolf-1,2017-18,Brown,F,27,16,392,29,52,.558,29,52,.558,0,0,,24,47,.511,39,80,119,13,12,5,29,41,82,2.9
5048,Wayne Langston\wayne-langston-1,2014-15,Murray State,F,33,0,404,30,50,.600,30,50,.600,0,0,,22,42,.524,33,71,104,6,8,10,21,62,82,2.1
5049,Jaden Sayles\jaden-sayles-1,2017-18,Akron,F,16,1,234,26,40,.650,26,40,.650,0,0,,30,41,.732,7,20,27,4,2,5,13,15,82,3.8
5050,Chris Kemp\chris-kemp-2,2013-14,Montana,F,29,0,304,35,57,.614,35,57,.614,0,0,,12,21,.571,25,36,61,4,9,8,20,56,82,1.9
5051,William Pfister\william-pfister-1,2016-17,Florida Atlantic,F,30,14,515,36,76,.474,36,76,.474,0,0,,10,21,.476,60,58,118,23,18,7,27,96,82,2.4
5052,Chad Calcaterra\chad-calcaterra-1,2013-14,North Dakota,F,30,13,356,31,63,.492,31,63,.492,0,0,,20,30,.667,27,40,67,2,3,9,15,46,82,1.8
5053,Josh Huntley\josh-huntley-1,2016-17,Stephen F. Austin,F,32,3,271,34,69,.493,34,69,.493,0,0,,14,21,.667,26,38,64,3,5,4,38,43,82,0.9
5054,Liam Thomas\liam-thomas-1,2013-14,Nicholls State,F,25,21,387,34,62,.548,34,58,.586,0,4,.000,14,30,.467,28,53,81,16,7,33,21,68,82,3.0
5055,Justin Browning\justin-browning-1,2013-14,Western Carolina,F,32,1,424,32,58,.552,32,52,.615,0,6,.000,18,28,.643,28,40,68,18,30,28,20,76,82,2.9
5056,Jacob Cushing\jacob-cushing-1,2017-18,Delaware,F,22,7,337,31,80,.388,17,29,.586,14,51,.275,6,7,.857,6,45,51,9,4,2,14,37,82,1.8
5057,Travis Julien\travis-julien-1,2014-15,Nicholls State,F,27,0,349,34,65,.523,34,63,.540,0,2,.000,14,39,.359,27,42,69,14,9,18,28,70,82,1.7
5058,Lauri Toivonen\lauri-toivonen-1,2013-14,Texas-Rio Grande Valley,F,32,12,586,31,71,.437,30,66,.455,1,5,.200,19,33,.576,32,48,80,22,12,12,18,77,82,2.0
5059,Omar Habwe\omar-habwe-1,2017-18,Mount St. Mary's,F,31,1,345,27,48,.563,20,29,.690,7,19,.368,21,31,.677,14,34,48,8,11,3,8,33,82,2.3
5060,Devon Scott\devon-scott-1,2014-15,Dayton,F,9,9,249,28,44,.636,28,44,.636,0,0,,26,42,.619,21,46,67,7,4,4,15,20,82,8.1
5061,Quintin Brewer\quentin-brewer-1,2015-16,Illinois State,F,30,6,489,31,75,.413,30,71,.423,1,4,.250,19,26,.731,46,76,122,10,7,17,24,73,82,2.2
5062,Jarred Vanderbilt\jarred-vanderbilt-1,2017-18,Kentucky,F,14,0,238,29,68,.426,29,67,.433,0,1,.000,24,38,.632,46,64,110,14,6,11,15,37,82,6.1
5063,Mike Fofana\mike-fofana-1,2017-18,Tennessee-Martin,F,30,21,484,35,91,.385,35,82,.427,0,9,.000,12,22,.545,26,69,95,31,10,8,30,35,82,2.0
5064,Alan Flannigan\alan-flannigan-1,2013-14,Lafayette,F,25,13,352,29,67,.433,26,64,.406,3,3,1.000,21,27,.778,10,40,50,20,7,0,16,45,82,2.0
5065,Isaac Banks\isaac-banks-1,2014-15,East Tennessee State,F,28,14,527,36,69,.522,35,67,.522,1,2,.500,9,19,.474,51,87,138,19,10,27,18,80,82,3.5
5066,Jordan Butler\jordan-butler-1,2014-15,Norfolk State,F,33,1,454,33,68,.485,33,68,.485,0,0,,16,33,.485,37,67,104,19,11,36,29,41,82,2.8
5067,Aleksej Rostov\aleksejs-rostov-1,2014-15,Western Kentucky,F,32,20,327,31,82,.378,26,61,.426,5,21,.238,15,21,.714,29,49,78,12,4,7,25,48,82,1.3
5068,Terrance O'Donohue\terrance-odonohue-1,2014-15,College of Charleston,F,30,6,381,31,71,.437,27,61,.443,4,10,.400,15,26,.577,29,29,58,5,17,12,22,68,81,1.6
5069,Barry Smith\barry-smith-1,2013-14,Bethune-Cookman,F,16,5,298,25,56,.446,25,56,.446,0,0,,31,49,.633,28,34,62,7,12,7,16,36,81,4.1
5070,Jabari Alex\jabari-alex-1,2016-17,Mississippi Valley State,F,28,1,304,38,61,.623,37,57,.649,1,4,.250,4,7,.571,21,26,47,7,11,5,10,32,81,2.6
5071,William Powell\william-powell-1,2013-14,Seattle,F,28,0,356,32,65,.492,32,64,.500,0,1,.000,17,41,.415,40,49,89,11,12,4,17,54,81,2.3
5072,C.J. Bray\cj-bray-1,2013-14,Citadel,F,22,5,274,27,69,.391,21,49,.429,6,20,.300,21,31,.677,19,38,57,4,6,4,11,30,81,2.4
5073,Nick Madray\nick-madray-1,2016-17,Eastern Michigan,F,33,11,453,28,63,.444,28,54,.519,0,9,.000,25,37,.676,34,45,79,3,12,15,18,80,81,1.7
5074,Xzavier Taylor\xzavier-taylor-1,2014-15,Bradley,F,29,7,287,31,70,.443,31,70,.443,0,0,,19,34,.559,30,23,53,3,5,8,23,75,81,0.9
5075,Simi Fajemisin\simi-fajemisin-1,2013-14,San Diego,F,35,0,394,29,59,.492,29,59,.492,0,0,,23,40,.575,35,45,80,4,9,16,28,80,81,1.3
5076,Fallou Ndoye\fallou-ndoye-1,2017-18,Cal State Bakersfield,F,29,9,375,31,62,.500,31,62,.500,0,0,,19,39,.487,36,56,92,3,1,7,39,76,81,0.8
5077,Joe Tuss\joe-tuss-1,2015-16,Air Force,F,30,2,348,29,104,.279,20,61,.328,9,43,.209,14,27,.519,15,43,58,19,6,1,20,44,81,0.7
5078,Logan McLane\logan-mclane-1,2015-16,Miami (OH),F,24,3,287,28,81,.346,20,56,.357,8,25,.320,17,24,.708,18,37,55,11,8,4,22,35,81,1.6
5079,Joe Boyd\joe-boyd-1,2014-15,Cal State Fullerton,F,31,16,525,29,74,.392,29,74,.392,0,0,,23,27,.852,36,79,115,12,3,6,25,65,81,1.7
5080,Stetson Billings\stetson-billings-1,2016-17,Little Rock,F,19,17,358,27,71,.380,15,40,.375,12,31,.387,15,17,.882,8,35,43,25,12,5,14,40,81,3.2
5081,Ryan Layman\ryan-layman-1,2017-18,Bryant,F,30,7,429,32,77,.416,20,36,.556,12,41,.293,5,10,.500,20,55,75,10,8,5,19,33,81,1.8
5082,Dominic Green\dominic-green-2,2015-16,Washington,F,30,0,337,27,98,.276,9,33,.273,18,65,.277,9,19,.474,7,27,34,7,4,7,10,24,81,0.9
5083,Marko Pirovic\marko-pirovic-1,2013-14,Maine,F,26,0,278,26,64,.406,22,36,.611,4,28,.143,25,39,.641,22,26,48,14,8,1,16,39,81,2.0
5084,Forrest Robinson\forrest-robinson-1,2013-14,DePaul,F,22,7,269,29,66,.439,7,12,.583,22,54,.407,1,2,.500,9,30,39,8,6,3,12,49,81,2.0
5085,Anthony Pratt\anthony-pratt-1,2015-16,Eastern Kentucky,F,29,1,304,34,52,.654,34,51,.667,0,1,.000,13,28,.464,23,50,73,10,3,12,18,60,81,2.1
5086,Eric Robertson\eric-robertson-2,2013-14,South Dakota,F,29,0,464,31,81,.383,28,55,.509,3,26,.115,16,20,.800,27,59,86,19,13,10,12,59,81,2.4
5087,Jarquez Smith\jarquez-smith-1,2013-14,Florida State,F,34,0,343,32,73,.438,28,56,.500,4,17,.235,13,25,.520,17,33,50,2,2,24,28,39,81,1.1
5088,Bourama Sidibe\bourama-sidibe-1,2017-18,Syracuse,F,30,0,373,31,52,.596,31,52,.596,0,0,,19,40,.475,37,59,96,4,10,20,27,71,81,2.1
5089,Cheick Diallo\cheick-diallo-1,2015-16,Kansas,F,27,1,202,33,58,.569,33,58,.569,0,0,,15,27,.556,17,51,68,1,7,23,17,38,81,2.5
5090,Jalen Williams\jalen-williams-1,2017-18,Furman,F,30,1,286,29,59,.492,29,59,.492,0,0,,22,34,.647,47,62,109,9,7,15,25,44,80,2.6
5091,Bryce Clark\bryce-clark-1,2013-14,Southern,F,25,1,218,28,73,.384,26,53,.491,2,20,.100,22,31,.710,18,40,58,9,3,2,11,22,80,2.1
5092,Thomas Huerter Jr.\thomas-huerterjr-1,2017-18,Siena,F,26,6,457,31,65,.477,21,37,.568,10,28,.357,8,17,.471,18,59,77,30,7,18,25,48,80,2.7
5093,Russell Woods\russell-woods-1,2015-16,Missouri,F,29,6,388,33,63,.524,33,63,.524,0,0,,14,36,.389,27,50,77,9,4,7,13,74,80,1.6
5094,Connor McClenaghan\connor-mcclenaghan-1,2017-18,Marist,F,29,1,280,29,69,.420,17,38,.447,12,31,.387,10,16,.625,13,33,46,13,8,15,17,47,80,1.8
5095,Kendell Ramlal\kendall-ramlal-1,2017-18,Texas-San Antonio,F,31,2,283,32,56,.571,32,56,.571,0,0,,16,27,.593,28,53,81,3,8,28,19,42,80,2.5
5096,Maxwell Kupchak\maxwell-kupchak-1,2016-17,UC-Santa Barbara,F,26,11,461,30,91,.330,30,86,.349,0,5,.000,20,27,.741,28,55,83,13,5,5,19,39,80,1.7
5097,Taylor Abt\taylor-abt-1,2013-14,Holy Cross,F,34,14,409,32,67,.478,25,47,.532,7,20,.350,9,19,.474,30,55,85,3,6,7,26,76,80,1.1
5098,Devonta Abron\devonta-abron-1,2014-15,Texas Christian,F,28,0,211,24,46,.522,24,46,.522,0,0,,32,61,.525,32,28,60,8,4,4,11,48,80,2.1
5099,Will Miller\will-miller-2,2017-18,Virginia Military Institute,F,29,13,372,34,70,.486,27,47,.574,7,23,.304,5,12,.417,13,31,44,10,11,3,19,38,80,1.6
5100,Hanner Mosquera-Perea\hanner-mosquera-perea-1,2013-14,Indiana,F,29,0,224,23,40,.575,23,40,.575,0,0,,34,47,.723,20,42,62,6,5,13,19,34,80,2.4
5101,Jaylen Butz\jaylen-butz-1,2017-18,DePaul,F,23,4,272,32,52,.615,32,52,.615,0,0,,16,33,.485,40,56,96,8,5,12,19,49,80,3.3
5102,Shack Scott\shack-scott-1,2017-18,Wagner,F,25,1,317,35,59,.593,35,59,.593,0,0,,10,17,.588,17,38,55,3,3,7,7,59,80,2.1
5103,Brenden Evans\brenden-evans-1,2013-14,Utah Valley,F,32,0,328,24,49,.490,24,44,.545,0,5,.000,32,50,.640,23,57,80,4,10,6,21,47,80,1.8
5104,Alec Brennan\alec-brennan-1,2015-16,Princeton,F,29,1,277,31,58,.534,22,38,.579,9,20,.450,9,20,.450,21,44,65,15,14,12,16,55,80,2.4
5105,B.J. Gladden\bj-gladden-1,2014-15,Akron,F,28,11,272,28,70,.400,24,57,.421,4,13,.308,20,36,.556,19,25,44,12,7,4,24,28,80,1.4
5106,Scott Ulaneo\scott-ulaneo-1,2017-18,Seattle,F,34,4,354,25,59,.424,22,45,.489,3,14,.214,27,48,.563,24,63,87,20,5,6,24,68,80,1.4
5107,Tyrel Hunt\tyrel-hunt-1,2013-14,Alcorn State,F,27,3,252,27,64,.422,27,63,.429,0,1,.000,26,39,.667,11,28,39,5,6,3,12,22,80,1.8
5108,Boo Milligan\michael-milligan-1,2015-16,Central Arkansas,F,28,0,258,26,80,.325,19,45,.422,7,35,.200,21,32,.656,10,29,39,21,12,5,17,39,80,1.5
5109,Michael Zangari\michael-zangari-1,2014-15,East Carolina,F,31,15,490,32,82,.390,31,71,.437,1,11,.091,15,25,.600,40,61,101,18,10,15,19,68,80,2.1
5110,Matt Cimino\matt-cimino-1,2016-17,American,F,26,3,326,30,63,.476,19,35,.543,11,28,.393,9,14,.643,11,32,43,18,6,13,28,42,80,1.8
5111,Malik Petteway\malik-petteway-1,2017-18,Robert Morris,F,13,5,247,28,65,.431,28,64,.438,0,1,.000,24,37,.649,33,48,81,2,11,14,14,40,80,5.4
5112,Felix Von Hofe\felix-van-hofe-1,2013-14,Eastern Washington,F,28,0,241,26,68,.382,7,11,.636,19,57,.333,9,14,.643,2,16,18,5,1,2,6,21,80,1.4
5113,Martin Krampelj\martin-krampelj-1,2016-17,Creighton,F,28,1,172,31,59,.525,29,51,.569,2,8,.250,16,29,.552,28,35,63,6,1,10,11,27,80,2.4
5114,Perry Francois\perry-francois-1,2017-18,Texas A&M-Corpus Christi,F,29,6,337,35,71,.493,35,71,.493,0,0,,10,18,.556,32,46,78,14,2,17,32,63,80,1.5
5115,Joel James\joel-james-1,2015-16,North Carolina,F,37,10,289,34,75,.453,34,75,.453,0,0,,12,23,.522,35,49,84,0,1,7,15,45,80,1.3
5116,Zavier Peart\zavier-peart-1,2016-17,Manhattan,F,26,11,256,36,68,.529,36,68,.529,0,0,,7,16,.438,31,32,63,3,2,8,13,53,79,1.9
5117,God'sgift Achiuwa\godsgift-achiuwa-1,2013-14,St. John's (NY),F,32,3,289,28,49,.571,28,49,.571,0,0,,23,49,.469,28,40,68,1,8,26,11,27,79,2.6
5118,Kevin Thomas\kevin-thomas-3,2013-14,Tulane,F,33,17,429,29,60,.483,29,60,.483,0,0,,21,31,.677,31,41,72,5,6,43,26,68,79,2.0
5119,Myles Cherry\myles-cherry-1,2017-18,Lafayette,F,30,1,396,30,52,.577,29,48,.604,1,4,.250,18,25,.720,28,79,107,18,10,4,29,48,79,2.4
5120,Kalif Wright\kalif-wright-1,2014-15,Miami (OH),F,27,7,256,32,78,.410,32,78,.410,0,0,,15,25,.600,11,35,46,0,3,3,18,49,79,0.7
5121,Scott King\scott-king-1,2014-15,Stony Brook,F,26,0,206,24,70,.343,8,18,.444,16,52,.308,15,22,.682,13,17,30,10,4,4,12,20,79,1.7
5122,Bennett Holley\bennett-holley-1,2016-17,Appalachian State,F,24,1,167,23,57,.404,6,11,.545,17,46,.370,16,18,.889,7,23,30,6,3,0,4,38,79,2.0
5123,Papa Ndao\papa-ndao-1,2013-14,Saint Joseph's,F,31,2,361,25,58,.431,8,16,.500,17,42,.405,12,13,.923,9,31,40,19,9,4,17,43,79,1.8
5124,Silvio De Sousa\silvio-desousa-1,2017-18,Kansas,F,20,0,175,32,47,.681,32,47,.681,0,0,,15,21,.714,33,41,74,4,1,3,18,33,79,3.3
5125,Lucas Stivrins\lucas-stivrins-1,2014-15,Nevada,F,29,11,327,27,55,.491,26,54,.481,1,1,1.000,24,38,.632,32,49,81,7,2,7,19,49,79,1.9
5126,Dwight Wilson\dwight-wilson-1,2017-18,James Madison,F,26,0,237,34,74,.459,34,74,.459,0,0,,11,19,.579,33,55,88,1,4,3,18,35,79,2.0
5127,Kalif Wright\kalif-wright-1,2015-16,Miami (OH),F,25,6,239,36,79,.456,35,78,.449,1,1,1.000,6,14,.429,18,27,45,2,5,0,7,34,79,1.7
5128,Daquan Brown\daquan-brown-1,2013-14,Bethune-Cookman,F,13,3,233,30,66,.455,30,66,.455,0,0,,19,30,.633,20,36,56,1,4,5,15,28,79,3.6
5129,Omar El-Sheikh\omar-el-sheikh-1,2017-18,Fairfield,F,23,0,239,29,57,.509,29,53,.547,0,4,.000,21,42,.500,17,46,63,11,10,9,25,46,79,2.1
5130,Julian Harris\julian-harris-2,2016-17,Texas-Arlington,F,34,0,325,29,54,.537,29,53,.547,0,1,.000,21,35,.600,25,25,50,3,4,7,15,43,79,1.5
5131,DaRohn Scott\darohn-scott-1,2014-15,Central Michigan,F,32,0,276,30,53,.566,30,52,.577,0,1,.000,19,40,.475,28,33,61,1,6,28,14,56,79,2.0
5132,Assane Diop\assane-diop-1,2014-15,Austin Peay,F,27,1,290,27,91,.297,16,42,.381,11,49,.224,14,19,.737,12,35,47,7,3,12,19,43,79,0.9
5133,Emmanuel Olojakpoke\emmanuel-olojakpoke-1,2016-17,Akron,F,33,1,195,35,51,.686,35,51,.686,0,0,,9,18,.500,18,28,46,0,2,20,6,50,79,2.0
5134,Austin Colbert\austin-colbert-1,2017-18,Hampton,F,26,2,341,30,85,.353,25,54,.463,5,31,.161,14,17,.824,15,44,59,9,5,10,17,42,79,1.5
5135,Jordy Kuiper\jordy-kuiper-1,2014-15,North Carolina-Greensboro,F,24,3,339,32,55,.582,32,55,.582,0,0,,15,21,.714,30,33,63,9,9,4,13,59,79,2.6
5136,J.J. Thomas\jj-thomas-1,2013-14,Cal State Northridge,F,28,9,321,27,67,.403,24,59,.407,3,8,.375,22,31,.710,23,38,61,15,13,3,22,66,79,1.6
5137,Tim Rowe\tim-rowe-1,2016-17,Southern Mississippi,F,8,2,206,27,55,.491,24,48,.500,3,7,.429,22,35,.629,12,39,51,7,3,11,21,21,79,6.6
5138,Rodney Hawkins\rodney-hawkins-1,2014-15,Saint Peter's,F,22,0,223,29,72,.403,26,63,.413,3,9,.333,18,31,.581,15,24,39,2,2,9,5,42,79,1.8
5139,Chevez Goodwin\chevez-goodwin-1,2016-17,College of Charleston,F,35,5,342,34,66,.515,34,65,.523,0,1,.000,11,29,.379,31,71,102,4,8,19,15,57,79,2.0
5140,Zach Coleman\zach-coleman-1,2014-15,Massachusetts,F,32,0,329,27,71,.380,16,32,.500,11,39,.282,14,18,.778,18,44,62,10,7,9,18,46,79,1.5
5141,Paulin Mpawe\paulin-mpawe-1,2014-15,Idaho,F,30,24,411,33,72,.458,33,72,.458,0,0,,13,32,.406,39,48,87,7,6,12,20,54,79,1.8
5142,Caleb Stewart\caleb-stewart-1,2017-18,Binghamton,F,25,2,235,27,69,.391,12,28,.429,15,41,.366,9,17,.529,5,32,37,9,7,13,17,17,78,2.0
5143,Fred Iruafemi\fred-iruafemi-1,2014-15,Virginia Military Institute,F,28,6,343,31,68,.456,31,68,.456,0,0,,16,25,.640,23,47,70,21,18,23,12,52,78,3.1
5144,Shane Randall\shane-randall-1,2013-14,Maryland-Eastern Shore,F,28,7,358,26,57,.456,26,56,.464,0,1,.000,26,32,.813,24,33,57,4,7,8,24,56,78,1.5
5145,Michal Cekovsky\michal-cekovsky-1,2014-15,Maryland,F,30,1,379,36,69,.522,36,69,.522,0,0,,6,21,.286,27,47,74,4,4,19,16,62,78,1.7
5146,Jamar Akoh\jamar-akoh-1,2014-15,Cal State Fullerton,F,30,0,431,29,74,.392,27,67,.403,2,7,.286,18,38,.474,24,51,75,12,13,6,24,45,78,1.5
5147,Kyle Williams\kyle-williams-3,2014-15,Grambling,F,29,24,557,31,69,.449,31,69,.449,0,0,,16,32,.500,34,66,100,7,5,10,28,59,78,1.5
5148,Marvin Singleton\marvin-singleton-1,2013-14,Northern Iowa,F,23,8,277,32,66,.485,31,53,.585,1,13,.077,13,20,.650,22,35,57,11,6,3,15,28,78,2.5
5149,Ajani Kennedy\ajani-kennedy-1,2017-18,UC-Riverside,F,22,2,221,26,53,.491,20,37,.541,6,16,.375,20,24,.833,12,22,34,12,4,7,18,26,78,2.4
5150,B.J. Gladden\bj-gladden-1,2017-18,Georgia Southern,F,28,3,312,27,84,.321,27,80,.338,0,4,.000,24,61,.393,19,52,71,14,5,3,18,31,78,1.1
5151,Ben Freeland\ben-freeland-1,2015-16,Lafayette,F,28,13,386,36,63,.571,36,63,.571,0,0,,6,8,.750,23,70,93,5,13,10,19,75,78,2.1
5152,Maurius Hill\maurius-hill-1,2013-14,Little Rock,F,29,7,241,32,76,.421,32,74,.432,0,2,.000,14,23,.609,18,25,43,9,6,5,25,30,78,1.1
5153,Myles Taylor\myles-taylor-1,2014-15,Tennessee-Martin,F,7,7,142,25,34,.735,25,33,.758,0,1,.000,28,35,.800,12,30,42,7,3,3,12,23,78,9.7
5154,Ngor Barnaba\ngor-barnaba-1,2016-17,Utah State,F,25,4,292,29,87,.333,21,49,.429,8,38,.211,12,18,.667,12,56,68,18,3,5,16,34,78,1.6
5155,Alex Peters\alex-peters-1,2016-17,Samford,F,32,0,270,29,42,.690,29,42,.690,0,0,,20,29,.690,12,16,28,6,9,8,10,55,78,1.8
5156,Travis Fuller\travis-fuller-1,2015-16,Brown,F,28,0,301,30,68,.441,25,52,.481,5,16,.313,13,39,.333,27,41,68,18,8,6,24,45,78,1.6
5157,Christian Lutete\christian-lutete-1,2015-16,Radford,F,27,2,255,28,81,.346,14,28,.500,14,53,.264,8,12,.667,17,43,60,11,1,2,14,17,78,1.7
5158,Christopher Rozier\christopher-rozier-1,2013-14,Florida A&M,F,27,3,227,28,106,.264,20,68,.294,8,38,.211,14,20,.700,16,45,61,3,6,6,10,36,78,0.9
5159,Jordan Robinson\jordan-robinson-1,2015-16,Duquesne,F,23,1,185,28,52,.538,28,52,.538,0,0,,22,35,.629,19,39,58,7,1,5,12,29,78,2.5
5160,Charles Waters\charles-waters-1,2014-15,Arkansas State,F,25,6,323,31,72,.431,31,70,.443,0,2,.000,16,21,.762,32,52,84,3,14,18,14,58,78,2.7
5161,Rylan Murry\rylan-murry-1,2014-15,Omaha,F,25,0,251,26,58,.448,12,19,.632,14,39,.359,12,18,.667,12,12,24,8,3,3,9,39,78,1.7
5162,Taylor Adway\taylor-adway-1,2016-17,Toledo,F,30,2,205,29,54,.537,29,54,.537,0,0,,20,40,.500,14,36,50,3,2,7,15,33,78,1.5
5163,Josh Ferguson\josh-ferguson-1,2016-17,Winthrop,F,32,1,276,26,59,.441,21,39,.538,5,20,.250,21,27,.778,23,46,69,7,10,17,19,29,78,2.2
5164,Jonathan Graham\jonathan-graham-1,2014-15,Maryland,F,34,7,383,32,60,.533,32,60,.533,0,0,,14,27,.519,36,58,94,5,3,8,16,52,78,1.8
5165,Eugene Omoruyi\eugene-omoruyi-1,2016-17,Rutgers,F,33,11,395,29,82,.354,29,71,.408,0,11,.000,20,32,.625,32,41,73,34,15,9,35,47,78,1.6
5166,Anton Gill\anton-gill-1,2014-15,Louisville,F,31,0,292,30,85,.353,19,42,.452,11,43,.256,7,19,.368,2,23,25,17,15,4,20,32,78,1.0
5167,David Bottenberg\david-bottenberg-1,2017-18,South Carolina State,F,29,8,330,29,64,.453,29,64,.453,0,0,,20,26,.769,24,29,53,8,3,1,8,50,78,1.7
5168,Wadly Mompremier\wadly-mompremier-1,2015-16,Ohio,F,30,0,272,27,49,.551,25,44,.568,2,5,.400,22,46,.478,32,60,92,3,4,34,18,35,78,2.8
5169,Quadri Moore\quadri-moore-1,2016-17,Cincinnati,F,28,1,215,27,78,.346,18,46,.391,9,32,.281,15,19,.789,12,25,37,7,6,3,20,35,78,1.0
5170,Karolis Kundrotas\karolis-kundrotas-1,2017-18,Elon,F,31,2,325,32,63,.508,27,48,.563,5,15,.333,9,13,.692,21,37,58,11,7,6,18,41,78,1.8
5171,Zach McRoberts\zach-mcroberts-1,2017-18,Indiana,F,28,17,613,27,63,.429,14,30,.467,13,33,.394,11,16,.688,35,60,95,33,37,4,18,66,78,3.7
5172,Javier Martinez\javier-martinez-1,2015-16,Tennessee-Martin,F,26,1,207,36,54,.667,36,54,.667,0,0,,6,12,.500,25,25,50,4,1,2,17,29,78,2.1
5173,Paul McRoberts\paul-mcroberts-1,2013-14,Southeast Missouri State,F,13,0,228,31,56,.554,22,32,.688,9,24,.375,6,13,.462,13,15,28,15,15,3,9,32,77,5.1
5174,Jordan Percell\jordan-percell-1,2013-14,Morehead State,F,27,0,332,28,60,.467,26,52,.500,2,8,.250,19,37,.514,24,11,35,9,8,1,9,49,77,1.7
5175,Kyle Meyer\kyle-meyer-1,2015-16,Houston,F,32,22,446,29,66,.439,28,55,.509,1,11,.091,18,27,.667,33,53,86,14,12,20,23,60,77,2.1
5176,Eric Jacobsen\eric-jacobsen-1,2013-14,Arizona State,F,32,15,332,26,53,.491,26,53,.491,0,0,,25,41,.610,28,45,73,9,5,13,21,73,77,1.5
5177,Jarvis Doles\jarvis-doles-1,2017-18,Drexel,F,23,10,296,25,58,.431,11,19,.579,14,39,.359,13,16,.813,10,38,48,3,4,1,7,32,77,2.2
5178,Tyler Wideman\tyler-wideman-1,2014-15,Butler,F,34,5,371,30,56,.536,30,56,.536,0,0,,17,41,.415,32,57,89,15,9,15,22,62,77,1.9
5179,Loomis Gerring\loomis-gerring-1,2015-16,Missouri State,F,26,2,276,28,86,.326,24,66,.364,4,20,.200,17,25,.680,17,35,52,4,7,5,22,42,77,0.8
5180,John Davis\john-davis-4,2013-14,Towson,F,24,0,206,32,59,.542,32,59,.542,0,0,,13,23,.565,30,37,67,2,4,6,6,33,77,2.8
5181,Hassan Hussein\hassan-hussein-1,2016-17,Florida International,F,23,1,235,35,58,.603,34,53,.642,1,5,.200,6,15,.400,15,24,39,3,4,7,8,44,77,2.2
5182,Devontae Watson\devontae-watson-1,2013-14,Temple,F,31,17,423,32,72,.444,32,72,.444,0,0,,13,26,.500,37,77,114,8,10,34,16,66,77,2.6
5183,Jarriesse Blackmon\jarriesse-blackmon-1,2016-17,UC-Santa Barbara,F,18,8,265,33,68,.485,31,64,.484,2,4,.500,9,26,.346,28,29,57,11,7,10,14,27,77,3.4
5184,Marcus Bryan\marcus-bryan-1,2016-17,North Carolina-Wilmington,F,35,0,314,28,54,.519,28,54,.519,0,0,,21,42,.500,37,56,93,7,6,14,14,67,77,1.8
5185,Austin Budke\austin-budke-1,2015-16,Kansas State,F,33,1,430,21,55,.382,19,44,.432,2,11,.182,33,44,.750,21,46,67,13,8,3,20,70,77,1.3
5186,Reed Nikko\reed-nikko-1,2017-18,Missouri,F,33,0,267,28,51,.549,28,51,.549,0,0,,21,40,.525,22,45,67,6,5,22,16,37,77,2.0
5187,Justin Alston\justin-alston-1,2013-14,Boston University,F,28,0,242,34,53,.642,34,53,.642,0,0,,9,12,.750,18,31,49,4,7,7,15,53,77,1.9
5188,Donte Thomas\donte-thomas-1,2014-15,Bradley,F,31,5,369,30,91,.330,21,52,.404,9,39,.231,8,20,.400,20,56,76,19,9,7,32,53,77,0.8
5189,Davante Drinkard\davante-drinkard-1,2013-14,Southern Illinois,F,33,19,507,31,76,.408,31,76,.408,0,0,,15,27,.556,26,39,65,14,7,19,35,59,77,1.0
5190,Evan Cole\evan-cole-1,2017-18,Georgia Tech,F,24,7,332,29,63,.460,23,41,.561,6,22,.273,13,26,.500,18,44,62,11,7,8,15,44,77,2.2
5191,LaDarien Griffin\ladarien-griffin-1,2016-17,St. Bonaventure,F,29,2,357,30,57,.526,29,53,.547,1,4,.250,16,30,.533,25,40,65,18,20,12,22,48,77,2.5
5192,Riley Payne\riley-payne-1,2014-15,Abilene Christian,F,30,17,438,33,72,.458,33,72,.458,0,0,,11,28,.393,26,28,54,8,4,1,12,65,77,1.1
5193,Jack Whitman\jack-whitman-1,2015-16,William & Mary,F,23,0,299,30,55,.545,30,55,.545,0,0,,17,32,.531,24,39,63,10,4,19,14,60,77,2.6
5194,Isaiah Whaley\isaiah-whaley-1,2017-18,Connecticut,F,30,12,414,29,52,.558,29,52,.558,0,0,,19,28,.679,34,33,67,10,11,30,12,47,77,3.0
5195,Allan Chaney\allan-chaney-2,2013-14,High Point,F,5,5,119,33,52,.635,33,46,.717,0,6,.000,11,13,.846,8,35,43,2,5,2,10,10,77,12.6
5196,Alex Fountain\alex-fountain-1,2014-15,Houston Baptist,F,22,1,299,30,79,.380,25,62,.403,5,17,.294,12,15,.800,21,23,44,11,6,1,13,25,77,2.1
5197,Fallou Ndoye\fallou-ndoye-1,2016-17,Cal State Bakersfield,F,24,4,264,32,72,.444,32,71,.451,0,1,.000,12,30,.400,19,42,61,3,2,8,29,55,76,0.7
5198,Patrick Smith\patrick-smith-1,2016-17,Southern,F,27,11,293,31,62,.500,29,56,.518,2,6,.333,12,21,.571,18,38,56,6,8,3,30,50,76,1.1
5199,Terry Brutus\terry-brutus-1,2016-17,Samford,F,29,3,304,26,64,.406,26,59,.441,0,5,.000,24,35,.686,12,50,62,12,10,3,26,45,76,1.3
5200,Hayden Farquhar\hayden-farquhar-1,2015-16,Abilene Christian,F,30,1,250,31,71,.437,23,44,.523,8,27,.296,6,16,.375,14,35,49,10,7,1,17,39,76,1.2
5201,Henry Caruso\henry-caruso-1,2016-17,Princeton,F,8,8,178,32,63,.508,26,45,.578,6,18,.333,6,7,.857,9,26,35,6,9,0,14,7,76,6.9
5202,Christian Robertson\christian-robertson-1,2017-18,Arkansas-Pine Bluff,F,35,8,412,29,77,.377,29,70,.414,0,7,.000,18,31,.581,23,31,54,15,7,0,19,37,76,1.1
5203,J.C. Washington\jc-washington-1,2014-15,Houston,F,27,4,457,33,74,.446,31,72,.431,2,2,1.000,8,19,.421,36,47,83,11,11,11,19,66,76,2.0
5204,Davin Guinn\davin-guinn-2,2016-17,Brigham Young,F,33,1,431,26,78,.333,14,39,.359,12,39,.308,12,19,.632,30,40,70,17,21,2,13,46,76,2.0
5205,Mitch McGary\mitch-mcgary-1,2013-14,Michigan,F,8,4,198,30,55,.545,30,53,.566,0,2,.000,16,24,.667,23,43,66,12,15,6,13,25,76,10.0
5206,Ty'Quan Bitting\tyquan-bitting-1,2013-14,Charleston Southern,F,23,1,190,31,45,.689,31,45,.689,0,0,,14,32,.438,16,31,47,3,4,16,8,30,76,2.9
5207,Japhet Kadji\japhet-kadji-1,2014-15,Wagner,F,24,5,255,29,61,.475,22,44,.500,7,17,.412,11,16,.688,19,41,60,5,7,6,9,48,76,2.3
5208,Adrian Brown\adrian-brown-2,2016-17,McNeese State,F,26,3,273,28,57,.491,27,55,.491,1,2,.500,19,29,.655,13,31,44,3,8,8,21,43,76,1.5
5209,Leroy Butts IV\leroy-buttsiv-1,2017-18,Radford,F,34,1,255,32,65,.492,26,46,.565,6,19,.316,6,15,.400,16,39,55,7,9,1,14,17,76,1.7
5210,Derrick Randall\derrick-randall-1,2013-14,Pittsburgh,F,36,1,309,31,55,.564,31,55,.564,0,0,,14,31,.452,40,46,86,1,8,15,14,49,76,2.0
5211,Jalen Williams\jalen-williams-1,2016-17,Furman,F,29,0,249,22,53,.415,22,53,.415,0,0,,32,40,.800,32,34,66,9,4,13,29,49,76,1.7
5212,Ariston Johnson\ariston-johnson-1,2016-17,Alabama A&M,F,29,4,440,25,90,.278,19,71,.268,6,19,.316,20,27,.741,4,31,35,33,9,0,33,47,76,0.4
5213,Willem Brandwijk\willem-brandwijk-1,2014-15,Siena,F,31,12,396,27,65,.415,18,45,.400,9,20,.450,13,25,.520,26,55,81,12,21,14,22,55,76,2.1
5214,Keanu Pinder\keanu-pinder-1,2016-17,Arizona,F,35,1,421,28,53,.528,27,49,.551,1,4,.250,19,33,.576,32,68,100,11,16,22,29,69,76,2.0
5215,Ryan King\ryan-king-1,2013-14,Northwestern State,F,25,0,287,33,58,.569,33,58,.569,0,0,,10,25,.400,24,42,66,2,5,17,15,29,76,2.5
5216,Kene Chukwuka\kene-chukwuka-1,2017-18,Pittsburgh,F,31,13,528,27,76,.355,18,29,.621,9,47,.191,13,30,.433,27,57,84,26,16,13,28,79,76,1.5
5217,Harrison Meads\harrison-meads-1,2017-18,Pepperdine,F,23,2,300,31,51,.608,31,51,.608,0,0,,14,22,.636,18,30,48,1,5,5,11,40,76,2.3
5218,Cameron Jackson\cameron-jackson-1,2014-15,Wofford,F,32,0,265,30,53,.566,30,53,.566,0,0,,16,21,.762,15,37,52,7,11,12,11,48,76,2.0
5219,Odera Nweke\odera-nweke-1,2013-14,NJIT,F,22,12,380,27,56,.482,27,55,.491,0,1,.000,22,34,.647,25,63,88,14,12,8,17,55,76,3.1
5220,Angel Nunez\angel-nunez-1,2014-15,Gonzaga,F,28,1,176,27,46,.587,22,31,.710,5,15,.333,17,26,.654,13,39,52,15,3,8,15,26,76,2.3
5221,Dan Jech\dan-jech-1,2017-18,South Dakota,F,23,0,165,29,48,.604,29,45,.644,0,3,.000,17,22,.773,15,26,41,7,2,3,9,26,75,2.6
5222,Eral Penn\eral-penn-1,2017-18,Long Island University,F,32,1,307,27,35,.771,27,35,.771,0,0,,21,42,.500,32,56,88,5,10,24,10,55,75,2.8
5223,Kameron Hankerson\kameron-hankerson-1,2016-17,Green Bay,F,24,0,193,30,60,.500,21,36,.583,9,24,.375,6,7,.857,6,12,18,12,7,4,12,34,75,1.9
5224,Keanu Pinder\keanu-pinder-1,2017-18,Arizona,F,32,0,334,27,39,.692,27,39,.692,0,0,,21,34,.618,15,52,67,3,9,16,13,62,75,2.0
5225,Adrian Edwards\adrian-edwards-1,2015-16,Alabama A&M,F,29,2,362,32,92,.348,32,89,.360,0,3,.000,11,17,.647,31,43,74,12,9,3,14,55,75,1.3
5226,Calvin Martin\calvin-martin-1,2017-18,Sacramento State,F,28,4,330,27,56,.482,27,56,.482,0,0,,21,34,.618,35,46,81,3,12,4,19,72,75,1.7
5227,Luke McDonnell\luke-mcdonnell-1,2016-17,Northern Iowa,F,22,0,215,26,54,.481,18,31,.581,8,23,.348,15,22,.682,18,33,51,4,6,10,18,25,75,2.5
5228,Blake Paul\blake-paul-1,2015-16,Tulane,F,33,1,368,29,53,.547,29,53,.547,0,0,,17,30,.567,35,46,81,2,5,30,20,71,75,1.9
5229,Charles Ieans\charles-ieans-1,2013-14,Coppin State,F,26,8,291,30,64,.469,25,46,.543,5,18,.278,10,19,.526,17,31,48,11,5,4,13,48,75,1.7
5230,Daniel Gomis\daniel-gomis-1,2013-14,Oregon State,F,32,2,344,31,52,.596,31,52,.596,0,0,,13,30,.433,35,46,81,9,6,31,30,72,75,1.8
5231,Austin Etherington\austin-etherington-1,2014-15,Butler,F,32,0,392,26,68,.382,16,30,.533,10,38,.263,13,14,.929,18,49,67,17,9,3,22,67,75,1.2
5232,Weisner Perez\weisner-perez-1,2015-16,Harvard,F,29,1,246,26,68,.382,22,54,.407,4,14,.286,19,27,.704,24,39,63,4,2,3,13,27,75,1.6
5233,Josh Smith\josh-smith-2,2014-15,Clemson,F,31,0,296,26,50,.520,26,50,.520,0,0,,23,37,.622,30,54,84,4,7,6,17,29,75,2.2
5234,Chuck Ogbodo\chuck-ogbodo-1,2014-15,North Carolina-Wilmington,F,30,4,361,31,50,.620,31,50,.620,0,0,,13,19,.684,35,61,96,3,11,25,20,55,75,2.7
5235,Dwayne Morgan\dwayne-morgan-1,2016-17,Nevada-Las Vegas,F,9,6,193,28,70,.400,27,63,.429,1,7,.143,18,32,.563,12,47,59,5,7,11,18,33,75,4.6
5236,Jordan Session\jordan-session-1,2015-16,Georgia State,F,29,7,273,32,78,.410,31,75,.413,1,3,.333,10,17,.588,14,32,46,8,11,6,15,41,75,1.4
5237,Elias Desport\elias-desport-1,2014-15,Saint Peter's,F,34,0,498,27,71,.380,27,70,.386,0,1,.000,21,31,.677,30,44,74,13,11,19,31,78,75,1.1
5238,Dane Norman\dane-norman-1,2016-17,Air Force,F,21,2,223,25,57,.439,16,39,.410,9,18,.500,16,20,.800,27,32,59,9,3,2,17,37,75,2.4
5239,Deividas Zemgulis\deividas-zemgulis-1,2015-16,Penn State,F,26,1,318,26,68,.382,16,28,.571,10,40,.250,13,19,.684,20,24,44,8,4,0,13,20,75,1.7
5240,BeeJay Anya\beejay-anya-1,2016-17,North Carolina State,F,27,10,347,28,52,.538,28,52,.538,0,0,,19,43,.442,20,48,68,11,3,33,19,56,75,2.3
5241,JaMarkus Horace\jamarkus-horace-1,2014-15,Nicholls State,F,29,0,316,33,71,.465,33,71,.465,0,0,,9,27,.333,26,31,57,15,6,11,33,59,75,0.9
5242,Jamee Crockett\jamee-crockett-1,2013-14,DePaul,F,19,1,278,23,91,.253,9,39,.231,14,52,.269,14,21,.667,8,19,27,9,9,2,15,26,74,1.0
5243,Jalen Morgan\jalen-morgan-1,2015-16,Western Illinois,F,25,0,241,30,53,.566,30,52,.577,0,1,.000,14,21,.667,15,33,48,6,7,4,13,41,74,2.0
5244,Omar El Manasterly\omar-el-manasterly-1,2015-16,Jacksonville,F,31,10,363,25,54,.463,25,54,.463,0,0,,24,35,.686,34,62,96,9,8,2,12,58,74,2.1
5245,Mikhail McLean\mikhail-mclean-1,2013-14,Houston,F,28,16,317,26,53,.491,26,53,.491,0,0,,22,38,.579,19,31,50,4,9,6,14,42,74,1.7
5246,Kenneth Hall\kenny-hall-2,2014-15,Western Carolina,F,32,5,443,30,62,.484,30,62,.484,0,0,,14,22,.636,27,48,75,21,7,23,20,79,74,1.8
5247,Kyle Doyle\kyle-doyle-1,2014-15,Georgia Southern,F,29,5,352,31,74,.419,30,70,.429,1,4,.250,11,29,.379,29,38,67,10,10,13,29,51,74,1.2
5248,Kyle Mallers\kyle-mallers-1,2016-17,Ball State,F,34,3,379,22,71,.310,4,19,.211,18,52,.346,12,16,.750,21,34,55,16,8,7,15,40,74,1.5
5249,Khalil Fuller\khalil-fuller-1,2015-16,North Texas,F,31,12,304,28,59,.475,28,58,.483,0,1,.000,18,44,.409,32,36,68,2,3,0,24,41,74,1.0
5250,Darelle Porter\darelle-porter-2,2016-17,St. Francis (NY),F,26,2,267,27,85,.318,19,52,.365,8,33,.242,12,19,.632,21,37,58,8,15,10,15,35,74,1.8
5251,Tavario Miller\tavario-miller-1,2015-16,Texas A&M,F,36,1,387,24,54,.444,24,54,.444,0,0,,26,48,.542,43,89,132,12,10,12,30,62,74,1.8
5252,Richard Laku\richard-laku-1,2016-17,McNeese State,F,26,0,222,24,71,.338,9,24,.375,15,47,.319,11,15,.733,21,17,38,2,6,5,10,36,74,1.5
5253,Jabari Alex\jabari-alex-1,2014-15,Mississippi Valley State,F,20,5,364,34,59,.576,34,58,.586,0,1,.000,6,11,.545,24,51,75,9,11,9,23,48,74,2.9
5254,Stephen Lennox\stephen-lennox-1,2015-16,Idaho State,F,27,4,273,23,66,.348,11,32,.344,12,34,.353,16,24,.667,15,55,70,4,2,5,9,30,74,1.8
5255,Brandon Perry\brandon-perry-2,2015-16,San Diego,F,13,0,177,25,47,.532,25,47,.532,0,0,,24,51,.471,22,25,47,7,3,6,21,37,74,3.0
5256,Michael Obacha\michael-obacha-1,2014-15,Appalachian State,F,25,23,393,24,49,.490,24,49,.490,0,0,,26,41,.634,33,55,88,14,6,2,24,50,74,2.2
5257,Justus Stanback\justus-stanback-1,2014-15,IUPUI,F,31,15,274,37,71,.521,37,69,.536,0,2,.000,0,1,.000,7,29,36,7,9,7,23,37,74,1.1
5258,Kyle Meyer\kyle-meyer-1,2016-17,Houston,F,32,18,527,29,65,.446,27,52,.519,2,13,.154,14,27,.519,55,61,116,19,9,13,18,79,74,2.3
5259,Branden Sheppard\branden-sheppard-1,2015-16,Louisiana Tech,F,31,11,411,35,52,.673,35,52,.673,0,0,,4,18,.222,33,42,75,8,10,7,17,44,74,2.2
5260,Michael Hutchins\michael-hutchins-1,2014-15,Alabama A&M,F,29,21,436,25,71,.352,16,33,.485,9,38,.237,15,20,.750,20,48,68,18,4,5,16,73,74,1.2
5261,Malik Toppin\malik-toppin-1,2015-16,Central Connecticut State,F,23,2,227,32,59,.542,32,58,.552,0,1,.000,10,19,.526,16,29,45,5,3,17,9,36,74,2.5
5262,Ugo Mmonu\ugo-mmonu-1,2015-16,Charleston Southern,F,18,0,202,26,43,.605,23,36,.639,3,7,.429,19,26,.731,23,42,65,0,6,7,18,42,74,3.1
5263,Bennett Holley\bennett-holley-1,2015-16,Appalachian State,F,25,0,232,23,54,.426,6,11,.545,17,43,.395,11,14,.786,9,19,28,7,0,2,9,34,74,1.6
5264,Chad Rykhoek\chad-rykhoek-1,2016-17,Memphis,F,15,13,212,31,57,.544,31,55,.564,0,2,.000,12,34,.353,12,22,34,11,5,8,16,38,74,2.7
5265,Maljhum McCrea\maljhum-mccrea-1,2015-16,Texas State,F,28,3,254,32,78,.410,32,75,.427,0,3,.000,10,30,.333,25,41,66,6,1,8,23,47,74,0.8
5266,Kevin Degnan\kevin-degnan-1,2015-16,Fairfield,F,24,0,175,30,62,.484,17,33,.515,13,29,.448,1,6,.167,6,33,39,6,4,6,5,21,74,2.2
5267,Kevin Senghore-Peterson\kevin-senghore-peterson-1,2017-18,Fairfield,F,24,0,354,26,58,.448,20,41,.488,6,17,.353,16,34,.471,24,46,70,11,1,9,15,40,74,2.1
5268,Keon Williams\keon-williams-2,2015-16,St. Francis (NY),F,28,8,485,26,71,.366,15,31,.484,11,40,.275,11,19,.579,25,42,67,11,16,5,19,38,74,2.0
5269,Armani Flannigan\armani-flannigan-1,2013-14,North Texas,F,31,11,311,31,56,.554,31,55,.564,0,1,.000,12,42,.286,23,41,64,4,7,30,17,31,74,2.1
5270,Stephen Domingo\stephen-domingo-1,2016-17,University of California,F,31,4,419,23,106,.217,10,35,.286,13,71,.183,15,33,.455,13,53,66,18,10,11,6,50,74,1.0
5271,Will Magarity\will-magarity-1,2013-14,Boston College,F,30,8,316,29,58,.500,26,46,.565,3,12,.250,13,21,.619,21,21,42,12,7,8,17,53,74,1.5
5272,Patrick Kirksey\patrick-kirksey-1,2013-14,South Carolina State,F,27,1,274,21,57,.368,21,57,.368,0,0,,32,74,.432,16,42,58,4,10,1,18,25,74,1.3
5273,Chaed Wellian\chaed-wellian-1,2013-14,Tennessee State,F,25,2,224,29,51,.569,17,22,.773,12,29,.414,3,4,.750,8,28,36,4,5,2,12,31,73,1.9
5274,Christopher Morgan\christopher-morgan-1,2014-15,Holy Cross,F,27,0,283,31,47,.660,31,47,.660,0,0,,11,17,.647,15,27,42,1,2,5,11,43,73,1.7
5275,Zigmars Raimo\zigmars-raimo-1,2016-17,Hawaii,F,28,0,346,26,67,.388,26,60,.433,0,7,.000,21,37,.568,27,28,55,15,12,6,22,45,73,1.6
5276,Cory Kilby\cory-kilby-1,2015-16,Mercer,F,34,0,277,28,68,.412,20,41,.488,8,27,.296,9,13,.692,17,37,54,11,2,5,14,29,73,1.3
5277,Bronson Verhines\bronson-verhines-1,2013-14,Southern Illinois,F,27,8,366,32,61,.525,32,61,.525,0,0,,9,16,.563,23,53,76,8,6,8,13,59,73,2.0
5278,Roman Sorkin\roman-sorkin-1,2016-17,Oregon,F,23,0,184,24,53,.453,14,32,.438,10,21,.476,15,16,.938,18,25,43,12,0,8,8,21,73,2.7
5279,David Cole\david-cole-2,2017-18,Robert Morris,F,32,11,342,25,59,.424,25,59,.424,0,0,,23,37,.622,26,26,52,3,7,4,21,77,73,0.7
5280,John Edgar Jr.\john-edgarjr-1,2016-17,UC-Irvine,F,34,2,268,29,66,.439,20,34,.588,9,32,.281,6,9,.667,16,30,46,8,4,0,15,34,73,1.1
5281,Jai Williams\jai-williams-1,2016-17,Saint Joseph's,F,27,0,289,26,41,.634,26,41,.634,0,0,,21,34,.618,23,36,59,1,5,3,17,39,73,1.9
5282,Ezra Talbert\ezra-talbert-1,2016-17,Liberty,F,31,1,224,26,56,.464,14,30,.467,12,26,.462,9,15,.600,14,19,33,3,3,5,10,42,73,1.3
5283,Anthony Silvestri\anthony-silvestri-1,2013-14,Cal Poly,F,29,1,246,25,66,.379,4,4,1.000,21,62,.339,2,6,.333,8,20,28,2,5,1,3,45,73,1.1
5284,O'Karo Akamune\okaro-akamune-1,2013-14,Western Kentucky,F,18,3,307,29,54,.537,29,54,.537,0,0,,15,39,.385,34,56,90,14,10,8,13,46,73,4.0
5285,Pete Miller\pete-miller-1,2013-14,Princeton,F,29,0,303,32,69,.464,32,69,.464,0,0,,9,31,.290,26,42,68,20,10,23,27,45,73,1.9
5286,Matthew Temple\matthew-temple-1,2016-17,Texas Tech,F,32,2,257,26,53,.491,18,33,.545,8,20,.400,13,17,.765,15,21,36,12,1,6,21,54,73,1.0
5287,Rui Hachimura\rui-hachimura-1,2016-17,Gonzaga,F,28,0,130,28,53,.528,24,39,.615,4,14,.286,13,24,.542,12,25,37,2,6,4,8,16,73,1.9
5288,Gabriel Aguirre\gabriel-aguirre-1,2013-14,Pacific,F,28,0,252,23,34,.676,23,33,.697,0,1,.000,27,39,.692,17,32,49,6,6,3,11,43,73,2.1
5289,Davon Clare\davon-clare-1,2016-17,Cal State Fullerton,F,29,2,385,29,80,.363,26,58,.448,3,22,.136,12,23,.522,19,68,87,25,15,14,22,34,73,2.2
5290,Manny Suarez\manny-suarez-1,2017-18,Creighton,F,24,0,180,29,65,.446,24,45,.533,5,20,.250,10,15,.667,16,46,62,9,1,13,11,32,73,2.3
5291,Austin Torres\austin-torres-1,2017-18,Notre Dame,F,31,5,330,33,52,.635,33,52,.635,0,0,,7,20,.350,23,47,70,12,11,10,17,51,73,2.1
5292,David Howard\david-howard-1,2014-15,Evansville,F,25,0,163,25,46,.543,25,46,.543,0,0,,23,41,.561,11,17,28,3,3,4,3,33,73,1.9
5293,Scott King\scott-king-1,2015-16,Fairfield,F,24,5,258,32,72,.444,26,48,.542,6,24,.250,3,5,.600,3,41,44,16,4,8,12,53,73,1.5
5294,Fred Iruafemi\fred-iruafemi-1,2017-18,Virginia Military Institute,F,30,3,469,31,61,.508,31,61,.508,0,0,,11,22,.500,43,67,110,12,23,40,30,87,73,2.8
5295,Max Hoetzel\max-hoetzel-1,2014-15,Indiana,F,31,0,240,24,56,.429,14,27,.519,10,29,.345,15,21,.714,10,31,41,10,4,3,13,32,73,1.4
5296,Sidney Umude\sidney-umude-1,2014-15,Youngstown State,F,22,0,227,24,51,.471,24,49,.490,0,2,.000,25,48,.521,18,27,45,10,8,5,20,32,73,2.0
5297,Aaron Jones\aaron-jones-1,2014-15,Mississippi,F,24,1,309,27,57,.474,27,56,.482,0,1,.000,19,23,.826,24,36,60,9,14,18,13,41,73,3.1
5298,Nikola Marijan\nikola-marijan-1,2015-16,South Alabama,F,32,11,392,28,67,.418,28,67,.418,0,0,,17,34,.500,33,47,80,8,9,16,36,95,73,0.6
5299,Eric Adams\eric-adams-2,2016-17,Samford,F,30,2,255,25,47,.532,25,47,.532,0,0,,23,36,.639,31,54,85,7,8,17,20,45,73,2.3
5300,Maljhum McCrea\maljhum-mccrea-1,2016-17,Texas State,F,13,13,219,33,67,.493,33,66,.500,0,1,.000,7,13,.538,21,26,47,7,3,10,13,40,73,3.5
5301,Jermaine Ukaegbu\jermaine-ukaegbu-1,2017-18,Winthrop,F,29,7,352,27,42,.643,27,42,.643,0,0,,19,41,.463,35,64,99,15,5,19,22,68,73,2.4
5302,Dante Bailey\dante-bailey-1,2016-17,Tennessee-Martin,F,29,3,223,24,68,.353,9,17,.529,15,51,.294,10,14,.714,7,23,30,8,2,2,10,21,73,1.2
5303,Daniel Meyer\daniel-meyer-2,2017-18,Omaha,F,27,9,290,33,78,.423,33,77,.429,0,1,.000,6,27,.222,26,33,59,12,3,4,18,37,72,1.2
5304,Luke Devlin\luke-devlin-1,2013-14,Albany (NY),F,30,1,391,31,63,.492,31,63,.492,0,0,,10,21,.476,21,52,73,21,10,6,15,30,72,2.3
5305,Pierre Sarr\pierre-sarr-1,2017-18,Monmouth,F,23,4,224,21,41,.512,15,29,.517,6,12,.500,24,34,.706,15,50,65,12,9,6,23,36,72,2.5
5306,Jermaine Lawrence\jermaine-lawrence-1,2013-14,Cincinnati,F,26,0,391,28,84,.333,28,84,.333,0,0,,16,34,.471,32,43,75,13,7,16,27,58,72,1.1
5307,Jordan Martin\jordan-martin-2,2016-17,Missouri State,F,32,6,290,26,49,.531,26,49,.531,0,0,,20,40,.500,21,38,59,2,11,11,22,68,72,1.2
5308,Yalim Olcay\yalim-olcay-1,2016-17,Western Carolina,F,28,6,316,29,60,.483,29,59,.492,0,1,.000,14,29,.483,22,42,64,2,4,2,23,63,72,0.8
5309,Winslo Barry\winslo-barry-1,2013-14,Incarnate Word,F,26,7,223,31,61,.508,31,61,.508,0,0,,10,32,.313,27,49,76,3,2,13,8,37,72,2.2
5310,Shane Henry\shane-henry-1,2014-15,Virginia Tech,F,31,16,318,31,73,.425,31,73,.425,0,0,,10,22,.455,26,58,84,3,8,28,21,53,72,1.7
5311,Steve Smith\steve-smith-6,2013-14,Fairfield,F,27,1,264,22,74,.297,1,4,.250,21,70,.300,7,8,.875,8,20,28,5,3,2,11,20,72,1.1
5312,Adonis Rwabigwi\adonis-rwabigwi-1,2015-16,Texas-Rio Grande Valley,F,29,0,286,26,52,.500,26,51,.510,0,1,.000,20,36,.556,21,45,66,4,7,9,23,56,72,1.3
5313,Julius Rajala\julius-rajala-1,2015-16,Loyola (IL),F,30,11,301,32,49,.653,32,49,.653,0,0,,8,14,.571,22,33,55,9,8,12,22,53,72,1.8
5314,Jordan Naughton\jordan-naughton-1,2015-16,Wyoming,F,24,0,270,26,33,.788,26,33,.788,0,0,,20,41,.488,19,27,46,0,5,6,10,37,72,2.4
5315,Deshon Bayless\deshon-bayless-1,2015-16,Arkansas-Pine Bluff,F,15,5,273,25,70,.357,17,47,.362,8,23,.348,14,24,.583,9,21,30,9,12,0,14,48,72,1.8
5316,Evan Clayborne\evan-clayborne-1,2017-18,Cleveland State,F,24,1,240,32,63,.508,32,63,.508,0,0,,8,19,.421,22,28,50,3,6,16,25,48,72,1.5
5317,Anthony Lee\anthony-lee-1,2014-15,Ohio State,F,21,6,230,31,50,.620,31,50,.620,0,0,,10,19,.526,16,32,48,3,1,8,13,37,72,2.3
5318,Charles Thomas IV\charles-thomasiv-1,2015-16,Wisconsin,F,31,0,282,27,73,.370,23,58,.397,4,15,.267,14,30,.467,21,42,63,3,6,12,5,33,72,1.6
5319,Akiean Frederick\akiean-frederick-1,2017-18,Kent State,F,25,4,251,28,51,.549,26,43,.605,2,8,.250,14,23,.609,22,27,49,8,6,7,19,46,72,1.9
5320,Quate McKinzie\quate-mckinzie-1,2016-17,Buffalo,F,17,1,260,28,44,.636,19,27,.704,9,17,.529,7,11,.636,19,53,72,10,7,12,9,44,72,4.5
5321,Nick McGlynn\nick-mcglynn-1,2015-16,Drake,F,30,0,305,25,53,.472,25,53,.472,0,0,,22,35,.629,21,57,78,10,4,15,19,56,72,1.7
5322,Chandler Rowe\chandler-rowe-1,2015-16,Tennessee-Martin,F,32,11,395,26,50,.520,24,46,.522,2,4,.500,18,37,.486,34,57,91,13,12,6,21,66,72,1.8
5323,Jarad Scott\jarad-scott-1,2013-14,Winthrop,F,30,1,281,27,58,.466,24,43,.558,3,15,.200,15,32,.469,15,52,67,6,3,8,15,39,72,1.5
5324,Cassidy Ryan\cassidy-ryan-1,2015-16,Canisius,F,28,0,196,29,65,.446,19,41,.463,10,24,.417,4,7,.571,10,21,31,9,7,2,12,36,72,1.4
5325,Brandon Mitchell\brandon-mitchell-2,2013-14,San Jose State,F,30,3,366,21,61,.344,18,47,.383,3,14,.214,27,37,.730,26,55,81,6,10,9,18,60,72,1.6
5326,Anthony Perez\anthony-perez-1,2014-15,Mississippi,F,27,0,290,21,73,.288,8,29,.276,13,44,.295,16,27,.593,24,29,53,6,8,4,13,25,71,1.5
5327,A.J. Avery\aj-avery-1,2014-15,Western Michigan,F,28,0,289,23,60,.383,23,60,.383,0,0,,25,41,.610,37,45,82,4,4,16,16,43,71,2.0
5328,Jordan Session\jordan-session-1,2014-15,Georgia State,F,32,0,208,28,51,.549,27,50,.540,1,1,1.000,14,25,.560,12,26,38,7,6,8,12,32,71,1.6
5329,Juwan Morgan\juwan-morgan-1,2015-16,Indiana,F,30,0,273,21,41,.512,16,30,.533,5,11,.455,24,30,.800,23,41,64,5,9,11,15,41,71,2.2
5330,Jehyve Floyd\jehyve-floyd-1,2016-17,Holy Cross,F,31,3,374,30,55,.545,30,54,.556,0,1,.000,11,18,.611,17,34,51,25,17,25,25,63,71,2.1
5331,Matt Freeman\matt-freeman-1,2016-17,Oklahoma,F,26,2,231,25,67,.373,11,24,.458,14,43,.326,7,8,.875,8,31,39,6,6,4,15,19,71,1.5
5332,Coye Simmons\coye-simmons-1,2017-18,Georgia Southern,F,33,7,387,26,59,.441,26,58,.448,0,1,.000,19,25,.760,51,73,124,7,6,1,16,66,71,2.0
5333,Will Miller\will-miller-2,2016-17,Virginia Military Institute,F,30,2,320,29,59,.492,27,44,.614,2,15,.133,11,23,.478,17,23,40,14,10,6,13,39,71,1.7
5334,Evan Bailey\evan-bailey-1,2016-17,College of Charleston,F,32,2,305,20,68,.294,3,13,.231,17,55,.309,14,19,.737,8,39,47,7,4,0,11,37,71,0.9
5335,Julius Van Sauers\julius-vansauers-1,2017-18,Long Island University,F,35,22,392,25,49,.510,16,28,.571,9,21,.429,12,19,.632,23,55,78,10,8,4,21,76,71,1.2
5336,Alex Floresca\alex-floresca-1,2015-16,San Diego,F,28,0,310,23,41,.561,23,41,.561,0,0,,25,36,.694,20,31,51,13,2,2,23,49,71,1.4
5337,Maurice Taylor\maurice-taylor-4,2015-16,Niagara,F,32,2,378,27,60,.450,25,55,.455,2,5,.400,15,34,.441,35,59,94,4,9,8,33,49,71,1.2
5338,Aaron Weidenaar\aaron-weidenaar-1,2016-17,Central Arkansas,F,28,3,288,24,82,.293,6,12,.500,18,70,.257,5,10,.500,10,27,37,11,4,1,10,39,71,0.8
5339,Trey Carver\trey-carver-1,2017-18,Hampton,F,29,0,254,24,53,.453,24,51,.471,0,2,.000,23,33,.697,21,24,45,3,8,1,11,31,71,1.7
5340,Makhtar Gueye\makhtar-gueye-1,2017-18,Alabama-Birmingham,F,32,1,303,29,61,.475,24,38,.632,5,23,.217,8,12,.667,13,38,51,7,1,4,20,48,71,0.9
5341,Anas Mahmoud\anas-mahmoud-1,2015-16,Louisville,F,22,2,288,29,62,.468,29,62,.468,0,0,,13,33,.394,25,40,65,12,11,29,17,36,71,3.1
5342,James Bourne\james-bourne-1,2015-16,College of Charleston,F,21,1,316,25,42,.595,25,41,.610,0,1,.000,21,41,.512,28,23,51,7,3,3,21,44,71,2.0
5343,Chris Baldwin\chris-baldwin-1,2016-17,Massachusetts,F,32,1,301,32,69,.464,32,66,.485,0,3,.000,7,12,.583,29,60,89,9,4,15,20,42,71,1.7
5344,Matthew McCarthy\matthew-mccarthy-1,2015-16,San Francisco,F,30,0,407,31,84,.369,31,72,.431,0,12,.000,9,24,.375,44,67,111,12,10,5,20,49,71,1.7
5345,Eric Hamilton\eric-hamilton-1,2015-16,Wichita State,F,21,0,136,23,44,.523,19,33,.576,4,11,.364,21,32,.656,10,25,35,2,1,4,9,15,71,2.4
5346,Alex Illikainen\alex-illikainen-1,2015-16,Wisconsin,F,33,0,324,26,63,.413,17,35,.486,9,28,.321,10,15,.667,16,33,49,13,5,3,11,33,71,1.5
5347,David Jesperson\david-jesperson-1,2016-17,Green Bay,F,30,0,258,24,52,.462,16,27,.593,8,25,.320,15,20,.750,8,40,48,11,10,3,14,35,71,1.7
5348,Calvin Crawford\calvin-crawford-1,2014-15,Manhattan,F,30,1,234,27,75,.360,19,41,.463,8,34,.235,9,16,.563,14,32,46,7,8,4,15,25,71,1.2
5349,Basil Thompson\basil-thompson-1,2014-15,Saint Francis (PA),F,23,3,242,26,66,.394,23,44,.523,3,22,.136,16,23,.696,16,33,49,4,8,7,14,35,71,1.8
5350,Dakota Quinn\dakota-quinn-1,2015-16,Samford,F,27,0,204,32,58,.552,32,56,.571,0,2,.000,7,15,.467,11,38,49,3,6,15,13,41,71,1.8
5351,Mrdjan Gasevic\mrdjan-gasevic-1,2015-16,Delaware State,F,28,5,284,27,69,.391,27,69,.391,0,0,,17,32,.531,26,41,67,16,4,6,20,36,71,1.5
5352,Mangok Mathiang\mangok-mathiang-1,2015-16,Louisville,F,10,2,188,27,48,.563,27,48,.563,0,0,,17,29,.586,26,31,57,5,7,12,11,22,71,7.0
5353,Houston Kessler\houston-kessler-1,2015-16,Georgia,F,34,14,535,30,80,.375,28,60,.467,2,20,.100,9,15,.600,38,56,94,9,10,13,24,69,71,1.2
5354,Dominik Heinzl\dominik-heinzl-1,2017-18,Cal State Fullerton,F,30,5,303,29,51,.569,29,51,.569,0,0,,13,18,.722,15,36,51,4,6,5,21,38,71,1.4
5355,Davis Francis\davis-francis-1,2017-18,Bethune-Cookman,F,26,1,225,29,61,.475,27,56,.482,2,5,.400,11,28,.393,29,27,56,14,7,5,13,33,71,2.1
5356,Danny Robison\danny-robison-1,2013-14,Montana State,F,29,4,313,24,53,.453,21,41,.512,3,12,.250,19,24,.792,26,37,63,1,11,1,13,46,70,1.8
5357,D.J. Wilson\dj-wilson-1,2015-16,Michigan,F,26,0,158,27,57,.474,19,33,.576,8,24,.333,8,11,.727,4,14,18,8,5,10,9,21,70,1.8
5358,Mantvydas Urmilevicius\mantvydas-urmilevicius-1,2017-18,Bryant,F,18,7,244,29,56,.518,29,56,.518,0,0,,12,25,.480,30,34,64,14,5,1,11,27,70,3.5
5359,Ty Egbert\ty-egbert-1,2014-15,Idaho,F,27,0,289,26,53,.491,26,53,.491,0,0,,18,24,.750,18,44,62,5,1,8,12,41,70,1.8
5360,Glenn Feidanga\glenn-feidanga-1,2014-15,Long Island University,F,17,0,245,22,55,.400,22,54,.407,0,1,.000,26,34,.765,32,30,62,2,3,3,5,44,70,3.1
5361,James Hawthorne\james-hawthorne-1,2017-18,Middle Tennessee,F,32,1,257,27,70,.386,26,58,.448,1,12,.083,15,22,.682,17,25,42,9,5,4,16,29,70,1.1
5362,Chris Thompson\christian-thompson-1,2014-15,Southern Utah,F,21,3,196,28,64,.438,18,39,.462,10,25,.400,4,5,.800,8,39,47,3,3,11,22,17,70,1.8
5363,Shayok M. Shayok\shayok-m-shayok-1,2014-15,Missouri-Kansas City,F,8,8,207,28,50,.560,26,48,.542,2,2,1.000,12,24,.500,19,37,56,6,7,6,16,19,70,7.2
5364,Ryan Custer\ryan-custer-1,2016-17,Wright State,F,32,0,315,22,67,.328,12,31,.387,10,36,.278,16,26,.615,26,23,49,13,11,6,12,54,70,1.4
5365,Isaac Kreuer\isaac-kreuer-1,2013-14,Missouri-Kansas City,F,30,4,312,27,60,.450,27,59,.458,0,1,.000,16,30,.533,19,48,67,5,6,5,14,55,70,1.3
5366,Khalil Brown\khalil-brown-1,2013-14,Monmouth,F,23,0,173,24,52,.462,16,26,.615,8,26,.308,14,21,.667,9,7,16,4,1,3,8,20,70,1.7
5367,Brett Bailey\brett-bailey-1,2014-15,San Diego,F,30,12,357,28,75,.373,22,56,.393,6,19,.316,8,19,.421,20,59,79,12,6,2,24,35,70,1.1
5368,Maxwell Starwood\maxwell-starwood-1,2016-17,Texas State,F,33,1,271,32,74,.432,32,73,.438,0,1,.000,6,12,.500,18,24,42,11,3,16,18,48,70,1.0
5369,Grant Dressler\grant-dressler-1,2016-17,Sacramento State,F,16,2,191,24,62,.387,15,33,.455,9,29,.310,13,17,.765,4,29,33,14,7,1,12,7,70,3.1
5370,Basil Smotherman\basil-smotherman-1,2016-17,Purdue,F,18,0,217,30,54,.556,26,41,.634,4,13,.308,6,11,.545,7,23,30,15,9,1,12,30,70,2.8
5371,Luke Vargo\luke-vargo-1,2017-18,High Point,F,30,1,320,24,59,.407,11,20,.550,13,39,.333,9,14,.643,8,37,45,8,3,3,13,29,70,1.3
5372,Ja'Cardo Hawkins\jacardo-hawkins-1,2016-17,Tennessee Tech,F,28,14,293,30,71,.423,27,54,.500,3,17,.176,7,19,.368,27,56,83,18,10,15,17,47,70,2.2
5373,Will Chevalier\will-chevalier-1,2017-18,Green Bay,F,26,1,210,23,65,.354,5,15,.333,18,50,.360,6,6,1.000,9,24,33,2,2,3,7,19,70,1.5
5374,Elias Desport\elias-desport-1,2013-14,Saint Peter's,F,30,0,398,25,52,.481,25,52,.481,0,0,,20,29,.690,24,42,66,12,7,12,20,68,70,1.5
5375,Alex Hart\alex-hart-1,2015-16,UC-Santa Barbara,F,25,0,178,28,61,.459,20,38,.526,8,23,.348,6,14,.429,15,32,47,6,3,7,14,16,70,1.9
5376,Andrew McAuliffe\andrew-mcauliffe-1,2013-14,Davidson,F,31,5,308,33,62,.532,33,60,.550,0,2,.000,4,21,.190,14,34,48,11,4,4,24,47,70,0.8
5377,Justin Alston\justin-alston-1,2015-16,Boston University,F,8,7,177,26,56,.464,26,56,.464,0,0,,18,28,.643,12,27,39,12,3,3,10,24,70,6.0
5378,Scott Sill\scott-sill-1,2015-16,Delaware State,F,15,6,246,28,79,.354,15,31,.484,13,48,.271,1,4,.250,12,33,45,3,3,2,10,19,70,2.1
5379,John Edwards\john-edwards-2,2013-14,New Hampshire,F,20,7,305,19,64,.297,18,50,.360,1,14,.071,31,46,.674,14,31,45,16,7,4,29,32,70,1.3
5380,Vlad Shustov\vlad-shustov-1,2014-15,NJIT,F,28,0,256,31,66,.470,29,59,.492,2,7,.286,6,12,.500,15,29,44,7,3,11,17,41,70,1.3
5381,Boaz Williams\boaz-williams-1,2015-16,Lamar,F,22,1,139,27,55,.491,19,39,.487,8,16,.500,8,14,.571,12,17,29,5,4,3,16,23,70,1.7
5382,Devin Davis\devin-davis-1,2013-14,Indiana,F,29,1,254,27,51,.529,27,51,.529,0,0,,16,24,.667,24,50,74,0,5,13,18,47,70,1.8
5383,Jaro Moravek\jaro-moravek-1,2015-16,Troy,F,30,0,332,23,70,.329,10,21,.476,13,49,.265,11,17,.647,22,35,57,10,12,9,11,36,70,1.8
5384,Connor Niego\connor-niego-1,2017-18,Holy Cross,F,22,4,284,27,71,.380,14,29,.483,13,42,.310,2,4,.500,8,33,41,5,5,8,16,19,69,1.6
5385,Joe Thompson\joe-thompson-5,2017-18,South Alabama,F,26,2,298,23,60,.383,21,47,.447,2,13,.154,21,36,.583,23,45,68,4,6,8,17,37,69,1.6
5386,Yalen Reed\yalen-reed-1,2016-17,Alcorn State,F,32,9,269,29,52,.558,25,41,.610,4,11,.364,7,25,.280,23,39,62,5,6,18,11,48,69,1.8
5387,Reed Nikko\reed-nikko-1,2016-17,Missouri,F,27,0,294,28,55,.509,28,55,.509,0,0,,13,25,.520,24,39,63,10,8,19,12,48,69,2.3
5388,Ilija Stojiljkovic\ilija-stojiljkovic-1,2016-17,Maine,F,24,8,366,27,76,.355,21,41,.512,6,35,.171,9,13,.692,21,58,79,17,7,6,37,48,69,1.0
5389,Joe Furstinger\joe-furstinger-1,2014-15,New Mexico,F,29,0,359,24,67,.358,23,57,.404,1,10,.100,20,35,.571,20,37,57,22,4,15,16,53,69,1.5
5390,Damarion Geter\damarion-geter-1,2013-14,Longwood,F,32,5,614,33,58,.569,33,58,.569,0,0,,3,14,.214,38,66,104,31,14,15,40,102,69,1.5
5391,Karamoko Cisse\karamoko-cisse-1,2017-18,Rider,F,31,2,242,23,42,.548,23,42,.548,0,0,,23,49,.469,26,33,59,3,8,3,15,51,69,1.4
5392,Aaron Rountree\aaron-roundtree-1,2014-15,Wake Forest,F,25,8,359,26,61,.426,25,58,.431,1,3,.333,16,29,.552,29,33,62,28,13,17,19,39,69,2.9
5393,Josh Cunningham\josh-cunningham-1,2016-17,Dayton,F,11,2,162,25,42,.595,25,42,.595,0,0,,19,24,.792,13,19,32,7,3,1,12,24,69,4.5
5394,Courtney Alexander II\courtney-alexanderii-1,2016-17,Tennessee Tech,F,27,9,379,27,57,.474,27,57,.474,0,0,,15,36,.417,33,68,101,31,13,13,40,65,69,2.0
5395,BeeJay Anya\beejay-anya-1,2013-14,North Carolina State,F,33,0,384,27,46,.587,27,46,.587,0,0,,15,31,.484,23,45,68,4,4,46,17,57,69,2.1
5396,Kelvin Downs\kelvin-downs-1,2013-14,Arkansas State,F,32,3,419,23,62,.371,23,62,.371,0,0,,23,35,.657,25,44,69,15,5,19,32,64,69,1.0
5397,Jake Flaggert\jake-flaggert-1,2015-16,Texas-El Paso,F,31,4,427,22,51,.431,2,3,.667,20,48,.417,5,9,.556,1,36,37,18,4,2,11,51,69,1.2
5398,Lenell Henry\lenell-henry-1,2017-18,Northern Arizona,F,19,0,224,27,50,.540,26,47,.553,1,3,.333,14,28,.500,19,36,55,3,8,8,25,37,69,2.1
5399,Sam Waardenburg\sam-waardenburg-1,2017-18,Miami (FL),F,21,0,310,24,58,.414,10,26,.385,14,32,.438,7,8,.875,26,33,59,17,10,9,14,31,69,3.2
5400,Josiah Heath\josiah-heath-1,2013-14,Canisius,F,34,0,373,27,63,.429,27,63,.429,0,0,,15,27,.556,27,48,75,8,10,14,18,67,69,1.3
5401,Jordan Tyson\jordan-tyson-1,2017-18,Georgia State,F,35,0,352,30,56,.536,30,56,.536,0,0,,9,21,.429,21,47,68,4,4,22,23,68,69,1.1
5402,Rudy Stradnieks\rudy-stradnieks-1,2016-17,Southern Illinois,F,32,1,246,25,60,.417,16,38,.421,9,22,.409,10,14,.714,21,21,42,4,4,1,10,31,69,1.3
5403,Idy Diallo\idy-diallo-1,2017-18,UC-Riverside,F,27,8,297,30,57,.526,30,57,.526,0,0,,9,16,.563,29,60,89,8,6,17,33,73,69,1.4
5404,Eugene Jones Jr.\eugene-jonesjr-1,2016-17,Alabama A&M,F,24,4,313,26,83,.313,25,68,.368,1,15,.067,15,22,.682,14,34,48,13,5,3,17,38,68,0.9
5405,Alex Peters\alex-peters-1,2017-18,Samford,F,17,0,246,28,41,.683,28,41,.683,0,0,,12,22,.545,15,31,46,3,5,4,12,53,68,2.5
5406,Josh Collins\josh-collins-1,2016-17,North Dakota,F,30,3,324,24,55,.436,18,36,.500,6,19,.316,14,19,.737,11,34,45,11,5,4,19,55,68,1.0
5407,Coleman Johnson\coleman-johnson-1,2015-16,Fairfield,F,29,2,433,28,67,.418,28,66,.424,0,1,.000,12,18,.667,36,70,106,20,10,37,14,74,68,2.8
5408,Jamarcus Hairston\jamarcus-hairston-1,2016-17,Cleveland State,F,30,1,254,23,71,.324,14,29,.483,9,42,.214,13,20,.650,18,32,50,8,9,8,9,28,68,1.6
5409,Coye Simmons\coye-simmons-1,2016-17,Georgia Southern,F,30,11,455,27,50,.540,27,50,.540,0,0,,14,22,.636,52,80,132,7,13,8,22,72,68,2.5
5410,Dom Uhl\dom-uhl-1,2014-15,Iowa,F,33,0,331,26,72,.361,21,45,.467,5,27,.185,11,21,.524,22,39,61,14,8,7,23,25,68,1.2
5411,Marko Gujanicic\marko-gujanicic-1,2014-15,George Mason,F,25,7,282,30,63,.476,27,53,.509,3,10,.300,5,12,.417,15,27,42,16,4,3,14,33,68,1.7
5412,Marcus Hall\marcus-hall-4,2017-18,Howard,F,28,6,357,28,40,.700,28,40,.700,0,0,,12,25,.480,30,44,74,16,4,3,14,71,68,2.0
5413,Tariiq Jones\tariiq-jones-1,2017-18,Detroit Mercy,F,7,2,133,26,54,.481,20,37,.541,6,17,.353,10,15,.667,10,22,32,8,0,2,16,11,68,5.5
5414,Brady Ernst\brady-ernst-1,2017-18,Florida Gulf Coast,F,33,3,321,28,42,.667,28,42,.667,0,0,,12,29,.414,16,55,71,10,9,9,14,40,68,1.9
5415,Brandon St. Louis\brandon-st-louis-1,2013-14,Coppin State,F,24,16,471,26,65,.400,26,64,.406,0,1,.000,16,28,.571,55,53,108,9,11,10,21,57,68,2.6
5416,Theo Pinson\theo-pinson-1,2014-15,North Carolina,F,24,1,300,25,68,.368,18,42,.429,7,26,.269,11,18,.611,21,51,72,37,14,5,17,22,68,3.1
5417,Fred Iruafemi\fred-iruafemi-1,2015-16,Virginia Military Institute,F,29,2,344,25,49,.510,25,48,.521,0,1,.000,18,20,.900,22,42,64,17,11,25,11,68,68,2.5
5418,Elijah Burns\elijah-burns-1,2017-18,Notre Dame,F,29,1,308,22,54,.407,21,50,.420,1,4,.250,23,30,.767,19,47,66,7,6,3,14,19,68,1.9
5419,Ali Fall\cheikh-alioune-fall-1,2013-14,Nevada,F,24,8,336,24,55,.436,24,55,.436,0,0,,20,26,.769,24,24,48,8,3,13,28,68,68,1.0
5420,Terrance O'Donohue\terrance-odonohue-1,2015-16,College of Charleston,F,20,0,312,26,58,.448,22,49,.449,4,9,.444,12,20,.600,13,56,69,2,6,3,17,43,68,1.8
5421,Montray Clemons\montray-clemons-1,2015-16,San Francisco,F,23,2,233,25,63,.397,25,59,.424,0,4,.000,17,24,.708,22,40,62,4,6,4,17,37,67,1.6
5422,Ezra Talbert\ezra-talbert-1,2017-18,Liberty,F,32,4,224,25,59,.424,18,28,.643,7,31,.226,10,17,.588,15,23,38,7,3,1,10,45,67,1.0
5423,Stetson Billings\setson-billings-1,2013-14,Little Rock,F,32,3,311,21,65,.323,21,63,.333,0,2,.000,25,33,.758,25,53,78,9,4,4,13,33,67,1.5
5424,Ryan Mikesell\ryan-mikesell-1,2015-16,Dayton,F,22,0,176,25,51,.490,14,18,.778,11,33,.333,6,13,.462,10,22,32,17,4,5,10,22,67,2.4
5425,Connor Devine\connor-devine-1,2015-16,South Dakota State,F,26,0,215,25,39,.641,25,39,.641,0,0,,17,31,.548,19,23,42,7,2,15,7,36,67,2.3
5426,Jalen Morgan\jalen-morgan-1,2016-17,Western Illinois,F,21,0,213,31,55,.564,31,55,.564,0,0,,5,16,.313,8,25,33,6,0,4,14,34,67,1.4
5427,Aaron Carver\aaron-carver-1,2017-18,Old Dominion,F,31,2,564,26,59,.441,26,57,.456,0,2,.000,15,30,.500,43,81,124,20,15,22,22,58,67,2.7
5428,Alvin Ellis\alvin-ellis-1,2013-14,Michigan State,F,36,1,283,24,50,.480,18,37,.486,6,13,.462,13,22,.591,8,15,23,14,13,3,22,42,67,1.0
5429,Jordan Robinson\jordan-robinson-1,2016-17,Duquesne,F,18,0,167,25,43,.581,25,43,.581,0,0,,17,27,.630,23,30,53,3,1,6,9,27,67,3.1
5430,Zigmars Raimo\zigmars-raimo-1,2017-18,Hawaii,F,25,2,213,21,36,.583,21,36,.583,0,0,,25,42,.595,23,20,43,12,7,1,18,23,67,2.2
5431,Tavario Miller\tavario-miller-1,2014-15,Texas A&M,F,25,0,283,28,44,.636,28,43,.651,0,1,.000,11,27,.407,34,42,76,5,1,9,18,62,67,1.8
5432,Ami Lakoju\ami-lakoju-1,2016-17,UC-Santa Barbara,F,10,7,169,30,49,.612,30,49,.612,0,0,,7,16,.438,24,33,57,5,0,6,9,26,67,5.6
5433,Ejike Obinna\ejike-obinna-1,2017-18,Vanderbilt,F,25,14,235,26,44,.591,26,43,.605,0,1,.000,15,31,.484,12,41,53,1,1,2,13,50,67,1.2
5434,Michal Cekovsky\michal-cekovsky-1,2015-16,Maryland,F,29,1,250,24,43,.558,24,42,.571,0,1,.000,19,37,.514,15,41,56,4,7,12,16,46,67,1.6
5435,Sam Beeler\sam-beeler-1,2014-15,UC-Santa Barbara,F,33,7,298,29,59,.492,29,59,.492,0,0,,9,15,.600,29,43,72,2,5,20,15,47,67,1.7
5436,Patrick Szpir\patrick-szpir-1,2017-18,Chicago State,F,26,10,326,22,49,.449,22,47,.468,0,2,.000,23,29,.793,11,36,47,6,5,6,30,48,67,0.8
5437,Glenn Feidanga\glenn-feidanga-1,2015-16,Long Island University,F,30,0,266,23,52,.442,23,51,.451,0,1,.000,21,35,.600,24,32,56,3,4,2,11,62,67,1.1
5438,Devon Friend\devon-friend-1,2015-16,Chicago State,F,20,13,304,28,57,.491,28,57,.491,0,0,,11,26,.423,23,36,59,4,13,8,23,41,67,2.1
5439,Jesse Little\jesse-little-1,2017-18,American,F,23,16,433,26,49,.531,25,43,.581,1,6,.167,14,27,.519,33,42,75,19,11,21,23,62,67,2.8
5440,James Baker\james-baker-1,2017-18,Morehead State,F,24,3,225,23,51,.451,14,24,.583,9,27,.333,12,16,.750,16,22,38,6,7,7,15,38,67,1.8
5441,Nathan Ekwu\nathan-ekwu-1,2016-17,Davidson,F,21,0,220,29,55,.527,29,55,.527,0,0,,9,19,.474,16,53,69,11,7,8,18,49,67,2.2
5442,Lukas Jarrett\lukas-jarrett-1,2017-18,Lafayette,F,30,8,459,22,57,.386,14,33,.424,8,24,.333,15,26,.577,12,76,88,30,12,19,31,52,67,1.9
5443,Gilbert Thomas Jr.\gilbert-thomasjr-1,2016-17,Murray State,F,22,2,246,30,46,.652,30,44,.682,0,2,.000,7,18,.389,30,30,60,5,10,6,8,36,67,3.1
5444,Deion Rhea\deion-rhea-1,2017-18,Texas A&M-Corpus Christi,F,11,0,183,23,55,.418,16,33,.485,7,22,.318,14,19,.737,7,24,31,4,4,8,17,27,67,2.9
5445,Darion Clark\darion-clark-1,2015-16,Southern California,F,26,0,289,26,58,.448,26,58,.448,0,0,,15,32,.469,43,75,118,8,5,11,22,29,67,2.6
5446,Jamal Aytes\jamal-aytes-1,2015-16,Brigham Young,F,22,0,186,28,52,.538,28,52,.538,0,0,,11,22,.500,11,24,35,3,1,1,16,29,67,1.3
5447,Khadeem Lattin\khadeem-lattin-1,2014-15,Oklahoma,F,34,0,403,28,65,.431,28,64,.438,0,1,.000,11,21,.524,39,70,109,9,12,31,14,68,67,2.2
5448,Will Gladson\will-gladson-1,2016-17,Princeton,F,29,0,302,25,74,.338,16,35,.457,9,39,.231,8,11,.727,9,24,33,14,4,13,15,39,67,1.0
5449,Obi Momah\obi-momah-1,2016-17,Marist,F,26,0,160,23,49,.469,22,48,.458,1,1,1.000,20,27,.741,16,32,48,6,2,4,12,36,67,1.6
5450,Brandon Smith\brandon-smith-9,2017-18,UC-Irvine,F,30,9,373,26,68,.382,25,44,.568,1,24,.042,14,20,.700,7,39,46,26,9,6,24,41,67,1.2
5451,Anthony Morse\anthony-morse-1,2014-15,Tennessee Tech,F,25,3,257,26,56,.464,26,56,.464,0,0,,14,28,.500,26,30,56,8,7,12,11,31,66,2.3
5452,Raasean Davis\raasean-davis-1,2015-16,Kent State,F,25,2,203,25,46,.543,25,46,.543,0,0,,16,23,.696,25,27,52,0,1,10,19,29,66,1.8
5453,Levi Stockard III\levi-stockardiii-1,2017-18,Kansas State,F,36,0,311,26,50,.520,26,50,.520,0,0,,14,22,.636,21,39,60,4,5,2,17,70,66,0.8
5454,Ronnie Stevens\ronnie-stevens-1,2014-15,Nevada,F,22,1,305,18,46,.391,18,46,.391,0,0,,30,45,.667,29,36,65,1,1,9,23,42,66,1.6
5455,Chuck Ogbodo\chuck-ogbodo-1,2015-16,North Carolina-Wilmington,F,19,8,213,30,47,.638,30,47,.638,0,0,,6,15,.400,27,36,63,1,4,23,21,52,66,2.6
5456,Derrick Walker\derrick-walker-1,2017-18,Tennessee,F,34,0,299,28,47,.596,28,47,.596,0,0,,10,25,.400,29,46,75,9,3,7,21,43,66,1.4
5457,James Jackson\james-jackson-3,2017-18,UC-Riverside,F,30,6,368,26,65,.400,19,41,.463,7,24,.292,7,22,.318,16,51,67,24,3,4,23,33,66,1.3
5458,Michael Wolfe\michael-wolfe-1,2013-14,Siena,F,36,0,181,21,47,.447,20,39,.513,1,8,.125,23,29,.793,10,13,23,8,3,4,6,10,66,1.4
5459,Deng Deng\deng-deng-1,2014-15,Baylor,F,23,0,203,29,56,.518,29,53,.547,0,3,.000,8,16,.500,14,33,47,5,9,6,21,22,66,1.8
5460,Calvin Hermanson\calvin-hermanson-1,2014-15,Saint Mary's (CA),F,26,0,216,21,43,.488,6,9,.667,15,34,.441,9,13,.692,5,18,23,4,7,0,5,35,66,1.6
5461,Roberto Vercellino\roberto-vercellino-1,2016-17,Northern Colorado,F,26,7,273,24,48,.500,19,33,.576,5,15,.333,13,21,.619,22,41,63,9,6,5,24,40,66,1.6
5462,Andre Wesson\andre-wesson-1,2016-17,Ohio State,F,29,0,326,19,52,.365,6,15,.400,13,37,.351,15,28,.536,15,21,36,9,6,5,18,33,66,1.2
5463,Geno Artison\geno-artison-1,2017-18,Tulsa,F,30,0,334,23,73,.315,14,34,.412,9,39,.231,11,15,.733,17,50,67,11,9,8,7,20,66,1.9
5464,Ralph Hill\ralph-hill-1,2013-14,Oakland,F,26,6,180,24,49,.490,14,24,.583,10,25,.400,8,14,.571,6,23,29,4,6,9,9,20,66,1.9
5465,Greig Stire\greig-stire-1,2014-15,Albany (NY),F,33,0,349,20,48,.417,20,48,.417,0,0,,26,39,.667,24,43,67,8,11,2,17,55,66,1.3
5466,Kevin Mickle\kevin-mickle-1,2015-16,Florida Gulf Coast,F,31,0,323,27,55,.491,27,55,.491,0,0,,12,21,.571,27,36,63,8,7,4,30,41,66,1.1
5467,Jordan Gaines\jordan-gaines-1,2016-17,Savannah State,F,26,4,232,26,67,.388,21,48,.438,5,19,.263,9,20,.450,12,36,48,1,8,7,20,33,66,1.0
5468,Lucas N'Guessan\lucas-nguessan-1,2016-17,Oklahoma State,F,28,10,240,29,43,.674,29,43,.674,0,0,,8,20,.400,22,26,48,7,6,15,21,69,66,1.4
5469,Parris Massey\parris-massey-1,2013-14,Massachusetts-Lowell,F,27,0,311,28,47,.596,28,47,.596,0,0,,10,21,.476,19,51,70,7,6,27,6,29,66,3.0
5470,Zach Hanson\zach-hanson-1,2013-14,Creighton,F,24,0,122,26,38,.684,26,36,.722,0,2,.000,14,25,.560,11,16,27,1,0,6,4,19,66,2.1
5471,Jason Burnell\jason-burnell-1,2015-16,Georgia Southern,F,23,1,185,25,74,.338,13,33,.394,12,41,.293,4,7,.571,17,21,38,7,8,5,10,25,66,1.6
5472,Keith Smith\keith-smith-5,2017-18,Oregon,F,34,3,312,27,58,.466,27,50,.540,0,8,.000,12,18,.667,22,27,49,20,15,6,15,37,66,1.8
5473,Ben Kone\ben-kone-1,2016-17,Oregon State,F,23,0,308,22,75,.293,15,54,.278,7,21,.333,15,24,.625,16,46,62,5,6,3,24,46,66,0.6
5474,Matt Freeman\matt-freeman-1,2017-18,Oklahoma,F,26,0,245,23,62,.371,9,19,.474,14,43,.326,6,8,.750,5,29,34,11,4,2,8,30,66,1.4
5475,Collin Luther\collin-luther-1,2014-15,Elon,F,32,0,389,20,63,.317,7,18,.389,13,45,.289,13,17,.765,22,40,62,17,9,1,15,40,66,1.4
5476,Bobby Wehrli\bobby-wehrli-1,2014-15,Dayton,F,29,0,407,24,46,.522,12,22,.545,12,24,.500,6,11,.545,28,34,62,10,6,9,15,50,66,1.9
5477,Jordan Cintron\jordan-cintron-1,2017-18,Longwood,F,28,0,373,25,55,.455,23,48,.479,2,7,.286,14,34,.412,20,45,65,14,18,5,28,42,66,1.6
5478,Jalen Jones\jalen-jones-3,2015-16,Howard,F,29,0,361,28,50,.560,26,46,.565,2,4,.500,7,21,.333,30,49,79,6,12,3,14,50,65,1.9
5479,Greg Eboigbodin\greg-eboigbodin-1,2017-18,Illinois,F,30,2,318,27,49,.551,27,49,.551,0,0,,11,25,.440,33,40,73,8,11,11,16,63,65,1.8
5480,Olaf Schaftenaar\olaf-schaftenaar-1,2013-14,Oregon State,F,30,0,270,21,53,.396,8,14,.571,13,39,.333,10,13,.769,4,36,40,19,8,4,8,25,65,1.8
5481,Davere Creighton\davere-creighton-1,2017-18,Mississippi Valley State,F,27,3,210,19,71,.268,11,33,.333,8,38,.211,19,31,.613,13,31,44,5,5,0,11,31,65,0.8
5482,Kenny Goins\kenny-goins-1,2017-18,Michigan State,F,31,0,431,27,59,.458,23,44,.523,4,15,.267,7,11,.636,25,63,88,37,12,22,16,35,65,3.0
5483,Veer Singh\veer-singh-1,2015-16,Seton Hall,F,30,1,267,21,70,.300,4,15,.267,17,55,.309,6,10,.600,8,28,36,4,3,0,12,42,65,0.5
5484,Kevin Noreen\kevin-noreen-1,2013-14,West Virginia,F,33,20,512,21,37,.568,20,34,.588,1,3,.333,22,30,.733,42,48,90,23,16,15,19,96,65,2.2
5485,KaVaughn Scott\kavaughn-scott-1,2016-17,Loyola (MD),F,27,6,225,24,40,.600,24,40,.600,0,0,,17,30,.567,19,24,43,13,5,2,16,47,65,1.6
5486,Kyrin Galloway\kyrin-galloway-1,2016-17,North Carolina-Greensboro,F,29,2,239,26,40,.650,26,39,.667,0,1,.000,13,15,.867,23,41,64,7,6,15,6,25,65,2.8
5487,Isaiah Thomas\isaiah-thomas-2,2016-17,Northern Arizona,F,25,2,207,24,41,.585,24,41,.585,0,0,,17,26,.654,19,38,57,3,3,11,13,46,65,1.9
5488,Nathan Taphorn\nathan-taphorn-1,2013-14,Northwestern,F,26,1,268,21,67,.313,6,13,.462,15,54,.278,8,14,.571,5,21,26,8,6,1,22,23,65,0.6
5489,Alonzo Walker\alonzo-walker-1,2016-17,Kent State,F,28,2,309,26,50,.520,24,44,.545,2,6,.333,11,23,.478,33,35,68,4,9,7,20,53,65,1.6
5490,Curtis Phillips\curtis-phillips-1,2015-16,Campbell,F,8,7,208,23,66,.348,15,36,.417,8,30,.267,11,21,.524,4,29,33,13,8,1,7,16,65,5.0
5491,Cody Martin\cody-martin-1,2014-15,North Carolina State,F,19,3,216,28,59,.475,28,52,.538,0,7,.000,9,17,.529,17,21,38,23,9,6,18,36,65,2.5
5492,Damien Sears\damien-sears-1,2017-18,Jacksonville,F,16,6,260,30,53,.566,30,52,.577,0,1,.000,5,22,.227,20,38,58,6,14,6,14,42,65,3.1
5493,Willie Jackson\willie-jackson-1,2016-17,Missouri,F,11,0,186,29,53,.547,29,52,.558,0,1,.000,7,10,.700,15,36,51,4,3,6,13,18,65,4.5
5494,Jeff Johnson\jeff-johnson-4,2013-14,Eastern Kentucky,F,34,1,348,22,53,.415,11,25,.440,11,28,.393,10,11,.909,16,33,49,37,4,3,13,45,65,1.7
5495,JaColby Pemberton\jacolby-pemberton-1,2017-18,Louisiana Tech,F,27,0,276,22,43,.512,20,36,.556,2,7,.286,18,30,.600,16,31,47,18,8,2,18,35,64,1.8
5496,Antwan Walker\antwan-walker-1,2017-18,Georgetown,F,24,1,183,24,49,.490,22,44,.500,2,5,.400,14,15,.933,20,26,46,6,7,3,11,22,64,2.3
5497,Kristian Doolittle\kristian-doolittle-2,2017-18,Oklahoma,F,22,6,373,23,63,.365,21,59,.356,2,4,.500,16,26,.615,23,71,94,14,9,3,15,30,64,2.6
5498,Brandon Smith\brandon-smith-9,2015-16,UC-Irvine,F,36,7,352,21,55,.382,13,31,.419,8,24,.333,14,23,.609,18,39,57,11,8,6,21,39,64,1.1
5499,Bo Calhoun\bo-calhoun-1,2013-14,Ball State,F,27,2,253,23,66,.348,23,66,.348,0,0,,18,30,.600,30,54,84,8,6,6,21,53,64,1.2
5500,Yohanny Dalembert\yohanny-dalembert-1,2013-14,James Madison,F,28,1,328,19,41,.463,19,41,.463,0,0,,26,37,.703,30,39,69,5,4,15,21,39,64,1.9
5501,Isaiah Gable\isaiah-gable-1,2017-18,Southeast Missouri State,F,15,0,187,22,55,.400,9,19,.474,13,36,.361,7,11,.636,5,23,28,6,0,0,7,19,64,2.2
5502,Sam Neumann\sam-neumann-1,2015-16,Montana State,F,28,0,270,19,38,.500,8,9,.889,11,29,.379,15,25,.600,11,35,46,13,2,1,4,35,64,1.9
5503,Candido Sa\candido-sa-1,2017-18,Rutgers,F,32,0,394,26,60,.433,24,55,.436,2,5,.400,10,23,.435,37,64,101,3,12,13,22,43,64,1.8
5504,Gabe Bealer\gabe-bealer-1,2015-16,Utah,F,16,0,105,22,43,.512,15,24,.625,7,19,.368,13,19,.684,8,13,21,3,2,3,2,12,64,3.1
5505,Jacara Cross\jacara-cross-1,2017-18,Jacksonville State,F,27,0,183,27,52,.519,27,52,.519,0,0,,10,19,.526,15,34,49,9,6,10,21,35,64,1.5
5506,Jack Whitman\jack-whitman-1,2014-15,William & Mary,F,28,0,322,25,45,.556,25,45,.556,0,0,,14,30,.467,33,32,65,13,7,14,24,50,64,1.8
5507,Spencer Mathis\spencer-mathis-1,2015-16,Northern Colorado,F,23,4,272,26,64,.406,24,57,.421,2,7,.286,10,15,.667,19,31,50,13,6,6,10,50,64,1.7
5508,Zena Edosomwan\zena-edosomwan-1,2013-14,Harvard,F,22,0,126,25,57,.439,25,57,.439,0,0,,14,22,.636,20,18,38,3,1,6,9,19,64,1.9
5509,Ike Ngwudo\ikemefuna-ngwudo-1,2016-17,Dartmouth,F,27,12,317,25,53,.472,17,36,.472,8,17,.471,6,14,.429,13,30,43,14,8,7,18,57,64,1.2
5510,Marko Pirovic\marko-pirovic-1,2014-15,Maine,F,9,6,196,21,48,.438,12,23,.522,9,25,.360,13,24,.542,12,31,43,9,5,0,18,31,64,3.7
5511,Shane Randall\shane-randall-1,2015-16,Maryland-Eastern Shore,F,27,18,294,21,42,.500,19,34,.559,2,8,.250,20,23,.870,13,28,41,8,6,2,23,71,64,0.8
5512,Len Springs\len-springs-1,2013-14,Northern Arizona,F,32,10,481,25,58,.431,25,57,.439,0,1,.000,14,24,.583,49,69,118,5,4,58,18,74,64,2.7
5513,Thomas Reuter\thomas-reuter-1,2013-14,Eastern Washington,F,28,1,321,25,66,.379,21,44,.477,4,22,.182,10,24,.417,18,46,64,23,3,6,20,40,64,1.3
5514,Devine Eke\devine-eke-1,2017-18,Rider,F,31,3,291,25,35,.714,22,31,.710,3,4,.750,11,41,.268,26,32,58,15,10,25,8,48,64,2.5
5515,Dale Francis\dale-francis-1,2014-15,Texas A&M-Corpus Christi,F,30,10,362,21,65,.323,2,8,.250,19,57,.333,3,4,.750,11,17,28,3,4,4,5,65,64,0.6
5516,Evan Bailey\evan-bailey-1,2017-18,College of Charleston,F,26,1,240,20,55,.364,5,11,.455,15,44,.341,9,11,.818,6,24,30,4,5,0,8,24,64,1.3
5517,Eli Chuha\eli-chuha-1,2015-16,New Mexico State,F,21,0,155,26,46,.565,25,40,.625,1,6,.167,11,18,.611,15,29,44,9,4,3,21,21,64,2.0
5518,V.J. Beachem\vj-beachem-1,2013-14,Notre Dame,F,27,1,228,23,72,.319,12,30,.400,11,42,.262,7,10,.700,7,12,19,7,5,2,7,14,64,1.1
5519,Ira Lee\ira-lee-1,2017-18,Arizona,F,27,0,276,24,52,.462,23,50,.460,1,2,.500,15,25,.600,19,43,62,10,5,12,13,50,64,1.7
5520,Evan Nolte\evan-nolte-1,2015-16,Virginia,F,34,1,299,23,61,.377,11,22,.500,12,39,.308,6,10,.600,7,19,26,12,8,6,10,26,64,1.2
5521,Jamaal Samuel\jamaal-samuel-1,2013-14,Illinois State,F,26,1,291,27,55,.491,23,40,.575,4,15,.267,6,15,.400,14,48,62,3,4,23,8,50,64,2.0
5522,Jake Flaggert\jake-flaggert-1,2013-14,Texas-El Paso,F,30,0,370,19,55,.345,6,14,.429,13,41,.317,13,19,.684,4,26,30,11,7,2,14,41,64,0.9
5523,Damarion Geter\damarion-geter-1,2014-15,Longwood,F,34,31,862,29,50,.580,29,50,.580,0,0,,6,19,.316,42,103,145,49,29,32,33,99,64,3.2
5524,Garrison Goode\garrison-goode-1,2016-17,UC-Davis,F,25,4,533,25,56,.446,25,56,.446,0,0,,14,35,.400,39,59,98,18,16,4,23,56,64,2.3
5525,Brett Boese\brett-boese-1,2015-16,Washington State,F,29,7,297,22,54,.407,8,15,.533,14,39,.359,6,9,.667,10,17,27,7,6,0,9,24,64,1.3
5526,Jordan Nobles\jordan-nobles-1,2015-16,Eastern Michigan,F,30,1,328,25,48,.521,25,46,.543,0,2,.000,14,25,.560,24,47,71,6,13,10,5,55,64,2.1
5527,David Wacker\david-wacker-1,2014-15,Boise State,F,29,4,259,22,49,.449,22,48,.458,0,1,.000,20,30,.667,15,26,41,5,0,6,13,31,64,1.2
5528,Torren Jones\torren-jones-1,2013-14,Missouri,F,30,0,243,23,43,.535,23,43,.535,0,0,,17,22,.773,28,41,69,5,12,3,14,45,63,1.9
5529,Kai Edwards\kai-edwards-1,2017-18,Northern Colorado,F,28,0,201,26,36,.722,26,36,.722,0,0,,11,29,.379,22,39,61,8,2,5,7,34,63,2.1
5530,Brian Bridgewater\brian-bridgewater-1,2014-15,Louisiana State,F,29,0,192,28,52,.538,28,52,.538,0,0,,7,11,.636,13,18,31,6,7,3,11,36,63,1.3
5531,Ben Carter\ben-carter-1,2013-14,Oregon,F,25,5,317,18,47,.383,18,46,.391,0,1,.000,27,35,.771,26,36,62,18,12,14,16,58,63,2.3
5532,Gilbert Talbot\gilbert-talbot-1,2013-14,Louisiana Tech,F,28,0,179,27,48,.563,27,48,.563,0,0,,9,28,.321,26,29,55,2,1,5,15,49,63,1.1
5533,Blake Danielak\blake-danielak-1,2013-14,Drake,F,16,4,238,23,64,.359,9,25,.360,14,39,.359,3,6,.500,20,27,47,11,6,4,12,24,63,2.7
5534,Kimani Jackson\kimani-jackson-1,2016-17,Colorado State,F,15,6,187,24,55,.436,23,49,.469,1,6,.167,14,23,.609,21,24,45,6,1,9,13,30,63,2.6
5535,Connor McClenaghan\connor-mcclenaghan-1,2014-15,Marist,F,30,0,321,17,53,.321,12,34,.353,5,19,.263,24,37,.649,16,26,42,13,11,13,33,67,63,0.5
5536,Gorjok Gak\gorjok-gak-1,2017-18,Florida,F,29,1,259,26,41,.634,26,41,.634,0,0,,11,28,.393,33,37,70,3,3,12,12,36,63,2.0
5537,Jake Hammond\jake-hammond-1,2015-16,Nebraska,F,29,8,311,23,53,.434,23,53,.434,0,0,,17,39,.436,42,39,81,6,5,17,13,45,63,2.0
5538,Jerimyjah Batts\jerimyjah-batts-1,2014-15,Coppin State,F,31,18,369,25,67,.373,25,67,.373,0,0,,13,25,.520,10,30,40,9,1,11,17,79,63,0.1
5539,Drew Wilson\drew-wilson-1,2013-14,Oral Roberts,F,31,4,379,28,47,.596,28,46,.609,0,1,.000,7,26,.269,32,52,84,10,12,20,17,51,63,2.2
5540,Mubashar Ali\mubashar-ali-1,2017-18,Southern,F,24,3,169,20,51,.392,20,50,.400,0,1,.000,23,34,.676,15,29,44,3,2,7,16,24,63,1.4
5541,LaRon Smith\laron-smith-1,2016-17,Auburn,F,24,3,288,24,45,.533,24,45,.533,0,0,,15,29,.517,29,28,57,6,7,23,16,56,63,2.2
5542,Ronnie Stevens\ronnie-stevens-1,2013-14,Nevada,F,19,3,274,25,49,.510,25,49,.510,0,0,,13,17,.765,28,22,50,5,4,8,16,42,63,2.3
5543,Eric Rippetoe\eric-rippetoe-1,2013-14,Southern Utah,F,21,0,174,22,50,.440,10,22,.455,12,28,.429,7,11,.636,6,12,18,5,5,1,12,24,63,1.5
5544,Chad Ross\chad-ross-1,2014-15,Utah Valley,F,19,1,234,24,57,.421,17,39,.436,7,18,.389,8,15,.533,9,30,39,10,6,1,20,37,63,1.3
5545,David Howard\david-howard-1,2013-14,Evansville,F,27,0,197,22,44,.500,22,43,.512,0,1,.000,19,45,.422,16,33,49,0,3,10,13,35,63,1.3
5546,Fallou Ndoye\fallou-ndoye-1,2014-15,Mississippi State,F,30,6,372,26,54,.481,26,54,.481,0,0,,11,21,.524,22,33,55,5,6,7,27,67,63,0.6
5547,Sammy Friday\sammy-friday-1,2017-18,Siena,F,25,3,190,22,51,.431,22,51,.431,0,0,,19,31,.613,30,30,60,2,3,6,12,28,63,1.9
5548,Chad Calcaterra\chad-calcaterra-1,2014-15,North Dakota,F,19,8,212,27,47,.574,27,47,.574,0,0,,9,21,.429,11,17,28,2,3,8,12,30,63,1.8
5549,Bernard Sullivan\bernard-sullivan-1,2014-15,Charlotte,F,13,0,175,24,51,.471,23,49,.469,1,2,.500,13,21,.619,13,22,35,2,4,3,11,8,62,3.2
5550,A.J. John\aj-john-1,2015-16,Pepperdine,F,31,0,374,24,61,.393,24,56,.429,0,5,.000,14,19,.737,21,57,78,6,7,15,23,63,62,1.0
5551,Kevin Marfo\kevin-marfo-1,2016-17,George Washington,F,23,0,205,16,44,.364,16,44,.364,0,0,,30,56,.536,28,36,64,4,7,7,21,31,62,1.7
5552,Craig Hinton\craig-hinton-1,2013-14,Virginia Military Institute,F,24,8,209,20,61,.328,8,23,.348,12,38,.316,10,15,.667,12,34,46,5,2,9,9,26,62,1.5
5553,Lukas Poderis\lukas-poderis-1,2013-14,East Tennessee State,F,33,3,379,21,47,.447,21,47,.447,0,0,,20,37,.541,34,46,80,4,7,18,13,65,62,1.6
5554,Jackson Davis\jackson-davis-1,2015-16,Butler,F,25,0,142,25,45,.556,25,44,.568,0,1,.000,12,17,.706,9,32,41,2,7,4,10,30,62,1.7
5555,Marius Myles\marius-myles-1,2013-14,Alcorn State,F,29,11,465,21,46,.457,21,46,.457,0,0,,20,28,.714,27,41,68,9,15,9,15,55,62,2.0
5556,Eddie Odio\eddie-odio-1,2014-15,Boston College,F,29,6,435,21,59,.356,13,26,.500,8,33,.242,12,17,.706,24,50,74,27,12,11,27,64,62,1.5
5557,Skye Johnson\skye-johnson-1,2015-16,Delaware,F,17,3,264,21,44,.477,21,44,.477,0,0,,20,32,.625,24,33,57,4,7,7,26,37,62,2.1
5558,Aleer Leek\aleer-leek-1,2015-16,Missouri-Kansas City,F,30,0,248,22,56,.393,11,29,.379,11,27,.407,7,18,.389,11,21,32,3,2,5,14,33,62,0.7
5559,Bobby King\bobby-king-1,2014-15,Stephen F. Austin,F,32,0,238,24,43,.558,24,43,.558,0,0,,14,27,.519,29,24,53,10,4,15,25,41,62,1.4
5560,Vacha Vaughn\vacha-vaughn-1,2013-14,Mississippi Valley State,F,26,2,309,20,49,.408,19,46,.413,1,3,.333,21,31,.677,31,51,82,15,8,3,19,44,62,2.0
5561,Kevin Mickle\kevin-mickle-1,2016-17,Florida Gulf Coast,F,32,5,403,27,53,.509,27,52,.519,0,1,.000,8,10,.800,40,47,87,11,12,11,20,48,62,2.0
5562,Charles Thomas IV\charles-thomasiv-1,2016-17,Wisconsin,F,28,0,177,21,54,.389,19,48,.396,2,6,.333,18,20,.900,14,22,36,6,0,4,17,40,62,0.8
5563,Patrick Tape\patrick-tape-1,2016-17,Columbia,F,17,0,176,24,45,.533,24,45,.533,0,0,,14,20,.700,18,44,62,8,5,10,9,33,62,3.5
5564,Teslim Idris\teslim-idris-1,2015-16,Savannah State,F,29,12,333,25,52,.481,20,40,.500,5,12,.417,7,16,.438,17,24,41,10,10,7,14,40,62,1.5
5565,Brady Twombly\brady-twombly-1,2015-16,Northern Arizona,F,21,2,232,21,52,.404,7,12,.583,14,40,.350,6,8,.750,8,25,33,3,4,4,9,18,62,1.9
5566,Vitto Brown\vitto-brown-1,2014-15,Wisconsin,F,34,0,214,26,59,.441,26,59,.441,0,0,,10,17,.588,12,31,43,7,8,8,15,38,62,1.0
5567,Pieter Prinsolo\pieter-prinsolo-1,2013-14,Marist,F,28,6,293,21,53,.396,15,35,.429,6,18,.333,14,21,.667,27,34,61,2,4,18,10,43,62,1.8
5568,Armani Taylor\armani-taylor-1,2017-18,South Carolina State,F,28,2,205,24,44,.545,24,44,.545,0,0,,14,38,.368,27,32,59,2,2,15,19,45,62,1.3
5569,Jonathan DeWane\jonathan-dewane-1,2017-18,Air Force,F,21,0,110,24,42,.571,18,32,.563,6,10,.600,8,12,.667,7,18,25,6,4,3,4,11,62,2.5
5570,Matz Stockman\matz-stockman-1,2015-16,Louisville,F,23,0,142,26,47,.553,26,47,.553,0,0,,10,21,.476,20,19,39,4,1,8,7,27,62,2.0
5571,Amir Smith\amir-smith-1,2017-18,Florida Atlantic,F,28,1,253,29,58,.500,29,58,.500,0,0,,4,11,.364,27,46,73,2,6,33,8,30,62,2.6
5572,Austin Lewis\austin-lewis-1,2013-14,McNeese State,F,31,6,298,28,50,.560,28,50,.560,0,0,,6,12,.500,28,31,59,5,2,25,9,45,62,2.0
5573,Stephane Raquil\stephane-raquil-1,2013-14,Alcorn State,F,31,26,539,24,57,.421,24,56,.429,0,1,.000,14,29,.483,26,53,79,7,6,22,17,88,62,1.1
5574,Sean Price\sean-price-1,2017-18,Charleston Southern,F,21,4,226,22,50,.440,13,23,.565,9,27,.333,9,12,.750,8,13,21,22,11,2,7,22,62,2.7
5575,Chase Jeter\chase-jeter-1,2015-16,Duke,F,32,0,254,21,38,.553,21,38,.553,0,0,,20,37,.541,25,36,61,4,3,9,19,59,62,1.1
5576,Jalen Henry\jalen-henry-1,2014-15,Southern Illinois-Edwardsville,F,26,0,162,18,41,.439,18,41,.439,0,0,,26,37,.703,13,26,39,1,2,9,8,39,62,1.5
5577,Ethan Lee\ethan-lee-1,2014-15,Central Arkansas,F,26,0,250,20,41,.488,20,40,.500,0,1,.000,22,30,.733,14,26,40,7,7,5,22,46,62,1.2
5578,Cheikh Mbacke Diong\cheikh-mbackediong-1,2017-18,Nevada-Las Vegas,F,29,0,276,22,40,.550,22,40,.550,0,0,,18,29,.621,20,54,74,6,13,21,21,59,62,1.9
5579,Ryan King\ryan-king-1,2014-15,Northwestern State,F,22,0,237,24,41,.585,24,41,.585,0,0,,13,22,.591,22,22,44,4,2,9,4,28,61,2.6
5580,Matej Svoboda\matej-svoboda-1,2017-18,Dayton,F,28,0,318,25,76,.329,16,31,.516,9,45,.200,2,2,1.000,9,24,33,17,4,2,25,44,61,0.2
5581,Robert Baker\robert-baker-2,2016-17,Harvard,F,22,0,185,23,52,.442,15,28,.536,8,24,.333,7,10,.700,7,36,43,5,5,12,10,20,61,2.1
5582,Cole Long\cole-long-1,2016-17,Detroit Mercy,F,30,7,367,21,78,.269,19,54,.352,2,24,.083,17,24,.708,26,38,64,12,11,7,15,57,61,0.9
5583,Craig Sealey\craig-sealey-1,2013-14,Bowling Green State,F,16,1,247,23,64,.359,22,62,.355,1,2,.500,14,23,.609,12,27,39,9,4,6,9,17,61,2.3
5584,Hunter Mickelson\hunter-mickelson-1,2015-16,Kansas,F,26,11,201,25,57,.439,25,56,.446,0,1,.000,11,16,.688,20,39,59,12,13,23,7,40,61,2.7
5585,Aleks Abrams\aleks-abrams-1,2016-17,Cal Poly,F,25,10,313,21,39,.538,21,39,.538,0,0,,19,33,.576,48,56,104,2,4,10,10,41,61,2.9
5586,Henrik Jadersten\henrik-jadersten-1,2017-18,Santa Clara,F,21,0,205,21,51,.412,11,19,.579,10,32,.313,9,12,.750,9,29,38,6,2,11,3,33,61,2.2
5587,Jay Copeland\jay-copeland-1,2015-16,North Carolina Central,F,11,11,232,22,38,.579,22,38,.579,0,0,,17,26,.654,25,28,53,1,11,3,21,35,61,4.0
5588,Alex Ogundadegbe\alex-ogundadegbe-1,2013-14,Binghamton,F,27,9,307,21,45,.467,21,44,.477,0,1,.000,19,31,.613,20,29,49,11,13,5,23,51,61,1.4
5589,Andre Frederick\andre-frederick-1,2015-16,Robert Morris,F,27,6,361,28,45,.622,28,45,.622,0,0,,5,17,.294,18,20,38,3,14,18,19,43,61,1.7
5590,Myles Douglas\myles-douglas-1,2017-18,Central Florida,F,31,1,276,20,68,.294,15,39,.385,5,29,.172,16,34,.471,4,29,33,9,1,1,25,29,61,-0.1
5591,Jesse Bunting\jesse-bunting-1,2016-17,Fordham,F,29,9,295,24,43,.558,23,38,.605,1,5,.200,12,20,.600,32,29,61,8,12,13,8,42,61,2.4
5592,Jeremy Jones\jeremy-jones-4,2017-18,Gonzaga,F,36,0,233,19,33,.576,17,26,.654,2,7,.286,21,31,.677,11,34,45,8,10,6,10,30,61,1.6
5593,Deontae Cole\deontae-cole-1,2013-14,Northern Kentucky,F,24,1,256,19,76,.250,3,11,.273,16,65,.246,7,7,1.000,7,13,20,8,3,3,3,25,61,0.9
5594,Stavian Allen\stavian-allen-1,2016-17,Norfolk State,F,27,4,256,23,55,.418,17,39,.436,6,16,.375,9,17,.529,11,50,61,7,3,13,19,36,61,1.3
5595,Alex Thompson\alex-thompson-2,2014-15,Auburn,F,23,0,261,19,67,.284,12,30,.400,7,37,.189,16,26,.615,13,30,43,6,5,7,13,34,61,1.0
5596,Rokas Ulvydas\rokas-ulvydas-1,2017-18,Central Florida,F,26,2,277,22,46,.478,22,46,.478,0,0,,17,30,.567,17,43,60,1,2,22,16,45,61,1.6
5597,Angus Riley\angus-riley-1,2017-18,Bryant,F,24,8,239,20,57,.351,7,17,.412,13,40,.325,8,12,.667,15,33,48,12,3,2,8,35,61,1.6
5598,Zeno Lake\zeno-lake-1,2017-18,Cal State Northridge,F,16,9,323,23,44,.523,23,44,.523,0,0,,15,30,.500,28,44,72,4,6,6,9,35,61,3.5
5599,Jeff Coby\jeff-coby-1,2013-14,Columbia,F,22,0,224,19,44,.432,18,41,.439,1,3,.333,22,29,.759,20,37,57,8,3,5,14,46,61,1.8
5600,Julian Royal\julian-royal-1,2014-15,George Mason,F,18,1,223,24,67,.358,23,58,.397,1,9,.111,12,18,.667,15,28,43,4,4,5,17,36,61,1.1
5601,Sean Harris\sean-harris-1,2014-15,Utah State,F,31,1,384,27,49,.551,27,49,.551,0,0,,7,13,.538,31,43,74,15,8,16,16,41,61,2.2
5602,Roman Sorkin\roman-sorkin-1,2017-18,Oregon,F,21,2,141,22,45,.489,13,18,.722,9,27,.333,7,9,.778,8,11,19,5,0,7,5,23,60,1.9
5603,Austin Weiher\austin-weiher-1,2016-17,Southern Illinois,F,24,1,187,19,44,.432,11,23,.478,8,21,.381,14,22,.636,10,13,23,4,7,1,11,27,60,1.4
5604,Austin Etherington\austin-etherington-1,2013-14,Indiana,F,30,6,318,15,46,.326,10,25,.400,5,21,.238,25,32,.781,11,37,48,14,10,4,17,46,60,1.2
5605,Donoven Carlisle\donoven-carlisle-1,2017-18,Denver,F,26,0,342,25,42,.595,23,38,.605,2,4,.500,8,13,.615,14,58,72,3,5,4,14,38,60,1.8
5606,Nick Reese\nick-reese-1,2016-17,North Carolina A&T,F,26,8,295,24,57,.421,21,42,.500,3,15,.200,9,19,.474,21,28,49,10,7,2,14,66,60,0.9
5607,TreVaughn Wilkerson\trevaughn-wilkerson-1,2015-16,Hartford,F,25,9,294,25,44,.568,25,43,.581,0,1,.000,10,14,.714,13,42,55,9,6,20,23,60,60,1.5
5608,Adam Sledd\adam-sledd-1,2017-18,Western Carolina,F,31,2,211,28,59,.475,28,59,.475,0,0,,4,10,.400,24,14,38,6,2,5,7,35,60,1.2
5609,E'Torrion Wilridge\etorrion-wilridge-1,2016-17,Georgia,F,29,8,470,22,48,.458,13,21,.619,9,27,.333,7,17,.412,5,42,47,34,11,11,18,26,60,2.1
5610,Demonte Flannigan\demonte-flannigan-1,2014-15,Cleveland State,F,30,0,218,27,43,.628,27,42,.643,0,1,.000,6,20,.300,18,19,37,3,3,6,12,31,60,1.3
5611,Daniel Mortensen\daniel-mortensen-1,2015-16,Wright State,F,22,0,139,21,52,.404,3,8,.375,18,44,.409,0,0,,2,15,17,5,1,3,5,17,60,1.5
5612,Shawn Smith\shawn-smith-3,2014-15,Marshall,F,5,5,124,21,43,.488,12,19,.632,9,24,.375,9,12,.750,2,5,7,3,3,1,7,10,60,7.0
5613,Howard Thomas\howard-thomas-1,2016-17,McNeese State,F,20,2,188,24,51,.471,24,51,.471,0,0,,12,28,.429,18,23,41,3,7,6,12,20,60,2.0
5614,Jerome Hunter\jerome-hunter-1,2014-15,Eastern Michigan,F,35,3,397,22,38,.579,22,37,.595,0,1,.000,16,24,.667,27,62,89,4,12,13,18,78,60,1.5
5615,Shane Henry\shane-henry-1,2015-16,Virginia Tech,F,33,22,287,25,46,.543,25,46,.543,0,0,,10,34,.294,16,53,69,2,6,12,13,49,60,1.2
5616,Tracy Burnett\tracy-burnett-1,2016-17,Alabama A&M,F,10,8,234,23,49,.469,23,49,.469,0,0,,14,25,.560,8,22,30,4,2,1,18,19,60,2.3
5617,Steven Davis\steven-davis-2,2013-14,Wright State,F,22,2,200,17,50,.340,14,32,.438,3,18,.167,23,31,.742,11,21,32,12,11,6,16,34,60,1.7
5618,Travis Fuller\travis-fuller-1,2017-18,Brown,F,18,3,179,22,53,.415,22,47,.468,0,6,.000,16,21,.762,19,39,58,19,3,3,16,31,60,2.5
5619,Robyn Missa\robyn-missa-1,2014-15,Nevada,F,24,11,318,23,54,.426,20,44,.455,3,10,.300,11,19,.579,21,43,64,2,2,4,18,29,60,1.4
5620,Jerred Kite\jerred-kite-1,2016-17,Incarnate Word,F,26,7,301,17,40,.425,9,24,.375,8,16,.500,18,22,.818,16,20,36,10,8,10,7,37,60,2.1
5621,Jeffery McClendon\jeffery-mcclendon-1,2016-17,Loyola Marymount,F,28,3,318,23,67,.343,19,41,.463,4,26,.154,10,25,.400,16,20,36,13,22,6,19,49,60,1.1
5622,Jamal Aytes\jamal-aytes-1,2016-17,Brigham Young,F,27,0,163,23,41,.561,23,41,.561,0,0,,14,20,.700,14,19,33,6,0,3,12,28,60,1.4
5623,Brennan Gillis\brennan-gillis-1,2015-16,Northern Kentucky,F,29,1,253,18,53,.340,13,39,.333,5,14,.357,19,27,.704,19,25,44,7,9,7,23,43,60,0.9
5624,Stone Gettings\stone-gettings-1,2015-16,Cornell,F,28,0,267,22,71,.310,15,37,.405,7,34,.206,9,13,.692,24,27,51,3,4,8,18,52,60,0.5
5625,San Antonio Brinson\sanantonio-brinson-1,2017-18,NJIT,F,23,1,186,22,56,.393,22,44,.500,0,12,.000,16,23,.696,17,31,48,12,8,7,7,16,60,2.4
5626,Luke Worthington\luke-worthington-1,2014-15,Brigham Young,F,33,20,407,21,46,.457,21,46,.457,0,0,,18,27,.667,23,32,55,6,10,2,14,93,60,0.7
5627,Joe Boyd\joe-boyd-1,2013-14,Cal State Fullerton,F,28,7,335,22,54,.407,22,52,.423,0,2,.000,16,22,.727,21,50,71,3,5,6,16,42,60,1.3
5628,Jake Verhagen\jake-verhagen-1,2013-14,Eastern Illinois,F,28,0,261,21,54,.389,3,7,.429,18,47,.383,0,0,,4,21,25,7,10,5,3,24,60,1.6
5629,Ibrahim Djambo\ibrahim-djambo-1,2013-14,Clemson,F,32,1,294,21,66,.318,11,24,.458,10,42,.238,8,12,.667,14,30,44,4,5,6,14,42,60,0.6
5630,Aaron Ross\aaron-ross-1,2014-15,Texas Tech,F,23,0,227,16,62,.258,14,43,.326,2,19,.105,26,30,.867,11,31,42,8,1,6,21,29,60,0.7
5631,Nolan Gerrity\nolan-gerrity-1,2015-16,Maryland-Baltimore County,F,19,2,220,23,43,.535,23,43,.535,0,0,,14,33,.424,21,21,42,2,1,11,5,38,60,2.2
5632,Kanu Aja\kanu-aja-1,2014-15,East Carolina,F,29,0,239,26,62,.419,26,62,.419,0,0,,8,18,.444,26,21,47,4,5,2,18,35,60,0.9
5633,Clarence Williams\clarence-williams-1,2016-17,East Carolina,F,12,12,234,22,57,.386,19,49,.388,3,8,.375,13,18,.722,18,33,51,6,8,4,28,26,60,2.2
5634,Cameron Smith\cameron-smith-2,2016-17,Florida International,F,22,13,272,20,34,.588,20,34,.588,0,0,,20,29,.690,15,41,56,4,8,16,15,29,60,2.7
5635,Sean Tingle\sean-tingle-1,2013-14,Arkansas-Pine Bluff,F,27,1,174,18,44,.409,18,43,.419,0,1,.000,24,41,.585,15,14,29,2,3,4,30,36,60,0.3
5636,Mohamed Bah\mohamed-bah-1,2015-16,Drexel,F,26,2,341,22,51,.431,22,50,.440,0,1,.000,15,32,.469,19,56,75,8,7,11,18,52,59,1.4
5637,Tyler Burgess\tyler-burgess-1,2016-17,Citadel,F,12,0,97,19,52,.365,0,1,.000,19,51,.373,2,4,.500,3,8,11,2,0,0,3,4,59,2.6
5638,Donaven Dorsey\donaven-dorsey-1,2015-16,Washington,F,27,0,248,21,57,.368,7,14,.500,14,43,.326,3,7,.429,7,23,30,11,5,0,7,35,59,1.1
5639,Ty Egbert\ty-egbert-1,2013-14,Idaho,F,30,1,372,23,41,.561,23,41,.561,0,0,,13,32,.406,23,43,66,7,4,15,12,65,59,1.4
5640,Jermaine Lippert\jermaine-lippert-1,2013-14,Detroit Mercy,F,32,4,280,25,38,.658,25,37,.676,0,1,.000,9,20,.450,12,25,37,15,17,9,20,63,59,1.3
5641,Giacomo Zilli\giacomo-zilli-1,2013-14,North Carolina-Asheville,F,22,2,174,21,35,.600,21,35,.600,0,0,,17,21,.810,17,18,35,10,4,4,13,39,59,2.0
5642,Isaiah Thomas\isaiah-thomas-2,2015-16,Northern Arizona,F,30,6,257,24,45,.533,24,45,.533,0,0,,11,17,.647,14,31,45,2,2,13,11,63,59,1.0
5643,Ryan Winters\ryan-winters-1,2013-14,Elon,F,20,0,215,22,37,.595,22,37,.595,0,0,,15,19,.789,12,18,30,8,2,0,12,31,59,1.9
5644,Tyler Riemersma\tyler-riemersma-1,2017-18,Navy,F,28,0,288,20,51,.392,20,46,.435,0,5,.000,19,25,.760,34,43,77,22,11,6,18,20,59,2.5
5645,Vitaliy Shibel\vitaliy-shibel-1,2017-18,Arizona State,F,32,22,332,19,55,.345,8,11,.727,11,44,.250,10,12,.833,11,48,59,17,4,9,13,73,59,0.9
5646,Alex Peters\alex-peters-1,2015-16,Samford,F,28,1,329,23,55,.418,23,55,.418,0,0,,13,25,.520,27,31,58,5,8,8,21,77,59,0.7
5647,Alex Fountain\alex-fountain-1,2013-14,Houston Baptist,F,24,3,263,17,44,.386,16,39,.410,1,5,.200,24,30,.800,14,23,37,7,5,9,15,37,59,1.5
5648,Kris Acox\kris-acox-1,2013-14,Furman,F,16,2,331,23,42,.548,23,42,.548,0,0,,13,24,.542,35,41,76,7,6,4,11,34,59,3.8
5649,Marcus Lee\marcus-lee-2,2013-14,Kentucky,F,25,4,156,26,42,.619,26,42,.619,0,0,,7,16,.438,21,15,36,2,0,14,4,19,59,2.2
5650,Myles Hanson\myles-hanson-1,2017-18,Columbia,F,19,0,200,21,64,.328,9,21,.429,12,43,.279,5,5,1.000,8,35,43,8,5,4,8,18,59,1.9
5651,Kimani Jackson\kimani-jackson-1,2015-16,Colorado State,F,25,1,222,24,56,.429,24,54,.444,0,2,.000,11,22,.500,28,24,52,9,1,10,27,43,59,0.9
5652,Alain Chigha\alain-chigha-1,2016-17,Quinnipiac,F,29,2,297,24,46,.522,18,26,.692,6,20,.300,5,12,.417,21,36,57,9,10,5,8,59,59,1.6
5653,Noe Anabir\noe-anabir-1,2017-18,Youngstown State,F,25,5,243,23,41,.561,23,41,.561,0,0,,13,25,.520,21,27,48,13,7,5,16,42,59,1.8
5654,Merrill Holden\merrill-holden-1,2016-17,Iowa State,F,25,14,280,17,32,.531,17,32,.531,0,0,,25,44,.568,24,25,49,0,4,12,13,59,59,1.4
5655,Derrien King\derrien-king-1,2016-17,Washington State,F,9,6,221,17,60,.283,12,35,.343,5,25,.200,20,26,.769,5,34,39,7,3,2,24,19,59,1.4
5656,Nathan Bain\nathan-bain-1,2015-16,Stephen F. Austin,F,24,0,179,22,43,.512,21,39,.538,1,4,.250,14,27,.519,17,32,49,11,8,7,9,18,59,2.4
5657,Evan Kuhlman\evan-kuhlman-1,2017-18,Evansville,F,25,3,284,22,48,.458,12,26,.462,10,22,.455,5,6,.833,5,24,29,7,5,3,6,31,59,1.5
5658,Tanner Schmit\tanner-schmit-1,2015-16,Central Arkansas,F,26,0,196,25,58,.431,25,58,.431,0,0,,9,14,.643,4,22,26,3,4,6,15,39,59,0.6
5659,Quadri Moore\quadri-moore-1,2015-16,Cincinnati,F,26,0,190,21,54,.389,17,42,.405,4,12,.333,13,19,.684,13,21,34,2,8,2,18,21,59,1.0
5660,Mike Shaw\mike-shaw-1,2014-15,Bradley,F,31,10,449,22,64,.344,20,53,.377,2,11,.182,12,29,.414,38,68,106,20,24,16,35,79,58,1.4
5661,Alonzo Chatman\alonzo-chatman-1,2017-18,Morehead State,F,24,6,289,23,38,.605,23,38,.605,0,0,,12,25,.480,23,33,56,8,3,0,29,62,58,0.7
5662,Jarrod Simmons\jarrod-simmons-1,2017-18,Pennsylvania,F,24,0,147,19,42,.452,14,27,.519,5,15,.333,15,19,.789,13,27,40,7,4,6,10,25,58,1.9
5663,Corey Barrett\corey-barrett-1,2014-15,Central Connecticut State,F,27,0,282,25,68,.368,25,68,.368,0,0,,8,16,.500,26,41,67,3,3,9,12,39,58,1.2
5664,Alec Brennan\alec-brennan-1,2016-17,Princeton,F,25,0,192,23,44,.523,16,27,.593,7,17,.412,5,7,.714,13,24,37,7,4,8,7,29,58,1.9
5665,Jamal Evans\jamal-evans-1,2015-16,Northern Colorado,F,16,0,128,21,45,.467,11,27,.407,10,18,.556,6,11,.545,8,20,28,1,0,5,10,29,58,1.7
5666,Matt Jackson\matt-jackson-1,2014-15,Grand Canyon,F,22,6,284,16,50,.320,10,34,.294,6,16,.375,20,27,.741,7,35,42,12,3,2,12,26,58,1.5
5667,Terrance Shannon\terrance-shannon-1,2013-14,Virginia Commonwealth,F,20,6,211,22,52,.423,22,51,.431,0,1,.000,14,33,.424,20,26,46,6,16,14,13,37,58,2.3
5668,Hikeem Champaigne\hikeem-champaigne-1,2013-14,Savannah State,F,29,4,265,27,58,.466,27,58,.466,0,0,,4,10,.400,28,28,56,5,6,13,23,40,58,1.2
5669,Elijah Thomas\elijah-thomas-2,2017-18,Saint Mary's (CA),F,29,0,192,20,43,.465,10,20,.500,10,23,.435,8,14,.571,6,19,25,5,16,1,3,28,58,1.7
5670,Vlatko Granic\vlatko-granic-1,2016-17,Loyola (IL),F,24,0,222,23,49,.469,17,29,.586,6,20,.300,6,15,.400,12,19,31,6,5,4,8,24,58,1.6
5671,Marcale Lotts\marcale-lotts-1,2017-18,Canisius,F,32,9,315,26,42,.619,26,42,.619,0,0,,6,19,.316,32,29,61,6,5,1,24,63,58,0.8
5672,Kyle Rhoades\kyle-rhoades-1,2016-17,Western Carolina,F,25,0,199,19,42,.452,15,34,.441,4,8,.500,16,23,.696,21,28,49,11,9,2,21,30,58,1.7
5673,Desmond Ringer\desmond-ringer-1,2013-14,South Carolina,F,28,1,291,18,48,.375,18,48,.375,0,0,,22,35,.629,24,31,55,7,2,6,17,58,58,0.8
5674,Dom Samac\dom-samac-1,2013-14,Denver,F,17,11,215,22,44,.500,15,24,.625,7,20,.350,7,10,.700,6,19,25,9,5,1,6,26,58,2.4
5675,Christian Ejiga\christian-ejiga-1,2013-14,Maine,F,20,7,226,22,50,.440,22,50,.440,0,0,,14,22,.636,21,42,63,3,7,7,17,50,58,1.6
5676,Brandon Mitchell\brandon-mitchell-2,2017-18,San Jose State,F,9,0,152,25,47,.532,22,38,.579,3,9,.333,5,9,.556,8,16,24,6,5,7,14,15,58,4.2
5677,Kimani Lawrence\kimani-lawrence-1,2017-18,Arizona State,F,19,0,186,22,48,.458,19,33,.576,3,15,.200,11,13,.846,10,23,33,3,7,8,9,31,58,2.1
5678,Luka Radovic\luka-radovic-1,2013-14,South Carolina State,F,28,13,312,22,54,.407,22,46,.478,0,8,.000,14,25,.560,35,32,67,6,4,9,22,46,58,1.2
5679,Tim Myles\tim-myles-1,2017-18,Houston Baptist,F,24,3,242,23,52,.442,22,51,.431,1,1,1.000,11,26,.423,32,40,72,13,11,15,40,66,58,1.0
5680,Jalen Brown\jalen-brown-1,2014-15,Georgia State,F,32,0,250,17,41,.415,3,5,.600,14,36,.389,10,20,.500,7,38,45,5,6,4,14,26,58,1.1
5681,Demetrius Houston\demetrius-houston-1,2016-17,Alabama State,F,7,6,194,23,55,.418,23,51,.451,0,4,.000,12,21,.571,13,31,44,9,9,7,26,21,58,4.2
5682,Nicola Akele\nicola-akele-1,2017-18,Rhode Island,F,29,0,248,26,56,.464,24,48,.500,2,8,.250,4,6,.667,24,30,54,5,7,5,5,48,58,1.5
5683,Fletcher Larson\fletcher-larson-1,2014-15,Youngstown State,F,26,2,307,25,59,.424,25,59,.424,0,0,,8,9,.889,11,30,41,12,3,6,9,49,58,1.2
5684,John Kopriva\john-kopriva-1,2013-14,George Washington,F,33,0,395,21,48,.438,21,48,.438,0,0,,16,31,.516,29,53,82,13,12,10,21,54,58,1.5
5685,Onno Steger\onno-steger-1,2017-18,Western Carolina,F,27,4,247,23,63,.365,13,29,.448,10,34,.294,2,11,.182,7,17,24,9,9,3,15,25,58,0.8
5686,Roberto Vercellino\roberto-vercellino-1,2017-18,Northern Colorado,F,28,1,291,20,41,.488,19,28,.679,1,13,.077,17,23,.739,24,40,64,11,7,11,14,44,58,1.9
5687,Alain Chigha\alain-chigha-1,2017-18,Quinnipiac,F,29,18,370,23,61,.377,19,39,.487,4,22,.182,8,17,.471,20,31,51,9,28,2,17,57,58,1.4
5688,Vlad Shustov\vlad-shustov-1,2015-16,NJIT,F,25,8,292,27,57,.474,26,54,.481,1,3,.333,3,5,.600,13,31,44,11,2,12,23,51,58,0.8
5689,Andy Van Vliet\andy-vanvliet-1,2017-18,Wisconsin,F,17,4,131,18,39,.462,6,16,.375,12,23,.522,10,14,.714,5,18,23,3,1,3,5,14,58,2.3
5690,Aleks Abrams\aleks-abrams-1,2017-18,Cal Poly,F,24,5,321,21,47,.447,21,47,.447,0,0,,16,22,.727,41,61,102,10,4,14,15,37,58,2.9
5691,Hunter Seacat\hunter-seacat-1,2017-18,Appalachian State,F,22,0,246,26,46,.565,26,46,.565,0,0,,6,9,.667,16,39,55,12,4,10,13,32,58,2.3
5692,Michael Cobbins\mike-cobbins-1,2013-14,Oklahoma State,F,13,13,256,25,50,.500,25,50,.500,0,0,,8,17,.471,20,36,56,5,8,19,10,32,58,4.3
5693,Nik Biberaj\nik-biberaj-1,2014-15,Old Dominion,F,28,0,237,21,61,.344,14,41,.341,7,20,.350,9,14,.643,20,28,48,11,1,4,6,33,58,1.3
5694,Kory Kuenstling\kory-kuenstling-1,2014-15,Drake,F,30,1,299,16,37,.432,16,37,.432,0,0,,26,32,.813,11,28,39,2,4,6,23,37,58,0.8
5695,Taze Moore\taze-moore-1,2016-17,Cal State Bakersfield,F,24,0,259,23,48,.479,18,31,.581,5,17,.294,7,11,.636,12,37,49,22,18,3,18,40,58,2.2
5696,Christopher Ikuenobe\christopher-ikuenobe-1,2015-16,Texas-Rio Grande Valley,F,27,2,209,23,44,.523,23,44,.523,0,0,,12,22,.545,12,19,31,7,4,7,10,32,58,1.4
5697,Richard Laku\richard-laku-1,2017-18,McNeese State,F,22,2,163,19,53,.358,8,20,.400,11,33,.333,9,12,.750,8,17,25,5,2,7,6,24,58,1.5
5698,Chibueze Jacobs\chibueze-jacobs-1,2016-17,Sacramento State,F,30,1,223,21,40,.525,15,28,.536,6,12,.500,10,11,.909,16,36,52,4,5,11,7,22,58,2.0
5699,Tyler Olander\tyler-olander-1,2013-14,Connecticut,F,33,4,273,20,44,.455,18,37,.486,2,7,.286,16,22,.727,18,22,40,3,12,3,4,43,58,1.4
5700,Daryus Quarles\daryus-quarles-1,2013-14,Saint Joseph's,F,24,0,275,20,58,.345,14,30,.467,6,28,.214,12,21,.571,7,19,26,8,8,1,12,23,58,1.1
5701,Kregg Jones\kregg-jones-1,2014-15,Cal State Bakersfield,F,27,1,221,21,41,.512,21,41,.512,0,0,,15,35,.429,9,27,36,0,2,10,11,24,57,1.2
5702,Brett Jolly\brett-jolly-1,2014-15,Saint Louis,F,30,2,326,13,50,.260,11,31,.355,2,19,.105,29,39,.744,11,15,26,12,6,12,18,57,57,0.6
5703,Melvin Tabb\melvin-tabb-1,2013-14,Kent State,F,20,1,168,19,40,.475,19,40,.475,0,0,,19,38,.500,17,19,36,3,1,1,19,39,57,0.8
5704,Phillip Lawrence-Ricks\phillip-lawrence-1,2015-16,Marist,F,20,3,170,22,49,.449,17,32,.531,5,17,.294,8,14,.571,12,21,33,7,2,2,7,15,57,2.0
5705,Charles Wilson-Fisher\charle-wilson-fisher-1,2014-15,Hampton,F,19,0,199,25,51,.490,23,41,.561,2,10,.200,5,11,.455,19,35,54,6,7,6,14,32,57,2.2
5706,Grady Eifert\grady-eifert-1,2017-18,Purdue,F,36,2,299,21,33,.636,19,28,.679,2,5,.400,13,24,.542,19,41,60,19,6,1,8,25,57,1.8
5707,Karim York\karim-york-1,2013-14,Prairie View,F,17,0,150,22,53,.415,12,26,.462,10,27,.370,3,7,.429,6,21,27,2,5,4,14,15,57,1.6
5708,Joshua Tomaic\joshua-tomaic-1,2017-18,Maryland,F,26,1,230,20,31,.645,13,16,.813,7,15,.467,10,17,.588,17,30,47,8,0,6,10,21,57,2.0
5709,Blake Simpson\blake-simpson-1,2015-16,Coppin State,F,29,25,567,14,42,.333,14,42,.333,0,0,,29,48,.604,48,72,120,10,11,21,24,102,57,1.7
5710,Mohamed Bendary\mohamed-bendary-1,2016-17,NJIT,F,30,1,265,25,41,.610,25,41,.610,0,0,,7,12,.583,29,24,53,13,4,9,16,49,57,1.6
5711,Albert Christensson\albert-christensson-1,2015-16,Central Arkansas,F,27,0,210,18,40,.450,18,39,.462,0,1,.000,21,43,.488,16,26,42,3,0,3,16,31,57,0.8
5712,Quadri Moore\quadri-moore-1,2014-15,Cincinnati,F,26,0,213,21,56,.375,17,42,.405,4,14,.286,11,15,.733,6,22,28,6,7,4,19,26,57,0.8
5713,Justin Martin\justin-martin-1,2014-15,Southern Methodist,F,10,1,122,20,40,.500,16,27,.593,4,13,.308,13,18,.722,3,19,22,7,4,0,10,9,57,3.8
5714,Steve Taylor\steve-taylor-2,2013-14,Marquette,F,23,3,237,22,68,.324,20,55,.364,2,13,.154,11,18,.611,19,43,62,10,7,1,15,17,57,1.5
5715,Alec Brennan\alec-brennan-1,2017-18,Princeton,F,26,7,212,21,44,.477,12,25,.480,9,19,.474,6,12,.500,8,11,19,9,2,8,10,31,57,1.3
5716,Assane Diop\assane-diop-1,2016-17,Austin Peay,F,24,1,267,22,38,.579,22,38,.579,0,0,,13,27,.481,15,46,61,7,0,6,18,53,57,1.2
5717,Justin Tucker\justin-tucker-1,2016-17,Wofford,F,27,0,249,20,49,.408,20,48,.417,0,1,.000,17,28,.607,20,20,40,6,4,2,10,24,57,1.3
5718,Mamadou Ndaiye\mamadou-ndaiye-1,2016-17,Saint Peter's,F,32,1,177,22,50,.440,22,50,.440,0,0,,13,19,.684,22,21,43,4,2,0,11,27,57,1.0
5719,Phillip Jones\phillip-jones-2,2016-17,Sam Houston State,F,19,1,149,21,52,.404,21,49,.429,0,3,.000,15,27,.556,20,20,40,2,9,6,16,30,57,1.6
5720,Rantavious Gilbert\rantavious-gilbert-1,2013-14,Appalachian State,F,18,1,155,23,47,.489,23,47,.489,0,0,,11,17,.647,16,21,37,4,2,12,8,21,57,2.5
5721,Jacob McCord\jacob-mccord-1,2017-18,Idaho State,F,18,0,139,21,57,.368,19,47,.404,2,10,.200,13,20,.650,20,28,48,4,4,1,18,19,57,1.5
5722,Jonathan Joseph\jonathan-joseph-1,2014-15,Stetson,F,15,2,218,20,42,.476,16,28,.571,4,14,.286,13,23,.565,12,27,39,5,3,7,21,32,57,1.7
5723,Ozante Fields\ozante-fields-1,2016-17,South Carolina State,F,27,0,291,23,49,.469,23,49,.469,0,0,,11,16,.688,22,42,64,6,3,5,18,62,57,1.0
5724,Jeffery McClendon\jeffery-mcclendon-1,2015-16,Loyola Marymount,F,26,4,263,18,47,.383,14,37,.378,4,10,.400,16,27,.593,29,29,58,19,13,0,12,36,56,2.1
5725,Dale Francis\dale-francis-1,2015-16,Texas A&M-Corpus Christi,F,31,1,347,20,54,.370,9,12,.750,11,42,.262,5,6,.833,13,31,44,5,10,5,10,72,56,0.7
5726,John Carroll\john-carroll-2,2015-16,Hartford,F,5,5,123,21,54,.389,19,46,.413,2,8,.250,12,17,.706,9,19,28,10,1,3,8,21,56,6.1
5727,A.J. Avery\aj-avery-1,2013-14,Western Michigan,F,32,0,313,21,53,.396,21,53,.396,0,0,,14,21,.667,26,33,59,6,5,18,17,57,56,1.1
5728,Will Joyce\will-joyce-1,2015-16,Southern Utah,F,25,0,156,22,45,.489,22,45,.489,0,0,,12,26,.462,25,21,46,3,4,7,6,31,56,1.8
5729,Abu Kigab\abu-kigab-1,2017-18,Oregon,F,35,0,269,21,61,.344,16,39,.410,5,22,.227,9,22,.409,12,27,39,8,13,7,16,40,56,0.7
5730,David Howard\david-howard-1,2015-16,Evansville,F,28,0,150,17,33,.515,17,32,.531,0,1,.000,22,39,.564,14,25,39,4,3,6,13,39,56,1.1
5731,Dalton Nixon\dalton-nixon-1,2014-15,Brigham Young,F,27,2,262,20,47,.426,17,29,.586,3,18,.167,13,13,1.000,12,33,45,21,4,4,12,32,56,1.7
5732,Malek Harris\malek-harris-1,2014-15,Kansas State,F,27,0,336,21,53,.396,21,50,.420,0,3,.000,14,23,.609,17,33,50,14,2,0,18,38,56,0.9
5733,Samuli Nieminen\samuli-nieminen-1,2016-17,Stephen F. Austin,F,15,5,218,20,37,.541,18,32,.563,2,5,.400,14,20,.700,16,13,29,5,7,2,21,35,56,1.8
5734,Jalanni White\jalanni-white-1,2017-18,Canisius,F,25,4,247,22,47,.468,21,36,.583,1,11,.091,11,18,.611,22,19,41,8,7,12,16,46,56,1.5
5735,Kader Tapsoba\kader-tapsoba-1,2013-14,Texas Tech,F,26,3,244,22,40,.550,22,40,.550,0,0,,12,18,.667,12,17,29,7,10,15,14,51,56,1.5
5736,Tyshawn Myles\tyshawn-myles-1,2016-17,Drexel,F,25,0,310,23,48,.479,23,48,.479,0,0,,10,21,.476,31,40,71,5,1,8,7,60,56,1.6
5737,Grant Fiorentinos\grant-fiorentinos-1,2014-15,Southern Illinois-Edwardsville,F,26,2,248,22,46,.478,21,44,.477,1,2,.500,11,15,.733,19,28,47,7,8,3,13,44,56,1.4
5738,Brian Dawkins\brian-dawkins-1,2013-14,Elon,F,27,0,188,21,45,.467,21,45,.467,0,0,,14,21,.667,18,29,47,5,5,2,13,46,56,1.1
5739,Abiola Akintola\abiola-akintola-1,2017-18,Denver,F,29,10,321,25,50,.500,25,50,.500,0,0,,6,21,.286,19,44,63,12,7,6,14,50,56,1.3
5740,Jarred Guest\jarred-guest-1,2013-14,Virginia Commonwealth,F,35,1,318,25,70,.357,23,66,.348,2,4,.500,4,9,.444,43,37,80,8,14,11,19,49,56,1.3
5741,Charles Buggs\charles-buggs-1,2016-17,Southern California,F,24,2,213,21,36,.583,14,22,.636,7,14,.500,7,9,.778,9,33,42,4,8,10,9,38,56,2.0
5742,Jesse Hunt\jesse-hunt-1,2015-16,Eastern Washington,F,30,10,283,23,48,.479,18,31,.581,5,17,.294,5,8,.625,28,27,55,9,8,8,7,55,56,1.6
5743,Jason Owens\jason-owens-1,2013-14,Delaware State,F,28,2,260,25,67,.373,25,66,.379,0,1,.000,6,13,.462,17,45,62,5,6,2,17,37,56,0.7
5744,DaJuan Coleman\dajuan-coleman-1,2013-14,Syracuse,F,13,12,169,21,36,.583,21,36,.583,0,0,,14,28,.500,31,23,54,3,4,7,11,23,56,4.1
5745,Simi Fajemisin\simi-fajemisin-1,2014-15,San Diego,F,31,6,269,24,40,.600,24,40,.600,0,0,,8,16,.500,26,33,59,2,3,9,6,54,56,1.5
5746,Tavario Miller\tavario-miller-1,2013-14,Texas A&M,F,31,0,304,20,48,.417,20,48,.417,0,0,,16,34,.471,24,50,74,6,7,9,14,55,56,1.2
5747,Nakye Sanders\nayke-sanders-1,2015-16,Duquesne,F,30,1,276,21,32,.656,21,32,.656,0,0,,14,38,.368,27,59,86,14,7,17,15,67,56,1.9
5748,Oliver Black\oliver-black-1,2014-15,Mississippi State,F,31,4,490,22,45,.489,22,45,.489,0,0,,12,27,.444,24,51,75,8,12,8,24,59,56,1.1
5749,Magnus Richards\magnus-richards-1,2014-15,Binghamton,F,26,2,258,19,43,.442,19,42,.452,0,1,.000,18,32,.563,18,33,51,5,8,6,25,45,56,0.9
5750,Harry Froling\harry-froling-1,2017-18,Marquette,F,20,4,248,25,56,.446,21,37,.568,4,19,.211,2,5,.400,19,41,60,20,3,4,16,32,56,2.1
5751,Javion Ogunyemi\javion-ogunyemi-1,2013-14,Siena,F,30,4,324,22,69,.319,22,69,.319,0,0,,12,28,.429,24,31,55,7,5,22,11,58,56,0.9
5752,Junior Longrus\junior-longrus-1,2015-16,Washington State,F,31,14,449,24,40,.600,24,39,.615,0,1,.000,7,21,.333,26,46,72,19,23,18,25,63,55,2.0
5753,Tavares Sledge\tavares-sledge-1,2013-14,Wright State,F,21,4,260,22,49,.449,21,46,.457,1,3,.333,10,14,.714,17,54,71,5,4,9,11,42,55,2.0
5754,Waverly Austin\waverly-austin-1,2013-14,Oregon,F,31,23,328,19,46,.413,19,46,.413,0,0,,17,29,.586,28,44,72,8,9,26,14,64,55,1.7
5755,Tyler Stone\tyler-stone-2,2014-15,Howard,F,32,1,243,18,38,.474,16,36,.444,2,2,1.000,17,25,.680,12,32,44,4,14,9,12,35,55,1.5
5756,Lucas Jones\lucas-jones-2,2015-16,Eastern Illinois,F,19,6,238,22,54,.407,14,28,.500,8,26,.308,3,5,.600,13,24,37,5,3,2,8,18,55,1.8
5757,Matija Radovic\matija-radovic-1,2017-18,Hofstra,F,25,0,260,17,60,.283,3,12,.250,14,48,.292,7,12,.583,13,33,46,7,5,1,12,21,55,1.1
5758,Jack Anton\jack-anton-1,2015-16,Elon,F,31,0,272,21,52,.404,17,35,.486,4,17,.235,9,15,.600,21,27,48,13,3,5,15,49,55,0.9
5759,Clevon Brown\clevon-brown-1,2016-17,Vanderbilt,F,34,1,259,20,51,.392,12,24,.500,8,27,.296,7,12,.583,16,34,50,3,1,14,16,35,55,0.9
5760,Xeyrius Williams\xeryius-williams-1,2015-16,Dayton,F,27,0,245,21,47,.447,17,35,.486,4,12,.333,9,12,.750,15,30,45,5,11,10,12,30,55,1.7
5761,D.J. Bennett\dj-bennett-1,2014-15,Oklahoma,F,29,0,226,21,42,.500,21,42,.500,0,0,,13,24,.542,15,35,50,3,4,19,10,44,55,1.5
5762,Amar Alibegovic\amar-alibegovic-1,2016-17,St. John's (NY),F,26,0,267,19,46,.413,12,21,.571,7,25,.280,10,17,.588,9,34,43,17,5,10,14,47,55,1.4
5763,Remi Barry\remi-barry-1,2013-14,New Mexico State,F,9,0,113,17,34,.500,17,33,.515,0,1,.000,21,25,.840,10,16,26,5,0,3,4,9,55,5.1
5764,Nikola Rakicevic\nikola-rakicevic-1,2016-17,Buffalo,F,21,3,181,22,52,.423,18,34,.529,4,18,.222,7,17,.412,15,13,28,8,6,3,8,12,55,1.8
5765,Tarekeyi Edogi\tarekeyi-edogi-1,2014-15,Tulsa,F,32,0,238,21,37,.568,21,37,.568,0,0,,13,36,.361,22,30,52,0,2,7,11,29,55,1.2
5766,Jay Harvey\jay-harvey-1,2017-18,Florida International,F,30,12,481,20,44,.455,20,44,.455,0,0,,15,41,.366,56,36,92,3,5,8,21,65,55,1.3
5767,Andrew McAuliffe\andrew-mcauliffe-1,2016-17,Davidson,F,25,5,222,25,42,.595,25,42,.595,0,0,,5,11,.455,10,18,28,9,2,9,16,48,55,1.0
5768,Derek Webster Jr.\derek-websterjr-1,2017-18,Citadel,F,27,1,215,21,40,.525,20,38,.526,1,2,.500,12,25,.480,20,29,49,9,8,8,16,29,55,1.7
5769,Bennett Holley\bennett-holley-1,2017-18,Appalachian State,F,29,0,199,18,45,.400,3,6,.500,15,39,.385,4,4,1.000,8,20,28,7,2,3,4,32,55,1.2
5770,Joonas Tahvanainen\joonas-tahvanainen-1,2016-17,Utah Valley,F,25,1,177,21,43,.488,17,29,.586,4,14,.286,9,13,.692,11,26,37,5,7,0,13,25,55,1.4
5771,Glenn Hollaway\glenn-hollaway-1,2015-16,Alabama State,F,25,4,297,25,39,.641,25,38,.658,0,1,.000,5,11,.455,25,36,61,8,3,20,5,41,55,2.6
5772,Justin Whatley\justin-whatley-1,2017-18,East Carolina,F,22,1,296,24,53,.453,20,39,.513,4,14,.286,3,6,.500,12,23,35,8,6,4,22,51,55,0.6
5773,Marcus Burwell\marcus-burwell-1,2014-15,Sam Houston State,F,28,7,283,20,54,.370,14,34,.412,6,20,.300,9,18,.500,18,32,50,12,2,12,12,25,55,1.5
5774,Alvin Ellis\alvin-ellis-1,2014-15,Michigan State,F,32,1,274,17,53,.321,11,28,.393,6,25,.240,15,33,.455,4,18,22,18,12,5,18,32,55,0.7
5775,Jermaine Morgan\jermaine-morgan-1,2014-15,Bradley,F,22,10,267,21,62,.339,21,61,.344,0,1,.000,13,28,.464,24,35,59,4,9,4,20,54,55,0.7
5776,Salif Boudie\salif-boudie-1,2016-17,Arkansas State,F,22,6,224,24,36,.667,24,36,.667,0,0,,7,15,.467,13,30,43,2,2,6,18,55,55,1.0
5777,Austin Torres\austin-torres-1,2014-15,Notre Dame,F,27,0,192,24,35,.686,24,35,.686,0,0,,7,10,.700,17,27,44,4,3,1,6,21,55,1.9
5778,Greg Jones\greg-jones-911,2017-18,James Madison,F,31,0,324,20,64,.313,17,47,.362,3,17,.176,12,19,.632,35,35,70,4,11,13,23,46,55,1.0
5779,Simon Wright\simon-wright-1,2017-18,Elon,F,32,2,287,22,63,.349,12,34,.353,10,29,.345,1,2,.500,15,33,48,18,7,2,17,36,55,0.9
5780,Henry Welsh\henry-welsh-1,2016-17,Harvard,F,17,6,198,22,41,.537,22,41,.537,0,0,,11,16,.688,20,25,45,5,1,3,12,15,55,2.5
5781,Grayson Moore\grayson-moore-1,2015-16,Utah State,F,18,4,252,17,48,.354,10,23,.435,7,25,.280,14,21,.667,23,40,63,21,8,8,13,18,55,3.4
5782,Max Curran\max-curran-1,2016-17,Maryland-Baltimore County,F,22,0,151,18,37,.486,14,21,.667,4,16,.250,14,15,.933,7,34,41,3,5,11,13,28,54,1.8
5783,Tim Myles\tim-myles-1,2015-16,Cal State Fullerton,F,29,5,370,18,40,.450,18,40,.450,0,0,,18,38,.474,48,74,122,10,11,6,22,69,54,1.8
5784,Luka Radovic\luka-radovic-1,2015-16,South Carolina State,F,34,5,287,19,40,.475,15,29,.517,4,11,.364,12,17,.706,20,38,58,8,2,8,24,61,54,0.6
5785,Justin Hollins\justin-hollins-1,2015-16,Cal State Bakersfield,F,32,0,383,23,44,.523,23,44,.523,0,0,,8,20,.400,24,59,83,3,7,60,24,65,54,2.0
5786,Michel Enanga\michel-enanga-1,2016-17,Coastal Carolina,F,14,2,141,20,45,.444,18,35,.514,2,10,.200,12,25,.480,16,22,38,2,8,2,10,26,54,2.4
5787,Josh Martin\josh-martin-2,2016-17,Cal Poly,F,5,5,124,17,45,.378,14,35,.400,3,10,.300,17,32,.531,11,31,42,9,2,2,7,9,54,7.9
5788,Michel Enanga\michel-enanga-1,2015-16,Coastal Carolina,F,10,1,158,18,37,.486,14,21,.667,4,16,.250,14,21,.667,15,34,49,5,6,3,11,26,54,4.3
5789,Matt Conway\matt-conway-2,2017-18,Albany (NY),F,23,0,200,22,49,.449,19,35,.543,3,14,.214,7,13,.538,12,14,26,6,1,5,8,19,54,1.4
5790,Jerimyjah Batts\jerimyjah-batts-1,2013-14,Coppin State,F,29,11,316,20,47,.426,20,47,.426,0,0,,14,24,.583,21,31,52,2,6,6,12,62,54,0.8
5791,Felix Rivera-Vega\felix-rivera-vega-1,2016-17,Northern Arizona,F,13,3,126,21,46,.457,13,22,.591,8,24,.333,4,11,.364,14,25,39,7,1,0,9,16,54,2.7
5792,Will Gladson\will-gladson-1,2017-18,Princeton,F,15,9,157,22,48,.458,17,35,.486,5,13,.385,5,6,.833,5,15,20,11,5,3,8,20,54,2.4
5793,Joel Fiegler\joel-fiegler-1,2014-15,Central Arkansas,F,28,11,304,22,50,.440,22,47,.468,0,3,.000,10,13,.769,11,50,61,13,8,27,35,57,54,1.0
5794,Parker Ernsthausen\parker-ernsthausen-1,2015-16,Wright State,F,32,8,290,16,36,.444,16,35,.457,0,1,.000,22,33,.667,19,28,47,2,10,2,10,58,54,1.0
5795,Chris Seeley\chris-seeley-1,2017-18,Utah,F,20,0,150,20,46,.435,20,43,.465,0,3,.000,14,30,.467,12,38,50,8,1,8,11,27,54,1.7
5796,Greg Kuakumensah\greg-kuakumensah-1,2017-18,Niagara,F,29,1,267,23,59,.390,22,48,.458,1,11,.091,7,12,.583,21,31,52,9,6,11,12,47,54,1.1
5797,Greg Noack\greg-noack-1,2013-14,Monmouth,F,27,0,209,24,40,.600,24,40,.600,0,0,,6,8,.750,14,27,41,6,10,0,8,37,54,1.6
5798,Jordan Martin\jordan-martin-2,2015-16,Missouri State,F,27,3,217,20,53,.377,20,53,.377,0,0,,14,36,.389,24,18,42,6,11,11,25,65,54,0.4
5799,Julian Powell\julian-powell-2,2017-18,Saint Peter's,F,30,1,252,23,43,.535,22,34,.647,1,9,.111,7,10,.700,16,30,46,9,8,14,15,44,54,1.5
5800,Vin Baker Jr.\vin-bakerjr-1,2017-18,Boston College,F,29,0,208,19,56,.339,11,16,.688,8,40,.200,8,10,.800,9,18,27,5,3,2,18,22,54,0.5
5801,Evan Fisher\evan-fisher-1,2015-16,Siena,F,34,0,282,21,43,.488,13,29,.448,8,14,.571,4,6,.667,13,29,42,6,2,3,7,61,54,0.8
5802,Keenan Simmons\keenan-simmons-1,2014-15,Southern Illinois-Edwardsville,F,16,0,134,22,40,.550,14,22,.636,8,18,.444,2,4,.500,4,23,27,1,0,13,3,14,54,2.8
5803,Garland Owens\garland-owens-1,2016-17,Boston College,F,28,2,294,21,50,.420,17,33,.515,4,17,.235,8,14,.571,20,43,63,23,3,6,16,37,54,1.6
5804,James Johnson\james-johnson-4,2013-14,Cal State Fullerton,F,27,2,287,23,37,.622,23,37,.622,0,0,,8,15,.533,23,41,64,3,6,10,10,61,54,1.6
5805,Victor Enoh\victor-enoh-1,2017-18,Memphis,F,34,1,301,16,36,.444,16,36,.444,0,0,,22,39,.564,22,34,56,7,1,2,17,37,54,0.9
5806,Joshua Nurse\joshua-nurse-1,2016-17,St. Francis (NY),F,30,16,290,18,38,.474,18,38,.474,0,0,,18,41,.439,27,37,64,12,8,16,25,70,54,1.0
5807,Javis Howard\javis-howard-1,2014-15,Charleston Southern,F,25,0,173,25,41,.610,24,37,.649,1,4,.250,3,4,.750,11,15,26,5,4,1,10,23,54,1.4
5808,Wesley Johnson\wesley-johnson-1,2015-16,Charleston Southern,F,28,8,300,16,28,.571,16,28,.571,0,0,,22,35,.629,23,30,53,5,8,7,10,49,54,1.7
5809,John Baker\john-baker-1,2013-14,Incarnate Word,F,24,0,151,18,35,.514,18,35,.514,0,0,,18,25,.720,13,25,38,0,3,2,5,17,54,1.8
5810,Amadi Ikpeze\amadi-ikpeze-1,2016-17,St. Bonaventure,F,24,1,220,22,48,.458,22,48,.458,0,0,,10,11,.909,11,35,46,0,6,12,12,58,54,1.1
5811,Gavin Schilling\gavin-schilling-1,2013-14,Michigan State,F,37,1,239,21,38,.553,21,38,.553,0,0,,11,21,.524,28,31,59,9,0,8,20,50,53,0.9
5812,Idy Diallo\idy-diallo-1,2015-16,Boston College,F,31,0,302,26,44,.591,26,44,.591,0,0,,1,14,.071,14,46,60,5,2,11,22,65,53,0.5
5813,Chandler Rowe\chandler-rowe-1,2014-15,Tennessee-Martin,F,34,7,357,17,43,.395,16,42,.381,1,1,1.000,18,27,.667,29,41,70,13,10,6,18,69,53,1.1
5814,Bakari Copeland\bakari-copeland-1,2013-14,Charleston Southern,F,17,0,106,18,38,.474,12,18,.667,6,20,.300,11,15,.733,5,13,18,5,6,1,7,9,53,2.3
5815,Jeremy Jones\jeremy-jones-4,2014-15,Rice,F,24,2,346,19,38,.500,18,35,.514,1,3,.333,14,33,.424,15,52,67,7,21,10,16,54,53,2.0
5816,Elijah Foster\elijah-foster-1,2017-18,Nevada,F,32,5,210,17,42,.405,17,40,.425,0,2,.000,19,26,.731,10,39,49,10,8,3,7,31,53,1.4
5817,Kyle Haber\kyle-haber-1,2015-16,Brown,F,23,4,286,18,52,.346,9,20,.450,9,32,.281,8,11,.727,12,22,34,10,9,1,17,17,53,1.3
5818,Kevin Degnan\kevin-degnan-1,2014-15,Fairfield,F,21,0,226,20,57,.351,15,32,.469,5,25,.200,8,14,.571,6,37,43,5,4,4,11,27,53,1.1
5819,Blake Simpson\blake-simpson-1,2016-17,Coppin State,F,31,14,527,15,49,.306,15,46,.326,0,3,.000,23,43,.535,52,73,125,9,8,15,18,84,53,1.6
5820,Blake Reynolds\blake-reynolds-1,2015-16,Yale,F,25,0,174,19,43,.442,14,25,.560,5,18,.278,10,14,.714,15,24,39,9,6,2,6,13,53,2.0
5821,David Pekarek\david-pekarek-1,2016-17,Fordham,F,15,1,238,17,61,.279,6,17,.353,11,44,.250,8,9,.889,0,20,20,16,8,4,17,27,53,1.1
5822,Charleston Dobbs\charleston-dobbs-1,2014-15,Prairie View,F,31,1,331,24,59,.407,24,58,.414,0,1,.000,5,12,.417,20,42,62,2,5,9,11,62,53,0.7
5823,Tristian Curtis\tristian-curtis-1,2013-14,Coastal Carolina,F,27,3,260,21,51,.412,19,47,.404,2,4,.500,9,30,.300,32,48,80,7,3,15,14,19,53,1.9
5824,James Loupos\james-loupos-1,2013-14,Navy,F,28,9,280,18,47,.383,18,47,.383,0,0,,17,26,.654,17,23,40,12,7,2,8,44,53,1.2
5825,Leslee Smith\leslee-smith-1,2014-15,Nebraska,F,17,9,214,23,50,.460,23,50,.460,0,0,,7,16,.438,18,35,53,9,10,9,15,28,53,2.5
5826,Adonis Rwabigwi\adonis-rwabigwi-1,2017-18,Texas-Rio Grande Valley,F,29,5,267,15,42,.357,15,42,.357,0,0,,23,32,.719,15,39,54,4,7,10,15,64,53,0.8
5827,Malik Eichler\malik-eichler-1,2016-17,Detroit Mercy,F,24,0,177,18,37,.486,11,26,.423,7,11,.636,10,18,.556,7,21,28,1,4,4,6,37,53,1.2
5828,Kyle Alexander\kyle-alexander-1,2015-16,Tennessee,F,32,11,390,16,37,.432,16,37,.432,0,0,,21,32,.656,49,52,101,2,5,31,15,55,53,2.2
5829,Jack Anton\jack-anton-1,2014-15,Elon,F,31,0,351,19,46,.413,17,39,.436,2,7,.286,13,20,.650,10,36,46,5,2,1,5,45,53,0.9
5830,Phillip Nolan\phillip-nolan-1,2015-16,Connecticut,F,32,13,339,22,41,.537,22,41,.537,0,0,,9,11,.818,18,31,49,6,4,7,14,70,53,0.8
5831,Dennis Tunstall\dennis-tunstall-1,2016-17,Towson,F,29,0,207,23,28,.821,23,28,.821,0,0,,7,20,.350,30,36,66,5,10,11,5,24,53,2.6
5832,Solomon Hainna\solomon-hainna-1,2016-17,Evansville,F,28,5,297,17,42,.405,14,34,.412,3,8,.375,16,28,.571,14,47,61,5,10,0,13,41,53,1.2
5833,Jeremiah Eason\jeremiah-eason-1,2014-15,Southern Mississippi,F,18,18,446,20,68,.294,20,65,.308,0,3,.000,13,37,.351,22,42,64,14,5,3,18,32,53,1.0
5834,Andrew Moemeka\andrew-moemeka-1,2017-18,Wyoming,F,29,3,309,20,37,.541,20,37,.541,0,0,,13,19,.684,25,38,63,7,14,9,13,51,53,1.8
5835,Racine Talla\racine-talla-1,2015-16,Purdue-Fort Wayne,F,32,1,324,16,69,.232,12,46,.261,4,23,.174,17,28,.607,25,36,61,11,6,18,24,47,53,0.6
5836,Georgi Boyanov\georgi-boyanov-1,2013-14,South Alabama,F,19,2,186,17,37,.459,15,30,.500,2,7,.286,17,27,.630,23,35,58,5,12,3,19,30,53,2.3
5837,Leon Williams\leon-williams-2,2016-17,Florida A&M,F,10,2,160,21,48,.438,21,47,.447,0,1,.000,11,19,.579,12,18,30,4,5,2,9,24,53,2.9
5838,Jordan Tyson\jordan-tyson-1,2015-16,St. Bonaventure,F,23,9,364,20,47,.426,20,47,.426,0,0,,13,27,.481,22,52,74,0,3,25,22,63,53,1.2
5839,Adam Ward\adam-ward-2,2016-17,Nicholls State,F,31,7,388,23,45,.511,23,44,.523,0,1,.000,7,31,.226,24,34,58,15,9,28,20,79,53,1.1
5840,Nick Reese\nick-reese-1,2015-16,North Carolina A&T,F,25,1,240,22,54,.407,20,47,.426,2,7,.286,7,12,.583,8,30,38,12,8,1,15,37,53,1.0
5841,John Meeks\john-meeks-1,2017-18,Bucknell,F,28,0,169,24,46,.522,22,31,.710,2,15,.133,3,6,.500,10,16,26,9,2,0,10,14,53,1.2
5842,Walter Foster\walter-foster-1,2013-14,Towson,F,36,0,451,19,43,.442,19,42,.452,0,1,.000,15,29,.517,47,62,109,10,2,28,15,62,53,1.8
5843,Ben Clifford\ben-clifford-1,2013-14,Utah State,F,20,0,190,13,37,.351,8,21,.381,5,16,.313,22,27,.815,11,22,33,4,3,7,10,29,53,1.7
5844,Mufaro Murinda\mufaro-murinda-1,2015-16,Coppin State,F,19,1,147,18,48,.375,10,20,.500,8,28,.286,9,11,.818,4,12,16,6,2,2,4,11,53,1.7
5845,Miks Antoms\miks-antoms-1,2017-18,Maine,F,27,0,251,19,48,.396,19,48,.396,0,0,,15,50,.300,22,35,57,12,5,5,19,30,53,0.9
5846,Callum Barker\callum-barker-1,2016-17,Bradley,F,27,3,233,18,36,.500,18,36,.500,0,0,,16,21,.762,17,29,46,5,7,6,12,37,52,1.5
5847,Stephon Mosley\stephon-mosley-1,2013-14,Saint Francis (PA),F,8,5,164,16,47,.340,12,34,.353,4,13,.308,16,22,.727,13,14,27,5,4,2,12,24,52,3.0
5848,Robert Baker\robert-baker-2,2017-18,Harvard,F,22,3,236,17,52,.327,11,27,.407,6,25,.240,12,15,.800,10,50,60,13,11,10,17,28,52,1.9
5849,John Fulkerson\john-fulkerson-1,2017-18,Tennessee,F,30,1,279,18,42,.429,18,42,.429,0,0,,16,22,.727,18,31,49,16,16,9,22,36,52,1.5
5850,Chris Dees\chris-dees-1,2013-14,St. Bonaventure,F,32,0,272,25,56,.446,25,55,.455,0,1,.000,2,7,.286,27,36,63,4,6,6,12,51,52,1.0
5851,Jamal Watson\jamal-watson-1,2016-17,Mississippi Valley State,F,30,15,276,23,67,.343,23,67,.343,0,0,,6,21,.286,29,44,73,6,5,3,17,47,52,0.6
5852,Connor Devine\connor-devine-1,2014-15,South Dakota State,F,25,0,246,18,30,.600,18,30,.600,0,0,,16,38,.421,27,27,54,3,4,28,13,45,52,2.0
5853,Jack Ballantyne\jack-ballantyne-1,2017-18,Detroit Mercy,F,24,1,284,16,57,.281,7,20,.350,9,37,.243,11,12,.917,7,35,42,19,2,1,18,26,52,0.9
5854,Jagos Lasic\jagos-lasic-1,2016-17,St. Francis (NY),F,25,3,225,17,41,.415,11,27,.407,6,14,.429,12,16,.750,9,24,33,11,3,3,13,19,52,1.4
5855,Rodney Hunter\rodney-hunter-1,2016-17,Columbia,F,25,12,327,24,55,.436,24,51,.471,0,4,.000,4,11,.364,21,29,50,16,7,2,17,38,52,1.2
5856,Kenny Goins\kenny-goins-1,2015-16,Michigan State,F,26,0,266,20,29,.690,20,29,.690,0,0,,12,21,.571,24,51,75,20,4,11,15,32,52,2.5
5857,Kassoum Yakwe\kassoum-yakwe-1,2017-18,St. John's (NY),F,24,1,284,16,35,.457,16,35,.457,0,0,,20,28,.714,20,31,51,5,5,19,22,44,52,1.5
5858,Sam Jones\sam-jones-1,2017-18,Pennsylvania,F,26,1,113,17,43,.395,0,1,.000,17,42,.405,1,2,.500,1,21,22,1,3,0,1,10,52,1.3
5859,Javonntie Jackson\javonntie-jackson-1,2016-17,Cal State Long Beach,F,30,8,258,21,46,.457,20,43,.465,1,3,.333,9,16,.563,23,24,47,9,11,0,22,33,52,1.0
5860,Brett Bisping\brett-bisping-1,2014-15,Siena,F,6,6,141,18,38,.474,16,29,.552,2,9,.222,14,19,.737,13,15,28,7,4,4,9,25,52,6.2
5861,Gerald Blackshear\gerald-blackshear-1,2017-18,Detroit Mercy,F,20,9,191,25,39,.641,25,39,.641,0,0,,2,5,.400,23,32,55,3,9,7,20,40,52,2.0
5862,Blake Hibbitts\blake-hibbitts-1,2016-17,Central Michigan,F,31,1,208,16,43,.372,1,2,.500,15,41,.366,5,8,.625,6,17,23,5,3,2,3,16,52,1.1
5863,Mustapha Traore\mustapha-traore-1,2016-17,Monmouth,F,29,0,205,23,41,.561,23,41,.561,0,0,,6,13,.462,22,37,59,5,7,7,21,31,52,1.3
5864,Matej Buovac\matej-buovac-1,2013-14,New Mexico State,F,26,0,193,16,54,.296,3,7,.429,13,47,.277,7,11,.636,7,10,17,9,1,2,6,11,52,1.0
5865,Keenen Anderson\keenan-anderson-1,2014-15,Eastern Illinois,F,26,4,260,20,46,.435,20,46,.435,0,0,,12,27,.444,22,19,41,3,6,6,5,32,52,1.4
5866,Ahman Fells\ahman-fells-1,2013-14,Illinois-Chicago,F,25,0,222,22,45,.489,20,38,.526,2,7,.286,6,13,.462,18,34,52,2,10,4,16,23,52,1.5
5867,Brett Prahl\brett-prahl-1,2014-15,Milwaukee,F,25,0,196,17,32,.531,17,30,.567,0,2,.000,18,30,.600,12,19,31,5,5,8,15,29,52,1.3
5868,James Jackson\james-jackson-3,2016-17,UC-Riverside,F,25,8,292,20,49,.408,16,39,.410,4,10,.400,8,14,.571,19,39,58,11,5,4,23,31,52,1.1
5869,Derrick Woods\derrick-woods-1,2017-18,Delaware,F,9,3,135,21,35,.600,20,33,.606,1,2,.500,9,16,.563,11,34,45,5,1,4,13,19,52,4.2
5870,Enoch Hood\enoch-hood-1,2014-15,North Carolina Central,F,28,0,226,21,43,.488,21,43,.488,0,0,,10,22,.455,18,32,50,1,7,7,12,34,52,1.2
5871,Joel James\joel-james-1,2013-14,North Carolina,F,30,13,236,19,49,.388,19,49,.388,0,0,,14,18,.778,30,51,81,6,2,4,18,37,52,1.2
5872,Mrdjan Gasevic\mrdjan-gasevic-1,2014-15,Delaware State,F,26,2,222,22,46,.478,22,46,.478,0,0,,8,21,.381,25,40,65,4,5,4,15,33,52,1.4
5873,Kyle Williams\kyle-williams-3,2015-16,Grambling,F,29,9,299,21,39,.538,21,39,.538,0,0,,10,24,.417,15,28,43,3,5,9,19,40,52,0.9
5874,Denell Henderson\denell-henderson-1,2013-14,Oral Roberts,F,15,8,200,18,44,.409,17,41,.415,1,3,.333,15,25,.600,9,25,34,7,8,11,14,43,52,1.8
5875,Gabe Grant\gabe-grant-1,2017-18,Houston,F,24,0,125,14,44,.318,4,15,.267,10,29,.345,14,22,.636,8,18,26,4,4,3,3,7,52,1.6
5876,Solly Stansbury\solly-stansbury-1,2017-18,Richmond,F,17,6,214,20,56,.357,16,34,.471,4,22,.182,8,13,.615,11,17,28,12,12,2,12,30,52,1.7
5877,Andrew Scocca\andrew-scocca-1,2014-15,Bryant,F,30,10,360,17,40,.425,17,39,.436,0,1,.000,18,25,.720,20,51,71,16,2,9,21,45,52,1.3
5878,Mike Edwards\mike-edwards-2,2017-18,Georgia,F,29,0,274,18,47,.383,18,47,.383,0,0,,16,26,.615,19,34,53,6,5,5,13,34,52,1.1
5879,Keith Smith\keith-smith-5,2016-17,Oregon,F,28,0,175,21,48,.438,18,31,.581,3,17,.176,7,13,.538,11,15,26,17,7,5,11,27,52,1.3
5880,Lance Stokes\lance-stokes-1,2014-15,Chattanooga,F,30,9,350,18,41,.439,18,41,.439,0,0,,16,24,.667,15,36,51,7,13,6,15,39,52,1.3
5881,Uros Ljeskovic\uros-ljeskovic-1,2015-16,Grand Canyon,F,22,15,158,23,46,.500,23,46,.500,0,0,,5,18,.278,16,9,25,2,6,2,8,36,51,1.1
5882,Fred Iruafemi\fred-iruafemi-1,2016-17,Virginia Military Institute,F,29,15,341,23,40,.575,23,40,.575,0,0,,5,11,.455,24,38,62,14,11,27,16,73,51,1.8
5883,Dylan Jones\dylan-jones-1,2017-18,Rice,F,23,2,185,21,33,.636,21,33,.636,0,0,,9,22,.409,13,14,27,6,5,2,15,30,51,1.2
5884,Henry Welsh\henry-welsh-1,2017-18,Harvard,F,28,2,222,24,55,.436,24,54,.444,0,1,.000,3,4,.750,21,32,53,9,5,9,11,35,51,1.4
5885,Andre Berry\andre-berry-1,2015-16,Rhode Island,F,16,0,110,21,31,.677,21,31,.677,0,0,,9,13,.692,15,24,39,0,0,1,5,11,51,2.8
5886,Joe Ebondo\joe-ebondo-1,2013-14,Old Dominion,F,36,0,583,20,50,.400,20,50,.400,0,0,,11,25,.440,55,68,123,10,14,4,23,87,51,1.2
5887,Kyle Pearson\kyle-pearson-1,2013-14,Fairleigh Dickinson,F,15,0,140,22,40,.550,20,34,.588,2,6,.333,5,12,.417,7,15,22,2,6,2,6,15,51,2.3
5888,Travis Charles\travis-charles-1,2015-16,Albany (NY),F,9,0,127,21,36,.583,21,36,.583,0,0,,9,16,.563,8,15,23,2,1,2,6,20,51,3.5
5889,Deshaun Sunderhaus\deshaun-sunderhaus-1,2014-15,Seattle,F,8,2,125,21,31,.677,21,31,.677,0,0,,9,13,.692,16,11,27,6,1,3,5,14,51,5.9
5890,Anthony Wilson\anthony-wilson-2,2016-17,Kennesaw State,F,17,1,206,18,57,.316,18,46,.391,0,11,.000,15,19,.789,20,29,49,17,8,6,7,28,51,2.7
5891,Michael Gilmore\michael-gilmore-1,2014-15,Virginia Commonwealth,F,26,0,157,21,43,.488,16,26,.615,5,17,.294,4,16,.250,11,28,39,4,5,6,4,31,51,1.4
5892,Michael Hoffman\michael-hoffman-1,2014-15,Lafayette,F,32,1,278,20,47,.426,14,28,.500,6,19,.316,5,8,.625,10,36,46,10,3,7,8,27,51,1.2
5893,Marvelle Harris\marvelle-harris-1,2013-14,Campbell,F,17,0,192,22,48,.458,21,45,.467,1,3,.333,6,15,.400,23,33,56,3,5,4,8,27,51,2.3
5894,Viktor Juricek\viktor-juricek-1,2014-15,Texas A&M-Corpus Christi,F,29,0,198,14,47,.298,9,26,.346,5,21,.238,18,24,.750,14,10,24,5,3,2,23,41,51,0.1
5895,Josh Nicholas\josh-nicholas-1,2013-14,Alcorn State,F,24,4,278,22,49,.449,22,49,.449,0,0,,7,13,.538,21,47,68,7,8,26,15,58,51,1.9
5896,Jahleem Montague\jahleem-montague-1,2017-18,Longwood,F,17,6,222,20,49,.408,20,47,.426,0,2,.000,11,17,.647,14,30,44,11,8,10,22,35,51,1.6
5897,Daniel Edozie\daniel-edozie-1,2014-15,Iowa State,F,16,2,148,16,28,.571,16,28,.571,0,0,,19,27,.704,23,17,40,6,3,1,7,18,51,3.1
5898,Christian Matthews\christian-matthews-1,2016-17,Georgia Tech,F,15,0,107,15,39,.385,9,25,.360,6,14,.429,15,20,.750,2,7,9,4,3,3,6,10,51,1.9
5899,Mike Rowley\michael-rowley-1,2013-14,Albany (NY),F,27,0,277,15,45,.333,11,31,.355,4,14,.286,17,26,.654,19,39,58,7,9,0,16,33,51,1.2
5900,Scotty Tyler\scotty-tyler-1,2013-14,Idaho State,F,25,1,254,21,40,.525,19,36,.528,2,4,.500,7,10,.700,8,28,36,6,15,5,13,35,51,1.6
5901,Joseph Smoyer\joseph-smoyer-1,2016-17,Portland,F,17,1,197,17,29,.586,17,28,.607,0,1,.000,17,33,.515,9,35,44,5,3,13,9,25,51,2.6
5902,Kelvin Downs\kelvin-downs-1,2015-16,Arkansas State,F,10,3,134,22,35,.629,22,35,.629,0,0,,7,7,1.000,6,21,27,4,3,8,11,18,51,3.9
5903,Ivan Bender\ivan-bender-1,2017-18,Maryland,F,15,7,184,19,33,.576,18,30,.600,1,3,.333,12,18,.667,14,30,44,21,1,2,21,25,51,2.5
5904,Maurice Kirby\maurice-kirby-1,2016-17,Loyola (IL),F,31,25,289,22,48,.458,22,48,.458,0,0,,7,19,.368,20,46,66,10,5,8,11,43,51,1.2
5905,Vaughn Gray\vaughn-gray-1,2013-14,George Mason,F,19,0,182,19,50,.380,9,23,.391,10,27,.370,3,8,.375,4,16,20,6,3,2,9,24,51,1.0
5906,Dane Pineau\dane-pineau-1,2013-14,Saint Mary's (CA),F,27,2,222,18,40,.450,11,23,.478,7,17,.412,8,10,.800,19,19,38,9,3,10,6,27,51,1.8
5907,Shawn Moore\shawn-moore-2,2013-14,UC-Santa Barbara,F,25,5,274,23,38,.605,22,33,.667,1,5,.200,4,5,.800,14,23,37,14,3,1,8,27,51,1.8
5908,Tadas Kararinas\tadas-kararinas-1,2017-18,Drexel,F,32,0,237,17,43,.395,9,22,.409,8,21,.381,9,10,.900,10,16,26,5,2,8,9,33,51,0.9
5909,Cliff Cornish\cliff-cornish-1,2013-14,High Point,F,27,4,231,20,51,.392,20,51,.392,0,0,,11,16,.688,16,26,42,10,5,9,20,31,51,1.0
5910,Donovon Wright\donovon-wright-1,2016-17,Cornell,F,10,5,179,16,50,.320,8,31,.258,8,19,.421,11,25,.440,12,14,26,4,2,4,5,23,51,2.3
5911,Matt Sellers\matt-sellers-1,2014-15,Wyoming,F,15,0,141,21,31,.677,21,31,.677,0,0,,9,15,.600,8,17,25,7,1,6,13,17,51,2.4
5912,Hayden Graham\hayden-graham-1,2013-14,Air Force,F,15,0,185,18,42,.429,9,19,.474,9,23,.391,5,9,.556,6,14,20,11,12,7,7,23,50,2.9
5913,Stephen Domingo\stephen-domingo-1,2015-16,University of California,F,30,0,319,18,56,.321,7,20,.350,11,36,.306,3,11,.273,20,33,53,17,5,8,10,29,50,1.3
5914,Zack Moore\zack-moore-1,2015-16,Seattle,F,16,0,128,16,35,.457,5,8,.625,11,27,.407,7,7,1.000,8,11,19,6,2,1,7,21,50,2.0
5915,Robert Franks\robert-franks-1,2015-16,Washington State,F,23,0,191,14,50,.280,8,23,.348,6,27,.222,16,21,.762,8,21,29,9,1,4,13,33,50,0.6
5916,Adrio Bailey\adrio-bailey-1,2016-17,Arkansas,F,27,2,199,22,39,.564,22,39,.564,0,0,,6,19,.316,13,22,35,7,13,7,11,29,50,1.6
5917,Mo Lewis\mo-lewis-1,2017-18,Navy,F,21,0,188,18,31,.581,18,31,.581,0,0,,14,15,.933,25,19,44,6,5,1,7,29,50,2.4
5918,Norville Carey\norville-carey-1,2013-14,Southern Mississippi,F,26,0,159,19,40,.475,19,40,.475,0,0,,12,23,.522,14,21,35,4,5,6,9,15,50,1.5
5919,Deion Giddens\deion-giddens-1,2013-14,Cornell,F,14,5,189,22,33,.667,22,33,.667,0,0,,6,10,.600,23,17,40,4,6,9,4,26,50,4.0
5920,Youssoupha Kane\youssoupha-kane-1,2014-15,Detroit Mercy,F,24,21,311,21,51,.412,21,51,.412,0,0,,8,19,.421,25,35,60,7,9,11,19,53,50,1.2
5921,Cliff Thomas Jr.\cliff-thomasjr-1,2017-18,High Point,F,18,1,92,21,27,.778,21,27,.778,0,0,,8,10,.800,7,20,27,0,0,7,3,10,50,2.6
5922,Dani Koljanin\dani-koljanin-1,2017-18,Marshall,F,21,7,234,18,49,.367,12,24,.500,6,25,.240,8,14,.571,10,27,37,14,3,2,9,26,50,1.4
5923,Aaron Rountree\aaron-roundtree-1,2013-14,Wake Forest,F,32,0,325,20,48,.417,17,38,.447,3,10,.300,7,18,.389,14,34,48,16,12,17,12,36,50,1.5
5924,Arlando Cook\arlando-cook-1,2017-18,Arkansas,F,28,2,292,22,49,.449,22,49,.449,0,0,,6,16,.375,13,36,49,11,8,2,10,19,50,1.4
5925,Serigne Mboup\serigne-mboup-1,2013-14,Austin Peay,F,27,0,198,15,29,.517,15,29,.517,0,0,,20,36,.556,18,23,41,4,9,11,18,24,50,1.5
5926,Michael Chandler\michael-chandler-1,2015-16,Southern Illinois-Edwardsville,F,20,0,283,22,34,.647,22,34,.647,0,0,,6,16,.375,33,28,61,7,5,31,2,35,50,3.9
5927,Brian Thomas\brian-thomas-2,2017-18,Florida Gulf Coast,F,18,0,147,18,28,.643,18,28,.643,0,0,,14,20,.700,17,31,48,1,2,6,10,15,50,2.6
5928,Jason Owens\jason-owens-1,2015-16,Delaware State,F,23,11,259,19,59,.322,18,57,.316,1,2,.500,11,19,.579,10,42,52,11,6,8,17,41,50,0.8
5929,Kwesi Abakah\kwesi-abakah-1,2015-16,Northeastern,F,33,9,427,16,46,.348,16,46,.348,0,0,,18,41,.439,30,42,72,17,5,9,21,53,50,0.9
5930,Julian Moore\julian-moore-1,2014-15,Penn State,F,33,1,250,21,40,.525,20,39,.513,1,1,1.000,7,18,.389,18,36,54,1,3,12,17,34,50,0.9
5931,Phillip Nolan\phillip-nolan-1,2014-15,Connecticut,F,34,10,516,23,49,.469,23,49,.469,0,0,,4,14,.286,29,34,63,4,7,14,21,90,50,0.4
5932,Evan Cummins\evan-cummins-1,2014-15,Harvard,F,21,0,238,18,32,.563,18,32,.563,0,0,,14,24,.583,18,29,47,9,11,6,12,25,50,2.5
5933,Ahmad Wagner\ahmad-wagner-1,2017-18,Iowa,F,30,7,272,21,42,.500,19,36,.528,2,6,.333,6,18,.333,25,26,51,18,7,2,18,41,50,1.2
5934,Hans Brase\hans-brase-1,2017-18,Iowa State,F,21,2,324,16,54,.296,11,34,.324,5,20,.250,13,17,.765,15,65,80,12,4,8,15,26,50,1.9
5935,Chris Hawkins\chris-hawkins-1,2014-15,Memphis,F,18,2,205,20,41,.488,18,37,.486,2,4,.500,8,14,.571,21,27,48,10,7,2,10,21,50,2.6
5936,Abiola Akintola\abiola-akintola-1,2016-17,Denver,F,28,1,190,13,25,.520,13,25,.520,0,0,,23,34,.676,15,26,41,7,6,5,6,30,49,1.7
5937,Lewis Sullivan\lewis-sullivan-1,2014-15,Alabama-Birmingham,F,26,0,211,19,50,.380,14,31,.452,5,19,.263,6,8,.750,13,35,48,14,6,4,10,24,49,1.5
5938,Dan Jech\dan-jech-1,2016-17,South Dakota,F,20,2,170,19,50,.380,18,38,.474,1,12,.083,10,19,.526,17,28,45,3,4,13,11,38,49,1.4
5939,Tanner Lancona\tanner-lancona-1,2013-14,Saint Louis,F,21,0,178,17,36,.472,12,22,.545,5,14,.357,10,14,.714,8,21,29,4,4,3,7,21,49,1.6
5940,Payton Banks\payton-banks-1,2014-15,Penn State,F,29,0,252,15,53,.283,4,14,.286,11,39,.282,8,16,.500,6,32,38,2,7,2,12,24,49,0.6
5941,Preston Herring\preston-herring-1,2013-14,Austin Peay,F,24,1,172,19,28,.679,19,28,.679,0,0,,11,21,.524,7,20,27,3,4,10,6,21,49,1.8
5942,Viktor Juricek\viktor-juricek-1,2015-16,Texas A&M-Corpus Christi,F,28,1,193,19,40,.475,9,16,.563,10,24,.417,1,4,.250,8,13,21,2,3,3,11,32,49,0.7
5943,Anthony Townes\anthony-townes-1,2015-16,Pacific,F,17,0,197,20,43,.465,20,43,.465,0,0,,9,15,.600,15,28,43,3,6,7,11,31,49,1.9
5944,Nick Gorski\nick-gorski-1,2014-15,Loyola (MD),F,30,0,310,19,51,.373,18,48,.375,1,3,.333,10,16,.625,20,35,55,9,4,6,20,35,49,0.8
5945,Greg Lewis\greg-lewis-5,2013-14,Rutgers,F,32,1,312,23,53,.434,23,53,.434,0,0,,3,10,.300,21,42,63,10,2,18,22,58,49,0.7
5946,Drew LaMont\drew-lamont-1,2017-18,American,F,14,3,245,16,45,.356,3,9,.333,13,36,.361,4,8,.500,5,18,23,13,7,6,10,18,49,2.5
5947,Matt Rennie\matt-rennie-1,2013-14,Dartmouth,F,25,4,290,16,39,.410,16,38,.421,0,1,.000,17,31,.548,30,34,64,13,7,4,11,35,49,1.9
5948,Brandon Miller\brandon-miller-5,2017-18,Gardner-Webb,F,10,1,167,21,36,.583,21,36,.583,0,0,,7,10,.700,7,22,29,2,6,3,12,32,49,2.7
5949,Kwan Cheatham\kwan-cheatham-1,2013-14,Akron,F,21,2,185,13,46,.283,3,15,.200,10,31,.323,13,16,.813,5,24,29,5,3,5,16,17,49,0.9
5950,Javier Lacunza\javier-lacunza-1,2013-14,Florida Atlantic,F,19,1,173,16,47,.340,6,18,.333,10,29,.345,7,8,.875,11,18,29,5,3,1,9,16,49,1.4
5951,Tobias Dowdell\tobias-dowdell-1,2013-14,Tennessee-Martin,F,27,11,272,22,39,.564,22,39,.564,0,0,,5,10,.500,15,26,41,3,4,9,11,31,49,1.3
5952,Jarred Guest\jarred-guest-1,2014-15,Virginia Commonwealth,F,34,3,240,22,47,.468,22,47,.468,0,0,,5,11,.455,26,26,52,3,15,3,12,40,49,1.2
5953,Will Weeks\will-weeks-1,2014-15,North Carolina-Asheville,F,11,0,167,18,36,.500,18,36,.500,0,0,,13,21,.619,20,29,49,14,7,0,12,13,49,4.6
5954,Josh James\josh-james-1,2016-17,IUPUI,F,32,0,243,18,39,.462,18,39,.462,0,0,,13,17,.765,28,43,71,1,4,4,7,48,49,1.3
5955,Jamie Schneck\jamie-schneck-1,2013-14,Hartford,F,31,2,309,20,37,.541,20,37,.541,0,0,,9,24,.375,14,32,46,11,4,9,13,57,49,0.9
5956,Nate Rohrer\nate-rohrer-1,2017-18,Vermont,F,28,0,272,17,32,.531,17,27,.630,0,5,.000,15,22,.682,13,23,36,12,7,6,8,19,49,1.8
5957,Michael Matlock\michael-matlock-1,2016-17,Mississippi Valley State,F,25,17,364,18,50,.360,18,50,.360,0,0,,13,29,.448,25,63,88,10,15,3,13,35,49,1.9
5958,Adrian Brown\adrian-brown-2,2015-16,McNeese State,F,22,0,162,19,45,.422,19,45,.422,0,0,,11,20,.550,10,20,30,5,5,7,12,38,49,0.9
5959,Dominic Woodson\dominic-woodson-1,2013-14,Memphis,F,20,0,136,22,52,.423,22,52,.423,0,0,,5,13,.385,16,22,38,8,6,5,11,34,49,1.3
5960,Logan Ryan\logan-ryan-1,2017-18,Colorado State,F,21,1,173,17,30,.567,10,15,.667,7,15,.467,8,14,.571,12,23,35,6,1,3,4,31,49,1.8
5961,Nick Gorski\nick-gorski-1,2013-14,Loyola (MD),F,26,3,239,21,55,.382,18,45,.400,3,10,.300,4,6,.667,9,21,30,3,5,6,11,35,49,0.7
5962,Jordan Hunter\jordan-hunter-2,2016-17,Saint Mary's (CA),F,27,0,125,17,31,.548,16,30,.533,1,1,1.000,13,20,.650,11,31,42,3,3,5,7,35,48,1.3
5963,Jacob Cushing\jacob-cushing-1,2016-17,Delaware,F,27,8,314,17,63,.270,10,29,.345,7,34,.206,7,14,.500,7,40,47,5,1,3,8,27,48,0.5
5964,Angus Riley\angus-riley-1,2016-17,Bryant,F,21,5,187,15,38,.395,7,17,.412,8,21,.381,10,14,.714,10,32,42,9,2,1,10,38,48,1.2
5965,Ryden Hines\ryden-hines-1,2013-14,Iona,F,21,2,135,17,29,.586,10,14,.714,7,15,.467,7,10,.700,10,10,20,7,6,0,5,26,48,1.8
5966,Roman Davis\roman-davis-1,2017-18,University of California,F,25,0,205,17,53,.321,15,45,.333,2,8,.250,12,26,.462,16,37,53,9,4,1,13,31,48,0.8
5967,Mohamed Bah\mohamed-bah-1,2013-14,Drexel,F,24,1,280,19,30,.633,19,30,.633,0,0,,10,19,.526,23,41,64,3,3,11,3,33,48,2.3
5968,Greg Senat\greg-senat-1,2015-16,Wagner,F,32,2,272,16,40,.400,16,40,.400,0,0,,16,33,.485,37,30,67,4,7,8,19,51,48,1.0
5969,Chris McComber\chris-mccomber-1,2015-16,Columbia,F,23,3,219,17,40,.425,5,5,1.000,12,35,.343,2,3,.667,8,18,26,6,2,0,3,30,48,1.2
5970,Cameron Blakley\cameron-blakely-1,2014-15,Charlotte,F,21,0,149,16,37,.432,5,8,.625,11,29,.379,5,7,.714,3,19,22,4,3,5,9,21,48,1.3
5971,Racine Talla\racine-talla-1,2016-17,Purdue-Fort Wayne,F,24,0,241,17,46,.370,13,35,.371,4,11,.364,10,17,.588,16,26,42,6,4,10,20,34,48,0.9
5972,Brian Steele\brian-steele-1,2013-14,South Carolina,F,22,0,218,18,44,.409,8,17,.471,10,27,.370,2,5,.400,7,17,24,11,5,0,8,30,48,1.2
5973,Joan Duran\joan-duran-1,2017-18,Tennessee Tech,F,20,0,157,19,42,.452,13,28,.464,6,14,.429,4,9,.444,10,21,31,8,8,2,9,24,48,1.7
5974,Eric Moeller\eric-moeller-1,2014-15,Florida Gulf Coast,F,27,6,253,17,41,.415,16,37,.432,1,4,.250,13,27,.481,13,25,38,6,4,9,25,43,48,0.3
5975,Ed Porter\ed-porter-3,2017-18,Lehigh,F,13,1,209,22,43,.512,22,43,.512,0,0,,4,6,.667,13,22,35,4,2,5,15,26,48,1.9
5976,Brian Kelley\brian-kelley-1,2015-16,Norfolk State,F,29,5,318,18,52,.346,17,39,.436,1,13,.077,11,13,.846,6,18,24,31,12,3,29,42,48,0.6
5977,Izais Hicks\izais-hicks-1,2016-17,Coppin State,F,25,0,280,18,44,.409,18,44,.409,0,0,,12,28,.429,30,36,66,2,6,5,9,54,48,1.2
5978,Austin Torres\austin-torres-1,2016-17,Notre Dame,F,36,1,261,21,38,.553,21,38,.553,0,0,,6,18,.333,23,29,52,7,9,8,9,46,48,1.2
5979,Kyle Ingram\kyle-ingram-2,2017-18,Idaho State,F,12,11,277,21,45,.467,21,45,.467,0,0,,6,9,.667,13,33,46,29,3,10,9,31,48,4.3
5980,Paulin Mpawe\paulin-mpawe-1,2013-14,Idaho,F,28,4,283,15,38,.395,15,38,.395,0,0,,18,35,.514,26,34,60,3,3,7,19,44,48,0.8
5981,Simon Krych\simon-krych-1,2013-14,Omaha,F,26,0,185,21,37,.568,21,36,.583,0,1,.000,6,12,.500,19,23,42,3,4,4,3,18,48,1.8
5982,James Hemphill\james-hemphill-1,2013-14,Navy,F,23,0,269,18,44,.409,18,43,.419,0,1,.000,12,32,.375,22,29,51,10,7,2,11,36,48,1.3
5983,Lucas Jones\lucas-jones-2,2017-18,Eastern Illinois,F,26,7,325,15,37,.405,8,17,.471,7,20,.350,11,14,.786,12,39,51,18,5,7,9,15,48,2.1
5984,Steve Smith\steve-smith-6,2014-15,Fairfield,F,19,0,171,17,49,.347,3,6,.500,14,43,.326,0,1,.000,2,22,24,7,1,0,4,24,48,1.1
5985,Phillip Jones\phillip-jones-2,2014-15,Texas-San Antonio,F,15,0,135,17,40,.425,16,34,.471,1,6,.167,13,25,.520,25,18,43,1,6,8,17,26,48,2.0
5986,Sebastian Norman\sebastian-norman-1,2013-14,Lamar,F,26,1,238,17,36,.472,17,36,.472,0,0,,14,21,.667,19,36,55,1,1,7,8,39,48,1.3
5987,Malik Martin\malik-price-martin-1,2015-16,Southern California,F,27,0,179,16,37,.432,15,33,.455,1,4,.250,15,26,.577,10,30,40,4,6,9,7,34,48,1.3
5988,Lonnie Rivera\lonnie-rivera-1,2015-16,American,F,22,0,227,16,42,.381,15,34,.441,1,8,.125,14,18,.778,10,26,36,10,3,1,19,20,47,1.0
5989,Tyshawn Myles\tyshawn-myles-1,2017-18,Drexel,F,22,4,237,15,25,.600,15,25,.600,0,0,,17,25,.680,28,24,52,2,7,16,14,60,47,1.9
5990,Tidell Pierre\tidell-pierre-1,2015-16,Central Connecticut State,F,22,4,240,17,48,.354,16,47,.340,1,1,1.000,12,23,.522,23,34,57,5,2,1,13,30,47,1.1
5991,Sarp Gobeloglu\sarp-gobeloglu-1,2016-17,Montana State,F,12,0,165,16,47,.340,4,9,.444,12,38,.316,3,4,.750,8,24,32,3,2,2,12,32,47,1.1
5992,Brandon Huffman\brandon-huffman-1,2017-18,North Carolina,F,29,0,98,19,35,.543,19,35,.543,0,0,,9,16,.563,17,24,41,1,0,8,12,18,47,1.2
5993,Jordan Scott\jordan-scott-2,2014-15,Idaho,F,21,0,203,18,30,.600,18,30,.600,0,0,,11,17,.647,13,19,32,5,3,2,10,25,47,1.6
5994,Mario Matasovic\mario-matasovic-1,2014-15,Western Michigan,F,27,0,236,21,44,.477,21,43,.488,0,1,.000,5,11,.455,20,22,42,5,8,6,15,42,47,1.0
5995,Kuran Iverson\kuran-iverson-1,2013-14,Memphis,F,19,0,172,19,45,.422,18,36,.500,1,9,.111,8,21,.381,10,21,31,14,6,4,17,12,47,1.5
5996,Courtney Alexander II\courtney-alexanderii-1,2015-16,Tennessee Tech,F,29,0,304,21,41,.512,21,41,.512,0,0,,5,22,.227,23,54,77,12,4,12,19,41,47,1.3
5997,Samuel Dingba\samuel-dingba-1,2015-16,Quinnipiac,F,27,10,264,17,46,.370,17,46,.370,0,0,,13,24,.542,33,35,68,2,2,15,17,41,47,1.2
5998,Logan Power\logan-power-1,2017-18,South Dakota,F,20,0,89,17,28,.607,7,11,.636,10,17,.588,3,6,.500,5,20,25,10,2,0,5,4,47,2.2
5999,James Suber\james-suber-1,2014-15,Niagara,F,21,1,207,18,32,.563,18,32,.563,0,0,,11,18,.611,23,29,52,2,3,4,10,21,47,2.0
6000,Nathan Bain\nathan-bain-1,2017-18,Stephen F. Austin,F,24,0,154,14,28,.500,13,22,.591,1,6,.167,18,26,.692,5,13,18,7,13,6,11,29,47,1.5
6001,Junior Longrus\junior-longrus-1,2014-15,Washington State,F,31,11,364,19,38,.500,19,38,.500,0,0,,9,28,.321,45,45,90,15,10,12,13,53,47,1.9
6002,Kendell Ramlal\kendall-ramlal-1,2014-15,Texas State,F,31,1,288,20,41,.488,20,41,.488,0,0,,7,18,.389,20,30,50,9,4,20,14,30,47,1.4
6003,Dave Wiegmann\dave-wiegmann-1,2013-14,Albany (NY),F,29,5,302,17,44,.386,15,33,.455,2,11,.182,11,19,.579,18,48,66,11,6,10,18,29,47,1.3
6004,Josh Smith\josh-smith-2,2013-14,Clemson,F,30,3,299,19,54,.352,19,54,.352,0,0,,9,18,.500,15,48,63,5,2,6,16,39,47,0.5
6005,Kory Kuenstling\kory-kuenstling-1,2016-17,Drake,F,22,6,207,18,34,.529,18,34,.529,0,0,,11,22,.500,25,22,47,4,1,9,13,33,47,1.5
6006,Ioannis Dimakopoulos\ioannis-dimakopoulos-1,2013-14,UC-Irvine,F,22,0,119,17,34,.500,13,26,.500,4,8,.500,9,14,.643,6,23,29,5,2,7,10,11,47,1.6
6007,Karl Gamble\karl-gamble-1,2016-17,Middle Tennessee,F,30,3,154,18,40,.450,17,36,.472,1,4,.250,10,21,.476,11,25,36,6,6,11,3,21,47,1.5
6008,Eric Rwahwire\eric-rwahwire-1,2017-18,UC-Riverside,F,15,2,154,16,56,.286,7,23,.304,9,33,.273,6,7,.857,6,18,24,4,3,2,6,16,47,1.2
6009,Ugo Mmonu\ugo-mmonu-1,2013-14,Tennessee State,F,21,1,198,13,33,.394,12,28,.429,1,5,.200,20,27,.741,10,20,30,2,3,7,19,34,47,0.8
6010,Austin Sparks\austin-sparks-1,2016-17,South Dakota,F,24,7,248,20,31,.645,20,31,.645,0,0,,7,11,.636,16,19,35,6,5,4,17,43,47,1.1
6011,Aaron Ariri\aaron-ariri-1,2015-16,Troy,F,26,1,202,20,36,.556,20,36,.556,0,0,,7,15,.467,20,34,54,1,4,3,5,35,47,1.5
6012,Aleer Leek\aleer-leek-1,2016-17,Missouri-Kansas City,F,26,0,204,17,39,.436,12,20,.600,5,19,.263,8,11,.727,7,26,33,0,3,9,12,32,47,0.9
6013,John Fulkerson\john-fulkerson-1,2016-17,Tennessee,F,10,6,160,17,30,.567,17,30,.567,0,0,,13,20,.650,14,32,46,10,11,9,8,23,47,5.7
6014,Jared Chatham\jared-chatham-1,2017-18,Central Arkansas,F,19,1,92,17,34,.500,15,27,.556,2,7,.286,11,17,.647,8,14,22,3,2,1,5,11,47,1.7
6015,Mickey Mitchell\mickey-mitchell-1,2015-16,Ohio State,F,23,7,295,17,48,.354,16,44,.364,1,4,.250,12,23,.522,20,44,64,15,7,6,24,41,47,1.1
6016,Roderick Davis\roderick-davis-1,2014-15,Wright State,F,28,5,287,21,37,.568,21,37,.568,0,0,,5,14,.357,10,28,38,4,2,11,18,50,47,0.6
6017,Ross Wilson\ross-wilson-1,2013-14,Rice,F,26,2,316,21,49,.429,21,49,.429,0,0,,5,8,.625,14,29,43,20,5,1,16,51,47,0.8
6018,Eric Adams\eric-adams-2,2015-16,Samford,F,28,2,187,15,33,.455,15,32,.469,0,1,.000,17,28,.607,18,32,50,8,7,20,14,50,47,1.4
6019,Jevon Smith\jevon-smith-1,2016-17,Mississippi Valley State,F,12,0,115,17,45,.378,13,32,.406,4,13,.308,8,14,.571,10,10,20,9,2,2,8,11,46,2.2
6020,Maurice Rivers\maurice-rivers-1,2014-15,Rice,F,12,0,215,17,45,.378,15,37,.405,2,8,.250,10,17,.588,17,26,43,7,2,7,20,28,46,1.6
6021,Zach Gordon\zach-gordon-1,2013-14,Cal Poly,F,33,5,349,13,42,.310,13,42,.310,0,0,,20,37,.541,24,55,79,2,11,9,21,52,46,0.8
6022,Joe Furstinger\joe-furstinger-1,2015-16,New Mexico,F,29,0,337,14,43,.326,14,42,.333,0,1,.000,18,29,.621,15,41,56,13,15,19,16,55,46,1.4
6023,Gyorgy Goloman\gyorgy-goloman-1,2014-15,UCLA,F,35,0,377,19,42,.452,13,30,.433,6,12,.500,2,9,.222,8,45,53,20,15,10,18,63,46,1.0
6024,Jorge Bilbao\jorge-bilbao-1,2013-14,Texas-Arlington,F,30,10,324,20,51,.392,20,40,.500,0,11,.000,6,15,.400,31,52,83,13,13,3,23,46,46,1.2
6025,Hikeem Champaigne\hikeem-champaigne-1,2014-15,Savannah State,F,8,4,119,20,38,.526,20,38,.526,0,0,,6,14,.429,15,15,30,2,3,7,11,17,46,3.8
6026,Temjae Singleton\temjae-singleton-1,2014-15,Cal State Fullerton,F,21,1,174,14,46,.304,6,14,.429,8,32,.250,10,19,.526,12,20,32,5,0,0,10,24,46,0.7
6027,Isaiah Wilkins\isaiah-wilkins-1,2014-15,Virginia,F,28,0,264,19,48,.396,17,45,.378,2,3,.667,6,11,.545,19,50,69,11,5,18,15,26,46,1.7
6028,Jaylin Stewart\jaylin-stewart-1,2015-16,Southeast Missouri State,F,26,1,210,18,52,.346,11,25,.440,7,27,.259,3,8,.375,7,38,45,2,5,2,7,33,46,0.7
6029,Jaylon Floyd\jaylon-floyd-1,2013-14,Arkansas-Pine Bluff,F,30,9,296,20,34,.588,20,33,.606,0,1,.000,6,14,.429,18,31,49,3,8,6,12,42,46,1.1
6030,Matt Dahlen\matt-dahlen-1,2016-17,Oregon State,F,30,10,313,17,34,.500,17,33,.515,0,1,.000,12,24,.500,18,40,58,18,8,4,20,64,46,0.9
6031,Stephen Vassor\stephen-vassor-1,2015-16,Old Dominion,F,31,4,207,20,33,.606,20,33,.606,0,0,,6,9,.667,21,23,44,8,1,4,11,43,46,1.0
6032,Shelby Moats\shelby-moats-1,2013-14,Vanderbilt,F,31,1,340,17,45,.378,10,19,.526,7,26,.269,5,9,.556,14,36,50,9,7,2,21,45,46,0.5
6033,Lucas Dyer\lucas-dyer-1,2014-15,Radford,F,26,0,203,15,33,.455,15,33,.455,0,0,,16,20,.800,13,39,52,4,6,15,8,30,46,1.8
6034,Mustafa Jones\mustafa-jones-1,2014-15,Central Connecticut State,F,29,0,240,18,52,.346,18,52,.346,0,0,,10,17,.588,18,22,40,4,2,12,12,16,46,1.0
6035,Sherron Wilson\sherron-wilson-1,2014-15,Southern Utah,F,26,0,224,14,53,.264,9,34,.265,5,19,.263,13,21,.619,9,13,22,14,9,1,17,30,46,0.5
6036,Chris McComber\chris-mccomber-1,2016-17,Columbia,F,22,1,219,18,34,.529,11,15,.733,7,19,.368,3,12,.250,4,15,19,14,2,2,6,22,46,1.4
6037,Merrill Holden\merrill-holden-1,2014-15,Louisiana Tech,F,27,1,178,17,28,.607,17,27,.630,0,1,.000,12,26,.462,18,17,35,2,4,11,6,25,46,1.6
6038,Alex Foster\alex-foster-1,2013-14,Texas Tech,F,25,0,182,19,36,.528,19,36,.528,0,0,,8,12,.667,16,22,38,1,1,5,8,27,46,1.2
6039,Alex Gauna\alex-gauna-1,2013-14,Michigan State,F,29,6,206,21,38,.553,21,37,.568,0,1,.000,4,13,.308,13,24,37,6,2,7,7,35,46,1.1
6040,Kevin Holmes Jr.\kevin-holmesjr-1,2015-16,Coastal Carolina,F,23,0,246,17,57,.298,7,15,.467,10,42,.238,2,5,.400,9,36,45,2,5,11,17,18,46,0.8
6041,Wesley Dickinson\wesley-dickinson-1,2015-16,Dartmouth,F,22,0,96,17,21,.810,17,21,.810,0,0,,12,21,.571,10,9,19,1,3,5,4,20,46,1.8
6042,Chuba Ohams\chuba-ohams-1,2016-17,Fordham,F,24,9,328,19,48,.396,17,35,.486,2,13,.154,6,19,.316,25,49,74,19,17,12,31,55,46,1.4
6043,Colton Blevins\colton-blevins-1,2016-17,Tennessee Tech,F,15,1,88,15,31,.484,15,27,.556,0,4,.000,16,22,.727,13,15,28,4,1,2,5,14,46,2.4
6044,Roger Moute a Bidias\roger-moute-a-bidias-1,2014-15,University of California,F,29,3,280,16,45,.356,13,31,.419,3,14,.214,11,24,.458,14,26,40,10,3,8,13,24,46,0.9
6045,Christian Ejiga\christian-ejiga-1,2014-15,Maine,F,23,0,217,17,41,.415,17,40,.425,0,1,.000,12,17,.706,14,26,40,5,8,9,12,43,46,1.2
6046,Paul Thomas\paul-thomas-1,2015-16,Texas-El Paso,F,22,4,241,19,39,.487,19,39,.487,0,0,,8,15,.533,17,40,57,11,6,7,15,35,46,1.7
6047,Jaylon Floyd\jaylon-floyd-1,2014-15,Arkansas-Pine Bluff,F,32,8,317,17,40,.425,17,38,.447,0,2,.000,11,17,.647,12,40,52,6,4,8,19,46,45,0.6
6048,Al Eichelberger\al-eichelberger-1,2016-17,DePaul,F,26,0,212,16,21,.762,16,21,.762,0,0,,13,32,.406,15,17,32,1,2,8,10,26,45,1.3
6049,Isaac Kreuer\isaac-kreuer-1,2014-15,Missouri-Kansas City,F,29,8,308,14,38,.368,14,37,.378,0,1,.000,17,21,.810,14,24,38,2,6,9,15,44,45,0.7
6050,Hunter Mickelson\hunter-mickelson-1,2014-15,Kansas,F,19,0,133,16,32,.500,16,32,.500,0,0,,13,15,.867,15,19,34,1,7,19,9,25,45,2.4
6051,Milan Mijovic\milan-mijovic-1,2016-17,Marshall,F,23,1,179,18,28,.643,17,27,.630,1,1,1.000,8,14,.571,7,18,25,4,5,2,9,29,45,1.3
6052,Josh Sharp\josh-sharp-1,2013-14,Brigham Young,F,32,3,352,17,27,.630,17,25,.680,0,2,.000,11,19,.579,26,51,77,14,5,9,6,52,45,1.8
6053,Eric Vila\eric-vila-1,2016-17,Texas A&M,F,20,1,237,15,51,.294,9,28,.321,6,23,.261,9,16,.563,4,36,40,18,10,0,13,16,45,1.5
6054,Kregg Jones\kregg-jones-1,2013-14,Cal State Bakersfield,F,16,0,147,20,38,.526,20,38,.526,0,0,,5,12,.417,10,18,28,2,1,12,10,33,45,1.5
6055,Nigel Snipes\nigel-snipes-1,2014-15,Western Kentucky,F,24,3,207,16,57,.281,8,24,.333,8,33,.242,5,6,.833,12,42,54,7,7,2,11,20,45,1.1
6056,Jordan Jones\jordan-jones-2,2016-17,Charleston Southern,F,30,0,263,16,28,.571,16,28,.571,0,0,,13,21,.619,23,30,53,1,7,16,19,70,45,0.9
6057,Cory Starkey\cory-starkey-1,2013-14,Bucknell,F,14,0,182,21,34,.618,21,34,.618,0,0,,3,9,.333,12,42,54,6,7,2,9,13,45,3.3
6058,Lucas Kraljevic\lucas-kraljevic-1,2017-18,Boston College,F,31,1,290,15,42,.357,12,29,.414,3,13,.231,12,24,.500,11,35,46,16,7,14,24,63,45,0.4
6059,Aerris Smith\aerris-smith-1,2013-14,Wofford,F,31,11,274,18,35,.514,18,35,.514,0,0,,9,16,.563,19,37,56,2,3,1,7,30,45,1.1
6060,Wesley Dickinson\wesley-dickinson-1,2013-14,Dartmouth,F,24,0,137,13,34,.382,13,34,.382,0,0,,19,25,.760,17,19,36,0,6,5,12,14,45,1.4
6061,Michael Matlock\michael-matlock-1,2015-16,Mississippi Valley State,F,13,5,225,16,40,.400,16,40,.400,0,0,,13,31,.419,27,41,68,10,7,1,11,28,45,3.1
6062,Doug Taylor\doug-taylor-1,2015-16,Ohio,F,29,1,148,15,32,.469,14,30,.467,1,2,.500,14,19,.737,24,30,54,3,5,5,6,30,45,1.6
6063,Kienan Walter\kienan-walter-1,2016-17,North Dakota,F,19,0,78,17,32,.531,15,24,.625,2,8,.250,9,15,.600,8,19,27,2,0,0,9,24,45,1.1
6064,Benson Osayande\benson-osayande-1,2017-18,Montana State,F,21,2,127,13,29,.448,13,29,.448,0,0,,19,26,.731,18,8,26,3,5,2,9,22,45,1.6
6065,Mo Hughley\mo-hughley-1,2013-14,Eastern Michigan,F,34,1,252,15,29,.517,15,29,.517,0,0,,15,32,.469,21,29,50,9,14,8,8,55,45,1.3
6066,Jake Belford\jake-belford-1,2014-15,Davidson,F,6,5,122,17,33,.515,14,23,.609,3,10,.300,8,11,.727,3,21,24,13,1,3,9,16,45,5.5
6067,Anthony Smith\anthony-smith-14,2017-18,Nevada-Las Vegas,F,13,0,144,20,40,.500,16,27,.593,4,13,.308,1,2,.500,14,14,28,8,6,1,8,24,45,2.6
6068,Austin Sparks\austin-sparks-1,2017-18,South Dakota,F,30,0,194,16,30,.533,16,30,.533,0,0,,13,16,.813,10,21,31,4,3,3,9,18,45,1.1
6069,Bertrand Nkali\bertrand-nkali-1,2016-17,Houston,F,31,5,353,14,30,.467,14,30,.467,0,0,,17,26,.654,35,33,68,3,5,38,10,65,45,1.9
6070,Sterling Christy\sterling-christy-1,2016-17,Radford,F,28,4,334,17,59,.288,13,41,.317,4,18,.222,7,10,.700,25,52,77,26,6,10,29,45,45,1.0
6071,Tyler Koch\tyler-koch-1,2013-14,Ball State,F,20,8,290,15,42,.357,8,16,.500,7,26,.269,8,15,.533,17,35,52,14,5,1,20,43,45,1.0
6072,Cameron Lewis\cameron-lewis-2,2016-17,Howard,F,24,3,144,17,33,.515,17,32,.531,0,1,.000,11,16,.688,18,13,31,1,5,3,9,37,45,1.1
6073,Juwan Durham\juwan-durham-1,2016-17,Connecticut,F,28,0,232,20,41,.488,18,39,.462,2,2,1.000,3,8,.375,18,25,43,7,3,9,7,27,45,1.4
6074,Anton Gill\anton-gill-1,2016-17,Nebraska,F,12,1,208,16,59,.271,8,30,.267,8,29,.276,5,8,.625,7,16,23,6,4,0,11,17,45,0.8
6075,Marten Linssen\marten-linssen-1,2017-18,Valparaiso,F,22,1,163,13,30,.433,13,30,.433,0,0,,19,33,.576,15,29,44,6,12,7,15,39,45,1.5
6076,Michael O'Donnell\michael-odonnell-1,2014-15,Southern Mississippi,F,25,2,229,17,43,.395,8,19,.421,9,24,.375,2,5,.400,8,15,23,4,4,3,16,45,45,0.2
6077,Dylan Jones\dylan-jones-1,2014-15,Pennsylvania,F,22,0,154,15,32,.469,15,32,.469,0,0,,15,26,.577,14,15,29,2,6,4,15,39,45,0.8
6078,Jacob Wiley\jacob-wiley-2,2017-18,Illinois-Chicago,F,26,0,205,18,37,.486,16,31,.516,2,6,.333,7,19,.368,7,34,41,9,5,5,12,31,45,1.0
6079,Nick Fuller\nick-fuller-1,2015-16,Nebraska,F,24,0,189,14,29,.483,14,27,.519,0,2,.000,16,29,.552,15,18,33,5,9,3,13,27,44,1.3
6080,Adrian Brown\adrian-brown-2,2017-18,McNeese State,F,26,2,142,16,40,.400,16,39,.410,0,1,.000,12,19,.632,8,23,31,4,4,4,7,19,44,1.0
6081,Jeff Pollard\jeff-pollard-1,2016-17,Washington State,F,24,2,205,17,36,.472,17,36,.472,0,0,,10,16,.625,11,32,43,4,5,2,8,24,44,1.3
6082,Williams Gabriel\williams-gabriel-1,2013-14,New Hampshire,F,28,10,352,14,29,.483,14,29,.483,0,0,,16,28,.571,20,29,49,1,6,21,23,74,44,0.6
6083,Keanau Post\keanau-post-1,2013-14,Missouri,F,30,3,243,19,30,.633,19,30,.633,0,0,,6,20,.300,18,34,52,0,1,3,13,36,44,0.8
6084,Bubba Furlong\bubba-furlong-1,2017-18,Sam Houston State,F,24,7,169,16,39,.410,14,34,.412,2,5,.400,10,13,.769,20,18,38,3,5,9,13,38,44,1.1
6085,Phillip Lawrence-Ricks\phillip-lawrence-1,2013-14,Marist,F,28,1,274,16,43,.372,12,24,.500,4,19,.211,8,11,.727,8,24,32,6,6,8,5,31,44,1.1
6086,Kyle Young\kyle-young-3,2017-18,Ohio State,F,25,0,216,19,43,.442,18,33,.545,1,10,.100,5,11,.455,19,21,40,4,7,3,9,19,44,1.4
6087,Garrison Goode\garrison-goode-1,2015-16,UC-Davis,F,29,4,441,17,50,.340,17,49,.347,0,1,.000,10,27,.370,25,36,61,12,14,6,21,44,44,0.9
6088,Fatodd Lewis\fatodd-lewis-1,2015-16,Tennessee-Martin,F,19,0,153,17,46,.370,12,28,.429,5,18,.278,5,14,.357,8,21,29,2,3,5,10,20,44,0.9
6089,Jordan Giles\jordan-giles-1,2016-17,Missouri-Kansas City,F,27,0,183,15,35,.429,12,25,.480,3,10,.300,11,12,.917,11,27,38,11,2,7,16,27,44,1.1
6090,Jordan Jones\jordan-jones-1,2014-15,Kennesaw State,F,26,0,248,18,47,.383,18,46,.391,0,1,.000,8,16,.500,13,39,52,4,4,12,3,50,44,1.1
6091,Reuben King\reuben-king-1,2014-15,Charleston Southern,F,25,9,232,18,45,.400,13,25,.520,5,20,.250,3,8,.375,16,34,50,4,10,4,23,28,44,0.8
6092,Dusan Perovic\dusan-perovic-1,2017-18,Binghamton,F,17,1,104,17,34,.500,15,26,.577,2,8,.250,8,12,.667,3,9,12,5,2,1,10,18,44,1.1
6093,Colin Russell\colin-russell-1,2017-18,UC-Davis,F,26,1,241,17,37,.459,17,37,.459,0,0,,10,21,.476,22,20,42,6,2,1,10,49,44,0.7
6094,Ben Dickinson\ben-dickinson-1,2014-15,North Carolina-Greensboro,F,19,0,200,17,46,.370,17,42,.405,0,4,.000,10,16,.625,19,25,44,5,3,0,15,38,44,0.7
6095,Ed Jones\edward-jones-1,2015-16,Jacksonville State,F,14,1,153,18,42,.429,18,41,.439,0,1,.000,8,10,.800,6,12,18,2,1,11,5,20,44,1.9
6096,Matt Shrigley\matt-shrigley-1,2015-16,San Diego State,F,18,0,212,15,54,.278,1,5,.200,14,49,.286,0,1,.000,3,15,18,11,2,2,6,18,44,0.9
6097,Amar Alibegovic\amar-alibegovic-1,2017-18,St. John's (NY),F,27,2,312,16,59,.271,8,20,.400,8,39,.205,4,7,.571,8,25,33,3,7,11,12,45,44,0.3
6098,D'Angelo Allen\dangelo-allen-1,2015-16,Missouri,F,21,0,177,20,38,.526,19,34,.559,1,4,.250,3,13,.231,13,28,41,8,4,6,9,18,44,1.7
6099,Jonathan Graham\jonathan-graham-1,2013-14,Maryland,F,27,2,284,18,36,.500,18,36,.500,0,0,,8,17,.471,24,42,66,5,1,14,11,44,44,1.4
6100,Braiden Shaw\braiden-shaw-1,2016-17,Brigham Young,F,31,2,203,18,31,.581,18,31,.581,0,0,,8,20,.400,24,36,60,5,10,1,11,31,44,1.4
6101,Jimmy McDonnell\jimmy-mcdonnell-1,2013-14,Temple,F,24,6,289,13,32,.406,7,18,.389,6,14,.429,12,17,.706,10,29,39,12,7,1,17,50,44,0.8
6102,K.J. James\kj-james-1,2014-15,High Point,F,24,0,202,17,33,.515,17,33,.515,0,0,,10,25,.400,14,30,44,11,8,5,13,18,44,1.6
6103,Brandon Watkins\brandon-watkins-2,2014-15,West Virginia,F,23,0,154,19,41,.463,19,41,.463,0,0,,6,14,.429,21,12,33,4,5,14,15,27,44,1.3
6104,Alex Poythress\alex-poythress-1,2014-15,Kentucky,F,8,8,162,16,42,.381,16,35,.457,0,7,.000,12,14,.857,12,18,30,2,4,12,8,17,44,4.1
6105,Jarriesse Blackmon\jarriesse-blackmon-1,2017-18,UC-Santa Barbara,F,23,3,268,17,36,.472,16,33,.485,1,3,.333,9,15,.600,22,38,60,6,4,14,11,40,44,1.8
6106,Lloyd Neely\lloyd-neely-1,2013-14,Oakland,F,27,3,167,16,38,.421,13,30,.433,3,8,.375,9,12,.750,11,20,31,8,5,3,10,23,44,1.1
6107,Steven Enoch\steven-enoch-1,2015-16,Connecticut,F,27,0,188,19,35,.543,19,35,.543,0,0,,6,14,.429,13,27,40,1,0,3,6,34,44,0.9
6108,Ryan Luther\ryan-luther-1,2014-15,Pittsburgh,F,23,0,185,18,35,.514,13,24,.542,5,11,.455,3,7,.429,13,11,24,7,1,4,5,22,44,1.4
6109,Sam Schwietz\sam-schwietz-1,2015-16,Maryland-Baltimore County,F,27,9,248,18,34,.529,18,34,.529,0,0,,8,26,.308,22,21,43,3,8,15,12,58,44,1.0
6110,Dontay Bassett\dontay-bassett-1,2017-18,Florida,F,25,2,178,17,31,.548,17,31,.548,0,0,,9,14,.643,24,17,41,5,8,7,4,40,43,1.8
6111,Taj Price\taj-price-1,2017-18,NJIT,F,15,0,95,14,30,.467,12,26,.462,2,4,.500,13,15,.867,11,14,25,5,3,5,6,17,43,2.4
6112,Wyatt Yess\wyatt-yess-1,2017-18,Yale,F,22,1,181,13,33,.394,12,27,.444,1,6,.167,16,31,.516,13,31,44,11,5,8,10,35,43,1.4
6113,Mike LeBlanc\mike-leblanc-1,2017-18,Princeton,F,24,6,268,13,49,.265,4,11,.364,9,38,.237,8,10,.800,8,31,39,13,6,3,12,27,43,0.9
6114,Evan Fisher\evan-fisher-1,2016-17,Siena,F,31,1,250,14,51,.275,9,21,.429,5,30,.167,10,18,.556,5,31,36,2,4,6,10,35,43,0.3
6115,Jarad Scott\jarad-scott-1,2015-16,Winthrop,F,19,0,128,15,33,.455,6,9,.667,9,24,.375,4,6,.667,3,25,28,5,1,0,10,25,43,1.0
6116,Josh Hairston\josh-hairston-1,2013-14,Duke,F,30,9,284,17,35,.486,17,34,.500,0,1,.000,9,14,.643,21,17,38,11,3,3,10,65,43,0.7
6117,Tyler Roberson\tyler-roberson-1,2013-14,Syracuse,F,20,1,162,14,47,.298,14,42,.333,0,5,.000,15,22,.682,14,24,38,5,4,4,7,17,43,1.3
6118,Olalekan Ajayi\lekan-ajayi-1,2014-15,Eastern Michigan,F,29,2,397,14,24,.583,14,24,.583,0,0,,15,25,.600,35,72,107,4,13,13,10,65,43,2.2
6119,Austin Sparks\austin-sparks-1,2014-15,South Dakota,F,19,1,188,17,23,.739,17,23,.739,0,0,,9,13,.692,13,11,24,7,1,6,15,24,43,1.6
6120,Zachary Reynolds\zachary-reynolds-1,2014-15,Northern Arizona,F,26,1,234,17,28,.607,17,28,.607,0,0,,9,14,.643,33,45,78,2,3,9,9,25,43,2.2
6121,Leon Tolksdorf\leon-tolksdorf-1,2015-16,American,F,22,1,221,16,50,.320,8,15,.533,8,35,.229,3,7,.429,12,24,36,14,9,5,3,24,43,1.7
6122,Tanner Lancona\tanner-lancona-1,2014-15,Saint Louis,F,22,3,215,17,52,.327,14,26,.538,3,26,.115,6,18,.333,5,18,23,13,8,1,11,15,43,0.8
6123,E'Torrion Wilridge\etorrion-wilridge-1,2015-16,Georgia,F,33,0,301,16,29,.552,13,19,.684,3,10,.300,8,18,.444,6,39,45,20,2,11,20,18,43,1.1
6124,Greg Sequele\greg-sequele-1,2013-14,DePaul,F,31,1,317,20,33,.606,20,33,.606,0,0,,3,9,.333,24,29,53,4,7,12,12,57,43,1.1
6125,Isaac Humphries\isaac-humphries-1,2015-16,Kentucky,F,23,1,210,16,41,.390,16,41,.390,0,0,,11,15,.733,20,36,56,2,2,16,10,46,43,1.3
6126,Anthony Ochefu\anthony-ochefu-1,2017-18,Stony Brook,F,22,8,184,18,46,.391,18,45,.400,0,1,.000,7,19,.368,16,31,47,3,6,4,16,26,43,0.8
6127,Austin Colbert\austin-colbert-1,2014-15,Illinois,F,25,0,190,16,33,.485,13,29,.448,3,4,.750,8,13,.615,24,31,55,2,4,2,7,29,43,1.5
6128,Derrick Randall\derrick-randall-1,2014-15,Pittsburgh,F,27,5,211,16,33,.485,16,33,.485,0,0,,11,27,.407,31,32,63,0,1,1,12,36,43,1.0
6129,Andrew Moemeka\andrew-moemeka-1,2016-17,Wyoming,F,26,4,203,20,29,.690,20,29,.690,0,0,,3,6,.500,21,41,62,4,11,10,22,46,43,1.4
6130,Ryan Pierson\ryan-pierson-1,2013-14,Vermont,F,14,0,92,15,32,.469,15,32,.469,0,0,,13,16,.813,7,12,19,1,3,2,3,12,43,2.2
6131,Byron Fulton\byron-fulton-1,2013-14,Weber State,F,21,1,120,17,30,.567,9,11,.818,8,19,.421,1,4,.250,3,17,20,1,2,2,6,16,43,1.3
6132,Joshua Nurse\joshua-nurse-1,2017-18,St. Francis (NY),F,29,28,274,18,46,.391,18,46,.391,0,0,,7,24,.292,24,29,53,17,5,16,26,61,43,0.5
6133,Josh James\josh-james-1,2013-14,IUPUI,F,21,0,122,17,25,.680,17,25,.680,0,0,,9,11,.818,12,15,27,3,4,1,4,22,43,1.8
6134,Harry Froling\harry-froling-1,2016-17,Southern Methodist,F,10,0,146,18,37,.486,15,27,.556,3,10,.300,4,10,.400,12,20,32,6,4,2,14,15,43,2.6
6135,Femi Olujobi\femi-olujobi-1,2014-15,Oakland,F,26,8,238,15,40,.375,15,31,.484,0,9,.000,13,27,.481,18,24,42,10,2,3,23,30,43,0.4
6136,Shay'rone Jett\shayrone-jett-1,2017-18,Prairie View,F,21,2,193,18,44,.409,17,34,.500,1,10,.100,6,11,.545,13,18,31,4,3,6,11,37,43,0.8
6137,Brandon Gonzalez\brandon-gonzalez-1,2017-18,Southeastern Louisiana,F,20,0,162,16,31,.516,8,13,.615,8,18,.444,3,4,.750,10,16,26,4,3,1,8,30,43,1.3
6138,David Jesperson\david-jesperson-1,2014-15,Pepperdine,F,24,1,267,18,34,.529,15,26,.577,3,8,.375,4,6,.667,12,29,41,7,0,5,10,32,43,1.2
6139,Aaron Williams\aaron-williams-5,2014-15,Chicago State,F,24,4,250,16,55,.291,15,34,.441,1,21,.048,10,11,.909,12,32,44,3,11,5,16,28,43,0.7
6140,Chibueze Jacobs\chibueze-jacobs-1,2017-18,Sacramento State,F,27,0,206,14,28,.500,11,23,.478,3,5,.600,12,14,.857,13,23,36,6,2,0,15,18,43,1.0
6141,John Harrar\john-harrar-1,2017-18,Penn State,F,27,8,195,18,33,.545,18,33,.545,0,0,,6,11,.545,29,28,57,3,3,4,7,31,42,1.5
6142,Tshiefu Ngalakulondi\tshiefu-ngalakulondi-1,2017-18,St. Bonaventure,F,18,1,72,17,28,.607,12,17,.706,5,11,.455,3,6,.500,7,17,24,6,7,6,5,10,42,2.5
6143,Khadre Lane\khadre-lane-1,2016-17,Campbell,F,12,1,94,11,36,.306,7,23,.304,4,13,.308,16,22,.727,4,4,8,1,6,2,5,13,42,1.7
6144,Tyshawn Myles\tyshawn-myles-1,2014-15,Drexel,F,27,0,314,17,44,.386,17,44,.386,0,0,,8,16,.500,40,52,92,5,4,14,8,42,42,1.9
6145,Ryan Sawvell\ryan-sawvell-1,2013-14,Evansville,F,7,1,106,18,33,.545,18,29,.621,0,4,.000,6,7,.857,7,20,27,6,3,1,5,15,42,4.8
6146,Isaiah Hicks\isaiah-hicks-1,2013-14,North Carolina,F,34,0,249,15,36,.417,14,31,.452,1,5,.200,11,19,.579,14,21,35,7,5,12,14,35,42,0.8
6147,Chris Egi\chris-egi-1,2015-16,Harvard,F,25,2,287,17,38,.447,17,38,.447,0,0,,8,29,.276,15,33,48,13,6,16,20,46,42,0.9
6148,Christian Davis\christian-davis-1,2015-16,Arkansas State,F,28,6,234,12,46,.261,12,43,.279,0,3,.000,18,28,.643,8,30,38,1,4,6,19,47,42,-0.1
6149,Barnett Harris\barnett-harris-1,2016-17,Delaware,F,28,9,253,11,23,.478,11,23,.478,0,0,,20,29,.690,19,40,59,23,12,12,14,58,42,1.8
6150,Marcus Fuggins\marcus-fuggins-1,2014-15,Morehead State,F,28,2,241,16,39,.410,16,38,.421,0,1,.000,10,32,.313,27,30,57,5,11,14,22,66,42,0.6
6151,Phil Cofer\phil-cofer-1,2015-16,Florida State,F,11,4,132,13,23,.565,13,22,.591,0,1,.000,16,19,.842,5,17,22,2,4,3,7,9,42,3.2
6152,Noah Bramlage\noah-bramlage-1,2015-16,Princeton,F,17,0,118,13,37,.351,9,22,.409,4,15,.267,12,18,.667,6,12,18,11,3,1,8,11,42,1.5
6153,Mike Auger\mike-auger-1,2015-16,Pennsylvania,F,15,1,107,19,33,.576,18,31,.581,1,2,.500,3,8,.375,7,22,29,2,1,1,9,23,42,1.4
6154,JaMarkus Horace\jamarkus-horace-1,2013-14,Nicholls State,F,9,8,168,20,37,.541,20,37,.541,0,0,,2,8,.250,13,19,32,5,4,5,18,25,42,2.2
6155,Trey Grundy\trey-grundy-1,2015-16,North Carolina-Wilmington,F,17,0,123,16,38,.421,15,28,.536,1,10,.100,9,14,.643,9,11,20,4,5,3,9,29,42,1.1
6156,JC Washington\jc-washington-2,2016-17,Charlotte,F,9,8,157,20,40,.500,20,39,.513,0,1,.000,2,5,.400,11,28,39,11,3,6,13,27,42,3.1
6157,Brandon Allen\brandon-allen-4,2016-17,Florida State,F,14,0,87,15,32,.469,5,9,.556,10,23,.435,2,2,1.000,1,5,6,4,2,2,3,10,42,1.9
6158,Isaac Taylor\isaac-taylor-1,2015-16,Maryland-Eastern Shore,F,31,2,176,17,48,.354,17,48,.354,0,0,,8,12,.667,20,21,41,1,0,5,15,39,42,0.2
6159,Anthony Allen\anthony-allen-1,2014-15,Oklahoma State,F,25,2,179,16,21,.762,16,21,.762,0,0,,10,23,.435,16,45,61,4,3,19,22,36,42,1.4
6160,Solomon Mangham\solomon-mangham-1,2014-15,Howard,F,24,1,166,15,46,.326,8,24,.333,7,22,.318,5,8,.625,18,17,35,5,3,2,8,15,42,1.1
6161,AJ Sumbry\aj-sumbry-1,2013-14,Quinnipiac,F,29,3,264,17,43,.395,17,43,.395,0,0,,8,13,.615,18,19,37,4,1,11,16,65,42,0.2
6162,Patrick Wrencher\patrick-wrencher-1,2016-17,Saint Francis (PA),F,22,4,142,17,35,.486,17,35,.486,0,0,,8,13,.615,12,12,24,6,2,2,12,22,42,1.0
6163,Freddy Bitondo\freddy-bitondo-1,2017-18,Sam Houston State,F,28,1,208,18,35,.514,18,35,.514,0,0,,6,19,.316,19,19,38,4,1,1,9,44,42,0.6
6164,Demontrez Austin\demontrez-austin-1,2015-16,Jacksonville,F,25,2,305,19,36,.528,19,36,.528,0,0,,4,8,.500,31,49,80,7,7,6,10,29,42,2.1
6165,Maciej Bender\maciej-bender-1,2017-18,West Virginia,F,35,1,308,18,39,.462,18,36,.500,0,3,.000,6,15,.400,32,36,68,7,9,9,14,42,42,1.2
6166,Toby Van Ry\toby-vanry-1,2017-18,Texas-San Antonio,F,23,2,197,15,35,.429,11,22,.500,4,13,.308,7,12,.583,12,39,51,13,1,9,18,39,41,1.0
6167,Dusan Kovacevic\dusan-kovacevic-1,2016-17,Davidson,F,17,0,146,18,42,.429,16,32,.500,2,10,.200,3,9,.333,11,25,36,6,3,2,15,31,41,0.8
6168,Joseph Smoyer\joseph-smoyer-1,2017-18,Portland,F,23,0,174,15,27,.556,14,26,.538,1,1,1.000,10,15,.667,6,19,25,4,3,10,5,39,41,1.2
6169,Kenny Paul Geno\kenny-paul-geno-1,2016-17,Georgia,F,28,2,252,14,32,.438,7,13,.538,7,19,.368,6,9,.667,6,30,36,15,4,3,2,35,41,1.3
6170,Nick Banyard\nick-banyard-1,2013-14,New Mexico,F,24,0,252,15,44,.341,14,38,.368,1,6,.167,10,13,.769,11,27,38,5,2,4,9,34,41,0.7
6171,Roderick Taylor\roderick-taylor-2,2016-17,Louisiana-Monroe,F,27,3,284,18,47,.383,18,47,.383,0,0,,5,14,.357,21,23,44,1,2,12,11,47,41,0.5
6172,Admassu Williams\admassu-williams-1,2016-17,Prairie View,F,7,4,94,17,28,.607,17,28,.607,0,0,,7,11,.636,4,21,25,1,2,4,11,11,41,3.7
6173,Roman Sorkin\roman-sorkin-1,2015-16,Oregon,F,22,0,124,15,32,.469,11,17,.647,4,15,.267,7,9,.778,7,14,21,5,1,3,5,14,41,1.3
6174,Bronson Kessinger\bronson-kessinger-1,2016-17,Indiana State,F,27,1,220,17,60,.283,17,59,.288,0,1,.000,7,13,.538,20,35,55,2,10,4,8,28,41,0.8
6175,Cheickna Dembele\cheickna-dembele-1,2017-18,Nevada-Las Vegas,F,25,0,177,14,30,.467,14,30,.467,0,0,,13,28,.464,23,9,32,10,5,14,12,19,41,1.6
6176,Connor Devine\connor-devine-1,2013-14,South Dakota State,F,26,0,185,14,33,.424,14,33,.424,0,0,,13,22,.591,16,34,50,5,5,12,6,37,41,1.4
6177,Patrick Wrencher\patrick-wrencher-1,2015-16,Saint Francis (PA),F,24,0,178,18,33,.545,18,33,.545,0,0,,5,6,.833,12,13,25,3,3,4,9,21,41,1.1
6178,Nadi Beciri\nadi-beciri-1,2017-18,Fairleigh Dickinson,F,27,0,156,16,39,.410,15,32,.469,1,7,.143,8,16,.500,19,26,45,7,7,8,13,29,41,1.1
6179,Jay Huff\jay-huff-1,2017-18,Virginia,F,12,0,105,17,25,.680,15,18,.833,2,7,.286,5,8,.625,6,17,23,4,1,14,4,14,41,3.5
6180,Tommy Carpenter\tommy-carpenter-1,2015-16,Dartmouth,F,27,1,242,19,43,.442,19,41,.463,0,2,.000,3,5,.600,10,28,38,30,2,1,19,21,41,1.1
6181,Chase Jeter\chase-jeter-1,2016-17,Duke,F,16,6,238,13,26,.500,13,26,.500,0,0,,15,27,.556,18,25,43,6,7,17,17,31,41,2.3
6182,Adam Roe\adam-roe-1,2016-17,Army,F,9,0,77,14,31,.452,6,8,.750,8,23,.348,5,8,.625,4,7,11,2,6,0,7,7,41,2.9
6183,Brian Bridgewater\brian-bridgewater-1,2015-16,Louisiana State,F,19,1,152,16,34,.471,16,34,.471,0,0,,9,17,.529,12,19,31,4,6,6,11,18,41,1.5
6184,Jeff Havenstein\jeff-havenstein-1,2013-14,Longwood,F,32,27,396,16,31,.516,16,31,.516,0,0,,9,13,.692,25,38,63,6,3,4,16,66,41,0.6
6185,Gavin Skelly\gavin-skelly-1,2014-15,Northwestern,F,29,0,210,16,33,.485,16,33,.485,0,0,,9,17,.529,23,31,54,14,9,16,9,36,41,1.8
6186,Jeron Rogers\jeron-rogers-1,2015-16,Cleveland State,F,25,1,228,12,46,.261,7,23,.304,5,23,.217,12,18,.667,9,29,38,7,4,3,11,26,41,0.6
6187,Devin Wyatt\devin-wyatt-1,2017-18,Incarnate Word,F,21,8,248,15,38,.395,15,37,.405,0,1,.000,11,22,.500,21,22,43,2,5,30,9,38,41,1.9
6188,Alfonzo McKinnie\alfonzo-mckinnie-1,2013-14,Green Bay,F,9,0,115,15,35,.429,9,22,.409,6,13,.462,5,6,.833,4,21,25,2,3,4,2,19,41,3.2
6189,Ariston Johnson\ariston-johnson-1,2017-18,Alabama A&M,F,30,5,331,15,56,.268,9,36,.250,6,20,.300,5,8,.625,10,32,42,18,3,0,18,23,41,0.4
6190,Ty'Quan Bitting\tyquan-bitting-1,2015-16,Morehead State,F,19,0,131,18,31,.581,18,31,.581,0,0,,5,7,.714,6,8,14,2,3,1,8,15,41,1.2
6191,Hank Hollingsworth\hank-hollingsworth-1,2016-17,Cal Poly,F,29,8,313,15,29,.517,15,29,.517,0,0,,11,26,.423,19,47,66,2,4,29,17,52,41,1.2
6192,Kevin Morris\kevin-morris-2,2016-17,South Alabama,F,29,0,205,15,37,.405,15,37,.405,0,0,,11,27,.407,13,27,40,5,4,6,11,56,41,0.4
6193,Chukuka Emili\chukuka-emili-1,2017-18,Houston Baptist,F,23,0,232,16,57,.281,12,38,.316,4,19,.211,5,13,.385,16,32,48,3,5,19,13,35,41,0.8
6194,Austin Henry\austin-henry-1,2014-15,Incarnate Word,F,28,1,231,18,56,.321,16,49,.327,2,7,.286,3,8,.375,15,26,41,3,3,7,5,42,41,0.5
6195,Jere Vucica\jere-vucica-1,2015-16,Miami (OH),F,8,5,86,15,32,.469,14,26,.538,1,6,.167,10,16,.625,11,10,21,1,1,0,3,8,41,3.6
6196,DeLovell Earls\delovell-earls-1,2014-15,Air Force,F,19,4,222,15,37,.405,14,30,.467,1,7,.143,10,16,.625,10,25,35,30,10,2,16,41,41,1.7
6197,Victor Dorsey\victor-dorsey-1,2014-15,Longwood,F,24,0,221,17,41,.415,17,40,.425,0,1,.000,7,11,.636,14,25,39,4,4,5,13,32,41,0.8
6198,Jarred Reuter\jarred-reuter-1,2015-16,Virginia,F,26,0,121,16,34,.471,16,34,.471,0,0,,8,10,.800,10,15,25,5,1,0,6,24,40,0.9
6199,Milos Kostic\milos-kostic-1,2014-15,Appalachian State,F,21,0,146,14,44,.318,8,17,.471,6,27,.222,6,8,.750,12,17,29,7,3,1,8,11,40,1.1
6200,Greg Senat\greg-senat-1,2016-17,Wagner,F,22,3,223,15,30,.500,15,30,.500,0,0,,10,22,.455,23,35,58,3,6,9,10,30,40,1.8
6201,Lamar Wofford-Humphrey\lamar-wofford-humphrey-1,2016-17,Eastern Michigan,F,24,2,184,16,36,.444,14,24,.583,2,12,.167,6,12,.500,16,29,45,1,5,5,10,33,40,1.0
6202,Kyle Gullett\kyle-gullett-1,2015-16,Southeast Missouri State,F,23,4,285,14,45,.311,5,22,.227,9,23,.391,3,5,.600,15,19,34,14,7,1,9,22,40,1.3
6203,Charles Gavin\charles-gavin-1,2017-18,Western Illinois,F,18,0,181,18,38,.474,18,38,.474,0,0,,4,11,.364,16,17,33,2,1,1,5,21,40,1.3
6204,Nikola Rakicevic\nikola-rakicevic-1,2015-16,Buffalo,F,20,0,167,15,30,.500,11,20,.550,4,10,.400,6,11,.545,12,18,30,9,6,1,10,9,40,1.8
6205,Jesse Bunting\jesse-bunting-1,2015-16,Fordham,F,24,1,163,17,28,.607,17,28,.607,0,0,,6,11,.545,7,16,23,4,6,5,10,22,40,1.2
6206,Hunter Seacat\hunter-seacat-1,2015-16,William & Mary,F,19,0,166,17,28,.607,17,28,.607,0,0,,6,12,.500,9,11,20,8,1,5,8,21,40,1.5
6207,Kristijan Krajina\kristijan-krajina-1,2013-14,Mount St. Mary's,F,7,6,117,17,28,.607,16,27,.593,1,1,1.000,5,10,.500,8,22,30,3,3,0,5,20,40,4.2
6208,Dane Norman\dane-norman-1,2017-18,Air Force,F,21,0,133,14,32,.438,8,13,.615,6,19,.316,6,10,.600,8,20,28,5,0,1,11,20,40,0.9
6209,Chase Kammerer\chase-kammerer-1,2013-14,Air Force,F,28,8,252,14,34,.412,13,28,.464,1,6,.167,11,21,.524,22,28,50,22,9,5,14,36,40,1.5
6210,Taavi Jurkatamm\taavi-jurkatamm-1,2017-18,San Francisco,F,31,7,349,18,46,.391,15,34,.441,3,12,.250,1,7,.143,20,39,59,16,9,16,12,53,40,1.2
6211,Ryan Andrus\ryan-andrus-1,2014-15,Brigham Young,F,21,1,157,12,22,.545,9,14,.643,3,8,.375,13,18,.722,12,16,28,3,4,2,5,24,40,1.6
6212,Mikail Simmons\mikail-simmons-1,2017-18,Loyola Marymount,F,20,1,144,15,36,.417,10,17,.588,5,19,.263,5,9,.556,12,16,28,6,4,3,10,36,40,0.9
6213,Bear Henderson\bear-henderson-1,2015-16,Eastern Washington,F,28,3,150,12,23,.522,10,19,.526,2,4,.500,14,21,.667,9,9,18,6,4,1,8,29,40,0.9
6214,Ivan Lukic\ivan-lukic-1,2013-14,James Madison,F,25,6,270,11,42,.262,9,25,.360,2,17,.118,16,21,.762,7,16,23,5,1,1,10,34,40,0.2
6215,Alonzo Nelson-Ododa\alonzo-nelson-ododa-1,2015-16,Pittsburgh,F,31,5,251,17,37,.459,17,37,.459,0,0,,6,15,.400,25,23,48,4,1,23,11,40,40,1.1
6216,Corey Douglas\corey-douglas-1,2016-17,Rice,F,9,8,155,17,20,.850,17,20,.850,0,0,,6,7,.857,17,17,34,2,4,8,9,27,40,4.5
6217,Sacha Killeya-Jones\sacha-killeya-jones-1,2016-17,Kentucky,F,14,0,96,17,29,.586,17,29,.586,0,0,,6,15,.400,12,19,31,2,1,10,7,19,40,2.3
6218,Emir Ahmedic\emir-ahmedic-1,2017-18,Oral Roberts,F,18,0,110,16,40,.400,16,40,.400,0,0,,8,14,.571,9,12,21,2,3,2,5,28,40,0.9
6219,David Watkins\david-watkins-1,2017-18,New Hampshire,F,18,1,131,15,41,.366,8,14,.571,7,27,.259,3,4,.750,7,20,27,3,0,2,5,10,40,1.2
6220,Ian Carter\ian-carter-2,2016-17,Dartmouth,F,19,0,142,15,34,.441,11,21,.524,4,13,.308,6,15,.400,8,17,25,5,4,5,14,25,40,0.9
6221,Luke Maye\luke-maye-1,2015-16,North Carolina,F,33,0,178,16,41,.390,14,34,.412,2,7,.286,6,14,.429,25,30,55,7,3,3,10,26,40,0.9
6222,Leon Tolksdorf\leon-tolksdorf-1,2016-17,American,F,14,14,256,14,44,.318,7,12,.583,7,32,.219,5,7,.714,10,42,52,10,4,5,15,24,40,1.7
6223,Ryan Singer\ryan-singer-1,2014-15,San Jose State,F,28,3,401,11,43,.256,7,19,.368,4,24,.167,14,23,.609,24,31,55,9,5,8,15,57,40,0.6
6224,Alec Wnuk\alec-wnuk-1,2014-15,North Carolina-Asheville,F,15,0,122,16,38,.421,15,36,.417,1,2,.500,7,14,.500,11,20,31,5,2,2,3,22,40,1.7
6225,Josh Mendenhall\josh-mendenhall-1,2013-14,Western Carolina,F,22,8,212,16,40,.400,16,40,.400,0,0,,8,9,.889,20,24,44,8,7,10,11,29,40,1.6
6226,Milan Mijovic\milan-mijovic-1,2017-18,Marshall,F,25,22,315,16,40,.400,16,39,.410,0,1,.000,8,14,.571,13,39,52,15,5,6,19,45,40,0.8
6227,Garrett Moon\garrett-moon-1,2014-15,Eastern Washington,F,31,1,176,19,34,.559,18,32,.563,1,2,.500,1,6,.167,20,17,37,3,6,14,11,33,40,1.1
6228,Jordan Barnett\jordan-barnett-1,2014-15,Texas,F,21,0,179,15,45,.333,8,24,.333,7,21,.333,3,3,1.000,5,23,28,10,7,6,9,11,40,1.4
6229,Chris Griffin\chris-griffin-3,2013-14,Auburn,F,7,0,117,14,40,.350,7,15,.467,7,25,.280,5,5,1.000,5,23,28,3,4,7,8,8,40,4.0
6230,Sam Schwietz\sam-schwietz-1,2016-17,Maryland-Baltimore County,F,21,0,210,19,30,.633,19,30,.633,0,0,,2,6,.333,20,36,56,5,5,16,6,43,40,2.2
6231,Nadi Beciri\nadi-beciri-1,2016-17,Fairleigh Dickinson,F,25,0,123,10,29,.345,6,21,.286,4,8,.500,16,20,.800,13,22,35,4,4,4,13,30,40,0.9
6232,Samuel Idowu\samuel-idowu-1,2015-16,Saint Peter's,F,24,0,131,18,42,.429,16,35,.457,2,7,.286,2,3,.667,12,17,29,3,2,3,8,23,40,0.8
6233,Joe Thomas\joe-thomas-1,2014-15,Miami (FL),F,31,16,328,18,31,.581,18,31,.581,0,0,,4,14,.286,32,33,65,9,7,4,7,33,40,1.6
6234,Aaron Weidenaar\aaron-weidenaar-1,2017-18,Central Arkansas,F,26,1,168,15,42,.357,6,11,.545,9,31,.290,1,2,.500,6,13,19,7,1,2,10,32,40,0.3
6235,Karlis Garoza\karlis-garoza-1,2017-18,Cal Poly,F,20,0,237,16,39,.410,16,39,.410,0,0,,8,13,.615,26,30,56,12,5,3,17,34,40,1.5
6236,Ugo Mmonu\ugo-mmonu-1,2016-17,Charleston Southern,F,24,7,226,13,45,.289,12,37,.324,1,8,.125,12,19,.632,26,29,55,3,4,12,15,43,39,0.8
6237,Tevin Glass\tevin-glass-1,2014-15,Wichita State,F,19,0,107,12,31,.387,9,25,.360,3,6,.500,12,15,.800,11,10,21,4,1,3,5,15,39,1.4
6238,Ethan Mackey\ethan-mackey-1,2014-15,Maine,F,9,4,116,17,31,.548,17,31,.548,0,0,,5,10,.500,9,18,27,5,0,2,7,13,39,2.9
6239,Glen Pierre\glen-pierre-1,2014-15,College of Charleston,F,32,0,281,13,38,.342,13,38,.342,0,0,,13,18,.722,20,37,57,1,5,21,14,48,39,0.9
6240,Tyler Wood\tyler-wood-1,2013-14,Texas-San Antonio,F,18,7,300,13,35,.371,7,15,.467,6,20,.300,7,12,.583,16,32,48,12,8,3,9,38,39,1.8
6241,Alex Foster\alex-foster-1,2016-17,Bradley,F,19,2,103,16,29,.552,16,29,.552,0,0,,7,15,.467,7,14,21,1,0,5,9,17,39,1.0
6242,Albert Christensson\albert-christensson-1,2016-17,Central Arkansas,F,31,8,283,15,40,.375,15,40,.375,0,0,,9,15,.600,18,27,45,8,4,1,22,46,39,0.2
6243,Brent Calhoun\brent-calhoun-1,2014-15,Purdue-Fort Wayne,F,17,1,134,15,34,.441,15,34,.441,0,0,,9,17,.529,12,30,42,2,1,10,14,29,39,1.1
6244,Bennett Koch\bennett-koch-1,2014-15,Northern Iowa,F,28,0,115,15,28,.536,15,28,.536,0,0,,9,17,.529,8,9,17,0,0,3,9,23,39,0.5
6245,Aric Holman\aric-holman-1,2015-16,Mississippi State,F,21,3,193,18,44,.409,16,31,.516,2,13,.154,1,6,.167,9,30,39,8,2,14,16,37,39,0.7
6246,Jarriesse Blackmon\jarriesse-blackmon-1,2015-16,UC-Santa Barbara,F,24,8,215,15,56,.268,13,44,.295,2,12,.167,7,10,.700,17,41,58,8,7,8,5,17,39,1.5
6247,Thomas Smallwood\thomas-smallwood-1,2015-16,Alabama-Birmingham,F,10,0,47,14,25,.560,8,12,.667,6,13,.462,5,6,.833,4,15,19,2,0,3,0,9,39,3.4
6248,Angus Riley\angus-riley-1,2014-15,Bryant,F,17,7,177,14,43,.326,7,17,.412,7,26,.269,4,8,.500,8,21,29,5,1,0,5,15,39,1.1
6249,Petr Herman\petr-herman-1,2014-15,Loyola Marymount,F,28,2,272,13,48,.271,7,27,.259,6,21,.286,7,10,.700,7,30,37,6,8,5,16,28,39,0.4
6250,Alex Thomas\alex-thomas-1,2015-16,Towson,F,29,0,188,16,30,.533,16,30,.533,0,0,,7,13,.538,26,20,46,1,8,13,3,43,39,1.5
6251,Soufiyane Diakite\soufiyane-diakite-1,2016-17,Morehead State,F,6,0,54,15,23,.652,12,19,.632,3,4,.750,6,9,.667,8,8,16,5,3,0,6,10,39,5.4
6252,Tim Harrison\tim-harrison-1,2016-17,Rice,F,25,1,137,16,25,.640,15,20,.750,1,5,.200,6,9,.667,5,21,26,2,2,10,8,24,39,1.2
6253,Milan Mijovic\milan-mijovic-1,2014-15,Marshall,F,28,0,209,14,24,.583,14,24,.583,0,0,,11,18,.611,16,19,35,4,6,0,17,46,39,0.5
6254,Ryan Manning\ryan-manning-1,2014-15,Air Force,F,28,1,219,13,40,.325,7,16,.438,6,24,.250,7,12,.583,13,20,33,10,2,3,7,22,39,0.9
6255,Kordario Fleming\kordario-fleming-1,2013-14,Jacksonville,F,7,1,172,15,40,.375,15,39,.385,0,1,.000,9,20,.450,13,26,39,11,2,5,15,20,39,2.8
6256,Stephen Ugochukwu\stephen-ugochukwu-1,2014-15,McNeese State,F,27,0,195,16,48,.333,16,41,.390,0,7,.000,7,15,.467,13,32,45,3,2,9,9,28,39,0.6
6257,Omar El Manasterly\omar-el-manasterly-1,2014-15,Jacksonville,F,26,0,321,13,31,.419,13,31,.419,0,0,,13,28,.464,31,39,70,7,9,0,12,46,39,1.3
6258,Matthew Reed\matthew-reed-1,2015-16,Florida Atlantic,F,13,6,161,17,30,.567,17,30,.567,0,0,,5,5,1.000,9,28,37,0,1,6,4,33,39,2.1
6259,Matt Van Dyk\matt-vandyk-1,2016-17,Michigan State,F,30,4,231,14,26,.538,14,26,.538,0,0,,11,23,.478,27,25,52,12,9,12,12,34,39,1.6
6260,Ali Tew\alioune-tew-1,2015-16,Niagara,F,25,3,163,15,32,.469,15,32,.469,0,0,,9,26,.346,14,19,33,3,3,8,19,35,39,0.4
6261,Mitchell Solomon\mitchell-solomon-1,2014-15,Oklahoma State,F,32,2,348,14,30,.467,13,28,.464,1,2,.500,9,17,.529,42,44,86,11,11,19,16,71,38,1.6
6262,Isaac Copeland\isaac-copeland-1,2016-17,Georgetown,F,7,5,137,11,40,.275,11,30,.367,0,10,.000,16,19,.842,8,15,23,6,6,0,7,12,38,3.1
6263,Deverin Muff\deverin-muff-1,2014-15,Eastern Kentucky,F,32,3,354,15,36,.417,15,36,.417,0,0,,8,10,.800,15,24,39,5,18,18,7,58,38,1.2
6264,TreVaughn Wilkerson\trevaughn-wilkerson-1,2016-17,Hartford,F,30,1,371,16,47,.340,15,40,.375,1,7,.143,5,15,.333,13,49,62,12,7,16,22,45,38,0.6
6265,Ervin Thomas\ervin-thomas-1,2013-14,Mississippi Valley State,F,19,3,241,16,47,.340,16,36,.444,0,11,.000,6,14,.429,27,47,74,17,10,8,12,29,38,2.4
6266,Kirk Korver\kirk-korver-1,2013-14,Missouri-Kansas City,F,20,1,168,11,43,.256,1,2,.500,10,41,.244,6,8,.750,0,16,16,14,2,1,8,19,38,0.7
6267,Jordan Jackson\jordan-jackson-2,2014-15,Florida A&M,F,27,10,313,15,44,.341,15,44,.341,0,0,,8,18,.444,20,24,44,7,4,7,23,38,38,0.2
6268,Troy Temara\troy-temara-1,2016-17,George Mason,F,24,1,200,16,41,.390,16,41,.390,0,0,,6,15,.400,11,18,29,4,1,1,13,32,38,0.2
6269,Darryl Reynolds\darryl-reynolds-1,2014-15,Villanova,F,27,0,145,15,21,.714,15,21,.714,0,0,,8,20,.400,10,21,31,5,4,14,9,27,38,1.3
6270,Brendan Rumel\brendan-rumel-1,2017-18,Portland State,F,8,1,59,14,24,.583,14,23,.609,0,1,.000,10,12,.833,11,7,18,0,4,3,4,10,38,4.2
6271,Travis Carroll\travis-carroll-1,2013-14,Purdue,F,26,1,185,17,32,.531,15,28,.536,2,4,.500,2,4,.500,19,17,36,7,3,5,1,19,38,1.6
6272,Mason Stuteville\mason-stuteville-1,2015-16,Sacramento State,F,17,1,94,15,40,.375,9,20,.450,6,20,.300,2,4,.500,8,17,25,3,1,3,4,13,38,1.3
6273,Ronald Strother Jr.\ronald-strotherjr-1,2016-17,Mississippi Valley State,F,24,3,153,14,47,.298,9,23,.391,5,24,.208,5,7,.714,7,4,11,2,3,5,7,10,38,0.5
6274,Jamar Martin\jamar-martin-1,2017-18,Charleston Southern,F,25,3,196,14,45,.311,11,23,.478,3,22,.136,7,10,.700,14,28,42,17,6,4,9,19,38,1.3
6275,Roberto Mantovani\roberto-mantovani-1,2016-17,Robert Morris,F,22,13,286,13,35,.371,13,35,.371,0,0,,12,22,.545,22,33,55,9,4,2,17,47,38,0.7
6276,Pina Guillaume\pina-guillaume-1,2013-14,Maryland-Eastern Shore,F,17,5,224,17,41,.415,16,37,.432,1,4,.250,3,6,.500,13,38,51,4,5,2,12,37,38,1.0
6277,Montie Leunen\montie-leunen-1,2016-17,Portland State,F,26,2,206,10,28,.357,8,16,.500,2,12,.167,16,20,.800,6,17,23,13,5,4,4,32,38,1.2
6278,Jaylen McManus\jaylen-mcmanus-1,2016-17,College of Charleston,F,28,2,176,13,50,.260,3,11,.273,10,39,.256,2,5,.400,9,24,33,6,0,1,7,21,38,0.4
6279,KeyShawn Feazell\keyshawn-feazell-1,2017-18,Mississippi State,F,28,0,170,18,38,.474,17,29,.586,1,9,.111,1,6,.167,9,26,35,1,2,2,9,20,38,0.6
6280,Mac Hoffman\mac-hoffman-1,2015-16,Army,F,25,5,295,13,32,.406,12,29,.414,1,3,.333,11,16,.688,24,45,69,13,5,4,13,50,38,1.3
6281,Elijah Schmidt\elijah-schmidt-1,2016-17,Texas A&M-Corpus Christi,F,31,13,300,16,39,.410,15,34,.441,1,5,.200,5,8,.625,13,35,48,4,4,9,14,50,38,0.5
6282,Dave LaMore\dave-lamore-1,2013-14,Cornell,F,23,0,233,14,33,.424,14,32,.438,0,1,.000,10,18,.556,19,18,37,4,2,3,10,31,38,0.9
6283,Satchel Pierce\satchel-pierce-1,2017-18,Penn State,F,24,0,173,11,34,.324,11,33,.333,0,1,.000,16,28,.571,16,23,39,3,3,5,18,34,38,0.4
6284,Brendan Rumel\brendan-rumel-1,2016-17,Portland State,F,16,2,72,13,20,.650,13,20,.650,0,0,,12,13,.923,5,11,16,2,0,1,1,6,38,2.1
6285,Josiah Talbert\josiah-talbert-1,2016-17,Liberty,F,25,2,125,17,39,.436,16,26,.615,1,13,.077,3,9,.333,4,20,24,1,2,6,10,18,38,0.5
6286,Keion Alexander\keion-alexander-1,2017-18,Prairie View,F,30,2,180,15,29,.517,15,29,.517,0,0,,8,19,.421,20,22,42,3,4,17,10,34,38,1.1
6287,Alexsander Milosavljevic\alexsander-milosavljevic-1,2013-14,Abilene Christian,F,19,0,127,17,33,.515,17,32,.531,0,1,.000,4,8,.500,13,20,33,3,0,3,10,19,38,1.1
6288,Richie Edwards\richie-edwards-1,2013-14,Arizona State,F,15,0,101,14,33,.424,8,15,.533,6,18,.333,4,5,.800,3,11,14,6,4,1,4,13,38,1.7
6289,Jake Belford\jake-belford-1,2015-16,Davidson,F,7,6,131,10,27,.370,5,12,.417,5,15,.333,13,16,.813,9,28,37,6,2,2,6,14,38,4.7
6290,Colin Gruber\colin-gruber-1,2013-14,UC-Riverside,F,26,1,245,11,47,.234,6,24,.250,5,23,.217,11,13,.846,14,23,37,5,9,6,8,30,38,0.9
6291,Mikhail McLean\mikhail-mclean-1,2014-15,Houston,F,15,0,149,16,36,.444,16,33,.485,0,3,.000,6,18,.333,17,9,26,7,2,3,4,29,38,1.5
6292,Levi Yancy\levi-yancy-1,2015-16,Northwestern State,F,24,0,235,14,37,.378,14,35,.400,0,2,.000,10,10,1.000,12,27,39,14,6,7,16,31,38,1.1
6293,Brett Prahl\brett-prahl-1,2015-16,Milwaukee,F,26,0,118,15,19,.789,15,18,.833,0,1,.000,8,14,.571,11,8,19,2,2,1,11,25,38,0.8
6294,Dave LaMore\dave-lamore-1,2014-15,Cornell,F,17,0,229,17,28,.607,17,28,.607,0,0,,4,10,.400,16,31,47,2,0,6,8,31,38,1.7
6295,Jason Pimentel\jason-pimentel-1,2014-15,Longwood,F,8,0,157,14,27,.519,12,22,.545,2,5,.400,7,9,.778,10,25,35,3,4,6,6,23,37,4.1
6296,Babacar Thiombane\babacar-thiombane-1,2017-18,Army,F,30,1,281,16,27,.593,16,27,.593,0,0,,5,15,.333,24,59,83,10,14,19,23,59,37,1.4
6297,Alex Bates\alex-bates-1,2014-15,East Tennessee State,F,25,15,286,16,31,.516,16,30,.533,0,1,.000,5,15,.333,28,30,58,6,12,13,14,50,37,1.5
6298,DJ Laster\daniel-laster-1,2015-16,Gardner-Webb,F,15,0,105,15,33,.455,13,23,.565,2,10,.200,5,10,.500,11,6,17,2,3,2,10,23,37,0.9
6299,Peter Ryckbosch\peter-ryckbosch-1,2015-16,DePaul,F,24,7,233,14,30,.467,14,30,.467,0,0,,9,15,.600,29,30,59,5,4,2,18,45,37,0.9
6300,Amar Alibegovic\amar-alibegovic-1,2014-15,St. John's (NY),F,24,2,201,15,43,.349,9,17,.529,6,26,.231,1,7,.143,13,24,37,3,4,3,9,42,37,0.4
6301,Lucas N'Guessan\lucas-nguessan-1,2017-18,Oklahoma State,F,25,7,245,12,23,.522,12,21,.571,0,2,.000,13,22,.591,13,35,48,9,7,11,12,37,37,1.4
6302,Elston Jones\elston-jones-1,2014-15,Utah State,F,28,0,269,15,34,.441,15,34,.441,0,0,,7,15,.467,17,38,55,17,6,12,8,44,37,1.4
6303,Tyler Carter\tyler-carter-1,2016-17,Alcorn State,F,30,5,155,11,37,.297,8,19,.421,3,18,.167,12,17,.706,9,16,25,8,3,0,15,39,37,0.1
6304,Tyshawn Myles\tyshawn-myles-1,2015-16,Drexel,F,23,0,215,14,32,.438,14,32,.438,0,0,,9,27,.333,27,30,57,2,4,10,10,37,37,1.2
6305,Mike Louder\mike-louder-1,2013-14,Jacksonville State,F,14,0,106,15,30,.500,12,25,.480,3,5,.600,4,4,1.000,7,10,17,0,1,2,3,21,37,1.5
6306,Jalen Tate\jalen-tate-1,2016-17,Northern Kentucky,F,8,8,150,14,34,.412,13,24,.542,1,10,.100,8,24,.333,4,12,16,13,7,2,10,24,37,2.1
6307,Carlos Lopez-Sosa\carlos-lopez-1,2013-14,Nevada-Las Vegas,F,28,2,205,14,39,.359,14,38,.368,0,1,.000,9,20,.450,17,28,45,8,8,6,11,41,37,0.8
6308,T.J. Williams\tj-williams-3,2013-14,Chattanooga,F,24,0,182,16,28,.571,16,28,.571,0,0,,5,10,.500,16,22,38,0,2,14,14,34,37,1.0
6309,Preston Purifoy\preston-purifoy-1,2013-14,Alabama-Birmingham,F,24,2,178,12,32,.375,6,14,.429,6,18,.333,7,11,.636,5,17,22,5,3,2,6,11,37,1.0
6310,Greg Louis\greg-louis-1,2013-14,Pennsylvania,F,8,4,111,13,19,.684,10,14,.714,3,5,.600,8,15,.533,6,17,23,1,4,8,8,20,37,3.7
6311,Jackson Forbes\jackson-forbes-1,2015-16,Princeton,F,20,0,115,12,38,.316,3,5,.600,9,33,.273,4,5,.800,6,12,18,9,3,0,7,13,37,1.0
6312,Alex Hart\alex-hart-1,2017-18,UC-Santa Barbara,F,24,1,150,14,31,.452,14,31,.452,0,0,,9,16,.563,13,25,38,1,3,5,7,16,37,1.2
6313,Adonis Rwabigwi\adonis-rwabigwi-1,2016-17,Texas-Rio Grande Valley,F,26,4,245,13,28,.464,13,28,.464,0,0,,11,24,.458,19,30,49,3,7,7,11,60,37,0.7
6314,Tory Stewart-Miller\tory-stewart-miller-1,2017-18,Colorado,F,6,6,133,12,18,.667,12,18,.667,0,0,,13,23,.565,7,21,28,2,1,1,15,11,37,3.4
6315,Kyle Reid\kyle-reid-1,2015-16,Eastern Washington,F,28,1,149,13,20,.650,13,20,.650,0,0,,11,21,.524,12,20,32,5,7,5,3,37,37,1.2
6316,York Benjamin\york-benjamin-1,2017-18,Texas A&M-Corpus Christi,F,15,2,162,11,25,.440,11,24,.458,0,1,.000,15,17,.882,16,21,37,5,5,2,31,26,37,0.6
6317,Aaron Ariri\aaron-ariri-1,2014-15,Troy,F,29,0,294,13,44,.295,13,43,.302,0,1,.000,11,26,.423,35,49,84,3,4,8,19,29,37,0.9
6318,James Hemphill\james-hemphill-1,2016-17,Navy,F,18,1,120,16,23,.696,16,23,.696,0,0,,5,10,.500,8,12,20,3,2,1,8,13,37,1.5
6319,Greg Senat\greg-senat-1,2013-14,Wagner,F,21,0,125,15,30,.500,15,30,.500,0,0,,7,16,.438,18,16,34,1,0,3,3,23,37,1.3
6320,Sean O'Mara\sean-omara-1,2014-15,Xavier,F,25,0,106,14,25,.560,14,25,.560,0,0,,9,19,.474,9,8,17,5,2,7,4,16,37,1.2
6321,Kuran Iverson\kuran-iverson-1,2014-15,Memphis,F,8,0,94,13,26,.500,11,21,.524,2,5,.400,9,12,.750,6,9,15,8,3,4,13,15,37,2.8
6322,Colby Wollenman\colby-wollenman-1,2015-16,Michigan State,F,31,1,187,13,24,.542,13,24,.542,0,0,,11,15,.733,18,32,50,20,1,4,16,29,37,1.2
6323,Anthony Morse\anthony-morse-1,2013-14,Tennessee Tech,F,25,3,164,13,37,.351,13,37,.351,0,0,,11,18,.611,13,14,27,4,7,7,9,27,37,0.9
6324,Johnathan Spicer\johnathan-spicer-1,2014-15,Florida A&M,F,28,4,267,11,34,.324,10,26,.385,1,8,.125,13,20,.650,11,28,39,8,5,0,21,13,36,0.5
6325,Avery Sullivan\avery-sullivan-1,2017-18,Lamar,F,28,0,199,13,37,.351,13,36,.361,0,1,.000,10,20,.500,21,23,44,9,11,2,14,37,36,0.8
6326,River Reed\river-reed-1,2017-18,Loyola (MD),F,15,5,135,14,23,.609,14,21,.667,0,2,.000,8,16,.500,8,15,23,6,2,4,5,24,36,1.8
6327,Conrad Stephens\conrad-stephens-1,2015-16,Robert Morris,F,14,0,152,15,26,.577,15,26,.577,0,0,,6,9,.667,17,17,34,2,6,0,8,15,36,2.4
6328,Hassan Thomas\hassan-thomas-1,2015-16,Illinois-Chicago,F,21,0,167,10,36,.278,8,31,.258,2,5,.400,14,19,.737,15,26,41,7,6,2,7,22,36,1.3
6329,Kenny Grant\kenny-grant-2,2015-16,Rider,F,10,1,115,15,25,.600,15,25,.600,0,0,,6,10,.600,7,23,30,2,2,4,8,24,36,2.3
6330,Colby Wollenman\colby-wollenman-1,2014-15,Michigan State,F,29,0,220,17,28,.607,17,28,.607,0,0,,2,9,.222,14,35,49,6,3,4,12,27,36,1.0
6331,Jamar Brown\jamar-brown-1,2017-18,Wagner,F,11,0,74,12,16,.750,12,16,.750,0,0,,12,20,.600,9,8,17,0,2,3,10,26,36,1.7
6332,Jack Salt\jack-salt-1,2015-16,Virginia,F,22,9,138,17,33,.515,17,33,.515,0,0,,2,6,.333,14,10,24,0,1,5,10,25,36,0.7
6333,Everett Ray\everett-ray-1,2017-18,Southern Methodist,F,16,0,160,14,22,.636,12,19,.632,2,3,.667,6,20,.300,19,24,43,7,2,1,9,27,36,1.8
6334,Julius Rajala\julius-rajala-1,2014-15,Loyola (IL),F,19,0,119,14,30,.467,13,28,.464,1,2,.500,7,11,.636,8,13,21,2,2,5,10,8,36,1.2
6335,Jordan Abdur-Ra'oof\jordan-abdur-raoof-1,2014-15,Cornell,F,27,0,173,13,40,.325,7,24,.292,6,16,.375,4,5,.800,2,14,16,4,5,4,4,24,36,0.6
6336,Maciej Bender\maciej-bender-1,2016-17,West Virginia,F,23,0,148,13,38,.342,12,32,.375,1,6,.167,9,16,.563,14,15,29,8,2,11,5,15,36,1.3
6337,Austin Sparks\austin-sparks-1,2015-16,South Dakota,F,20,0,165,14,24,.583,14,24,.583,0,0,,8,14,.571,13,19,32,2,0,3,8,21,36,1.2
6338,Dantai St. Louis\dantai-stlouis-1,2016-17,Canisius,F,32,0,218,15,36,.417,15,36,.417,0,0,,6,16,.375,22,24,46,5,1,3,8,49,36,0.5
6339,Kenny Paul Geno\kenny-paul-geno-1,2014-15,Georgia,F,22,6,251,13,31,.419,11,22,.500,2,9,.222,8,13,.615,9,24,33,8,6,4,8,27,36,1.2
6340,Samuel Dingba\samuel-dingba-1,2017-18,Vermont,F,17,0,129,13,19,.684,13,19,.684,0,0,,10,18,.556,11,17,28,1,4,6,5,20,36,2.0
6341,Jalen Jones\jalen-jones-3,2016-17,Howard,F,26,2,256,14,23,.609,14,22,.636,0,1,.000,8,20,.400,16,39,55,10,7,6,17,28,36,1.3
6342,Evan Wardlow\evan-wardlow-1,2014-15,Santa Clara,F,30,1,272,15,34,.441,14,31,.452,1,3,.333,5,6,.833,2,21,23,16,4,2,15,19,36,0.7
6343,Miroslav Jaksic\miroslav-jaksic-1,2014-15,Grand Canyon,F,13,2,74,15,29,.517,15,27,.556,0,2,.000,6,13,.462,5,11,16,0,0,4,8,14,36,1.1
6344,Evan Wardlow\evan-wardlow-1,2016-17,Santa Clara,F,19,1,201,12,29,.414,7,17,.412,5,12,.417,7,10,.700,1,19,20,12,4,4,6,26,36,1.3
6345,Grant Fiorentinos\grant-fiorentinos-1,2013-14,Southern Illinois-Edwardsville,F,24,0,168,16,37,.432,16,37,.432,0,0,,4,13,.308,10,17,27,2,4,3,10,37,36,0.3
6346,Christian Crockett\christian-crockett-1,2014-15,Tennessee State,F,19,0,164,11,38,.289,11,35,.314,0,3,.000,14,38,.368,8,26,34,3,3,0,8,26,36,0.2
6347,Mike Kobani\mike-kobani-1,2014-15,Appalachian State,F,21,6,127,14,31,.452,14,31,.452,0,0,,8,19,.421,10,15,25,1,1,2,5,27,36,0.7
6348,Cameron Neubauer\cameron-neubauer-1,2014-15,San Diego,F,17,0,152,13,31,.419,6,14,.429,7,17,.412,3,9,.333,5,11,16,2,3,2,3,11,36,1.3
6349,Martinas Geben\martinas-geben-1,2014-15,Notre Dame,F,22,1,194,11,20,.550,11,20,.550,0,0,,14,20,.700,9,26,35,9,1,8,13,23,36,1.3
6350,Derek Sloan\derek-sloan-1,2015-16,Cleveland State,F,28,6,207,12,30,.400,12,30,.400,0,0,,12,19,.632,13,21,34,4,4,6,14,44,36,0.4
6351,Sam Mike\sam-mike-1,2013-14,Georgia Southern,F,32,0,327,12,28,.429,12,28,.429,0,0,,12,23,.522,25,30,55,2,5,5,13,51,36,0.6
6352,Matej Drgon\matej-drgon-1,2017-18,Northern Colorado,F,18,0,125,12,43,.279,2,7,.286,10,36,.278,2,3,.667,7,15,22,2,1,1,8,22,36,0.3
6353,T.J. Oliver\tj-oliver-1,2015-16,Tulane,F,17,1,101,16,41,.390,14,32,.438,2,9,.222,2,5,.400,16,18,34,2,0,1,9,16,36,0.9
6354,Dishon Lowery\dishon-lowery-1,2016-17,Wofford,F,24,0,183,13,27,.481,13,27,.481,0,0,,9,14,.643,24,26,50,6,3,8,17,29,35,1.2
6355,Mike Owona\mike-owona-1,2013-14,Fairleigh Dickinson,F,30,3,305,16,37,.432,16,37,.432,0,0,,3,7,.429,20,48,68,5,5,14,15,50,35,0.9
6356,Jacquil Taylor\jacquil-taylor-1,2017-18,Purdue,F,19,0,115,14,32,.438,12,27,.444,2,5,.400,5,8,.625,6,20,26,3,4,7,7,13,35,1.4
6357,Tommy Carpenter\tommy-carpenter-1,2013-14,Dartmouth,F,15,1,139,15,23,.652,15,22,.682,0,1,.000,5,8,.625,11,12,23,16,3,4,13,20,35,2.1
6358,Logan Routt\logan-routt-1,2017-18,West Virginia,F,31,0,247,15,24,.625,15,24,.625,0,0,,5,10,.500,39,25,64,10,0,11,12,40,35,1.4
6359,Hugo Naurais\hugo-naurais-1,2014-15,Wagner,F,25,3,250,16,49,.327,16,37,.432,0,12,.000,3,6,.500,22,34,56,4,6,9,16,35,35,0.7
6360,Harrison Kay\harrison-kay-1,2016-17,Central Connecticut State,F,20,1,175,12,37,.324,8,27,.296,4,10,.400,7,13,.538,6,15,21,7,5,1,17,33,35,0.0
6361,D.J. Jackson\dj-jackson-4,2017-18,Southern Illinois-Edwardsville,F,19,2,183,13,33,.394,11,21,.524,2,12,.167,7,11,.636,15,14,29,4,5,0,5,20,35,1.3
6362,Anas Mahmoud\anas-mahmoud-1,2014-15,Louisville,F,30,2,236,13,25,.520,13,25,.520,0,0,,9,12,.750,17,24,41,11,4,20,14,30,35,1.3
6363,Jabari McGhee\jabari-mcghee-1,2014-15,Tennessee,F,8,2,103,14,20,.700,14,20,.700,0,0,,7,17,.412,16,14,30,0,3,1,3,24,35,3.6
6364,Marko Pirovic\marko-pirovic-1,2015-16,Maine,F,17,0,179,12,38,.316,9,21,.429,3,17,.176,8,15,.533,4,22,26,13,8,1,9,14,35,1.4
6365,Ivan Lukic\ivan-lukic-1,2015-16,James Madison,F,17,0,103,11,24,.458,11,22,.500,0,2,.000,13,18,.722,13,19,32,4,2,3,4,15,35,1.9
6366,David Chadwick\david-chadwick-1,2013-14,Valparaiso,F,12,0,84,15,29,.517,11,19,.579,4,10,.400,1,4,.250,5,8,13,5,2,2,4,1,35,2.3
6367,Chuck Ogbodo\chuck-ogbodo-1,2016-17,North Carolina-Wilmington,F,23,1,178,14,27,.519,14,27,.519,0,0,,7,12,.583,24,21,45,3,3,17,9,40,35,1.5
6368,Thair Heath\thair-heath-1,2013-14,Morgan State,F,20,1,127,16,27,.593,16,27,.593,0,0,,3,12,.250,12,14,26,8,6,10,10,33,35,1.3
6369,Donovan Gilmore\donovan-gilmore-1,2015-16,College of Charleston,F,25,6,183,13,37,.351,13,37,.351,0,0,,9,15,.600,13,30,43,1,2,5,13,23,35,0.6
6370,Seth Kisler\seth-kisler-1,2013-14,Arkansas State,F,18,0,120,13,23,.565,9,14,.643,4,9,.444,5,9,.556,8,6,14,2,3,0,7,19,35,1.1
6371,Ajdin Penava\ajdin-penava-1,2015-16,Marshall,F,18,1,109,12,31,.387,10,17,.588,2,14,.143,9,13,.692,4,14,18,5,1,8,7,35,35,0.7
6372,Brian Steele\brian-steele-1,2014-15,South Carolina,F,21,0,179,11,47,.234,2,9,.222,9,38,.237,4,4,1.000,2,10,12,8,7,1,5,20,35,0.5
6373,Peter Ryckbosch\peter-ryckbosch-1,2017-18,DePaul,F,18,2,160,17,26,.654,17,26,.654,0,0,,1,9,.111,18,22,40,0,5,3,4,23,35,1.9
6374,Nenad Tomic\nenad-tomic-1,2014-15,Cornell,F,23,0,147,10,31,.323,10,31,.323,0,0,,15,23,.652,15,9,24,2,2,0,3,16,35,0.9
6375,Mike Fofana\mike-fofana-1,2016-17,Tennessee-Martin,F,19,0,112,11,21,.524,10,18,.556,1,3,.333,12,14,.857,5,14,19,7,4,0,10,11,35,1.4
6376,Nick Gorski\nick-gorski-1,2015-16,Loyola (MD),F,24,0,138,12,30,.400,12,29,.414,0,1,.000,11,15,.733,10,12,22,5,1,2,9,17,35,0.7
6377,Oliver Powell\oliver-powell-1,2016-17,Louisiana Tech,F,27,0,241,15,34,.441,14,31,.452,1,3,.333,4,11,.364,9,49,58,9,5,2,13,21,35,1.0
6378,Anali Okoloji\anali-okoloji-1,2013-14,George Mason,F,17,0,136,9,27,.333,7,24,.292,2,3,.667,15,28,.536,10,21,31,4,7,2,10,27,35,1.1
6379,Devin Thornton\devin-thornton-1,2015-16,Southern Illinois-Edwardsville,F,21,0,155,11,41,.268,3,21,.143,8,20,.400,5,12,.417,4,12,16,11,6,3,8,20,35,0.7
6380,Sam Ibiezugbe\sam-ibiezugbe-1,2016-17,Monmouth,F,29,0,218,15,39,.385,15,39,.385,0,0,,5,10,.500,19,44,63,0,2,17,9,37,35,1.0
6381,David Wacker\david-wacker-1,2017-18,Boise State,F,25,0,164,11,19,.579,11,19,.579,0,0,,13,18,.722,18,20,38,1,0,4,8,18,35,1.2
6382,Chris Dees\chris-dees-1,2014-15,St. Bonaventure,F,31,2,294,16,42,.381,16,42,.381,0,0,,3,6,.500,18,43,61,5,13,10,5,45,35,1.2
6383,Richard Bivens\richard-bivens-1,2016-17,Florida International,F,13,6,142,14,25,.560,9,17,.529,5,8,.625,2,3,.667,8,20,28,0,1,2,8,16,35,1.7
6384,Marshall Guilmette\marshall-guilmette-1,2013-14,East Carolina,F,5,4,73,12,27,.444,12,27,.444,0,0,,11,14,.786,7,15,22,2,1,1,6,7,35,4.7
6385,Kellen McCormick\kellen-mccormick-1,2016-17,Georgia Tech,F,24,0,113,12,16,.750,1,1,1.000,11,15,.733,0,0,,1,7,8,3,2,0,5,6,35,1.2
6386,James Hemphill\james-hemphill-1,2014-15,Navy,F,15,5,156,14,22,.636,14,22,.636,0,0,,7,11,.636,9,19,28,5,4,0,7,11,35,2.1
6387,Travis Atson\travis-atson-1,2016-17,Tulsa,F,22,3,135,13,33,.394,7,14,.500,6,19,.316,3,5,.600,5,16,21,4,2,2,9,17,35,0.7
6388,Nolan Long\nolan-long-1,2013-14,Wagner,F,19,0,152,13,25,.520,13,25,.520,0,0,,9,15,.600,17,39,56,0,2,9,2,29,35,2.0
6389,Manny Suarez\manny-suarez-1,2014-15,Fordham,F,19,1,143,12,52,.231,5,24,.208,7,28,.250,4,6,.667,10,30,40,3,3,18,12,26,35,0.7
6390,Logan Power\logan-power-1,2015-16,South Dakota,F,14,0,87,11,26,.423,5,9,.556,6,17,.353,6,9,.667,1,11,12,3,0,1,3,5,34,1.5
6391,Josh Hawkinson\josh-hawkinson-1,2013-14,Washington State,F,28,0,180,11,24,.458,11,24,.458,0,0,,12,20,.600,13,32,45,5,1,4,6,24,34,1.0
6392,Jose Martinez\jose-martinez-1,2017-18,San Diego,F,16,0,67,12,28,.429,4,8,.500,8,20,.400,2,4,.500,2,16,18,1,1,2,4,22,34,0.9
6393,Peter Ryckbosch\peter-ryckbosch-1,2013-14,DePaul,F,27,0,146,10,24,.417,10,24,.417,0,0,,14,25,.560,12,16,28,0,2,2,9,33,34,0.4
6394,Jordan Swopshire\jordan-swopshire-1,2013-14,Bradley,F,26,1,114,10,26,.385,2,6,.333,8,20,.400,6,15,.400,3,9,12,3,2,0,5,5,34,0.7
6395,Noah McCarty\noah-mccarty-1,2016-17,Northern Illinois,F,29,1,208,12,32,.375,12,30,.400,0,2,.000,10,13,.769,20,26,46,9,3,7,17,52,34,0.5
6396,Jamin Lackey\jamin-lackey-1,2015-16,North Carolina A&T,F,18,5,169,17,31,.548,17,31,.548,0,0,,0,4,.000,11,29,40,7,0,4,14,29,34,0.9
6397,Landen Lucas\landen-lucas-1,2013-14,Kansas,F,22,0,107,12,21,.571,12,21,.571,0,0,,10,20,.500,9,21,30,0,2,7,5,20,34,1.2
6398,Chris Walker\chris-walker-6,2013-14,Florida,F,18,0,87,16,27,.593,16,27,.593,0,0,,2,7,.286,10,14,24,1,2,8,2,19,34,1.6
6399,Austin Burgett\austin-burgett-1,2014-15,Notre Dame,F,20,0,139,15,27,.556,14,16,.875,1,11,.091,3,6,.500,7,21,28,7,6,1,7,21,34,1.4
6400,Corey Brown\corey-brown-4,2016-17,Northern Arizona,F,23,1,171,14,31,.452,14,31,.452,0,0,,6,10,.600,8,25,33,4,1,3,12,36,34,0.4
6401,Nick Fuller\nick-fuller-1,2014-15,Nebraska,F,16,1,129,13,25,.520,10,17,.588,3,8,.375,5,6,.833,8,13,21,4,2,2,4,12,34,1.8
6402,Bertrand Nkali\bertrand-nkali-1,2015-16,Houston,F,24,4,217,11,19,.579,11,19,.579,0,0,,12,24,.500,31,22,53,2,4,18,7,41,34,1.8
6403,Daniel Melifonwu\daniel-melifonwu-1,2015-16,Southern Utah,F,29,5,270,14,31,.452,14,31,.452,0,0,,6,15,.400,14,31,45,1,2,18,19,60,34,0.2
6404,Tariq Owens\tariq-owens-1,2014-15,Tennessee,F,28,5,214,12,34,.353,12,34,.353,0,0,,10,19,.526,14,17,31,3,5,13,11,40,34,0.6
6405,Jakob Stenhede\jakob-stenhede-1,2014-15,Maryland-Baltimore County,F,27,2,201,13,26,.500,13,26,.500,0,0,,8,14,.571,12,28,40,1,2,6,6,25,34,1.0
6406,Joey Quigley\joey-quigley-1,2013-14,Sacramento State,F,28,3,175,14,37,.378,13,34,.382,1,3,.333,5,11,.455,15,23,38,8,9,6,13,11,34,1.1
6407,Alex Illikainen\alex-illikainen-1,2016-17,Wisconsin,F,27,0,224,12,37,.324,8,21,.381,4,16,.250,6,12,.500,16,24,40,9,3,3,5,19,34,1.0
6408,Richard Freudenberg\richard-freudenberg-1,2016-17,St. John's (NY),F,26,0,242,12,48,.250,5,13,.385,7,35,.200,3,4,.750,6,29,35,12,1,2,17,30,34,0.0
6409,Kentan Facey\kentan-facey-1,2013-14,Connecticut,F,24,0,123,13,27,.481,11,24,.458,2,3,.667,6,9,.667,15,26,41,4,2,7,3,30,34,1.3
6410,Jahlin Smith\jahlin-smith-1,2017-18,Savannah State,F,9,5,109,15,36,.417,13,24,.542,2,12,.167,2,4,.500,11,25,36,2,6,1,15,13,34,1.9
6411,Sammy Friday\sammy-friday-1,2016-17,Siena,F,26,0,110,10,22,.455,10,22,.455,0,0,,14,20,.700,11,10,21,1,4,2,3,14,34,1.1
6412,Duane Moss\duane-moss-1,2017-18,Chattanooga,F,7,1,135,11,23,.478,3,9,.333,8,14,.571,4,7,.571,4,16,20,9,3,1,7,19,34,3.4
6413,Jaro Moravek\jaro-moravek-1,2016-17,Troy,F,22,1,129,14,36,.389,10,14,.714,4,22,.182,2,4,.500,11,23,34,5,2,3,5,14,34,1.1
6414,Johncarlos Reyes\johncarlos-reyes-1,2016-17,Boston College,F,21,0,134,15,28,.536,15,28,.536,0,0,,4,10,.400,5,19,24,4,4,11,7,21,34,1.3
6415,Coye Simmons\coye-simmons-1,2014-15,Georgia Southern,F,19,0,98,14,26,.538,14,26,.538,0,0,,6,13,.462,16,25,41,0,1,2,3,13,34,1.7
6416,Eividas Petrulis\eividas-petrulis-1,2013-14,Saint Mary's (CA),F,18,0,75,11,23,.478,2,4,.500,9,19,.474,3,5,.600,2,4,6,4,1,0,11,8,34,0.8
6417,Jose Martinez\jose-martinez-1,2016-17,San Diego,F,13,1,91,11,40,.275,3,8,.375,8,32,.250,4,7,.571,1,10,11,2,0,7,4,15,34,0.7
6418,Ali Tew\alioune-tew-1,2016-17,Niagara,F,27,2,203,12,41,.293,12,41,.293,0,0,,10,18,.556,25,25,50,0,3,13,16,31,34,0.6
6419,Cameron Walker\cameron-walker-1,2015-16,Stanford,F,25,2,275,7,24,.292,6,18,.333,1,6,.167,19,39,.487,10,22,32,23,5,2,18,40,34,0.6
6420,Dylan Jones\dylan-jones-1,2013-14,Pennsylvania,F,21,1,130,14,34,.412,14,34,.412,0,0,,6,20,.300,12,14,26,1,2,4,7,24,34,0.6
6421,Grant Anticevich\grant-anticevich-1,2017-18,University of California,F,23,0,171,11,35,.314,9,22,.409,2,13,.154,10,13,.769,11,25,36,3,2,3,10,18,34,0.7
6422,David Watkins\david-watkins-1,2015-16,New Hampshire,F,18,0,82,12,29,.414,6,13,.462,6,16,.375,4,9,.444,6,13,19,0,0,4,6,17,34,0.8
6423,Nick Blair\nick-blair-1,2016-17,Idaho,F,19,0,113,13,28,.464,10,19,.526,3,9,.333,5,8,.625,9,13,22,7,3,2,6,11,34,1.4
6424,Ronald Strother Jr.\ronald-strotherjr-1,2015-16,Mississippi Valley State,F,24,4,186,14,41,.341,13,31,.419,1,10,.100,5,10,.500,12,20,32,3,5,7,10,10,34,0.9
6425,Eric Hamilton\eric-hamilton-1,2016-17,Wichita State,F,26,0,124,13,44,.295,11,32,.344,2,12,.167,6,17,.353,6,28,34,1,3,5,8,16,34,0.4
6426,Wesley Dickinson\wesley-dickinson-1,2014-15,Dartmouth,F,27,2,190,15,30,.500,15,30,.500,0,0,,4,9,.444,14,16,30,2,2,11,11,18,34,0.9
6427,Scott Hitchon\scott-hitchon-1,2017-18,Canisius,F,21,1,137,11,26,.423,9,16,.563,2,10,.200,10,15,.667,4,19,23,3,1,9,10,34,34,0.6
6428,Dale Jones\dale-jones-1,2015-16,Iowa,F,6,0,78,12,30,.400,3,10,.300,9,20,.450,0,0,,2,16,18,3,1,2,4,11,33,3.2
6429,Femi Olujobi\femi-olujobi-1,2015-16,Oakland,F,30,1,187,13,34,.382,13,32,.406,0,2,.000,7,15,.467,20,23,43,6,1,3,6,24,33,0.8
6430,Perry Francois\perry-francois-1,2016-17,Texas A&M-Corpus Christi,F,35,5,244,16,35,.457,16,35,.457,0,0,,1,15,.067,20,26,46,3,3,8,10,46,33,0.4
6431,Jake Flaggert\jake-flaggert-1,2017-18,Texas-El Paso,F,29,3,361,7,30,.233,0,3,.000,7,27,.259,12,14,.857,4,26,30,20,2,2,6,64,33,0.4
6432,Chad Ross\chad-ross-1,2013-14,Utah Valley,F,32,0,252,13,41,.317,13,36,.361,0,5,.000,7,10,.700,9,36,45,3,8,5,13,29,33,0.5
6433,Scott Sill\scott-sill-1,2014-15,Delaware State,F,24,1,150,12,36,.333,4,13,.308,8,23,.348,1,5,.200,8,18,26,3,3,3,8,20,33,0.6
6434,Frederik Jorg\frederik-jorg-1,2014-15,Eastern Washington,F,15,4,68,13,19,.684,13,19,.684,0,0,,7,12,.583,8,9,17,3,0,5,5,19,33,1.6
6435,Quadree Smith\quadree-smith-1,2015-16,Providence,F,19,1,96,10,19,.526,10,19,.526,0,0,,13,17,.765,7,13,20,1,3,1,5,21,33,1.2
6436,Zach Cameron\zach-cameron-1,2016-17,Kennesaw State,F,30,0,311,14,30,.467,14,30,.467,0,0,,5,15,.333,19,58,77,19,8,12,13,40,33,1.5
6437,Maurice Kirby\maurice-kirby-1,2015-16,Loyola (IL),F,24,5,165,14,32,.438,14,32,.438,0,0,,5,14,.357,16,20,36,3,2,4,12,35,33,0.4
6438,Terrance Hubby\terrance-hubby-1,2016-17,Lamar,F,15,0,92,11,16,.688,11,15,.733,0,1,.000,11,21,.524,3,15,18,0,5,4,5,15,33,1.7
6439,Ben Freeland\ben-freeland-1,2013-14,Lafayette,F,28,8,188,16,30,.533,16,30,.533,0,0,,1,4,.250,6,33,39,5,5,8,17,39,33,0.5
6440,Yilret Yiljep\yilret-yiljep-1,2013-14,American,F,13,0,147,13,26,.500,13,26,.500,0,0,,7,12,.583,8,19,27,15,1,3,19,30,33,0.9
6441,Alex Hart\alex-hart-1,2014-15,UC-Santa Barbara,F,12,0,79,10,22,.455,5,9,.556,5,13,.385,8,11,.727,8,10,18,6,0,0,4,10,33,2.1
6442,Michael Douglas\michael-douglas-1,2015-16,Florida International,F,26,0,195,12,41,.293,7,12,.583,5,29,.172,4,15,.267,6,24,30,3,2,3,3,17,33,0.5
6443,Alex Peters\alex-peters-1,2014-15,Samford,F,31,8,287,16,29,.552,16,29,.552,0,0,,1,4,.250,13,26,39,3,8,12,19,76,33,0.1
6444,Sam Green\sam-green-1,2016-17,Drexel,F,14,0,95,12,27,.444,3,7,.429,9,20,.450,0,0,,5,5,10,5,0,1,3,8,33,1.6
6445,Luke Vargo\luke-vargo-1,2016-17,High Point,F,30,0,252,12,37,.324,5,17,.294,7,20,.350,2,8,.250,7,23,30,5,4,7,7,27,33,0.5
6446,Kyle Steward\kyle-steward-1,2013-14,Youngstown State,F,17,0,88,14,25,.560,13,20,.650,1,5,.200,4,8,.500,10,14,24,3,5,2,4,16,33,1.7
6447,Melvin Brooks\melvin-brooks-1,2015-16,Charleston Southern,F,18,0,168,13,29,.448,13,29,.448,0,0,,7,10,.700,13,27,40,1,1,5,3,40,33,1.1
6448,T.J. Thomas\tj-thomas-1,2014-15,Southeast Missouri State,F,15,0,120,9,19,.474,9,19,.474,0,0,,15,20,.750,12,12,24,4,2,4,7,17,33,1.8
6449,Connor McClenaghan\connor-mcclenaghan-1,2015-16,Marist,F,19,1,148,12,31,.387,11,28,.393,1,3,.333,8,15,.533,4,11,15,8,2,12,12,35,33,0.5
6450,Alec Brennan\alec-brennan-1,2014-15,Princeton,F,23,0,151,11,27,.407,8,18,.444,3,9,.333,8,12,.667,9,13,22,8,3,7,10,32,33,0.8
6451,Azariah Sykes\azariah-sykes-1,2017-18,Morgan State,F,27,8,406,9,16,.563,9,15,.600,0,1,.000,15,29,.517,32,73,105,7,10,9,12,72,33,1.6
6452,Nikola Cerina\nikola-cerina-1,2013-14,Northwestern,F,32,2,280,13,27,.481,13,24,.542,0,3,.000,7,21,.333,15,34,49,10,11,4,16,57,33,0.5
6453,Dylan Hastings\dylan-hastings-1,2017-18,Lafayette,F,23,0,176,12,35,.343,6,16,.375,6,19,.316,3,7,.429,9,31,40,3,1,15,9,21,33,1.0
6454,Lucas Stivrins\lucas-stivrins-1,2015-16,Nevada,F,10,1,63,11,24,.458,4,8,.500,7,16,.438,4,7,.571,10,9,19,0,1,2,2,15,33,2.4
6455,Jalen Ragland\jalen-ragland-1,2013-14,Texas-El Paso,F,9,2,140,10,37,.270,4,15,.267,6,22,.273,7,9,.778,2,3,5,6,4,0,6,6,33,1.4
6456,Jordan Jackson\jordan-jackson-2,2015-16,Florida A&M,F,13,1,157,13,33,.394,13,33,.394,0,0,,7,13,.538,12,33,45,4,2,4,12,27,33,1.2
6457,Lorenzo Edwards\lorenzo-edwards-1,2017-18,Saint Joseph's,F,19,1,165,11,42,.262,4,8,.500,7,34,.206,4,8,.500,15,24,39,3,3,10,4,18,33,1.3
6458,Andreas Bigum\andreas-bigum-1,2014-15,Texas-Rio Grande Valley,F,29,2,329,12,40,.300,12,39,.308,0,1,.000,9,22,.409,13,23,36,17,3,6,24,57,33,-0.2
6459,Karolis Kundrotas\karolis-kundrotas-1,2015-16,Elon,F,28,0,153,11,38,.289,5,20,.250,6,18,.333,5,9,.556,11,17,28,1,4,4,14,28,33,0.2
6460,Juwan Grant\juwan-grant-1,2017-18,Savannah State,F,15,0,68,13,26,.500,10,16,.625,3,10,.300,4,6,.667,5,10,15,1,0,1,3,6,33,1.4
6461,Christian Griggs-Williams\christian-griggs-williams-1,2013-14,Cal State Long Beach,F,28,1,194,11,35,.314,11,35,.314,0,0,,11,20,.550,11,32,43,3,1,2,4,16,33,0.7
6462,Marquiez Lawrence\marquiez-lawrence-1,2014-15,Kent State,F,31,5,289,13,27,.481,13,27,.481,0,0,,7,15,.467,24,43,67,6,7,11,21,74,33,0.5
6463,Kaileb Rodriguez\kaileb-rodriguez-1,2014-15,Nevada,F,30,9,422,13,51,.255,13,51,.255,0,0,,7,14,.500,17,56,73,10,2,11,24,64,33,-0.2
6464,Bruno Solomun\bruno-solomun-1,2016-17,Miami (OH),F,13,0,129,13,35,.371,10,17,.588,3,18,.167,4,8,.500,5,17,22,2,1,2,4,16,33,1.1
6465,Herve Aholode\herve-aholode-1,2015-16,Gardner-Webb,F,24,7,199,13,28,.464,13,27,.481,0,1,.000,7,12,.583,17,23,40,5,6,4,5,35,33,1.2
6466,Rodney Hunter\rodney-hunter-1,2017-18,Columbia,F,26,1,214,13,25,.520,13,22,.591,0,3,.000,7,12,.583,14,35,49,17,10,7,17,30,33,1.4
6467,Tanner Omlid\tanner-omlid-1,2014-15,Army,F,5,0,75,15,36,.417,14,26,.538,1,10,.100,2,4,.500,11,18,29,11,11,7,3,18,33,7.9
6468,Travis Rollo\travis-rollo-1,2013-14,Army,F,28,0,284,15,30,.500,15,30,.500,0,0,,3,7,.429,10,17,27,11,5,4,16,49,33,0.3
6469,Satchel Pierce\satchel-pierce-1,2015-16,Virginia Tech,F,20,0,124,12,19,.632,12,19,.632,0,0,,8,10,.800,9,17,26,6,3,4,10,28,32,1.1
6470,Evan Clayborne\evan-clayborne-1,2016-17,Cleveland State,F,24,1,257,15,24,.625,15,24,.625,0,0,,2,12,.167,24,22,46,8,6,9,4,31,32,1.8
6471,Jordan Wells\jordan-wells-1,2014-15,McNeese State,F,18,0,102,14,24,.583,14,24,.583,0,0,,4,9,.444,12,10,22,1,1,2,9,23,32,0.8
6472,Ifeanyi Umezurike\ifeanyi-umezurike-1,2015-16,Saint Francis (PA),F,11,0,85,12,24,.500,12,24,.500,0,0,,8,17,.471,13,16,29,0,0,2,8,28,32,1.1
6473,Eric Carter\eric-carter-1,2014-15,Delaware,F,23,3,218,12,34,.353,12,34,.353,0,0,,8,17,.471,29,28,57,12,4,8,20,42,32,0.8
6474,Anthony Mayo\anthony-mayo-1,2013-14,Stony Brook,F,33,3,303,10,40,.250,10,40,.250,0,0,,12,17,.706,19,34,53,6,4,11,7,48,32,0.6
6475,Josh Linder\josh-linder-1,2017-18,Georgia State,F,24,0,110,13,27,.481,13,26,.500,0,1,.000,6,17,.353,11,11,22,3,2,3,10,25,32,0.5
6476,David Jesperson\david-jesperson-1,2013-14,Pepperdine,F,25,1,232,11,24,.458,8,14,.571,3,10,.300,7,10,.700,15,30,45,6,4,9,8,21,32,1.4
6477,John Edwards\john-edwards-2,2014-15,New Hampshire,F,7,0,78,9,18,.500,8,14,.571,1,4,.250,13,15,.867,0,5,5,4,1,0,5,8,32,2.8
6478,Jakob Hartsock\jakob-hartsock-1,2015-16,Brigham Young,F,24,2,145,11,42,.262,1,6,.167,10,36,.278,0,0,,4,25,29,4,2,3,5,18,32,0.5
6479,Jordan Garnett\jordan-garnett-1,2014-15,Northern Kentucky,F,17,0,108,10,23,.435,10,19,.526,0,4,.000,12,23,.522,13,9,22,3,2,1,8,15,32,1.1
6480,Mitar Stanojevic\mitar-stanojevic-1,2016-17,Texas-San Antonio,F,21,0,132,12,26,.462,11,17,.647,1,9,.111,7,9,.778,11,13,24,1,2,1,11,12,32,0.8
6481,Kosta Jankovic\kosta-jankovic-1,2015-16,Kennesaw State,F,16,1,109,14,29,.483,10,18,.556,4,11,.364,0,2,.000,2,13,15,5,1,1,5,12,32,1.1
6482,Aboubacar Diallo\aboubacar-diallo-1,2017-18,Eastern Illinois,F,31,6,403,12,29,.414,12,29,.414,0,0,,8,11,.727,29,64,93,16,5,47,10,55,32,2.3
6483,Brion Sanchious\brion-sanchious-1,2015-16,Murray State,F,18,5,247,14,26,.538,14,26,.538,0,0,,4,10,.400,24,28,52,7,5,11,12,38,32,1.8
6484,Zac Grossenbacher\zac-grossenbacher-1,2013-14,Wofford,F,17,0,94,11,28,.393,3,7,.429,8,21,.381,2,4,.500,3,9,12,2,1,2,4,12,32,0.9
6485,Luke Worthington\luke-worthington-1,2013-14,Brigham Young,F,31,3,252,12,26,.462,12,26,.462,0,0,,8,20,.400,13,16,29,4,4,2,14,56,32,0.0
6486,Anton Gill\anton-gill-1,2013-14,Louisville,F,24,0,136,11,34,.324,5,9,.556,6,25,.240,4,12,.333,3,13,16,5,4,0,3,16,32,0.6
6487,Uros Ljeskovic\uros-ljeskovic-1,2014-15,Coastal Carolina,F,8,6,91,11,21,.524,11,21,.524,0,0,,10,17,.588,13,13,26,2,3,0,7,6,32,3.4
6488,Charleston Dobbs\charleston-dobbs-1,2015-16,Prairie View,F,31,2,268,11,30,.367,11,30,.367,0,0,,10,17,.588,19,26,45,0,3,6,6,47,32,0.5
6489,Jermaine Ukaegbu\jermaine-ukaegbu-1,2015-16,Sacred Heart,F,21,3,140,14,26,.538,14,25,.560,0,1,.000,4,11,.364,13,20,33,5,5,6,6,23,32,1.4
6490,Jackson Simmons\jackson-simmons-1,2013-14,North Carolina,F,32,1,184,11,20,.550,11,20,.550,0,0,,10,20,.500,13,21,34,9,5,1,4,20,32,1.1
6491,Will Ransom\will-ransom-1,2014-15,Illinois State,F,25,0,232,13,22,.591,13,21,.619,0,1,.000,6,9,.667,19,30,49,4,6,7,14,38,32,1.1
6492,Javon Bess\javon-bess-1,2014-15,Michigan State,F,12,3,148,11,23,.478,10,21,.476,1,2,.500,9,21,.429,15,20,35,12,4,3,9,16,32,2.6
6493,Josh Sharp\josh-sharp-1,2014-15,Brigham Young,F,23,10,238,12,21,.571,10,17,.588,2,4,.500,6,9,.667,26,28,54,16,8,10,6,38,32,2.3
6494,Nelson Nweke\nelson-nweke-1,2016-17,Arkansas State,F,21,6,147,14,26,.538,14,26,.538,0,0,,4,7,.571,13,18,31,1,3,1,12,26,32,0.7
6495,Derail Green\derail-green-1,2013-14,Wichita State,F,28,0,138,10,41,.244,2,13,.154,8,28,.286,4,4,1.000,7,9,16,9,4,1,8,10,32,0.5
6496,Ramel Thompkins\ramel-thompkins-1,2015-16,South Carolina Upstate,F,13,1,118,12,28,.429,8,15,.533,4,13,.308,4,6,.667,3,15,18,7,5,4,4,7,32,2.2
6497,Sedee Keita\sedee-keita-1,2016-17,South Carolina,F,29,0,279,12,44,.273,12,43,.279,0,1,.000,8,18,.444,20,38,58,3,7,11,15,40,32,0.5
6498,Austin Burgett\austin-burgett-1,2015-16,Notre Dame,F,17,4,97,11,19,.579,5,7,.714,6,12,.500,4,6,.667,3,12,15,3,2,4,4,13,32,1.5
6499,Aleksandar Dozic\aleksandar-dozic-1,2015-16,Marshall,F,23,0,199,14,37,.378,10,22,.455,4,15,.267,0,5,.000,5,28,33,12,5,2,7,30,32,0.8
6500,E'Torrion Wilridge\etorrion-wilridge-1,2017-18,Georgia,F,28,12,289,10,35,.286,7,11,.636,3,24,.125,9,16,.563,6,26,32,21,5,6,18,7,32,0.9
6501,Tyrone O'Garro\tyrone-ogarro-1,2016-17,Fairleigh Dickinson,F,15,5,157,11,26,.423,11,24,.458,0,2,.000,10,15,.667,11,23,34,7,5,6,9,27,32,1.7
6502,Pierre Sarr\pierre-sarr-1,2015-16,Monmouth,F,25,1,130,13,27,.481,11,21,.524,2,6,.333,4,12,.333,12,27,39,3,5,2,8,23,32,0.9
6503,Jake Zuilhof\jake-zuilhof-1,2013-14,Grand Canyon,F,20,0,142,11,20,.550,11,20,.550,0,0,,10,17,.588,9,22,31,1,3,5,10,28,32,0.9
6504,Hans Brase\hans-brase-1,2016-17,Princeton,F,5,5,78,11,22,.500,6,12,.500,5,10,.500,5,5,1.000,3,11,14,7,0,0,6,10,32,4.3
6505,Jakub Petras\jakub-petras-1,2014-15,Stony Brook,F,28,1,195,14,32,.438,14,32,.438,0,0,,4,8,.500,20,22,42,4,3,4,10,29,32,0.8
6506,Alex Ennis\alex-ennis-1,2017-18,Morgan State,F,25,5,241,11,31,.355,11,31,.355,0,0,,10,15,.667,20,29,49,3,4,2,10,29,32,0.9
6507,Jordan Hardwick\jordan-hardwick-1,2017-18,Coppin State,F,15,2,158,14,34,.412,13,26,.500,1,8,.125,3,6,.500,14,17,31,0,1,13,12,23,32,1.1
6508,Austin Karazsia\austin-karazsia-1,2013-14,South Alabama,F,22,0,139,11,28,.393,8,14,.571,3,14,.214,7,11,.636,9,16,25,1,1,2,5,22,32,0.7
6509,Darien Williams\darien-williams-1,2017-18,Nevada,F,15,2,98,11,27,.407,10,20,.500,1,7,.143,9,12,.750,4,22,26,2,3,2,10,17,32,1.0
6510,Kyle Reid\kyle-reid-1,2014-15,Eastern Washington,F,31,1,198,14,28,.500,14,27,.519,0,1,.000,4,9,.444,10,27,37,5,6,8,11,29,32,0.8
6511,Jack Hobbs\jack-hobbs-1,2014-15,Hartford,F,14,0,158,12,33,.364,4,6,.667,8,27,.296,0,4,.000,5,21,26,4,4,3,3,14,32,1.6
6512,Sean Goodwin\sean-goodwin-1,2014-15,Sam Houston State,F,17,0,87,10,15,.667,10,15,.667,0,0,,12,18,.667,11,12,23,9,3,0,3,12,32,2.1
6513,Corbin Byford\corbin-byford-1,2013-14,Oral Roberts,F,18,2,106,10,22,.455,7,11,.636,3,11,.273,8,11,.727,4,21,25,3,3,6,8,23,31,1.1
6514,Ryan Manning\ryan-manning-1,2015-16,Air Force,F,5,3,104,10,33,.303,8,19,.421,2,14,.143,9,9,1.000,7,5,12,6,1,4,3,8,31,4.0
6515,Danny Dixon\danny-dixon-1,2015-16,George Mason,F,25,0,187,9,23,.391,9,23,.391,0,0,,13,20,.650,12,19,31,7,0,5,9,26,31,0.8
6516,Leron Black\leron-black-1,2015-16,Illinois,F,7,3,100,15,36,.417,15,36,.417,0,0,,1,2,.500,10,21,31,4,2,2,5,23,31,2.4
6517,Otas Iyekekpolor\otas-iyekekpolor-2,2017-18,Central Arkansas,F,23,0,137,12,25,.480,12,25,.480,0,0,,7,10,.700,15,13,28,2,3,6,11,26,31,0.8
6518,Ramel Thompkins\ramel-thompkins-1,2014-15,South Carolina Upstate,F,16,0,138,12,34,.353,8,10,.800,4,24,.167,3,11,.273,10,26,36,10,1,3,1,8,31,1.8
6519,Brendan Casper\brendan-casper-1,2014-15,Saint Joseph's,F,23,0,108,13,34,.382,12,25,.480,1,9,.111,4,11,.364,12,21,33,5,6,2,11,22,31,0.7
6520,Ray Kasongo\ray-kasongo-1,2015-16,Tennessee,F,22,0,121,12,23,.522,12,23,.522,0,0,,7,11,.636,13,19,32,1,1,7,6,26,31,1.1
6521,Wesley Johnson\wesley-johnson-1,2014-15,Charleston Southern,F,24,0,158,11,23,.478,11,23,.478,0,0,,9,26,.346,15,12,27,2,4,6,5,26,31,0.9
6522,Kaileb Rodriguez\kaileb-rodriguez-1,2015-16,Nevada,F,31,3,164,11,19,.579,11,19,.579,0,0,,9,17,.529,17,26,43,3,2,6,11,44,31,0.6
6523,Jesse Lopez\jesse-lopez-1,2014-15,Sam Houston State,F,19,0,104,14,34,.412,13,29,.448,1,5,.200,2,3,.667,8,15,23,5,3,1,6,15,31,0.9
6524,Garrett Moon\garrett-moon-1,2013-14,Eastern Washington,F,26,0,185,13,32,.406,12,28,.429,1,4,.250,4,9,.444,20,20,40,3,5,6,9,50,31,0.5
6525,Daniel Meyer\daniel-meyer-2,2014-15,Omaha,F,21,0,97,12,27,.444,12,27,.444,0,0,,7,11,.636,9,22,31,1,1,4,2,5,31,1.4
6526,William Tchiengang\william-tchiengang-1,2016-17,Southeast Missouri State,F,18,10,212,12,16,.750,12,16,.750,0,0,,7,12,.583,13,33,46,0,1,5,15,40,31,0.8
6527,Devenir Duruisseau\devenir-duruisseau-1,2015-16,Washington,F,16,0,134,10,24,.417,10,20,.500,0,4,.000,11,22,.500,14,17,31,0,2,4,9,29,31,0.8
6528,Charlendez Brooks\charlendez-brooks-1,2016-17,Western Carolina,F,18,3,194,10,26,.385,10,26,.385,0,0,,11,13,.846,13,27,40,8,4,8,19,48,31,0.6
6529,Christian Beyer\christian-beyer-1,2013-14,Virginia Tech,F,28,1,269,13,25,.520,11,18,.611,2,7,.286,3,9,.333,19,44,63,10,5,1,14,24,31,1.1
6530,Dylan Karell\dylan-karell-1,2014-15,Central Florida,F,29,5,283,12,25,.480,12,25,.480,0,0,,7,20,.350,16,29,45,10,8,9,15,38,31,0.8
6531,Jon Ander Cuadra\jonander-cuadra-1,2017-18,Campbell,F,5,0,34,12,14,.857,9,11,.818,3,3,1.000,4,7,.571,1,4,5,1,1,2,2,5,31,5.2
6532,Shack Scott\shack-scott-1,2016-17,Wagner,F,18,1,147,12,34,.353,11,32,.344,1,2,.500,6,13,.462,13,17,30,2,3,5,7,34,31,0.6
6533,Niklas Ney\niklas-ney-1,2014-15,Mercer,F,22,0,107,9,20,.450,9,20,.450,0,0,,13,17,.765,10,9,19,1,0,1,5,15,31,0.9
6534,DeJuan Marrero\dejuan-marrero-1,2013-14,DePaul,F,25,3,171,12,30,.400,12,30,.400,0,0,,7,17,.412,27,29,56,4,4,6,9,23,31,1.2
6535,Kraig Shields\kraig-shields-1,2014-15,North Dakota,F,17,0,139,12,22,.545,12,22,.545,0,0,,7,10,.700,6,24,30,2,2,9,5,21,31,1.6
6536,Otas Iyekekpolor\otas-iyekekpolor-2,2016-17,Central Arkansas,F,24,1,162,10,25,.400,10,25,.400,0,0,,11,18,.611,8,21,29,3,2,2,3,31,31,0.7
6537,Chris Blake\chris-blake-2,2013-14,Bradley,F,32,8,303,10,24,.417,10,24,.417,0,0,,11,23,.478,22,55,77,3,6,14,14,33,31,1.1
6538,Joshua Phillips\joshua-phillips-1,2015-16,Middle Tennessee,F,27,1,144,12,24,.500,12,23,.522,0,1,.000,7,16,.438,12,31,43,0,4,3,16,31,31,0.4
6539,Matz Stockman\matz-stockman-1,2016-17,Louisville,F,18,0,74,11,17,.647,11,17,.647,0,0,,9,15,.600,12,9,21,3,2,3,7,16,31,1.4
6540,T.J. Shipes\tj-shipes-1,2013-14,Georgia State,F,29,1,240,11,16,.688,11,16,.688,0,0,,9,17,.529,35,20,55,2,4,8,13,57,31,0.9
6541,Andre Frederick\andre-frederick-1,2014-15,Robert Morris,F,24,0,179,14,26,.538,14,26,.538,0,0,,3,5,.600,12,19,31,2,5,14,8,20,31,1.3
6542,Dan Dwyer\dan-dwyer-1,2015-16,Pennsylvania,F,23,4,253,15,37,.405,15,34,.441,0,3,.000,1,1,1.000,17,33,50,9,2,14,16,31,31,1.0
6543,Josh Smith\josh-smith-2,2015-16,Clemson,F,26,0,191,12,34,.353,9,23,.391,3,11,.273,4,5,.800,17,29,46,2,4,2,10,22,31,0.8
6544,James Johnson\james-johnson-5,2013-14,San Diego State,F,17,0,155,11,19,.579,11,19,.579,0,0,,9,14,.643,7,18,25,2,5,5,5,37,31,1.2
6545,Brett Boese\brett-boese-1,2013-14,Washington State,F,20,1,83,11,28,.393,2,5,.400,9,23,.391,0,0,,3,4,7,2,1,0,4,10,31,0.7
6546,Sai Tummala\sai-tummala-1,2013-14,Arizona State,F,15,0,80,11,28,.393,5,7,.714,6,21,.286,3,5,.600,6,5,11,3,2,0,2,14,31,1.1
6547,Samson Oyediran\samson-oyediran-1,2015-16,Tennessee State,F,23,1,163,12,25,.480,8,12,.667,4,13,.308,3,8,.375,12,15,27,1,2,0,15,39,31,0.1
6548,Jeremy Peck\jeremy-peck-1,2016-17,Drexel,F,19,0,123,11,22,.500,9,17,.529,2,5,.400,7,9,.778,9,21,30,0,2,1,3,9,31,1.5
6549,LaRond Williams\larond-williams-1,2016-17,Cal State Long Beach,F,25,1,183,9,31,.290,9,31,.290,0,0,,13,20,.650,14,26,40,3,5,15,16,53,31,0.3
6550,Jeremiah Worthem\jeremiah-worthem-1,2015-16,North Carolina Central,F,10,0,92,9,20,.450,9,20,.450,0,0,,13,18,.722,9,17,26,3,3,0,6,9,31,2.6
6551,Luke Rosinski\luke-rosinski-1,2016-17,New Hampshire,F,23,2,190,13,32,.406,13,32,.406,0,0,,5,12,.417,18,31,49,4,2,5,17,25,31,0.6
6552,Anthony Silvestri\anthony-silvestri-1,2014-15,Cal Poly,F,24,1,226,9,59,.153,3,10,.300,6,49,.122,6,8,.750,10,22,32,2,2,0,5,23,30,-0.2
6553,Aaron Moesch\aaron-moesch-1,2017-18,Wisconsin,F,26,0,157,7,9,.778,5,7,.714,2,2,1.000,14,15,.933,3,11,14,7,3,0,6,14,30,1.1
6554,Michael Porter Jr.\michael-porterjr-1,2017-18,Missouri,F,3,1,53,10,30,.333,7,20,.350,3,10,.300,7,9,.778,4,16,20,1,3,1,3,6,30,6.3
6555,A.J. Patty\aj-patty-1,2015-16,Murray State,F,18,0,93,10,29,.345,10,24,.417,0,5,.000,10,12,.833,8,15,23,0,3,3,4,16,30,1.0
6556,Kerem Kanter\kerem-kanter-1,2014-15,Green Bay,F,19,0,82,13,24,.542,11,17,.647,2,7,.286,2,5,.400,6,12,18,3,2,2,5,10,30,1.1
6557,Zachary Hollis\zachary-hollis-1,2014-15,Lamar,F,21,1,209,10,34,.294,10,34,.294,0,0,,10,16,.625,17,34,51,6,2,4,11,33,30,0.7
6558,Rasi Jenkins\rasi-jenkins-1,2013-14,Prairie View,F,29,2,322,9,24,.375,9,24,.375,0,0,,12,20,.600,13,40,53,9,10,9,12,41,30,1.0
6559,Greg McClinton\greg-mcclinton-1,2016-17,Wake Forest,F,26,1,184,14,27,.519,13,26,.500,1,1,1.000,1,5,.200,20,13,33,1,4,1,10,34,30,0.6
6560,Scott Plaisance\scott-plaisance-1,2016-17,Louisiana,F,11,2,77,13,23,.565,13,22,.591,0,1,.000,4,8,.500,10,18,28,1,2,3,5,18,30,2.0
6561,Elijah Thomas\elijah-thomas-1,2015-16,Texas A&M,F,8,0,79,12,19,.632,12,19,.632,0,0,,6,18,.333,5,15,20,6,0,8,9,23,30,2.0
6562,Jordon Granger\jordon-granger-1,2013-14,Auburn,F,24,1,241,12,28,.429,12,27,.444,0,1,.000,6,9,.667,16,27,43,4,2,4,13,34,30,0.6
6563,Xavier Dupree\xavier-dupree-1,2015-16,Houston,F,21,0,164,11,31,.355,3,11,.273,8,20,.400,0,0,,10,26,36,9,5,4,11,21,30,1.1
6564,Scott Plaisance\scott-plaisance-1,2015-16,Louisiana,F,18,0,56,9,17,.529,9,16,.563,0,1,.000,12,19,.632,9,8,17,1,2,5,2,13,30,1.5
6565,Grant Dressler\grant-dressler-1,2015-16,Sacramento State,F,19,0,110,8,36,.222,1,12,.083,7,24,.292,7,8,.875,4,12,16,7,2,0,6,6,30,0.7
6566,Tony Lewis\tony-lewis-3,2016-17,Santa Clara,F,16,1,100,14,31,.452,14,30,.467,0,1,.000,2,5,.400,8,14,22,0,2,4,12,26,30,0.3
6567,Cam Biedscheid\cameron-biedscheid-1,2015-16,Jacksonville State,F,5,1,79,12,33,.364,7,15,.467,5,18,.278,1,1,1.000,2,6,8,5,3,1,6,8,30,2.6
6568,Karl Gamble\karl-gamble-1,2015-16,Middle Tennessee,F,32,0,136,10,30,.333,10,30,.333,0,0,,10,23,.435,13,21,34,0,1,5,8,28,30,0.3
6569,Gyorgy Goloman\gyorgy-goloman-1,2015-16,UCLA,F,15,0,181,11,33,.333,9,24,.375,2,9,.222,6,16,.375,18,23,41,4,5,6,10,34,30,1.0
6570,Patrick Agho\patrick-agho-2,2013-14,Prairie View,F,21,0,114,13,20,.650,13,20,.650,0,0,,4,10,.400,5,19,24,1,0,4,8,21,30,0.7
6571,James Gordon IV\james-gordoniv-1,2017-18,Toledo,F,11,0,62,12,25,.480,10,21,.476,2,4,.500,4,7,.571,6,7,13,3,1,0,6,6,30,1.6
6572,Tyler Creammer\tyler-creammer-1,2016-17,Virginia Military Institute,F,26,2,171,13,36,.361,13,36,.361,0,0,,4,7,.571,10,24,34,2,3,2,11,27,30,0.3
6573,Kentrall Brooks\kentrall-brooks-1,2013-14,Marist,F,30,2,208,11,28,.393,11,28,.393,0,0,,8,15,.533,14,24,38,4,2,13,13,44,30,0.4
6574,Robin Thompson\robin-thompson-1,2015-16,Missouri State,F,19,1,126,12,25,.480,12,24,.500,0,1,.000,6,13,.462,12,11,23,3,9,6,7,28,30,1.2
6575,Jason Cudd\jason-cudd-1,2017-18,South Carolina,F,23,0,156,9,23,.391,9,23,.391,0,0,,12,17,.706,9,13,22,3,0,3,5,19,30,0.8
6576,Mike Sagay\mike-sagay-1,2016-17,Boston College,F,15,0,67,11,29,.379,7,22,.318,4,7,.571,4,10,.400,3,11,14,0,2,1,7,6,30,0.7
6577,Nate Austin\nate-austin-1,2014-15,Brigham Young,F,10,10,197,9,18,.500,8,13,.615,1,5,.200,11,14,.786,15,41,56,9,7,2,3,22,30,4.6
6578,Chris Egi\chris-egi-1,2016-17,Harvard,F,15,7,132,8,17,.471,8,17,.471,0,0,,14,28,.500,14,14,28,3,7,6,10,18,30,1.7
6579,Darrious Hamilton\darrious-hamilton-2,2014-15,Utah Valley,F,25,2,174,10,39,.256,10,39,.256,0,0,,9,13,.692,7,19,26,5,0,4,13,21,29,0.0
6580,Jesse Lopez\jesse-lopez-1,2015-16,Sam Houston State,F,21,0,98,9,17,.529,7,13,.538,2,4,.500,9,12,.750,12,12,24,2,2,3,2,12,29,1.4
6581,Fletcher Larson\fletcher-larson-1,2013-14,Youngstown State,F,20,0,237,14,24,.583,14,24,.583,0,0,,1,1,1.000,7,23,30,5,2,10,15,40,29,0.6
6582,Edward Alade\edward-alade-1,2013-14,Navy,F,23,0,144,13,29,.448,13,29,.448,0,0,,3,6,.500,18,16,34,1,3,9,12,18,29,0.9
6583,Kendell Ramlal\kendall-ramlal-1,2013-14,Texas State,F,19,0,146,12,22,.545,12,22,.545,0,0,,5,8,.625,15,14,29,6,1,7,8,11,29,1.6
6584,Boston Gubler\boston-gubler-1,2014-15,Utah Valley,F,27,14,252,11,37,.297,11,37,.297,0,0,,7,13,.538,15,32,47,11,3,6,19,29,29,0.4
6585,Jace Hogan\jace-hogan-1,2014-15,Navy,F,8,0,94,11,34,.324,11,32,.344,0,2,.000,7,9,.778,8,10,18,5,4,1,7,5,29,2.1
6586,Kendell Ramlal\kendall-ramlal-1,2015-16,Texas State,F,25,1,212,12,31,.387,12,31,.387,0,0,,5,12,.417,20,21,41,6,6,15,16,31,29,0.9
6587,Raymond Doby\raymond-doby-1,2015-16,South Carolina,F,16,0,108,10,27,.370,10,26,.385,0,1,.000,9,15,.600,11,9,20,4,4,2,6,10,29,1.3
6588,Josh Collins\josh-collins-1,2015-16,North Dakota,F,22,0,141,11,33,.333,10,26,.385,1,7,.143,6,15,.400,6,15,21,3,4,1,5,14,29,0.5
6589,Austin Colbert\austin-colbert-1,2013-14,Illinois,F,22,0,121,13,26,.500,13,23,.565,0,3,.000,3,10,.300,9,8,17,4,0,2,3,19,29,0.7
6590,Jalen Robinson\jalen-robinson--1,2014-15,Dayton,F,9,0,138,11,38,.289,10,30,.333,1,8,.125,6,12,.500,11,11,22,7,6,2,6,10,29,2.0
6591,Jaylen Johnson\jaylen-johnson-1,2014-15,Louisville,F,23,0,106,13,27,.481,12,26,.462,1,1,1.000,2,5,.400,13,16,29,2,4,3,6,20,29,0.9
6592,Terry Winn\terry-winn-1,2016-17,Texas-El Paso,F,3,2,68,13,25,.520,13,25,.520,0,0,,3,3,1.000,3,14,17,2,0,1,6,10,29,5.0
6593,Isaac Banks\isaac-banks-1,2013-14,East Tennessee State,F,23,0,130,11,19,.579,11,18,.611,0,1,.000,7,10,.700,11,17,28,6,2,5,7,6,29,1.4
6594,Makinde London\makinde-london-1,2015-16,Xavier,F,18,0,95,9,25,.360,2,7,.286,7,18,.389,4,8,.500,8,15,23,7,5,5,9,13,29,1.3
6595,Tarique Thompson\tarique-thompson-1,2013-14,High Point,F,17,0,146,14,31,.452,14,29,.483,0,2,.000,1,4,.250,14,21,35,5,3,1,8,12,29,1.3
6596,Chris Carter\chris-carter-7,2013-14,Long Island University,F,7,0,54,11,21,.524,9,16,.563,2,5,.400,5,7,.714,3,7,10,0,0,0,4,8,29,2.1
6597,Logan Stumpf\logan-stumpf-1,2013-14,Gardner-Webb,F,13,0,66,10,20,.500,6,6,1.000,4,14,.286,5,6,.833,3,12,15,2,2,1,4,8,29,1.6
6598,Reggie Cameron\reggie-cameron-1,2016-17,Georgetown,F,17,0,138,9,23,.391,3,5,.600,6,18,.333,5,10,.500,2,14,16,7,3,1,8,6,29,1.1
6599,Dionte Adams\dionte-adams-1,2014-15,Hampton,F,21,0,183,10,28,.357,10,28,.357,0,0,,9,11,.818,18,25,43,6,8,9,11,26,29,1.4
6600,Conroy Baltimore\conroy-baltimore-1,2013-14,Lehigh,F,9,0,106,12,23,.522,12,23,.522,0,0,,5,8,.625,11,19,30,3,0,2,4,22,29,2.3
6601,Geno Artison\geno-artison-1,2016-17,Tulsa,F,17,1,109,10,34,.294,1,6,.167,9,28,.321,0,2,.000,2,16,18,5,3,3,6,13,29,0.7
6602,Cameron Gunter\cameron-gunter-1,2013-14,Pennsylvania,F,27,1,179,10,24,.417,10,24,.417,0,0,,9,18,.500,12,22,34,3,3,9,14,32,29,0.5
6603,Nigel Snipes\nigel-snipes-1,2013-14,Western Kentucky,F,14,0,102,10,30,.333,5,15,.333,5,15,.333,4,4,1.000,2,13,15,2,1,0,9,14,29,0.4
6604,Duol Mayot\duol-mayot-1,2014-15,South Dakota,F,26,0,138,10,24,.417,10,24,.417,0,0,,9,18,.500,10,17,27,2,2,1,6,16,29,0.6
6605,Hassan Hussein\hassan-hussein-1,2014-15,Florida International,F,12,1,83,12,17,.706,12,17,.706,0,0,,5,6,.833,5,6,11,0,0,2,3,10,29,1.8
6606,Erik Stenger\erik-stenger-1,2013-14,Xavier,F,24,8,165,11,19,.579,11,19,.579,0,0,,7,21,.333,9,21,30,2,5,6,6,21,29,1.0
6607,Kellen Manek\kellen-manek-1,2017-18,Oral Roberts,F,12,0,48,6,16,.375,2,6,.333,4,10,.400,13,18,.722,5,8,13,3,1,1,3,4,29,1.9
6608,Jarmal Reid\jarmal-reid-1,2013-14,Oregon State,F,26,2,216,12,24,.500,12,24,.500,0,0,,5,13,.385,2,17,19,11,10,8,20,33,29,0.4
6609,Jeffrey Uju\jeffrey-uju-1,2017-18,Bowling Green State,F,30,2,218,12,34,.353,12,32,.375,0,2,.000,5,11,.455,27,39,66,6,3,7,15,35,29,0.7
6610,Trey Mourning\trey-mourning-1,2015-16,Georgetown,F,20,0,124,12,23,.522,11,17,.647,1,6,.167,4,7,.571,7,13,20,6,4,5,9,29,29,0.8
6611,Uche Ofoegbu\uche-ofoegbu-1,2014-15,San Francisco,F,14,0,88,9,20,.450,8,16,.500,1,4,.250,10,20,.500,6,13,19,4,3,1,5,14,29,1.3
6612,Sherron Wilson\sherron-wilson-1,2016-17,Jackson State,F,20,2,212,11,46,.239,6,25,.240,5,21,.238,2,4,.500,13,19,32,9,4,1,8,28,29,0.4
6613,Brett Jolly\brett-jolly-1,2015-16,Saint Louis,F,18,1,157,10,26,.385,10,24,.417,0,2,.000,9,15,.600,6,18,24,4,4,6,12,35,29,0.4
6614,Oskar Michelsen\oskar-michelson-1,2016-17,Davidson,F,22,0,141,11,39,.282,7,11,.636,4,28,.143,3,8,.375,6,18,24,8,4,4,6,17,29,0.6
6615,Sean Obi\sean-obi-1,2017-18,Maryland,F,21,0,126,11,19,.579,11,19,.579,0,0,,7,12,.583,14,26,40,2,2,2,7,24,29,1.1
6616,Jameel Alausa\jameel-alausa-1,2017-18,Yale,F,15,0,75,8,24,.333,7,19,.368,1,5,.200,12,17,.706,9,8,17,3,1,3,7,16,29,0.9
6617,Christian Oshita\christian-oshita-1,2015-16,San Diego,F,18,0,152,10,34,.294,5,15,.333,5,19,.263,4,9,.444,9,20,29,4,2,0,12,17,29,0.3
6618,Carson Smith\carson-smith-1,2016-17,South Carolina Upstate,F,16,3,122,11,23,.478,10,19,.526,1,4,.250,6,8,.750,7,17,24,9,5,3,9,14,29,1.6
6619,A.J. John\aj-john-1,2014-15,Pepperdine,F,24,5,251,12,34,.353,12,33,.364,0,1,.000,4,9,.444,15,40,55,1,3,9,13,44,28,0.4
6620,David Chadwick\david-chadwick-1,2014-15,Valparaiso,F,12,2,105,11,24,.458,8,14,.571,3,10,.300,3,10,.300,4,11,15,2,0,4,5,8,28,1.2
6621,Reggie Agbeko\reggie-agbeko-1,2013-14,Saint Louis,F,17,2,94,13,17,.765,13,17,.765,0,0,,2,7,.286,6,18,24,2,1,1,6,9,28,1.3
6622,Raasean Davis\raasean-davis-1,2014-15,Kent State,F,21,1,92,12,21,.571,12,21,.571,0,0,,4,6,.667,8,11,19,1,2,0,4,18,28,0.8
6623,Julian Harris\julian-harris-2,2014-15,Texas-Arlington,F,18,0,130,11,32,.344,5,19,.263,6,13,.462,0,2,.000,8,13,21,5,1,1,9,14,28,0.5
6624,LaTre'e Russell\latree-russell-1,2013-14,Norfolk State,F,11,0,71,9,17,.529,9,16,.563,0,1,.000,10,16,.625,8,6,14,3,0,2,6,16,28,1.4
6625,Kierell Green\kierell-green-1,2017-18,Niagara,F,21,1,101,10,25,.400,6,8,.750,4,17,.235,4,6,.667,9,18,27,4,3,11,7,23,28,1.1
6626,Jerred Kite\jerred-kite-1,2014-15,Incarnate Word,F,21,1,159,13,21,.619,13,21,.619,0,0,,2,6,.333,13,21,34,7,8,5,4,21,28,1.7
6627,DouDou Gueye\doudou-gueye-1,2015-16,South Carolina State,F,34,19,291,13,25,.520,13,25,.520,0,0,,2,8,.250,18,37,55,6,4,9,15,49,28,0.5
6628,Semi Ojeleye\semi-ojeleye-1,2013-14,Duke,F,17,0,80,7,14,.500,3,7,.429,4,7,.571,10,11,.909,7,8,15,2,4,4,5,6,28,1.7
6629,Sterling Christy\sterling-christy-1,2015-16,Radford,F,9,3,126,10,25,.400,10,21,.476,0,4,.000,8,17,.471,7,16,23,5,3,3,6,18,28,1.8
6630,Sam Ibiezugbe\sam-ibiezugbe-1,2017-18,Monmouth,F,20,0,123,14,24,.583,14,24,.583,0,0,,0,5,.000,6,13,19,1,4,3,7,22,28,0.7
6631,Roger Moute a Bidias\roger-moute-a-bidias-1,2015-16,University of California,F,23,0,187,7,25,.280,2,14,.143,5,11,.455,9,12,.750,4,18,22,6,1,2,5,36,28,0.3
6632,Roderick Taylor\roderick-taylor-2,2017-18,Louisiana-Monroe,F,20,3,195,12,24,.500,12,24,.500,0,0,,4,7,.571,7,22,29,4,4,3,13,41,28,0.3
6633,Daivon Gamble\daivon-gamble-1,2017-18,Delaware State,F,10,0,100,9,21,.429,8,19,.421,1,2,.500,9,11,.818,6,10,16,1,4,4,4,13,28,2.2
6634,Kyle Thomas\kyle-thomas-3,2013-14,Morgan State,F,21,0,94,8,29,.276,1,9,.111,7,20,.350,5,8,.625,2,9,11,7,3,2,6,15,28,0.5
6635,Cameron Jackson\cameron-jackson-1,2015-16,Wofford,F,7,1,100,11,22,.500,11,21,.524,0,1,.000,6,9,.667,11,16,27,2,8,2,5,23,28,3.6
6636,Damien Wilson\damien-wilson-1,2013-14,Memphis,F,15,0,106,11,25,.440,10,18,.556,1,7,.143,5,11,.455,5,10,15,6,5,0,8,12,28,1.0
6637,Daniel Bridges\daniel-bridges-1,2014-15,South Carolina Upstate,F,9,1,80,11,33,.333,6,14,.429,5,19,.263,1,2,.500,6,13,19,6,1,0,7,3,28,1.6
6638,Pete Kpan\pete-kpan-1,2013-14,McNeese State,F,18,1,115,10,13,.769,10,12,.833,0,1,.000,8,11,.727,13,16,29,5,0,2,3,14,28,1.8
6639,John Odo\john-odo-1,2013-14,Louisiana State,F,28,0,145,11,18,.611,11,18,.611,0,0,,6,11,.545,12,26,38,0,4,7,8,25,28,0.9
6640,Devin Haygood\devin-haygood-1,2015-16,Youngstown State,F,17,2,104,9,21,.429,9,21,.429,0,0,,10,18,.556,9,13,22,1,4,8,6,26,28,1.0
6641,Bret Barclay\bret-barclay-1,2014-15,Southeastern Louisiana,F,29,0,148,11,27,.407,10,24,.417,1,3,.333,5,6,.833,11,14,25,3,2,2,8,21,28,0.5
6642,Sam Green\sam-green-1,2017-18,Drexel,F,6,1,81,11,20,.550,7,10,.700,4,10,.400,2,6,.333,3,12,15,5,1,0,3,16,28,2.9
6643,Stefon Fisher\stefon-fisher-1,2017-18,Stephen F. Austin,F,11,0,61,11,19,.579,11,19,.579,0,0,,6,10,.600,6,7,13,4,1,2,7,14,28,1.5
6644,Alex Olesinski\alex-olesinski-1,2015-16,UCLA,F,23,0,161,7,26,.269,6,19,.316,1,7,.143,13,20,.650,21,25,46,4,5,0,10,34,28,0.7
6645,Javier Lacunza\javier-lacunza-1,2015-16,Florida Atlantic,F,19,0,139,10,25,.400,3,10,.300,7,15,.467,1,1,1.000,10,15,25,1,1,0,7,29,28,0.5
6646,Izais Hicks\izais-hicks-1,2015-16,Coppin State,F,18,1,151,10,23,.435,10,19,.526,0,4,.000,8,15,.533,12,16,28,6,4,2,7,28,28,1.0
6647,Keith Gray\keith-gray-2,2014-15,Northern Illinois,F,27,1,205,8,20,.400,8,20,.400,0,0,,12,19,.632,19,22,41,1,5,2,13,41,28,0.4
6648,Lionel Gomis\lionel-gomis-1,2014-15,Robert Morris,F,27,1,259,10,33,.303,10,33,.303,0,0,,8,17,.471,15,27,42,5,4,2,12,58,28,-0.1
6649,Tyler Ott\tyler-ott-1,2015-16,Utah Valley,F,13,0,66,9,26,.346,3,7,.429,6,19,.316,4,7,.571,0,9,9,1,2,0,5,14,28,0.5
6650,Janari Joesaar\janari-joesaar-1,2013-14,Mississippi,F,12,0,52,9,19,.474,7,11,.636,2,8,.250,8,10,.800,9,9,18,1,4,0,3,10,28,2.0
6651,Spencer Eliason\spencer-eliason-1,2016-17,North Dakota State,F,19,1,124,11,25,.440,11,25,.440,0,0,,6,13,.462,10,14,24,5,2,1,7,17,28,0.8
6652,Tyrell Williams\tyrell-williams-1,2016-17,Iona,F,26,0,157,10,21,.476,10,21,.476,0,0,,8,10,.800,16,28,44,2,2,10,9,43,28,0.8
6653,Jason Owens\jason-owens-1,2014-15,Delaware State,F,16,0,112,12,28,.429,12,27,.444,0,1,.000,4,7,.571,6,16,22,2,1,1,7,17,28,0.6
6654,Dexter Werner\dexter-werner-1,2013-14,North Dakota State,F,10,0,43,9,15,.600,9,15,.600,0,0,,10,20,.500,9,9,18,2,2,1,1,6,28,2.7
6655,Julius Palmer\julius-palmer-1,2017-18,Oakland,F,26,4,183,8,21,.381,8,21,.381,0,0,,12,17,.706,15,28,43,3,2,18,9,31,28,1.1
6656,Zach Cottrell\zach-cottrell-1,2017-18,Appalachian State,F,23,6,188,9,28,.321,3,6,.500,6,22,.273,3,6,.500,7,27,34,9,5,0,5,20,27,0.9
6657,Jaraan Lands\jaraan-lands-1,2016-17,Albany (NY),F,5,0,85,8,21,.381,8,21,.381,0,0,,11,21,.524,7,12,19,2,3,0,9,6,27,2.6
6658,Paris Maragkos\paris-maragkos-1,2013-14,George Washington,F,30,0,96,12,29,.414,12,23,.522,0,6,.000,3,6,.500,6,9,15,0,1,0,9,22,27,0.0
6659,Gaston Diedhiou\gaston-diedhiou-1,2017-18,Minnesota,F,16,0,153,12,27,.444,12,27,.444,0,0,,3,7,.429,5,15,20,4,4,5,2,20,27,1.2
6660,Reggie Cameron\reggie-cameron-1,2014-15,Georgetown,F,23,0,105,8,29,.276,3,5,.600,5,24,.208,6,7,.857,1,6,7,5,1,2,6,7,27,0.4
6661,Tim Dixon\tim-dixon-1,2013-14,Georgia,F,33,0,259,11,34,.324,11,34,.324,0,0,,5,8,.625,14,30,44,7,5,4,12,17,27,0.6
6662,Payton Dastrup\payton-dastrup-1,2016-17,Brigham Young,F,23,0,103,12,32,.375,9,17,.529,3,15,.200,0,0,,7,24,31,5,2,5,7,14,27,0.8
6663,Jordan Abdur-Ra'oof\jordan-abdur-raoof-1,2017-18,Cornell,F,13,1,72,10,20,.500,7,10,.700,3,10,.300,4,10,.400,0,6,6,4,2,1,5,10,27,1.0
6664,Dylan Haines\dylan-haines-1,2016-17,Boston University,F,19,1,126,12,37,.324,12,29,.414,0,8,.000,3,7,.429,12,18,30,5,0,5,6,20,27,0.6
6665,Stefan Rosic\stefan-rosic-1,2016-17,Youngstown State,F,16,3,90,10,29,.345,7,14,.500,3,15,.200,4,6,.667,1,8,9,3,1,2,5,9,27,0.6
6666,Charles Brown\charles-brown-2,2015-16,Murray State,F,16,2,127,9,18,.500,9,18,.500,0,0,,9,13,.692,9,18,27,4,1,2,5,29,27,1.0
6667,Ruben Fuamba\ruben-fuamba-1,2017-18,Northern Arizona,F,19,2,215,11,23,.478,11,23,.478,0,0,,5,9,.556,21,39,60,2,2,11,14,42,27,1.1
6668,Christian Thieneman\christian-thieneman-1,2016-17,Marshall,F,19,1,160,9,24,.375,5,8,.625,4,16,.250,5,8,.625,6,29,35,3,1,0,5,16,27,0.9
6669,Kevin Gray\kevin-gray-2,2013-14,Northern Illinois,F,22,2,237,8,34,.235,8,34,.235,0,0,,11,17,.647,16,25,41,4,10,2,14,37,27,0.4
6670,Charles Buggs\charles-buggs-1,2013-14,Minnesota,F,16,0,107,11,16,.688,6,9,.667,5,7,.714,0,0,,5,13,18,4,2,3,5,15,27,1.5
6671,Ron Giplaye\ron-giplaye-1,2014-15,East Tennessee State,F,6,1,110,12,25,.480,12,25,.480,0,0,,3,17,.176,20,22,42,4,4,6,6,14,27,4.8
6672,Erik Nissen\erik-nissen-1,2013-14,Maine,F,9,2,66,9,16,.563,8,14,.571,1,2,.500,8,9,.889,4,12,16,1,1,5,3,14,27,2.4
6673,Joshua Phillips\joshua-phillips-1,2014-15,Middle Tennessee,F,17,1,151,8,27,.296,8,27,.296,0,0,,11,18,.611,12,17,29,5,3,5,10,19,27,0.8
6674,Tracy Hector\tracy-hector-1,2015-16,Kennesaw State,F,18,1,302,10,27,.370,10,25,.400,0,2,.000,7,16,.438,11,23,34,21,11,1,20,27,27,1.0
6675,Jack McVeigh\jack-mcveigh-1,2017-18,Nebraska,F,14,0,105,10,29,.345,4,11,.364,6,18,.333,1,1,1.000,4,11,15,2,5,2,5,11,27,1.1
6676,Deitrich Cole\dietrich-cole-1,2014-15,Jacksonville State,F,20,1,196,11,29,.379,11,28,.393,0,1,.000,5,11,.455,11,17,28,6,2,12,11,42,27,0.4
6677,Jermaine Samuels\jermaine-samuels-1,2017-18,Villanova,F,25,0,153,7,28,.250,4,12,.333,3,16,.188,10,16,.625,7,23,30,7,1,3,12,23,27,0.3
6678,Sam Lindgren\sam-lindgren-1,2017-18,Colgate,F,12,0,107,12,18,.667,12,18,.667,0,0,,3,3,1.000,9,18,27,4,5,3,5,21,27,2.3
6679,Eric Cobb\eric-cobb-1,2015-16,South Carolina,F,24,0,147,13,23,.565,13,23,.565,0,0,,1,18,.056,13,32,45,3,1,3,14,26,27,0.4
6680,Chuck Ogbodo\chuck-ogbodo-1,2013-14,North Carolina-Wilmington,F,21,4,228,9,20,.450,9,20,.450,0,0,,9,16,.563,15,31,46,1,2,12,12,25,27,1.1
6681,Drick Bernstine\drick-bernstine-1,2013-14,Denver,F,13,5,198,11,39,.282,11,29,.379,0,10,.000,5,8,.625,9,22,31,14,9,4,15,29,27,0.8
6682,John Bailey\john-bailey-2,2013-14,Portland,F,9,2,64,10,24,.417,8,19,.421,2,5,.400,5,8,.625,3,3,6,3,3,1,3,5,27,1.9
6683,Alec Wnuk\alec-wnuk-1,2015-16,North Carolina-Asheville,F,19,0,107,12,22,.545,11,17,.647,1,5,.200,2,7,.286,7,17,24,3,1,2,9,18,27,0.7
6684,Gavin DeJong\gavin-dejong-1,2015-16,Montana,F,21,0,101,12,25,.480,12,25,.480,0,0,,3,7,.429,9,17,26,3,3,3,8,17,27,0.8
6685,Georgi Funtarov\georgi-funtarov-1,2015-16,UC-Davis,F,10,0,94,11,28,.393,9,13,.692,2,15,.133,3,10,.300,6,21,27,3,4,1,7,8,27,1.6
6686,Deion James\deion-james-2,2015-16,North Carolina A&T,F,21,0,115,8,27,.296,8,23,.348,0,4,.000,11,25,.440,12,19,31,9,6,2,6,26,27,0.8
6687,Austin Williams\austin-williams-3,2016-17,Yale,F,14,0,92,13,27,.481,13,26,.500,0,1,.000,1,1,1.000,6,8,14,7,0,2,1,15,27,1.4
6688,Eyimofe Edukugho\eyimofe-edukugho-1,2013-14,Sacred Heart,F,14,0,123,10,23,.435,10,23,.435,0,0,,6,23,.261,9,15,24,2,3,6,13,20,26,0.4
6689,Ron Alston\ron-alston-2,2016-17,NJIT,F,21,0,111,11,31,.355,7,15,.467,4,16,.250,0,0,,6,11,17,7,3,2,9,17,26,0.5
6690,Eric Cobb\eric-cobb-1,2017-18,Connecticut,F,15,5,116,8,18,.444,6,14,.429,2,4,.500,8,14,.571,8,32,40,3,3,1,18,17,26,0.7
6691,David Wacker\david-wacker-1,2015-16,Boise State,F,7,0,80,9,13,.692,9,13,.692,0,0,,8,11,.727,8,12,20,2,2,2,5,13,26,3.3
6692,Dakota Slaughter\dakota-slaughter-1,2014-15,Alabama,F,15,1,93,9,17,.529,3,3,1.000,6,14,.429,2,2,1.000,3,3,6,3,2,1,2,8,26,1.4
6693,Dre' Clayton\dre-clayton-1,2014-15,South Florida,F,28,0,215,9,37,.243,6,19,.316,3,18,.167,5,11,.455,12,31,43,7,4,5,12,21,26,0.4
6694,Mitchell Smith\mitchell-smith-1,2016-17,Missouri,F,11,0,83,10,17,.588,10,17,.588,0,0,,6,14,.429,3,16,19,2,3,4,7,16,26,1.4
6695,Joey Asbury\joey-asbury-1,2013-14,Oakland,F,20,6,111,8,17,.471,6,11,.545,2,6,.333,8,10,.800,4,7,11,0,2,0,5,14,26,0.6
6696,Matt Korcheck\matt-korcheck-1,2014-15,Arizona,F,21,1,77,10,14,.714,10,14,.714,0,0,,6,6,1.000,7,10,17,3,1,7,1,9,26,1.5
6697,Primitivo Gomez\primitivo-gomez-1,2015-16,UC-Riverside,F,12,0,101,6,23,.261,3,16,.188,3,7,.429,11,14,.786,7,13,20,3,2,0,9,5,26,1.1
6698,Cheick Thiero\cheick-thiero-1,2014-15,UC-Riverside,F,16,0,96,12,17,.706,12,17,.706,0,0,,2,2,1.000,4,20,24,0,2,0,6,19,26,1.0
6699,James Suber\james-suber-1,2016-17,Cal State Bakersfield,F,28,13,271,11,27,.407,11,27,.407,0,0,,4,14,.286,36,62,98,9,3,8,21,52,26,0.9
6700,Erik Nissen\erik-nissen-1,2014-15,Maine,F,20,0,116,12,33,.364,12,33,.364,0,0,,2,5,.400,5,23,28,3,3,3,10,22,26,0.3
6701,James Harrison\james-harrison-2,2017-18,East Tennessee State,F,15,1,80,12,25,.480,12,25,.480,0,0,,2,9,.222,5,14,19,2,1,4,7,16,26,0.7
6702,Austin Burnette\austin-burnette-1,2016-17,Campbell,F,24,1,165,9,29,.310,7,17,.412,2,12,.167,6,8,.750,8,19,27,9,2,5,6,17,26,0.8
6703,Samir Sehic\samir-sehic-1,2015-16,Vanderbilt,F,22,0,104,7,21,.333,4,15,.267,3,6,.500,9,14,.643,12,19,31,4,1,0,2,11,26,1.1
6704,Onyekachukwu Odi\onyekachukwu-odi-1,2013-14,Florida A&M,F,32,11,252,12,39,.308,12,39,.308,0,0,,2,12,.167,31,35,66,4,1,26,21,74,26,0.1
6705,Dylan Sinnickson\dylan-sinnickson-1,2015-16,Vermont,F,18,1,84,11,20,.550,7,11,.636,4,9,.444,0,1,.000,12,17,29,1,2,0,5,15,26,1.2
6706,Aaron Carver\aaron-carver-1,2016-17,Old Dominion,F,27,2,209,10,33,.303,10,31,.323,0,2,.000,6,10,.600,17,21,38,4,7,10,6,27,26,0.9
6707,Dan Studer\dan-studer-1,2016-17,Milwaukee,F,25,0,135,10,30,.333,10,27,.370,0,3,.000,6,10,.600,12,19,31,9,5,1,7,23,26,0.7
6708,Lance Thomas\lance-thomas-3,2017-18,Louisville,F,12,0,50,9,14,.643,7,7,1.000,2,7,.286,6,8,.750,3,12,15,0,2,2,3,11,26,1.7
6709,Austin Montgomery\austin-montgomery-2,2015-16,Utah,F,8,0,36,10,13,.769,9,12,.750,1,1,1.000,5,6,.833,5,7,12,2,0,1,4,5,26,2.8
6710,Charles Thomas IV\charles-thomasiv-1,2017-18,Wisconsin,F,22,0,131,12,28,.429,12,22,.545,0,6,.000,2,5,.400,12,23,35,4,1,1,5,22,26,0.7
6711,Akil Douglas\akil-douglas-1,2016-17,Santa Clara,F,12,1,42,10,22,.455,10,15,.667,0,7,.000,6,10,.600,3,6,9,0,1,3,4,6,26,1.1
6712,Millaun Brown\millaun-brown-1,2013-14,Louisiana-Monroe,F,18,1,163,10,20,.500,10,20,.500,0,0,,6,17,.353,21,14,35,2,3,2,11,25,26,0.9
6713,Hugo Naurais\hugo-naurais-1,2013-14,Wagner,F,18,0,120,10,24,.417,6,13,.462,4,11,.364,2,5,.400,9,27,36,0,3,1,9,21,26,0.7
6714,Patrick Zeck\patrick-zeck-1,2016-17,Gardner-Webb,F,19,1,109,10,15,.667,10,15,.667,0,0,,6,8,.750,11,13,24,3,6,3,3,29,26,1.4
6715,Barnett Harris\barnett-harris-1,2014-15,Delaware,F,29,4,303,5,26,.192,5,26,.192,0,0,,16,28,.571,32,43,75,9,6,12,9,55,26,1.0
6716,Damian Goodwin\damien-goodwin-1,2015-16,South Carolina Upstate,F,3,0,59,8,28,.286,8,22,.364,0,6,.000,10,19,.526,4,10,14,2,0,1,7,13,26,0.6
6717,Bryce Jackson\bryce-jackson-1,2014-15,New Orleans,F,23,1,159,8,21,.381,6,12,.500,2,9,.222,8,12,.667,5,8,13,3,1,2,13,25,26,0.0
6718,Malik Smith\malik-smith-2,2016-17,North Carolina-Asheville,F,20,0,130,8,28,.286,7,21,.333,1,7,.143,9,11,.818,6,23,29,7,4,2,8,23,26,0.7
6719,Brian Bridgewater\brian-bridgewater-1,2016-17,Louisiana State,F,23,1,104,10,21,.476,10,21,.476,0,0,,6,7,.857,7,11,18,3,2,1,6,21,26,0.6
6720,Blake McLimans\blake-mclimans-1,2013-14,Miami (OH),F,4,4,111,10,30,.333,6,9,.667,4,21,.190,2,2,1.000,9,10,19,3,2,9,3,5,26,5.9
6721,Ede Egharevba\ede-egharevba-1,2013-14,Albany (NY),F,13,1,76,9,23,.391,7,14,.500,2,9,.222,6,7,.857,5,11,16,4,4,0,9,10,26,1.1
6722,Houston Kessler\houston-kessler-1,2014-15,Georgia,F,29,1,181,9,26,.346,6,17,.353,3,9,.333,5,10,.500,10,17,27,0,2,4,9,22,26,0.3
6723,Samson Akilo\samson-akilo-1,2015-16,Manhattan,F,28,19,221,11,21,.524,11,21,.524,0,0,,4,6,.667,7,17,24,3,3,4,11,38,26,0.2
6724,Weisner Perez\weisner-perez-1,2017-18,Harvard,F,12,3,106,12,24,.500,12,23,.522,0,1,.000,2,3,.667,10,15,25,1,6,0,8,15,26,1.5
6725,Kobe Wilson\kobe-wilson-1,2017-18,Alcorn State,F,27,1,209,8,27,.296,6,19,.316,2,8,.250,8,20,.400,12,39,51,8,6,10,9,28,26,0.9
6726,Will Weeks\will-weeks-1,2013-14,North Carolina-Asheville,F,2,2,74,11,20,.550,11,20,.550,0,0,,4,10,.400,6,8,14,6,3,0,7,4,26,9.6
6727,Malik Eichler\malik-eichler-1,2017-18,Detroit Mercy,F,18,0,130,10,22,.455,8,15,.533,2,7,.286,4,6,.667,7,11,18,0,3,1,7,19,26,0.6
6728,Rashed Anthony\rashed-anthony-1,2014-15,Seton Hall,F,30,0,265,10,17,.588,10,17,.588,0,0,,6,10,.600,15,26,41,3,4,10,13,72,26,0.2
6729,Eliel Nsoseme\eliel-nsoseme-1,2017-18,Cincinnati,F,29,0,166,11,21,.524,11,21,.524,0,0,,4,20,.200,20,29,49,5,3,11,11,23,26,0.9
6730,Andrew Eudy\andrew-eudy-1,2015-16,Campbell,F,26,0,217,8,34,.235,6,20,.300,2,14,.143,8,12,.667,18,37,55,11,5,17,12,32,26,1.1
6731,Kevin Degnan\kevin-degnan-1,2017-18,Siena,F,18,0,89,11,33,.333,9,25,.360,2,8,.250,2,2,1.000,6,14,20,4,1,1,7,6,26,0.6
6732,Jamie Rutherford\jamie-rutherford-1,2016-17,Texas Southern,F,21,0,131,8,42,.190,0,4,.000,8,38,.211,2,6,.333,3,16,19,2,3,1,1,9,26,0.3
6733,Kevin Granger\kevin-granger-2,2017-18,Texas Southern,F,15,0,106,11,20,.550,11,20,.550,0,0,,3,16,.188,9,19,28,2,2,4,4,13,25,1.3
6734,Patrick Wrencher\patrick-wrencher-1,2014-15,Saint Francis (PA),F,22,0,148,12,22,.545,12,22,.545,0,0,,1,5,.200,16,18,34,3,1,5,10,24,25,0.7
6735,Christian Behrens\christian-behrens-1,2013-14,University of California,F,24,0,165,10,21,.476,10,21,.476,0,0,,5,8,.625,7,26,33,3,2,3,3,30,25,0.7
6736,Thomas Brandsma\thomas-brandsma-1,2016-17,Texas Tech,F,28,1,130,8,16,.500,6,11,.545,2,5,.400,7,9,.778,3,7,10,1,2,1,6,9,25,0.5
6737,Julian Harris\julian-harris-2,2015-16,Texas-Arlington,F,19,0,104,11,32,.344,9,24,.375,2,8,.250,1,2,.500,15,11,26,6,2,0,4,16,25,0.9
6738,Nick Gorski\nick-gorski-1,2016-17,Loyola (MD),F,20,2,97,8,23,.348,7,14,.500,1,9,.111,8,8,1.000,2,5,7,3,0,0,8,11,25,0.2
6739,Amir Smith\amir-smith-1,2015-16,Rice,F,24,0,118,9,16,.563,9,16,.563,0,0,,7,13,.538,8,12,20,1,2,3,6,29,25,0.5
6740,Jamal Watson\jamal-watson-1,2017-18,Mississippi Valley State,F,8,5,124,11,22,.500,11,22,.500,0,0,,3,6,.500,5,19,24,9,2,4,6,17,25,2.5
6741,Kwintin Williams\kwintin-williams-1,2017-18,Connecticut,F,18,0,113,8,14,.571,8,12,.667,0,2,.000,9,16,.563,15,19,34,1,2,0,3,13,25,1.5
6742,Joey Brunk\joey-brunk-1,2017-18,Butler,F,20,0,109,11,21,.524,11,21,.524,0,0,,3,6,.500,13,22,35,3,0,2,7,10,25,1.1
6743,Rashed Anthony\rashed-anthony-1,2017-18,Saint Louis,F,32,1,248,10,16,.625,10,16,.625,0,0,,5,8,.625,12,20,32,5,4,20,18,41,25,0.6
6744,Kwesi Abakah\kwesi-abakah-1,2014-15,Northeastern,F,25,0,112,9,19,.474,9,19,.474,0,0,,7,13,.538,6,15,21,0,0,1,3,20,25,0.5
6745,Ulmer Manzie\ulmer-manzie-1,2017-18,Bethune-Cookman,F,13,0,126,8,24,.333,8,24,.333,0,0,,9,27,.333,15,11,26,3,2,2,11,26,25,0.2
6746,Jethro Tshisumpa\jethro-tshisumpa-1,2016-17,Arizona State,F,26,5,192,11,26,.423,11,26,.423,0,0,,3,9,.333,16,23,39,0,4,25,8,55,25,0.7
6747,Blake Simpson\blake-simpson-1,2014-15,Coppin State,F,25,0,225,7,29,.241,7,29,.241,0,0,,11,21,.524,24,19,43,4,1,8,15,43,25,0.1
6748,Joshua Phillips\joshua-phillips-1,2013-14,Middle Tennessee,F,21,0,106,7,15,.467,7,15,.467,0,0,,11,18,.611,11,24,35,3,1,7,9,21,25,1.0
6749,Bill Awet\bill-awet-1,2017-18,Southern Illinois-Edwardsville,F,21,0,180,9,31,.290,9,25,.360,0,6,.000,7,11,.636,8,31,39,6,4,9,15,33,25,0.3
6750,Alex Holcombe\alex-holcombe-1,2016-17,Texas A&M-Corpus Christi,F,24,2,135,10,22,.455,10,22,.455,0,0,,5,10,.500,11,19,30,4,1,11,7,22,25,0.9
6751,Craig Victor\craig-victor-1,2014-15,Arizona,F,8,0,57,8,13,.615,8,13,.615,0,0,,9,17,.529,6,3,9,0,3,2,1,4,25,2.9
6752,Derek Willis\derek-willis-1,2014-15,Kentucky,F,19,0,75,7,18,.389,2,3,.667,5,15,.333,6,6,1.000,5,9,14,5,2,3,8,5,25,1.0
6753,Logan Power\logan-power-1,2016-17,South Dakota,F,19,0,81,8,18,.444,4,9,.444,4,9,.444,5,8,.625,4,16,20,8,1,0,4,7,25,1.1
6754,Mrdjan Gasevic\mrdjan-gasevic-1,2013-14,Delaware State,F,21,3,138,9,17,.529,9,17,.529,0,0,,7,9,.778,4,15,19,3,1,1,9,16,25,0.6
6755,Dishon Lowery\dishon-lowery-1,2017-18,Wofford,F,14,0,85,8,13,.615,8,13,.615,0,0,,9,12,.750,4,14,18,4,1,2,4,9,25,1.6
6756,Johnathan Spicer\johnathan-spicer-1,2015-16,Florida A&M,F,20,3,133,10,28,.357,10,25,.400,0,3,.000,5,8,.625,10,13,23,4,0,2,14,8,25,0.3
6757,Joshua Spiers\joshua-spiers-1,2014-15,Loyola Marymount,F,15,1,109,8,22,.364,2,6,.333,6,16,.375,3,6,.500,5,4,9,4,0,1,7,14,25,0.5
6758,D'Angelo Hunter\dangelo-hunter-1,2017-18,West Virginia,F,17,0,93,7,28,.250,1,11,.091,6,17,.353,5,6,.833,6,10,16,3,2,3,2,12,25,0.8
6759,Taylor Adway\taylor-adway-1,2015-16,Toledo,F,17,0,130,12,20,.600,12,20,.600,0,0,,1,7,.143,7,19,26,4,0,0,12,16,25,0.5
6760,RA Kpedi\ra-kpedi-1,2017-18,Vermont,F,12,0,87,9,20,.450,9,20,.450,0,0,,7,10,.700,8,14,22,1,1,3,7,10,25,1.3
6761,Myles Mann\myles-mann-1,2014-15,Fairleigh Dickinson,F,24,0,127,11,20,.550,11,20,.550,0,0,,3,11,.273,13,19,32,2,3,7,6,29,25,0.8
6762,Jabari Craig\jabari-craig-1,2016-17,East Carolina,F,25,0,208,6,23,.261,6,23,.261,0,0,,13,22,.591,25,25,50,3,6,13,16,37,25,0.8
6763,Ibrahim Dosunmu\ibrahim-dosunmu-1,2017-18,Howard,F,10,1,69,12,15,.800,12,14,.857,0,1,.000,1,4,.250,10,12,22,3,1,0,5,11,25,2.2
6764,Azariah Sykes\azariah-sykes-1,2016-17,Morgan State,F,21,8,251,7,13,.538,7,12,.583,0,1,.000,11,22,.500,24,42,66,2,3,3,4,47,25,1.3
6765,Payton Wilson\payton-wilson-1,2017-18,Jackson State,F,12,0,88,8,18,.444,4,12,.333,4,6,.667,5,10,.500,8,9,17,2,2,4,9,12,25,1.2
6766,Kevin Chuisseu\kevin-chuisseu-1,2014-15,Furman,F,15,6,151,9,23,.391,9,23,.391,0,0,,7,23,.304,10,34,44,3,2,1,11,25,25,0.5
6767,Malik William\malik-william-1,2017-18,Clemson,F,17,0,74,10,27,.370,9,24,.375,1,3,.333,4,6,.667,14,12,26,3,1,3,2,11,25,1.3
6768,Matt Cimino\matt-cimino-1,2017-18,American,F,18,5,190,11,27,.407,8,13,.615,3,14,.214,0,2,.000,10,23,33,12,2,6,20,25,25,0.5
6769,Glenn Hollaway\glenn-hollaway-1,2016-17,Alabama State,F,28,4,213,8,27,.296,7,21,.333,1,6,.167,8,9,.889,14,24,38,5,0,4,12,30,25,0.3
6770,Braylon Lazare\braylon-lazare-1,2013-14,Louisiana,F,12,1,56,11,20,.550,11,20,.550,0,0,,3,5,.600,12,5,17,5,3,1,3,16,25,1.9
6771,Kennedy Edwards\kennedy-edwards-1,2014-15,Army,F,4,0,55,8,17,.471,6,11,.545,2,6,.333,7,11,.636,5,7,12,2,4,3,4,6,25,5.4
6772,Nick Madray\nick-madray-1,2017-18,Wagner,F,9,1,102,8,26,.308,7,22,.318,1,4,.250,8,10,.800,7,19,26,3,1,5,10,31,25,0.4
6773,Chidozie Ndu\chidozie-ndu-1,2017-18,Sam Houston State,F,18,2,93,11,18,.611,11,18,.611,0,0,,3,6,.500,7,6,13,0,2,4,3,13,25,1.1
6774,Nigel Holley\nigel-holley-1,2015-16,East Tennessee State,F,19,2,125,10,22,.455,10,22,.455,0,0,,4,7,.571,5,12,17,5,0,1,8,23,24,0.3
6775,Kenny Paul Geno\kenny-paul-geno-1,2013-14,Georgia,F,21,0,80,9,17,.529,7,13,.538,2,4,.500,4,6,.667,8,7,15,3,4,1,1,10,24,1.2
6776,Sammis Reyes\sammis-reyes-1,2016-17,Tulane,F,30,2,247,9,33,.273,9,33,.273,0,0,,6,23,.261,16,30,46,8,11,12,15,55,24,0.2
6777,Ben Lawson\ben-lawson-1,2013-14,Western Kentucky,F,12,2,95,8,17,.471,8,15,.533,0,2,.000,8,12,.667,6,12,18,2,1,9,6,16,24,1.5
6778,Austin Torres\austin-torres-1,2015-16,Notre Dame,F,26,0,119,10,20,.500,10,20,.500,0,0,,4,10,.400,15,10,25,3,9,6,6,20,24,1.0
6779,Wesley Afolayan\wesley-afolayan-1,2014-15,Prairie View,F,20,0,121,9,28,.321,9,28,.321,0,0,,6,17,.353,11,16,27,0,1,3,10,30,24,-0.1
6780,Justin Jamison\justin-jamison-1,2014-15,Texas Tech,F,9,0,64,8,19,.421,6,15,.400,2,4,.500,6,9,.667,9,9,18,2,1,1,4,13,24,1.7
6781,Derek Sloan\derek-sloan-1,2014-15,Cleveland State,F,22,0,125,10,18,.556,10,18,.556,0,0,,4,8,.500,2,14,16,5,2,3,3,23,24,0.7
6782,Levan Shengelia\levan-shengelia-1,2013-14,Albany (NY),F,18,0,132,8,22,.364,8,22,.364,0,0,,8,12,.667,12,17,29,4,4,7,7,15,24,1.2
6783,Marko Kovacevic\marko-kovacevic-1,2013-14,Utah,F,14,0,69,9,15,.600,9,15,.600,0,0,,6,8,.750,5,5,10,3,0,1,7,12,24,0.9
6784,Matt Korcheck\matt-korcheck-1,2013-14,Arizona,F,22,0,101,8,12,.667,8,12,.667,0,0,,8,12,.667,10,20,30,2,2,5,6,17,24,1.1
6785,Cameron Lewis\cameron-lewis-2,2015-16,Howard,F,18,1,134,8,19,.421,8,19,.421,0,0,,8,14,.571,9,15,24,1,5,2,7,31,24,0.6
6786,Josh Cuthbertson\josh-cuthbertson-1,2013-14,South Carolina Upstate,F,9,0,110,9,27,.333,3,7,.429,6,20,.300,0,0,,4,6,10,4,2,0,5,6,24,1.2
6787,D.J. MacLeay\dj-macleay-1,2013-14,Bucknell,F,16,0,128,9,24,.375,8,21,.381,1,3,.333,5,6,.833,12,26,38,3,6,4,12,23,24,1.0
6788,Michael Chandler\michael-chandler-1,2014-15,Southern Illinois-Edwardsville,F,27,0,168,12,20,.600,12,19,.632,0,1,.000,0,5,.000,17,15,32,2,2,27,7,23,24,1.3
6789,Karlos Odum\karlos-odum-1,2015-16,North Florida,F,21,0,109,5,16,.313,5,16,.313,0,0,,14,17,.824,10,12,22,3,4,0,5,18,24,0.9
6790,Grant Bryant\grant-bryant-1,2015-16,East Carolina,F,13,0,91,10,17,.588,10,17,.588,0,0,,4,7,.571,5,8,13,2,2,1,4,15,24,1.1
6791,Cade Towers\cade-towers-1,2013-14,Nicholls State,F,16,0,111,10,29,.345,8,24,.333,2,5,.400,2,8,.250,8,7,15,2,2,1,8,27,24,-0.1
6792,Jake Scoggins\jake-scoggins-1,2017-18,Arkansas State,F,25,3,156,11,24,.458,11,24,.458,0,0,,2,8,.250,7,20,27,3,3,1,8,35,24,0.2
6793,Wadly Mompremier\wadly-mompremier-1,2014-15,Ohio,F,17,5,141,9,19,.474,8,16,.500,1,3,.333,5,16,.313,6,12,18,3,2,7,8,17,24,0.7
6794,Mitch Lightfoot\mitch-lightfoot-1,2016-17,Kansas,F,25,0,102,10,18,.556,8,15,.533,2,3,.667,2,12,.167,9,16,25,1,2,11,7,17,24,0.8
6795,Christian Jones\christian-jones-1,2014-15,St. John's (NY),F,20,0,124,10,19,.526,10,18,.556,0,1,.000,4,6,.667,8,16,24,0,1,1,4,11,24,0.9
6796,Bik Gill\bik-gill-1,2014-15,Ball State,F,15,1,118,5,24,.208,3,11,.273,2,13,.154,12,15,.800,7,18,25,3,2,3,14,9,24,0.5
6797,Cameron Benford\cameron-benford-1,2017-18,Purdue-Fort Wayne,F,25,1,157,10,24,.417,10,24,.417,0,0,,4,7,.571,20,31,51,5,4,3,9,42,24,0.7
6798,Daniel Green\daniel-green-2,2015-16,Little Rock,F,21,2,143,9,24,.375,9,22,.409,0,2,.000,6,11,.545,13,21,34,2,3,7,8,30,24,0.6
6799,Rob Marberry\rob-marberry-1,2014-15,Western Kentucky,F,12,0,75,9,14,.643,9,14,.643,0,0,,6,12,.500,4,9,13,3,2,1,2,8,24,1.7
6800,LaRond Williams\larond-williams-1,2017-18,Cal State Long Beach,F,11,1,98,11,24,.458,11,24,.458,0,0,,2,6,.333,8,11,19,1,5,7,9,19,24,1.2
6801,Justin Harris\justin-harris-1,2013-14,Quinnipiac,F,13,0,96,8,20,.400,8,19,.421,0,1,.000,8,12,.667,7,15,22,2,3,6,6,13,24,1.4
6802,James Hemphill\james-hemphill-1,2015-16,Navy,F,17,0,76,12,20,.600,12,20,.600,0,0,,0,5,.000,12,14,26,0,1,0,3,11,24,1.1
6803,Rudy Stradnieks\rudy-stradnieks-1,2015-16,Southern Illinois,F,24,0,112,9,23,.391,9,20,.450,0,3,.000,6,11,.545,6,20,26,2,0,3,2,14,24,0.7
6804,Jacquil Taylor\jacquil-taylor-1,2015-16,Purdue,F,13,0,60,9,18,.500,7,13,.538,2,5,.400,4,9,.444,9,11,20,3,2,4,5,14,24,1.5
6805,Daniel Edozie\daniel-edozie-1,2013-14,Iowa State,F,24,2,138,9,15,.600,9,15,.600,0,0,,6,12,.500,10,27,37,2,2,8,2,18,24,1.2
6806,Jordan Hunter\jordan-hunter-2,2015-16,Saint Mary's (CA),F,27,0,71,9,18,.500,9,18,.500,0,0,,6,18,.333,9,16,25,4,2,5,6,21,24,0.6
6807,Zach McRoberts\zach-mcroberts-1,2016-17,Indiana,F,31,3,350,9,27,.333,5,15,.333,4,12,.333,2,2,1.000,13,32,45,29,12,6,8,45,24,1.2
6808,Dusan Kovacevic\dusan-kovacevic-1,2017-18,Davidson,F,7,0,75,9,22,.409,8,17,.471,1,5,.200,5,7,.714,2,17,19,3,1,1,5,12,24,1.7
6809,Brandon Bolden\brandon-bolden-1,2016-17,Southern,F,7,1,62,9,12,.750,9,12,.750,0,0,,5,8,.625,5,8,13,2,1,3,7,13,23,2.2
6810,Gorjok Gak\gorjok-gak-1,2016-17,Florida,F,15,0,80,11,17,.647,11,17,.647,0,0,,1,10,.100,11,12,23,0,1,3,7,13,23,0.9
6811,Tyler Barlow\tyler-barlow-1,2015-16,Lafayette,F,20,0,143,9,24,.375,9,24,.375,0,0,,5,8,.625,9,19,28,2,3,5,2,25,23,0.8
6812,Skye Johnson\skye-johnson-1,2014-15,Delaware,F,19,0,134,8,19,.421,8,19,.421,0,0,,7,13,.538,10,17,27,7,4,5,9,14,23,1.1
6813,James Claar\james-claar-1,2016-17,Western Illinois,F,18,0,123,9,18,.500,9,18,.500,0,0,,5,10,.500,7,16,23,3,2,5,5,17,23,1.0
6814,Yaradyah Evans\yaradyah-evans-1,2017-18,St. Francis (NY),F,15,0,121,8,24,.333,5,11,.455,3,13,.231,4,7,.571,2,18,20,4,4,1,13,21,23,0.1
6815,Quinton Gustavson\quinton-gustavson-1,2013-14,Milwaukee,F,15,0,57,9,16,.563,6,9,.667,3,7,.429,2,4,.500,2,11,13,1,2,1,0,6,23,1.4
6816,Tony Armstrong\tony-armstrong-1,2014-15,Alabama State,F,11,0,69,10,19,.526,10,19,.526,0,0,,3,8,.375,3,4,7,2,1,1,5,6,23,1.0
6817,Claybrin McMath\claybrin-mcmath-1,2013-14,Bryant,F,29,13,218,11,23,.478,11,23,.478,0,0,,1,5,.200,7,22,29,3,6,6,6,48,23,0.3
6818,Usman Haruna\usman-haruna-1,2017-18,East Carolina,F,24,0,208,11,21,.524,11,21,.524,0,0,,1,8,.125,13,42,55,2,4,7,8,41,23,0.7
6819,Keon Williams\keon-williams-2,2017-18,St. Francis (NY),F,12,3,112,7,21,.333,4,6,.667,3,15,.200,6,11,.545,0,13,13,2,4,1,4,11,23,0.9
6820,Jamie Schneck\jamie-schneck-1,2014-15,Hartford,F,29,2,203,8,18,.444,8,18,.444,0,0,,7,11,.636,6,13,19,2,4,13,8,33,23,0.5
6821,Alex Foster\alex-foster-1,2014-15,Texas Tech,F,23,1,139,10,19,.526,10,19,.526,0,0,,3,14,.214,4,14,18,3,0,6,14,21,23,0.0
6822,Abdoulaye Gueye\abdoulaye-gueye-1,2016-17,Georgia Tech,F,20,3,201,11,28,.393,11,25,.440,0,3,.000,1,6,.167,18,31,49,9,3,12,24,33,23,0.4
6823,Deven Dorsett\deven-dorsett-1,2016-17,Maryland-Eastern Shore,F,19,0,142,10,42,.238,9,31,.290,1,11,.091,2,9,.222,13,20,33,4,3,2,9,13,23,0.2
6824,Reid Aube\reid-aube-1,2015-16,Charlotte,F,26,1,182,7,12,.583,7,12,.583,0,0,,9,9,1.000,15,21,36,2,2,5,6,40,23,0.7
6825,Nick King\nick-king-1,2016-17,Alabama,F,7,2,89,8,25,.320,5,12,.417,3,13,.231,4,6,.667,3,17,20,3,5,2,7,3,23,2.2
6826,Quinn Price\quinn-price-1,2014-15,Montana State,F,25,0,190,10,26,.385,10,26,.385,0,0,,3,6,.500,15,30,45,3,5,14,11,36,23,0.7
6827,Brandon Allen\brandon-allen-4,2017-18,Florida State,F,23,2,94,10,20,.500,7,8,.875,3,12,.250,0,0,,3,6,9,7,3,0,9,11,23,0.5
6828,Paulius Satkus\paulius-satkus-1,2013-14,James Madison,F,14,0,104,7,13,.538,7,13,.538,0,0,,9,12,.750,6,22,28,2,0,1,8,28,23,0.7
6829,Dontavious Smith\dontavious-smith-1,2016-17,Massachusetts-Lowell,F,13,0,62,7,10,.700,7,10,.700,0,0,,9,12,.750,3,12,15,4,0,7,7,12,23,1.5
6830,Nahshon George\nahshon-george-1,2014-15,Idaho,F,14,0,139,10,24,.417,10,23,.435,0,1,.000,3,4,.750,15,25,40,2,3,1,15,23,23,0.6
6831,Chandler Rowe\chandler-rowe-1,2013-14,Tennessee-Martin,F,28,2,183,9,18,.500,9,18,.500,0,0,,5,9,.556,9,14,23,5,7,7,8,57,23,0.3
6832,Rakim Lubin\rakem-lubin-1,2014-15,Connecticut,F,24,0,155,8,15,.533,8,15,.533,0,0,,7,15,.467,13,15,28,2,0,4,8,27,23,0.5
6833,Tafari Whittingham\tafari-whittingham-1,2014-15,South Alabama,F,5,0,61,7,16,.438,7,15,.467,0,1,.000,9,14,.643,5,10,15,0,1,4,4,7,23,3.2
6834,Justin Robinson\justin-robinson-4,2017-18,Duke,F,17,0,82,8,19,.421,2,2,1.000,6,17,.353,1,4,.250,0,11,11,2,0,9,5,7,23,0.9
6835,Gavin Kensmil\gavin-kensmil-1,2017-18,Iona,F,23,1,105,10,21,.476,10,21,.476,0,0,,3,14,.214,8,16,24,2,3,3,9,29,23,0.2
6836,Jabari McGhee\jabari-mcghee-1,2015-16,Tennessee,F,6,0,65,9,17,.529,9,17,.529,0,0,,5,6,.833,8,11,19,0,4,3,1,17,23,3.6
6837,Matt Van Dyk\matt-vandyk-1,2015-16,Michigan State,F,21,0,49,7,14,.500,7,14,.500,0,0,,9,13,.692,2,11,13,4,3,2,3,8,23,1.0
6838,Thomas Pierre-Louis\thomas-pierre-louis-1,2014-15,Southern,F,10,2,74,10,18,.556,10,18,.556,0,0,,3,12,.250,8,8,16,1,2,4,7,15,23,1.1
6839,Brandan Kearney\brandan-kearney-1,2013-14,Arizona State,F,19,1,123,7,26,.269,4,17,.235,3,9,.333,6,8,.750,5,8,13,3,3,0,9,21,23,0.0
6840,Mike Thomas\mike-thomas-2,2013-14,Hawaii,F,20,0,112,7,25,.280,7,17,.412,0,8,.000,9,15,.600,11,12,23,6,2,4,8,28,23,0.4
6841,Jonathan Baehre\jonathan-baehre-1,2016-17,North Carolina-Asheville,F,11,0,82,9,19,.474,8,16,.500,1,3,.333,4,9,.444,9,8,17,5,3,3,5,9,23,1.8
6842,Aboubacar Diallo\aboubacar-diallo-1,2016-17,Eastern Illinois,F,27,2,184,6,28,.214,6,28,.214,0,0,,11,22,.500,30,39,69,5,6,19,8,29,23,1.4
6843,Bud Jones\bud-jones-1,2017-18,Eastern Michigan,F,24,2,93,10,15,.667,10,15,.667,0,0,,3,8,.375,11,13,24,1,0,4,7,22,23,0.6
6844,Andre Walker\andre-walker-2,2014-15,Hofstra,F,17,3,162,9,20,.450,9,20,.450,0,0,,4,8,.500,8,43,51,4,2,21,6,37,22,1.6
6845,Gabe Osabuohien\gabe-osabuohien-1,2017-18,Arkansas,F,20,0,136,10,25,.400,10,21,.476,0,4,.000,2,10,.200,6,22,28,7,3,3,11,21,22,0.3
6846,Bray Barnes\bray-barnes-1,2017-18,Cal State Bakersfield,F,13,0,35,5,11,.455,3,5,.600,2,6,.333,10,11,.909,3,5,8,2,0,0,1,11,22,1.2
6847,Isaiah Watkins\isaiah-watkins-1,2013-14,Duquesne,F,16,0,96,7,23,.304,7,21,.333,0,2,.000,8,11,.727,10,12,22,1,7,1,7,19,22,0.7
6848,Luke McDonnell\luke-mcdonnell-1,2017-18,Northern Iowa,F,11,0,64,11,20,.550,11,15,.733,0,5,.000,0,3,.000,3,12,15,2,3,7,4,7,22,1.8
6849,Ben Coupet\ben-coupet-2,2016-17,Nevada-Las Vegas,F,17,2,116,7,22,.318,7,12,.583,0,10,.000,8,10,.800,9,17,26,10,0,0,6,12,22,1.0
6850,Steven Stanley\steven-stanley-1,2016-17,Northern Arizona,F,11,0,77,7,11,.636,7,11,.636,0,0,,8,9,.889,4,10,14,2,0,0,7,14,22,1.0
6851,Jack White\jack-white-1,2017-18,Duke,F,28,0,161,9,22,.409,7,10,.700,2,12,.167,2,2,1.000,10,32,42,7,7,6,7,11,22,1.1
6852,Josh Pitts\josh-pitts-1,2017-18,Cal State Fullerton,F,19,0,92,9,26,.346,9,26,.346,0,0,,4,8,.500,11,12,23,3,2,2,5,26,22,0.4
6853,Taj Price\taj-price-1,2016-17,NJIT,F,14,0,53,7,12,.583,7,12,.583,0,0,,8,11,.727,4,13,17,3,2,1,4,12,22,1.3
6854,BillyDee Williams\billydee-williams-1,2014-15,West Virginia,F,18,0,131,9,40,.225,5,24,.208,4,16,.250,0,1,.000,10,17,27,7,4,1,4,21,22,0.4
6855,Klay Stall\klay-stall-1,2017-18,Utah State,F,10,1,86,9,16,.563,9,16,.563,0,0,,4,9,.444,8,21,29,2,1,4,7,13,22,1.7
6856,Martinas Geben\martinas-geben-1,2015-16,Notre Dame,F,16,0,48,6,11,.545,6,11,.545,0,0,,10,10,1.000,5,10,15,0,1,2,4,11,22,1.1
6857,Artem Tavakalyan\artem-tavakalyan-1,2014-15,Delaware State,F,13,0,81,8,22,.364,6,13,.462,2,9,.222,4,12,.333,2,10,12,1,2,2,5,11,22,0.4
6858,Matt Bullock\matt-bullock-1,2017-18,Rutgers,F,9,0,72,9,23,.391,9,17,.529,0,6,.000,4,10,.400,7,8,15,2,1,0,5,8,22,1.0
6859,Strahinja Gavrilovic\strahinja-gavrilovic-1,2015-16,Southern California,F,18,1,46,7,15,.467,5,11,.455,2,4,.500,6,6,1.000,0,4,4,0,3,1,4,0,22,0.8
6860,Cole Welle\cole-welle-1,2016-17,University of California,F,12,0,50,11,20,.550,11,18,.611,0,2,.000,0,3,.000,9,10,19,0,1,1,0,9,22,1.6
6861,Andre Walker\andre-walker-2,2015-16,Hofstra,F,25,0,121,9,22,.409,9,22,.409,0,0,,4,7,.571,10,20,30,4,3,13,9,26,22,0.7
6862,Jordy Kuiper\jordy-kuiper-1,2015-16,North Carolina-Greensboro,F,8,1,99,10,20,.500,10,18,.556,0,2,.000,2,3,.667,9,11,20,3,4,0,5,16,22,2.0
6863,Bryant Thomas\bryant-thomas-1,2017-18,Charlotte,F,10,0,127,8,16,.500,8,16,.500,0,0,,6,12,.500,5,20,25,2,2,8,5,12,22,2.0
6864,Quin Cooper\quin-cooper-1,2013-14,Southeastern Louisiana,F,12,0,37,8,14,.571,4,5,.800,4,9,.444,2,5,.400,0,3,3,1,0,0,2,2,22,1.1
6865,Brandon Murphy\brandon-murphy-1,2014-15,Indiana State,F,22,0,127,5,24,.208,5,24,.208,0,0,,12,19,.632,11,23,34,0,2,9,6,23,22,0.6
6866,Alex Thompson\alex-thompson-2,2013-14,Auburn,F,21,0,163,8,24,.333,4,12,.333,4,12,.333,2,8,.250,8,24,32,4,7,1,8,24,22,0.6
6867,Nate Grimes\nate-grimes-1,2016-17,Fresno State,F,13,0,82,8,21,.381,8,21,.381,0,0,,6,11,.545,14,9,23,1,3,3,4,12,22,1.4
6868,Jakub Petras\jakub-petras-1,2015-16,Stony Brook,F,21,0,91,10,20,.500,10,20,.500,0,0,,2,3,.667,8,13,21,4,2,3,2,10,22,1.0
6869,Peter Hanley\peter-hanley-1,2015-16,Bradley,F,27,0,187,9,23,.391,7,16,.438,2,7,.286,2,3,.667,8,24,32,8,4,3,10,12,22,0.7
6870,Michael Middlebrooks\michael-middlebrooks-1,2013-14,Illinois State,F,4,4,99,10,14,.714,10,13,.769,0,1,.000,2,3,.667,10,29,39,4,4,8,4,15,22,8.5
6871,Mac Hoffman\mac-hoffman-1,2014-15,Army,F,18,0,149,8,22,.364,6,13,.462,2,9,.222,4,5,.800,12,12,24,5,4,3,2,34,22,0.9
6872,T.J. Traylor\tj-traylor-1,2016-17,Mississippi Valley State,F,9,4,104,10,24,.417,8,16,.500,2,8,.250,0,0,,5,7,12,3,3,4,5,19,22,1.1
6873,Alain Chigha\alain-chigha-1,2014-15,Quinnipiac,F,16,2,158,5,15,.333,3,10,.300,2,5,.400,10,15,.667,9,19,28,2,1,0,6,34,22,0.4
6874,Joey Brunk\joey-brunk-1,2016-17,Butler,F,7,0,49,7,13,.538,7,11,.636,0,2,.000,8,12,.667,0,7,7,1,1,1,3,8,22,1.8
6875,Jesse Deloach\jesse-deloach-1,2015-16,Western Carolina,F,30,0,190,9,29,.310,9,28,.321,0,1,.000,4,15,.267,9,44,53,2,5,16,8,24,22,0.7
6876,Rod Mills\rod-mills-1,2014-15,Miami (OH),F,15,0,79,8,26,.308,4,14,.286,4,12,.333,2,2,1.000,3,6,9,0,2,1,7,12,22,0.1
6877,Tyler Miller\tyler-miller-1,2015-16,Prairie View,F,12,5,135,9,23,.391,9,23,.391,0,0,,4,10,.400,3,16,19,4,1,3,4,18,22,0.7
6878,Chris Wray\chris-wray-1,2014-15,Mount St. Mary's,F,18,1,115,10,17,.588,10,17,.588,0,0,,2,6,.333,11,12,23,0,8,5,3,14,22,1.5
6879,Fredens Deneus\fredens-deneus-1,2017-18,Alabama State,F,17,0,78,8,21,.381,8,21,.381,0,0,,6,13,.462,7,10,17,3,2,1,5,10,22,0.7
6880,Ivan Lukic\ivan-lukic-1,2014-15,James Madison,F,15,0,139,6,16,.375,5,14,.357,1,2,.500,9,14,.643,6,13,19,2,5,3,10,24,22,0.5
6881,Nate Rucker\nate-rucker-1,2014-15,Kennesaw State,F,6,0,59,9,25,.360,9,25,.360,0,0,,4,5,.800,3,12,15,0,0,1,7,11,22,0.5
6882,Mitar Stanojevic\mitar-stanojevic-1,2017-18,Texas-San Antonio,F,10,0,50,8,16,.500,8,11,.727,0,5,.000,6,10,.600,6,6,12,5,0,0,3,1,22,1.9
6883,Andre Slavik\andre-slavik-1,2014-15,Idaho State,F,23,0,196,10,14,.714,10,14,.714,0,0,,2,7,.286,9,10,19,1,2,3,10,30,22,0.3
6884,Daniel Relvao\daniel-relvao-1,2016-17,George Mason,F,27,0,187,8,20,.400,8,20,.400,0,0,,6,9,.667,16,28,44,3,4,10,12,37,22,0.6
6885,Andrija Matic\andrija-matic-1,2016-17,American,F,17,0,113,7,15,.467,6,13,.462,1,2,.500,7,14,.500,9,11,20,4,0,0,7,6,22,0.9
6886,Charles Bargman\charles-bargman-1,2014-15,Mississippi Valley State,F,19,6,192,6,32,.188,0,15,.000,6,17,.353,4,6,.667,7,13,20,5,12,2,9,20,22,0.5
6887,Martin Jones\martin-jones-1,2016-17,North Carolina A&T,F,19,0,105,7,31,.226,3,8,.375,4,23,.174,4,7,.571,6,5,11,5,2,0,3,14,22,0.2
6888,Tyson Kanseyo\tyson-kanseyo-1,2015-16,Montana State,F,26,10,209,7,14,.500,7,14,.500,0,0,,8,17,.471,17,41,58,7,2,6,20,46,22,0.3
6889,Montray Clemons\montray-clemons-1,2014-15,San Francisco,F,15,0,83,7,19,.368,7,18,.389,0,1,.000,8,14,.571,8,14,22,3,3,2,5,18,22,0.9
6890,Andre Berry\andre-berry-1,2016-17,Rhode Island,F,14,0,69,10,20,.500,10,20,.500,0,0,,2,3,.667,7,3,10,1,1,2,5,11,22,0.8
6891,Marcus Blake\marcus-blake-1,2013-14,Florida Gulf Coast,F,25,1,160,7,19,.368,7,19,.368,0,0,,8,12,.667,13,29,42,2,4,4,11,12,22,0.8
6892,Alex Bates\alex-bates-1,2013-14,Tennessee State,F,29,12,310,8,17,.471,8,17,.471,0,0,,6,12,.500,21,24,45,5,9,6,5,56,22,0.8
6893,Austin Karazsia\austin-karazsia-1,2014-15,South Alabama,F,21,0,143,8,21,.381,4,11,.364,4,10,.400,2,6,.333,5,16,21,2,3,1,6,16,22,0.5
6894,Giacomo Zilli\giacomo-zilli-1,2015-16,North Carolina-Asheville,F,14,0,70,8,17,.471,8,17,.471,0,0,,5,7,.714,3,8,11,2,2,2,8,14,21,0.5
6895,Dayon Goodman\dayon-goodman-1,2014-15,Utah Valley,F,16,1,102,8,21,.381,8,21,.381,0,0,,5,11,.455,11,17,28,5,3,2,6,6,21,1.2
6896,Jack White\jack-white-1,2016-17,Duke,F,10,0,61,6,9,.667,5,7,.714,1,2,.500,8,10,.800,2,11,13,1,1,2,4,5,21,1.8
6897,Brice Kofane\brice-kofane-1,2013-14,Providence,F,21,0,93,7,12,.583,7,12,.583,0,0,,7,14,.500,7,9,16,1,0,8,5,14,21,0.8
6898,Justin Strings\justin-strings-1,2014-15,Sacramento State,F,25,0,106,8,13,.615,8,13,.615,0,0,,5,13,.385,4,14,18,7,1,2,3,17,21,0.7
6899,Noah Yates\noah-yates-1,2016-17,Yale,F,11,0,60,7,13,.538,3,5,.600,4,8,.500,3,6,.500,0,10,10,3,3,2,7,6,21,1.2
6900,Ifeanyi Umezurike\ifeanyi-umezurike-1,2016-17,Saint Francis (PA),F,22,2,141,7,28,.250,7,28,.250,0,0,,7,11,.636,14,30,44,1,3,2,15,32,21,-0.1
6901,Jackson Simmons\jackson-simmons-1,2014-15,North Carolina,F,28,1,102,9,13,.692,9,13,.692,0,0,,3,4,.750,7,5,12,1,2,0,2,17,21,0.6
6902,A.J. Cheeseman\aj-cheeseman-1,2016-17,New Orleans,F,20,0,99,8,16,.500,8,16,.500,0,0,,5,11,.455,2,13,15,6,2,3,8,20,21,0.4
6903,Greg Dorleus\greg-dorleus-1,2013-14,Charleston Southern,F,9,1,38,7,12,.583,7,12,.583,0,0,,7,9,.778,5,5,10,0,4,3,3,5,21,2.3
6904,Victor Uyaelunmo\victor-uyaelunmo-1,2017-18,Southern California,F,15,1,52,6,9,.667,6,9,.667,0,0,,9,16,.563,4,9,13,1,0,1,3,6,21,1.1
6905,Lorenzo Hunt\lorenzo-hunt-1,2016-17,Mississippi Valley State,F,24,1,110,7,24,.292,6,19,.316,1,5,.200,6,16,.375,2,14,16,3,0,1,1,15,21,0.2
6906,Scott Muirhead\scott-muirhead-1,2017-18,Texas-Arlington,F,17,0,50,7,27,.259,0,1,.000,7,26,.269,0,0,,2,4,6,1,0,0,1,5,21,0.3
6907,Duol Mayot\duol-mayot-1,2015-16,South Dakota,F,17,0,102,9,20,.450,9,20,.450,0,0,,3,7,.429,10,14,24,6,2,0,8,12,21,0.8
6908,Bobby Duncan\bobby-duncan-1,2015-16,Citadel,F,21,0,116,7,12,.583,7,11,.636,0,1,.000,7,15,.467,9,26,35,2,6,0,4,32,21,0.8
6909,Ryan Preston\ryan-preston-1,2017-18,Rhode Island,F,17,0,92,10,22,.455,10,20,.500,0,2,.000,1,4,.250,11,18,29,3,4,8,5,23,21,1.1
6910,Connor McClenaghan\connor-mcclenaghan-1,2016-17,Marist,F,19,0,108,9,26,.346,8,16,.500,1,10,.100,2,7,.286,5,12,17,4,2,3,5,22,21,0.2
6911,Barnett Harris\barnett-harris-1,2015-16,Delaware,F,27,1,223,6,13,.462,6,13,.462,0,0,,9,18,.500,27,38,65,7,8,10,12,52,21,1.0
6912,Goodluck Okonoboh\goodluck-okonoboh-1,2015-16,Nevada-Las Vegas,F,6,2,91,8,21,.381,8,21,.381,0,0,,5,14,.357,9,9,18,2,5,7,6,9,21,2.8
6913,Steve Harris\steve-harris-3,2016-17,Austin Peay,F,13,0,92,8,14,.571,7,12,.583,1,2,.500,4,11,.364,1,8,9,6,6,2,4,5,21,1.6
6914,Thomas Smallwood\thomas-smallwood-1,2016-17,Alabama-Birmingham,F,15,0,79,10,23,.435,10,16,.625,0,7,.000,1,3,.333,9,4,13,6,0,1,2,17,21,0.8
6915,Wanaah Bail\wanaah-bail-1,2013-14,UCLA,F,13,0,60,8,18,.444,8,17,.471,0,1,.000,5,8,.625,1,7,8,4,4,2,1,14,21,1.1
6916,Zach Saylor\zach-saylor-1,2013-14,Central Michigan,F,25,0,133,8,19,.421,8,19,.421,0,0,,5,8,.625,6,19,25,4,5,3,5,21,21,0.6
6917,Bobby Wehrli\bobby-wehrli-1,2015-16,Dayton,F,22,0,119,8,20,.400,6,10,.600,2,10,.200,2,4,.500,10,7,17,5,1,0,3,23,20,0.4
6918,Chance Anderson\chance-anderson-1,2016-17,San Francisco,F,22,2,92,8,19,.421,8,15,.533,0,4,.000,4,9,.444,5,21,26,6,1,2,5,22,20,0.5
6919,Joe Aase\joe-aase-1,2013-14,Davidson,F,24,0,152,8,24,.333,5,13,.385,3,11,.273,1,2,.500,3,20,23,4,3,3,4,31,20,0.2
6920,Mason Green\mason-green-1,2017-18,Mercer,F,16,1,58,8,11,.727,8,11,.727,0,0,,4,7,.571,7,4,11,1,2,3,5,9,20,1.0
6921,Austin Budke\austin-budke-1,2016-17,Kansas State,F,23,0,109,6,20,.300,3,7,.429,3,13,.231,5,10,.500,4,6,10,5,4,1,3,15,20,0.4
6922,Aram Martin\aram-martin-1,2015-16,Brown,F,16,0,86,8,31,.258,8,20,.400,0,11,.000,4,4,1.000,3,18,21,6,1,13,8,15,20,0.6
6923,Brett Barney\brett-barney-1,2016-17,Wichita State,F,17,0,39,10,18,.556,10,18,.556,0,0,,0,2,.000,4,2,6,0,3,0,0,5,20,0.9
6924,Jeff Howard\jeff-howard-2,2013-14,Indiana,F,23,2,129,5,11,.455,5,11,.455,0,0,,10,15,.667,11,9,20,5,2,2,7,18,20,0.7
6925,Kris Drees\kris-drees-1,2013-14,Kennesaw State,F,21,0,170,9,18,.500,9,18,.500,0,0,,2,6,.333,9,17,26,2,2,0,7,27,20,0.3
6926,John Odo\john-odo-1,2014-15,Louisiana State,F,16,10,114,8,14,.571,8,14,.571,0,0,,4,6,.667,8,10,18,2,0,6,4,14,20,1.1
6927,Jason Carter\jason-carter-5,2017-18,Ohio,F,3,0,42,5,17,.294,5,14,.357,0,3,.000,10,12,.833,2,8,10,5,5,0,3,3,20,5.8
6928,Will Emery\will-emery-1,2016-17,Dartmouth,F,12,0,70,7,15,.467,7,13,.538,0,2,.000,6,10,.600,5,2,7,0,0,0,4,9,20,0.6
6929,Brandon Jordan\brandon-jordan-1,2015-16,Savannah State,F,17,2,143,7,13,.538,7,13,.538,0,0,,6,11,.545,9,18,27,2,1,5,7,24,20,0.7
6930,Yusef Yakubu\yusef-yakubu-1,2016-17,Prairie View,F,19,4,189,9,14,.643,9,13,.692,0,1,.000,2,7,.286,16,24,40,2,4,4,11,43,20,0.5
6931,Charlendez Brooks\charlendez-brooks-1,2014-15,Western Carolina,F,18,0,150,9,18,.500,9,18,.500,0,0,,2,6,.333,6,11,17,5,1,7,7,26,20,0.5
6932,Terrel Martin-Garcia\terrel-martin-garcia-1,2016-17,Albany (NY),F,12,0,40,8,13,.615,7,11,.636,1,2,.500,3,4,.750,2,8,10,0,1,0,5,6,20,0.9
6933,TyQuayion Smith\tyquayion-smith-1,2017-18,Alcorn State,F,20,1,112,7,14,.500,6,11,.545,1,3,.333,5,7,.714,6,10,16,2,5,4,8,10,20,0.8
6934,Mamoudou Diarra\mamoudou-diarra-1,2017-18,Cincinnati,F,7,0,46,7,20,.350,6,18,.333,1,2,.500,5,6,.833,5,8,13,2,1,5,4,3,20,2.1
6935,Eric Rwahwire\eric-rwahwire-1,2016-17,UC-Riverside,F,7,0,65,8,26,.308,6,12,.500,2,14,.143,2,3,.667,6,15,21,2,0,1,5,8,20,1.0
6936,Martin Krampelj\martin-krampelj-1,2015-16,Creighton,F,7,0,46,9,19,.474,8,14,.571,1,5,.200,1,6,.167,10,15,25,2,1,3,2,8,20,2.7
6937,Shane Hammink\shane-hammink-1,2013-14,Louisiana State,F,21,0,120,9,16,.563,9,13,.692,0,3,.000,2,7,.286,10,11,21,4,2,1,10,15,20,0.5
6938,Jalen Stephens-Holmes\jalen-stephens-holmes-1,2017-18,Chicago State,F,8,0,84,9,19,.474,9,18,.500,0,1,.000,2,5,.400,12,12,24,3,2,5,6,16,20,2.0
6939,Trayvond Massenburg\trayvond-massenburg-1,2016-17,Chattanooga,F,17,1,81,9,17,.529,9,17,.529,0,0,,2,7,.286,8,15,23,1,4,4,4,15,20,1.0
6940,Collin Goss\collin-goss-1,2016-17,George Washington,F,13,0,80,7,12,.583,7,12,.583,0,0,,6,8,.750,4,10,14,1,2,4,3,13,20,1.3
6941,Parker Hazen\parker-hazen-1,2017-18,Valparaiso,F,21,12,175,6,20,.300,6,14,.429,0,6,.000,8,14,.571,8,17,25,4,1,1,19,22,20,-0.3
6942,Alex Illikainen\alex-illikainen-1,2017-18,Wisconsin,F,25,0,170,7,18,.389,1,6,.167,6,12,.500,0,3,.000,9,13,22,10,0,3,4,17,20,0.7
6943,Cassidy Ryan\cassidy-ryan-1,2014-15,Canisius,F,16,0,95,9,29,.310,8,25,.320,1,4,.250,1,1,1.000,3,7,10,6,0,1,9,18,20,-0.2
6944,James Bento\james-bento-1,2015-16,Mercer,F,27,0,164,9,24,.375,9,24,.375,0,0,,2,7,.286,18,25,43,6,4,3,6,12,20,0.9
6945,Williams Gabriel\williams-gabriel-1,2014-15,New Hampshire,F,17,3,92,9,20,.450,9,20,.450,0,0,,2,2,1.000,9,18,27,1,3,5,8,19,20,0.8
6946,Tom Lacey\tom-lacey-1,2014-15,Navy,F,15,1,117,7,17,.412,7,17,.412,0,0,,6,11,.545,9,15,24,4,5,3,9,19,20,0.9
6947,Floris Versteeg\floris-versteeg-1,2013-14,Cal State Fullerton,F,15,0,106,6,21,.286,2,4,.500,4,17,.235,4,6,.667,3,13,16,0,1,0,5,7,20,0.4
6948,Tyjhai Byers\tyjhai-byers-1,2016-17,Morgan State,F,22,13,198,10,18,.556,10,18,.556,0,0,,0,1,.000,16,16,32,1,4,21,6,36,20,1.2
6949,Kenan Guzonjic\kevin-guzonjic-1,2015-16,Colorado,F,13,0,53,7,19,.368,5,15,.333,2,4,.500,4,7,.571,6,8,14,1,0,1,6,9,20,0.5
6950,Brodricks Jones\brodricks-jones-1,2015-16,Texas-El Paso,F,16,0,139,5,20,.250,5,20,.250,0,0,,10,16,.625,5,18,23,3,4,10,8,19,20,0.8
6951,Markus Starks\markus-starks-1,2013-14,Chicago State,F,24,0,153,8,25,.320,6,22,.273,2,3,.667,2,4,.500,2,20,22,1,2,0,7,25,20,-0.1
6952,Dylan Painter\dylan-painter-1,2016-17,Villanova,F,22,0,127,6,14,.429,6,11,.545,0,3,.000,8,12,.667,7,24,31,0,1,0,5,13,20,0.6
6953,Jayson Snearl\jayson-snearl-1,2014-15,Florida A&M,F,25,1,196,9,24,.375,9,24,.375,0,0,,2,2,1.000,10,23,33,1,3,1,8,33,20,0.2
6954,Jordyn Martin\jordyn-martin-1,2015-16,Northern Arizona,F,3,3,82,9,19,.474,9,18,.500,0,1,.000,2,2,1.000,7,3,10,2,3,0,6,5,20,4.2
6955,Cliff Thomas Jr.\cliff-thomasjr-1,2016-17,High Point,F,17,0,96,6,11,.545,6,11,.545,0,0,,8,21,.381,6,17,23,1,2,5,8,12,20,0.7
6956,Mike LeBlanc\mike-leblanc-1,2015-16,Princeton,F,14,0,80,7,24,.292,2,6,.333,5,18,.278,1,1,1.000,1,10,11,5,4,0,3,8,20,0.8
6957,Alassane Kah\alassane-kah-1,2016-17,Old Dominion,F,13,0,42,9,14,.643,8,11,.727,1,3,.333,1,4,.250,4,10,14,1,1,3,1,13,20,1.2
6958,Stojan Gjuroski\stojan-gjuroski-1,2013-14,Louisiana Tech,F,25,0,108,7,31,.226,3,9,.333,4,22,.182,2,6,.333,11,16,27,6,2,0,7,7,20,0.3
6959,Kennedy Chukwuocha\kennedy-chukwuocha-1,2013-14,Massachusetts-Lowell,F,14,2,171,7,19,.368,7,18,.389,0,1,.000,6,11,.545,9,14,23,3,4,3,15,39,20,-0.3
6960,Blake Simpson\blake-simpson-1,2017-18,Coppin State,F,12,2,96,7,15,.467,7,15,.467,0,0,,6,6,1.000,3,9,12,1,0,4,5,12,20,0.9
6961,Scott Muirhead\scott-muirhead-1,2016-17,Texas-Arlington,F,19,0,31,7,19,.368,1,3,.333,6,16,.375,0,0,,0,3,3,2,0,0,4,3,20,0.3
6962,Demonte Flannigan\demonte-flannigan-1,2013-14,Cleveland State,F,20,0,99,9,14,.643,9,14,.643,0,0,,2,5,.400,5,9,14,2,2,1,8,17,20,0.4
6963,JaQuan Smith\jaquan-smith-1,2015-16,Stephen F. Austin,F,17,0,45,8,20,.400,8,20,.400,0,0,,3,8,.375,6,10,16,1,2,3,3,7,19,0.7
6964,Austin Davis\austin-davis-1,2017-18,Michigan,F,16,0,50,9,14,.643,9,14,.643,0,0,,1,3,.333,7,15,22,0,1,6,3,15,19,1.1
6965,T.J. Maston\tj-maston-1,2014-15,Baylor,F,11,0,36,8,15,.533,8,15,.533,0,0,,3,4,.750,5,5,10,1,2,1,3,5,19,1.3
6966,Kory Kuenstling\kory-kuenstling-1,2017-18,Drake,F,20,1,105,6,14,.429,6,14,.429,0,0,,7,10,.700,6,11,17,3,1,4,8,26,19,0.3
6967,Jibreel Faulkner\jibreel-faulkner-1,2016-17,Canisius,F,6,0,34,6,13,.462,4,9,.444,2,4,.500,5,8,.625,4,3,7,2,0,0,3,4,19,1.9
6968,Ilias Theodorou\ilias-theodorou-1,2014-15,Pacific,F,11,0,64,7,18,.389,4,9,.444,3,9,.333,2,5,.400,4,5,9,1,1,0,3,9,19,0.7
6969,Tim Priller\tim-priller-1,2016-17,Indiana,F,10,0,27,7,9,.778,7,9,.778,0,0,,5,6,.833,4,7,11,4,0,2,1,7,19,2.0
6970,Leke Solanke\leke-solanke-1,2013-14,Stetson,F,25,0,148,7,10,.700,7,10,.700,0,0,,5,8,.625,6,12,18,1,2,5,7,25,19,0.4
6971,Eric Rwahwire\eric-rwahwire-1,2015-16,UC-Riverside,F,11,0,71,6,24,.250,4,13,.308,2,11,.182,5,7,.714,1,10,11,6,0,0,6,11,19,0.1
6972,Yevgen Sakhniuk\yevgen-sakhniuk-1,2016-17,La Salle,F,17,1,83,8,18,.444,8,18,.444,0,0,,3,6,.500,5,5,10,5,1,2,5,13,19,0.5
6973,Rashard Todd\rashard-todd-1,2015-16,Cal State Fullerton,F,6,0,43,7,16,.438,4,7,.571,3,9,.333,2,3,.667,3,5,8,1,3,1,2,4,19,2.4
6974,Elijah Foster\elijah-foster-1,2014-15,Nevada,F,21,0,133,8,17,.471,8,17,.471,0,0,,3,3,1.000,10,25,35,2,2,0,3,20,19,0.8
6975,M.J. Cage\mj-cage-1,2017-18,Oregon,F,11,0,71,8,13,.615,7,12,.583,1,1,1.000,2,4,.500,9,15,24,2,0,1,3,7,19,1.8
6976,Maurice Taylor\maurice-taylor-2,2013-14,North Carolina A&T,F,26,5,194,4,22,.182,4,16,.250,0,6,.000,11,23,.478,20,30,50,13,7,6,23,38,19,0.2
6977,Mike Layssard\mike-layssard-1,2017-18,Rhode Island,F,13,0,37,9,13,.692,9,13,.692,0,0,,1,2,.500,2,8,10,1,0,1,2,6,19,1.1
6978,Mario Matasovic\mario-matasovic-1,2013-14,Western Michigan,F,24,0,133,7,18,.389,7,16,.438,0,2,.000,5,7,.714,9,9,18,3,3,4,12,25,19,0.1
6979,Adida Ikongshul\adida-ikongshul-1,2017-18,Western Michigan,F,16,0,125,8,21,.381,6,18,.333,2,3,.667,1,3,.333,9,21,30,5,1,0,8,21,19,0.5
6980,Serigne Mboup\serigne-mboup-1,2014-15,Austin Peay,F,21,0,104,4,17,.235,4,17,.235,0,0,,11,16,.688,11,7,18,5,2,3,11,23,19,0.2
6981,Sacar Anim\sacar-anim-1,2015-16,Marquette,F,17,0,83,8,17,.471,6,12,.500,2,5,.400,1,6,.167,5,2,7,1,4,0,5,9,19,0.5
6982,Desmond Hubert\desmond-hubert-1,2013-14,North Carolina,F,31,0,190,7,15,.467,7,15,.467,0,0,,5,17,.294,17,17,34,3,0,12,8,21,19,0.6
6983,Otas Iyekekpolor\otas-iyekekpolor-1,2014-15,Central Arkansas,F,23,0,149,5,16,.313,3,11,.273,2,5,.400,7,12,.583,5,11,16,3,1,8,11,28,19,0.0
6984,Raphael Akpejiori\raphael-akpejiori-1,2013-14,Miami (FL),F,25,7,267,5,15,.333,5,15,.333,0,0,,9,15,.600,16,28,44,2,1,12,7,40,19,0.6
6985,Shane Randall\shane-randall-1,2014-15,Maryland-Eastern Shore,F,22,2,127,5,22,.227,5,22,.227,0,0,,9,12,.750,12,13,25,3,0,2,8,18,19,0.2
6986,Cameron Walker\cameron-walker-1,2016-17,Stanford,F,14,0,99,4,11,.364,4,10,.400,0,1,.000,11,16,.688,7,18,25,3,3,1,8,14,19,1.0
6987,Assane Diop\assane-diop-1,2015-16,Austin Peay,F,21,0,99,9,28,.321,8,27,.296,1,1,1.000,0,1,.000,6,16,22,11,1,2,9,22,19,0.2
6988,Geremy McKay\geremy-mckay-1,2016-17,Eastern Washington,F,10,3,50,6,8,.750,6,8,.750,0,0,,7,13,.538,10,4,14,0,1,1,2,8,19,1.8
6989,Michael Wolfe\michael-wolfe-1,2016-17,North Carolina Central,F,17,3,60,6,13,.462,4,5,.800,2,8,.250,5,8,.625,2,8,10,0,1,1,2,12,19,0.6
6990,Erik Copes\erik-copes-1,2014-15,George Mason,F,4,0,66,5,10,.500,5,10,.500,0,0,,9,11,.818,10,7,17,2,0,4,1,13,19,5.1
6991,Xavier Dupree\xavier-dupree-1,2016-17,Houston,F,17,2,97,7,19,.368,3,9,.333,4,10,.400,1,2,.500,4,17,21,7,5,4,7,18,19,0.9
6992,Skyler White\skyler-white-1,2015-16,Idaho,F,9,0,46,8,23,.348,7,14,.500,1,9,.111,2,5,.400,5,17,22,6,1,1,2,5,19,1.7
6993,Justin Dueck\justin-dueck-1,2013-14,UC-Davis,F,21,13,246,8,14,.571,8,14,.571,0,0,,3,8,.375,20,14,34,3,1,5,7,47,19,0.4
6994,Quentin Scott\quentin-scott-1,2017-18,Texas State,F,13,0,64,6,23,.261,6,18,.333,0,5,.000,7,18,.389,9,10,19,1,2,1,2,10,19,0.6
6995,Dale Francis\dale-francis-1,2013-14,Texas A&M-Corpus Christi,F,26,0,126,8,16,.500,5,12,.417,3,4,.750,0,2,.000,3,10,13,1,0,2,10,32,19,-0.2
6996,Javin DeLaurier\javin-delaurier-1,2016-17,Duke,F,12,0,86,9,11,.818,9,10,.900,0,1,.000,1,4,.250,8,15,23,1,4,4,8,21,19,1.2
6997,Kerwin Smith\kerwin-smith-1,2017-18,Grand Canyon,F,16,0,66,8,13,.615,8,13,.615,0,0,,3,7,.429,7,11,18,3,1,4,7,14,19,0.8
6998,Jacob Kilgore\jacob-kilgore-1,2015-16,Marshall,F,14,0,55,6,14,.429,1,2,.500,5,12,.417,1,2,.500,3,3,6,1,3,1,0,5,18,1.1
6999,Joshu'a Warren\joshua-warren-1,2015-16,Maryland-Eastern Shore,F,10,5,93,7,17,.412,7,17,.412,0,0,,4,8,.500,11,5,16,0,4,4,12,19,18,0.4
7000,Nick Macarchuk\nick-macarchuk-3,2017-18,American,F,18,0,212,8,12,.667,7,11,.636,1,1,1.000,1,4,.250,12,11,23,13,8,2,10,37,18,0.9
7001,Mike Kirkland\mike-kirkland-1,2015-16,Fairfield,F,11,0,62,5,18,.278,4,15,.267,1,3,.333,7,10,.700,2,7,9,3,3,1,5,9,18,0.6
7002,Ivan Bender\ivan-bender-1,2015-16,Maryland,F,10,0,43,7,9,.778,7,9,.778,0,0,,4,9,.444,3,14,17,3,1,0,4,5,18,1.6
7003,Giovanni Fraser\giovanni-fraser-1,2016-17,IUPUI,F,15,0,82,6,14,.429,6,14,.429,0,0,,6,14,.429,4,11,15,0,0,4,6,19,18,0.2
7004,Jerimyjah Batts\jerimyjah-batts-1,2015-16,Coppin State,F,14,5,90,7,18,.389,7,18,.389,0,0,,4,6,.667,14,8,22,2,2,2,6,31,18,0.4
7005,Roderick Davis\roderick-davis-1,2015-16,Wright State,F,12,0,50,8,15,.533,8,14,.571,0,1,.000,2,6,.333,3,6,9,2,0,2,5,13,18,0.5
7006,Lachlan Anderson\lachlan-anderson-1,2017-18,Eastern Kentucky,F,13,0,40,5,6,.833,4,5,.800,1,1,1.000,7,10,.700,1,11,12,2,0,0,3,3,18,1.2
7007,Tommy Williams\tommy-williams-2,2014-15,East Tennessee State,F,14,0,93,6,23,.261,6,23,.261,0,0,,6,13,.462,14,16,30,0,2,3,7,17,18,0.5
7008,Stefan Micovic\stefan-micovic-1,2013-14,Maine,F,14,4,130,6,18,.333,6,18,.333,0,0,,6,11,.545,10,19,29,1,4,3,12,27,18,0.2
7009,Trey Carver\trey-carver-1,2016-17,Hampton,F,20,0,156,7,27,.259,7,24,.292,0,3,.000,4,11,.364,10,17,27,1,0,0,5,9,18,0.2
7010,Deividas Zemgulis\deividas-zemgulis-1,2017-18,Penn State,F,23,2,134,6,20,.300,2,4,.500,4,16,.250,2,2,1.000,9,8,17,4,3,1,3,12,18,0.6
7011,Jai Williams\jai-williams-1,2014-15,Saint Joseph's,F,14,0,98,8,13,.615,8,13,.615,0,0,,2,4,.500,6,10,16,1,4,4,5,22,18,0.9
7012,Deverin Muff\deverin-muff-1,2013-14,Eastern Kentucky,F,29,0,111,6,10,.600,6,10,.600,0,0,,6,18,.333,6,9,15,0,4,5,7,28,18,0.2
7013,Kyle Haber\kyle-haber-1,2016-17,Brown,F,8,0,43,6,12,.500,5,8,.625,1,4,.250,5,9,.556,3,3,6,1,1,1,0,1,18,1.9
7014,Michael Hurt\michael-hurt-1,2016-17,Minnesota,F,25,0,149,6,20,.300,4,6,.667,2,14,.143,4,4,1.000,4,9,13,6,2,1,6,12,18,0.3
7015,Brandon Eddlestone\brian-eddlestone-1,2016-17,Louisiana State,F,12,1,100,7,14,.500,5,10,.500,2,4,.500,2,4,.500,15,11,26,1,0,1,3,12,18,1.5
7016,Stetson Billings\stetson-billings-1,2015-16,Little Rock,F,29,1,224,7,30,.233,6,25,.240,1,5,.200,3,6,.500,11,21,32,10,5,5,8,34,18,0.2
7017,Aaron Epps\aaron-epps-1,2014-15,Louisiana State,F,14,2,86,8,24,.333,6,16,.375,2,8,.250,0,0,,9,11,20,4,4,5,6,9,18,1.1
7018,Josh Fuller\josh-fuller-1,2013-14,Weber State,F,11,0,51,6,9,.667,4,5,.800,2,4,.500,4,5,.800,4,11,15,0,1,1,4,7,18,1.3
7019,Mitch Hill\mitch-hill-1,2017-18,Winthrop,F,24,1,63,6,16,.375,0,1,.000,6,15,.400,0,0,,5,12,17,4,4,1,4,4,18,0.8
7020,Trevond Barnes\trevond-barnes-1,2015-16,Hampton,F,14,0,84,8,17,.471,8,16,.500,0,1,.000,2,8,.250,10,10,20,0,3,6,4,14,18,1.0
7021,Jeremy Combs\jeremy-combs-1,2017-18,Louisiana State,F,6,0,52,7,11,.636,7,11,.636,0,0,,4,8,.500,4,8,12,4,2,3,4,13,18,2.4
7022,Omar Beauperthuy\omar-beauperthuy-1,2014-15,Alcorn State,F,22,0,182,7,21,.333,7,19,.368,0,2,.000,4,6,.667,10,18,28,5,0,2,11,26,18,0.1
7023,Leo Edwards\leo-edwards-1,2014-15,Louisiana Tech,F,20,0,100,7,12,.583,7,12,.583,0,0,,4,5,.800,9,17,26,1,0,4,9,18,18,0.5
7024,Ludovic Ndaye\ludovic-ndaye-1,2013-14,Cleveland State,F,6,0,51,8,13,.615,8,13,.615,0,0,,2,3,.667,6,8,14,0,1,5,1,11,18,2.9
7025,Semi Ojeleye\semi-ojeleye-1,2014-15,Duke,F,6,0,63,5,18,.278,1,2,.500,4,16,.250,4,7,.571,3,11,14,1,3,0,0,11,18,1.8
7026,Pape Diatta\pape-diatta-1,2017-18,Georgia,F,15,1,121,5,14,.357,1,6,.167,4,8,.500,4,8,.500,4,14,18,5,4,1,6,14,18,0.8
7027,David Bottenberg\david-bottenberg-1,2016-17,South Carolina State,F,25,1,155,7,20,.350,7,20,.350,0,0,,4,7,.571,8,13,21,1,2,2,5,27,18,0.1
7028,Andy Van Vliet\andy-vanvliet-1,2016-17,Wisconsin,F,13,0,48,6,17,.353,3,9,.333,3,8,.375,3,4,.750,5,15,20,2,0,2,2,3,18,1.2
7029,Malik London\malik-london-1,2015-16,Tennessee-Martin,F,13,1,86,9,15,.600,9,15,.600,0,0,,0,6,.000,9,16,25,2,1,3,8,19,18,0.7
7030,Steve Smith\steve-smith-6,2015-16,Fairfield,F,14,0,93,6,21,.286,0,0,,6,21,.286,0,0,,1,10,11,3,3,1,3,9,18,0.6
7031,Precious Ayah\precious-ayah-1,2017-18,Miami (OH),F,15,2,67,4,14,.286,4,13,.308,0,1,.000,10,11,.909,8,13,21,4,3,5,4,15,18,1.2
7032,Reid Aube\reid-aube-1,2016-17,Charlotte,F,22,3,158,6,13,.462,6,13,.462,0,0,,6,7,.857,16,16,32,1,3,6,8,34,18,0.6
7033,Aaron Ariri\aaron-ariri-1,2016-17,Troy,F,13,0,57,6,11,.545,6,10,.600,0,1,.000,6,13,.462,11,6,17,1,0,3,4,10,18,1.1
7034,Clark Lammert\clark-lammert-1,2014-15,Texas Tech,F,29,1,212,6,16,.375,5,13,.385,1,3,.333,5,14,.357,20,22,42,15,4,2,8,16,18,1.0
7035,Leo Edwards\leo-edwards-1,2016-17,Kent State,F,18,1,80,9,22,.409,9,22,.409,0,0,,0,2,.000,9,10,19,0,3,3,2,14,18,0.7
7036,Grant Golden\grant-golden-1,2016-17,Richmond,F,9,0,68,7,20,.350,6,15,.400,1,5,.200,3,9,.333,3,15,18,8,0,2,3,9,18,1.3
7037,Kodye Pugh\kodye-pugh-1,2017-18,Stanford,F,17,1,106,6,19,.316,5,10,.500,1,9,.111,5,10,.500,5,4,9,6,3,1,11,10,18,0.2
7038,Brenden Morris\brenden-morris-1,2017-18,Weber State,F,8,0,37,8,13,.615,6,8,.750,2,5,.400,0,1,.000,3,11,14,0,3,2,3,8,18,1.9
7039,Jordan Naughton\jordan-naughton-1,2017-18,Wyoming,F,9,0,71,8,14,.571,8,14,.571,0,0,,2,3,.667,2,9,11,0,1,1,3,8,18,1.2
7040,Mike Owona\mike-owona-1,2016-17,North Carolina A&T,F,16,4,146,9,13,.692,9,13,.692,0,0,,0,4,.000,7,19,26,0,4,8,7,24,18,0.9
7041,Tanner Borchardt\tanner-borchardt-1,2017-18,Nebraska,F,20,0,118,6,13,.462,6,13,.462,0,0,,6,14,.429,17,19,36,2,2,4,2,23,18,1.0
7042,Brenden Morris\brenden-morris-1,2016-17,Weber State,F,7,0,24,6,13,.462,5,10,.500,1,3,.333,4,5,.800,3,4,7,1,3,1,0,1,17,2.5
7043,LaRon Smith\laron-smith-1,2013-14,Georgia State,F,16,0,68,6,11,.545,6,11,.545,0,0,,5,17,.294,6,7,13,0,3,6,3,10,17,0.8
7044,Quincy Ford\quincy-ford-1,2013-14,Northeastern,F,2,2,53,5,17,.294,2,7,.286,3,10,.300,4,6,.667,0,4,4,4,2,0,1,6,17,4.5
7045,John Baker\john-baker-1,2014-15,Incarnate Word,F,14,0,105,7,18,.389,7,18,.389,0,0,,3,6,.500,5,16,21,0,1,0,1,10,17,0.7
7046,Kasper Christensen\kasper-christensen-1,2017-18,Florida International,F,10,0,56,5,17,.294,0,1,.000,5,16,.313,2,3,.667,0,5,5,1,3,3,1,8,17,1.0
7047,Galen Alexander\galen-alexander-1,2017-18,Louisiana State,F,9,0,55,6,16,.375,4,5,.800,2,11,.182,3,4,.750,5,14,19,1,1,0,2,5,17,1.5
7048,Nick Fuller\nick-fuller-1,2016-17,Nebraska,F,15,0,85,6,9,.667,6,9,.667,0,0,,5,7,.714,5,12,17,4,2,0,1,15,17,1.1
7049,Akoy Agau\akoy-agau-1,2013-14,Louisville,F,19,0,95,7,9,.778,7,8,.875,0,1,.000,3,10,.300,5,16,21,1,1,5,7,9,17,0.7
7050,Abdul Sarki\abdul-sarki-1,2017-18,Charleston Southern,F,6,0,45,6,14,.429,6,14,.429,0,0,,5,6,.833,13,3,16,0,1,0,3,7,17,2.4
7051,Harrison Henderson\harrison-henderson-1,2016-17,Southern California,F,13,0,50,5,14,.357,3,9,.333,2,5,.400,5,12,.417,1,11,12,2,2,4,2,5,17,1.0
7052,Ramon Eaton\ramon-eaton-1,2013-14,North Carolina Central,F,13,0,79,5,13,.385,5,10,.500,0,3,.000,7,12,.583,6,5,11,0,4,0,5,11,17,0.6
7053,Milan Mijovic\milan-mijovic-1,2015-16,Marshall,F,13,0,52,5,11,.455,5,11,.455,0,0,,7,14,.500,7,9,16,3,0,1,3,12,17,0.9
7054,Luke Rosinski\luke-rosinski-1,2017-18,New Hampshire,F,12,0,64,3,13,.231,3,12,.250,0,1,.000,11,17,.647,9,9,18,3,5,0,6,5,17,1.2
7055,Joe Hanel\joe-hanel-1,2015-16,DePaul,F,18,0,153,8,16,.500,8,16,.500,0,0,,1,4,.250,6,11,17,3,0,0,4,28,17,0.1
7056,Jakob Stenhede\jakob-stenhede-1,2015-16,Maryland-Baltimore County,F,14,0,83,6,14,.429,6,14,.429,0,0,,5,12,.417,5,12,17,0,0,3,3,15,17,0.5
7057,Aron Phillips-Nwankwo\aron-nwankwo-1,2014-15,Pittsburgh,F,14,0,81,7,13,.538,7,12,.583,0,1,.000,3,3,1.000,4,12,16,1,3,0,2,11,17,1.0
7058,Ja'Kwan Jones\jakwan-jones-1,2016-17,Quinnipiac,F,16,0,104,5,17,.294,5,16,.313,0,1,.000,7,14,.500,11,18,29,1,3,2,5,13,17,0.8
7059,T.J. Bell\tj-bell-1,2013-14,Indiana State,F,18,0,83,8,16,.500,8,16,.500,0,0,,1,3,.333,6,7,13,0,0,3,7,17,17,0.2
7060,Luis Santos\luis-santos-1,2015-16,South Florida,F,15,0,105,3,15,.200,3,15,.200,0,0,,11,15,.733,14,19,33,1,3,3,6,17,17,1.0
7061,Dondre Rhoden\dondre-rhoden-1,2015-16,Fairleigh Dickinson,F,27,0,113,7,16,.438,7,15,.467,0,1,.000,3,6,.500,6,12,18,1,4,5,4,21,17,0.4
7062,Deji Adekunle\dell-adekunle-1,2014-15,Northwestern State,F,17,0,120,7,16,.438,7,16,.438,0,0,,3,9,.333,8,21,29,1,1,2,11,21,17,0.1
7063,James Bento\james-bento-1,2014-15,Mercer,F,13,0,104,7,15,.467,7,14,.500,0,1,.000,3,8,.375,4,20,24,2,2,1,2,14,17,1.0
7064,Trace Cureton\trace-cureton-1,2014-15,Utah State,F,11,0,73,5,18,.278,3,13,.231,2,5,.400,5,8,.625,1,6,7,2,3,0,4,3,17,0.6
7065,Malik Hines\malik-hines-1,2015-16,Massachusetts,F,16,0,158,6,13,.462,6,13,.462,0,0,,5,8,.625,10,28,38,3,3,10,14,28,17,0.7
7066,Christian Negron\christian-negron-1,2017-18,Loyola (IL),F,17,0,71,5,14,.357,5,14,.357,0,0,,7,16,.438,4,9,13,2,1,1,6,12,17,0.2
7067,Zack Tobler\zack-tobler-1,2016-17,Cincinnati,F,13,1,28,4,13,.308,2,8,.250,2,5,.400,7,10,.700,2,5,7,1,2,0,3,6,17,0.7
7068,Vittorio Reynoso-Avila\vittorio-reynoso-avila-1,2017-18,Princeton,F,10,0,38,5,9,.556,5,9,.556,0,0,,7,10,.700,3,3,6,0,0,0,3,6,17,0.9
7069,Andrew Scocca\andrew-scocca-1,2015-16,Bryant,F,23,2,133,3,15,.200,3,15,.200,0,0,,11,14,.786,9,19,28,8,1,6,3,21,17,0.8
7070,Gaston Diedhiou\gaston-diedhiou-1,2015-16,Minnesota,F,24,2,131,6,18,.333,6,18,.333,0,0,,5,8,.625,9,9,18,1,3,3,5,22,17,0.3
7071,Colin Russell\colin-russell-1,2015-16,Portland,F,30,0,241,7,20,.350,7,20,.350,0,0,,3,12,.250,30,27,57,5,10,4,14,41,17,0.6
7072,Obi Romeo\obi-romeo-1,2016-17,Longwood,F,20,0,122,6,12,.500,6,12,.500,0,0,,5,15,.333,12,20,32,1,2,4,4,22,17,0.7
7073,Austin Williams\austin-williams-2,2015-16,Drexel,F,18,1,132,6,17,.353,6,17,.353,0,0,,5,10,.500,11,28,39,2,0,6,7,28,17,0.5
7074,Randall West\randall-west-1,2017-18,Massachusetts,F,8,0,92,6,14,.429,6,14,.429,0,0,,5,8,.625,12,15,27,3,3,3,1,14,17,2.7
7075,Ryan Swan-Ford\ryan-swan-ford-1,2016-17,Air Force,F,9,0,50,7,15,.467,6,11,.545,1,4,.250,2,2,1.000,6,3,9,1,1,0,5,7,17,0.9
7076,Dave Krmpotich\dave-krmpotich-1,2016-17,Colgate,F,7,0,34,7,11,.636,7,10,.700,0,1,.000,3,9,.333,5,4,9,2,0,3,3,7,17,1.7
7077,Gerron Scissum\gerron-scissum-1,2017-18,James Madison,F,7,2,65,5,12,.417,3,6,.500,2,6,.333,5,7,.714,7,10,17,3,2,2,3,7,17,2.5
7078,Bul Ajang\bul-ajang-1,2017-18,Tulane,F,21,4,163,6,25,.240,6,24,.250,0,1,.000,5,8,.625,15,16,31,6,1,3,13,35,17,-0.2
7079,Yves Pons\yves-pons-1,2017-18,Tennessee,F,24,0,124,7,14,.500,5,11,.455,2,3,.667,1,2,.500,4,11,15,5,3,2,5,17,17,0.5
7080,Weisner Perez\weisner-perez-1,2016-17,Harvard,F,9,0,69,3,9,.333,3,6,.500,0,3,.000,11,16,.688,11,17,28,2,3,2,3,5,17,2.6
7081,Marlon Alcindor\marlon-alcindor-1,2015-16,St. Francis (NY),F,8,0,30,5,14,.357,1,5,.200,4,9,.444,3,4,.750,0,2,2,0,0,0,1,3,17,0.9
7082,Marlon Jones\marlon-jones-1,2016-17,New Mexico State,F,3,2,57,7,14,.500,7,13,.538,0,1,.000,3,6,.500,5,4,9,1,0,1,4,11,17,2.2
7083,Chase Johnson\chase-johnson-1,2017-18,Florida,F,4,0,33,6,12,.500,6,12,.500,0,0,,5,6,.833,5,3,8,1,2,2,1,2,17,4.3
7084,Terrance O'Donohue\terrance-odonohue-1,2016-17,College of Charleston,F,19,2,115,5,13,.385,5,10,.500,0,3,.000,7,13,.538,3,10,13,1,5,3,2,22,17,0.5
7085,Braeden Anderson\braeden-anderson-1,2014-15,Fresno State,F,17,7,181,3,17,.176,3,17,.176,0,0,,11,23,.478,14,16,30,3,4,4,8,28,17,0.3
7086,Wanaah Bail\wanaah-bail-1,2014-15,UCLA,F,11,0,99,7,18,.389,7,18,.389,0,0,,3,9,.333,13,16,29,1,1,2,4,8,17,1.3
7087,Aleks Abrams\aleks-abrams-1,2014-15,Cal Poly,F,26,1,196,4,32,.125,4,32,.125,0,0,,9,12,.750,28,27,55,2,1,8,4,36,17,0.5
7088,Zach Korkowski\zach-korkowski-1,2015-16,Wofford,F,13,1,38,6,6,1.000,6,6,1.000,0,0,,5,5,1.000,4,5,9,5,2,0,3,7,17,1.5
7089,Darius Hicks\darius-hicks-1,2017-18,North Carolina State,F,4,0,34,7,10,.700,7,10,.700,0,0,,3,4,.750,9,3,12,1,1,0,0,3,17,5.0
7090,Jai Williams\jai-williams-1,2017-18,Saint Joseph's,F,12,1,47,7,12,.583,7,12,.583,0,0,,3,5,.600,2,3,5,0,0,2,1,9,17,0.8
7091,Jesse Tesmer\jesse-tesmer-1,2014-15,Chicago State,F,19,4,161,6,22,.273,6,22,.273,0,0,,5,6,.833,5,9,14,0,3,1,7,20,17,-0.1
7092,Marshawn Blackmon\marshawn-blackmon-1,2016-17,Eastern Illinois,F,8,0,48,7,15,.467,7,14,.500,0,1,.000,2,5,.400,5,4,9,1,1,1,4,7,16,0.9
7093,Zach Cottrell\zach-cottrell-1,2016-17,Appalachian State,F,11,0,57,6,18,.333,4,6,.667,2,12,.167,2,4,.500,3,0,3,4,2,0,3,5,16,0.6
7094,Bray Barnes\bray-barnes-1,2015-16,Cal State Bakersfield,F,20,0,78,4,11,.364,4,7,.571,0,4,.000,8,10,.800,5,3,8,0,1,2,3,21,16,0.2
7095,George Thomas\george-thomas-1,2013-14,Alcorn State,F,25,1,169,6,19,.316,3,9,.333,3,10,.300,1,1,1.000,6,15,21,3,3,1,10,21,16,0.0
7096,Ben Freeland\ben-freeland-1,2014-15,Lafayette,F,20,0,66,6,17,.353,6,17,.353,0,0,,4,10,.400,5,7,12,2,1,0,4,16,16,0.1
7097,Ilias Theodorou\ilias-theodorou-1,2016-17,Pacific,F,10,0,58,6,17,.353,3,7,.429,3,10,.300,1,3,.333,5,8,13,3,0,1,7,5,16,0.5
7098,Samuel Dingba\samuel-dingba-1,2014-15,Quinnipiac,F,18,1,144,5,13,.385,5,13,.385,0,0,,6,10,.600,10,21,31,4,3,7,8,27,16,0.7
7099,Kwesi Abakah\kwesi-abakah-1,2013-14,Northeastern,F,16,0,62,7,11,.636,7,11,.636,0,0,,2,5,.400,5,6,11,1,0,1,3,12,16,0.6
7100,Brian Oddo\brian-oddo-1,2015-16,Miami (OH),F,10,2,87,5,15,.333,2,3,.667,3,12,.250,3,4,.750,4,10,14,3,0,0,5,9,16,0.6
7101,Damonte Dodd\damonte-dodd-1,2013-14,Maryland,F,22,1,166,7,19,.368,7,19,.368,0,0,,2,16,.125,19,14,33,1,3,9,8,27,16,0.4
7102,Jesse Bunting\jesse-bunting-1,2017-18,Fordham,F,5,1,45,7,10,.700,7,10,.700,0,0,,2,2,1.000,6,5,11,1,1,1,1,6,16,3.3
7103,Michael Green\michael-green-2,2013-14,Tennessee State,F,5,1,83,6,26,.231,4,16,.250,2,10,.200,2,2,1.000,4,9,13,3,1,5,8,9,16,0.1
7104,Elijah Barnes\elijah-barnes-1,2017-18,Princeton,F,9,0,55,5,16,.313,3,9,.333,2,7,.286,4,7,.571,4,14,18,1,0,0,4,6,16,0.8
7105,Nate Rohrer\nate-rohrer-1,2016-17,Vermont,F,13,0,111,6,13,.462,6,13,.462,0,0,,4,5,.800,4,13,17,11,3,1,2,9,16,1.6
7106,Clint Thomas\clint-thomas-1,2013-14,Idaho State,F,11,0,48,6,11,.545,3,5,.600,3,6,.500,1,2,.500,0,3,3,2,0,0,1,5,16,0.9
7107,Fred Haywood\fred-haywood-2,2017-18,McNeese State,F,13,0,28,7,13,.538,7,12,.583,0,1,.000,2,5,.400,5,4,9,0,4,0,0,3,16,1.2
7108,Isaiah Green\isaiah-green-1,2017-18,Eastern Michigan,F,17,1,92,7,15,.467,7,14,.500,0,1,.000,2,3,.667,3,17,20,1,5,5,2,7,16,1.1
7109,Henry Uwadiae\henry-uwadiae-1,2014-15,Green Bay,F,17,0,89,7,11,.636,7,11,.636,0,0,,2,7,.286,4,9,13,2,1,15,9,26,16,0.5
7110,Kevin Holmes Jr.\kevin-holmesjr-1,2016-17,Coastal Carolina,F,17,0,124,6,33,.182,3,8,.375,3,25,.120,1,3,.333,6,16,22,0,0,0,6,13,16,-0.5
7111,Jonathan Davis\jonathan-davis-2,2016-17,Baylor,F,12,0,23,5,9,.556,4,7,.571,1,2,.500,5,6,.833,1,0,1,0,0,0,2,1,16,0.8
7112,Nick Loew\nick-loew-1,2017-18,San Francisco,F,9,3,76,6,12,.500,6,12,.500,0,0,,4,6,.667,7,7,14,3,2,1,2,9,16,1.7
7113,Derek Willis\derek-willis-1,2013-14,Kentucky,F,14,0,39,3,9,.333,2,3,.667,1,6,.167,9,12,.750,1,7,8,0,1,0,4,0,16,0.7
7114,Jevon Estelle\jevon-estelle-1,2013-14,Grand Canyon,F,10,0,55,6,11,.545,5,8,.625,1,3,.333,3,5,.600,4,2,6,3,0,0,5,6,16,0.8
7115,Andrew Hampton\andrew-hampton-1,2015-16,Morgan State,F,4,1,52,5,16,.313,0,4,.000,5,12,.417,1,2,.500,0,4,4,2,1,1,0,8,16,1.9
7116,Brandon McDonnell\brandon-mcdonnell-1,2014-15,Dartmouth,F,7,0,48,7,18,.389,6,13,.462,1,5,.200,1,2,.500,8,9,17,1,2,3,4,13,16,1.4
7117,Stephen Vassor\stephen-vassor-1,2017-18,Old Dominion,F,18,2,108,6,11,.545,6,11,.545,0,0,,4,4,1.000,8,14,22,1,3,1,6,16,16,0.7
7118,Terrance O'Donohue\terrance-odonohue-1,2013-14,College of Charleston,F,17,0,64,4,9,.444,3,8,.375,1,1,1.000,7,11,.636,4,7,11,0,1,2,8,8,16,0.3
7119,Terron Gilmore\terron-gilmore-1,2013-14,Murray State,F,18,1,134,5,13,.385,5,13,.385,0,0,,6,10,.600,6,14,20,1,6,3,10,35,16,0.0
7120,Nick Shepherd\nick-shepherd-1,2013-14,Cal State Long Beach,F,13,1,128,7,16,.438,7,16,.438,0,0,,2,2,1.000,9,17,26,1,1,10,5,14,16,1.3
7121,Michael Obindu\michael-obindu-1,2017-18,Howard,F,19,2,134,7,17,.412,7,17,.412,0,0,,2,5,.400,6,22,28,4,2,2,5,22,16,0.5
7122,Derrick Flowers\derrick-flowers-3,2017-18,Jacksonville,F,15,0,142,5,18,.278,2,8,.250,3,10,.300,3,5,.600,6,12,18,2,2,0,8,15,16,0.1
7123,Steve Harris\steve-harris-3,2015-16,Austin Peay,F,12,0,36,7,16,.438,6,14,.429,1,2,.500,1,5,.200,6,4,10,0,2,1,1,3,16,1.0
7124,Seth Berger\seth-berger-1,2014-15,Massachusetts,F,8,8,109,6,16,.375,4,10,.400,2,6,.333,2,2,1.000,7,9,16,6,11,2,5,17,16,2.5
7125,Scott Blakney\scott-blakney-1,2017-18,Idaho,F,16,0,90,7,14,.500,7,14,.500,0,0,,2,3,.667,5,9,14,1,0,1,7,18,16,0.1
7126,Balsa Dragovic\balsa-dragovic-1,2015-16,Harvard,F,9,1,44,5,11,.455,3,7,.429,2,4,.500,4,4,1.000,4,9,13,1,0,1,4,7,16,1.2
7127,Garrett Mayleben\garrett-mayleben-1,2014-15,Bowling Green State,F,22,0,190,7,26,.269,5,12,.417,2,14,.143,0,0,,8,15,23,0,0,2,6,17,16,0.0
7128,Dionte Adams\dionte-adams-1,2013-14,Hampton,F,18,0,115,6,14,.429,6,14,.429,0,0,,4,8,.500,6,14,20,4,3,3,7,18,16,0.5
7129,Nolan Wilson\nolan-wilson-1,2016-17,Prairie View,F,24,0,168,6,11,.545,6,11,.545,0,0,,4,10,.400,5,17,22,1,3,12,6,33,16,0.4
7130,Troy Henderson\troy-henderson-1,2015-16,Mount St. Mary's,F,19,6,121,5,19,.263,1,3,.333,4,16,.250,2,3,.667,3,4,7,0,0,3,4,14,16,0.0
7131,Larry Johnson\larry-johnson-5,2014-15,Youngstown State,F,22,0,92,5,15,.333,5,15,.333,0,0,,6,12,.500,6,16,22,2,4,3,3,27,16,0.4
7132,Adam Webb\adam-webb-1,2017-18,Stetson,F,13,0,76,8,20,.400,8,20,.400,0,0,,0,0,,6,11,17,0,0,8,6,18,16,0.4
7133,Leon Tolksdorf\leon-tolksdorf-1,2013-14,Connecticut,F,13,0,47,6,21,.286,3,8,.375,3,13,.231,1,2,.500,3,7,10,4,1,0,3,5,16,0.5
7134,Kevin Chuisseu\kevin-chuisseu-1,2013-14,Furman,F,17,3,115,6,16,.375,6,15,.400,0,1,.000,4,10,.400,10,12,22,2,2,5,5,10,16,0.8
7135,Cal Kennedy\cal-kennedy-1,2015-16,Loyola (IL),F,14,0,36,7,13,.538,5,8,.625,2,5,.400,0,0,,5,6,11,0,0,0,2,4,16,0.8
7136,Jerred Kite\jerred-kite-1,2015-16,Incarnate Word,F,22,3,126,6,14,.429,6,14,.429,0,0,,4,11,.364,7,10,17,4,6,5,8,18,16,0.5
7137,Dane Norman\dane-norman-1,2015-16,Air Force,F,15,0,45,6,12,.500,5,8,.625,1,4,.250,3,6,.500,3,8,11,1,0,2,1,3,16,0.9
7138,Paulin Mpawe\paulin-mpawe-1,2015-16,Idaho,F,16,1,88,4,13,.308,4,13,.308,0,0,,7,11,.636,11,8,19,1,3,1,4,15,15,0.7
7139,Maxwell Kupchak\maxwell-kupchak-1,2017-18,UC-Santa Barbara,F,21,1,114,6,12,.500,6,12,.500,0,0,,3,7,.429,4,22,26,5,3,5,5,15,15,0.8
7140,Karim Sameh Azab\karim-samehazab-1,2017-18,Memphis,F,15,1,84,7,21,.333,7,21,.333,0,0,,1,3,.333,1,10,11,5,1,2,4,9,15,0.3
7141,Matt Killian\matt-killian-1,2013-14,Northwestern State,F,22,6,160,5,22,.227,4,13,.308,1,9,.111,4,6,.667,5,15,20,7,12,6,6,14,15,0.8
7142,Ebube Ebube\ebube-ebube-1,2017-18,Manhattan,F,25,0,178,6,19,.316,6,15,.400,0,4,.000,3,9,.333,21,13,34,10,10,5,7,33,15,0.8
7143,Nick Havener\nick-havener-1,2014-15,Boston University,F,16,2,130,6,16,.375,6,13,.462,0,3,.000,3,5,.600,12,20,32,3,6,1,10,20,15,0.7
7144,Max Bielfeldt\max-bielfeldt-1,2013-14,Michigan,F,19,0,89,6,21,.286,3,12,.250,3,9,.333,0,1,.000,8,12,20,0,2,2,2,14,15,0.4
7145,Ali Mackay\ali-mackay-1,2013-14,Davidson,F,15,0,52,6,8,.750,5,6,.833,1,2,.500,2,4,.500,4,8,12,2,0,0,1,5,15,1.0
7146,Jeff Drew\jeff-drew-2,2013-14,Central Arkansas,F,8,1,105,7,21,.333,6,20,.300,1,1,1.000,0,0,,7,15,22,2,4,4,11,25,15,0.0
7147,Jackson Davis\jackson-davis-1,2014-15,Butler,F,17,0,67,6,17,.353,6,17,.353,0,0,,3,9,.333,3,20,23,0,2,4,3,12,15,0.5
7148,Corey Manigault\corey-manigault-1,2016-17,Pittsburgh,F,18,0,80,5,20,.250,5,17,.294,0,3,.000,5,8,.625,5,10,15,2,0,1,0,13,15,0.3
7149,Patrick Smith\patrick-smith-1,2017-18,Southern,F,5,3,69,5,15,.333,4,12,.333,1,3,.333,4,8,.500,5,3,8,2,0,1,2,7,15,1.3
7150,Logan Hovey\logan-hovey-1,2014-15,Florida Gulf Coast,F,14,0,92,6,14,.429,6,13,.462,0,1,.000,3,9,.333,8,16,24,3,2,1,3,11,15,0.9
7151,Grady Eifert\grady-eifert-1,2016-17,Purdue,F,16,0,46,6,7,.857,6,7,.857,0,0,,3,5,.600,3,5,8,0,1,1,0,3,15,1.0
7152,Mike Aaman\mike-aaman-2,2013-14,Rhode Island,F,5,0,47,7,14,.500,7,14,.500,0,0,,1,1,1.000,5,7,12,1,0,1,3,4,15,2.1
7153,Roderick Taylor\roderick-taylor-2,2015-16,Louisiana-Monroe,F,13,1,61,6,10,.600,6,10,.600,0,0,,3,4,.750,6,6,12,0,2,0,1,13,15,0.9
7154,Lavonne Davis\lavonne-davis-1,2016-17,Prairie View,F,23,4,118,5,11,.455,5,11,.455,0,0,,5,9,.556,5,18,23,0,3,0,6,32,15,0.0
7155,John Cain Carney\john-cain-carney-1,2014-15,Boston College,F,26,0,204,7,16,.438,6,12,.500,1,4,.250,0,3,.000,7,29,36,3,6,2,7,27,15,0.4
7156,Brandon Allen\brandon-allen-4,2014-15,Florida State,F,24,0,116,5,16,.313,2,7,.286,3,9,.333,2,2,1.000,4,10,14,5,4,2,7,21,15,0.2
7157,Clark Wilkinson\clark-wilkinson-1,2016-17,Idaho State,F,16,0,65,4,9,.444,4,9,.444,0,0,,7,9,.778,3,7,10,1,0,0,1,16,15,0.4
7158,Terron Gilmore\terron-gilmore-1,2014-15,Murray State,F,14,0,73,3,9,.333,3,9,.333,0,0,,9,15,.600,8,12,20,1,4,0,10,21,15,0.2
7159,Jeremy Jones\jeremy-jones-4,2016-17,Gonzaga,F,23,0,82,6,16,.375,6,12,.500,0,4,.000,3,5,.600,8,18,26,6,5,3,5,7,15,0.9
7160,Jake Verhagen\jake-verhagen-1,2014-15,Eastern Illinois,F,19,0,81,6,18,.333,3,4,.750,3,14,.214,0,0,,3,11,14,4,2,2,1,6,15,0.7
7161,Marcus Holt\marcus-holt-1,2014-15,Colorado State,F,15,1,89,6,12,.500,6,9,.667,0,3,.000,3,9,.333,9,6,15,0,3,1,2,9,15,0.9
7162,Herve Aholode\herve-aholode-1,2014-15,Gardner-Webb,F,11,0,56,5,16,.313,5,16,.313,0,0,,5,7,.714,8,7,15,1,3,2,4,6,15,1.0
7163,Roman Davis\roman-davis-1,2016-17,University of California,F,14,0,48,7,17,.412,7,16,.438,0,1,.000,1,5,.200,3,8,11,0,0,0,2,8,15,0.3
7164,Jared Bryant\jared-bryant-1,2014-15,Northern Kentucky,F,10,3,69,7,13,.538,7,13,.538,0,0,,1,2,.500,7,12,19,1,0,1,1,16,15,1.1
7165,Brandon Bolden\brandon-bolden-1,2014-15,Kansas State,F,17,0,71,6,12,.500,6,12,.500,0,0,,3,9,.333,5,10,15,1,2,8,7,7,15,0.7
7166,Tavin Askew\tavin-askew-1,2015-16,Incarnate Word,F,12,0,67,7,17,.412,7,16,.438,0,1,.000,1,4,.250,5,7,12,0,2,1,1,15,15,0.5
7167,Djordjije Sljivancanin\djordjije-sljivancanin-1,2016-17,Nevada-Las Vegas,F,10,0,47,6,11,.545,3,7,.429,3,4,.750,0,0,,1,4,5,1,0,1,1,2,15,1.1
7168,Mayan Kiir\mayan-kiir-1,2017-18,Louisiana State,F,8,0,43,5,11,.455,5,11,.455,0,0,,5,9,.556,9,7,16,2,1,2,6,5,15,1.5
7169,Hampus Ahlin\hampus-ahlin-1,2017-18,Tennessee State,F,10,1,71,5,19,.263,2,7,.286,3,12,.250,2,2,1.000,1,7,8,1,2,0,7,5,15,0.0
7170,Ben Milshtein\ben-milshtein-1,2013-14,Mississippi Valley State,F,12,1,57,7,16,.438,7,16,.438,0,0,,1,5,.200,5,10,15,1,0,0,5,16,15,0.1
7171,Harrison Kay\harrison-kay-1,2017-18,Central Connecticut State,F,12,0,54,6,14,.429,6,12,.500,0,2,.000,3,5,.600,5,8,13,1,0,0,4,14,15,0.3
7172,Malik Ondigo\malik-ondigo-1,2017-18,Texas Tech,F,14,0,75,6,13,.462,6,13,.462,0,0,,3,4,.750,4,7,11,0,1,1,9,11,15,0.1
7173,Johncarlos Reyes\johncarlos-reyes-1,2015-16,Boston College,F,7,1,59,7,12,.583,7,12,.583,0,0,,1,4,.250,9,15,24,2,3,3,4,6,15,2.7
7174,Conroy Baltimore\conroy-baltimore-1,2014-15,Lehigh,F,7,1,32,7,11,.636,7,11,.636,0,0,,1,2,.500,3,7,10,0,2,2,1,5,15,2.0
7175,Ben Carter\ben-carter-1,2017-18,Michigan State,F,23,1,178,7,17,.412,7,16,.438,0,1,.000,1,7,.143,8,20,28,20,3,5,8,21,15,0.8
7176,Chris Lester\chris-lester-1,2017-18,New Hampshire,F,4,1,28,6,10,.600,6,10,.600,0,0,,3,5,.600,8,5,13,3,3,1,0,5,15,5.1
7177,Lonnie McElwain\lonnie-mcelwain-1,2014-15,Grambling,F,18,4,186,6,19,.316,6,17,.353,0,2,.000,3,4,.750,8,13,21,1,2,5,13,47,15,-0.7
7178,Garrett Mayleben\garrett-mayleben-1,2015-16,Bowling Green State,F,16,0,96,5,16,.313,4,13,.308,1,3,.333,4,7,.571,2,11,13,2,0,1,5,19,15,-0.1
7179,Nick Jorgensen\nick-jorgensen-1,2013-14,Air Force,F,11,1,127,5,15,.333,3,8,.375,2,7,.286,2,6,.333,7,15,22,5,2,1,2,15,14,1.0
7180,Deividas Zemgulis\deividas-zemgulis-1,2016-17,Penn State,F,18,0,111,5,20,.250,2,6,.333,3,14,.214,1,2,.500,3,9,12,1,2,1,7,21,14,-0.3
7181,Lewis Djonkam\lewis-djonkam-1,2017-18,Virginia Commonwealth,F,20,0,69,4,11,.364,4,11,.364,0,0,,6,12,.500,5,3,8,2,2,3,4,17,14,0.2
7182,John Mooney\john-mooney-1,2016-17,Notre Dame,F,12,0,46,5,8,.625,3,4,.750,2,4,.500,2,2,1.000,6,13,19,2,1,1,1,5,14,1.6
7183,Davin Guinn\davin-guinn-2,2015-16,Brigham Young,F,8,0,26,4,10,.400,3,7,.429,1,3,.333,5,8,.625,5,5,10,1,1,0,1,1,14,1.6
7184,Kameron Dunnican\kameron-dunnican-1,2013-14,Georgia Southern,F,6,0,49,4,4,1.000,4,4,1.000,0,0,,6,6,1.000,1,2,3,0,2,3,2,11,14,2.0
7185,Evan Wessenberg\evan-wessenberg-1,2014-15,North Dakota State,F,17,0,80,7,15,.467,7,14,.500,0,1,.000,0,2,.000,5,4,9,4,2,1,5,10,14,0.4
7186,Shea Rush\shea-rush-1,2016-17,North Carolina,F,20,0,34,4,14,.286,3,11,.273,1,3,.333,5,10,.500,1,3,4,0,2,1,2,4,14,0.2
7187,Goran Pantovic\goran-pantovic-1,2013-14,Drexel,F,12,3,161,6,12,.500,6,12,.500,0,0,,2,5,.400,21,20,41,2,4,19,4,28,14,2.6
7188,Austin Stone\austin-stone-1,2017-18,Portland,F,9,0,48,5,13,.385,4,11,.364,1,2,.500,3,4,.750,3,12,15,2,1,1,0,5,14,1.5
7189,Bryce Jackson\bryce-jackson-1,2016-17,North Texas,F,20,0,83,7,13,.538,7,13,.538,0,0,,0,0,,11,11,22,2,1,2,2,12,14,0.8
7190,Ege Mala\ege-mala-1,2013-14,UC-Irvine,F,13,0,45,5,13,.385,4,10,.400,1,3,.333,3,4,.750,4,2,6,3,0,2,2,6,14,0.7
7191,Patrick Wrencher\patrick-wrencher-1,2013-14,Saint Francis (PA),F,11,0,45,4,6,.667,4,6,.667,0,0,,6,6,1.000,4,5,9,0,0,1,2,3,14,1.2
7192,Tyrell Green\tyrell-green-1,2015-16,Nevada-Las Vegas,F,7,0,38,3,14,.214,1,6,.167,2,8,.250,6,7,.857,3,6,9,2,0,0,2,6,14,0.8
7193,Sai Tummala\sai-tummala-1,2014-15,Arizona State,F,14,0,59,4,12,.333,2,4,.500,2,8,.250,4,6,.667,2,5,7,4,1,0,4,14,14,0.3
7194,Alexsander Milosavljevic\alexsander-milosavljevic-1,2014-15,Abilene Christian,F,21,0,88,7,20,.350,7,20,.350,0,0,,0,0,,12,7,19,1,1,0,6,8,14,0.3
7195,Logan Doyle\logan-doyle-1,2014-15,South Dakota State,F,8,0,29,3,6,.500,3,5,.600,0,1,.000,8,9,.889,3,10,13,2,0,2,1,3,14,2.0
7196,Samson Oyediran\samson-oyediran-1,2016-17,Tennessee State,F,15,0,79,4,12,.333,3,7,.429,1,5,.200,5,9,.556,5,8,13,1,0,0,1,19,14,0.2
7197,Brandon Watkins\brandon-watkins-2,2015-16,West Virginia,F,23,0,125,6,18,.333,6,18,.333,0,0,,2,6,.333,10,14,24,4,1,7,10,30,14,0.0
7198,Matt Sellers\matt-sellers-1,2013-14,Wyoming,F,12,1,83,4,14,.286,4,14,.286,0,0,,6,8,.750,6,5,11,1,1,2,8,13,14,0.1
7199,Brandon Houston\brandon-houston-1,2017-18,Alabama A&M,F,11,0,50,5,16,.313,2,2,1.000,3,14,.214,1,1,1.000,2,2,4,1,1,0,4,2,14,0.3
7200,Daniel Gomis\daniel-gomis-1,2015-16,Oregon State,F,11,2,78,6,10,.600,6,10,.600,0,0,,2,2,1.000,3,4,7,0,1,1,5,25,14,-0.1
7201,Matt Christiansen\matt-christiansen-1,2013-14,San Francisco,F,24,0,141,6,18,.333,6,18,.333,0,0,,2,6,.333,10,8,18,4,1,0,8,26,14,-0.1
7202,Sharife Sergeant\sharife-sergeant-1,2013-14,Stephen F. Austin,F,20,0,66,4,12,.333,4,12,.333,0,0,,6,13,.462,3,5,8,1,1,2,4,12,14,0.1
7203,Ryan Burton\ryan-burton-1,2015-16,Indiana,F,24,0,77,5,9,.556,1,2,.500,4,7,.571,0,1,.000,3,7,10,1,1,0,1,11,14,0.4
7204,Brendan Keane\brendan-keane-1,2013-14,Northern Colorado,F,11,0,82,6,19,.316,5,16,.313,1,3,.333,1,1,1.000,5,2,7,2,1,3,3,21,14,0.0
7205,Wes Noble\wes-noble-1,2016-17,Morehead State,F,6,0,26,5,11,.455,3,7,.429,2,4,.500,2,3,.667,2,1,3,1,5,1,3,4,14,1.9
7206,B.J. Johnson\bj-johnson-2,2013-14,Syracuse,F,10,0,55,6,24,.250,4,8,.500,2,16,.125,0,0,,3,6,9,2,1,3,4,6,14,0.2
7207,Javonntie Jackson\javonntie-jackson-1,2017-18,Cal State Long Beach,F,10,0,65,5,11,.455,5,10,.500,0,1,.000,4,6,.667,3,9,12,2,1,1,8,9,14,0.4
7208,Aaron Foster-Smith\aaron-foster-smith-1,2016-17,Detroit Mercy,F,4,0,57,6,19,.316,5,14,.357,1,5,.200,1,2,.500,7,11,18,1,0,0,4,8,14,1.1
7209,Braeden Anderson\braeden-anderson-1,2015-16,Seton Hall,F,19,0,110,3,12,.250,3,12,.250,0,0,,8,12,.667,9,17,26,1,3,1,4,20,14,0.5
7210,Skyler White\skyler-white-1,2013-14,George Washington,F,16,0,25,4,10,.400,0,2,.000,4,8,.500,2,2,1.000,1,4,5,1,1,1,0,4,14,0.7
7211,Mike Bedulskis\mike-bedulskis-1,2013-14,North Carolina-Asheville,F,6,0,18,4,7,.571,4,7,.571,0,0,,6,9,.667,3,5,8,0,1,0,1,2,14,2.1
7212,Kellon Taylor\kellon-taylor-1,2016-17,Duquesne,F,12,0,58,5,8,.625,4,6,.667,1,2,.500,3,5,.600,2,7,9,0,4,1,2,7,14,1.1
7213,Hefeng Sun\hefeng-sun-1,2014-15,Norfolk State,F,18,1,65,6,11,.545,6,11,.545,0,0,,2,2,1.000,0,4,4,2,1,2,3,9,14,0.4
7214,Austin Mueller\austin-mueller-1,2017-18,Wyoming,F,13,0,85,5,9,.556,3,5,.600,2,4,.500,2,2,1.000,1,5,6,1,1,1,6,13,14,0.2
7215,Domen Omladic\domen-omladic-1,2017-18,Tennessee Tech,F,12,0,46,7,13,.538,7,11,.636,0,2,.000,0,0,,3,7,10,1,1,0,4,14,14,0.3
7216,Mike LeBlanc\mike-leblanc-1,2016-17,Princeton,F,18,0,57,5,15,.333,2,4,.500,3,11,.273,1,2,.500,1,5,6,3,2,1,1,6,14,0.5
7217,Travis Rollo\travis-rollo-1,2014-15,Army,F,24,0,212,6,12,.500,6,12,.500,0,0,,2,8,.250,9,16,25,9,3,5,3,21,14,0.8
7218,Dominic Woodson\dominic-woodson-1,2014-15,Tennessee,F,4,0,48,6,12,.500,6,12,.500,0,0,,2,6,.333,3,5,8,1,3,2,3,12,14,1.8
7219,Hashim Moore\hashim-moore-1,2014-15,Princeton,F,4,0,18,6,9,.667,6,9,.667,0,0,,2,3,.667,2,3,5,1,0,0,2,4,14,2.3
7220,Seth LeDay\seth-leday-1,2016-17,Virginia Tech,F,1,0,25,5,11,.455,5,11,.455,0,0,,4,4,1.000,4,3,7,2,0,0,1,2,14,11.6
7221,Jacob Brown\jacob-brown-1,2017-18,Youngstown State,F,10,1,54,5,14,.357,4,5,.800,1,9,.111,3,4,.750,2,8,10,2,3,1,2,7,14,1.0
7222,Davion Thomas\davion-thomas-1,2017-18,Middle Tennessee,F,13,0,39,5,13,.385,5,10,.500,0,3,.000,3,4,.750,2,2,4,1,1,1,4,6,13,0.3
7223,Nolan Wilson\nolan-wilson-1,2015-16,Prairie View,F,29,0,209,2,10,.200,2,10,.200,0,0,,9,18,.500,11,23,34,5,5,7,5,36,13,0.4
7224,Nolan Narain\nolan-narain-1,2016-17,San Diego State,F,10,0,55,6,18,.333,5,14,.357,1,4,.250,0,0,,3,7,10,0,1,0,3,9,13,0.1
7225,Brent Calhoun\brent-calhoun-1,2013-14,Purdue-Fort Wayne,F,14,0,52,6,14,.429,6,14,.429,0,0,,1,4,.250,6,10,16,1,2,8,9,6,13,0.6
7226,Thomas Smallwood\thomas-smallwood-1,2017-18,Alabama-Birmingham,F,11,1,82,4,17,.235,1,11,.091,3,6,.500,2,2,1.000,5,9,14,3,1,4,5,8,13,0.6
7227,Cedric Wright\cedric-wright-1,2017-18,Morehead State,F,4,0,36,6,9,.667,6,9,.667,0,0,,1,3,.333,4,4,8,0,1,0,4,13,13,1.0
7228,Pierre Mopo\pierre-mopo-1,2013-14,Tennessee-Martin,F,25,6,231,5,10,.500,5,10,.500,0,0,,3,6,.500,19,21,40,0,3,3,8,54,13,0.1
7229,Jakub Jokl\jakub-jokl-1,2016-17,Utah,F,12,0,46,4,7,.571,4,7,.571,0,0,,5,8,.625,1,14,15,1,0,4,3,14,13,0.7
7230,Myles Thornton\myles-thornton-1,2016-17,Incarnate Word,F,20,1,46,4,8,.500,2,2,1.000,2,6,.333,3,3,1.000,0,8,8,0,2,0,0,6,13,0.6
7231,Obi Momah\obi-momah-1,2014-15,Marist,F,14,0,66,4,14,.286,2,7,.286,2,7,.286,3,6,.500,4,12,16,1,2,3,7,11,13,0.2
7232,Ethan Michael\ethan-michael-1,2013-14,Air Force,F,7,3,47,3,12,.250,2,7,.286,1,5,.200,6,10,.600,4,7,11,9,0,3,3,4,13,1.8
7233,Michael Obindu\michael-obindu-1,2016-17,Howard,F,13,1,117,4,10,.400,4,10,.400,0,0,,5,11,.455,14,3,17,1,4,5,7,16,13,0.8
7234,Robin Thompson\robin-thompson-1,2014-15,Missouri State,F,8,3,61,3,11,.273,3,11,.273,0,0,,7,11,.636,4,5,9,3,2,4,3,15,13,0.9
7235,Caleb Hollander\caleb-hollander-1,2017-18,Belmont,F,7,1,35,5,15,.333,2,4,.500,3,11,.273,0,0,,3,5,8,1,1,0,0,4,13,1.2
7236,Blake Brown\blake-brown-1,2015-16,Eastern Michigan,F,17,0,79,6,9,.667,6,9,.667,0,0,,1,3,.333,9,9,18,0,2,2,2,15,13,0.7
7237,Jon Ander Cuadra\jonander-cuadra-1,2015-16,Campbell,F,7,0,31,3,9,.333,3,7,.429,0,2,.000,7,9,.778,4,4,8,0,1,0,3,4,13,1.1
7238,Ryan Schultz\ryan-schultz-1,2013-14,Kansas State,F,15,0,36,3,14,.214,1,3,.333,2,11,.182,5,8,.625,3,4,7,3,4,0,5,7,13,0.3
7239,Jack Anton\jack-anton-1,2017-18,Elon,F,11,1,54,4,7,.571,3,4,.750,1,3,.333,4,7,.571,3,6,9,1,0,0,0,5,13,1.0
7240,Charlendez Brooks\charlendez-brooks-1,2017-18,Western Carolina,F,29,4,202,6,23,.261,6,23,.261,0,0,,1,2,.500,10,18,28,15,2,9,11,24,13,0.3
7241,Houston Kessler\houston-kessler-1,2016-17,Georgia,F,29,1,183,5,18,.278,5,13,.385,0,5,.000,3,5,.600,8,23,31,0,4,0,3,35,13,0.0
7242,Eric Katenda\eric-katenda-1,2014-15,Notre Dame,F,15,0,32,4,17,.235,4,17,.235,0,0,,5,9,.556,1,6,7,1,1,1,1,3,13,0.3
7243,Kwe Askew\kwe-askew-1,2016-17,Long Island University,F,15,0,84,5,12,.417,5,12,.417,0,0,,3,5,.600,5,12,17,2,1,6,2,11,13,0.9
7244,Jordan Barnett\jordan-barnett-1,2015-16,Texas,F,4,0,24,4,7,.571,2,3,.667,2,4,.500,3,4,.750,2,6,8,0,0,0,1,3,13,2.6
7245,Dallas Polk-Hilliard\dallas-polk-hilliard-1,2017-18,South Dakota State,F,5,0,35,5,12,.417,3,7,.429,2,5,.400,1,2,.500,2,5,7,0,0,0,2,5,13,1.0
7246,Emeka Ikezu\emeka-ikezu-1,2013-14,Samford,F,19,0,85,5,9,.556,5,9,.556,0,0,,3,8,.375,7,12,19,1,2,3,5,30,13,0.2
7247,DouDou Gueye\doudou-gueye-1,2016-17,Ball State,F,19,1,114,6,14,.429,6,14,.429,0,0,,1,3,.333,6,16,22,7,6,3,5,19,13,0.7
7248,Bray Barnes\bray-barnes-1,2016-17,Cal State Bakersfield,F,15,0,51,5,12,.417,3,4,.750,2,8,.250,1,2,.500,2,11,13,0,1,0,2,8,13,0.4
7249,Dondre Rhoden\dondre-rhoden-1,2017-18,Fairleigh Dickinson,F,15,0,57,5,7,.714,5,7,.714,0,0,,3,10,.300,3,7,10,1,1,3,2,9,13,0.6
7250,Xavier Williams\xavier-williams-1,2013-14,Alabama A&M,F,12,0,61,4,11,.364,4,11,.364,0,0,,5,8,.625,5,12,17,1,0,1,5,12,13,0.4
7251,Roman Sorkin\roman-sorkin-1,2014-15,Oregon,F,8,0,35,5,11,.455,3,5,.600,2,6,.333,1,2,.500,1,7,8,1,0,1,3,2,13,0.9
7252,Joonas Tahvanainen\joonas-tahvanainen-1,2017-18,Utah Valley,F,15,0,95,5,14,.357,5,9,.556,0,5,.000,3,5,.600,8,14,22,4,2,2,6,16,13,0.5
7253,Wadly Mompremier\wadly-mompremier-1,2013-14,Ohio,F,17,0,74,4,16,.250,4,14,.286,0,2,.000,5,9,.556,5,10,15,0,0,6,3,12,13,0.3
7254,Justin Diecker\justin-diecker-1,2014-15,Kennesaw State,F,12,1,78,5,13,.385,5,13,.385,0,0,,3,6,.500,1,6,7,1,1,3,7,26,13,-0.5
7255,Evan Wardlow\evan-wardlow-1,2015-16,Santa Clara,F,7,4,139,4,17,.235,4,14,.286,0,3,.000,5,8,.625,6,10,16,17,6,2,8,12,13,2.2
7256,Tom Cotter\tom-cotter-1,2017-18,Oakland,F,15,3,90,5,13,.385,5,13,.385,0,0,,3,5,.600,6,18,24,1,0,0,3,10,13,0.6
7257,Luke Litwiller\luke-litwiller-1,2017-18,Illinois State,F,10,1,49,5,8,.625,2,2,1.000,3,6,.500,0,0,,1,3,4,0,2,0,1,8,13,0.9
7258,Obi Momah\obi-momah-1,2015-16,Marist,F,9,0,45,4,13,.308,4,12,.333,0,1,.000,5,10,.500,5,7,12,1,2,2,4,6,13,0.8
7259,Wes Noble\wes-noble-1,2015-16,Morehead State,F,7,0,29,2,11,.182,1,6,.167,1,5,.200,8,10,.800,3,4,7,4,0,0,3,4,13,1.0
7260,Jacquil Taylor\jacquil-taylor-1,2014-15,Purdue,F,6,0,42,5,11,.455,4,7,.571,1,4,.250,2,4,.500,3,9,12,2,1,4,6,1,13,1.7
7261,Dakota Slaughter\dakota-slaughter-1,2013-14,Alabama,F,11,0,29,5,8,.625,2,2,1.000,3,6,.500,0,0,,2,5,7,2,2,1,0,2,13,1.4
7262,Ed Seay\ed-seay-1,2014-15,Texas State,F,9,0,45,6,13,.462,6,11,.545,0,2,.000,1,2,.500,1,6,7,2,0,3,4,5,13,0.7
7263,Edmunds Dukulis\edmunds-dukulis-1,2013-14,Boise State,F,9,0,47,6,12,.500,6,12,.500,0,0,,1,6,.167,4,12,16,1,0,1,2,7,13,0.9
7264,John Joyce\john-joyce-3,2017-18,Chicago State,F,5,0,44,5,17,.294,2,4,.500,3,13,.231,0,0,,2,2,4,1,2,0,2,5,13,0.8
7265,Kevin Hempy\kevin-hempy-1,2016-17,Pepperdine,F,19,3,179,6,15,.400,6,10,.600,0,5,.000,1,7,.143,11,21,32,8,3,0,1,15,13,1.0
7266,Lachlan Anderson\lachlan-anderson-1,2016-17,Eastern Kentucky,F,11,0,50,6,21,.286,5,11,.455,1,10,.100,0,2,.000,6,6,12,3,1,2,2,6,13,0.5
7267,Cameron Smith\cameron-smith-2,2017-18,James Madison,F,6,0,67,5,10,.500,5,10,.500,0,0,,3,5,.600,4,8,12,4,5,1,4,9,13,2.2
7268,Jamel Flash\jamel-flash-1,2014-15,Towson,F,23,1,126,4,14,.286,4,14,.286,0,0,,5,9,.556,8,10,18,0,1,2,4,12,13,0.2
7269,Ikem Eriobuna\ikem-eriobuna-1,2015-16,Missouri-Kansas City,F,8,0,44,3,11,.273,1,4,.250,2,7,.286,5,6,.833,2,5,7,1,0,0,2,3,13,0.8
7270,Olalekan Ajayi\lekan-ajayi-1,2013-14,Eastern Michigan,F,27,0,277,2,21,.095,2,21,.095,0,0,,9,24,.375,26,44,70,4,11,7,11,55,13,0.4
7271,Rashed Anthony\rashed-anthony-1,2015-16,Seton Hall,F,28,0,138,5,11,.455,5,11,.455,0,0,,3,4,.750,2,18,20,5,4,3,5,38,13,0.1
7272,Joshua Oswald\joshua-oswald-1,2014-15,Miami (OH),F,12,0,75,5,17,.294,5,12,.417,0,5,.000,3,4,.750,5,10,15,5,4,1,3,8,13,0.9
7273,Aram Martin\aram-martin-1,2017-18,Bryant,F,6,2,79,5,12,.417,4,9,.444,1,3,.333,2,4,.500,2,6,8,1,1,6,6,15,13,0.5
7274,Maurice Jeffers\maurice-jeffers-2,2013-14,Delaware,F,18,0,84,5,8,.625,5,8,.625,0,0,,3,5,.600,6,7,13,0,0,3,0,17,13,0.6
7275,Ali Mackay\ali-mackay-1,2014-15,Davidson,F,18,1,66,4,6,.667,3,4,.750,1,2,.500,3,4,.750,2,6,8,5,3,0,2,5,12,0.8
7276,Veer Singh\veer-singh-1,2016-17,Seton Hall,F,9,0,84,3,15,.200,1,3,.333,2,12,.167,4,5,.800,2,12,14,1,0,1,5,10,12,0.0
7277,Matt Elmore\matt-elmore-1,2016-17,North Carolina-Wilmington,F,13,0,43,3,10,.300,2,4,.500,1,6,.167,5,6,.833,1,6,7,0,1,1,1,9,12,0.4
7278,Paul Friendshuh\paul-friendshuh-1,2017-18,Richmond,F,22,0,84,4,8,.500,3,7,.429,1,1,1.000,3,8,.375,4,4,8,2,0,1,10,18,12,-0.2
7279,Erkam Kiris\erkam-kiris-1,2016-17,Texas-Arlington,F,17,0,49,6,7,.857,6,7,.857,0,0,,0,2,.000,4,12,16,2,0,2,1,11,12,0.7
7280,Klint Carlson\klint-carlson-1,2014-15,Northern Iowa,F,19,0,60,3,7,.429,1,5,.200,2,2,1.000,4,6,.667,3,6,9,2,1,0,2,3,12,0.6
7281,Logan Lowery\logan-lowery-1,2013-14,Baylor,F,13,0,27,5,7,.714,4,6,.667,1,1,1.000,1,2,.500,1,3,4,2,0,0,2,3,12,0.7
7282,Martin Jones\martin-jones-1,2015-16,North Carolina A&T,F,10,1,48,5,20,.250,3,4,.750,2,16,.125,0,0,,1,4,5,0,1,0,0,8,12,0.0
7283,Callum Barker\callum-barker-1,2017-18,Bradley,F,14,0,69,5,12,.417,5,12,.417,0,0,,2,6,.333,6,4,10,0,3,2,4,10,12,0.4
7284,Denny Burguillos\denny-burguillos-1,2013-14,Georgia State,F,21,1,120,4,7,.571,4,7,.571,0,0,,4,7,.571,5,8,13,1,2,4,5,29,12,0.1
7285,Mamadou Ndaiye\mamadou-ndaiye-1,2015-16,Saint Peter's,F,11,0,64,5,19,.263,5,16,.313,0,3,.000,2,5,.400,6,8,14,0,0,1,5,10,12,-0.2
7286,Jake Johnson\jake-johnson-1,2015-16,Pepperdine,F,12,1,58,4,6,.667,4,6,.667,0,0,,4,10,.400,2,4,6,1,0,1,2,21,12,0.1
7287,Rantavious Gilbert\rantavious-gilbert-1,2014-15,Appalachian State,F,17,0,80,6,18,.333,6,18,.333,0,0,,0,2,.000,7,12,19,2,1,6,5,12,12,0.4
7288,Trevor Stanback\trevor-stanback-1,2017-18,Stanford,F,13,0,52,5,6,.833,5,6,.833,0,0,,2,5,.400,6,5,11,2,3,4,3,7,12,1.2
7289,Zach Korkowski\zach-korkowski-1,2013-14,Wofford,F,10,0,30,3,5,.600,3,3,1.000,0,2,.000,6,6,1.000,2,3,5,0,1,0,5,5,12,0.6
7290,Julius Van Sauers\julius-vansauers-1,2015-16,Long Island University,F,5,0,55,3,12,.250,1,4,.250,2,8,.250,4,4,1.000,3,5,8,2,1,1,5,2,12,1.1
7291,Jon Ander Cuadra\jonander-cuadra-1,2016-17,Campbell,F,5,0,19,6,8,.750,6,8,.750,0,0,,0,0,,4,6,10,1,0,2,1,2,12,2.7
7292,Lacey James\lacey-james-1,2015-16,Rider,F,12,0,60,4,14,.286,4,14,.286,0,0,,4,11,.364,8,5,13,0,2,3,2,10,12,0.5
7293,Aaron Tate\aaron-tate-1,2015-16,Robert Morris,F,3,0,46,6,13,.462,6,13,.462,0,0,,0,0,,4,4,8,1,2,0,1,4,12,3.1
7294,Javonni Harrell\javonni-harrell-1,2017-18,Florida A&M,F,13,0,99,5,17,.294,5,16,.313,0,1,.000,2,6,.333,10,11,21,6,5,1,3,14,12,0.9
7295,Kelvin Gaines\kelvin-gaines-2,2013-14,North Texas,F,19,6,142,6,15,.400,6,15,.400,0,0,,0,4,.000,10,19,29,1,4,9,9,44,12,0.0
7296,David Erebor\david-erebor-1,2017-18,Brown,F,6,0,22,5,7,.714,5,7,.714,0,0,,2,3,.667,7,3,10,0,0,1,2,8,12,1.7
7297,Solomon Hainna\solomon-hainna-1,2017-18,Evansville,F,3,0,42,1,4,.250,1,3,.333,0,1,.000,10,14,.714,2,4,6,2,2,0,2,7,12,3.1
7298,Robert Martin\robert-martin-2,2016-17,Rice,F,17,0,81,4,13,.308,3,7,.429,1,6,.167,3,6,.500,2,14,16,2,1,0,5,15,12,0.0
7299,Terrell Scruggs\terrell-scruggs-1,2015-16,Texas-San Antonio,F,15,0,82,4,14,.286,4,10,.400,0,4,.000,4,10,.400,4,10,14,3,4,0,11,12,12,-0.2
7300,Markese Tucker\markese-tucker-1,2013-14,Saint Peter's,F,10,0,51,6,21,.286,6,21,.286,0,0,,0,0,,1,2,3,1,1,1,1,8,12,-0.1
7301,Jerrod Patton\jerrod-patton-1,2014-15,Fresno State,F,9,0,27,6,8,.750,6,8,.750,0,0,,0,1,.000,1,7,8,1,1,1,2,1,12,1.2
7302,Vicktor Arnick\vicktor-arnick-1,2013-14,Texas Southern,F,16,2,70,5,13,.385,3,7,.429,2,6,.333,0,2,.000,6,6,12,1,1,1,5,7,12,0.3
7303,Khalil Fuller\khalil-fuller-1,2017-18,North Texas,F,17,0,70,6,8,.750,6,8,.750,0,0,,0,1,.000,3,10,13,1,3,1,4,14,12,0.5
7304,Juan Ramon Rivas\juan-ramon-rivas-1,2014-15,Missouri-Kansas City,F,8,0,57,4,19,.211,3,12,.250,1,7,.143,3,3,1.000,4,2,6,2,2,0,4,3,12,0.2
7305,Logan Routt\logan-routt-1,2016-17,West Virginia,F,11,0,31,4,5,.800,4,5,.800,0,0,,4,6,.667,8,4,12,1,0,2,2,6,12,1.3
7306,Donyell Marshall Jr.\donyell-marshalljr-1,2016-17,Central Connecticut State,F,12,0,32,3,6,.500,3,6,.500,0,0,,6,8,.750,2,9,11,1,1,1,3,1,12,0.9
7307,Donell Tuff\donell-tuff-1,2013-14,Gardner-Webb,F,7,0,40,6,11,.545,6,10,.600,0,1,.000,0,6,.000,4,2,6,0,0,1,1,4,12,0.8
7308,Merv Lindsay\merv-lindsay-1,2013-14,New Mexico,F,21,0,129,5,17,.294,4,12,.333,1,5,.200,1,5,.200,3,20,23,5,1,2,3,21,12,0.1
7309,Marquiez Lawrence\marquiez-lawrence-1,2013-14,Kent State,F,16,0,51,5,10,.500,5,10,.500,0,0,,2,5,.400,7,6,13,0,1,1,3,12,12,0.4
7310,Johannes Dolven\johannes-dolven-1,2016-17,Drake,F,9,0,27,6,14,.429,6,14,.429,0,0,,0,2,.000,3,3,6,1,0,0,3,6,12,0.2
7311,Christian Romine\christian-romine-1,2015-16,Texas-El Paso,F,14,0,50,5,10,.500,5,10,.500,0,0,,2,4,.500,2,3,5,0,0,0,8,11,12,-0.3
7312,Ran Tut\ran-tut-1,2016-17,South Carolina,F,12,0,73,6,15,.400,6,14,.429,0,1,.000,0,0,,4,11,15,2,3,3,1,3,12,1.2
7313,Noah Bramlage\noah-bramlage-1,2017-18,Princeton,F,13,0,56,5,15,.333,4,11,.364,1,4,.250,1,3,.333,1,8,9,5,1,0,1,6,12,0.5
7314,Alan Wisniewski\alan-wisniewski-1,2013-14,Penn State,F,20,0,88,4,7,.571,4,7,.571,0,0,,4,6,.667,5,14,19,2,0,4,2,23,12,0.4
7315,Tony Jacob\tony-jacob-1,2013-14,Alabama State,F,5,0,22,5,6,.833,5,6,.833,0,0,,2,6,.333,0,5,5,2,1,4,5,6,12,1.5
7316,Aaron Brown\aaron-brown-3,2013-14,Mount St. Mary's,F,13,0,30,5,11,.455,3,4,.750,2,7,.286,0,1,.000,0,1,1,0,1,0,2,3,12,0.3
7317,Braiden Shaw\braiden-shaw-1,2015-16,Brigham Young,F,19,0,56,3,6,.500,3,6,.500,0,0,,6,12,.500,5,10,15,3,4,1,3,9,12,0.7
7318,Andre Washington\andre-washington-12,2016-17,Illinois State,F,17,0,82,5,8,.625,5,8,.625,0,0,,2,6,.333,4,6,10,1,1,2,7,17,12,0.0
7319,Spencer Eliason\spencer-eliason-1,2015-16,North Dakota State,F,11,1,45,5,9,.556,5,9,.556,0,0,,2,4,.500,9,6,15,3,0,0,2,9,12,1.0
7320,Barnett Harris\barnett-harris-1,2013-14,Delaware,F,29,1,92,5,6,.833,5,6,.833,0,0,,2,4,.500,10,10,20,1,2,3,7,37,12,0.1
7321,Dan Studer\dan-studer-1,2015-16,Milwaukee,F,8,0,34,5,14,.357,5,10,.500,0,4,.000,2,6,.333,3,5,8,3,2,0,3,4,12,0.7
7322,Nick Greely\nick-greely-1,2017-18,Campbell,F,3,0,15,4,6,.667,4,6,.667,0,0,,4,5,.800,2,0,2,2,1,0,1,3,12,3.5
7323,Kosta Jankovic\kosta-jankovic-1,2016-17,Kennesaw State,F,7,0,72,4,17,.235,4,16,.250,0,1,.000,4,6,.667,3,13,16,5,1,0,6,10,12,0.2
7324,Greg Bowman\greg-bowman-1,2016-17,Washington,F,11,0,21,5,9,.556,5,9,.556,0,0,,2,6,.333,5,6,11,1,1,0,1,1,12,1.1
7325,Alan Flannigan\alan-flannigan-1,2014-15,Lafayette,F,18,1,61,4,14,.286,3,8,.375,1,6,.167,3,4,.750,1,10,11,3,0,1,4,9,12,0.1
7326,Connor MacDougall\connor-macdougall-1,2014-15,Arizona State,F,6,0,23,4,4,1.000,4,4,1.000,0,0,,4,5,.800,0,4,4,0,0,2,0,7,12,1.7
7327,Nikola Colovic\nikola-colovic-1,2016-17,Hartford,F,7,0,31,4,7,.571,4,7,.571,0,0,,4,5,.800,2,3,5,0,1,1,3,12,12,0.6
7328,Aaron Cheatum\aaron-cheatum-1,2014-15,Washington State,F,16,0,92,4,14,.286,4,13,.308,0,1,.000,4,15,.267,7,11,18,3,4,2,4,13,12,0.4
7329,Zach Bohannon\zach-bohannon-1,2013-14,Wisconsin,F,14,0,27,4,7,.571,2,4,.500,2,3,.667,2,2,1.000,2,3,5,0,2,0,0,1,12,0.9
7330,Tommy Hobbs\tommy-hobbs-1,2013-14,New Orleans,F,7,0,20,5,8,.625,4,6,.667,1,2,.500,1,3,.333,3,6,9,1,2,2,0,0,12,2.2
7331,Jesse Lopez\jesse-lopez-1,2016-17,Sam Houston State,F,10,0,34,4,6,.667,4,6,.667,0,0,,4,6,.667,1,5,6,1,0,2,1,4,12,1.0
7332,Tyrell Williams\tyrell-williams-1,2017-18,Iona,F,14,0,37,5,10,.500,5,10,.500,0,0,,2,3,.667,4,9,13,0,0,3,3,5,12,0.7
7333,Mac Hoffman\mac-hoffman-1,2013-14,Army,F,13,0,63,4,17,.235,0,2,.000,4,15,.267,0,0,,3,6,9,2,2,0,8,10,12,-0.2
7334,Devon Brewer\devon-brewer-1,2016-17,Alcorn State,F,20,3,104,4,15,.267,4,15,.267,0,0,,4,6,.667,4,8,12,5,4,7,11,24,12,0.0
7335,Kyle Clark\kyle-clark-1,2017-18,Saint Mary's (CA),F,3,0,60,5,8,.625,5,6,.833,0,2,.000,2,2,1.000,3,1,4,1,0,0,0,5,12,3.2
7336,Yalim Olcay\yalim-olcay-1,2017-18,Western Carolina,F,17,0,55,3,9,.333,3,9,.333,0,0,,6,11,.545,5,10,15,3,2,0,4,11,12,0.4
7337,Austin Evans\austin-evans-1,2015-16,Texas State,F,14,0,32,3,3,1.000,3,3,1.000,0,0,,5,9,.556,2,6,8,1,0,2,2,9,11,0.6
7338,Tai Wynyard\tai-wynyard-1,2016-17,Kentucky,F,15,0,54,5,6,.833,5,6,.833,0,0,,1,3,.333,5,8,13,1,1,3,2,11,11,0.8
7339,Jonathan DeWane\jonathan-dewane-1,2016-17,Air Force,F,10,0,24,2,8,.250,1,5,.200,1,3,.333,6,8,.750,1,4,5,1,1,0,0,4,11,0.7
7340,Lamine Mbodj\lamine-mbodj-1,2015-16,New Orleans,F,16,0,64,4,15,.267,4,15,.267,0,0,,3,4,.750,7,14,21,2,0,0,4,11,11,0.2
7341,Moustapha Diagne\moustapha-diagne-2,2017-18,Western Kentucky,F,20,1,119,5,20,.250,5,17,.294,0,3,.000,1,3,.333,8,23,31,1,2,0,17,21,11,-0.6
7342,Isaiah Fontaine\isaiah-fontaine-1,2016-17,Southern,F,15,0,88,5,14,.357,5,14,.357,0,0,,1,4,.250,7,8,15,1,0,5,1,14,11,0.5
7343,Niksha Federico\niksha-federico-1,2013-14,San Diego State,F,4,0,10,4,6,.667,1,1,1.000,3,5,.600,0,0,,1,2,3,1,0,0,0,1,11,2.5
7344,Markell Lodge\markell-lodge-1,2017-18,Saint Joseph's,F,15,1,60,5,6,.833,5,6,.833,0,0,,1,3,.333,3,7,10,0,3,4,3,6,11,0.8
7345,Colin Gruber\colin-gruber-1,2014-15,UC-Riverside,F,11,0,79,4,20,.200,3,13,.231,1,7,.143,2,2,1.000,5,13,18,1,7,2,3,10,11,0.7
7346,Chasen Campbell\chasen-campbell-1,2013-14,South Carolina State,F,12,0,59,4,15,.267,4,12,.333,0,3,.000,3,7,.429,4,6,10,2,0,0,1,5,11,0.3
7347,Stephen Vassor\stephen-vassor-1,2016-17,Old Dominion,F,16,0,70,5,6,.833,5,6,.833,0,0,,1,1,1.000,1,11,12,3,0,1,4,13,11,0.4
7348,Chris Egi\chris-egi-1,2014-15,Harvard,F,11,0,45,3,9,.333,3,9,.333,0,0,,5,12,.417,1,5,6,4,1,2,3,3,11,0.6
7349,Joey Nebeker\joey-nebeker-1,2013-14,Boise State,F,10,0,28,3,14,.214,2,6,.333,1,8,.125,4,6,.667,1,6,7,2,1,2,4,1,11,0.4
7350,Pernell Adgei\pernell-adgei-1,2015-16,Loyola (IL),F,9,1,46,3,8,.375,3,8,.375,0,0,,5,9,.556,7,6,13,2,2,0,4,7,11,0.9
7351,Georgios Tsalmpouris\georgios-tsalmpouris-1,2014-15,Iowa State,F,8,0,35,4,10,.400,2,6,.333,2,4,.500,1,5,.200,2,4,6,2,1,0,3,1,11,0.7
7352,Jamell Bradley\jamell-bradley-1,2017-18,Texas A&M-Corpus Christi,F,14,0,49,3,10,.300,2,7,.286,1,3,.333,4,5,.800,2,8,10,1,1,0,2,7,11,0.4
7353,TyQuayion Smith\tyquayion-smith-1,2015-16,Alcorn State,F,13,0,40,4,8,.500,4,8,.500,0,0,,3,4,.750,1,0,1,1,0,1,1,8,11,0.3
7354,TyQuayion Smith\tyquayion-smith-1,2016-17,Alcorn State,F,17,0,61,4,12,.333,3,8,.375,1,4,.250,2,6,.333,0,6,6,1,1,8,4,14,11,0.1
7355,Jose Campo\jose-campo-1,2015-16,New Mexico State,F,12,0,48,5,7,.714,5,7,.714,0,0,,1,4,.250,5,5,10,2,1,0,3,11,11,0.6
7356,Derek Sloan\derek-sloan-1,2017-18,Cleveland State,F,8,2,59,2,12,.167,2,11,.182,0,1,.000,7,16,.438,4,9,13,6,1,2,7,12,11,0.0
7357,Sean Lonergan\sean-lonergan-1,2016-17,Michigan,F,17,0,36,4,9,.444,4,7,.571,0,2,.000,3,6,.500,1,6,7,3,0,1,2,11,11,0.2
7358,Austin Nichols\austin-nichols-2,2016-17,Virginia,F,1,0,16,4,7,.571,4,6,.667,0,1,.000,3,3,1.000,0,3,3,0,0,0,0,3,11,7.4
7359,Jonathan Davis\jonathan-davis-2,2017-18,Baylor,F,10,0,29,4,9,.444,2,3,.667,2,6,.333,1,1,1.000,1,1,2,2,0,0,2,3,11,0.6
7360,Khadim Gueye\khadim-gueye-1,2016-17,South Carolina,F,28,0,208,3,12,.250,3,12,.250,0,0,,5,8,.625,8,18,26,3,2,7,10,41,11,-0.1
7361,Brodricks Jones\brodricks-jones-1,2017-18,Wyoming,F,15,0,69,3,18,.167,2,10,.200,1,8,.125,4,4,1.000,3,3,6,3,0,0,4,9,11,-0.2
7362,Javier Langarica\javier-langarica-1,2017-18,George Washington,F,10,0,27,2,9,.222,1,2,.500,1,7,.143,6,8,.750,2,8,10,0,3,2,2,4,11,0.9
7363,Blake Brown\blake-brown-1,2016-17,Eastern Michigan,F,19,0,95,3,7,.429,3,7,.429,0,0,,5,10,.500,10,11,21,1,0,2,3,21,11,0.3
7364,Dylan Haines\dylan-haines-1,2013-14,Boston University,F,13,0,48,4,10,.400,2,2,1.000,2,8,.250,1,2,.500,1,6,7,2,2,2,2,6,11,0.6
7365,Samson George\samson-george-1,2017-18,Pittsburgh,F,13,0,52,5,8,.625,5,8,.625,0,0,,1,3,.333,3,9,12,1,0,0,0,6,11,0.7
7366,Glenn Feidanga\glenn-feidanga-1,2016-17,Long Island University,F,14,1,70,2,12,.167,2,11,.182,0,1,.000,7,8,.875,0,7,7,0,0,3,3,10,11,0.0
7367,Collin Hartman\collin-hartman-1,2013-14,Indiana,F,16,0,72,5,11,.455,5,8,.625,0,3,.000,1,2,.500,7,8,15,1,5,1,0,5,11,1.0
7368,Ervins Meznieks\ervin-meznieks-1,2017-18,Boston College,F,10,0,46,3,9,.333,1,2,.500,2,7,.286,3,3,1.000,1,8,9,3,1,0,3,9,11,0.6
7369,Bik Gill\bik-gill-1,2015-16,Ball State,F,5,0,26,3,3,1.000,1,1,1.000,2,2,1.000,3,4,.750,1,6,7,1,2,1,2,3,11,2.5
7370,Freddy Poole\freddy-poole-1,2016-17,Winthrop,F,11,0,27,4,12,.333,3,6,.500,1,6,.167,2,2,1.000,2,1,3,0,1,0,3,7,11,0.1
7371,Jakub Mijakowski\jakub-mijakowski-1,2017-18,Pennsylvania,F,7,0,39,4,16,.250,1,4,.250,3,12,.250,0,0,,2,4,6,1,1,0,1,3,11,0.5
7372,Paul White\paul-white-1,2015-16,Georgetown,F,7,0,67,5,13,.385,5,8,.625,0,5,.000,1,2,.500,1,10,11,11,1,1,5,6,11,1.3
7373,Sunday Okeke\sunday-okeke-1,2017-18,Wake Forest,F,21,0,94,5,10,.500,5,10,.500,0,0,,1,2,.500,15,13,28,4,4,3,6,26,11,0.6
7374,Quentin Shropshire\questin-shropshire-1,2016-17,Cal State Long Beach,F,13,0,59,4,12,.333,4,12,.333,0,0,,3,5,.600,10,8,18,2,1,3,2,16,11,0.7
7375,Jesse Deloach\jesse-deloach-1,2016-17,Western Carolina,F,12,0,93,3,9,.333,3,9,.333,0,0,,5,14,.357,6,6,12,4,3,5,7,15,11,0.4
7376,Brooks Cluxton\brooks-cluxton-1,2017-18,Campbell,F,7,0,46,5,11,.455,5,11,.455,0,0,,1,9,.111,6,16,22,1,2,5,2,5,11,1.9
7377,Daniel Robinson\daniel-robinson-1,2013-14,Iona,F,10,0,65,5,11,.455,5,11,.455,0,0,,1,3,.333,5,7,12,0,1,6,2,14,11,0.8
7378,Royce Hamm Jr.\royce-hammjr-1,2017-18,Texas,F,17,0,90,2,11,.182,2,7,.286,0,4,.000,7,15,.467,8,15,23,0,2,2,8,9,11,0.2
7379,Jamal Aytes\jamal-aytes-1,2013-14,Nevada-Las Vegas,F,4,0,37,5,8,.625,5,8,.625,0,0,,1,5,.200,2,1,3,0,1,0,3,4,11,1.0
7380,Alain Chigha\alain-chigha-1,2015-16,Quinnipiac,F,14,0,56,3,13,.231,1,7,.143,2,6,.333,3,7,.429,9,7,16,1,5,0,6,8,11,0.5
7381,Charlendez Brooks\charlendez-brooks-1,2015-16,Western Carolina,F,11,0,75,5,12,.417,5,12,.417,0,0,,1,2,.500,4,6,10,4,1,1,4,19,11,0.2
7382,Abdul Fofana\abdul-fofana-1,2017-18,Missouri State,F,13,0,67,4,9,.444,4,9,.444,0,0,,3,5,.600,4,12,16,1,4,1,5,13,11,0.5
7383,Marquis Barnett\marquis-barnett-1,2013-14,Quinnipiac,F,11,0,62,4,8,.500,4,8,.500,0,0,,3,5,.600,9,2,11,1,1,4,2,13,11,0.9
7384,Paul Friendshuh\paul-friendshuh-1,2015-16,Richmond,F,8,0,26,4,7,.571,4,6,.667,0,1,.000,3,4,.750,0,3,3,1,1,0,3,6,11,0.6
7385,Tristan Owens\tristan-owens-1,2017-18,Radford,F,17,1,57,4,21,.190,2,7,.286,2,14,.143,1,2,.500,2,7,9,5,1,0,5,5,11,-0.1
7386,Travis Julien\travis-julien-1,2013-14,Nicholls State,F,8,0,62,5,23,.217,5,14,.357,0,9,.000,1,3,.333,7,4,11,4,4,3,6,13,11,0.0
7387,Dontavious Smith\dontavious-smith-1,2017-18,Massachusetts-Lowell,F,8,0,42,5,9,.556,5,9,.556,0,0,,1,3,.333,6,9,15,0,2,5,7,13,11,0.8
7388,Ramses Sandifer\ramses-sandifer-1,2016-17,Louisiana-Monroe,F,10,0,57,3,17,.176,2,11,.182,1,6,.167,4,4,1.000,3,8,11,3,0,1,3,6,11,0.2
7389,Randy Brumant\randy-brumant-1,2017-18,Columbia,F,7,0,45,5,9,.556,5,9,.556,0,0,,1,1,1.000,7,7,14,4,0,1,2,8,11,1.7
7390,T.J. Traylor\tj-traylor-1,2014-15,Texas A&M-Corpus Christi,F,12,0,99,3,11,.273,3,11,.273,0,0,,5,13,.385,6,14,20,3,1,5,1,17,11,0.7
7391,Andrew Panayiotou\andrew-panayiotou-1,2016-17,Columbia,F,7,0,33,4,9,.444,2,4,.500,2,5,.400,1,1,1.000,1,2,3,3,2,0,4,5,11,0.8
7392,Lewis Cramer\lewis-cramer-1,2014-15,Seattle,F,9,0,70,2,8,.250,2,8,.250,0,0,,7,10,.700,3,7,10,1,2,1,3,9,11,0.7
7393,Collin Luther\collin-luther-1,2015-16,Elon,F,22,0,131,4,13,.308,4,9,.444,0,4,.000,3,5,.600,7,16,23,7,4,0,6,21,11,0.3
7394,Ryan McCoy\ryan-mccoy-2,2014-15,George Washington,F,28,0,99,5,11,.455,4,9,.444,1,2,.500,0,1,.000,4,4,8,1,1,3,5,21,11,0.0
7395,Grant Townsend\grant-townsend-1,2016-17,North Carolina-Asheville,F,10,0,30,4,11,.364,4,10,.400,0,1,.000,2,8,.250,3,6,9,1,0,0,3,6,10,0.1
7396,Joe Hanel\joe-hanel-1,2014-15,DePaul,F,15,0,60,4,7,.571,4,6,.667,0,1,.000,2,2,1.000,2,3,5,2,3,2,0,4,10,0.9
7397,Trevor Manuel\trevor-manual-1,2015-16,Oregon,F,9,0,64,4,13,.308,4,7,.571,0,6,.000,2,6,.333,1,8,9,3,1,9,3,16,10,0.4
7398,Matt Banas\matt-banas-1,2015-16,Bucknell,F,9,1,41,4,11,.364,4,10,.400,0,1,.000,2,3,.667,5,2,7,1,2,0,2,8,10,0.6
7399,Ivan Venegas\ivan-venegas-1,2016-17,Texas-El Paso,F,19,0,53,4,9,.444,4,9,.444,0,0,,2,4,.500,2,8,10,0,0,1,4,6,10,0.1
7400,Kenny Grant\kenny-grant-2,2014-15,Rider,F,24,0,92,5,14,.357,5,14,.357,0,0,,0,3,.000,7,12,19,0,2,4,9,19,10,-0.1
7401,Bahrom Firozgary\bahrom-firozgary-1,2013-14,Rice,F,14,1,52,4,8,.500,4,8,.500,0,0,,2,5,.400,5,6,11,1,0,0,7,15,10,-0.2
7402,Brandon Allen\brandon-allen-4,2013-14,Florida State,F,14,0,26,3,5,.600,1,3,.333,2,2,1.000,2,2,1.000,2,2,4,0,1,0,3,6,10,0.4
7403,Zach Coleman\zach-coleman-1,2016-17,Massachusetts,F,13,2,98,4,14,.286,2,6,.333,2,8,.250,0,0,,12,8,20,6,2,4,2,12,10,1.1
7404,Tom Rivard\tom-rivard-1,2013-14,James Madison,F,15,5,104,3,11,.273,3,8,.375,0,3,.000,4,8,.500,7,12,19,1,3,3,4,16,10,0.4
7405,Cole Welle\cole-welle-1,2017-18,University of California,F,15,0,51,2,15,.133,2,12,.167,0,3,.000,6,10,.600,10,5,15,0,2,2,1,14,10,0.3
7406,James Love\james-love-1,2017-18,Kansas State,F,15,0,69,4,9,.444,4,9,.444,0,0,,2,5,.400,2,4,6,0,1,5,1,20,10,0.1
7407,Aron Phillips-Nwankwo\aron-nwankwo-1,2013-14,Pittsburgh,F,9,0,16,4,9,.444,3,6,.500,1,3,.333,1,2,.500,5,2,7,0,0,1,2,2,10,0.8
7408,Devin Gilmore\devin-gilmore-1,2017-18,Murray State,F,13,0,30,5,8,.625,5,8,.625,0,0,,0,2,.000,2,10,12,0,1,1,1,3,10,0.7
7409,Brett Wishon\brett-wishon-1,2016-17,Lipscomb,F,5,0,24,3,8,.375,1,1,1.000,2,7,.286,2,3,.667,0,3,3,2,1,0,4,4,10,0.6
7410,Matt Cimino\matt-cimino-1,2014-15,George Washington,F,28,0,56,5,14,.357,5,11,.455,0,3,.000,0,3,.000,4,7,11,1,0,0,3,8,10,0.0
7411,Marcus Blake\marcus-blake-1,2014-15,Florida Gulf Coast,F,16,2,54,4,11,.364,4,11,.364,0,0,,2,3,.667,5,9,14,3,0,0,4,3,10,0.4
7412,Enrico Nuno\enrico-nuno-1,2015-16,Eastern Washington,F,17,0,108,3,12,.250,1,4,.250,2,8,.250,2,3,.667,11,18,29,7,8,5,4,23,10,1.1
7413,Markell Lodge\markell-lodge-1,2015-16,Saint Joseph's,F,13,0,58,4,5,.800,4,5,.800,0,0,,2,4,.500,6,6,12,0,0,1,3,9,10,0.6
7414,Trace Cureton\trace-cureton-1,2015-16,Utah State,F,9,1,44,3,11,.273,2,5,.400,1,6,.167,3,7,.429,1,5,6,4,1,0,3,3,10,0.4
7415,Doyin Akintobi-Adeyeye\doyin-akintobi-adeyeye-1,2016-17,Syracuse,F,12,0,19,5,11,.455,5,11,.455,0,0,,0,1,.000,4,2,6,0,1,2,3,5,10,0.4
7416,Nathan Bain\nathan-bain-1,2016-17,Stephen F. Austin,F,3,1,31,2,6,.333,1,2,.500,1,4,.250,5,7,.714,2,2,4,1,1,0,2,5,10,1.8
7417,Kevin Hickson\kevin-hickson-1,2014-15,North Carolina-Wilmington,F,16,1,74,4,7,.571,4,7,.571,0,0,,2,5,.400,3,6,9,0,6,4,2,17,10,0.6
7418,Devin Wyatt\devin-wyatt-1,2014-15,Loyola Marymount,F,16,0,76,2,9,.222,2,8,.250,0,1,.000,6,10,.600,3,4,7,0,1,1,2,16,10,0.0
7419,John Sica\john-sica-1,2015-16,Columbia,F,11,0,59,4,6,.667,3,5,.600,1,1,1.000,1,2,.500,4,6,10,1,2,3,1,9,10,1.1
7420,Demetrius Treadwell\demetrius-treadwell-1,2014-15,Akron,F,1,1,28,4,7,.571,4,7,.571,0,0,,2,6,.333,3,10,13,3,0,0,2,1,10,9.9
7421,Jeremy Postell\jeremy-postell-1,2015-16,Southern Illinois,F,6,0,9,4,9,.444,2,2,1.000,2,7,.286,0,0,,0,4,4,0,1,0,2,3,10,0.7
7422,Trevor Stanback\trevor-stanback-1,2016-17,Stanford,F,16,0,91,3,17,.176,3,17,.176,0,0,,4,14,.286,7,4,11,6,3,3,5,8,10,0.2
7423,Sam Downey\sam-downey-1,2013-14,Yale,F,7,0,22,5,7,.714,5,7,.714,0,0,,0,0,,2,3,5,0,0,0,1,1,10,1.1
7424,Brett Barney\brett-barney-1,2017-18,Wichita State,F,6,0,14,5,7,.714,5,7,.714,0,0,,0,0,,0,1,1,1,0,0,0,1,10,1.3
7425,Tyrone Powell\tyrone-powell-2,2017-18,Green Bay,F,6,0,24,4,6,.667,4,5,.800,0,1,.000,2,4,.500,1,5,6,2,2,0,2,1,10,1.6
7426,Eden Ewing\eden-ewing-1,2017-18,Purdue,F,6,0,27,4,9,.444,3,6,.500,1,3,.333,1,4,.250,0,3,3,0,0,0,1,6,10,0.3
7427,Adrian Rodriguez\adrian-rodriguez-1,2017-18,Texas-San Antonio,F,1,0,14,5,7,.714,5,7,.714,0,0,,0,0,,4,4,8,1,0,0,0,0,10,11.8
7428,Greg Bowman\greg-bowman-1,2015-16,Washington,F,8,0,17,5,7,.714,5,6,.833,0,1,.000,0,1,.000,2,2,4,0,0,0,0,0,10,1.1
7429,Montie Leunen\montie-leunen-1,2015-16,Portland State,F,10,0,54,4,9,.444,3,5,.600,1,4,.250,1,2,.500,3,2,5,3,3,1,3,10,10,0.6
7430,Austin Evans\austin-evans-1,2014-15,Texas State,F,9,0,29,4,8,.500,4,8,.500,0,0,,2,7,.286,1,6,7,0,0,1,2,3,10,0.4
7431,Mark Pollack\mark-pollack-1,2014-15,Army,F,10,0,41,4,16,.250,2,5,.400,2,11,.182,0,0,,0,7,7,1,0,1,4,6,10,-0.3
7432,Chris Egi\chris-egi-1,2017-18,Harvard,F,4,3,28,5,7,.714,5,7,.714,0,0,,0,1,.000,3,3,6,1,3,2,1,2,10,3.3
7433,Zach Burnham\zach-burnham-1,2013-14,Coppin State,F,5,0,57,4,11,.364,4,11,.364,0,0,,2,4,.500,2,6,8,0,0,1,2,12,10,0.0
7434,Mike Owona\mike-owona-1,2015-16,North Carolina A&T,F,12,1,63,3,8,.375,3,8,.375,0,0,,4,7,.571,7,8,15,2,2,0,7,5,10,0.5
7435,Isaac Kante\isaac-kante-1,2017-18,Georgia,F,10,0,23,4,8,.500,4,8,.500,0,0,,2,2,1.000,2,2,4,0,0,1,3,2,10,0.5
7436,Hans Christian Lauer\hans-christian-lauer-1,2014-15,Illinois-Chicago,F,14,0,55,3,10,.300,3,6,.500,0,4,.000,4,6,.667,0,10,10,0,0,0,1,6,10,0.2
7437,Scotty Tyler\scotty-tyler-1,2015-16,Milwaukee,F,12,0,49,5,12,.417,5,11,.455,0,1,.000,0,0,,9,6,15,4,1,1,1,10,10,0.9
7438,Brandon St. Louis\brandon-st-louis-1,2014-15,Coppin State,F,13,2,101,4,17,.235,4,17,.235,0,0,,2,4,.500,11,11,22,3,5,2,4,22,10,0.4
7439,Dajour Joseph\dajour-joseph-1,2017-18,La Salle,F,9,0,22,4,10,.400,2,5,.400,2,5,.400,0,0,,1,0,1,1,0,0,1,5,10,0.3
7440,Vittorio Reynoso-Avila\vittorio-reynoso-avila-1,2016-17,Princeton,F,9,0,31,5,8,.625,5,8,.625,0,0,,0,0,,3,5,8,5,1,0,0,1,10,1.6
7441,Dylan Karell\dylan-karell-1,2013-14,Central Florida,F,17,5,117,4,10,.400,4,10,.400,0,0,,2,6,.333,10,11,21,3,2,7,6,14,10,0.6
7442,Aubrey Williams\aubrey-williams-2,2014-15,Toledo,F,16,0,41,4,10,.400,4,9,.444,0,1,.000,2,5,.400,5,5,10,0,0,1,5,8,10,0.1
7443,Alex Murphy\alex-murphy-1,2015-16,Florida,F,3,0,23,4,10,.400,3,6,.500,1,4,.250,1,4,.250,2,2,4,0,0,1,1,5,10,1.0
7444,C.J. Cole\cj-cole-1,2016-17,Oklahoma,F,16,0,41,4,7,.571,4,7,.571,0,0,,2,4,.500,6,4,10,0,0,0,0,5,10,0.6
7445,Deion Giddens\deion-giddens-1,2014-15,Cornell,F,25,1,164,4,13,.308,4,13,.308,0,0,,2,3,.667,15,11,26,0,2,10,2,20,10,0.6
7446,Joe Hanel\joe-hanel-1,2017-18,DePaul,F,14,0,73,4,10,.400,4,10,.400,0,0,,2,5,.400,5,7,12,3,1,0,1,11,10,0.5
7447,Luke Loehr\luke-loehr-1,2017-18,Navy,F,3,0,10,5,7,.714,5,6,.833,0,1,.000,0,0,,1,2,3,0,0,0,3,5,10,1.1
7448,Julian Royal\julian-royal-1,2015-16,George Mason,F,7,0,32,4,13,.308,4,8,.500,0,5,.000,2,3,.667,3,2,5,0,1,2,5,4,10,0.1
7449,Xavier Williams\xavier-williams-1,2016-17,Tennessee State,F,10,0,52,5,12,.417,5,9,.556,0,3,.000,0,1,.000,3,6,9,2,2,3,3,10,10,0.6
7450,Stefan Jankovic\stefan-jankovic-1,2013-14,Missouri,F,3,0,26,3,5,.600,1,2,.500,2,3,.667,2,5,.400,3,5,8,2,1,0,1,3,10,3.4
7451,Colin Just\colin-just-1,2016-17,Houston Baptist,F,5,0,29,4,8,.500,4,8,.500,0,0,,2,4,.500,4,5,9,0,0,0,2,5,10,1.1
7452,Marko Krivacevic\marko-krivacevic-1,2017-18,Duquesne,F,8,1,30,3,8,.375,1,5,.200,2,3,.667,2,3,.667,3,4,7,0,1,0,2,9,10,0.5
7453,Jalen Brown\jalen-brown-1,2016-17,Eastern Michigan,F,18,0,70,3,15,.200,3,11,.273,0,4,.000,4,8,.500,1,4,5,5,4,0,3,4,10,0.2
7454,Austin Katstra\austin-katstra-1,2017-18,Virginia,F,10,0,19,4,7,.571,3,3,1.000,1,4,.250,1,2,.500,0,5,5,0,1,0,1,1,10,0.7
7455,Stephen Gossard\stephen-gossard-1,2013-14,Wright State,F,7,0,27,4,4,1.000,4,4,1.000,0,0,,2,2,1.000,0,1,1,0,1,1,0,0,10,1.5
7456,David Erebor\david-erebor-1,2016-17,Brown,F,19,0,77,4,11,.364,4,11,.364,0,0,,2,4,.500,5,11,16,0,6,0,5,24,10,0.1
7457,Matt Hubbard\matt-hubbard-1,2016-17,Santa Clara,F,8,0,52,3,14,.214,1,4,.250,2,10,.200,2,2,1.000,5,6,11,1,0,0,8,10,10,-0.6
7458,Marcellis Perkins\marcellis-perkins-1,2015-16,Holy Cross,F,18,0,47,4,13,.308,4,9,.444,0,4,.000,2,8,.250,5,5,10,0,1,0,2,6,10,0.1
7459,Gene Langan\gene-langan-1,2014-15,Furman,F,9,0,29,4,7,.571,4,7,.571,0,0,,2,2,1.000,4,6,10,0,0,0,2,2,10,0.9
7460,Greg Donlon\greg-donlon-1,2015-16,Virginia Tech,F,6,0,8,4,6,.667,4,6,.667,0,0,,2,2,1.000,1,3,4,0,0,0,1,0,10,1.3
7461,Shelby Moats\shelby-moats-1,2014-15,Vanderbilt,F,9,0,38,4,7,.571,4,6,.667,0,1,.000,2,5,.400,4,5,9,1,1,0,4,4,10,0.7
7462,Darius Scott\darius-scott-1,2013-14,Alabama State,F,12,0,31,4,7,.571,3,4,.750,1,3,.333,1,1,1.000,1,2,3,3,0,2,1,5,10,0.7
7463,Brett Rau\brett-rau-1,2017-18,Missouri,F,11,0,50,4,9,.444,3,6,.500,1,3,.333,1,3,.333,2,1,3,2,1,0,4,3,10,0.3
7464,Danny Powell\danny-powell-1,2013-14,Eastern Washington,F,3,0,17,4,7,.571,3,4,.750,1,3,.333,1,2,.500,0,3,3,0,2,1,1,6,10,2.2
7465,Evan Wessenberg\evan-wessenberg-1,2016-17,North Dakota State,F,10,0,32,5,7,.714,5,7,.714,0,0,,0,0,,1,3,4,0,0,0,2,5,10,0.5
7466,Jack Anton\jack-anton-1,2016-17,Elon,F,18,2,85,4,6,.667,4,5,.800,0,1,.000,2,6,.333,2,16,18,3,1,3,1,19,10,0.5
7467,Josh Lester\josh-lester-1,2015-16,Belmont,F,13,0,33,3,6,.500,2,3,.667,1,3,.333,3,4,.750,1,5,6,0,0,0,2,5,10,0.4
7468,Johnny Wang\johnny-wang-1,2017-18,Cal State Fullerton,F,15,0,75,3,13,.231,2,6,.333,1,7,.143,3,5,.600,2,16,18,3,1,2,4,7,10,0.3
7469,Simeon Carter\simeon-carter-1,2015-16,Iowa State,F,15,0,40,5,10,.500,5,10,.500,0,0,,0,3,.000,2,4,6,0,0,2,1,5,10,0.3
7470,Luke Meikle\luke-meikle-1,2013-14,Gonzaga,F,15,0,59,5,9,.556,5,7,.714,0,2,.000,0,2,.000,5,9,14,1,0,4,1,11,10,0.6
7471,Josh Martin\josh-martin-2,2014-15,Minnesota,F,7,0,38,3,7,.429,3,6,.500,0,1,.000,3,9,.333,2,5,7,0,0,3,6,4,9,0.0
7472,Ben Eke Kazee\ben-ekekazee-1,2016-17,Miami (OH),F,14,1,48,1,5,.200,1,5,.200,0,0,,7,12,.583,3,2,5,1,1,2,3,7,9,0.3
7473,Leon Gilmore\leon-gilmore-1,2014-15,Creighton,F,8,0,39,1,7,.143,0,4,.000,1,3,.333,6,10,.600,2,7,9,3,0,0,3,5,9,0.4
7474,Matthew Rodden\matthew-rodden-1,2016-17,Gardner-Webb,F,5,0,15,4,9,.444,3,6,.500,1,3,.333,0,4,.000,2,3,5,1,1,0,0,3,9,1.1
7475,Terrance Hubby\terrance-hubby-1,2015-16,Lamar,F,10,0,45,3,9,.333,3,7,.429,0,2,.000,3,8,.375,3,5,8,1,4,3,3,11,9,0.5
7476,Jackson White\jackson-white-1,2015-16,Chattanooga,F,10,0,41,3,7,.429,3,6,.500,0,1,.000,3,4,.750,3,5,8,2,0,0,1,6,9,0.7
7477,Danny Newsome\danny-newsome-1,2015-16,Texas,F,3,0,6,3,7,.429,0,2,.000,3,5,.600,0,0,,0,0,0,0,0,0,0,1,9,1.6
7478,Adam Wolf\adam-wolf-1,2017-18,Missouri,F,4,0,10,3,4,.750,0,1,.000,3,3,1.000,0,0,,0,0,0,0,1,0,0,0,9,2.1
7479,Lavonne Davis\lavonne-davis-1,2015-16,Prairie View,F,7,1,39,3,5,.600,3,5,.600,0,0,,3,4,.750,6,4,10,1,2,0,4,12,9,0.8
7480,Brent Hibbitts\brent-hibbitts-1,2017-18,Michigan,F,5,0,15,3,5,.600,2,4,.500,1,1,1.000,2,2,1.000,2,1,3,1,0,1,1,2,9,1.6
7481,Andrew Vollert\andrew-vollert-1,2014-15,San Jose State,F,3,0,56,4,7,.571,3,6,.500,1,1,1.000,0,0,,1,2,3,0,0,0,2,5,9,1.0
7482,Danny Dixon\danny-dixon-1,2016-17,George Mason,F,6,0,27,2,5,.400,2,5,.400,0,0,,5,7,.714,4,4,8,0,0,2,3,3,9,1.1
7483,Gene Langan\gene-langan-1,2015-16,Furman,F,8,0,16,3,6,.500,3,5,.600,0,1,.000,3,4,.750,3,3,6,0,0,0,1,2,9,0.9
7484,Nick Reese\nick-reese-1,2014-15,North Carolina A&T,F,16,0,74,4,15,.267,3,7,.429,1,8,.125,0,0,,5,8,13,4,3,2,9,11,9,0.0
7485,Chase Foster\chase-foster-1,2014-15,San Francisco,F,9,0,38,3,14,.214,2,6,.333,1,8,.125,2,4,.500,2,6,8,1,0,0,3,5,9,-0.2
7486,Daniel Edwards\daniel-edwards-1,2014-15,Princeton,F,12,1,25,3,7,.429,2,4,.500,1,3,.333,2,2,1.000,2,3,5,1,0,0,3,0,9,0.4
7487,Gary Gaskins\gary-gaskins-1,2013-14,Oklahoma State,F,11,0,34,4,8,.500,4,8,.500,0,0,,1,2,.500,7,8,15,1,0,0,5,7,9,0.4
7488,Henry Uwadiae\henry-uwadiae-1,2015-16,Green Bay,F,12,0,29,4,6,.667,4,6,.667,0,0,,1,5,.200,6,6,12,0,0,1,6,11,9,0.1
7489,Dominic Johnson\dominic-johnson-2,2017-18,Buffalo,F,11,0,26,4,5,.800,3,3,1.000,1,2,.500,0,0,,0,6,6,0,1,0,2,3,9,0.6
7490,Bobby Duncan\bobby-duncan-1,2016-17,Citadel,F,13,0,51,3,5,.600,3,5,.600,0,0,,3,7,.429,5,12,17,3,2,0,6,13,9,0.4
7491,Aaron Leblanc\aaron-leblanc-1,2014-15,Louisiana,F,11,1,43,4,10,.400,4,10,.400,0,0,,1,2,.500,4,4,8,2,0,6,5,4,9,0.6
7492,Jonothan Janssen\jonothan-janssen-1,2015-16,Cleveland State,F,11,1,37,2,7,.286,1,2,.500,1,5,.200,4,4,1.000,3,8,11,0,0,2,0,0,9,1.0
7493,Kyler Neilson\kyler-neilson-1,2014-15,Southern Utah,F,4,0,17,3,5,.600,2,2,1.000,1,3,.333,2,2,1.000,0,1,1,2,1,0,0,2,9,2.2
7494,Kwesi Abakah\kwesi-abakah-1,2016-17,Richmond,F,35,2,223,3,7,.429,3,7,.429,0,0,,3,11,.273,16,19,35,10,3,7,6,35,9,0.4
7495,Kyle Haber\kyle-haber-1,2014-15,Brown,F,6,0,56,3,8,.375,0,3,.000,3,5,.600,0,2,.000,1,3,4,1,2,1,0,3,9,1.3
7496,Elex Carter\elex-carter-1,2014-15,Southern,F,10,0,55,4,10,.400,4,10,.400,0,0,,1,2,.500,10,11,21,0,0,5,8,14,9,0.3
7497,Sajon Ford\sajon-ford-1,2015-16,Northeastern,F,9,0,60,4,10,.400,4,10,.400,0,0,,1,6,.167,5,9,14,1,5,2,5,5,9,0.9
7498,Alex Prahl\alex-prahl-1,2014-15,Milwaukee,F,20,0,87,3,4,.750,3,4,.750,0,0,,3,8,.375,4,7,11,1,0,0,4,17,9,0.0
7499,Nate Bowser\nate-bowser-1,2013-14,Citadel,F,12,3,82,3,13,.231,3,13,.231,0,0,,3,5,.600,5,10,15,0,3,2,5,25,9,-0.3
7500,Dante Williams\dante-williams-3,2016-17,Kansas State,F,6,0,29,3,6,.500,3,6,.500,0,0,,3,3,1.000,3,3,6,1,0,5,1,4,9,1.8
7501,Clay Young\clay-young-1,2017-18,Kansas,F,13,1,72,4,10,.400,4,7,.571,0,3,.000,1,2,.500,0,1,1,8,2,1,3,9,9,0.4
7502,Zack Tobler\zack-tobler-1,2015-16,Cincinnati,F,5,0,17,2,5,.400,2,5,.400,0,0,,5,8,.625,3,0,3,1,0,0,1,3,9,1.1
7503,Mohamed Sherif\mohamed-sherif-1,2015-16,Alabama A&M,F,13,0,72,2,10,.200,2,10,.200,0,0,,5,11,.455,3,10,13,1,1,1,9,8,9,-0.3
7504,Isaih Hood\isaih-hood-1,2017-18,Prairie View,F,8,0,73,2,4,.500,2,3,.667,0,1,.000,5,7,.714,1,8,9,0,3,1,5,16,9,0.2
7505,A.J. Gareri\aj-gareri-1,2017-18,Ohio,F,10,0,61,2,9,.222,1,4,.250,1,5,.200,4,6,.667,0,7,7,1,0,0,4,4,9,0.0
7506,Jeffrey Uju\jeffrey-uju-1,2016-17,Bowling Green State,F,2,0,28,4,6,.667,3,5,.600,1,1,1.000,0,0,,1,9,10,0,0,1,2,2,9,3.9
7507,Chris Carter\chris-carter-7,2014-15,Long Island University,F,10,0,35,4,8,.500,4,8,.500,0,0,,1,2,.500,5,5,10,0,2,3,3,7,9,0.8
7508,Nigel Shadd\nigel-shadd-1,2017-18,Kansas State,F,8,0,50,3,8,.375,3,8,.375,0,0,,3,4,.750,7,9,16,0,0,0,3,7,9,0.8
7509,Evan Sims\evan-sims-1,2013-14,Louisiana-Monroe,F,9,1,91,4,13,.308,4,12,.333,0,1,.000,1,4,.250,3,6,9,2,1,2,6,17,9,-0.5
7510,Dennis Levene\dennis-levene-1,2015-16,Bryant,F,18,3,50,4,8,.500,3,5,.600,1,3,.333,0,3,.000,2,10,12,3,1,1,3,6,9,0.4
7511,Freddy Poole\freddy-poole-1,2017-18,Winthrop,F,11,1,24,3,5,.600,1,2,.500,2,3,.667,1,2,.500,1,2,3,1,0,0,2,2,9,0.5
7512,Jordan Whitehead\jordan-whitehead-1,2016-17,High Point,F,11,0,35,3,8,.375,3,7,.429,0,1,.000,3,5,.600,4,7,11,1,1,1,6,3,9,0.4
7513,Larry Dennis\larry-dennis-1,2014-15,Florida International,F,9,5,74,4,12,.333,4,9,.444,0,3,.000,1,4,.250,2,12,14,2,2,0,5,12,9,0.0
7514,Chris Downing\chris-downing-1,2017-18,Fordham,F,17,0,56,4,7,.571,4,7,.571,0,0,,1,1,1.000,3,5,8,1,1,0,3,7,9,0.3
7515,Taylor Jenson\taylor-jenson-1,2013-14,Southern Utah,F,10,0,26,3,10,.300,0,1,.000,3,9,.333,0,0,,0,3,3,1,0,1,1,2,9,0.4
7516,Connor Griffin\connor-griffin-1,2014-15,Gonzaga,F,14,0,52,3,6,.500,3,6,.500,0,0,,3,6,.500,2,6,8,1,3,2,2,10,9,0.5
7517,Adam Wolf\adam-wolf-1,2015-16,Missouri,F,7,0,25,4,8,.500,3,4,.750,1,4,.250,0,0,,1,7,8,0,1,2,0,3,9,1.3
7518,Mitch Hill\mitch-hill-1,2014-15,Winthrop,F,10,0,23,2,10,.200,0,0,,2,10,.200,3,4,.750,1,3,4,3,0,2,2,0,9,0.6
7519,Ben Milshtein\ben-milshtein-1,2014-15,Mississippi Valley State,F,10,2,68,2,13,.154,2,12,.167,0,1,.000,5,9,.556,5,6,11,2,1,0,2,9,9,0.1
7520,Darien Williams\darien-williams-1,2015-16,St. John's (NY),F,3,0,49,2,6,.333,0,0,,2,6,.333,3,4,.750,1,8,9,0,0,2,3,4,9,1.7
7521,Jalen Brown\jalen-brown-1,2015-16,Georgia State,F,11,0,36,3,14,.214,0,3,.000,3,11,.273,0,0,,2,6,8,0,0,0,1,4,9,0.1
7522,Austin Williams\austin-williams-2,2014-15,Drexel,F,20,12,211,4,10,.400,4,10,.400,0,0,,1,5,.200,7,26,33,6,3,8,6,34,9,0.4
7523,DayJar Dickson\dayjar-dickson-1,2014-15,Niagara,F,18,0,140,3,15,.200,3,15,.200,0,0,,3,7,.429,8,11,19,4,4,4,7,18,9,0.1
7524,Garrett Franken\garrett-franken-1,2017-18,North Dakota,F,12,0,66,3,11,.273,0,2,.000,3,9,.333,0,0,,0,9,9,0,2,2,1,8,9,0.4
7525,Hassan Hussein\hassan-hussein-1,2015-16,Florida International,F,2,0,26,4,6,.667,4,6,.667,0,0,,1,2,.500,1,4,5,1,0,0,1,3,9,3.2
7526,Ude Ifeanyichukwu\ude-ifeanyichukwa-1,2013-14,Southern Mississippi,F,17,0,51,3,7,.429,3,7,.429,0,0,,3,5,.600,5,7,12,1,1,5,2,10,9,0.5
7527,Jack Purchase\jack-purchase-1,2014-15,Auburn,F,7,0,91,3,14,.214,0,1,.000,3,13,.231,0,0,,2,6,8,4,1,0,2,15,9,-0.1
7528,Stephen Domingo\stephen-domingo-1,2013-14,Georgetown,F,19,0,85,3,14,.214,2,5,.400,1,9,.111,2,3,.667,3,7,10,2,1,2,2,12,9,0.1
7529,Zay Henderson\zay-henderson-1,2013-14,Murray State,F,16,0,63,4,7,.571,4,7,.571,0,0,,1,6,.167,4,5,9,1,1,1,3,9,9,0.2
7530,Elijah Burns\elijah-burns-1,2016-17,Notre Dame,F,11,0,44,1,4,.250,1,3,.333,0,1,.000,7,8,.875,5,4,9,1,2,1,2,5,9,0.9
7531,Nicholas Kratholm\nicholas-kratholm-1,2017-18,Duquesne,F,9,0,54,3,13,.231,1,5,.200,2,8,.250,1,6,.167,4,6,10,1,0,0,3,3,9,0.0
7532,Damarion Geter\damarion-geter-1,2016-17,Longwood,F,4,3,78,4,11,.364,4,11,.364,0,0,,1,5,.200,2,8,10,2,4,2,6,10,9,0.5
7533,Ike Ngwudo\ikemefuna-ngwudo-1,2015-16,Dartmouth,F,8,0,26,3,10,.300,2,5,.400,1,5,.200,1,2,.500,4,3,7,4,0,1,4,4,8,0.4
7534,Connor Shorten\connor-shorten-1,2015-16,Florida Atlantic,F,11,0,67,4,7,.571,4,7,.571,0,0,,0,0,,3,10,13,4,1,1,1,14,8,0.7
7535,Austin Haldorson\austin-haldorson-1,2013-14,Wyoming,F,15,0,75,3,15,.200,1,7,.143,2,8,.250,0,0,,1,5,6,1,2,5,4,8,8,0.0
7536,Paul Rowley\paul-rowley-1,2015-16,William & Mary,F,8,0,22,3,9,.333,1,1,1.000,2,8,.250,0,0,,1,2,3,2,0,0,0,4,8,0.5
7537,Josh Lester\josh-lester-1,2014-15,Belmont,F,14,0,43,3,9,.333,3,8,.375,0,1,.000,2,5,.400,1,8,9,1,0,0,2,10,8,0.0
7538,Niksha Federico\niksha-federico-1,2015-16,San Diego State,F,7,0,12,3,8,.375,1,2,.500,2,6,.333,0,0,,0,1,1,1,1,0,0,1,8,0.7
7539,Devenir Duruisseau\devenir-duruisseau-1,2016-17,Washington,F,19,0,71,4,10,.400,4,10,.400,0,0,,0,0,,3,14,17,2,1,1,5,14,8,0.1
7540,A.J. Bowers\aj-bowers-1,2017-18,Chattanooga,F,14,0,74,3,4,.750,3,3,1.000,0,1,.000,2,2,1.000,5,9,14,2,1,2,4,11,8,0.6
7541,Gaston Diedhiou\gaston-diedhiou-1,2014-15,Minnesota,F,13,0,68,4,9,.444,4,5,.800,0,4,.000,0,1,.000,4,5,9,0,0,0,5,9,8,-0.1
7542,Jelani Mofford\jelani-mofford-1,2016-17,North Carolina-Greensboro,F,4,0,17,3,6,.500,1,2,.500,2,4,.500,0,0,,0,0,0,1,1,0,1,3,8,1.1
7543,Josh Forney\josh-forney-1,2014-15,Loyola (MD),F,18,0,58,3,4,.750,3,4,.750,0,0,,2,10,.200,4,5,9,0,4,1,5,11,8,0.2
7544,Niklas Ney\niklas-ney-1,2015-16,Mercer,F,13,0,38,0,2,.000,0,2,.000,0,0,,8,8,1.000,3,3,6,0,0,0,5,9,8,0.1
7545,Evan Borgman\evan-borgman-1,2017-18,IUPUI,F,9,1,30,2,6,.333,2,4,.500,0,2,.000,4,6,.667,2,4,6,0,0,0,3,2,8,0.3
7546,Chandler Levingston Simon\chandler-levingstonsimon-1,2015-16,Valparaiso,F,11,0,41,4,6,.667,4,6,.667,0,0,,0,0,,5,7,12,2,0,0,1,11,8,0.6
7547,Branden Aughburns\branden-aughburns-1,2015-16,Hampton,F,13,0,32,2,13,.154,1,12,.083,1,1,1.000,3,4,.750,4,5,9,0,0,5,1,7,8,0.3
7548,Greg Bowman\greg-bowman-1,2017-18,Washington,F,6,1,15,4,5,.800,4,5,.800,0,0,,0,0,,4,3,7,0,0,0,0,1,8,1.6
7549,Ryan Burton\ryan-burton-1,2014-15,Indiana,F,14,0,49,4,4,1.000,4,4,1.000,0,0,,0,0,,4,6,10,3,0,0,0,7,8,0.8
7550,Darius Hicks\darius-hicks-1,2016-17,North Carolina State,F,21,0,132,2,8,.250,2,7,.286,0,1,.000,4,17,.235,9,15,24,7,0,3,7,16,8,0.1
7551,Ibrahim Famouke Doumbia\ibrahimfamouke-doumbia-1,2017-18,South Carolina,F,12,0,43,3,13,.231,3,10,.300,0,3,.000,2,4,.500,2,8,10,0,1,0,0,10,8,0.0
7552,Sajon Ford\sajon-ford-1,2016-17,Northeastern,F,11,0,47,4,9,.444,4,9,.444,0,0,,0,1,.000,3,4,7,1,1,0,4,9,8,0.0
7553,Seth Rouse\seth-rouse-1,2017-18,Robert Morris,F,6,0,27,3,8,.375,1,6,.167,2,2,1.000,0,0,,4,3,7,0,1,0,0,4,8,1.1
7554,Lee Goldsbrough\lee-goldsbrough-1,2013-14,Providence,F,26,0,159,2,11,.182,2,10,.200,0,1,.000,4,7,.571,13,11,24,4,4,0,11,18,8,0.0
7555,Ibrahim Sylla\ibrahim-sylla-1,2017-18,Northern Colorado,F,15,0,41,3,6,.500,3,6,.500,0,0,,2,11,.182,4,9,13,0,0,3,6,10,8,-0.1
7556,J.C. Kennedy\jc-kennedy-1,2015-16,Weber State,F,4,0,8,2,3,.667,0,0,,2,3,.667,2,2,1.000,0,0,0,1,1,1,0,1,8,2.2
7557,Spencer Mathis\spencer-mathis-1,2014-15,Northern Colorado,F,9,0,73,2,10,.200,2,5,.400,0,5,.000,4,14,.286,3,3,6,4,0,0,5,13,8,-0.7
7558,Pierson McAtee\pierson-mcatee-1,2017-18,Kansas State,F,10,0,20,2,4,.500,0,1,.000,2,3,.667,2,2,1.000,0,2,2,1,0,0,2,1,8,0.5
7559,Tyjhai Byers\tyjhai-byers-1,2017-18,Morgan State,F,9,7,90,4,9,.444,4,9,.444,0,0,,0,2,.000,11,14,25,0,1,11,2,12,8,1.8
7560,Jonas Stakeliunas\jonas-stakeliunas-1,2016-17,Dartmouth,F,5,0,11,3,6,.500,1,4,.250,2,2,1.000,0,0,,0,3,3,0,0,0,1,1,8,0.9
7561,Leo Kontopoulos\leo-kontopoulos-1,2016-17,Southern Methodist,F,19,0,34,3,10,.300,3,9,.333,0,1,.000,2,4,.500,1,3,4,1,0,0,3,6,8,-0.1
7562,Boaz Williams\boaz-williams-1,2017-18,Longwood,F,7,0,71,3,20,.150,3,13,.231,0,7,.000,2,2,1.000,3,7,10,2,1,2,6,11,8,-1.0
7563,Ami Lakoju\ami-lakoju-1,2015-16,UC-Santa Barbara,F,15,0,70,4,10,.400,4,10,.400,0,0,,0,4,.000,5,8,13,0,1,7,8,21,8,-0.2
7564,Matt Rennie\matt-rennie-1,2015-16,Dartmouth,F,14,0,56,2,6,.333,2,6,.333,0,0,,4,7,.571,5,11,16,2,0,0,4,6,8,0.4
7565,James Manor\james-manor-1,2013-14,North Carolina,F,8,1,13,3,6,.500,1,2,.500,2,4,.500,0,0,,0,2,2,1,0,1,0,1,8,0.8
7566,Jonas Page\jonas-page-1,2014-15,Florida International,F,5,0,10,3,7,.429,1,2,.500,2,5,.400,0,0,,0,0,0,0,0,1,0,0,8,1.0
7567,Craig Eubanks\craig-eubanks-1,2016-17,Akron,F,4,0,26,3,5,.600,1,1,1.000,2,4,.500,0,0,,0,1,1,0,0,1,3,0,8,0.9
7568,Ellis Williams\ellis-williams-1,2013-14,Bryant,F,13,1,103,3,7,.429,3,7,.429,0,0,,2,5,.400,1,15,16,2,1,2,5,23,8,-0.2
7569,Drew Wilson\drew-wilson-1,2014-15,Oral Roberts,F,6,0,75,4,8,.500,4,8,.500,0,0,,0,2,.000,8,11,19,0,5,5,2,20,8,1.8
7570,Julian Moore\julian-moore-1,2013-14,Penn State,F,7,0,68,2,6,.333,2,6,.333,0,0,,4,4,1.000,1,10,11,1,2,3,0,12,8,1.2
7571,Kyle Benton\kyle-benton-1,2013-14,Portland State,F,10,0,38,2,3,.667,2,3,.667,0,0,,4,8,.500,3,5,8,2,4,1,1,2,8,1.3
7572,Brian Oddo\brian-oddo-1,2014-15,Miami (OH),F,8,0,38,4,8,.500,4,5,.800,0,3,.000,0,0,,1,0,1,0,2,0,0,3,8,0.7
7573,Dustin Adams\dustin-adams-1,2013-14,Northwestern State,F,13,0,33,3,7,.429,3,7,.429,0,0,,2,2,1.000,5,1,6,1,0,1,2,4,8,0.5
7574,Jabrille Williams\jabrille-williams-1,2014-15,Binghamton,F,10,1,47,4,10,.400,4,9,.444,0,1,.000,0,3,.000,2,8,10,0,1,0,2,8,8,0.1
7575,Josh Chojnacki\josh-chojnacki-1,2013-14,Youngstown State,F,27,1,172,4,10,.400,4,8,.500,0,2,.000,0,2,.000,4,12,16,3,3,3,4,35,8,-0.1
7576,Alonzo Campbell\alonzo-campbell-1,2016-17,Stony Brook,F,12,0,37,4,11,.364,4,11,.364,0,0,,0,0,,3,5,8,2,0,3,4,8,8,0.2
7577,Ervins Meznieks\ervin-meznieks-1,2016-17,Boston College,F,9,0,41,3,10,.300,1,2,.500,2,8,.250,0,0,,1,4,5,2,2,1,5,6,8,0.1
7578,Andrija Milovanovic\andrija-milovanovic-1,2014-15,McNeese State,F,12,0,41,2,9,.222,0,3,.000,2,6,.333,2,2,1.000,1,2,3,2,0,0,1,3,8,0.3
7579,Okey Ukah\okey-ukah-1,2015-16,Iowa,F,8,0,21,4,7,.571,4,7,.571,0,0,,0,2,.000,1,1,2,0,2,1,0,5,8,0.7
7580,Saleem Little\saleem-little-1,2015-16,Howard,F,9,0,28,2,8,.250,1,4,.250,1,4,.250,3,4,.750,1,5,6,0,0,3,2,1,8,0.5
7581,Trey Mourning\trey-mourning-1,2016-17,Georgetown,F,10,0,18,3,6,.500,3,6,.500,0,0,,2,2,1.000,1,4,5,0,0,1,0,4,8,0.6
7582,PJ Posey\ravonn-posey-1,2015-16,Cal State Bakersfield,F,5,0,19,4,5,.800,4,5,.800,0,0,,0,3,.000,2,3,5,0,0,1,2,8,8,0.5
7583,Luka Kamber\luka-kamber-1,2013-14,Louisiana,F,12,0,61,3,10,.300,3,4,.750,0,6,.000,2,2,1.000,2,12,14,0,3,1,4,6,8,0.4
7584,Demetris Morant\demetris-morant-1,2013-14,Nevada-Las Vegas,F,13,0,50,4,6,.667,4,6,.667,0,0,,0,0,,3,4,7,2,0,6,2,9,8,0.7
7585,Samson Oyediran\samson-oyediran-1,2017-18,Tennessee State,F,18,0,122,4,7,.571,4,6,.667,0,1,.000,0,2,.000,6,13,19,3,2,0,4,14,8,0.4
7586,Griffin McKenzie\griffin-mckenzie-1,2013-14,Denver,F,8,0,25,3,9,.333,2,7,.286,1,2,.500,1,1,1.000,0,1,1,2,0,0,2,5,8,0.1
7587,Zach Bush\zach-bush-1,2016-17,Wichita State,F,21,0,56,3,11,.273,2,5,.400,1,6,.167,1,3,.333,1,7,8,4,5,0,2,3,8,0.4
7588,Tai Wynyard\tai-wynyard-1,2017-18,Kentucky,F,8,0,43,3,7,.429,3,7,.429,0,0,,2,2,1.000,6,8,14,0,3,1,3,8,8,1.1
7589,Brendan Casper\brendan-casper-1,2015-16,Saint Joseph's,F,11,0,19,3,6,.500,2,4,.500,1,2,.500,1,2,.500,2,3,5,1,1,0,3,0,8,0.5
7590,J.D. Slajchert\jd-slajchert-1,2017-18,UC-Santa Barbara,F,7,0,28,3,9,.333,2,6,.333,1,3,.333,1,2,.500,2,4,6,0,1,0,3,2,8,0.3
7591,Norense Odiase\norense-odiase-1,2016-17,Texas Tech,F,3,0,19,4,8,.500,4,8,.500,0,0,,0,0,,1,2,3,2,1,0,0,0,8,2.6
7592,Jarrell Holliman\jarrell-holliman-1,2016-17,South Carolina,F,15,0,89,3,8,.375,3,8,.375,0,0,,2,2,1.000,4,6,10,2,0,1,2,17,8,0.1
7593,Nolan Wilson\nolan-wilson-1,2014-15,Prairie View,F,24,0,151,4,11,.364,4,11,.364,0,0,,0,3,.000,10,14,24,5,2,6,7,31,8,0.1
7594,Michael Oyefusi\michael-oyefusi-1,2014-15,Coppin State,F,4,0,13,2,5,.400,0,0,,2,5,.400,2,2,1.000,0,4,4,1,0,0,2,1,8,1.2
7595,Tre Vance\tre-vance-1,2015-16,Oral Roberts,F,10,0,41,2,7,.286,2,7,.286,0,0,,4,7,.571,2,3,5,2,0,4,1,10,8,0.4
7596,Robin Thompson\robin-thompson-1,2016-17,Missouri State,F,9,0,44,4,6,.667,4,6,.667,0,0,,0,0,,2,6,8,2,3,0,0,11,8,1.0
7597,Jacob Bonnington\jacob-bonnington-1,2017-18,McNeese State,F,7,1,24,4,14,.286,4,10,.400,0,4,.000,0,0,,3,5,8,0,0,0,2,2,8,0.1
7598,Kyle Broekhuis\kyle-broekhuis-1,2016-17,Air Force,F,13,0,91,3,17,.176,3,13,.231,0,4,.000,2,2,1.000,5,12,17,4,1,3,7,10,8,-0.1
7599,Lucas Stivrins\lucas-stivrins-1,2013-14,Nevada,F,18,2,112,3,9,.333,3,9,.333,0,0,,2,4,.500,10,8,18,7,1,3,4,13,8,0.6
7600,Willem Brandwijk\willem-brandwijk-1,2016-17,Siena,F,15,0,50,2,3,.667,2,2,1.000,0,1,.000,4,6,.667,1,5,6,0,2,0,2,4,8,0.4
7601,Tanner Lohaus\tanner-lohaus-1,2017-18,Northern Iowa,F,7,0,35,2,8,.250,0,4,.000,2,4,.500,2,4,.500,3,7,10,2,1,1,0,2,8,1.3
7602,Christian Thieneman\christian-thieneman-1,2017-18,Marshall,F,8,0,48,2,8,.250,1,3,.333,1,5,.200,3,7,.429,3,9,12,0,0,1,3,8,8,0.1
7603,Glen Pierre\glen-pierre-1,2016-17,Southern Illinois-Edwardsville,F,10,0,65,1,6,.167,1,6,.167,0,0,,6,7,.857,2,4,6,1,2,2,4,19,8,-0.1
7604,Seth Berger\seth-berger-1,2013-14,Massachusetts,F,18,0,40,3,9,.333,3,5,.600,0,4,.000,2,2,1.000,3,5,8,2,1,0,1,8,8,0.3
7605,Keion Alexander\keion-alexander-1,2016-17,Morehead State,F,9,0,50,3,6,.500,3,6,.500,0,0,,2,3,.667,5,3,8,1,3,5,5,10,8,0.8
7606,Hasaan Buggs\hasaan-buggs-1,2016-17,Mississippi Valley State,F,4,0,55,3,11,.273,3,10,.300,0,1,.000,2,4,.500,4,8,12,2,0,2,5,6,8,0.3
7607,Kevin Hickson\kevin-hickson-1,2015-16,North Carolina-Wilmington,F,10,1,34,4,8,.500,4,8,.500,0,0,,0,2,.000,1,3,4,0,2,1,2,14,8,0.0
7608,Thomas Huerter Jr.\thomas-huerterjr-1,2016-17,Siena,F,11,0,46,2,3,.667,2,2,1.000,0,1,.000,4,4,1.000,2,0,2,1,1,0,3,5,8,0.4
7609,Billy Murphy\billy-murphy-1,2014-15,Lafayette,F,10,0,17,3,8,.375,1,3,.333,2,5,.400,0,0,,0,1,1,1,1,0,1,1,8,0.4
7610,Whit Moreman\whit-moreman-1,2016-17,Troy,F,10,0,17,3,9,.333,3,9,.333,0,0,,2,5,.400,1,1,2,0,0,1,2,0,8,0.1
7611,Jakub Jokl\jakub-jokl-1,2017-18,Utah,F,12,0,40,3,5,.600,3,5,.600,0,0,,2,2,1.000,6,4,10,2,0,2,3,6,8,0.7
7612,Julien Johnson\julien-johnson-1,2014-15,North Carolina A&T,F,9,0,20,2,7,.286,1,2,.500,1,5,.200,3,4,.750,4,1,5,0,1,0,1,3,8,0.6
7613,Harold Givens\harold-givens-1,2015-16,New Mexico State,F,5,0,15,2,5,.400,2,5,.400,0,0,,4,4,1.000,3,0,3,0,0,0,0,1,8,1.4
7614,Duje Radja\duje-radja-1,2017-18,Elon,F,6,0,21,4,7,.571,4,6,.667,0,1,.000,0,0,,1,3,4,0,1,0,0,0,8,1.2
7615,Jalen Gibson\jalen-gibson-1,2015-16,Detroit Mercy,F,5,0,32,1,7,.143,1,6,.167,0,1,.000,5,10,.500,3,9,12,0,0,6,4,6,7,0.6
7616,Grant O'Brien\grant-obrien-1,2014-15,Wake Forest,F,13,0,26,3,6,.500,2,4,.500,1,2,.500,0,0,,2,2,4,0,0,0,0,3,7,0.4
7617,Troy Rike\troy-rike-1,2017-18,Wake Forest,F,9,1,12,3,7,.429,2,4,.500,1,3,.333,0,0,,0,0,0,1,0,0,1,0,7,0.3
7618,Dylan Haines\dylan-haines-1,2014-15,Boston University,F,14,0,79,3,13,.231,2,7,.286,1,6,.167,0,2,.000,6,4,10,0,1,2,8,13,7,-0.5
7619,Nick Pendergast\nick-pendergast-1,2013-14,Temple,F,11,0,22,3,6,.500,2,2,1.000,1,4,.250,0,0,,2,6,8,0,0,1,1,5,7,0.4
7620,Matic Vesel\matic-vesel-1,2017-18,Illinois,F,16,0,70,2,7,.286,2,7,.286,0,0,,3,8,.375,1,7,8,5,0,1,5,13,7,-0.1
7621,Austin Adams\austin-adams-1,2013-14,Northwestern State,F,8,0,11,3,6,.500,2,3,.667,1,3,.333,0,0,,0,1,1,1,0,1,1,2,7,0.5
7622,Tyler Ellerman\tyler-ellerman-1,2013-14,Iowa State,F,7,0,21,3,6,.500,3,6,.500,0,0,,1,4,.250,2,5,7,0,0,0,0,1,7,0.8
7623,Willie Carmichael\willie-carmichael-1,2016-17,Western Kentucky,F,4,0,23,2,7,.286,1,2,.500,1,5,.200,2,2,1.000,1,2,3,0,0,0,3,1,7,0.2
7624,Sommy Ogukwe\sommy-ogukwe-1,2013-14,Liberty,F,10,0,40,2,5,.400,2,4,.500,0,1,.000,3,4,.750,3,8,11,0,1,0,2,8,7,0.4
7625,Hakeem Anchrum\hakeem-anchrum-1,2015-16,Pepperdine,F,8,0,38,3,7,.429,3,7,.429,0,0,,1,2,.500,2,6,8,2,1,0,1,3,7,0.8
7626,Hans Christian Lauer\hans-christian-lauer-1,2013-14,Illinois-Chicago,F,8,0,27,0,3,.000,0,3,.000,0,0,,7,8,.875,0,4,4,0,1,0,1,8,7,0.3
7627,Desmond Hubert\desmond-hubert-1,2014-15,North Carolina,F,21,0,81,2,5,.400,2,5,.400,0,0,,3,9,.333,10,12,22,1,1,1,6,14,7,0.2
7628,Winslo Barry\winslo-barry-1,2014-15,Incarnate Word,F,21,2,73,3,13,.231,3,13,.231,0,0,,1,8,.125,8,16,24,0,3,3,2,19,7,0.1
7629,Grady Eifert\grady-eifert-1,2015-16,Purdue,F,11,0,28,2,7,.286,2,6,.333,0,1,.000,3,5,.600,5,3,8,0,1,0,2,1,7,0.5
7630,Clark Lammert\clark-lammert-1,2013-14,Texas Tech,F,7,0,18,3,6,.500,3,6,.500,0,0,,1,2,.500,5,0,5,0,1,1,1,5,7,0.8
7631,John McCarty\john-mccarty-1,2017-18,Central Michigan,F,9,1,17,3,6,.500,2,3,.667,1,3,.333,0,0,,2,3,5,0,1,0,1,2,7,0.6
7632,Billy Murphy\billy-murphy-1,2013-14,Lafayette,F,10,0,20,3,9,.333,2,3,.667,1,6,.167,0,1,.000,1,3,4,1,0,0,0,7,7,0.1
7633,Darryl Reynolds\darryl-reynolds-1,2013-14,Villanova,F,21,0,66,2,2,1.000,2,2,1.000,0,0,,3,10,.300,5,15,20,1,0,3,7,13,7,0.1
7634,Miki Ljuboja\miki-ljuboja-1,2016-17,Brown,F,5,0,18,2,3,.667,1,1,1.000,1,2,.500,2,2,1.000,0,2,2,0,0,1,1,2,7,1.0
7635,Ron Giplaye\ron-giplaye-1,2013-14,East Tennessee State,F,5,0,22,3,7,.429,3,7,.429,0,0,,1,2,.500,4,0,4,2,1,1,1,2,7,1.4
7636,Diing Diing Wol\diingdiing-wol-1,2017-18,Grambling,F,12,0,38,3,13,.231,3,12,.250,0,1,.000,1,7,.143,1,4,5,0,3,1,7,5,7,-0.6
7637,Marcanvis Hymon\marcanvis-hymon-1,2014-15,Mississippi,F,6,0,51,3,5,.600,3,5,.600,0,0,,1,2,.500,2,5,7,3,2,2,4,9,7,0.9
7638,Jerome Davis\jerome-davis-8,2017-18,Tennessee-Martin,F,7,0,20,2,4,.500,2,4,.500,0,0,,3,4,.750,1,3,4,1,0,0,2,5,7,0.4
7639,Petr Herman\petr-herman-1,2017-18,Loyola Marymount,F,1,1,19,3,5,.600,3,5,.600,0,0,,1,2,.500,2,3,5,1,0,2,1,2,7,6.9
7640,Brendan Casper\brendan-casper-1,2013-14,Saint Joseph's,F,8,0,15,2,7,.286,2,7,.286,0,0,,3,4,.750,2,0,2,1,1,0,0,3,7,0.6
7641,Marek Soucek\marek-soucek-1,2013-14,Oklahoma State,F,22,0,69,3,12,.250,3,5,.600,0,7,.000,1,3,.333,1,9,10,2,0,2,6,20,7,-0.4
7642,Sam Frayer\sam-frayer-1,2017-18,Ohio,F,6,0,14,3,9,.333,2,4,.500,1,5,.200,0,0,,1,5,6,0,0,0,0,0,7,0.7
7643,Reggie Theus\reggie-theus-2,2013-14,South Carolina,F,11,0,39,2,7,.286,2,7,.286,0,0,,3,10,.300,3,3,6,2,1,0,1,5,7,0.2
7644,Shane Acoveno\shane-acoveno-1,2017-18,Lehigh,F,7,0,34,3,4,.750,2,3,.667,1,1,1.000,0,0,,3,2,5,0,0,0,3,5,7,0.4
7645,Larry Johnson\larry-johnson-5,2013-14,Youngstown State,F,4,0,22,3,8,.375,3,8,.375,0,0,,1,6,.167,2,6,8,0,1,0,2,2,7,0.5
7646,Hugh Baxter\hugh-baxter-1,2017-18,Colgate,F,8,0,41,3,8,.375,2,2,1.000,1,6,.167,0,0,,2,3,5,2,0,0,3,6,7,0.1
7647,Jake Ness\jake-ness-1,2014-15,Boise State,F,20,0,88,2,5,.400,2,3,.667,0,2,.000,3,4,.750,2,12,14,3,2,1,3,13,7,0.3
7648,Mason Stuteville\mason-stuteville-1,2014-15,Sacramento State,F,7,0,19,3,11,.273,3,7,.429,0,4,.000,1,3,.333,1,7,8,0,0,1,3,6,7,-0.3
7649,Ellis Dozier\ellis-dozier-1,2016-17,Ohio,F,12,0,29,3,9,.333,3,7,.429,0,2,.000,1,4,.250,1,1,2,0,0,1,4,4,7,-0.3
7650,Dorian Cason\dorian-cason-1,2014-15,Portland State,F,3,0,27,2,6,.333,2,6,.333,0,0,,3,4,.750,4,2,6,0,0,1,2,3,7,1.4
7651,Myles Mann\myles-mann-1,2013-14,Fairleigh Dickinson,F,20,0,76,3,12,.250,3,12,.250,0,0,,1,2,.500,9,11,20,0,0,2,5,15,7,0.0
7652,Matt Greene\matt-greene-1,2015-16,Yale,F,8,0,29,3,6,.500,3,6,.500,0,0,,1,6,.167,4,3,7,2,1,1,3,9,7,0.3
7653,Kyle McKinley\kyle-mckinley-1,2017-18,Louisiana Tech,F,7,0,28,3,6,.500,3,6,.500,0,0,,1,8,.125,2,4,6,0,0,2,1,4,7,0.4
7654,Forrest Johnson\forrest-johnson-1,2013-14,Southeastern Louisiana,F,13,0,51,1,3,.333,1,3,.333,0,0,,5,8,.625,6,9,15,1,0,4,1,18,7,0.5
7655,Noah Bramlage\noah-bramlage-1,2016-17,Princeton,F,10,0,27,3,5,.600,2,3,.667,1,2,.500,0,0,,0,5,5,3,0,0,5,5,7,0.1
7656,Georgi Funtarov\georgi-funtarov-1,2014-15,UC-Davis,F,6,0,25,2,7,.286,1,3,.333,1,4,.250,2,2,1.000,0,7,7,0,1,0,2,4,7,0.4
7657,Zacarry Douglas\zacarry-douglas-1,2014-15,Cal State Northridge,F,2,0,29,3,5,.600,2,4,.500,1,1,1.000,0,1,.000,2,6,8,1,1,0,0,4,7,3.8
7658,Joe Tuss\joe-tuss-1,2013-14,Air Force,F,11,0,47,3,13,.231,2,4,.500,1,9,.111,0,1,.000,1,5,6,1,0,0,4,2,7,-0.3
7659,Connor Perkey\connor-perkey-1,2014-15,Davidson,F,8,0,15,2,3,.667,1,2,.500,1,1,1.000,2,2,1.000,0,1,1,0,0,0,1,3,7,0.5
7660,Sam Lindgren\sam-lindgren-1,2016-17,Colgate,F,6,0,17,3,8,.375,3,7,.429,0,1,.000,1,2,.500,1,1,2,3,1,1,0,0,7,1.2
7661,Matthew Stevenson\matthew-stevenson-1,2017-18,Delaware State,F,9,0,21,2,7,.286,0,1,.000,2,6,.333,1,2,.500,0,1,1,0,2,0,2,3,7,0.2
7662,Rashed Anthony\rashed-anthony-1,2016-17,Seton Hall,F,29,0,128,2,6,.333,2,6,.333,0,0,,3,3,1.000,9,9,18,0,1,1,4,35,7,-0.1
7663,Jevon Estelle\jevon-estelle-1,2015-16,Grand Canyon,F,11,1,43,2,13,.154,2,7,.286,0,6,.000,3,4,.750,2,4,6,2,1,0,2,5,7,-0.1
7664,Adam Dykman\adam-dykman-1,2016-17,South Dakota State,F,9,0,23,2,2,1.000,2,2,1.000,0,0,,3,4,.750,2,6,8,1,0,2,1,0,7,1.1
7665,Shea Rush\shea-rush-1,2017-18,North Carolina,F,20,0,29,3,12,.250,2,9,.222,1,3,.333,0,0,,2,4,6,2,3,3,6,6,7,0.0
7666,Mason Cox\mason-cox-1,2013-14,Oklahoma State,F,13,0,44,2,3,.667,2,2,1.000,0,1,.000,3,10,.300,3,15,18,2,2,2,2,11,7,0.6
7667,Mitch Hill\mitch-hill-1,2016-17,Winthrop,F,13,0,26,3,5,.600,2,2,1.000,1,3,.333,0,2,.000,3,4,7,0,1,0,0,0,7,0.6
7668,Grant Townsend\grant-townsend-1,2017-18,North Carolina-Asheville,F,5,1,31,3,6,.500,3,6,.500,0,0,,1,8,.125,5,2,7,0,0,4,3,4,7,0.7
7669,Sasha Seymore\sasha-seymore-1,2014-15,North Carolina,F,6,0,11,2,4,.500,2,4,.500,0,0,,3,4,.750,1,1,2,0,0,0,3,2,7,0.3
7670,Jackson Forbes\jackson-forbes-1,2016-17,Princeton,F,8,0,21,3,6,.500,3,3,1.000,0,3,.000,0,0,,1,2,3,2,0,0,1,2,6,0.5
7671,Ryan Reagan\ryan-reagan-1,2017-18,Navy,F,2,0,7,2,4,.500,2,4,.500,0,0,,2,3,.667,1,1,2,0,0,0,0,0,6,2.3
7672,Nikola Marijan\nikola-marijan-1,2016-17,South Alabama,F,6,0,22,3,4,.750,3,4,.750,0,0,,0,2,.000,4,4,8,0,0,1,3,6,6,0.5
7673,Igor Ibaka\igor-ibaka-1,2015-16,Oklahoma State,F,7,0,23,1,2,.500,1,2,.500,0,0,,4,8,.500,3,5,8,0,1,0,2,2,6,0.7
7674,Tom Planek\tom-planek-1,2017-18,Providence,F,12,0,19,3,8,.375,3,8,.375,0,0,,0,1,.000,1,2,3,0,4,0,2,4,6,0.2
7675,Clifton Moore\clifton-moore-1,2017-18,Indiana,F,9,0,43,3,12,.250,3,10,.300,0,2,.000,0,0,,2,6,8,2,1,6,2,6,6,0.5
7676,Lincoln Conrey\lincoln-conrey-1,2017-18,Northern Iowa,F,5,0,13,3,5,.600,3,4,.750,0,1,.000,0,0,,1,1,2,0,1,0,0,0,6,1.1
7677,Kyle Meyer\kyle-meyer-1,2013-14,Iowa,F,12,0,51,2,10,.200,1,5,.200,1,5,.200,1,2,.500,4,11,15,4,1,1,6,5,6,0.2
7678,James Claar\james-claar-1,2015-16,Western Illinois,F,7,0,21,3,6,.500,3,6,.500,0,0,,0,0,,2,2,4,0,0,2,1,1,6,0.7
7679,Lincoln Conrey\lincoln-conrey-1,2015-16,Northern Iowa,F,1,0,26,2,3,.667,0,1,.000,2,2,1.000,0,0,,0,2,2,2,0,0,3,2,6,2.9
7680,Xavier Eaglin\xavier-eaglin-1,2017-18,Prairie View,F,6,0,11,3,4,.750,3,4,.750,0,0,,0,0,,1,3,4,0,0,0,0,2,6,0.9
7681,Josh Forney\josh-forney-1,2013-14,Loyola (MD),F,14,0,41,3,4,.750,3,4,.750,0,0,,0,2,.000,2,2,4,0,1,1,5,8,6,-0.1
7682,Ace Stallings\ace-stallings-1,2017-18,Mount St. Mary's,F,8,0,43,2,5,.400,2,5,.400,0,0,,2,5,.400,3,6,9,2,1,2,1,9,6,0.7
7683,LaDarien Griffin\ladarien-griffin-1,2015-16,St. Bonaventure,F,11,0,30,2,5,.400,2,4,.500,0,1,.000,2,3,.667,3,2,5,0,0,1,3,10,6,-0.1
7684,Michael Manning Jr.\michael-manningjr-1,2017-18,Wofford,F,12,1,53,3,7,.429,3,7,.429,0,0,,0,0,,3,6,9,2,1,1,0,8,6,0.5
7685,Vitto Brown\vitto-brown-1,2013-14,Wisconsin,F,14,0,44,3,11,.273,3,11,.273,0,0,,0,3,.000,0,12,12,3,0,0,2,5,6,0.0
7686,Andre Walker\andre-walker-2,2016-17,Hofstra,F,5,0,26,3,6,.500,3,6,.500,0,0,,0,1,.000,1,7,8,0,1,7,5,5,6,0.9
7687,Hunter Folkertsma\hunter-folkertsma-1,2016-17,Bowling Green State,F,1,0,5,1,1,1.000,1,1,1.000,0,0,,4,4,1.000,1,0,1,1,0,0,1,1,6,5.7
7688,Aaron Leblanc\aaron-leblanc-1,2013-14,Louisiana,F,6,0,21,3,6,.500,3,6,.500,0,0,,0,0,,3,3,6,1,0,2,1,3,6,1.0
7689,Marquis Salmon\marquis-salmon-1,2016-17,Wagner,F,4,3,45,2,6,.333,1,4,.250,1,2,.500,1,2,.500,2,4,6,1,0,1,1,9,6,0.4
7690,TJ Clifford\tj-clifford-1,2017-18,Western Michigan,F,9,0,28,3,6,.500,3,6,.500,0,0,,0,2,.000,4,4,8,0,0,1,0,2,6,0.7
7691,Ryan Shannon\ryan-shannon-1,2013-14,Montana State,F,7,0,15,3,6,.500,3,6,.500,0,0,,0,0,,0,1,1,1,0,0,0,0,6,0.6
7692,Dan Dwyer\dan-dwyer-1,2014-15,Pennsylvania,F,16,1,65,3,5,.600,3,5,.600,0,0,,0,0,,2,11,13,1,1,2,1,4,6,0.6
7693,Dominic Romeo\dominic-romeo-1,2014-15,Santa Clara,F,7,1,18,1,2,.500,1,2,.500,0,0,,4,8,.500,1,3,4,0,0,0,0,3,6,0.5
7694,Isaiah Baker\isaiah-baker-1,2015-16,Holy Cross,F,9,0,33,2,5,.400,2,5,.400,0,0,,2,8,.250,2,3,5,1,0,1,3,6,6,-0.1
7695,Joseph Bayless\joseph-bayless-1,2016-17,Cornell,F,13,0,20,2,4,.500,2,4,.500,0,0,,2,2,1.000,0,1,1,2,0,0,1,2,6,0.3
7696,Sean Harris\sean-harris-1,2013-14,Utah State,F,10,1,36,2,10,.200,2,10,.200,0,0,,2,4,.500,2,7,9,2,2,1,4,6,6,0.0
7697,Collin Luther\collin-luther-1,2017-18,Elon,F,15,3,77,3,8,.375,3,4,.750,0,4,.000,0,3,.000,5,10,15,6,3,0,2,11,6,0.5
7698,Connor Bennett\connor-bennett-1,2016-17,Massachusetts-Lowell,F,3,1,14,2,3,.667,2,3,.667,0,0,,2,3,.667,2,1,3,0,0,0,2,2,6,1.1
7699,De'Runnya Wilson\derunnya-wilson-1,2013-14,Mississippi State,F,7,0,52,1,9,.111,1,7,.143,0,2,.000,4,4,1.000,5,6,11,3,2,0,1,3,6,1.0
7700,Alexander Lee\alexander-lee-1,2016-17,Princeton,F,4,1,15,3,7,.429,3,7,.429,0,0,,0,0,,2,3,5,0,0,0,0,1,6,1.1
7701,Thomas Pierre-Louis\thomas-pierre-louis-1,2015-16,Southern,F,10,0,46,3,8,.375,3,8,.375,0,0,,0,1,.000,3,2,5,0,2,4,1,1,6,0.7
7702,Christian Davis\christian-davis-1,2016-17,Arkansas State,F,8,0,22,1,7,.143,1,6,.167,0,1,.000,4,8,.500,2,6,8,0,0,1,3,2,6,0.0
7703,Michael Clark\michael-clark-2,2014-15,Saint Francis (PA),F,12,0,43,2,8,.250,2,7,.286,0,1,.000,2,6,.333,1,5,6,0,2,1,5,9,6,-0.3
7704,Iman Johnson\iman-johnson-1,2013-14,Maryland-Eastern Shore,F,5,1,79,2,9,.222,2,9,.222,0,0,,2,6,.333,5,10,15,5,4,3,5,13,6,1.0
7705,C.J. Cole\cj-cole-1,2015-16,Oklahoma,F,11,0,27,3,6,.500,3,4,.750,0,2,.000,0,1,.000,0,4,4,0,0,0,3,6,6,-0.1
7706,Tony Jacob\tony-jacob-1,2014-15,Alabama State,F,7,0,14,2,4,.500,2,4,.500,0,0,,2,7,.286,3,1,4,1,0,0,3,3,6,0.1
7707,Sean Lonergan\sean-lonergan-1,2013-14,Michigan,F,11,0,23,2,5,.400,2,4,.500,0,1,.000,2,2,1.000,2,2,4,1,1,1,2,0,6,0.5
7708,Christopher Morgan\christopher-morgan-1,2013-14,Holy Cross,F,13,0,41,3,4,.750,3,4,.750,0,0,,0,0,,1,4,5,1,1,0,1,8,6,0.3
7709,Matt Gregory\matt-gregory-1,2017-18,Notre Dame,F,16,0,32,2,12,.167,0,4,.000,2,8,.250,0,0,,1,3,4,0,0,0,0,1,6,0.0
7710,Jartavious Dobbs\jartavious-dobbs-1,2016-17,Austin Peay,F,14,1,88,3,7,.429,3,7,.429,0,0,,0,1,.000,7,18,25,1,0,3,10,13,6,0.0
7711,Isiah Jasey\isiah-jasey-1,2017-18,Texas A&M,F,15,0,50,3,6,.500,3,5,.600,0,1,.000,0,0,,2,6,8,0,1,5,3,4,6,0.4
7712,Miki Ljuboja\miki-ljuboja-1,2015-16,Brown,F,7,0,14,2,5,.400,2,3,.667,0,2,.000,2,2,1.000,1,3,4,1,1,0,2,0,6,0.7
7713,Austin Weiher\austin-weiher-1,2017-18,Southern Illinois,F,13,0,36,2,10,.200,2,9,.222,0,1,.000,2,2,1.000,0,4,4,1,0,0,2,6,6,-0.2
7714,Xan Ricketts\xan-ricketts-1,2013-14,Utah,F,9,0,25,3,4,.750,3,4,.750,0,0,,0,2,.000,3,4,7,0,0,0,2,3,6,0.4
7715,Zach Korkowski\zach-korkowski-1,2014-15,Wofford,F,7,0,15,2,5,.400,2,4,.500,0,1,.000,2,2,1.000,0,5,5,2,0,0,0,4,6,0.7
7716,Alonzo Chatman\alonzo-chatman-1,2016-17,Morehead State,F,5,0,28,2,4,.500,2,4,.500,0,0,,2,3,.667,3,9,12,0,2,2,2,7,6,1.4
7717,Ross Young\ross-young-1,2017-18,Mount St. Mary's,F,5,0,13,2,3,.667,2,3,.667,0,0,,2,4,.500,3,0,3,0,0,0,1,6,6,0.5
7718,Jalen Courtney\jalen-courtney-1,2014-15,Morehead State,F,5,0,27,3,10,.300,3,7,.429,0,3,.000,0,0,,3,4,7,1,2,0,1,6,6,0.6
7719,Kentrall Brooks\kentrall-brooks-1,2014-15,Marist,F,22,1,180,2,18,.111,2,14,.143,0,4,.000,2,3,.667,11,25,36,14,3,6,18,39,6,-0.3
7720,Wes Brewer\wes-brewer-1,2015-16,Elon,F,6,1,10,3,3,1.000,3,3,1.000,0,0,,0,0,,0,2,2,1,0,0,2,0,6,0.7
7721,Rodney Ross\rodney-ross-1,2017-18,Bethune-Cookman,F,7,0,23,3,10,.300,3,10,.300,0,0,,0,2,.000,5,0,5,0,0,0,1,1,6,0.2
7722,Mark Pollack\mark-pollack-1,2017-18,Army,F,6,1,16,2,10,.200,0,2,.000,2,8,.250,0,0,,0,2,2,0,0,1,1,2,6,-0.1
7723,Develle Phillips\develle-phillips-1,2015-16,DePaul,F,10,0,30,0,0,,0,0,,0,0,,6,16,.375,0,5,5,1,1,0,1,5,6,0.2
7724,K.J. James\kj-james-1,2015-16,High Point,F,10,0,26,2,4,.500,2,2,1.000,0,2,.000,2,4,.500,3,5,8,2,0,0,2,2,6,0.5
7725,Austin Mankin\austin-mankin-1,2013-14,Oklahoma,F,9,0,23,2,4,.500,0,2,.000,2,2,1.000,0,0,,1,3,4,3,0,0,0,2,6,0.8
7726,Emil Knighton\emil-knighton-1,2017-18,Denver,F,9,0,15,3,5,.600,3,5,.600,0,0,,0,0,,1,2,3,1,0,0,0,0,6,0.6
7727,Mike LeBlanc\mike-leblanc-1,2014-15,Princeton,F,3,0,9,2,2,1.000,0,0,,2,2,1.000,0,0,,0,0,0,1,0,0,0,0,6,2.0
7728,Ami Lakoju\ami-lakoju-1,2014-15,UC-Santa Barbara,F,3,0,27,3,6,.500,3,6,.500,0,0,,0,0,,0,4,4,0,0,0,0,5,6,0.7
7729,Simeon Carter\simeon-carter-1,2016-17,Iowa State,F,6,0,14,2,2,1.000,2,2,1.000,0,0,,2,3,.667,1,3,4,0,0,0,0,1,6,1.0
7730,Stokley Chaffee\stokley-chaffee-1,2015-16,San Francisco,F,7,0,12,0,1,.000,0,1,.000,0,0,,6,7,.857,0,2,2,0,0,1,2,1,6,0.5
7731,Egi Gjikondi\egi-gjikondi-1,2014-15,Houston,F,9,0,38,2,9,.222,2,9,.222,0,0,,2,4,.500,8,4,12,2,0,2,4,13,6,0.0
7732,Ben Kone\ben-kone-1,2017-18,Oregon State,F,16,0,77,1,11,.091,1,9,.111,0,2,.000,4,4,1.000,5,15,20,0,1,1,4,14,6,-0.1
7733,Jake Lohrbach\jake-lohrbach-1,2013-14,Ohio State,F,8,0,14,3,7,.429,3,7,.429,0,0,,0,3,.000,0,2,2,0,1,0,1,2,6,0.1
7734,Matt Dahlen\matt-dahlen-1,2014-15,Oregon State,F,13,1,58,3,5,.600,3,5,.600,0,0,,0,4,.000,4,4,8,2,2,0,3,15,6,0.0
7735,Alex Prahl\alex-prahl-1,2015-16,Milwaukee,F,9,0,25,2,4,.500,2,4,.500,0,0,,2,2,1.000,0,3,3,1,0,0,2,4,6,0.2
7736,Willis Turnipseed\willis-turnipseed-1,2013-14,Morgan State,F,6,0,8,3,3,1.000,3,3,1.000,0,0,,0,0,,0,1,1,0,0,1,1,3,6,0.7
7737,Tucker Thompson\tucker-thompson-1,2016-17,North Carolina State,F,5,0,7,3,5,.600,3,5,.600,0,0,,0,0,,1,1,2,0,0,0,0,2,6,0.8
7738,James Sosinski\james-sosinski-1,2017-18,Kansas,F,7,0,9,3,3,1.000,3,3,1.000,0,0,,0,0,,1,3,4,0,0,0,0,3,6,0.8
7739,Joell Hopkins\joell-hopkins-1,2013-14,Florida State,F,14,0,26,2,6,.333,2,4,.500,0,2,.000,2,8,.250,1,2,3,0,0,0,1,3,6,-0.1
7740,Aaron Rohlman\aaron-rohlman-1,2017-18,North Carolina,F,21,1,31,3,3,1.000,3,3,1.000,0,0,,0,1,.000,2,7,9,2,0,0,2,2,6,0.3
7741,Ryden Hines\ryden-hines-1,2015-16,Iona,F,21,3,93,2,7,.286,2,4,.500,0,3,.000,2,5,.400,3,15,18,3,1,1,3,12,6,0.2
7742,Joseph Cook\joseph-cook-1,2017-18,Dartmouth,F,6,1,8,3,3,1.000,3,3,1.000,0,0,,0,0,,2,3,5,0,0,0,0,1,6,1.2
7743,Kyle Rhoades\kyle-rhoades-1,2015-16,Western Carolina,F,3,0,13,3,4,.750,3,4,.750,0,0,,0,0,,2,7,9,0,0,0,1,4,6,1.8
7744,Thomas Peters\thomas-peters-1,2014-15,Pacific,F,5,0,13,3,4,.750,3,4,.750,0,0,,0,4,.000,0,1,1,0,0,0,1,1,6,0.3
7745,Ellis Dozier\ellis-dozier-1,2017-18,Ohio,F,11,0,39,3,12,.250,3,10,.300,0,2,.000,0,1,.000,2,2,4,0,0,0,1,6,6,-0.3
7746,Piers Carroll\piers-carroll-1,2013-14,Nicholls State,F,4,0,7,2,3,.667,0,0,,2,3,.667,0,0,,0,0,0,2,0,0,0,1,6,1.4
7747,Tanner Borchardt\tanner-borchardt-1,2015-16,Nebraska,F,8,0,28,3,3,1.000,3,3,1.000,0,0,,0,0,,2,7,9,0,0,0,5,5,6,0.2
7748,John Heard\john-heard-1,2015-16,Baylor,F,9,0,22,2,9,.222,1,3,.333,1,6,.167,1,1,1.000,1,3,4,0,1,0,0,1,6,0.3
7749,Blake Wilkinson\blake-wilkinson-1,2016-17,Brown,F,9,0,28,2,4,.500,2,4,.500,0,0,,2,4,.500,2,3,5,2,1,1,5,3,6,0.3
7750,Tony Washington\tony-washington-1,2014-15,La Salle,F,13,0,37,3,5,.600,3,5,.600,0,0,,0,1,.000,1,5,6,0,0,1,4,14,6,-0.3
7751,Jackson Bart\jackson-bart-1,2017-18,Cincinnati,F,12,0,15,2,6,.333,0,1,.000,2,5,.400,0,0,,1,1,2,0,0,0,0,0,6,0.3
7752,Nick Emerson\nick-emerson-1,2013-14,Montana,F,11,0,22,3,7,.429,3,4,.750,0,3,.000,0,1,.000,2,2,4,0,0,0,3,4,6,-0.1
7753,Dimitrije Cabarkapa\dimitrije-cabarkapa-1,2013-14,James Madison,F,4,0,12,2,6,.333,1,1,1.000,1,5,.200,1,2,.500,2,1,3,0,0,0,2,0,6,0.5
7754,Fred John Jr.\fred-johnjr-1,2015-16,Toledo,F,8,0,20,2,4,.500,2,4,.500,0,0,,2,3,.667,3,5,8,0,0,0,1,2,6,0.7
7755,Jacob Kilgore\jacob-kilgore-1,2016-17,Marshall,F,8,0,36,2,8,.250,0,0,,2,8,.250,0,0,,1,5,6,0,0,2,0,2,6,0.5
7756,Aboubacar Diallo\aboubacar-diallo-1,2015-16,Eastern Illinois,F,15,1,65,3,7,.429,3,7,.429,0,0,,0,3,.000,6,6,12,5,2,8,3,13,6,0.7
7757,Cedric Turner\cedric-turner-1,2016-17,Arkansas-Pine Bluff,F,9,0,44,2,8,.250,2,8,.250,0,0,,2,5,.400,1,0,1,2,1,0,5,9,6,-0.6
7758,Gerron Scissum\gerron-scissum-1,2015-16,Virginia Commonwealth,F,13,0,29,3,9,.333,3,6,.500,0,3,.000,0,2,.000,5,3,8,1,0,1,0,5,6,0.3
7759,Gabe Agorioge\gabe-agorioge-1,2017-18,Buffalo,F,13,0,18,1,2,.500,0,1,.000,1,1,1.000,3,4,.750,1,0,1,1,0,0,1,3,6,0.3
7760,Georgi Funtarov\georgi-funtarov-1,2016-17,UC-Davis,F,12,0,71,2,9,.222,2,4,.500,0,5,.000,2,4,.500,4,7,11,2,1,2,2,5,6,0.4
7761,Mufaro Murinda\mufaro-murinda-1,2016-17,Coppin State,F,11,0,45,1,11,.091,1,2,.500,0,9,.000,4,9,.444,1,6,7,1,0,0,0,3,6,-0.1
7762,Jordan Tucker\jordan-tucker-1,2017-18,Duke,F,2,0,14,2,4,.500,1,2,.500,1,2,.500,1,2,.500,0,1,1,0,0,0,2,0,6,1.0
7763,Lake Lutes\lake-lutes-1,2014-15,Air Force,F,4,0,10,2,4,.500,0,1,.000,2,3,.667,0,0,,0,0,0,0,0,0,0,3,6,0.7
7764,Tom Planek\tom-planek-1,2015-16,Providence,F,14,0,32,2,3,.667,2,3,.667,0,0,,2,3,.667,2,0,2,1,1,0,0,4,6,0.4
7765,Mogboluwaga Oginni\mogboluwaga-oginni-1,2014-15,Creighton,F,11,0,25,2,8,.250,2,8,.250,0,0,,2,5,.400,5,3,8,0,0,0,3,7,6,-0.1
7766,Brian Oddo\brian-oddo-1,2013-14,Miami (OH),F,12,0,22,2,5,.400,0,2,.000,2,3,.667,0,1,.000,1,3,4,0,1,0,1,1,6,0.3
7767,Jaro Moravek\jaro-moravek-1,2014-15,Troy,F,3,0,26,2,7,.286,0,0,,2,7,.286,0,0,,3,3,6,1,0,0,2,2,6,0.9
7768,Will Lyle\will-lyle-1,2013-14,Mount St. Mary's,F,13,0,25,3,6,.500,3,6,.500,0,0,,0,0,,4,1,5,0,0,1,1,6,6,0.3
7769,Mikael Herbert\mikael-herbert-1,2013-14,Tulane,F,9,0,39,1,7,.143,1,2,.500,0,5,.000,4,6,.667,3,4,7,1,0,0,4,2,6,0.0
7770,Jeremiah Curtis\jeremiah-curtis-1,2014-15,Morgan State,F,12,1,47,1,9,.111,1,9,.111,0,0,,4,4,1.000,2,3,5,1,1,0,1,9,6,0.0
7771,Parker Fennema\parker-fennema-1,2017-18,Army,F,5,0,19,2,6,.333,1,2,.500,1,4,.250,1,2,.500,0,3,3,1,0,1,1,2,6,0.5
7772,Patrick Farrell\patrick-farrell-1,2015-16,Villanova,F,16,0,30,2,5,.400,0,0,,2,5,.400,0,0,,0,3,3,1,0,0,1,2,6,0.2
7773,Keaton Miles\keaton-miles-1,2014-15,Arkansas,F,16,0,48,3,9,.333,3,8,.375,0,1,.000,0,2,.000,2,4,6,1,1,0,2,20,6,-0.4
7774,Jordan Lumpkins\jordan-lumpkins-1,2016-17,Prairie View,F,13,1,43,3,7,.429,3,7,.429,0,0,,0,1,.000,0,5,5,0,1,0,2,9,6,-0.1
7775,Austin Sottile\austin-sottile-1,2016-17,Texas Christian,F,12,0,19,3,4,.750,3,4,.750,0,0,,0,0,,0,4,4,2,0,0,0,0,6,0.6
7776,Alexander Strating\alexander-strating-1,2017-18,Colorado,F,5,1,7,3,5,.600,3,5,.600,0,0,,0,2,.000,2,2,4,0,0,0,2,3,6,0.3
7777,Andrija Milovanovic\andrija-milovanovic-1,2013-14,McNeese State,F,9,0,31,2,8,.250,0,2,.000,2,6,.333,0,0,,5,5,10,1,0,0,1,2,6,0.6
7778,Joshua Friar\joshua-friar-1,2015-16,Texas Southern,F,3,1,31,2,4,.500,2,4,.500,0,0,,2,6,.333,2,5,7,1,0,2,0,6,6,1.7
7779,Josh Wolf\josh-wolf-1,2016-17,Lehigh,F,8,0,14,3,3,1.000,3,3,1.000,0,0,,0,0,,1,0,1,0,0,1,1,3,6,0.5
7780,Johnathan Nwankwo\johnathan-nwankwo-1,2017-18,Kent State,F,8,0,22,2,5,.400,2,5,.400,0,0,,1,2,.500,1,2,3,0,0,1,1,5,5,0.1
7781,Ryan Singer\ryan-singer-1,2016-17,San Jose State,F,16,1,68,2,10,.200,2,10,.200,0,0,,1,5,.200,2,8,10,2,0,0,5,16,5,-0.6
7782,Elliott Bullock\elliott-bullock-2,2014-15,Stanford,F,10,0,34,2,4,.500,1,3,.333,1,1,1.000,0,0,,1,2,3,0,0,0,0,6,5,0.2
7783,Zach Bush\zach-bush-1,2015-16,Wichita State,F,17,0,37,1,6,.167,1,3,.333,0,3,.000,3,4,.750,1,3,4,4,2,0,0,4,5,0.3
7784,Noah Thomas\noah-thomas-1,2016-17,IUPUI,F,8,0,20,1,5,.200,1,4,.250,0,1,.000,3,4,.750,1,3,4,0,0,0,7,6,5,-0.8
7785,David Georgiev\david-georgiev-1,2016-17,Georgia Southern,F,5,0,8,2,3,.667,1,1,1.000,1,2,.500,0,2,.000,1,2,3,2,0,1,0,2,5,1.1
7786,Mohamed Farih\mohamed-farih-1,2014-15,Saint Peter's,F,6,0,9,2,3,.667,2,3,.667,0,0,,1,2,.500,0,1,1,0,0,0,3,2,5,0.0
7787,Hassante Manning\hassante-manning-1,2013-14,Morgan State,F,12,0,60,2,7,.286,2,7,.286,0,0,,1,2,.500,1,11,12,4,0,1,2,11,5,0.1
7788,Xavier Smith\xavier-smith-1,2014-15,St. Bonaventure,F,12,0,59,2,7,.286,2,6,.333,0,1,.000,1,3,.333,4,11,15,1,1,8,1,5,5,0.9
7789,Nathan Payne\nathan-payne-1,2017-18,Charleston Southern,F,5,0,26,2,8,.250,2,8,.250,0,0,,1,3,.333,6,2,8,0,0,1,0,1,5,0.9
7790,Jake Coddington\jake-coddington-1,2015-16,Mississippi,F,12,0,26,2,2,1.000,1,1,1.000,1,1,1.000,0,0,,1,1,2,0,1,0,0,5,5,0.4
7791,Kamall Richards\kamall-richards-1,2013-14,Xavier,F,7,0,23,2,7,.286,2,5,.400,0,2,.000,1,1,1.000,1,3,4,2,2,0,2,0,5,0.6
7792,Walker Miller\walker-miller-1,2017-18,North Carolina,F,20,0,29,2,7,.286,2,7,.286,0,0,,1,1,1.000,1,6,7,4,0,2,1,3,5,0.3
7793,Ronnie White\ronnie-white-1,2014-15,Arkansas State,F,3,0,26,1,4,.250,1,4,.250,0,0,,3,4,.750,2,8,10,0,0,0,1,4,5,1.1
7794,Sean Obi\sean-obi-1,2015-16,Duke,F,10,0,27,1,2,.500,1,2,.500,0,0,,3,6,.500,6,4,10,0,0,1,2,8,5,0.4
7795,Qwandell Newton\qwandell-newton-1,2015-16,Citadel,F,15,0,50,2,15,.133,2,5,.400,0,10,.000,1,2,.500,5,5,10,2,0,1,3,9,5,-0.3
7796,Mogboluwaga Oginni\mogboluwaga-oginni-1,2013-14,Creighton,F,9,0,19,2,4,.500,2,4,.500,0,0,,1,2,.500,0,3,3,0,0,0,0,3,5,0.3
7797,Pierson McAtee\pierson-mcatee-1,2016-17,Kansas State,F,14,0,26,1,5,.200,0,2,.000,1,3,.333,2,4,.500,3,7,10,0,0,0,0,1,5,0.4
7798,Damion Ottman\damion-ottman-1,2015-16,Troy,F,14,1,61,1,12,.083,1,7,.143,0,5,.000,3,6,.500,0,15,15,2,1,2,5,11,5,-0.4
7799,Ezra Talbert\ezra-talbert-1,2014-15,Liberty,F,5,0,19,1,5,.200,0,1,.000,1,4,.250,2,4,.500,0,5,5,0,1,0,1,2,5,0.4
7800,Ivan Venegas\ivan-vinegas-1,2015-16,Texas-El Paso,F,8,0,21,1,5,.200,1,5,.200,0,0,,3,9,.333,4,6,10,1,0,1,0,2,5,0.6
7801,Colby Wollenman\colby-wollenman-1,2013-14,Michigan State,F,12,0,25,1,2,.500,1,2,.500,0,0,,3,5,.600,0,2,2,0,0,0,0,4,5,0.2
7802,Ike Ngwudo\ikemefuna-ngwudo-1,2013-14,Dartmouth,F,4,0,29,1,4,.250,1,4,.250,0,0,,3,3,1.000,5,4,9,0,1,0,2,8,5,0.8
7803,Danny Newsome\danny-newsome-1,2013-14,Texas,F,5,0,14,2,3,.667,2,3,.667,0,0,,1,4,.250,2,3,5,0,0,0,2,3,5,0.3
7804,Rashad Austin\rashad-austin-2,2016-17,Florida A&M,F,13,1,42,2,3,.667,2,3,.667,0,0,,1,2,.500,1,5,6,4,1,0,1,10,5,0.3
7805,Myles Carter\myles-carter-1,2015-16,Seton Hall,F,9,0,32,2,2,1.000,2,2,1.000,0,0,,1,4,.250,3,3,6,1,0,1,3,5,5,0.3
7806,James Butler\james-butler-1,2016-17,Navy,F,4,0,25,2,4,.500,2,4,.500,0,0,,1,4,.250,4,1,5,1,0,1,1,1,5,1.2
7807,Cole Blackstock\cole-blackstock-1,2015-16,Auburn,F,5,0,9,1,1,1.000,1,1,1.000,0,0,,3,3,1.000,0,0,0,0,0,0,0,2,5,0.8
7808,Tom Planek\tom-planek-1,2014-15,Providence,F,8,0,13,1,4,.250,1,4,.250,0,0,,3,6,.500,4,2,6,0,0,0,4,2,5,0.0
7809,Joshua Nurse\joshua-nurse-1,2015-16,St. Francis (NY),F,15,0,71,0,3,.000,0,3,.000,0,0,,5,7,.714,3,10,13,0,2,2,5,18,5,-0.1
7810,Zach Snyder\zach-snyder-1,2017-18,Duquesne,F,4,0,6,2,3,.667,1,1,1.000,1,2,.500,0,1,.000,2,2,4,1,0,0,0,1,5,1.4
7811,Chris Clerkley\chris-clerkley-1,2016-17,Georgia State,F,10,0,26,1,3,.333,1,3,.333,0,0,,3,6,.500,2,3,5,0,0,4,1,5,5,0.4
7812,Denzel Flemings\denzel-flemings-1,2014-15,Nicholls State,F,4,0,32,2,6,.333,2,5,.400,0,1,.000,1,2,.500,2,4,6,2,2,0,2,1,5,1.2
7813,Bryant Beckford\bryant-beckford-1,2017-18,St. Francis (NY),F,7,0,12,2,2,1.000,2,2,1.000,0,0,,1,2,.500,0,2,2,0,0,0,0,1,5,0.6
7814,Ameka Akaya\ameka-akaya-1,2017-18,Air Force,F,7,0,19,2,5,.400,1,4,.250,1,1,1.000,0,0,,3,1,4,3,1,1,0,1,5,1.2
7815,Caid Kirven\caid-kirven-1,2015-16,Virginia,F,14,0,19,2,5,.400,1,2,.500,1,3,.333,0,0,,1,2,3,0,0,0,1,2,5,0.1
7816,Dominique Youmans\dominique-youmans-1,2013-14,Cal State Northridge,F,24,0,101,2,7,.286,2,7,.286,0,0,,1,2,.500,5,7,12,3,0,4,7,25,5,-0.3
7817,Osasumwen Osaghae\osasumwen-osaghae-1,2016-17,Florida International,F,3,0,12,2,3,.667,2,3,.667,0,0,,1,2,.500,1,3,4,0,0,1,2,2,5,0.9
7818,Logan Doyle\logan-doyle-1,2015-16,South Dakota State,F,6,0,15,2,7,.286,2,7,.286,0,0,,1,3,.333,1,6,7,0,1,0,1,1,5,0.4
7819,Andrija Milovanovic\andrija-milovanovic-1,2015-16,McNeese State,F,1,0,7,1,2,.500,0,0,,1,2,.500,2,2,1.000,0,1,1,0,0,0,0,1,5,3.9
7820,Josh Lester\josh-lester-1,2016-17,Belmont,F,19,0,39,1,7,.143,0,1,.000,1,6,.167,2,2,1.000,2,9,11,2,0,0,1,6,5,0.1
7821,Donovan Carter\donovan-carter-1,2013-14,Winthrop,F,20,1,114,2,10,.200,2,10,.200,0,0,,1,4,.250,5,10,15,3,2,1,8,11,5,-0.2
7822,Yannick Atanga\yannick-atanga-1,2014-15,Santa Clara,F,2,2,36,2,4,.500,2,4,.500,0,0,,1,2,.500,3,8,11,0,0,2,2,9,5,1.5
7823,Andrew Papenfus\andrew-papenfus-1,2014-15,Santa Clara,F,3,1,10,1,5,.200,0,1,.000,1,4,.250,2,2,1.000,1,2,3,1,4,0,0,1,5,2.5
7824,Kevin Hempy\kevin-hempy-1,2017-18,Pepperdine,F,10,1,47,1,2,.500,1,1,1.000,0,1,.000,3,4,.750,0,4,4,1,1,0,2,8,5,0.1
7825,Jonas Page\jonas-page-1,2013-14,Florida International,F,4,0,20,1,3,.333,0,0,,1,3,.333,2,2,1.000,0,4,4,0,1,0,1,3,5,0.8
7826,Dom Uhl\dom-uhl-1,2017-18,Iowa,F,16,1,73,2,9,.222,2,7,.286,0,2,.000,1,4,.250,4,14,18,6,0,4,8,6,5,0.1
7827,Jamel Flash\jamel-flash-1,2013-14,Towson,F,16,0,43,2,5,.400,2,5,.400,0,0,,1,1,1.000,5,1,6,0,2,0,4,5,5,0.1
7828,Aleksa Novakovic\aleksa-novakovic-1,2015-16,Eastern Illinois,F,8,0,26,1,11,.091,0,2,.000,1,9,.111,2,3,.667,2,5,7,4,0,0,4,1,5,-0.2
7829,Xavier Smith\xavier-smith-1,2013-14,St. Bonaventure,F,10,0,35,2,7,.286,2,6,.333,0,1,.000,1,4,.250,3,3,6,0,1,3,1,4,5,0.3
7830,John McCarty\john-mccarty-1,2016-17,Central Michigan,F,6,0,17,2,6,.333,1,2,.500,1,4,.250,0,0,,0,3,3,1,1,0,0,1,5,0.6
7831,Hassan Thomas\hassan-thomas-1,2016-17,Illinois-Chicago,F,7,0,33,1,9,.111,1,6,.167,0,3,.000,3,4,.750,2,3,5,1,1,0,4,3,5,-0.4
7832,Andrew Papenfus\andrew-papenfus-1,2013-14,Santa Clara,F,15,0,88,2,7,.286,1,3,.333,1,4,.250,0,0,,5,6,11,1,2,1,5,14,5,-0.1
7833,Trey Thompson\trey-thompson-1,2014-15,Arkansas,F,14,0,34,1,5,.200,1,5,.200,0,0,,3,3,1.000,3,3,6,1,1,1,4,3,5,0.2
7834,Fred Heldring\fred-heldring-1,2013-14,William & Mary,F,11,1,62,2,6,.333,1,3,.333,1,3,.333,0,0,,1,9,10,6,2,5,0,6,5,1.1
7835,Andrew Cartwright\andrew-cartwright-1,2015-16,Drexel,F,6,0,12,1,5,.200,0,0,,1,5,.200,2,2,1.000,0,2,2,1,0,0,1,3,5,0.2
7836,Jhan Paul Mejia\jhanpaul-mejia-1,2016-17,Cal State Fullerton,F,8,0,43,2,14,.143,1,3,.333,1,11,.091,0,0,,3,5,8,3,0,0,1,6,5,-0.2
7837,Jordan Rhodes\jordan-rhodes-1,2014-15,Massachusetts-Lowell,F,2,0,21,2,5,.400,2,5,.400,0,0,,1,2,.500,2,1,3,0,0,0,0,1,5,1.6
7838,Julien Johnson\julien-johnson-1,2015-16,North Carolina A&T,F,5,1,26,1,6,.167,1,5,.200,0,1,.000,3,3,1.000,3,2,5,0,0,0,2,4,5,0.1
7839,C.J. Baird\cj-baird-1,2017-18,Michigan,F,5,0,8,2,3,.667,1,1,1.000,1,2,.500,0,0,,0,1,1,1,0,1,1,0,5,0.9
7840,Logan Mortenson\logan-mortenson-1,2014-15,New Hampshire,F,2,0,16,2,5,.400,2,4,.500,0,1,.000,1,2,.500,1,2,3,0,1,0,0,1,5,1.9
7841,Jack Fleming\jack-fleming-1,2013-14,Colgate,F,6,0,15,2,4,.500,1,2,.500,1,2,.500,0,0,,0,0,0,1,0,0,1,0,5,0.5
7842,Alex Murphy\alex-murphy-1,2013-14,Duke,F,5,0,33,1,6,.167,0,1,.000,1,5,.200,2,4,.500,2,3,5,2,0,0,1,3,5,0.4
7843,Trent Buttrick\trent-buttrick-1,2017-18,Penn State,F,10,0,36,2,10,.200,1,5,.200,1,5,.200,0,2,.000,3,7,10,0,0,1,7,7,5,-0.7
7844,Alex Stecca\alex-stecca-1,2013-14,Northern Arizona,F,6,0,10,1,1,1.000,1,1,1.000,0,0,,2,4,.500,1,1,2,0,1,1,0,1,4,0.9
7845,Dylan Jones\dylan-jones-1,2015-16,Pennsylvania,F,4,0,6,2,2,1.000,2,2,1.000,0,0,,0,2,.000,0,1,1,0,0,0,0,0,4,0.7
7846,Kaleb Warner\kaleb-warner-1,2014-15,Pacific,F,6,0,25,2,5,.400,2,3,.667,0,2,.000,0,0,,3,2,5,7,0,0,0,0,4,1.5
7847,Alfis Pilavios\alfis-pilavios-1,2017-18,Old Dominion,F,9,0,19,1,1,1.000,0,0,,1,1,1.000,1,2,.500,3,2,5,3,1,0,0,2,4,0.9
7848,William Nash\william-nash-1,2016-17,Savannah State,F,3,0,8,2,2,1.000,2,2,1.000,0,0,,0,2,.000,0,0,0,0,1,0,0,1,4,1.1
7849,Michael Ritchie\michael-ritchie-1,2017-18,Miami (OH),F,7,0,13,1,3,.333,0,1,.000,1,2,.500,1,2,.500,2,0,2,2,0,0,1,2,4,0.4
7850,Georgi Funtarov\funtarov-georgi-1,2016-17,UC-Davis,F,1,0,5,2,2,1.000,2,2,1.000,0,0,,0,2,.000,1,1,2,0,0,0,1,2,4,1.8
7851,Ryan McClurg\ryan-mcclurg-1,2017-18,Texas,F,4,0,6,1,2,.500,1,2,.500,0,0,,2,4,.500,0,1,1,0,0,0,1,0,4,0.4
7852,Moses Toriola\moses-toriola-1,2015-16,Norfolk State,F,23,2,105,1,9,.111,1,9,.111,0,0,,2,5,.400,5,5,10,0,2,1,6,18,4,-0.4
7853,Marc Reininger\marc-reininger-1,2016-17,Utah,F,11,0,32,2,4,.500,2,4,.500,0,0,,0,0,,3,1,4,0,0,1,4,3,4,0.0
7854,Seth Rouse\seth-rouse-1,2015-16,Robert Morris,F,3,0,7,1,1,1.000,1,1,1.000,0,0,,2,2,1.000,1,0,1,0,0,0,0,0,4,1.5
7855,Chris Brickhouse\chris-brickhouse-1,2014-15,North Carolina State,F,5,0,9,2,4,.500,2,4,.500,0,0,,0,0,,2,1,3,0,1,0,1,1,4,0.7
7856,Xavier Lundy\xavier-lundy-1,2013-14,Rider,F,21,0,65,2,13,.154,2,8,.250,0,5,.000,0,0,,5,9,14,2,1,3,6,9,4,-0.2
7857,Collin Luther\collin-luther-1,2016-17,Elon,F,14,1,54,1,1,1.000,1,1,1.000,0,0,,2,2,1.000,2,2,4,3,1,1,4,7,4,0.2
7858,Gerald Blount\gerald-blount-1,2017-18,Saint Joseph's,F,3,0,4,2,2,1.000,2,2,1.000,0,0,,0,0,,2,1,3,0,0,0,0,0,4,1.7
7859,Lukas Bergang\lukas-bergang-1,2016-17,Charlotte,F,9,0,30,0,0,,0,0,,0,0,,4,4,1.000,0,0,0,0,1,2,1,12,4,0.1
7860,Temidayo Yussuf\temidayo-yussuf-1,2015-16,Cal State Long Beach,F,1,0,3,1,2,.500,1,2,.500,0,0,,2,2,1.000,2,0,2,0,0,0,0,0,4,4.4
7861,Jordan Lumpkins\jordan-lumpkins-1,2017-18,Prairie View,F,18,1,70,2,6,.333,2,6,.333,0,0,,0,0,,1,8,9,0,2,1,6,15,4,-0.3
7862,Jagos Lasic\jagos-lasic-1,2015-16,St. Francis (NY),F,8,0,26,2,5,.400,2,2,1.000,0,3,.000,0,0,,1,5,6,1,1,0,1,6,4,0.2
7863,Jai Williams\jai-williams-1,2015-16,Saint Joseph's,F,4,0,12,1,2,.500,1,2,.500,0,0,,2,2,1.000,2,2,4,0,0,0,2,4,4,0.4
7864,Brandon Eddlestone\brian-eddlestone-1,2013-14,Louisiana State,F,9,0,19,2,9,.222,2,7,.286,0,2,.000,0,0,,3,4,7,0,1,0,1,3,4,0.1
7865,Mike Davis\mike-davis-10,2015-16,Towson,F,4,0,7,2,2,1.000,2,2,1.000,0,0,,0,2,.000,0,1,1,0,0,0,2,2,4,0.0
7866,Caid Kirven\caid-kirven-1,2013-14,Virginia,F,13,0,27,2,4,.500,2,4,.500,0,0,,0,0,,1,1,2,0,0,0,1,1,4,0.1
7867,Lucas Jones\lucas-jones-2,2016-17,Eastern Illinois,F,7,0,37,2,4,.500,2,3,.667,0,1,.000,0,0,,5,8,13,3,3,2,3,3,4,1.5
7868,Chandler Levingston Simon\chandler-levingstonsimon-1,2016-17,Valparaiso,F,8,0,16,2,6,.333,2,6,.333,0,0,,0,0,,1,1,2,0,1,0,0,5,4,0.1
7869,Austin Mankin\austin-mankin-1,2014-15,Oklahoma,F,17,0,65,1,9,.111,1,6,.167,0,3,.000,2,2,1.000,0,6,6,2,1,0,1,4,4,0.0
7870,Terron Gilmore\terron-gilmore-1,2015-16,Murray State,F,6,3,20,2,3,.667,2,3,.667,0,0,,0,1,.000,1,3,4,0,0,1,0,8,4,0.2
7871,Hans Christian Lauer\hans-christian-lauer-1,2015-16,Illinois-Chicago,F,1,0,2,1,1,1.000,1,1,1.000,0,0,,2,2,1.000,0,0,0,0,1,0,0,0,4,4.7
7872,Jelani Mofford\jelani-mofford-1,2015-16,North Carolina-Greensboro,F,6,0,8,2,3,.667,2,3,.667,0,0,,0,0,,0,1,1,1,1,0,0,1,4,0.7
7873,Tre' Maloney\tre-maloney-1,2017-18,Florida Atlantic,F,6,0,21,2,3,.667,2,3,.667,0,0,,0,0,,0,2,2,0,0,0,1,2,4,0.3
7874,Kyle Broekhuis\kyle-broekhuis-1,2014-15,Air Force,F,9,0,31,1,5,.200,1,4,.250,0,1,.000,2,4,.500,2,7,9,3,2,0,3,4,4,0.3
7875,Samson Akilo\samson-akilo-1,2014-15,Manhattan,F,8,0,18,2,3,.667,2,3,.667,0,0,,0,0,,2,2,4,0,0,0,3,10,4,-0.3
7876,Wyatt Wilkes\wyatt-wilkes-1,2017-18,Florida State,F,6,0,44,2,9,.222,2,2,1.000,0,7,.000,0,1,.000,2,7,9,3,1,2,5,2,4,0.1
7877,Matt Gregory\matt-gregory-1,2014-15,Notre Dame,F,11,0,21,1,3,.333,1,3,.333,0,0,,2,4,.500,1,2,3,0,0,0,1,0,4,0.2
7878,Dan Dwyer\dan-dwyer-1,2017-18,Pennsylvania,F,8,0,37,2,3,.667,2,3,.667,0,0,,0,1,.000,2,5,7,4,1,0,4,7,4,0.3
7879,Antonio Kalpic\antonio-kalpic-1,2013-14,Campbell,F,2,1,9,1,2,.500,1,2,.500,0,0,,2,2,1.000,2,1,3,1,0,0,0,1,4,2.5
7880,Charles Lockett\charles-lockett-1,2014-15,Cal State Long Beach,F,11,0,21,1,5,.200,1,5,.200,0,0,,2,4,.500,1,2,3,0,0,0,3,1,4,-0.2
7881,Ken Uhlar\ken-uhlar-1,2016-17,New Hampshire,F,7,1,31,2,7,.286,2,7,.286,0,0,,0,1,.000,6,3,9,2,0,0,1,3,4,0.5
7882,Alex Moffatt\alex-moffatt-1,2016-17,Memphis,F,9,1,25,2,7,.286,2,5,.400,0,2,.000,0,0,,3,2,5,0,1,1,3,1,4,0.1
7883,Noah Thomas\noah-thomas-1,2017-18,IUPUI,F,2,0,8,1,1,1.000,1,1,1.000,0,0,,2,2,1.000,1,3,4,0,0,1,0,3,4,2.4
7884,Riley Voss\riley-voss-1,2017-18,Cornell,F,6,0,37,1,6,.167,1,4,.250,0,2,.000,2,5,.400,5,4,9,2,0,0,4,5,4,-0.2
7885,Gus Navickas\gus-navickas-1,2015-16,Bethune-Cookman,F,1,0,13,2,2,1.000,2,2,1.000,0,0,,0,0,,0,4,4,1,0,1,2,1,4,3.6
7886,Terry Brutus\terry-brutus-1,2015-16,Mississippi,F,7,1,50,2,8,.250,2,8,.250,0,0,,0,0,,2,4,6,0,2,0,2,6,4,-0.1
7887,Whit Moreman\whit-moreman-1,2017-18,Troy,F,6,0,11,2,3,.667,2,3,.667,0,0,,0,0,,1,2,3,1,0,0,0,1,4,0.7
7888,Sean Lonergan\sean-lonergan-1,2014-15,Michigan,F,17,0,57,2,2,1.000,2,2,1.000,0,0,,0,0,,1,4,5,0,0,0,2,4,4,0.1
7889,Connor Mannion\connor-mannion-1,2017-18,Navy,F,3,0,12,1,3,.333,1,1,1.000,0,2,.000,2,2,1.000,2,3,5,0,0,0,0,1,4,1.4
7890,Wes Brewer\wes-brewer-1,2014-15,Elon,F,3,0,12,2,3,.667,2,3,.667,0,0,,0,0,,0,4,4,0,0,0,4,3,4,-0.4
7891,Steven Stanley\steven-stanley-1,2015-16,Northern Arizona,F,5,0,12,2,3,.667,2,3,.667,0,0,,0,0,,0,2,2,1,0,0,2,0,4,0.4
7892,Joe Ebondo\joe-ebondo-1,2014-15,Old Dominion,F,15,1,58,2,3,.667,2,3,.667,0,0,,0,1,.000,2,8,10,0,2,1,0,9,4,0.3
7893,Tim Priller\tim-priller-1,2015-16,Indiana,F,13,0,17,1,3,.333,1,1,1.000,0,2,.000,2,2,1.000,3,2,5,0,2,0,1,2,4,0.4
7894,Zach Kent\zach-kent-1,2017-18,Tennessee,F,2,0,13,2,6,.333,2,5,.400,0,1,.000,0,0,,1,2,3,0,0,0,0,1,4,0.8
7895,Obi Romeo\obi-romeo-1,2014-15,Saint Joseph's,F,4,0,26,1,1,1.000,1,1,1.000,0,0,,2,3,.667,3,5,8,1,1,5,0,1,4,2.9
7896,Adam Drexler\adam-drexler-2,2014-15,Houston,F,11,0,26,1,5,.200,0,1,.000,1,4,.250,1,3,.333,4,2,6,1,1,0,1,5,4,0.2
7897,Alex Loehr\alex-loehr-1,2017-18,Navy,F,2,0,4,1,1,1.000,0,0,,1,1,1.000,1,2,.500,1,1,2,0,0,0,0,0,4,2.2
7898,Jeff Jones\jeff-jones-5,2014-15,Virginia,F,8,0,13,2,4,.500,2,4,.500,0,0,,0,0,,3,1,4,0,1,0,0,3,4,0.5
7899,Matz Stockman\matz-stockman-1,2014-15,Louisville,F,4,0,22,2,5,.400,2,5,.400,0,0,,0,2,.000,2,9,11,1,2,4,3,6,4,1.2
7900,Ryan Singer\ryan-singer-1,2017-18,San Jose State,F,3,0,43,1,5,.200,1,5,.200,0,0,,2,2,1.000,2,9,11,0,0,0,3,9,4,-0.5
7901,Alex Olsen\alex-olsen-1,2013-14,Creighton,F,13,0,27,1,2,.500,1,2,.500,0,0,,2,4,.500,0,2,2,2,0,0,0,2,4,0.3
7902,Tragen Fahl\tragen-fahl-1,2017-18,Virginia Military Institute,F,6,0,14,2,2,1.000,2,2,1.000,0,0,,0,0,,0,2,2,0,1,1,1,1,4,0.7
7903,Danny Feldmann\danny-feldmann-1,2013-14,Missouri,F,11,0,51,2,6,.333,2,4,.500,0,2,.000,0,0,,1,4,5,1,1,1,1,4,4,0.2
7904,Josh Forney\josh-forney-1,2015-16,Loyola (MD),F,6,0,16,1,1,1.000,1,1,1.000,0,0,,2,4,.500,0,1,1,0,0,0,0,2,4,0.4
7905,Jimmy Merrill\jimmy-merrill-1,2014-15,Siena,F,7,0,15,2,3,.667,2,2,1.000,0,1,.000,0,0,,1,1,2,0,1,0,0,1,4,0.6
7906,Aaron Moesch\aaron-moesch-1,2014-15,Wisconsin,F,14,0,28,2,7,.286,2,6,.333,0,1,.000,0,2,.000,2,4,6,3,0,1,2,4,4,0.1
7907,Dekeba Battee-Aston\dekeba-battee-aston-1,2014-15,Fordham,F,26,0,109,1,11,.091,1,9,.111,0,2,.000,2,3,.667,3,12,15,3,2,1,8,19,4,-0.3
7908,Christian Foxen\christian-foxen-1,2015-16,Connecticut,F,9,0,13,2,5,.400,2,2,1.000,0,3,.000,0,0,,0,1,1,0,0,0,0,4,4,0.0
7909,Kevin Lynch\kevin-lynch-2,2013-14,Texas A&M-Corpus Christi,F,11,0,51,2,6,.333,2,6,.333,0,0,,0,1,.000,4,5,9,0,1,1,3,11,4,-0.1
7910,Zach Turcotte\zach-turcotte-1,2015-16,Massachusetts,F,7,0,13,2,5,.400,2,3,.667,0,2,.000,0,0,,0,3,3,1,0,1,2,2,4,0.1
7911,Chuba Ohams\chuba-ohams-1,2017-18,Fordham,F,3,1,32,2,9,.222,2,8,.250,0,1,.000,0,2,.000,3,2,5,0,2,2,2,8,4,-0.5
7912,Harrison Henderson\harrison-henderson-1,2017-18,Southern California,F,11,0,26,2,10,.200,2,8,.250,0,2,.000,0,0,,2,4,6,0,0,0,1,6,4,-0.3
7913,Jerome Alexander\jerome-alexander-1,2013-14,Navy,F,1,0,5,1,3,.333,1,3,.333,0,0,,2,2,1.000,2,0,2,0,0,0,1,1,4,2.3
7914,Raheem Johnson\raheem-johnson-1,2015-16,Buffalo,F,2,0,16,2,4,.500,2,4,.500,0,0,,0,0,,2,5,7,0,0,2,0,3,4,2.6
7915,C.J. Cole\cj-cole-1,2014-15,Oklahoma,F,14,0,38,2,5,.400,2,5,.400,0,0,,0,3,.000,1,6,7,1,0,0,3,9,4,-0.2
7916,Aaron Brown\aaron-brown-3,2014-15,Mount St. Mary's,F,10,1,26,2,9,.222,2,3,.667,0,6,.000,0,0,,1,7,8,2,1,1,1,3,4,0.2
7917,Sebastian Norman\sebastian-norman-1,2014-15,Lamar,F,10,0,47,0,5,.000,0,4,.000,0,1,.000,4,4,1.000,4,3,7,0,2,1,1,5,4,0.4
7918,Trevor Bohnhoff\trevor-bohnhoff-1,2013-14,Michigan State,F,8,0,13,1,2,.500,1,2,.500,0,0,,2,4,.500,3,1,4,0,0,0,0,2,4,0.5
7919,Michael Nesbitt\michael-nesbitt-1,2015-16,New Mexico,F,5,0,8,2,4,.500,2,3,.667,0,1,.000,0,1,.000,2,1,3,0,0,0,0,0,4,0.7
7920,Michael Johnson\michael-johnson-5,2014-15,Chicago State,F,12,2,58,2,9,.222,2,8,.250,0,1,.000,0,0,,7,15,22,3,1,1,1,13,4,0.5
7921,Shawn Ray\shawn-ray-1,2014-15,UC-Irvine,F,10,0,18,2,2,1.000,2,2,1.000,0,0,,0,0,,1,5,6,1,0,1,0,4,4,0.5
7922,Emeka Ikezu\emeka-ikezu-1,2014-15,Samford,F,10,0,30,2,3,.667,2,3,.667,0,0,,0,2,.000,2,1,3,0,0,0,4,12,4,-0.5
7923,Jordan Madrid-Andrews\jordan-madrid-andrews-1,2017-18,Richmond,F,13,0,43,2,7,.286,2,4,.500,0,3,.000,0,0,,1,4,5,0,0,2,4,8,4,-0.3
7924,Nnamdi Amilo\nnamdi-amilo-1,2015-16,Connecticut,F,9,0,15,1,2,.500,1,2,.500,0,0,,2,2,1.000,0,5,5,0,0,0,0,2,4,0.4
7925,Charlie Anastasi\charlie-anastasi-1,2014-15,Harvard,F,9,1,20,1,4,.250,1,4,.250,0,0,,2,2,1.000,2,2,4,1,0,1,0,1,4,0.5
7926,Devontae Watson\devontae-watson-1,2015-16,Temple,F,10,3,54,2,5,.400,2,5,.400,0,0,,0,0,,2,7,9,0,1,1,2,10,4,0.1
7927,Myles Carter\myles-carter-1,2016-17,Seton Hall,F,5,0,33,2,7,.286,2,7,.286,0,0,,0,1,.000,2,5,7,0,1,0,3,5,4,-0.3
7928,Anthony Horton\anthony-horton-2,2013-14,Incarnate Word,F,1,1,16,1,5,.200,1,3,.333,0,2,.000,2,2,1.000,0,1,1,0,1,0,2,4,4,-1.4
7929,Herb Harrison\herb-harrison-2,2013-14,Eastern Kentucky,F,4,0,9,1,3,.333,1,3,.333,0,0,,2,2,1.000,2,2,4,0,0,0,0,0,4,1.1
7930,C.J. Cole\cj-cole-1,2013-14,Oklahoma,F,10,0,27,1,5,.200,1,4,.250,0,1,.000,2,6,.333,1,10,11,0,1,0,1,4,4,0.1
7931,Jack George\jack-george-1,2017-18,Elon,F,4,1,7,2,2,1.000,2,2,1.000,0,0,,0,0,,1,1,2,0,0,0,0,0,4,1.1
7932,Connor Griffin\connor-griffin-1,2013-14,Gonzaga,F,15,0,36,1,3,.333,1,3,.333,0,0,,2,4,.500,1,6,7,1,2,0,1,8,4,0.2
7933,Cole Blackstock\cole-blackstock-1,2017-18,Auburn,F,13,0,19,0,0,,0,0,,0,0,,4,4,1.000,0,4,4,0,0,1,0,5,4,0.3
7934,George Naldjieff\george-naldjieff-1,2013-14,Florida International,F,5,0,25,2,5,.400,2,5,.400,0,0,,0,0,,2,5,7,0,0,0,2,3,4,0.2
7935,Ryan Seelye\ryan-seelye-1,2015-16,Pittsburgh,F,8,0,12,2,5,.400,2,4,.500,0,1,.000,0,0,,1,0,1,0,0,0,0,2,4,0.2
7936,Karlis Silins\karlis-silins-1,2016-17,Mississippi,F,8,0,39,1,3,.333,1,3,.333,0,0,,2,4,.500,3,2,5,0,1,1,2,8,4,0.1
7937,Justin Earls\justin-earls-1,2015-16,Eastern Illinois,F,2,0,6,1,1,1.000,1,1,1.000,0,0,,2,4,.500,2,0,2,1,1,1,0,1,4,3.2
7938,Bates Jones\bates-jones-1,2017-18,Davidson,F,19,0,46,2,9,.222,2,6,.333,0,3,.000,0,0,,6,11,17,8,0,0,2,6,4,0.4
7939,Alberto Ganis\alberto-ganis-1,2014-15,Cal Poly,F,6,0,16,2,7,.286,2,7,.286,0,0,,0,0,,0,2,2,0,0,0,0,2,4,-0.1
7940,Abdoulaye Gueye\abdoulaye-gueye-1,2014-15,Georgia Tech,F,8,0,34,2,5,.400,2,4,.500,0,1,.000,0,2,.000,2,4,6,0,3,2,5,3,4,0.2
7941,Petr Stepanyants\petr-stepanyants-1,2017-18,Hartford,F,10,0,20,2,8,.250,2,7,.286,0,1,.000,0,1,.000,2,1,3,0,0,1,0,2,4,0.0
7942,Gabriel Connealy\gabriel-connealy-1,2014-15,Creighton,F,10,0,22,0,7,.000,0,4,.000,0,3,.000,4,4,1.000,4,2,6,0,1,0,1,2,4,0.2
7943,Luke Nathan\luke-nathan-1,2017-18,Rutgers,F,7,0,17,1,4,.250,1,4,.250,0,0,,2,4,.500,2,4,6,0,0,1,1,3,4,0.3
7944,Andre Brown\andre-brown-3,2014-15,Little Rock,F,12,3,78,2,6,.333,2,6,.333,0,0,,0,1,.000,8,5,13,0,3,0,4,9,4,0.2
7945,Reggie Theus\reggie-theus-2,2014-15,South Carolina,F,13,0,31,2,5,.400,2,3,.667,0,2,.000,0,0,,1,1,2,0,3,0,2,1,4,0.2
7946,Joshua Friar\joshua-friar-1,2014-15,Texas Southern,F,9,3,56,2,4,.500,2,4,.500,0,0,,0,2,.000,3,5,8,2,0,2,2,10,4,0.2
7947,Jordan Whitehead\jordan-whitehead-1,2015-16,High Point,F,9,0,18,1,5,.200,1,5,.200,0,0,,2,2,1.000,2,4,6,1,4,0,3,5,4,0.4
7948,Kevin Rafferty\kevin-rafferty-1,2015-16,Villanova,F,15,0,27,2,5,.400,2,4,.500,0,1,.000,0,0,,1,1,2,0,0,0,3,3,4,-0.1
7949,Clay Young\clay-young-1,2015-16,Kansas,F,9,0,20,1,1,1.000,1,1,1.000,0,0,,2,4,.500,0,3,3,0,0,0,1,2,4,0.2
7950,Connor Perkey\connor-perkey-1,2013-14,Davidson,F,7,0,12,1,1,1.000,1,1,1.000,0,0,,2,2,1.000,1,2,3,0,0,0,0,0,4,0.7
7951,Jon Schmidt\jon-schmidt-1,2014-15,Brown,F,5,1,18,2,4,.500,2,4,.500,0,0,,0,1,.000,1,4,5,0,0,2,1,1,4,0.7
7952,Adida Ikongshul\adida-ikongshul-1,2016-17,Western Michigan,F,21,0,130,1,13,.077,1,13,.077,0,0,,2,5,.400,11,21,32,2,2,1,6,24,4,-0.2
7953,Mitch Hill\mitch-hill-1,2015-16,Winthrop,F,9,0,25,2,8,.250,2,3,.667,0,5,.000,0,0,,0,3,3,2,0,0,1,0,4,0.1
7954,Ken Odiase\ken-odiase-1,2017-18,Chicago State,F,14,0,43,2,10,.200,2,10,.200,0,0,,0,6,.000,4,5,9,1,1,1,4,8,4,-0.4
7955,Cal Kennedy\cal-kennedy-1,2014-15,Loyola (IL),F,7,0,8,2,3,.667,2,2,1.000,0,1,.000,0,0,,1,1,2,0,0,1,0,1,4,0.6
7956,Greg McClinton\greg-mcclinton-1,2017-18,Old Dominion,F,2,1,10,2,2,1.000,2,2,1.000,0,0,,0,1,.000,1,2,3,0,0,0,1,1,4,1.5
7957,Ryan McClurg\ryan-mcclurg-1,2015-16,Texas,F,3,0,8,2,2,1.000,2,2,1.000,0,0,,0,1,.000,3,1,4,0,0,0,0,1,4,1.7
7958,Darius Scott\darius-scott-1,2014-15,Alabama State,F,9,0,30,2,8,.250,2,7,.286,0,1,.000,0,0,,0,2,2,1,0,0,2,4,4,-0.3
7959,Daniel Robinson\daniel-robinson-1,2014-15,Iona,F,2,0,13,2,3,.667,2,3,.667,0,0,,0,0,,0,1,1,0,0,1,0,2,4,1.5
7960,Charles O'Briant\charles-obriant-1,2017-18,Air Force,F,2,0,4,1,1,1.000,0,0,,1,1,1.000,1,2,.500,0,1,1,0,0,0,0,1,4,1.6
7961,Rosel Hurley\rosel-hurley-1,2016-17,Kent State,F,3,0,7,2,6,.333,2,5,.400,0,1,.000,0,1,.000,2,0,2,2,1,0,1,1,4,0.9
7962,Tyrie Hill-Thomas\tyrie-hill-thomas-1,2016-17,Missouri State,F,5,0,10,2,2,1.000,2,2,1.000,0,0,,0,0,,0,1,1,0,0,0,0,1,4,0.7
7963,Kevin Rafferty\kevin-rafferty-1,2014-15,Villanova,F,15,0,27,2,3,.667,2,2,1.000,0,1,.000,0,2,.000,0,4,4,0,0,0,0,4,4,0.1
7964,Eric Conklin\eric-conklin-1,2013-14,Arizona,F,7,0,17,2,2,1.000,2,2,1.000,0,0,,0,0,,0,1,1,0,0,0,0,1,4,0.5
7965,Aaron Moesch\aaron-moesch-1,2015-16,Wisconsin,F,15,0,48,1,2,.500,1,2,.500,0,0,,2,2,1.000,2,3,5,1,2,0,1,4,4,0.4
7966,James Bento\james-bento-1,2013-14,Mercer,F,12,0,24,2,6,.333,2,6,.333,0,0,,0,0,,4,5,9,1,0,0,0,5,4,0.3
7967,Alex Biggerstaff\alex-biggerstaff-1,2013-14,North Carolina-Asheville,F,7,0,49,1,11,.091,1,3,.333,0,8,.000,1,2,.500,3,6,9,5,0,0,1,4,3,0.0
7968,Tom Rivard\tom-rivard-1,2017-18,Colgate,F,2,0,20,1,7,.143,0,3,.000,1,4,.250,0,0,,0,0,0,1,0,1,2,2,3,-1.5
7969,Justin Burks\justin-burks-1,2014-15,UC-Santa Barbara,F,2,0,16,1,2,.500,0,0,,1,2,.500,0,0,,0,0,0,0,0,0,1,0,3,0.5
7970,Jordy Kuiper\jordy-kuiper-1,2013-14,North Carolina-Greensboro,F,24,0,106,1,9,.111,1,9,.111,0,0,,1,5,.200,6,18,24,0,0,0,9,19,3,-0.5
7971,Jimmy McDonnell\jimmy-mcdonnell-1,2014-15,Temple,F,15,1,52,1,9,.111,0,7,.000,1,2,.500,0,1,.000,4,4,8,2,2,3,5,8,3,-0.1
7972,Dondre Rhoden\dondre-rhoden-1,2016-17,Fairleigh Dickinson,F,18,0,40,1,3,.333,1,3,.333,0,0,,1,3,.333,1,4,5,0,1,1,3,10,3,-0.2
7973,Yito Alvarado\yito-alvarado-1,2016-17,South Florida,F,4,0,5,1,3,.333,0,1,.000,1,2,.500,0,0,,0,1,1,0,0,0,0,1,3,0.3
7974,Freddy Poole\freddy-poole-1,2015-16,Winthrop,F,12,0,34,1,4,.250,1,3,.333,0,1,.000,1,5,.200,0,5,5,0,3,0,1,5,3,0.0
7975,Austin Ervin\austin-ervin-1,2017-18,Central Michigan,F,8,1,10,1,4,.250,1,1,1.000,0,3,.000,1,2,.500,3,1,4,1,1,0,0,2,3,0.4
7976,Scott Kelly\scott-kelly-1,2014-15,Georgia Southern,F,5,0,14,1,1,1.000,1,1,1.000,0,0,,1,2,.500,2,4,6,1,0,0,2,1,3,0.6
7977,Brent Hibbitts\brent-hibbitts-1,2016-17,Michigan,F,11,0,22,1,2,.500,0,0,,1,2,.500,0,0,,2,2,4,2,0,0,2,2,3,0.2
7978,Aaron Moesch\aaron-moesch-1,2016-17,Wisconsin,F,17,0,40,1,4,.250,1,4,.250,0,0,,1,2,.500,5,2,7,2,2,0,0,1,3,0.4
7979,Chima Nwakpuda\chima-nwakpuda-1,2014-15,Temple,F,7,0,8,1,1,1.000,1,1,1.000,0,0,,1,2,.500,0,2,2,0,0,0,1,0,3,0.3
7980,Landon Fuller\landon-fuller-1,2017-18,Alabama,F,2,0,5,1,1,1.000,0,0,,1,1,1.000,0,0,,0,0,0,0,0,0,0,0,3,1.4
7981,Grant O'Brien\grant-obrien-1,2013-14,Wake Forest,F,4,0,4,1,2,.500,1,2,.500,0,0,,1,2,.500,0,2,2,0,0,0,0,0,3,0.6
7982,Alex Prahl\alex-prahl-1,2017-18,Milwaukee,F,11,0,20,0,2,.000,0,2,.000,0,0,,3,4,.750,0,6,6,0,0,0,0,2,3,0.2
7983,Zachary Reynolds\zachary-reynolds-1,2013-14,Northern Arizona,F,6,0,32,1,6,.167,0,5,.000,1,1,1.000,0,1,.000,3,3,6,0,0,0,1,2,3,0.0
7984,Naradain James\naradain-james-1,2017-18,Illinois-Chicago,F,3,0,25,1,9,.111,1,5,.200,0,4,.000,1,2,.500,2,2,4,0,1,3,1,1,3,0.1
7985,Henry Caruso\henry-caruso-1,2013-14,Princeton,F,8,0,14,0,4,.000,0,2,.000,0,2,.000,3,4,.750,2,3,5,0,0,1,5,2,3,-0.4
7986,Brandon Eddlestone\brian-eddlestone-1,2014-15,Louisiana State,F,3,0,9,1,2,.500,0,1,.000,1,1,1.000,0,0,,0,1,1,0,1,0,1,1,3,0.6
7987,Donovan Mitchell\donovan-mitchell-2,2016-17,Wake Forest,F,4,0,7,1,1,1.000,1,1,1.000,0,0,,1,2,.500,0,1,1,0,0,0,2,0,3,0.2
7988,Chris McComber\chris-mccomber-1,2013-14,Columbia,F,5,0,13,1,1,1.000,0,0,,1,1,1.000,0,0,,0,0,0,1,1,0,1,1,3,0.6
7989,Hudson Terrell\hudson-terrell-1,2015-16,Appalachian State,F,2,0,12,0,1,.000,0,1,.000,0,0,,3,6,.500,1,3,4,0,0,1,2,4,3,-0.1
7990,Ndene Gueye\ndene-gueye-1,2017-18,St. Bonaventure,F,5,1,17,0,3,.000,0,3,.000,0,0,,3,6,.500,3,2,5,0,2,0,2,4,3,0.2
7991,Eddie Davis\eddie-davis-1,2014-15,Southern Mississippi,F,4,0,19,1,5,.200,0,2,.000,1,3,.333,0,0,,1,4,5,0,0,1,1,5,3,-0.1
7992,Baylor Peterson\baylor-peterson-1,2015-16,Milwaukee,F,4,0,15,1,6,.167,1,2,.500,0,4,.000,1,2,.500,0,1,1,0,0,0,0,2,3,-0.4
7993,Tim Stainbrook\tim-stainbrook-1,2016-17,Xavier,F,13,0,37,1,5,.200,0,0,,1,5,.200,0,0,,0,3,3,2,0,1,0,4,3,0.1
7994,Marek Soucek\marek-soucek-1,2014-15,Oklahoma State,F,7,1,18,1,3,.333,0,1,.000,1,2,.500,0,0,,0,1,1,0,0,0,1,2,3,0.0
7995,Houston Kessler\houston-kessler-1,2013-14,Georgia,F,13,1,26,1,5,.200,0,2,.000,1,3,.333,0,0,,2,5,7,1,0,0,0,5,3,0.1
7996,Joe Strugg\joe-strugg-1,2016-17,Mississippi State,F,6,0,15,1,4,.250,0,1,.000,1,3,.333,0,0,,0,3,3,0,0,0,4,2,3,-0.6
7997,Andre Gonzague\andre-gonzague-1,2013-14,New Orleans,F,1,0,4,1,2,.500,0,0,,1,2,.500,0,0,,0,1,1,0,0,0,0,0,3,2.3
7998,Cameron Liss\cameron-liss-1,2015-16,Illinois,F,5,0,10,1,1,1.000,1,1,1.000,0,0,,1,2,.500,0,0,0,0,0,0,1,1,3,0.2
7999,Darius Stokes\darius-stokes-1,2013-14,Iowa,F,14,0,43,1,6,.167,1,6,.167,0,0,,1,2,.500,1,3,4,0,0,0,2,10,3,-0.4
8000,Greg Donlon\greg-donlon-1,2013-14,Virginia Tech,F,11,0,10,1,2,.500,1,2,.500,0,0,,1,2,.500,0,3,3,0,0,1,0,2,3,0.2
8001,Arthur Gray\arthur-gray-2,2017-18,Kennesaw State,F,3,0,4,1,3,.333,1,3,.333,0,0,,1,2,.500,0,1,1,0,0,0,1,1,3,-0.1
8002,Vincent Eze\vincent-eze-1,2015-16,Maine,F,1,1,26,1,5,.200,1,5,.200,0,0,,1,6,.167,3,6,9,3,0,1,2,2,3,1.8
8003,Tim Delaney\tim-delaney-1,2017-18,Villanova,F,22,0,49,1,6,.167,0,1,.000,1,5,.200,0,0,,2,3,5,3,0,0,1,14,3,-0.1
8004,Austin Mankin\austin-mankin-1,2015-16,Oklahoma,F,8,0,17,1,3,.333,1,2,.500,0,1,.000,1,2,.500,2,2,4,0,0,0,1,2,3,0.1
8005,Jeff Jones\jeff-jones-5,2016-17,Virginia,F,5,0,18,1,3,.333,0,1,.000,1,2,.500,0,0,,1,2,3,0,0,0,2,3,3,-0.1
8006,Darryl Matthews\darryl-matthews-1,2016-17,Hawaii,F,8,0,9,0,1,.000,0,1,.000,0,0,,3,6,.500,0,0,0,0,1,0,0,1,3,0.2
8007,Zack Tobler\zack-tobler-1,2014-15,Cincinnati,F,8,0,11,1,5,.200,1,3,.333,0,2,.000,1,5,.200,0,1,1,0,0,0,1,2,3,-0.4
8008,Brandon Allums\brandon-allums-1,2014-15,Texas,F,5,0,11,1,3,.333,1,3,.333,0,0,,1,2,.500,2,2,4,0,2,0,1,0,3,0.8
8009,Mudiaga Okagbare\mudiaga-okagbare-1,2014-15,Mississippi Valley State,F,1,1,25,1,3,.333,1,3,.333,0,0,,1,3,.333,0,4,4,0,1,0,3,0,3,-0.3
8010,Harrison Bowne\harrison-bowne-1,2014-15,College of Charleston,F,3,0,6,1,2,.500,0,1,.000,1,1,1.000,0,0,,0,1,1,1,0,0,0,0,3,1.0
8011,Alex Stecca\alex-stecca-1,2014-15,Northern Arizona,F,4,0,11,1,1,1.000,1,1,1.000,0,0,,1,2,.500,4,1,5,1,1,0,0,2,3,1.6
8012,Quentin Shropshire\questin-shropshire-1,2017-18,Cal State Long Beach,F,19,1,63,1,6,.167,1,6,.167,0,0,,1,3,.333,2,6,8,3,1,2,1,14,3,0.0
8013,Floyddell Wilson\floyddell-wilson-1,2013-14,Grambling,F,3,1,8,0,1,.000,0,1,.000,0,0,,3,4,.750,0,1,1,0,0,0,0,0,3,0.7
8014,Ousmane Ba\ousmane-ba-1,2015-16,Jacksonville State,F,19,7,87,1,6,.167,1,6,.167,0,0,,1,8,.125,9,10,19,3,2,2,5,30,3,-0.3
8015,Greg Roy\greg-roy-1,2016-17,Michigan State,F,8,0,8,1,3,.333,1,2,.500,0,1,.000,1,2,.500,1,0,1,0,0,0,0,2,3,0.1
8016,Craig Eubanks\craig-eubanks-1,2017-18,Akron,F,6,0,33,1,5,.200,0,1,.000,1,4,.250,0,0,,0,7,7,2,0,1,2,1,3,0.3
8017,Peter Hanley\peter-hanley-1,2016-17,Bradley,F,5,0,9,1,1,1.000,1,1,1.000,0,0,,1,2,.500,2,3,5,1,0,0,0,1,3,1.0
8018,Michael Dowdy\michael-dowdy-1,2015-16,Seton Hall,F,11,0,14,1,5,.200,0,4,.000,1,1,1.000,0,1,.000,1,3,4,0,0,0,0,0,3,0.1
8019,Cristian Perez\cristian-perez-1,2017-18,Sacramento State,F,3,0,13,1,3,.333,0,1,.000,1,2,.500,0,0,,0,1,1,0,1,0,3,0,3,-0.1
8020,Justin Burks\justin-burks-1,2015-16,UC-Santa Barbara,F,4,0,23,1,4,.250,0,1,.000,1,3,.333,0,0,,1,2,3,1,0,0,1,3,3,0.1
8021,Lucas Dyer\lucas-dyer-1,2013-14,Radford,F,4,0,39,0,5,.000,0,5,.000,0,0,,3,8,.375,5,6,11,2,3,1,2,6,3,0.9
8022,Brachen Hazen\brachen-hazen-1,2016-17,Arkansas,F,14,0,43,1,6,.167,1,4,.250,0,2,.000,1,4,.250,2,10,12,2,0,0,4,5,3,-0.2
8023,Ryan McClurg\ryan-mcclurg-1,2014-15,Texas,F,4,0,9,1,3,.333,1,3,.333,0,0,,1,2,.500,2,0,2,1,0,0,2,1,3,0.2
8024,James Richman\james-richman-1,2015-16,North Dakota,F,3,0,10,1,3,.333,1,3,.333,0,0,,1,2,.500,1,1,2,0,0,0,1,0,3,0.3
8025,Oliver Ehrnvall\oliver-ehrnvall-1,2016-17,Manhattan,F,10,0,42,1,5,.200,0,0,,1,5,.200,0,0,,4,3,7,1,0,0,2,3,3,0.1
8026,Andrew Cartwright\andrew-cartwright-1,2016-17,Drexel,F,4,0,10,1,3,.333,0,1,.000,1,2,.500,0,0,,1,0,1,0,0,0,0,1,3,0.4
8027,Judson Hall\judson-hall-1,2013-14,College of Charleston,F,5,1,6,1,2,.500,0,0,,1,2,.500,0,0,,0,4,4,0,0,0,0,0,3,0.6
8028,Patrick Farrell\patrick-farrell-1,2014-15,Villanova,F,15,0,27,1,5,.200,0,0,,1,5,.200,0,0,,0,3,3,1,2,0,3,1,3,0.0
8029,Okey Ukah\okey-ukah-1,2013-14,Iowa,F,9,0,26,1,4,.250,1,4,.250,0,0,,1,2,.500,2,4,6,0,0,1,1,0,3,0.3
8030,Jimmy Merrill\jimmy-merrill-1,2015-16,Siena,F,9,0,12,1,2,.500,0,0,,1,2,.500,0,0,,0,1,1,0,1,0,0,1,3,0.3
8031,Samer Dhillon\samer-dhillon-1,2016-17,Southern California,F,7,0,9,1,3,.333,0,1,.000,1,2,.500,0,0,,0,2,2,0,0,0,0,0,3,0.3
8032,Cole Welle\cole-welle-1,2015-16,University of California,F,5,0,13,1,3,.333,1,3,.333,0,0,,1,6,.167,0,3,3,0,1,0,0,1,3,0.2
8033,Sam Burkart\sam-burkart-1,2017-18,Milwaukee,F,6,0,8,1,3,.333,0,2,.000,1,1,1.000,0,0,,0,0,0,0,0,0,0,0,3,0.2
8034,Eric Rippetoe\eric-rippetoe-1,2014-15,Southern Utah,F,2,0,10,1,4,.250,1,2,.500,0,2,.000,1,2,.500,1,0,1,0,0,0,0,0,3,0.5
8035,Patrick Costello\patrick-costello-1,2013-14,Stephen F. Austin,F,14,0,37,1,3,.333,1,3,.333,0,0,,1,1,1.000,2,9,11,1,2,1,7,7,3,-0.1
8036,Roger Moute a Bidias\roger-moute-a-bidias-1,2013-14,University of California,F,15,0,89,0,6,.000,0,6,.000,0,0,,3,7,.429,5,8,13,4,0,4,5,7,3,0.1
8037,Eli Harrison\eli-harrison-1,2014-15,Dartmouth,F,3,0,7,1,1,1.000,0,0,,1,1,1.000,0,0,,0,1,1,0,0,0,0,2,3,0.7
8038,Tre Owens\tre-owens-1,2013-14,UC-Riverside,F,8,0,25,1,6,.167,0,1,.000,1,5,.200,0,0,,0,3,3,1,0,1,2,1,3,-0.1
8039,Courtland Sutton\courtland-sutton-1,2015-16,Southern Methodist,F,3,0,4,1,3,.333,0,1,.000,1,2,.500,0,0,,0,2,2,0,0,0,1,2,3,0.0
8040,Patrick Kerrigan\patrick-kerrigan-1,2014-15,Holy Cross,F,6,0,9,1,1,1.000,0,0,,1,1,1.000,0,0,,0,2,2,0,0,0,0,1,3,0.5
8041,Drew Romich\drew-romich-1,2015-16,Stetson,F,17,1,77,1,8,.125,1,8,.125,0,0,,1,3,.333,6,2,8,3,1,2,3,12,3,-0.1
8042,Evan Gross\evan-gross-1,2016-17,Oregon,F,2,0,4,1,1,1.000,0,0,,1,1,1.000,0,0,,0,1,1,0,0,0,1,0,3,1.0
8043,Aser Ghebremichael\aser-ghebremichael-1,2015-16,Boston College,F,2,0,7,1,1,1.000,0,0,,1,1,1.000,0,0,,0,1,1,0,0,0,0,2,3,1.1
8044,Justyn Hamilton\justyn-hamilton-1,2017-18,Temple,F,11,0,28,1,9,.111,1,9,.111,0,0,,1,2,.500,1,3,4,2,2,2,0,5,3,0.1
8045,Gerald Blount\gerald-blount-1,2016-17,Saint Joseph's,F,9,0,18,0,2,.000,0,2,.000,0,0,,3,4,.750,2,1,3,0,1,0,3,3,3,0.0
8046,Jake Hammond\jake-hammond-1,2014-15,Nebraska,F,11,0,36,1,5,.200,1,5,.200,0,0,,1,3,.333,3,4,7,1,0,2,2,6,3,0.0
8047,Zach Bush\zach-bush-1,2013-14,Wichita State,F,24,0,51,1,8,.125,0,4,.000,1,4,.250,0,2,.000,1,7,8,4,1,0,6,6,3,-0.2
8048,Ronnie Gombe\ron-gombe-1,2015-16,Canisius,F,13,0,38,1,6,.167,1,6,.167,0,0,,1,2,.500,1,4,5,0,0,1,3,12,3,-0.5
8049,Colin Kelly\colin-kelly-1,2013-14,Saint Joseph's,F,11,0,19,1,3,.333,1,2,.500,0,1,.000,1,2,.500,2,1,3,0,0,1,1,3,3,0.1
8050,Raivis Scerbinskis\raivis-scerbinskis-1,2017-18,Winthrop,F,9,0,22,1,11,.091,0,1,.000,1,10,.100,0,0,,2,1,3,0,1,0,1,3,3,-0.4
8051,Rashad Austin\rashad-austin-2,2017-18,Florida A&M,F,20,0,89,1,4,.250,1,4,.250,0,0,,1,3,.333,5,4,9,2,1,2,3,21,3,-0.2
8052,Gavin DeJong\gavin-dejong-1,2016-17,Montana,F,7,0,26,0,4,.000,0,4,.000,0,0,,3,4,.750,1,3,4,0,1,0,1,4,3,0.0
8053,Jeff Jones\jeff-jones-5,2013-14,Virginia,F,10,0,21,1,3,.333,1,2,.500,0,1,.000,1,3,.333,0,5,5,0,1,1,1,0,3,0.3
8054,John Heard\john-heard-1,2014-15,Baylor,F,7,0,15,1,4,.250,0,0,,1,4,.250,0,0,,0,4,4,0,0,0,0,2,3,0.1
8055,Aubrey Williams\aubrey-williams-2,2013-14,Toledo,F,9,0,18,1,2,.500,1,1,1.000,0,1,.000,1,2,.500,0,5,5,1,0,0,0,3,3,0.3
8056,Billy Murphy\billy-murphy-1,2015-16,Lafayette,F,12,1,16,1,5,.200,0,1,.000,1,4,.250,0,0,,0,1,1,0,0,1,0,0,3,0.1
8057,Eli Lininger\eli-lininger-1,2015-16,Yale,F,3,0,10,1,3,.333,1,3,.333,0,0,,1,4,.250,3,1,4,1,0,0,1,2,3,0.5
8058,Gilles Dekoninck\gilles-dekoninck-1,2017-18,Fresno State,F,7,0,14,1,3,.333,1,2,.500,0,1,.000,1,2,.500,0,2,2,0,0,0,1,1,3,0.0
8059,Tim Delaney\tim-delaney-1,2016-17,Villanova,F,7,0,26,1,2,.500,0,0,,1,2,.500,0,0,,0,2,2,0,0,0,2,4,3,-0.1
8060,Eyimofe Edukugho\eyimofe-edukugho-1,2014-15,Sacred Heart,F,3,0,16,0,5,.000,0,5,.000,0,0,,3,6,.500,2,1,3,1,0,2,1,2,3,0.1
8061,Raphael Veira\raphael-veira-1,2013-14,Cleveland State,F,11,0,16,1,3,.333,1,1,1.000,0,2,.000,1,2,.500,1,0,1,0,0,0,3,2,3,-0.2
8062,Elijah Graves\elijah-graves-1,2017-18,Southern Utah,F,4,0,13,1,3,.333,1,2,.500,0,1,.000,1,3,.333,0,2,2,1,0,0,1,4,3,-0.2
8063,Jackson Forbes\jackson-forbes-1,2014-15,Princeton,F,3,0,12,1,2,.500,0,0,,1,2,.500,0,0,,0,2,2,1,0,0,1,0,3,0.8
8064,Toby Van Ry\toby-vanry-1,2015-16,Colorado State,F,10,0,19,1,8,.125,1,5,.200,0,3,.000,1,2,.500,0,2,2,0,1,0,1,3,3,-0.3
8065,Eli Harrison\eli-harrison-1,2015-16,Dartmouth,F,2,0,40,1,5,.200,0,4,.000,1,1,1.000,0,0,,0,5,5,4,3,0,3,2,3,1.7
8066,Hunter Myers\hunter-myers-2,2013-14,Harvard,F,2,0,2,1,1,1.000,0,0,,1,1,1.000,0,0,,0,1,1,0,0,0,1,0,3,1.0
8067,Dale Jones\dale-jones-1,2016-17,Iowa,F,5,1,16,1,8,.125,0,1,.000,1,7,.143,0,0,,1,3,4,1,0,0,2,5,3,-0.8
8068,Connor Smith\connor-smith-1,2013-14,Washington,F,6,0,7,1,1,1.000,1,1,1.000,0,0,,0,0,,1,0,1,0,0,0,0,1,2,0.3
8069,Ryan Skovranko\ryan-skovranko-1,2014-15,Robert Morris,F,1,0,3,1,1,1.000,1,1,1.000,0,0,,0,0,,0,0,0,0,0,0,0,0,2,1.7
8070,Paul Friendshuh\paul-friendshuh-1,2016-17,Richmond,F,9,1,20,1,3,.333,1,3,.333,0,0,,0,0,,1,2,3,1,0,0,2,3,2,-0.1
8071,Danny Ogele\danny-ogele-1,2017-18,Navy,F,3,0,12,1,2,.500,1,2,.500,0,0,,0,0,,2,2,4,3,0,0,0,0,2,1.7
8072,Eric Washington Jr.\eric-washingtonjr-1,2016-17,Texas Southern,F,5,0,10,0,2,.000,0,1,.000,0,1,.000,2,4,.500,0,0,0,0,0,0,0,0,2,0.0
8073,Ryan McClurg\ryan-mcclurg-1,2016-17,Texas,F,4,0,15,0,0,,0,0,,0,0,,2,2,1.000,0,0,0,0,0,0,1,4,2,-0.2
8074,Isaac Mbuyamba\isaac-mbuyamba-1,2016-17,Kennesaw State,F,2,0,3,1,1,1.000,1,1,1.000,0,0,,0,0,,0,1,1,0,0,1,0,2,2,1.0
8075,Aaron Peek\aaron-peek-1,2013-14,Georgia Tech,F,3,0,9,1,3,.333,1,2,.500,0,1,.000,0,0,,1,2,3,0,0,0,0,1,2,0.4
8076,Darryl Wright\darryl-wright-1,2013-14,Mississippi Valley State,F,3,1,7,1,3,.333,1,3,.333,0,0,,0,0,,3,2,5,1,0,0,1,1,2,0.8
8077,Samer Dhillon\samer-dhillon-1,2015-16,Southern California,F,6,0,8,1,1,1.000,1,1,1.000,0,0,,0,0,,0,0,0,0,0,0,0,2,2,0.2
8078,Ryan Shannon\ryan-shannon-1,2014-15,Montana State,F,3,0,23,1,4,.250,1,4,.250,0,0,,0,0,,1,0,1,1,0,0,2,2,2,-0.6
8079,Tarekeyi Edogi\tarekeyi-edogi-1,2013-14,Tulsa,F,13,0,17,1,2,.500,1,2,.500,0,0,,0,0,,1,6,7,0,0,2,3,7,2,-0.1
8080,Demetrius Houston\demetrius-houston-1,2015-16,Mississippi State,F,1,0,6,1,1,1.000,1,1,1.000,0,0,,0,0,,0,0,0,0,0,0,0,0,2,1.7
8081,Jaylen Reid\jaylen-reid-1,2015-16,South Carolina State,F,5,0,23,1,5,.200,1,4,.250,0,1,.000,0,0,,2,1,3,2,0,0,0,0,2,0.4
8082,Greg Bowman\greg-bowman-1,2014-15,Washington,F,6,0,11,1,2,.500,1,1,1.000,0,1,.000,0,0,,1,1,2,1,0,0,0,1,2,0.4
8083,Kevin Coker\kevin-coker-1,2014-15,Xavier,F,3,0,4,1,1,1.000,1,1,1.000,0,0,,0,0,,0,0,0,0,0,0,0,0,2,0.6
8084,Michael Mache\michael-mache-1,2014-15,Marquette,F,4,0,6,1,2,.500,1,2,.500,0,0,,0,0,,2,0,2,0,0,0,0,0,2,0.6
8085,Anthony Catotti\anthony-catotti-1,2016-17,Central Florida,F,4,0,6,1,1,1.000,1,1,1.000,0,0,,0,0,,0,1,1,0,0,0,0,0,2,0.5
8086,Shaquillo Fritz\shaquillo-fritz-1,2017-18,Arkansas State,F,6,0,16,0,0,,0,0,,0,0,,2,2,1.000,1,4,5,0,0,1,1,9,2,0.0
8087,Montie Leunen\montie-leunen-1,2014-15,Portland State,F,5,0,19,0,3,.000,0,0,,0,3,.000,2,2,1.000,0,3,3,1,0,0,1,1,2,0.0
8088,Sam Frayer\sam-frayer-1,2014-15,Ohio,F,8,0,11,1,2,.500,1,1,1.000,0,1,.000,0,0,,0,5,5,0,0,1,1,1,2,0.2
8089,Naji Ozeir\naji-ozeir-1,2017-18,Michigan,F,2,0,7,1,2,.500,1,2,.500,0,0,,0,0,,0,1,1,0,1,0,0,1,2,1.0
8090,Grant Bryant\grant-bryant-1,2014-15,East Carolina,F,3,0,12,1,2,.500,1,2,.500,0,0,,0,0,,0,2,2,0,0,0,3,0,2,-0.5
8091,Ede Egharevba\ede-egharevba-1,2014-15,Albany (NY),F,5,0,8,1,5,.200,1,3,.333,0,2,.000,0,1,.000,0,1,1,0,2,0,1,3,2,-0.3
8092,Leo Walsh\leo-walsh-1,2013-14,Fordham,F,6,1,10,1,2,.500,1,2,.500,0,0,,0,0,,0,1,1,1,1,0,1,1,2,0.3
8093,Denzel Robinson\denzel-robinson-1,2013-14,North Carolina,F,8,1,13,1,2,.500,1,2,.500,0,0,,0,0,,1,4,5,1,0,0,1,1,2,0.3
8094,George Kiernan\george-kiernan-1,2015-16,Navy,F,2,0,5,1,2,.500,1,1,1.000,0,1,.000,0,0,,0,1,1,0,0,0,0,0,2,0.7
8095,Will Weethee\will-weethee-1,2015-16,Virginia Military Institute,F,6,0,13,0,1,.000,0,0,,0,1,.000,2,2,1.000,1,1,2,0,0,0,2,1,2,0.0
8096,Tyson Reynold\tyson-reynold-1,2014-15,Western Illinois,F,5,0,14,1,5,.200,1,5,.200,0,0,,0,0,,2,4,6,1,0,0,2,2,2,-0.1
8097,Jevoni Robinson\jevoni-robinson-1,2013-14,North Carolina State,F,5,0,6,1,1,1.000,1,1,1.000,0,0,,0,0,,2,0,2,0,0,0,0,3,2,0.4
8098,Alex Foree\alex-foree-1,2017-18,Tulsa,F,3,0,3,1,2,.500,1,1,1.000,0,1,.000,0,0,,0,1,1,0,0,0,0,0,2,0.4
8099,Mike Mondragon\mike-mondragon-1,2017-18,New Mexico,F,6,0,12,1,1,1.000,1,1,1.000,0,0,,0,0,,0,0,0,1,0,0,2,1,2,0.0
8100,Thomas Peters\thomas-peters-1,2013-14,Pacific,F,6,0,7,1,3,.333,1,3,.333,0,0,,0,0,,1,0,1,1,0,0,0,0,2,0.3
8101,Brady Ernst\brady-ernst-1,2015-16,Iowa State,F,6,0,14,1,3,.333,1,3,.333,0,0,,0,0,,2,2,4,0,0,1,0,1,2,0.4
8102,Eric Adams\eric-adams-2,2013-14,Samford,F,2,0,4,1,2,.500,1,2,.500,0,0,,0,0,,1,0,1,0,0,1,0,1,2,1.0
8103,Luka Kamber\luka-kamber-1,2016-17,Nicholls State,F,7,0,55,1,9,.111,1,5,.200,0,4,.000,0,0,,4,7,11,1,3,0,5,10,2,-0.6
8104,Sam Frayer\sam-frayer-1,2015-16,Ohio,F,10,0,8,1,6,.167,1,6,.167,0,0,,0,0,,3,1,4,0,0,0,1,0,2,0.0
8105,Freddy Poole\freddy-poole-1,2014-15,Winthrop,F,8,0,14,1,1,1.000,1,1,1.000,0,0,,0,0,,1,5,6,0,1,0,3,2,2,0.1
8106,Harrison Burton\harrison-burton-1,2015-16,Presbyterian,F,2,0,5,1,2,.500,1,2,.500,0,0,,0,2,.000,1,1,2,0,0,0,1,0,2,0.1
8107,Dan Studer\dan-studer-1,2014-15,Milwaukee,F,12,0,45,1,7,.143,1,6,.167,0,1,.000,0,1,.000,4,2,6,3,2,0,4,8,2,-0.2
8108,Leon Carswell\leon-carswell-1,2013-14,Louisiana-Monroe,F,1,0,5,0,0,,0,0,,0,0,,2,2,1.000,0,2,2,0,0,0,2,1,2,0.2
8109,Tim Priller\tim-priller-1,2014-15,Indiana,F,8,0,23,1,6,.167,1,3,.333,0,3,.000,0,0,,1,2,3,0,1,2,2,5,2,-0.3
8110,Clay Young\clay-young-1,2016-17,Kansas,F,10,0,19,0,1,.000,0,1,.000,0,0,,2,5,.400,1,6,7,1,0,0,0,1,2,0.3
8111,Nick Segura\nick-segura-1,2014-15,Northwestern,F,2,0,3,0,2,.000,0,1,.000,0,1,.000,2,2,1.000,2,0,2,0,0,0,0,1,2,0.8
8112,Wes Brewer\wes-brewer-1,2013-14,Elon,F,4,0,10,1,3,.333,1,3,.333,0,0,,0,2,.000,1,5,6,0,0,0,2,4,2,-0.5
8113,Will Hollmann\will-hollman-1,2015-16,Stetson,F,6,1,17,0,3,.000,0,2,.000,0,1,.000,2,2,1.000,0,3,3,0,0,0,1,4,2,-0.3
8114,Shandon Goldman\shandon-goldman-1,2016-17,Little Rock,F,5,0,23,1,3,.333,1,2,.500,0,1,.000,0,2,.000,0,3,3,1,1,2,3,4,2,-0.2
8115,Adam Wolf\adam-wolf-1,2016-17,Missouri,F,10,0,22,1,5,.200,1,3,.333,0,2,.000,0,0,,3,0,3,0,1,0,0,3,2,0.1
8116,Riley Till\riley-till-1,2017-18,Iowa,F,8,0,23,1,5,.200,1,1,1.000,0,4,.000,0,0,,0,1,1,0,2,0,1,2,2,-0.1
8117,Chris Downing\chris-downing-1,2015-16,Fordham,F,2,0,4,1,1,1.000,1,1,1.000,0,0,,0,0,,1,0,1,0,1,0,0,1,2,1.5
8118,Igor Cvorovic\igor-cvorovic-1,2016-17,Loyola (IL),F,1,0,7,1,5,.200,1,5,.200,0,0,,0,2,.000,2,2,4,1,0,0,1,1,2,-0.6
8119,John Gibson\john-gibson-1,2014-15,Alabama,F,3,0,5,1,1,1.000,1,1,1.000,0,0,,0,1,.000,1,2,3,0,1,0,0,2,2,0.9
8120,Fallou Ndoye\fallou-ndoye-1,2015-16,Mississippi State,F,6,0,45,1,2,.500,1,2,.500,0,0,,0,1,.000,4,3,7,1,0,1,3,16,2,-0.6
8121,Paxson Guest\paxson-guest-1,2014-15,Northwestern State,F,11,0,13,1,4,.250,1,1,1.000,0,3,.000,0,0,,1,0,1,0,0,0,2,2,2,-0.2
8122,Scott Kelly\scott-kelly-1,2013-14,Georgia Southern,F,12,0,33,1,2,.500,1,2,.500,0,0,,0,2,.000,1,5,6,0,0,0,1,4,2,0.0
8123,Arik Armstead\arik-armstead-1,2013-14,Oregon,F,1,0,4,1,1,1.000,1,1,1.000,0,0,,0,0,,0,0,0,0,0,0,0,1,2,1.3
8124,Jack Karapetyan\jack-karapetyan-1,2013-14,Kansas State,F,6,0,20,1,4,.250,1,4,.250,0,0,,0,0,,0,1,1,0,0,0,0,1,2,-0.1
8125,Patrick Herlihy\patrick-herlihy-1,2017-18,Syracuse,F,4,0,4,1,2,.500,1,2,.500,0,0,,0,0,,0,1,1,0,0,0,0,1,2,0.2
8126,Patrick Geha\patrick-geha-1,2017-18,Oklahoma,F,5,0,10,0,3,.000,0,3,.000,0,0,,2,2,1.000,0,2,2,0,0,0,0,0,2,0.1
8127,Troy Rike\troy-rike-1,2015-16,Wake Forest,F,5,0,7,1,2,.500,1,2,.500,0,0,,0,0,,0,6,6,0,0,0,0,0,2,0.6
8128,Tyler Johnson\tyler-johnson-3,2014-15,William & Mary,F,5,0,17,1,5,.200,1,5,.200,0,0,,0,0,,0,4,4,0,0,1,0,2,2,0.0
8129,John Auslander\john-auslander-1,2013-14,Maryland,F,9,1,24,0,4,.000,0,1,.000,0,3,.000,2,2,1.000,0,1,1,0,1,0,0,2,2,0.0
8130,Grant Hazle\grant-hazle-1,2016-17,Penn State,F,4,0,2,1,2,.500,1,2,.500,0,0,,0,0,,0,0,0,0,0,0,0,0,2,0.3
8131,Balsa Dragovic\balsa-dragovic-1,2016-17,Harvard,F,2,0,6,1,2,.500,1,1,1.000,0,1,.000,0,0,,1,3,4,0,0,1,1,0,2,1.2
8132,Lazaro Rojas\lazaro-rojas-1,2017-18,Fresno State,F,8,0,17,1,3,.333,1,2,.500,0,1,.000,0,0,,2,2,4,1,0,0,1,1,2,0.2
8133,Glen Pierre\glen-pierre-1,2013-14,College of Charleston,F,9,0,14,1,1,1.000,1,1,1.000,0,0,,0,0,,1,3,4,1,0,0,1,5,2,0.1
8134,Darian Jones\darian-jones-1,2016-17,Tulane,F,9,0,16,1,3,.333,1,2,.500,0,1,.000,0,0,,3,2,5,1,0,0,3,4,2,-0.1
8135,Jalen Hayes\jalen-hayes-1,2013-14,Oakland,F,4,0,13,1,2,.500,1,2,.500,0,0,,0,0,,1,1,2,0,0,1,0,4,2,0.3
8136,Khadim Ndiaye\khadim-ndiaye-1,2013-14,St. John's (NY),F,6,1,15,1,4,.250,1,4,.250,0,0,,0,0,,1,0,1,0,0,0,0,1,2,0.0
8137,Jake Desjardins\jake-desjardins-1,2017-18,Arizona,F,3,0,7,1,2,.500,1,2,.500,0,0,,0,0,,0,3,3,1,0,0,1,2,2,0.3
8138,Patrick Mazza\patrick-mazza-1,2016-17,Notre Dame,F,4,0,4,1,2,.500,1,2,.500,0,0,,0,0,,0,1,1,0,0,1,1,0,2,0.3
8139,Mo Lewis\mo-lewis-1,2016-17,Navy,F,5,0,16,1,3,.333,1,3,.333,0,0,,0,0,,1,0,1,1,0,0,0,0,2,0.3
8140,Kenneth Wachira\kenneth-wachira-1,2013-14,Jackson State,F,15,1,39,1,3,.333,1,2,.500,0,1,.000,0,0,,1,2,3,0,0,0,5,12,2,-0.5
8141,Spencer Nicolds\spencer-nicolds-1,2015-16,Idaho State,F,3,0,15,1,2,.500,1,1,1.000,0,1,.000,0,4,.000,0,3,3,2,0,2,0,5,2,0.4
8142,Emerson Bursis\emerson-bursis-1,2014-15,Rider,F,7,1,13,1,4,.250,1,2,.500,0,2,.000,0,0,,0,2,2,0,0,0,1,2,2,-0.2
8143,Keith Armstrong\keith-armstrong-1,2014-15,East Carolina,F,11,0,36,1,4,.250,1,4,.250,0,0,,0,0,,2,4,6,1,0,1,2,5,2,0.0
8144,Eric Washington Jr.\eric-washingtonjr-1,2015-16,Texas Southern,F,4,0,3,1,2,.500,1,2,.500,0,0,,0,0,,0,2,2,0,0,0,0,0,2,0.4
8145,Troy Rike\troy-rike-1,2016-17,Wake Forest,F,5,0,6,1,1,1.000,1,1,1.000,0,0,,0,1,.000,1,2,3,0,0,0,1,2,2,0.2
8146,Cameron Blakley\cameron-blakely-1,2013-14,Charlotte,F,15,0,47,0,11,.000,0,4,.000,0,7,.000,2,2,1.000,2,5,7,1,0,1,2,8,2,-0.4
8147,Ryan Seelye\ryan-seelye-1,2016-17,Pittsburgh,F,2,0,4,1,1,1.000,1,1,1.000,0,0,,0,0,,0,0,0,0,0,0,0,0,2,0.9
8148,Jaylen Reid\jaylen-reid-1,2016-17,South Carolina State,F,3,0,27,1,2,.500,1,2,.500,0,0,,0,0,,0,2,2,0,0,0,2,4,2,-0.7
8149,Trey Reeves\trey-reeves-1,2017-18,Oklahoma State,F,9,0,22,1,5,.200,1,3,.333,0,2,.000,0,0,,0,2,2,0,0,0,2,3,2,-0.4
8150,Cole Welle\cole-welle-1,2014-15,University of California,F,6,0,11,1,6,.167,1,6,.167,0,0,,0,0,,2,2,4,0,1,0,0,2,2,0.1
8151,Donyell Marshall Jr.\donyell-marshalljr-1,2017-18,Central Connecticut State,F,7,0,14,1,3,.333,1,3,.333,0,0,,0,0,,1,1,2,0,0,1,0,2,2,0.2
8152,Jamar Brown\jamar-brown-1,2016-17,Wagner,F,2,0,8,1,2,.500,1,2,.500,0,0,,0,0,,2,0,2,0,1,0,1,1,2,1.0
8153,Michael Oyefusi\michael-oyefusi-1,2013-14,Coppin State,F,3,0,6,1,2,.500,1,1,1.000,0,1,.000,0,1,.000,0,0,0,0,2,0,1,0,2,0.5
8154,Nick Pendergast\nick-pendergast-1,2014-15,Temple,F,12,1,20,1,6,.167,1,4,.250,0,2,.000,0,2,.000,1,0,1,1,0,1,1,3,2,-0.2
8155,Marshall Macheledt\marshall-macheledt-1,2014-15,Duquesne,F,6,0,10,1,2,.500,1,2,.500,0,0,,0,0,,1,2,3,0,0,1,0,1,2,0.4
8156,Kiko Stavrev\kiko-stavrev-1,2015-16,Weber State,F,4,0,20,1,4,.250,1,2,.500,0,2,.000,0,0,,1,1,2,3,0,0,1,2,2,0.2
8157,Evan Gross\evan-gross-1,2017-18,Oregon,F,3,0,8,1,1,1.000,1,1,1.000,0,0,,0,0,,0,0,0,3,1,0,3,2,2,0.3
8158,Nick DiNardi\nick-dinardi-1,2017-18,Loyola (IL),F,9,0,12,1,5,.200,1,5,.200,0,0,,0,0,,2,2,4,0,0,0,1,0,2,0.0
8159,John Cain Carney\john-cain-carney-1,2013-14,Boston College,F,4,0,5,1,1,1.000,1,1,1.000,0,0,,0,0,,2,0,2,0,0,0,0,0,2,0.8
8160,D'Andre Mahaffey\dandre-mahaffey-1,2015-16,Virginia Military Institute,F,10,0,45,0,4,.000,0,1,.000,0,3,.000,2,4,.500,0,5,5,1,1,1,4,8,2,-0.5
8161,John McCarty\john-mccarty-1,2014-15,Central Michigan,F,1,0,4,1,1,1.000,1,1,1.000,0,0,,0,0,,2,0,2,1,0,0,0,1,2,3.4
8162,Rand Rowland\rand-rowland-1,2016-17,Georgia Tech,F,8,0,16,1,3,.333,1,3,.333,0,0,,0,0,,3,1,4,2,0,0,3,1,2,0.1
8163,Nick Foschia\nick-foschia-1,2015-16,Duquesne,F,11,0,19,1,8,.125,1,6,.167,0,2,.000,0,0,,3,5,8,1,0,0,1,2,2,-0.1
8164,Jonathan Arledge\jonathan-arledge-1,2013-14,George Mason,F,1,1,25,0,0,,0,0,,0,0,,2,4,.500,1,2,3,0,1,1,3,4,2,-0.4
8165,Justin Botteri\justin-botteri-1,2015-16,Nevada,F,4,0,11,1,2,.500,1,2,.500,0,0,,0,0,,1,2,3,1,0,0,2,1,2,0.2
8166,Cameron Liss\cameron-liss-1,2017-18,Illinois,F,8,0,16,1,2,.500,1,2,.500,0,0,,0,0,,0,0,0,0,1,0,0,3,2,0.1
8167,Sean Tingle\sean-tingle-1,2014-15,Arkansas-Pine Bluff,F,3,0,9,0,5,.000,0,5,.000,0,0,,2,4,.500,4,0,4,0,1,1,1,2,2,0.1
8168,Miki Ljuboja\miki-ljuboja-1,2014-15,Brown,F,5,0,16,1,2,.500,1,1,1.000,0,1,.000,0,0,,1,1,2,0,2,0,4,2,2,-0.2
8169,Bo Blight\bo-blight-1,2017-18,Charlotte,F,7,0,14,1,3,.333,1,3,.333,0,0,,0,0,,1,4,5,0,0,0,0,0,2,0.3
8170,Nate Ritchie\nate-ritchie-1,2014-15,Indiana,F,6,0,15,0,1,.000,0,1,.000,0,0,,2,2,1.000,3,3,6,2,1,0,0,1,2,1.1
8171,D.J. Wilson\dj-wilson-1,2014-15,Michigan,F,5,0,24,1,4,.250,1,3,.333,0,1,.000,0,0,,1,5,6,0,0,3,1,4,2,0.3
8172,Alan Wisniewski\alan-wisniewski-1,2014-15,Penn State,F,10,1,18,1,1,1.000,1,1,1.000,0,0,,0,0,,2,4,6,0,0,1,0,2,2,0.4
8173,Joel Angus III\joel-angusiii-1,2016-17,Southeast Missouri State,F,1,0,9,1,2,.500,1,2,.500,0,0,,0,0,,0,1,1,0,0,0,1,0,2,0.3
8174,Jake Desjardins\jake-desjardins-1,2016-17,Arizona,F,6,0,12,0,2,.000,0,2,.000,0,0,,2,2,1.000,0,1,1,0,0,0,2,3,2,-0.4
8175,Tobias Dwumaah\tobias-dwumaah-1,2017-18,DePaul,F,5,0,9,0,0,,0,0,,0,0,,2,2,1.000,1,0,1,0,0,0,0,0,2,0.5
8176,Andrew Pickles\andrew-pickles-1,2017-18,UC-Santa Barbara,F,2,0,10,1,3,.333,1,3,.333,0,0,,0,1,.000,2,1,3,0,0,0,0,0,2,0.8
8177,Amir Savon\amir-savon-1,2015-16,Mississippi Valley State,F,7,2,34,1,4,.250,1,4,.250,0,0,,0,0,,0,2,2,0,0,0,0,2,2,-0.1
8178,Richard Bell\richard-bell-1,2013-14,Nevada,F,11,0,44,1,4,.250,1,3,.333,0,1,.000,0,0,,2,6,8,3,2,0,1,9,2,0.2
8179,Dan Steinberg\dan-steinberg-2,2013-14,Hofstra,F,6,0,5,1,1,1.000,1,1,1.000,0,0,,0,0,,0,1,1,0,0,0,0,0,2,0.3
8180,Okey Ukah\okey-ukah-1,2014-15,Iowa,F,10,0,24,1,2,.500,1,2,.500,0,0,,0,0,,2,5,7,1,2,0,2,3,2,0.3
8181,Malik Garner\malik-garner-1,2014-15,Maryland-Baltimore County,F,6,0,24,1,4,.250,1,3,.333,0,1,.000,0,0,,1,1,2,1,0,0,0,3,2,0.0
8182,Nick DiNardi\nick-dinardi-1,2016-17,Loyola (IL),F,4,0,10,1,1,1.000,1,1,1.000,0,0,,0,0,,1,3,4,0,0,0,0,3,2,0.5
8183,Tom Leibig\tom-leibig-1,2017-18,Villanova,F,15,0,22,1,5,.200,1,1,1.000,0,4,.000,0,0,,0,3,3,0,1,0,1,0,2,0.0
8184,Conrad Stephens\conrad-stephens-1,2016-17,Robert Morris,F,14,2,64,1,4,.250,1,4,.250,0,0,,0,0,,3,2,5,2,1,0,6,9,2,-0.4
8185,Lincoln Conrey\lincoln-conrey-1,2016-17,Northern Iowa,F,9,0,13,1,3,.333,1,2,.500,0,1,.000,0,1,.000,1,0,1,1,0,0,1,0,2,0.0
8186,Bryce Jackson\bryce-jackson-1,2017-18,North Texas,F,8,0,24,0,4,.000,0,0,,0,4,.000,2,2,1.000,2,6,8,0,0,0,4,4,2,-0.4
8187,Austin Flues\austin-flues-1,2013-14,Air Force,F,1,0,6,0,0,,0,0,,0,0,,2,2,1.000,0,0,0,0,0,0,0,0,2,2.0
8188,Shawn Ray\shawn-ray-1,2015-16,UC-Irvine,F,16,1,41,1,8,.125,1,8,.125,0,0,,0,1,.000,4,3,7,0,0,5,1,4,2,0.1
8189,Jonathan Graham\jonathan-graham-2,2013-14,Maryland,F,1,0,7,1,2,.500,1,2,.500,0,0,,0,0,,2,0,2,0,0,0,1,0,2,1.4
8190,Austin Williams\austin-williams-3,2017-18,Yale,F,3,0,9,1,3,.333,1,2,.500,0,1,.000,0,2,.000,0,1,1,0,0,1,0,1,2,0.0
8191,Barrington Alston\barrington-alston-1,2013-14,Towson,F,16,0,57,1,5,.200,1,4,.250,0,1,.000,0,0,,3,5,8,0,1,0,5,16,2,-0.5
8192,Quentin Shropshire\questin-shropshire-1,2015-16,Cal State Long Beach,F,7,0,13,1,4,.250,1,4,.250,0,0,,0,0,,1,2,3,0,1,0,1,2,2,0.0
8193,Matt Banas\matt-banas-1,2014-15,Bucknell,F,7,0,14,1,1,1.000,1,1,1.000,0,0,,0,0,,1,0,1,1,0,0,0,2,2,0.3
8194,KJ Logue\kj-logue-1,2014-15,Cal Poly,F,9,0,48,0,1,.000,0,1,.000,0,0,,2,6,.333,4,2,6,1,1,0,1,2,2,0.3
8195,Trevor Bohnhoff\trevor-bohnhoff-1,2014-15,Michigan State,F,13,0,23,0,0,,0,0,,0,0,,2,4,.500,1,2,3,0,1,0,0,0,2,0.3
8196,Terrance Ditimi\terrance-ditimi-1,2014-15,Connecticut,F,6,0,7,1,1,1.000,1,1,1.000,0,0,,0,0,,0,1,1,0,0,0,0,1,2,0.3
8197,Viktor Juricek\viktor-juricek-1,2013-14,South Alabama,F,3,0,14,1,6,.167,1,3,.333,0,3,.000,0,0,,1,1,2,0,1,0,1,4,2,-0.8
8198,Erando Halilaj\erando-halilaj-1,2014-15,Fordham,F,5,0,7,1,2,.500,1,2,.500,0,0,,0,0,,1,0,1,1,0,0,1,0,2,0.3
8199,Ty'Shaun McCollum\tyshaun-mccollum-1,2014-15,North Carolina A&T,F,6,0,6,1,1,1.000,1,1,1.000,0,0,,0,0,,0,0,0,0,0,0,0,0,2,0.3
8200,Brad Anlauf\brad-anlauf-1,2013-14,Michigan,F,8,0,16,1,4,.250,1,4,.250,0,0,,0,0,,0,2,2,1,0,0,1,2,2,-0.1
8201,Ashton Malone-Dunson\ashton-malone-dunson-1,2016-17,Fairleigh Dickinson,F,9,0,13,1,2,.500,1,2,.500,0,0,,0,0,,1,0,1,0,0,0,0,1,2,0.1
8202,Caid Kirven\caid-kirven-1,2014-15,Virginia,F,10,0,18,1,2,.500,1,2,.500,0,0,,0,0,,2,2,4,0,0,0,1,1,2,0.2
8203,Mike Layssard\mike-layssard-1,2016-17,Rhode Island,F,8,0,23,1,9,.111,1,8,.125,0,1,.000,0,0,,4,6,10,1,0,1,2,2,2,-0.1
8204,Myles Mann\myles-mann-1,2015-16,Fairleigh Dickinson,F,2,0,8,1,6,.167,1,6,.167,0,0,,0,0,,0,1,1,0,0,0,0,1,2,-1.0
8205,Bailey Patella\bailey-patella-1,2017-18,Vermont,F,13,0,31,1,1,1.000,1,1,1.000,0,0,,0,2,.000,0,7,7,3,1,1,0,2,2,0.5
8206,Dylan Causwell\dylan-causwell-1,2017-18,Loyola Marymount,F,4,0,10,0,2,.000,0,1,.000,0,1,.000,2,4,.500,0,2,2,0,0,1,0,0,2,0.3
8207,Brauhnye' Turner\brauhnye-turner-1,2013-14,Grambling,F,6,0,13,1,3,.333,1,2,.500,0,1,.000,0,0,,1,1,2,0,0,0,0,1,2,0.2
8208,Danny Newsome\danny-newsome-1,2014-15,Texas,F,5,0,13,1,4,.250,1,3,.333,0,1,.000,0,0,,1,4,5,0,0,0,1,3,2,-0.1
8209,Gaston Diedhiou\gaston-diedhiou-1,2016-17,Minnesota,F,4,0,9,1,3,.333,1,2,.500,0,1,.000,0,0,,1,1,2,0,0,0,0,0,2,0.3
8210,Hefeng Sun\hefeng-sun-1,2013-14,Norfolk State,F,6,0,14,0,1,.000,0,1,.000,0,0,,2,2,1.000,1,1,2,1,0,0,0,0,2,0.5
8211,Nate Sherwood\nate-sherwood-1,2014-15,Idaho,F,6,0,43,1,5,.200,1,4,.250,0,1,.000,0,2,.000,3,7,10,0,1,1,5,10,2,-0.8
8212,Harrison Prieto\harrison-prieto-1,2017-18,Florida State,F,2,0,5,1,2,.500,1,2,.500,0,0,,0,0,,0,0,0,1,0,0,0,0,2,0.9
8213,Josh Wolf\josh-wolf-1,2017-18,Lehigh,F,3,0,7,0,1,.000,0,1,.000,0,0,,2,2,1.000,0,1,1,0,0,1,2,1,2,0.0
8214,Rokas Ulvydas\rokas-ulvydas-1,2015-16,Texas Tech,F,9,0,23,0,2,.000,0,2,.000,0,0,,2,4,.500,1,1,2,0,0,6,3,6,2,0.0
8215,Mike Kobani\mike-kobani-1,2015-16,Appalachian State,F,6,0,26,1,3,.333,1,3,.333,0,0,,0,0,,5,3,8,0,0,0,4,8,2,-0.4
8216,Andrew Pickles\andrew-pickles-1,2016-17,UC-Santa Barbara,F,3,1,10,0,0,,0,0,,0,0,,2,2,1.000,1,2,3,0,0,0,1,1,2,0.6
8217,Antravious Simmons\antravious-simmons-1,2014-15,Virginia Commonwealth,F,3,0,9,1,1,1.000,1,1,1.000,0,0,,0,0,,0,2,2,0,0,0,0,2,2,0.5
8218,Will Lienhard\will-lienhard-1,2016-17,Oklahoma State,F,12,0,33,1,2,.500,1,2,.500,0,0,,0,2,.000,2,8,10,1,0,3,1,3,2,0.4
8219,Nnamdi Amilo\nnamdi-amilo-1,2013-14,Connecticut,F,2,0,5,0,1,.000,0,1,.000,0,0,,2,2,1.000,0,2,2,0,0,0,0,1,2,0.8
8220,Dan Dwyer\dan-dwyer-1,2016-17,Pennsylvania,F,7,0,15,1,1,1.000,1,1,1.000,0,0,,0,0,,1,2,3,2,0,1,0,6,2,0.4
8221,George Muresan\george-muresan-1,2017-18,Georgetown,F,6,0,17,1,1,1.000,1,1,1.000,0,0,,0,0,,0,0,0,0,0,0,0,0,2,0.3
8222,Rich Washington\rich-washington-1,2016-17,Wake Forest,F,8,0,17,1,6,.167,1,2,.500,0,4,.000,0,0,,0,2,2,3,0,0,1,3,2,-0.2
8223,Oumar Barry\oumar-barry-1,2015-16,DePaul,F,12,0,28,1,3,.333,1,3,.333,0,0,,0,6,.000,0,2,2,0,0,1,0,2,2,-0.1
8224,Samer Dhillon\samer-dhillon-1,2013-14,Southern California,F,3,0,4,1,3,.333,1,3,.333,0,0,,0,0,,1,0,1,0,0,0,0,0,2,0.3
8225,Reid Aube\reid-aube-1,2014-15,Charlotte,F,4,0,5,1,2,.500,1,2,.500,0,0,,0,0,,2,3,5,0,0,0,0,2,2,0.6
8226,Dan Sheets\dan-sheets-1,2017-18,Saint Mary's (CA),F,6,0,7,1,2,.500,1,2,.500,0,0,,0,0,,0,1,1,0,0,0,0,1,2,0.2
8227,Chase Jones\chase-jones-1,2015-16,Virginia Military Institute,F,3,0,6,1,2,.500,1,1,1.000,0,1,.000,0,0,,1,0,1,0,1,0,0,0,2,0.9
8228,Stanley Roberts\stanley-roberts-2,2014-15,Tulane,F,2,0,6,1,1,1.000,1,1,1.000,0,0,,0,0,,0,1,1,0,0,1,0,2,2,1.0
8229,Michael Rudy\michael-rudy-1,2014-15,George Mason,F,4,0,4,1,1,1.000,1,1,1.000,0,0,,0,0,,0,0,0,0,0,0,0,1,2,0.3
8230,Nick Foschia\nick-foschia-1,2014-15,Duquesne,F,10,0,18,1,4,.250,1,2,.500,0,2,.000,0,2,.000,1,2,3,0,0,0,1,1,2,-0.1
8231,Siyao Sun\siyao-sun-1,2016-17,Cal State Northridge,F,1,0,9,1,4,.250,1,3,.333,0,1,.000,0,0,,1,4,5,0,1,0,0,2,2,1.7
8232,Ronnie Gombe\ronnie-gombe-1,2016-17,Canisius,F,1,0,2,1,1,1.000,1,1,1.000,0,0,,0,0,,0,0,0,0,0,0,0,0,2,1.7
8233,Cameron Blakley\cameron-blakely-1,2015-16,Charlotte,F,10,0,36,0,11,.000,0,4,.000,0,7,.000,2,4,.500,1,1,2,0,1,1,3,16,2,-1.3
8234,Cavan LaRose\cavan-larose-1,2017-18,Sacred Heart,F,5,0,10,0,0,,0,0,,0,0,,1,2,.500,0,0,0,0,0,0,0,2,1,0.0
8235,Justin Dueck\justin-dueck-1,2014-15,UC-Davis,F,5,0,23,0,1,.000,0,1,.000,0,0,,1,4,.250,2,2,4,0,1,2,3,7,1,-0.5
8236,Spencer Barks\spencer-barks-1,2013-14,Maryland,F,4,0,5,0,1,.000,0,1,.000,0,0,,1,2,.500,1,0,1,0,0,0,0,0,1,0.2
8237,Connor O'Neill\connor-oneill-1,2017-18,Georgia,F,3,0,7,0,5,.000,0,5,.000,0,0,,1,2,.500,4,0,4,0,1,0,2,0,1,-0.4
8238,Will Thoni\will-thoni-1,2013-14,Davidson,F,9,1,16,0,7,.000,0,2,.000,0,5,.000,1,2,.500,0,2,2,1,2,0,2,0,1,-0.3
8239,Gilbert McGregor\gilbert-mcgregor-1,2015-16,Wake Forest,F,4,0,5,0,0,,0,0,,0,0,,1,2,.500,0,1,1,1,1,0,1,0,1,0.4
8240,Harrison Curry\harrison-curry-1,2017-18,Louisiana Tech,F,1,0,6,0,1,.000,0,1,.000,0,0,,1,2,.500,0,2,2,0,0,0,0,1,1,0.1
8241,Patrick Farrell\patrick-farrell-1,2013-14,Villanova,F,8,0,12,0,0,,0,0,,0,0,,1,3,.333,1,1,2,0,1,0,0,0,1,0.3
8242,John Sica\john-sica-1,2016-17,Columbia,F,6,0,32,0,6,.000,0,3,.000,0,3,.000,1,2,.500,1,6,7,2,0,0,2,4,1,-0.6
8243,Deshaven Reynolds\deshaven-reynolds-1,2016-17,Georgia Southern,F,2,0,5,0,2,.000,0,1,.000,0,1,.000,1,4,.250,0,1,1,0,0,0,0,0,1,-0.7
8244,Daniel Edwards\daniel-edwards-1,2013-14,Princeton,F,7,0,13,0,1,.000,0,1,.000,0,0,,1,2,.500,2,2,4,0,0,0,2,1,1,-0.1
8245,Zack Kaminsky\zach-kaminsky-1,2017-18,Pennsylvania,F,4,0,12,0,4,.000,0,1,.000,0,3,.000,1,2,.500,0,1,1,0,0,0,1,0,1,-0.7
8246,Troy Rike\troy-rike-1,2014-15,Wake Forest,F,4,0,6,0,1,.000,0,1,.000,0,0,,1,2,.500,1,1,2,1,0,0,0,0,1,0.4
8247,Alex Schulz\alex-schulz-1,2017-18,James Madison,F,1,0,2,0,0,,0,0,,0,0,,1,2,.500,2,1,3,0,0,0,0,0,1,2.3
8248,Chris Stowell\chris-stowell-1,2017-18,Miami (FL),F,7,1,11,0,1,.000,0,0,,0,1,.000,1,2,.500,0,1,1,0,0,0,0,0,1,0.0
8249,Charlie Hall\charlie-hall-1,2017-18,Northwestern,F,4,0,12,0,2,.000,0,0,,0,2,.000,1,3,.333,0,1,1,0,0,2,0,0,1,0.1
8250,Grant O'Brien\grant-obrien-1,2015-16,Wake Forest,F,10,1,44,0,8,.000,0,2,.000,0,6,.000,1,1,1.000,0,3,3,0,0,1,0,2,1,-0.4
8251,Cameron Liss\cameron-liss-1,2014-15,Illinois,F,12,0,16,0,0,,0,0,,0,0,,1,2,.500,0,3,3,0,0,0,1,1,1,0.0
8252,Malcolm Simmons\malcolm-simmons-1,2015-16,Central Connecticut State,F,3,0,12,0,1,.000,0,1,.000,0,0,,1,2,.500,0,4,4,0,0,0,1,1,1,-0.1
8253,Drew Mellon\drew-mellon-1,2013-14,Arizona,F,6,0,12,0,1,.000,0,1,.000,0,0,,1,2,.500,1,0,1,1,0,0,0,0,1,0.2
8254,Myles Thornton\myles-thornton-1,2017-18,Incarnate Word,F,14,1,24,0,1,.000,0,0,,0,1,.000,1,2,.500,0,2,2,0,0,1,1,3,1,-0.1
8255,Chido Onyiuke\chido-onyiuke-1,2013-14,Loyola (MD),F,8,0,9,0,1,.000,0,1,.000,0,0,,1,2,.500,2,0,2,0,0,0,1,1,1,0.0
8256,Hashim Moore\hashim-moore-1,2013-14,Princeton,F,7,0,10,0,0,,0,0,,0,0,,1,2,.500,0,3,3,0,0,0,2,2,1,-0.2
8257,Daniel Andrews\daniel-andrews-1,2015-16,Army,F,2,0,5,0,1,.000,0,1,.000,0,0,,1,4,.250,0,1,1,0,1,0,1,0,1,-0.3
8258,Travis Rollo\travis-rollo-1,2015-16,Army,F,16,1,67,0,4,.000,0,4,.000,0,0,,1,2,.500,5,8,13,1,1,1,2,6,1,0.1
8259,Matt Dahlen\matt-dahlen-1,2015-16,Oregon State,F,9,0,10,0,1,.000,0,1,.000,0,0,,1,2,.500,0,1,1,1,0,0,0,1,1,0.1
8260,John Carlson\john-carlson-2,2016-17,Nevada,F,9,0,31,0,1,.000,0,1,.000,0,0,,1,5,.200,3,4,7,0,0,1,1,3,1,0.1
8261,Justin Wesley\justin-wesley-1,2013-14,Kansas,F,14,1,33,0,3,.000,0,1,.000,0,2,.000,1,2,.500,1,8,9,0,0,1,1,4,1,0.0
8262,Alex Stecca\alex-stecca-1,2015-16,Northern Arizona,F,3,0,5,0,1,.000,0,1,.000,0,0,,1,2,.500,0,1,1,0,0,1,0,0,1,0.3
8263,Kaharri Carter\kaharri-carter-1,2016-17,Green Bay,F,4,0,10,0,1,.000,0,0,,0,1,.000,1,2,.500,0,1,1,0,1,0,0,0,1,0.3
8264,Justin Robinson\justin-robinson-4,2016-17,Duke,F,6,0,10,0,0,,0,0,,0,0,,1,2,.500,0,1,1,0,0,0,0,0,1,0.2
8265,Michael Mache\michael-mache-1,2015-16,Marquette,F,4,0,10,0,1,.000,0,1,.000,0,0,,1,2,.500,2,0,2,0,0,0,0,0,1,0.3
8266,Harrison Bowne\harrison-bowne-1,2015-16,College of Charleston,F,5,1,18,0,2,.000,0,0,,0,2,.000,1,3,.333,0,2,2,0,0,0,0,1,1,-0.2
8267,Evan Jester\evan-jester-1,2017-18,Georgia Tech,F,3,0,4,0,1,.000,0,0,,0,1,.000,1,2,.500,0,1,1,0,0,0,1,1,1,-0.4
8268,Daniel Green\daniel-green-2,2014-15,Wake Forest,F,4,0,4,0,0,,0,0,,0,0,,1,2,.500,1,0,1,0,0,0,0,0,1,0.3
8269,Collin Goss\collin-goss-1,2015-16,George Washington,F,18,0,41,0,5,.000,0,4,.000,0,1,.000,1,2,.500,1,8,9,1,1,3,3,6,1,-0.1
8270,Tanner Morgan\tanner-morgan-1,2016-17,Northern Colorado,F,1,0,0,0,0,,0,0,,0,0,,1,1,1.000,0,0,0,0,0,0,0,0,1,1.0
8271,Jernard Jarreau\jernard-jarreau-1,2013-14,Washington,F,1,1,2,0,0,,0,0,,0,0,,1,2,.500,0,0,0,0,1,0,0,0,1,1.6
8272,Tim Priller\tim-priller-1,2017-18,Indiana,F,4,0,4,0,0,,0,0,,0,0,,1,2,.500,0,2,2,0,0,0,0,1,1,0.2
8273,Patrick Onwenu\patrick-onwenu-1,2014-15,Detroit Mercy,F,1,0,5,0,1,.000,0,1,.000,0,0,,1,2,.500,2,0,2,0,0,0,1,1,1,-0.1
8274,Sam Frayer\sam-frayer-1,2016-17,Ohio,F,12,0,19,0,4,.000,0,1,.000,0,3,.000,1,4,.250,2,5,7,0,0,0,2,2,1,-0.2
8275,Stephen Zurich\stephen-zurich-1,2013-14,Rutgers,F,13,0,35,0,2,.000,0,1,.000,0,1,.000,1,2,.500,2,3,5,1,0,0,2,3,1,-0.1
8276,Jamarrio Rule\jamarrio-rule-1,2017-18,Central Michigan,F,4,0,6,0,0,,0,0,,0,0,,1,2,.500,0,1,1,1,0,0,0,0,1,0.4
8277,Alex Wolf\alex-wolf-2,2014-15,Dartmouth,F,4,0,4,0,0,,0,0,,0,0,,1,2,.500,0,1,1,0,0,0,0,0,1,0.2
8278,Omar El Manasterly\omar-el-manasterly-1,2013-14,Jacksonville,F,4,0,9,0,1,.000,0,1,.000,0,0,,0,0,,0,2,2,0,0,0,3,1,0,-0.9
8279,Kevin Coker\kevin-coker-1,2015-16,Xavier,F,6,0,5,0,1,.000,0,1,.000,0,0,,0,0,,0,0,0,0,0,0,0,1,0,-0.2
8280,Trey Mourning\trey-mourning-1,2014-15,Georgetown,F,6,0,12,0,4,.000,0,1,.000,0,3,.000,0,0,,1,1,2,3,0,0,1,3,0,-0.3
8281,Connor O'Neill\connor-oneill-1,2015-16,Georgia,F,3,0,4,0,0,,0,0,,0,0,,0,2,.000,0,0,0,0,0,0,0,0,0,-0.3
8282,Scott Sill\scott-sill-1,2013-14,Delaware State,F,1,0,1,0,0,,0,0,,0,0,,0,0,,0,0,0,0,0,0,0,0,0,0.0
8283,Rand Rowland\rand-rowland-1,2014-15,Georgia Tech,F,1,0,2,0,0,,0,0,,0,0,,0,0,,0,0,0,0,0,0,0,1,0,-0.4
8284,Kenneth Wachira\kenneth-wachira-1,2014-15,Jackson State,F,4,0,6,0,0,,0,0,,0,0,,0,0,,0,0,0,0,0,0,0,0,0,0.0
8285,Lorenzo Edwards\lorenzo-edwards-1,2016-17,Saint Joseph's,F,1,0,4,0,1,.000,0,0,,0,1,.000,0,0,,1,0,1,0,1,0,1,0,0,0.0
8286,Zach Bush\zach-bush-1,2014-15,Wichita State,F,3,0,11,0,1,.000,0,1,.000,0,0,,0,2,.000,0,2,2,1,0,0,0,1,0,-0.2
8287,Andre Slavik\andre-slavik-1,2013-14,Idaho State,F,1,0,0,0,0,,0,0,,0,0,,0,0,,0,0,0,0,0,1,0,0,0,0.7
8288,Brandon Allums\brandon-allums-1,2013-14,Texas,F,3,0,4,0,2,.000,0,2,.000,0,0,,0,0,,0,1,1,0,0,0,0,0,0,-0.4
8289,Chris Brickhouse\chris-brickhouse-1,2015-16,North Carolina State,F,2,0,2,0,0,,0,0,,0,0,,0,0,,0,0,0,0,0,0,0,0,0,0.0
8290,Eric Kindler\eric-kindler-1,2013-14,Saint Joseph's,F,6,0,11,0,2,.000,0,1,.000,0,1,.000,0,1,.000,1,3,4,1,0,0,3,0,0,-0.4
8291,Marquis Todd\marquis-todd-1,2013-14,Jackson State,F,2,0,1,0,0,,0,0,,0,0,,0,0,,1,0,1,0,0,0,0,0,0,0.4
8292,Cedrick Alley Jr\cedrick-alleyjr-1,2017-18,Houston,F,2,0,13,0,2,.000,0,0,,0,2,.000,0,0,,0,1,1,1,0,0,0,2,0,-0.6
8293,Jared Bryant\jared-bryant-1,2015-16,Northern Kentucky,F,1,0,3,0,0,,0,0,,0,0,,0,0,,0,0,0,0,0,0,0,0,0,0.0
8294,David Leitao III\david-leitaoiii-1,2016-17,DePaul,F,2,0,5,0,0,,0,0,,0,0,,0,0,,0,1,1,0,0,0,0,0,0,0.2
8295,Daniel Utomi\daniel-utomi-1,2015-16,Akron,F,2,0,4,0,2,.000,0,1,.000,0,1,.000,0,0,,0,0,0,0,1,0,0,0,0,-0.2
8296,Tim Stainbrook\tim-stainbrook-1,2015-16,Xavier,F,9,0,17,0,0,,0,0,,0,0,,0,0,,0,0,0,1,0,1,1,1,0,0.0
8297,Chris Stowell\chris-stowell-1,2016-17,Miami (FL),F,6,0,12,0,1,.000,0,0,,0,1,.000,0,0,,0,2,2,0,0,0,0,0,0,0.0
8298,Darien Best\darien-best-1,2013-14,Long Island University,F,3,0,4,0,0,,0,0,,0,0,,0,0,,0,0,0,0,0,0,0,1,0,-0.1
8299,Dan Sheets\dan-sheets-1,2015-16,Saint Mary's (CA),F,1,0,0,0,0,,0,0,,0,0,,0,0,,0,0,0,0,0,0,0,0,0,0.0
8300,Terry Brutus\terry-brutus-1,2014-15,Mississippi,F,2,1,7,0,0,,0,0,,0,0,,0,0,,0,0,0,1,1,0,0,1,0,0.7
8301,Terrell Scruggs\terrell-scruggs-1,2016-17,Texas-San Antonio,F,1,0,0,0,0,,0,0,,0,0,,0,0,,0,1,1,0,0,0,0,0,0,0.3
8302,Ben Brown-White\ben-brown-white-1,2013-14,Stephen F. Austin,F,12,0,27,0,1,.000,0,1,.000,0,0,,0,0,,0,2,2,0,0,1,4,10,0,-0.6
8303,Hayden Barnard\hayden-barnard-1,2014-15,Missouri,F,1,0,1,0,0,,0,0,,0,0,,0,0,,0,0,0,0,0,0,0,0,0,0.0
8304,Trey Tate\trey-tate-1,2016-17,Auburn,F,2,0,4,0,1,.000,0,0,,0,1,.000,0,0,,0,0,0,0,0,0,0,1,0,-0.6
8305,Alain Chigha\alain-chigha-1,2013-14,Quinnipiac,F,8,0,33,0,6,.000,0,6,.000,0,0,,0,2,.000,1,1,2,0,2,0,1,7,0,-0.7
8306,Ethan Claycomb\ethan-claycomb-1,2017-18,Indiana State,F,7,0,20,0,4,.000,0,1,.000,0,3,.000,0,0,,0,1,1,1,1,0,0,3,0,-0.3
8307,Nate Morris\nate-morris-1,2016-17,Mississippi,F,7,0,36,0,5,.000,0,5,.000,0,0,,0,0,,2,5,7,0,0,3,3,8,0,-0.7
8308,Vincent McFadden\vincent-mcfadden-1,2016-17,Army,F,1,0,2,0,0,,0,0,,0,0,,0,0,,0,0,0,0,0,0,0,0,0,0.0
8309,Matt Singleton\matt-singleton-1,2017-18,Xavier,F,6,0,5,0,0,,0,0,,0,0,,0,0,,0,0,0,0,0,0,0,1,0,-0.1
8310,Michael Hall\michael-hall-2,2013-14,Harvard,F,4,0,4,0,0,,0,0,,0,0,,0,0,,0,0,0,0,0,0,1,1,0,-0.4
8311,Felix White\felix-white-1,2016-17,UC-Santa Barbara,F,6,0,25,0,1,.000,0,1,.000,0,0,,0,0,,1,4,5,0,0,1,2,5,0,-0.4
8312,Connor Perkey\connor-perkey-1,2016-17,Davidson,F,2,1,1,0,0,,0,0,,0,0,,0,0,,0,0,0,0,0,0,0,0,0,0.0
8313,Jabrille Williams\jabrille-williams-1,2013-14,Binghamton,F,11,0,38,0,4,.000,0,4,.000,0,0,,0,0,,1,7,8,1,1,0,1,3,0,0.0
8314,John Gardner\john-gardner-1,2017-18,Southern Illinois,F,1,0,1,0,0,,0,0,,0,0,,0,2,.000,0,0,0,0,0,0,0,0,0,-0.8
8315,Marshall Macheledt\marshall-macheledt-1,2015-16,Duquesne,F,1,0,1,0,0,,0,0,,0,0,,0,0,,0,0,0,0,0,0,0,0,0,0.0
8316,Kuony Deng\kuony-deng-1,2016-17,Virginia Military Institute,F,1,0,1,0,0,,0,0,,0,0,,0,0,,0,0,0,0,0,0,0,0,0,0.0
8317,Toby Egbuna\toby-egbuna-1,2015-16,North Carolina,F,16,0,19,0,7,.000,0,4,.000,0,3,.000,0,0,,0,2,2,0,1,0,1,1,0,-0.3
8318,Nick Banyard\nick-banyard-1,2014-15,Illinois State,F,1,0,0,0,0,,0,0,,0,0,,0,0,,0,0,0,0,0,0,0,0,0,0.0
8319,Karam Mashour\karam-mashour-1,2013-14,Morehead State,F,2,0,5,0,1,.000,0,1,.000,0,0,,0,0,,0,2,2,1,0,1,1,1,0,-0.1
8320,Matt Weyand\matt-weyand-1,2017-18,Arizona,F,1,0,1,0,0,,0,0,,0,0,,0,0,,0,0,0,0,0,0,0,0,0,0.0
8321,Darian Childress\darian-childress-1,2017-18,Northern Kentucky,F,4,0,4,0,1,.000,0,1,.000,0,0,,0,0,,0,0,0,0,0,0,1,0,0,-0.4
8322,George Gudadze\george-gudadze-1,2014-15,Alcorn State,F,6,0,14,0,2,.000,0,1,.000,0,1,.000,0,4,.000,3,2,5,0,0,0,0,2,0,-0.2
8323,Christian Foxen\christian-foxen-1,2016-17,Connecticut,F,9,0,11,0,2,.000,0,1,.000,0,1,.000,0,0,,0,1,1,0,0,0,0,1,0,-0.2
8324,Tyriq Nady\tyriq-nady-1,2016-17,James Madison,F,8,0,27,0,5,.000,0,5,.000,0,0,,0,0,,3,1,4,2,0,0,4,4,0,-0.7
8325,Darius Dawkins\darius-dawkins-1,2014-15,Jacksonville,F,1,0,8,0,2,.000,0,0,,0,2,.000,0,0,,0,2,2,0,0,0,0,0,0,-0.8
8326,Matt Cimino\matt-cimino-1,2015-16,George Washington,F,3,0,12,0,1,.000,0,1,.000,0,0,,0,0,,0,2,2,0,0,0,1,2,0,-0.6
8327,Rafiki Muhamad\rafiki-muhamad-1,2015-16,Texas-Rio Grande Valley,F,4,0,6,0,0,,0,0,,0,0,,0,0,,0,1,1,0,0,0,2,1,0,-0.5
8328,Andrew Scocca\andrew-scocca-1,2013-14,Bryant,F,1,0,1,0,0,,0,0,,0,0,,0,0,,0,0,0,0,0,0,0,0,0,0.0
8329,Byron Smith\byron-smith-1,2015-16,Southeastern Louisiana,F,5,0,7,0,0,,0,0,,0,0,,0,0,,0,3,3,0,0,0,0,1,0,0.1
8330,Jimmy Merrill\jimmy-merrill-1,2016-17,Siena,F,9,1,21,0,5,.000,0,0,,0,5,.000,0,0,,1,9,10,1,0,0,0,2,0,0.0
8331,Chris Manning\chris-manning-1,2015-16,Mount St. Mary's,F,13,0,47,0,1,.000,0,1,.000,0,0,,0,0,,1,1,2,0,0,0,0,3,0,-0.1
8332,Tommy Williams\tommy-williams-1,2013-14,Delaware,F,9,1,12,0,2,.000,0,2,.000,0,0,,0,0,,1,4,5,0,0,0,1,3,0,-0.2
8333,Sean Barksdale\sean-barksdale-1,2016-17,Saint Peter's,F,5,0,6,0,2,.000,0,0,,0,2,.000,0,0,,0,4,4,0,0,0,0,1,0,-0.1
8334,Eric Horn\eric-horn-2,2017-18,Mississippi,F,1,0,1,0,0,,0,0,,0,0,,0,0,,0,1,1,0,0,0,0,0,0,0.3
8335,Duncan Douglas\duncan-douglas-1,2017-18,Maine,F,2,0,19,0,2,.000,0,0,,0,2,.000,0,0,,0,1,1,0,0,1,1,3,0,-1.3
8336,Aram Martin\aram-martin-1,2013-14,Brown,F,4,0,21,0,3,.000,0,1,.000,0,2,.000,0,0,,0,3,3,0,1,0,1,3,0,-0.6
8337,Rodney Ross\rodney-ross-1,2016-17,Bethune-Cookman,F,4,0,19,0,1,.000,0,1,.000,0,0,,0,2,.000,1,2,3,0,0,0,0,4,0,-0.5
8338,Eric Shaw\eric-shaw-1,2013-14,Longwood,F,1,0,0,0,1,.000,0,1,.000,0,0,,0,0,,0,0,0,0,0,0,0,0,0,-0.7
8339,Zack Kaminsky\zach-kaminsky-1,2016-17,Pennsylvania,F,4,0,5,0,0,,0,0,,0,0,,0,0,,0,0,0,0,0,0,0,0,0,0.0
8340,Jeff Jones\jeff-jones-5,2015-16,Virginia,F,12,0,18,0,4,.000,0,0,,0,4,.000,0,0,,0,0,0,1,0,0,2,4,0,-0.5
8341,Emil Knighton\emil-knighton-1,2016-17,Denver,F,6,0,7,0,1,.000,0,1,.000,0,0,,0,0,,1,1,2,0,0,0,0,0,0,0.1
8342,Jack Vukelich\jack-vukelich-1,2017-18,Mount St. Mary's,F,5,0,10,0,4,.000,0,2,.000,0,2,.000,0,0,,2,0,2,0,0,0,0,2,0,-0.4
8343,Chandler Thomas\chandler-thomas-1,2014-15,Ohio,F,3,0,4,0,3,.000,0,2,.000,0,1,.000,0,0,,1,0,1,0,0,0,1,0,0,-0.8
8344,David Cooper\david-cooper-2,2015-16,Air Force,F,1,0,0,0,0,,0,0,,0,0,,0,0,,1,0,1,0,0,0,0,0,0,0.7
8345,Jesse Johnson\jesse-johnson-1,2017-18,Memphis,F,1,0,2,0,0,,0,0,,0,0,,0,0,,0,0,0,0,0,0,0,0,0,0.0
8346,Marcus Roberts\marcus-roberts-1,2017-18,Mississippi Valley State,F,1,0,0,0,2,.000,0,2,.000,0,0,,0,0,,1,1,2,0,0,0,1,0,0,-1.4
8347,Rex Sunahara\rex-sunahara-1,2015-16,Rhode Island,F,3,0,3,0,0,,0,0,,0,0,,0,0,,0,1,1,0,0,0,0,0,0,0.1
8348,Yito Alvarado\yito-alvarado-1,2017-18,South Florida,F,9,0,10,0,2,.000,0,1,.000,0,1,.000,0,0,,2,1,3,1,1,0,1,0,0,0.1
8349,Tyler McNeely\tyler-mcneely-1,2013-14,North Carolina-Greensboro,F,2,1,3,0,0,,0,0,,0,0,,0,0,,0,0,0,0,0,0,0,0,0,0.0
8350,Khadim Ndiaye\khadim-ndiaye-1,2014-15,St. John's (NY),F,11,0,14,0,1,.000,0,1,.000,0,0,,0,0,,0,0,0,0,0,0,0,1,0,-0.1
8351,Jack Parsley\jack-parsley-1,2016-17,Dayton,F,2,0,2,0,0,,0,0,,0,0,,0,0,,0,0,0,0,0,0,0,0,0,0.0
8352,James Glenn\james-glenn-1,2017-18,Jackson State,F,8,0,21,0,1,.000,0,1,.000,0,0,,0,0,,1,3,4,1,0,2,2,7,0,-0.2
8353,Hunter Myers\hunter-myers-2,2015-16,Harvard,F,2,0,2,0,0,,0,0,,0,0,,0,0,,0,2,2,0,0,0,0,0,0,0.3
8354,Nick Finke\nick-finke-1,2017-18,Army,F,1,0,4,0,0,,0,0,,0,0,,0,0,,0,0,0,0,0,0,0,0,0,0.0
8355,Austin Williamson\austin-williamson-1,2013-14,Army,F,1,0,0,0,0,,0,0,,0,0,,0,0,,1,0,1,0,0,0,0,0,0,0.7
8356,Austin Sottile\austin-sottile-1,2017-18,Texas Christian,F,2,0,2,0,1,.000,0,1,.000,0,0,,0,0,,0,0,0,0,0,0,0,0,0,-0.4
8357,DouDou Gueye\doudou-gueye-1,2014-15,South Carolina State,F,1,0,0,0,0,,0,0,,0,0,,0,0,,0,0,0,0,0,1,0,0,0,0.7
8358,Mac Lake\mac-lake-1,2013-14,Presbyterian,F,1,0,1,0,0,,0,0,,0,0,,0,0,,0,0,0,0,0,0,0,0,0,0.0
8359,Callum Kimberley\callum-kimberley-1,2017-18,Idaho State,F,7,0,18,0,1,.000,0,1,.000,0,0,,0,1,.000,1,0,1,0,2,0,2,3,0,-0.2
8360,Neal Beshears\neal-beshears-1,2013-14,Purdue,F,6,0,12,0,1,.000,0,1,.000,0,0,,0,0,,0,2,2,0,0,1,0,2,0,0.0
8361,Charles Dent\charles-dent-1,2015-16,Chicago State,F,1,0,0,0,0,,0,0,,0,0,,0,0,,0,1,1,0,0,0,0,0,0,0.3
8362,Isaiah Baker\isaiah-baker-1,2013-14,Holy Cross,F,5,0,4,0,0,,0,0,,0,0,,0,0,,0,1,1,0,0,0,1,0,0,-0.1
8363,Tim Stainbrook\tim-stainbrook-1,2014-15,Xavier,F,4,0,5,0,1,.000,0,1,.000,0,0,,0,0,,1,0,1,0,0,0,0,1,0,-0.1
8364,Dylan Boehm\dylan-boehm-1,2017-18,Loyola (IL),F,5,0,7,0,1,.000,0,1,.000,0,0,,0,0,,0,0,0,2,0,0,0,1,0,0.1
8365,Yilret Yiljep\yilret-yiljep-1,2016-17,American,F,1,1,1,0,0,,0,0,,0,0,,0,0,,0,0,0,0,0,0,0,0,0,0.0
8366,Jake Johnson\jake-johnson-1,2014-15,Pepperdine,F,10,0,43,0,1,.000,0,1,.000,0,0,,0,1,.000,1,5,6,2,0,2,1,9,0,-0.1
8367,Balsa Dragovic\balsa-dragovic-1,2017-18,Harvard,F,1,0,1,0,0,,0,0,,0,0,,0,0,,0,0,0,0,0,0,0,1,0,-0.4
8368,Marek Hulva\marek-hulva-1,2016-17,Incarnate Word,F,4,0,3,0,0,,0,0,,0,0,,0,0,,1,0,1,0,0,0,0,2,0,0.0
8369,Dewayne Washington\dewayne-washington-1,2015-16,Texas Southern,F,4,0,4,0,1,.000,0,1,.000,0,0,,0,0,,0,1,1,0,0,0,1,3,0,-0.7
8370,Tom Schalk\tom-schalk-1,2013-14,William & Mary,F,10,0,31,0,4,.000,0,3,.000,0,1,.000,0,0,,4,3,7,1,0,0,2,2,0,-0.1
8371,Mack Mercer\mack-mercer-1,2016-17,Belmont,F,1,0,0,0,1,.000,0,1,.000,0,0,,0,0,,0,0,0,0,0,0,0,0,0,-0.7
8372,Christian Jones\christian-jones-1,2013-14,St. John's (NY),F,1,0,0,0,0,,0,0,,0,0,,0,0,,0,1,1,0,0,1,0,0,0,1.0
8373,Chris Stowell\chris-stowell-1,2015-16,Miami (FL),F,9,0,14,0,1,.000,0,0,,0,1,.000,0,0,,0,3,3,0,0,1,1,1,0,-0.1
8374,Chad Holtz\chad-holtz-1,2015-16,Notre Dame,F,1,0,1,0,0,,0,0,,0,0,,0,0,,0,1,1,0,0,0,0,0,0,0.3
8375,Tom Planek\tom-planek-1,2016-17,Providence,F,7,0,13,0,0,,0,0,,0,0,,0,3,.000,3,3,6,0,0,1,2,1,0,0.0
8376,Stafford Trueheart\stafford-trueheart-1,2016-17,Hofstra,F,1,0,1,0,0,,0,0,,0,0,,0,0,,0,1,1,0,0,0,0,0,0,0.3
8377,Sam Holtze\sam-holtze-1,2017-18,Boston College,F,2,0,3,0,0,,0,0,,0,0,,0,0,,0,0,0,0,0,0,1,0,0,-0.5
8378,Jordan Wells\jordan-wells-1,2013-14,McNeese State,F,5,0,19,0,4,.000,0,3,.000,0,1,.000,0,0,,0,0,0,0,1,1,0,1,0,-0.3
8379,Shaquille Evans\shaquille-evans-1,2017-18,Canisius,F,3,0,5,0,1,.000,0,1,.000,0,0,,0,0,,0,1,1,0,0,0,0,0,0,-0.1
8380,John McCarty\john-mccarty-1,2015-16,Central Michigan,F,4,0,5,0,1,.000,0,0,,0,1,.000,0,0,,0,0,0,0,0,0,0,0,0,-0.2
8381,T.J. Traylor\tj-traylor-1,2015-16,Texas A&M-Corpus Christi,F,1,0,6,0,2,.000,0,2,.000,0,0,,0,0,,0,3,3,0,0,0,0,0,0,-0.5
8382,Stephen Zurich\stephen-zurich-1,2014-15,Rutgers,F,8,0,29,0,1,.000,0,1,.000,0,0,,0,2,.000,0,2,2,1,0,1,2,4,0,-0.4
8383,Harrison Bowne\harrison-bowne-1,2013-14,College of Charleston,F,2,0,2,0,1,.000,0,1,.000,0,0,,0,0,,0,0,0,0,0,0,0,0,0,-0.4
8384,Conrad Stephens\conrad-stephens-1,2014-15,Robert Morris,F,4,0,5,0,2,.000,0,1,.000,0,1,.000,0,0,,0,0,0,1,0,0,0,1,0,-0.3
8385,Aser Ghebremichael\aser-ghebremichael-1,2016-17,Boston College,F,2,0,2,0,0,,0,0,,0,0,,0,0,,0,1,1,0,0,0,0,0,0,0.2
8386,Emerson Burk\emerson-burk-1,2013-14,Virginia Commonwealth,F,12,0,8,0,0,,0,0,,0,0,,0,0,,1,1,2,0,0,1,0,1,0,0.1
8387,Landon Fuller\landon-fuller-1,2016-17,Alabama,F,2,0,4,0,0,,0,0,,0,0,,0,0,,0,0,0,0,0,0,0,0,0,0.0
8388,Bryan Glenn\bryan-glenn-1,2015-16,Nevada-Las Vegas,F,1,0,3,0,0,,0,0,,0,0,,0,0,,0,1,1,0,0,0,0,1,0,-0.1
8389,Jordan Phillips\jordan-phillips-1,2016-17,Florida Atlantic,F,1,0,2,0,1,.000,0,0,,0,1,.000,0,0,,0,0,0,0,0,0,0,0,0,-0.7
8390,Abiola Akintola\abiola-akintola-1,2015-16,Denver,F,1,0,2,0,0,,0,0,,0,0,,0,0,,0,0,0,0,0,0,0,0,0,0.0
8391,Aaron Bodie\aaron-bodie-1,2013-14,Niagara,F,2,0,4,0,0,,0,0,,0,0,,0,0,,0,1,1,0,0,0,0,1,0,-0.1
8392,Dan Sheets\dan-sheets-1,2016-17,Saint Mary's (CA),F,8,0,9,0,0,,0,0,,0,0,,0,0,,0,2,2,0,1,0,0,0,0,0.2
8393,Alex Stewart\alex-stewart-1,2017-18,Charleston Southern,F,2,0,11,0,3,.000,0,2,.000,0,1,.000,0,0,,0,0,0,0,0,0,2,3,0,-2.7
8394,Josh Olabosipo\josh-olabosipo-1,2014-15,Maryland-Baltimore County,F,4,0,3,0,0,,0,0,,0,0,,0,0,,0,0,0,0,0,0,0,0,0,0.0
8395,Michael Rudy\michael-rudy-1,2015-16,George Mason,F,10,0,18,0,2,.000,0,2,.000,0,0,,0,0,,0,2,2,0,0,0,1,2,0,-0.3
8396,Chris Brickhouse\chris-brickhouse-1,2016-17,North Carolina State,F,6,0,9,0,1,.000,0,1,.000,0,0,,0,0,,3,2,5,1,0,1,2,0,0,0.2
8397,Jesse Johnson\jesse-johnson-1,2015-16,Alabama A&M,F,1,0,0,0,0,,0,0,,0,0,,0,0,,0,0,0,0,0,0,0,0,0,0.0
8398,Tim Stainbrook\tim-stainbrook-1,2013-14,Xavier,F,7,0,11,0,0,,0,0,,0,0,,0,2,.000,0,0,0,0,1,0,0,1,0,0.0
8399,Henry Odunze\henry-odunze-1,2017-18,Howard,F,6,0,14,0,0,,0,0,,0,0,,0,0,,1,2,3,0,0,1,0,3,0,0.1
8400,Denzel Davis\denzel-davis-1,2014-15,Rice,F,2,0,11,0,1,.000,0,0,,0,1,.000,0,0,,0,1,1,0,0,0,1,2,0,-1.1
8401,Drew Mellon\drew-mellon-1,2014-15,Arizona,F,12,0,23,0,7,.000,0,4,.000,0,3,.000,0,0,,1,2,3,2,0,0,0,1,0,-0.2
8402,Enouma Ebinum\enouma-ebinum-1,2013-14,Navy,F,2,0,4,0,1,.000,0,1,.000,0,0,,0,0,,0,1,1,0,0,0,0,0,0,-0.2
8403,Lewis Cramer\lewis-cramer-1,2013-14,Sacred Heart,F,1,0,4,0,1,.000,0,1,.000,0,0,,0,0,,0,0,0,0,0,0,0,1,0,-1.1
8404,Terry Winn\terry-winn-1,2014-15,Texas-El Paso,F,1,1,2,0,0,,0,0,,0,0,,0,0,,0,0,0,0,0,0,0,1,0,-0.4
8405,Alex Foree\alex-foree-1,2016-17,Tulsa,F,1,0,1,0,0,,0,0,,0,0,,0,0,,0,0,0,0,0,0,0,0,0,0.0
8406,Tanner Schmidt\tanner-schmidt-1,2014-15,Northern Colorado,F,1,0,2,0,0,,0,0,,0,0,,0,0,,0,0,0,0,0,0,0,0,0,0.0
8407,Brennen Woods\brennen-woods-1,2017-18,Northern Illinois,F,3,0,5,0,0,,0,0,,0,0,,0,0,,0,1,1,1,0,0,1,0,0,0.0
8408,Chase Fletcher\chase-fletcher-1,2013-14,Richmond,F,1,0,1,0,0,,0,0,,0,0,,0,0,,0,0,0,0,0,0,0,1,0,-0.4
8409,Tyler Barnes\tyler-barnes-1,2017-18,Alabama,F,4,0,7,0,0,,0,0,,0,0,,0,2,.000,0,0,0,0,1,0,0,0,0,0.1
8410,Reid Aube\reid-aube-1,2013-14,Charlotte,F,4,0,4,0,0,,0,0,,0,0,,0,0,,1,0,1,0,0,0,0,0,0,0.2
8411,Aaron Campbell\aaron-campbell-1,2017-18,Texas Southern,F,3,0,4,0,2,.000,0,0,,0,2,.000,0,0,,0,1,1,1,1,0,1,1,0,-0.3
8412,Matt Hill\matt-hill-4,2014-15,Fairfield,F,2,0,1,0,0,,0,0,,0,0,,0,0,,0,0,0,0,0,0,0,0,0,0.0
8413,Zach Snyder\zach-snyder-1,2015-16,Duquesne,F,1,0,1,0,0,,0,0,,0,0,,0,0,,0,0,0,0,0,0,0,0,0,0.0
8414,Aaron Falzon\aaron-falzon-1,2016-17,Northwestern,F,3,0,20,0,3,.000,0,0,,0,3,.000,0,0,,0,2,2,3,0,1,1,1,0,0.0
8415,Graham Pingree\graham-pingree-1,2013-14,Brigham Young,F,7,0,10,0,1,.000,0,1,.000,0,0,,0,0,,0,1,1,0,0,0,0,4,0,-0.3
8416,Tanner Borchardt\tanner-borchardt-1,2016-17,Nebraska,F,1,0,1,0,0,,0,0,,0,0,,0,0,,0,0,0,0,0,0,0,1,0,-0.4
8417,Grant Hazle\grant-hazle-1,2017-18,Penn State,F,3,0,3,0,0,,0,0,,0,0,,0,0,,0,0,0,0,0,1,0,0,0,0.2
8418,Matt Elmore\matt-elmore-1,2017-18,North Carolina-Wilmington,F,1,0,1,0,0,,0,0,,0,0,,0,0,,0,0,0,0,0,0,0,0,0,0.0
8419,Lamont West\lamont-west-1,2015-16,West Virginia,F,1,0,0,0,0,,0,0,,0,0,,0,0,,0,0,0,0,0,1,0,0,0,0.7
8420,Issac Vann\issac-vann-1,2016-17,Virginia Commonwealth,F,1,0,0,0,0,,0,0,,0,0,,0,0,,0,0,0,0,0,0,0,0,0,0.0
8421,Austin Weiher\austin-weiher-1,2014-15,Southern Illinois,F,1,0,0,0,0,,0,0,,0,0,,0,0,,0,0,0,0,0,0,0,0,0,0.0
8422,Chris Downing\chris-downing-1,2016-17,Fordham,F,4,0,5,0,0,,0,0,,0,0,,0,0,,0,0,0,0,0,0,0,0,0,0.0
8423,Jordan Bruner\jordan-bruner-1,2017-18,Yale,F,1,0,0,0,1,.000,0,1,.000,0,0,,0,0,,0,0,0,0,0,0,0,0,0,-0.7
8424,Jarrell Holliman\jarrell-holliman-1,2015-16,South Carolina,F,4,0,9,0,0,,0,0,,0,0,,0,0,,0,0,0,0,0,0,1,1,0,-0.4
8425,Jakoby Kemp\jakoby-kemp-1,2016-17,Missouri,F,1,0,0,0,0,,0,0,,0,0,,0,0,,0,0,0,0,0,0,0,0,0,0.0
8426,Jason Boswell\jason-boswell-12,2015-16,Central Michigan,F,2,0,1,0,0,,0,0,,0,0,,0,0,,0,0,0,0,1,0,1,1,0,-0.2
8427,Deryk Pearsall\deryk-pearsall-1,2014-15,Montana State,F,1,0,0,0,0,,0,0,,0,0,,0,0,,0,0,0,0,0,0,0,0,0,0.0
8428,Evan Wessenberg\evan-wessenberg-1,2015-16,North Dakota State,F,1,0,0,0,0,,0,0,,0,0,,0,0,,0,0,0,0,0,0,0,0,0,0.0
8429,Jules Erving\jules-erving-1,2017-18,University of California,F,1,0,1,0,0,,0,0,,0,0,,0,0,,0,1,1,0,0,0,0,0,0,0.3
8430,Peter Agba\peter-agba-1,2015-16,Akron,F,1,0,10,0,4,.000,0,3,.000,0,1,.000,0,2,.000,4,0,4,0,0,0,0,2,0,-1.6
8431,Colin Edwards\colin-edwards-1,2014-15,Troy,F,1,0,1,0,0,,0,0,,0,0,,0,0,,0,0,0,0,0,0,0,0,0,0.0
8432,Geremy McKay\geremy-mckay-1,2014-15,Albany (NY),F,1,0,1,0,1,.000,0,1,.000,0,0,,0,0,,0,1,1,0,0,0,0,0,0,-0.4
8433,Devenir Duruisseau\devenir-duruisseau-1,2017-18,Washington,F,1,0,0,0,0,,0,0,,0,0,,0,0,,0,0,0,0,0,0,0,0,0,0.0
8434,Tom Leibig\tom-leibig-1,2016-17,Villanova,F,7,0,11,0,0,,0,0,,0,0,,0,1,.000,0,3,3,0,1,0,0,0,0,0.2
8435,Matt Gregory\matt-gregory-1,2015-16,Notre Dame,F,5,0,6,0,3,.000,0,1,.000,0,2,.000,0,0,,0,0,0,0,0,0,0,0,0,-0.4
8436,Baylor Peterson\baylor-peterson-1,2016-17,Milwaukee,F,9,0,12,0,2,.000,0,0,,0,2,.000,0,0,,1,0,1,0,0,1,2,2,0,-0.3
8437,Raynard Robinson\raynard-robinson-1,2016-17,Northern Arizona,F,1,0,4,0,0,,0,0,,0,0,,0,0,,0,0,0,0,0,0,0,0,0,0.0
8438,Joseph Bayless\joseph-bayless-1,2015-16,Cornell,F,9,0,13,0,1,.000,0,1,.000,0,0,,0,0,,0,3,3,0,0,0,0,1,0,0.0
8439,Ryan Van Pelt\ryan-van-pelt-1,2014-15,Weber State,F,2,0,6,0,0,,0,0,,0,0,,0,0,,0,0,0,1,1,0,1,2,0,-0.1
8440,Jakub Mijakowski\jakub-mijakowski-1,2016-17,Pennsylvania,F,9,0,13,0,2,.000,0,0,,0,2,.000,0,0,,0,1,1,1,0,0,0,0,0,0.0
8441,Frederick Scott\frederick-scott-1,2015-16,DePaul,F,4,0,9,0,1,.000,0,1,.000,0,0,,0,1,.000,0,2,2,0,0,0,1,2,0,-0.6
8442,Aleks Abrams\aleks-abrams-1,2015-16,Cal Poly,F,4,3,28,0,0,,0,0,,0,0,,0,0,,5,2,7,0,0,0,1,4,0,0.4
8443,Jack George\jack-george-1,2016-17,Elon,F,3,0,5,0,1,.000,0,1,.000,0,0,,0,0,,0,1,1,0,0,0,0,0,0,-0.1
8444,Alex Moffatt\alex-moffatt-1,2017-18,Memphis,F,2,0,7,0,1,.000,0,1,.000,0,0,,0,0,,0,0,0,0,0,0,1,1,0,-1.1
8445,Justin David\justin-david-1,2015-16,South Florida,F,4,0,3,0,1,.000,0,1,.000,0,0,,0,0,,0,0,0,0,0,0,0,0,0,-0.2
8446,Khadim Gueye\khadim-gueye-1,2017-18,South Carolina,F,17,0,88,0,2,.000,0,2,.000,0,0,,0,2,.000,5,7,12,0,2,1,5,16,0,-0.3
8447,Will Hollmann\will-hollman-1,2016-17,Stetson,F,6,0,9,0,1,.000,0,1,.000,0,0,,0,0,,0,1,1,0,0,0,2,0,0,-0.4
8448,Tyler Borchers\tyler-borchers-1,2015-16,South Dakota,F,1,0,0,0,0,,0,0,,0,0,,0,0,,0,1,1,0,0,0,0,0,0,0.3
8449,Payton Carrell\payton-carrell-1,2013-14,Texas A&M,F,2,0,1,0,2,.000,0,2,.000,0,0,,0,0,,0,0,0,0,0,0,0,0,0,-0.7
8450,Zack Tobler\zack-tobler-1,2013-14,Cincinnati,F,8,0,13,0,4,.000,0,2,.000,0,2,.000,0,0,,1,1,2,0,0,0,0,1,0,-0.3
8451,Jordan Robertson\jordan-robertson-1,2013-14,North Carolina-Greensboro,F,5,0,14,0,3,.000,0,3,.000,0,0,,0,0,,0,1,1,0,0,0,0,3,0,-0.6
8452,DeCarlos Holmes\decarlos-holmes-1,2013-14,Alcorn State,F,1,0,0,0,0,,0,0,,0,0,,0,0,,0,1,1,0,0,0,0,0,0,0.3
8453,Dantai St. Louis\dantai-stlouis-1,2017-18,Canisius,F,3,0,2,0,0,,0,0,,0,0,,0,0,,0,0,0,0,0,1,0,0,0,0.2
8454,Nick Foschia\nick-foschia-1,2013-14,Duquesne,F,3,0,4,0,0,,0,0,,0,0,,0,0,,0,0,0,0,0,0,0,0,0,0.0
8455,Nick Loew\nick-loew-1,2014-15,San Francisco,F,6,0,11,0,2,.000,0,2,.000,0,0,,0,1,.000,2,2,4,0,0,0,1,5,0,-0.5
8456,Carson Smith\carson-smith-1,2015-16,South Carolina Upstate,F,1,1,9,0,0,,0,0,,0,0,,0,0,,0,1,1,1,0,0,2,0,0,-1.0
8457,Patrick Kerrigan\patrick-kerrigan-1,2013-14,Holy Cross,F,7,0,5,0,0,,0,0,,0,0,,0,0,,0,0,0,0,0,0,1,0,0,-0.1
8458,Dominic Rector\dominic-rector-1,2016-17,Pacific,F,1,0,2,0,1,.000,0,0,,0,1,.000,0,0,,0,0,0,0,0,0,0,0,0,-0.7
8459,Ryan Kelley\ryan-kelley-2,2014-15,Siena,F,5,0,5,0,0,,0,0,,0,0,,0,0,,0,1,1,0,0,0,0,0,0,0.1
8460,Nicholas Fullard\nicholas-fullard-1,2017-18,Virginia Tech,F,9,0,14,0,1,.000,0,1,.000,0,0,,0,2,.000,0,1,1,0,0,0,2,3,0,-0.5
8461,Keegan Culp\keegan-culp-1,2016-17,Air Force,F,4,0,7,0,1,.000,0,0,,0,1,.000,0,0,,1,1,2,0,0,0,0,1,0,0.0
8462,Eric Katenda\eric-katenda-1,2013-14,Notre Dame,F,2,0,3,0,0,,0,0,,0,0,,0,0,,0,0,0,0,0,0,0,1,0,-0.2
8463,Keynan Pittman\keynan-pittman-1,2015-16,Alcorn State,F,3,0,0,0,2,.000,0,1,.000,0,1,.000,0,0,,0,1,1,0,0,0,0,0,0,-0.4
8464,Nick Pellar\nick-pellar-1,2014-15,Florida Gulf Coast,F,8,0,8,0,0,,0,0,,0,0,,0,0,,0,1,1,1,1,0,1,0,0,0.1
8465,KoVien Dominaus\kovien-dominaus-1,2015-16,Richmond,F,2,0,1,0,1,.000,0,1,.000,0,0,,0,1,.000,1,0,1,0,0,0,0,1,0,-0.4
8466,Jordan Fuchs\jordan-fuchs-1,2014-15,Indiana,F,3,0,8,0,3,.000,0,3,.000,0,0,,0,0,,3,2,5,0,0,0,0,1,0,0.1
8467,Blake Danielak\blake-danielak-1,2014-15,Drake,F,7,0,23,0,3,.000,0,1,.000,0,2,.000,0,0,,1,1,2,0,0,0,0,2,0,-0.3
8468,Kierell Green\kierell-green-1,2016-17,Niagara,F,1,0,2,0,0,,0,0,,0,0,,0,0,,0,0,0,0,0,0,0,0,0,0.0
8469,Will Miles\will-miles-1,2017-18,Florida State,F,3,0,6,0,2,.000,0,0,,0,2,.000,0,0,,0,1,1,0,0,0,0,1,0,-0.5
8470,Josh Butler\josh-butler-1,2013-14,Louisiana Tech,F,1,0,1,0,0,,0,0,,0,0,,0,0,,0,0,0,0,0,0,0,0,0,0.0
8471,Ivan Saicic\ivan-saicic-1,2013-14,Winthrop,F,3,0,19,0,4,.000,0,3,.000,0,1,.000,0,0,,0,0,0,0,0,0,3,0,0,-1.9
8472,Greg Donlon\greg-donlon-1,2016-17,Virginia Tech,F,1,0,1,0,1,.000,0,1,.000,0,0,,0,0,,0,0,0,0,0,0,0,0,0,-0.7
8473,Riley Kemmer\riley-kemmer-1,2013-14,Tulsa,F,2,0,1,0,0,,0,0,,0,0,,0,0,,0,1,1,0,0,0,0,0,0,0.2
8474,Bernard Cherestal\bernard-cherestal-1,2016-17,Southern Illinois,F,2,0,1,0,0,,0,0,,0,0,,0,0,,0,0,0,0,0,0,0,1,0,-0.2
8475,Javan White\javan-white-1,2016-17,Oral Roberts,F,1,0,1,0,0,,0,0,,0,0,,0,0,,0,0,0,0,0,0,0,0,0,0.0
8476,Will Jackowitz\will-jackowitz-1,2017-18,Boston College,F,2,0,2,0,0,,0,0,,0,0,,0,0,,0,0,0,0,0,0,0,0,0,0.0
8477,David Whitmore\david-whitmore-1,2013-14,Arizona State,F,3,0,3,0,1,.000,0,0,,0,1,.000,0,0,,0,1,1,0,0,0,0,0,0,-0.1
8478,Seth Rouse\seth-rouse-1,2016-17,Robert Morris,F,2,1,3,0,0,,0,0,,0,0,,0,0,,0,0,0,0,0,0,0,1,0,-0.2
8479,Brian Crow\brian-crow-1,2013-14,Oregon,F,7,0,16,0,3,.000,0,0,,0,3,.000,0,0,,0,0,0,0,0,0,0,2,0,-0.4
8480,Doyin Akintobi-Adeyeye\doyin-akintobi-adeyeye-1,2015-16,Syracuse,F,6,0,7,0,1,.000,0,1,.000,0,0,,0,2,.000,1,1,2,0,0,0,0,1,0,-0.2
8481,Jason Strong\jason-strong-1,2017-18,Northeastern,F,10,0,31,0,11,.000,0,8,.000,0,3,.000,0,0,,1,1,2,2,0,0,2,2,0,-0.8
8482,Colton Ponder\colton-ponder-1,2013-14,Louisiana-Monroe,F,1,0,2,0,0,,0,0,,0,0,,0,0,,0,0,0,0,0,0,0,0,0,0.0
8483,Kashaun Hicks\kashaun-hicks-1,2016-17,Central Connecticut State,F,1,0,0,0,0,,0,0,,0,0,,0,0,,0,0,0,0,1,0,0,0,0,1.0
8484,Rokas Cesnulevicius\rokas-cesnulevicius-1,2013-14,Evansville,F,1,0,0,0,0,,0,0,,0,0,,0,0,,0,0,0,0,0,0,1,0,0,-1.0
8485,Sammis Reyes\sammis-reyes-1,2017-18,Tulane,F,2,0,7,0,1,.000,0,1,.000,0,0,,0,0,,1,1,2,0,0,0,2,4,0,-1.7
8486,J.C. Kennedy\jc-kennedy-1,2014-15,Weber State,F,1,0,3,0,1,.000,0,0,,0,1,.000,0,0,,0,0,0,0,0,0,0,0,0,-0.7
8487,Charlie Anastasi\charlie-anastasi-1,2013-14,Harvard,F,6,0,10,0,1,.000,0,1,.000,0,0,,0,0,,2,2,4,1,0,0,2,0,0,0.0
8488,Jackson Bart\jackson-bart-1,2016-17,Cincinnati,F,8,0,11,0,2,.000,0,0,,0,2,.000,0,0,,0,0,0,0,0,0,0,2,0,-0.3
8489,Jake Ness\jake-ness-1,2013-14,Boise State,F,14,0,31,0,1,.000,0,1,.000,0,0,,0,0,,2,2,4,0,0,1,0,8,0,-0.1
8490,Tyrell Taylor\tyrell-taylor-1,2016-17,Canisius,F,1,0,0,0,0,,0,0,,0,0,,0,0,,0,0,0,0,0,0,0,0,0,0.0
8491,Sean Burroughs\sean-burroughs-1,2013-14,Alabama State,F,1,0,0,0,0,,0,0,,0,0,,0,0,,0,0,0,0,0,0,0,1,0,-0.4
8492,Jordan Tyson\jordan-tyson-1,2014-15,St. Bonaventure,F,1,0,1,0,0,,0,0,,0,0,,0,0,,0,0,0,0,0,0,0,0,0,0.0
8493,Tom Cotter\tom-cotter-1,2014-15,Oakland,F,8,0,21,0,2,.000,0,2,.000,0,0,,0,0,,1,1,2,1,0,0,2,4,0,-0.4
8494,Greg Roy\greg-roy-1,2015-16,Michigan State,F,3,0,3,0,1,.000,0,0,,0,1,.000,0,0,,0,0,0,0,0,0,1,0,0,-0.6
8495,Zach Turcotte\zach-turcotte-1,2014-15,Massachusetts,F,1,0,1,0,0,,0,0,,0,0,,0,0,,0,0,0,1,0,0,0,0,0,0.7
8496,Todd Zafirovski\todd-zafirovski-1,2013-14,Duke,F,3,0,4,0,0,,0,0,,0,0,,0,0,,0,1,1,0,0,0,0,1,0,0.0
8497,Patrick Smith\patrick-smith-1,2015-16,Southern,F,1,0,1,0,0,,0,0,,0,0,,0,0,,0,0,0,0,0,0,0,0,0,0.0
8498,Vuk Baletic\vuk-baletic-1,2013-14,Monmouth,F,8,0,14,0,3,.000,0,3,.000,0,0,,0,2,.000,1,4,5,1,0,0,0,5,0,-0.3
8499,Ellis Williams\ellis-williams-1,2014-15,Bryant,F,7,0,18,0,1,.000,0,1,.000,0,0,,0,0,,0,2,2,1,2,0,2,5,0,-0.2
8500,Kellen Manek\kellen-manek-1,2016-17,Oral Roberts,F,1,1,12,0,3,.000,0,3,.000,0,0,,0,0,,0,1,1,0,2,0,2,5,0,-3.8
8501,Chris Stowell\chris-stowell-1,2014-15,Miami (FL),F,4,0,6,0,1,.000,0,1,.000,0,0,,0,0,,0,0,0,1,0,0,0,1,0,-0.1
8502,Will Lienhard\will-lienhard-1,2015-16,Oklahoma State,F,1,0,1,0,0,,0,0,,0,0,,0,0,,0,0,0,0,0,0,0,0,0,0.0
8503,Brandon Mitchell\brandon-mitchell-2,2015-16,San Jose State,F,1,0,0,0,0,,0,0,,0,0,,0,0,,0,0,0,0,1,0,0,0,0,1.0
8504,Jevon Estelle\jevon-estelle-1,2014-15,Grand Canyon,F,8,0,11,0,0,,0,0,,0,0,,0,0,,0,1,1,1,1,0,0,4,0,0.1
8505,Rapolas Ivanauskas\rapolas-ivanauskas-1,2017-18,Northwestern,F,3,0,11,0,2,.000,0,2,.000,0,0,,0,0,,0,3,3,0,0,0,0,5,0,-0.8
8506,Konner Frey\konner-frey-1,2014-15,Utah State,F,4,0,10,0,0,,0,0,,0,0,,0,0,,1,2,3,0,0,1,0,3,0,0.2
8507,Eric Washington\eric-washington-4,2013-14,Texas Southern,F,1,0,0,0,0,,0,0,,0,0,,0,0,,0,0,0,0,0,0,0,0,0,0.0
8508,Jaro Moravek\jaro-moravek-1,2017-18,Troy,F,1,0,1,0,0,,0,0,,0,0,,0,0,,0,0,0,0,0,0,0,0,0,0.0
8509,Kevin Coker\kevin-coker-1,2013-14,Xavier,F,5,0,6,0,0,,0,0,,0,0,,0,0,,0,0,0,0,0,0,0,1,0,-0.1
8510,Chris Brickhouse\chris-brickhouse-1,2013-14,North Carolina State,F,4,0,4,0,0,,0,0,,0,0,,0,0,,0,0,0,0,0,0,0,1,0,-0.1
8511,Luka Milosavljevic\luka-milosavljevic-1,2016-17,Iona,F,14,0,20,0,3,.000,0,0,,0,3,.000,0,0,,0,1,1,0,0,0,4,3,0,-0.5
8512,Marshall Thorpe\marshall-thorpe-1,2017-18,Oklahoma,F,4,0,8,0,0,,0,0,,0,0,,0,0,,0,2,2,0,0,0,0,1,0,0.1
8513,Matthew Mache\matthew-mache-1,2014-15,Marquette,F,3,0,3,0,0,,0,0,,0,0,,0,0,,0,0,0,0,0,0,0,0,0,0.0
8514,Thomas Allshouse\thomas-allshouse-1,2014-15,Delaware,F,3,0,4,0,0,,0,0,,0,0,,0,0,,0,1,1,0,0,0,0,0,0,0.1
8515,Christian Foxen\christian-foxen-1,2017-18,Connecticut,F,2,0,1,0,0,,0,0,,0,0,,0,0,,0,0,0,0,0,0,0,0,0,0.0
8516,D'Andre Mahaffey\dandre-mahaffey-1,2016-17,Virginia Military Institute,F,1,0,2,0,1,.000,0,0,,0,1,.000,0,0,,0,0,0,0,0,0,0,0,0,-0.7
8517,Antonio Pilipovic\antonio-pilipovic-1,2017-18,Drake,F,5,1,7,0,3,.000,0,0,,0,3,.000,0,0,,0,0,0,0,0,0,0,0,0,-0.4
8518,Adam Oresky\adam-oresky-1,2013-14,Hartford,F,7,0,7,0,0,,0,0,,0,0,,0,0,,0,1,1,0,0,0,0,0,0,0.0
8519,Chandler Levingston Simon\chandler-levingstonsimon-1,2013-14,Missouri-Kansas City,F,8,0,18,0,2,.000,0,2,.000,0,0,,0,0,,0,3,3,1,2,0,0,5,0,0.0
8520,Jalen King\jalen-king-1,2017-18,Eastern Michigan,F,20,0,90,0,3,.000,0,3,.000,0,0,,0,4,.000,4,11,15,0,4,9,7,23,0,-0.2
8521,Ike Ngwudo\ikemefuna-ngwudo-1,2014-15,Dartmouth,F,12,0,33,0,4,.000,0,2,.000,0,2,.000,0,2,.000,1,6,7,2,0,1,1,7,0,-0.2
8522,Charlie Hall\charlie-hall-1,2016-17,Northwestern,F,7,0,8,0,2,.000,0,0,,0,2,.000,0,0,,1,3,4,0,0,0,0,0,0,0.0
8523,Nnamdi Amilo\nnamdi-amilo-1,2014-15,Connecticut,F,2,0,2,0,0,,0,0,,0,0,,0,0,,0,0,0,0,0,0,0,0,0,0.0
8524,Peter Jones\peter-jones-1,2017-18,Montana,F,1,0,0,0,0,,0,0,,0,0,,0,0,,0,0,0,0,0,0,1,0,0,-1.0
8525,Treshawn Bolden\treshawn-bolden-1,2016-17,Jackson State,F,1,0,0,0,1,.000,0,0,,0,1,.000,0,0,,0,0,0,0,0,0,0,0,0,-0.7
8526,Rosco Allen\rosco-allen-1,2013-14,Stanford,F,1,0,7,0,1,.000,0,1,.000,0,0,,0,0,,0,0,0,0,1,0,0,0,0,0.3
8527,Doug Niedrich\doug-niedrich-1,2014-15,Wake Forest,F,7,0,8,0,6,.000,0,6,.000,0,0,,0,0,,2,2,4,0,0,0,0,0,0,-0.3
8528,Chase Fletcher\chase-fletcher-2,2016-17,Richmond,F,3,0,2,0,0,,0,0,,0,0,,0,0,,0,0,0,0,0,0,0,0,0,0.0
8529,Peter Hanley\peter-hanley-1,2017-18,Bradley,F,5,0,12,0,4,.000,0,4,.000,0,0,,0,0,,0,2,2,0,1,0,1,1,0,-0.5
8530,Matt Kamieniecki\matt-kamieniecki-1,2013-14,Ball State,F,1,0,0,0,1,.000,0,1,.000,0,0,,0,0,,0,0,0,0,0,0,0,0,0,-0.7
8531,Samer Dhillon\samer-dhillon-1,2014-15,Southern California,F,4,0,6,0,1,.000,0,1,.000,0,0,,0,0,,0,0,0,0,0,0,1,0,0,-0.4
8532,Jamell Bradley\jamell-bradley-1,2016-17,Texas A&M-Corpus Christi,F,2,1,6,0,1,.000,0,0,,0,1,.000,0,0,,0,3,3,1,0,0,0,1,0,0.3
8533,Will Slatten\will-slatten-1,2017-18,Middle Tennessee,F,2,0,2,0,1,.000,0,1,.000,0,0,,0,0,,2,0,2,0,0,0,0,0,0,0.4
8534,Tim Myles\tim-myles-1,2013-14,New Mexico,F,1,0,4,0,0,,0,0,,0,0,,0,0,,1,1,2,0,0,0,1,2,0,-0.8
8535,Jackson Tharp\jackson-tharp-1,2015-16,Indiana,F,5,0,5,0,0,,0,0,,0,0,,0,0,,0,0,0,0,0,0,1,0,0,-0.2
8536,David Kyle\david-kyle-2,2016-17,Nevada,F,5,0,6,0,0,,0,0,,0,0,,0,0,,0,4,4,0,0,0,0,1,0,0.2
8537,Aaron Peek\aaron-peek-1,2014-15,Georgia Tech,F,2,0,4,0,0,,0,0,,0,0,,0,0,,0,0,0,0,0,0,1,0,0,-0.5
8538,Joe Knight\joe-knight-2,2015-16,Washington,F,4,0,6,0,1,.000,0,1,.000,0,0,,0,0,,0,2,2,0,0,0,0,0,0,0.0
8539,Tyler Walston\tyler-walston-1,2013-14,St. John's (NY),F,5,0,8,0,0,,0,0,,0,0,,0,0,,0,1,1,0,0,0,0,1,0,0.0
8540,Quinn Price\quinn-price-1,2015-16,Montana State,F,2,1,7,0,1,.000,0,1,.000,0,0,,0,0,,1,0,1,0,0,0,0,2,0,-0.4
8541,Trey Reeves\trey-reeves-1,2016-17,Oklahoma State,F,8,0,12,0,4,.000,0,1,.000,0,3,.000,0,0,,0,3,3,0,0,0,0,1,0,-0.3
8542,Alex Prahl\alex-prahl-1,2016-17,Milwaukee,F,6,1,13,0,2,.000,0,2,.000,0,0,,0,0,,0,4,4,0,0,1,0,3,0,-0.1
8543,Matt Grooms\matt-grooms-1,2016-17,Boise State,F,5,0,7,0,2,.000,0,1,.000,0,1,.000,0,0,,1,0,1,0,0,0,1,2,0,-0.5
8544,Adam Denison\adam-denison-2,2013-14,East Tennessee State,F,1,0,0,0,0,,0,0,,0,0,,0,0,,0,0,0,0,0,0,0,0,0,0.0
8545,Julien Johnson\julien-johnson-1,2013-14,North Carolina A&T,F,2,0,2,0,0,,0,0,,0,0,,0,0,,0,0,0,0,0,0,0,0,0,0.0
8546,Zach Peters\zach-peters-1,2013-14,Arizona,F,11,0,31,0,6,.000,0,0,,0,6,.000,0,0,,0,4,4,0,0,0,2,5,0,-0.6
8547,Niksha Federico\niksha-federico-1,2014-15,San Diego State,F,5,0,8,0,4,.000,0,0,,0,4,.000,0,0,,0,1,1,0,0,1,0,1,0,-0.4
8548,Emerson Bursis\emerson-bursis-1,2013-14,Rider,F,10,0,11,0,1,.000,0,0,,0,1,.000,0,1,.000,0,0,0,0,0,0,0,1,0,-0.2
8549,Matt Hill\matt-hill-4,2015-16,Fairfield,F,6,0,6,0,0,,0,0,,0,0,,0,1,.000,0,2,2,1,1,0,1,1,0,0.1
8550,Neal Beshears\neal-beshears-1,2014-15,Purdue,F,1,0,0,0,0,,0,0,,0,0,,0,0,,0,0,0,0,0,0,0,0,0,0.0
8551,Jesse Lopez\jesse-lopez-1,2013-14,Sam Houston State,F,1,0,0,0,0,,0,0,,0,0,,0,0,,0,0,0,1,0,0,0,0,0,0.7
8552,Rocco Belcaster\rocco-belcaster-1,2015-16,Ball State,F,2,0,6,0,1,.000,0,0,,0,1,.000,0,0,,0,0,0,0,1,0,0,1,0,-0.1
8553,Matt Gregory\matt-gregory-1,2016-17,Notre Dame,F,5,0,6,0,4,.000,0,0,,0,4,.000,0,0,,0,0,0,0,0,0,0,0,0,-0.6
8554,Hank Hollingsworth\hank-hollingsworth-1,2015-16,Cal Poly,F,1,0,0,0,0,,0,0,,0,0,,0,0,,0,0,0,0,0,1,0,0,0,0.7
8555,A.J. Metz\aj-metz-1,2013-14,Maryland,F,1,0,1,0,0,,0,0,,0,0,,0,0,,0,0,0,0,0,0,0,0,0,0.0
8556,Deitrich Cole\dietrich-cole-1,2015-16,Jacksonville State,F,1,0,0,0,0,,0,0,,0,0,,0,0,,0,0,0,0,0,0,0,0,0,0.0
8557,Brett Rau\brett-rau-1,2016-17,Missouri,F,5,0,7,0,1,.000,0,1,.000,0,0,,0,0,,2,0,2,0,1,0,1,0,0,0.1
8558,Logan Routt\logan-routt-1,2015-16,West Virginia,F,1,0,3,0,0,,0,0,,0,0,,0,0,,0,0,0,0,0,0,0,0,0,0.0
8559,Keeston Smith\keeston-smith-1,2017-18,Army,F,1,0,4,0,0,,0,0,,0,0,,0,0,,0,1,1,0,0,0,0,0,0,0.3
8560,Fred John Jr.\fred-johnjr-1,2016-17,Toledo,F,1,0,1,0,0,,0,0,,0,0,,0,0,,0,0,0,0,0,0,0,0,0,0.0
8561,Saren Westrop\saren-westrop-1,2015-16,Iona,F,14,0,24,0,3,.000,0,0,,0,3,.000,0,0,,0,1,1,1,0,0,0,2,0,-0.1
8562,Nick Desmarais\nick-desmarais-1,2017-18,Chattanooga,F,2,0,4,0,1,.000,0,0,,0,1,.000,0,0,,0,1,1,0,0,0,0,0,0,-0.2
8563,Jack George\jack-george-1,2015-16,Elon,F,4,0,6,0,1,.000,0,1,.000,0,0,,0,0,,1,2,3,0,0,0,1,1,0,-0.2
8564,Cole Blackstock\cole-blackstock-1,2016-17,Auburn,F,3,0,5,0,0,,0,0,,0,0,,0,0,,0,2,2,0,0,0,0,2,0,-0.1
8565,Isaiah Baker\isaiah-baker-1,2014-15,Holy Cross,F,6,0,14,0,3,.000,0,3,.000,0,0,,0,0,,1,1,2,0,0,0,1,3,0,-0.6
8566,Aron Petros\aron-petros-1,2015-16,Longwood,F,1,0,0,0,0,,0,0,,0,0,,0,0,,0,0,0,0,0,0,0,0,0,0.0
8567,Rafe Blades\rafe-blades-1,2017-18,Nicholls State,F,10,0,23,0,3,.000,0,1,.000,0,2,.000,0,0,,2,4,6,2,0,0,2,4,0,-0.2
8568,Jake Lohrbach\jake-lohrbach-1,2014-15,Ohio State,F,8,0,13,0,1,.000,0,1,.000,0,0,,0,0,,0,0,0,0,1,0,2,2,0,-0.3
8569,Marshall Thorpe\marshall-thorpe-1,2016-17,Oklahoma,F,3,0,5,0,2,.000,0,2,.000,0,0,,0,0,,2,1,3,0,1,1,1,2,0,0.1
8570,Doyin Akintobi-Adeyeye\doyin-akintobi-adeyeye-1,2014-15,Syracuse,F,4,0,5,0,1,.000,0,1,.000,0,0,,0,2,.000,1,2,3,0,0,0,2,1,0,-0.7
8571,Mitchell Storm\mitchell-storm-1,2017-18,Mississippi State,F,8,0,20,0,4,.000,0,2,.000,0,2,.000,0,0,,2,4,6,0,0,0,1,1,0,-0.2
8572,James Kennedy\james-kennedy-1,2013-14,Boston University,F,1,0,0,0,0,,0,0,,0,0,,0,0,,0,1,1,0,0,0,0,0,0,0.3
8573,Daniel Andrews\daniel-andrews-1,2016-17,Army,F,1,0,4,0,0,,0,0,,0,0,,0,0,,0,3,3,0,0,0,1,0,0,-0.1
8574,Nick Loew\nick-loew-1,2016-17,San Francisco,F,1,0,1,0,0,,0,0,,0,0,,0,0,,1,0,1,0,0,0,0,1,0,0.3
8575,Travis Hawkins\travis-hawkins-1,2013-14,Grambling,F,1,0,0,0,0,,0,0,,0,0,,0,0,,0,0,0,0,0,0,0,0,0,0.0
8576,Luka Radovic\luka-radovic-2,2016-17,Southern Illinois-Edwardsville,F,1,0,1,0,0,,0,0,,0,0,,0,0,,0,1,1,0,0,0,0,0,0,0.3
8577,Sam Schwietz\sam-schwietz-1,2017-18,Maryland-Baltimore County,F,1,0,0,0,0,,0,0,,0,0,,0,0,,0,0,0,0,0,0,1,0,0,-1.0
8578,Albert Nassar\albert-nassar-1,2013-14,Syracuse,F,4,0,6,0,3,.000,0,2,.000,0,1,.000,0,0,,2,2,4,0,0,0,0,1,0,-0.1
8579,Braiden Shaw\braiden-shaw-1,2017-18,Brigham Young,F,1,0,1,0,0,,0,0,,0,0,,0,0,,0,0,0,0,0,0,0,1,0,-0.4
8580,Brandon Jordan\brandon-jordan-1,2016-17,Savannah State,F,1,0,1,0,0,,0,0,,0,0,,0,0,,0,0,0,0,0,0,0,0,0,0.0
8581,Nikola Colovic\nikola-colovic-1,2017-18,Hartford,F,5,0,9,0,0,,0,0,,0,0,,0,1,.000,0,2,2,0,0,0,0,7,0,-0.5
8582,Chris Huey\chris-huey-1,2014-15,Kansas,F,1,0,1,0,1,.000,0,1,.000,0,0,,0,0,,0,0,0,0,0,0,0,0,0,-0.7
8583,Collin Sanger\collin-sanger-1,2013-14,Northern Colorado,F,1,0,0,0,0,,0,0,,0,0,,0,0,,0,0,0,0,0,0,0,0,0,0.0
8584,Kyle Jackson\kyle-jackson-2,2013-14,Fresno State,F,5,0,17,0,1,.000,0,1,.000,0,0,,0,0,,0,2,2,1,0,0,0,1,0,0.0
8585,Reginald Giles Jr.\reginald-gilesjr-1,2016-17,Delaware State,F,2,0,5,0,0,,0,0,,0,0,,0,0,,0,0,0,0,0,0,0,0,0,0.0
8586,David Payne\david-payne-2,2017-18,Cleveland State,F,3,0,4,0,2,.000,0,0,,0,2,.000,0,0,,1,2,3,0,0,0,0,1,0,-0.2
8587,Sam Lindgren\sam-lindgren-1,2015-16,Colgate,F,4,0,10,0,1,.000,0,1,.000,0,0,,0,0,,1,2,3,1,0,0,1,2,0,-0.1
8588,Will Slatten\will-slatten-1,2016-17,Middle Tennessee,F,1,0,1,0,0,,0,0,,0,0,,0,0,,0,0,0,0,0,0,0,0,0,0.0
8589,Connor O'Neill\connor-oneill-1,2016-17,Georgia,F,4,0,6,0,1,.000,0,1,.000,0,0,,0,0,,0,3,3,0,0,0,2,2,0,-0.7
8590,John Heard\john-heard-1,2013-14,Baylor,F,11,0,14,0,4,.000,0,1,.000,0,3,.000,0,2,.000,1,0,1,1,0,0,2,2,0,-0.5
8591,Anthony Vernon\anthony-vernon-1,2014-15,Morgan State,F,4,0,7,0,1,.000,0,1,.000,0,0,,0,0,,0,0,0,0,0,0,1,1,0,-0.5
8592,James Suber\james-suber-1,2017-18,Cal State Bakersfield,F,4,0,6,0,3,.000,0,2,.000,0,1,.000,0,0,,1,0,1,0,1,0,0,2,0,-0.3
8593,Clayton Crawford\clayton-crawford-1,2017-18,Texas Christian,F,6,0,12,0,1,.000,0,0,,0,1,.000,0,0,,0,1,1,0,0,0,0,2,0,-0.2
8594,George Muresan\george-muresan-1,2016-17,Georgetown,F,5,0,6,0,1,.000,0,0,,0,1,.000,0,0,,0,0,0,0,1,0,0,0,0,0.1
8595,Spencer Barks\spencer-barks-1,2014-15,Maryland,F,5,0,8,0,1,.000,0,1,.000,0,0,,0,2,.000,0,2,2,0,0,0,0,2,0,-0.3
8596,Julian Thompson-Clay\julian-thompson-clay-1,2017-18,Tennessee-Martin,F,3,0,20,0,1,.000,0,1,.000,0,0,,0,1,.000,3,2,5,0,1,0,1,2,0,0.3
8597,Alex Zhao\alex-zhao-1,2016-17,Penn State,F,4,0,5,0,2,.000,0,1,.000,0,1,.000,0,0,,1,0,1,0,0,0,0,0,0,-0.2
8598,Marc Reininger\marc-reininger-1,2017-18,Utah,F,5,0,13,0,1,.000,0,1,.000,0,0,,0,0,,0,2,2,0,0,0,0,2,0,-0.2
8599,Bobby Wehrli\bobby-wehrli-1,2013-14,Dayton,F,3,0,3,0,1,.000,0,0,,0,1,.000,0,0,,0,0,0,0,0,1,0,0,0,0.0
8600,Brandon Eddlestone\brian-eddlestone-1,2015-16,Louisiana State,F,5,0,5,0,1,.000,0,0,,0,1,.000,0,0,,0,1,1,1,1,0,0,0,0,0.3
8601,Shaun Joplin\shaun-joplin-1,2013-14,Bowling Green State,F,1,0,0,0,0,,0,0,,0,0,,0,0,,0,0,0,0,0,0,0,1,0,-0.4
8602,Jesse Hill\jesse-hill-1,2016-17,Florida Atlantic,F,4,0,15,0,0,,0,0,,0,0,,0,0,,0,1,1,1,0,0,1,4,0,-0.4
8603,Akoy Agau\akoy-agau-1,2014-15,Louisville,F,3,0,11,0,1,.000,0,0,,0,1,.000,0,0,,0,1,1,0,0,0,1,0,0,-0.5
8604,Rand Rowland\rand-rowland-1,2015-16,Georgia Tech,F,6,0,13,0,1,.000,0,1,.000,0,0,,0,0,,0,0,0,0,0,0,1,3,0,-0.5
8605,Thomas Brandsma\thomas-brandsma-1,2015-16,Little Rock,F,1,0,1,0,0,,0,0,,0,0,,0,0,,0,1,1,0,0,0,0,0,0,0.3
8606,Thomas Allshouse\thomas-allshouse-1,2013-14,Delaware,F,7,0,6,0,0,,0,0,,0,0,,0,0,,0,0,0,0,0,0,0,0,0,0.0
8607,Aaron Rohlman\aaron-rohlman-1,2016-17,North Carolina,F,20,0,34,0,1,.000,0,1,.000,0,0,,0,0,,1,12,13,1,1,0,1,1,0,0.2
8608,Jermaine Blackmon Jr.\jermaine-blackmonjr-1,2017-18,College of Charleston,F,3,0,3,0,2,.000,0,2,.000,0,0,,0,0,,0,0,0,0,0,0,0,0,0,-0.5
8609,Matt Bullock\matt-bullock-1,2016-17,Rutgers,F,2,0,4,0,1,.000,0,0,,0,1,.000,0,0,,0,0,0,0,0,0,0,1,0,-0.6
8610,Tommy Ros\tommy-ros-1,2016-17,Hofstra,F,3,0,6,0,3,.000,0,3,.000,0,0,,0,0,,0,0,0,0,0,0,0,0,0,-0.7
8611,Cavan LaRose\cavan-larose-1,2015-16,Sacred Heart,F,1,0,2,0,0,,0,0,,0,0,,0,0,,0,0,0,0,0,0,0,1,0,-0.4
8612,Sam Burkart\sam-burkart-1,2016-17,Milwaukee,F,2,0,2,0,0,,0,0,,0,0,,0,0,,0,0,0,0,0,1,0,0,0,0.4
8613,Pernell Adgei\pernell-adgei-1,2017-18,Longwood,F,1,0,0,0,1,.000,0,0,,0,1,.000,0,0,,0,0,0,0,0,0,0,0,0,-0.7
8614,Marquis Salmon\marquis-salmon-1,2015-16,Wagner,F,8,0,19,0,1,.000,0,1,.000,0,0,,0,0,,0,5,5,0,0,2,1,8,0,-0.3
8615,Mike Shaw\mike-shaw-1,2015-16,Bradley,F,1,0,0,0,0,,0,0,,0,0,,0,0,,1,0,1,0,0,0,0,0,0,0.7
8616,Cavan LaRose\cavan-larose-1,2016-17,Sacred Heart,F,2,0,2,0,0,,0,0,,0,0,,0,0,,0,0,0,0,0,0,0,0,0,0.0
8617,Xavier Eaglin\xavier-eaglin-1,2015-16,Cornell,F,7,0,10,0,0,,0,0,,0,0,,0,4,.000,0,1,1,1,1,1,1,1,0,0.0
8618,Otas Iyekekpolor\otas-iyekekpolor-1,2015-16,Central Arkansas,F,1,0,0,0,0,,0,0,,0,0,,0,0,,0,0,0,0,0,0,0,0,0,0.0
8619,Sandy Cohen\sandy-cohen-1,2016-17,Marquette,F,3,0,19,0,4,.000,0,4,.000,0,0,,0,0,,1,2,3,1,0,2,4,1,0,-1.3
8620,Chris Clerkley\chris-clerkley-1,2017-18,Georgia State,F,17,0,47,0,4,.000,0,4,.000,0,0,,0,1,.000,2,7,9,3,0,2,3,4,0,0.0
8621,Dominique Miller\dominique-miller-2,2014-15,Jacksonville State,F,1,0,1,0,0,,0,0,,0,0,,0,0,,0,0,0,0,0,0,0,0,0,0.0
8622,Demetrius Houston\demetrius-houston-1,2017-18,Alabama State,F,2,0,0,0,1,.000,0,1,.000,0,0,,0,0,,0,0,0,0,0,0,0,1,0,-0.6
8623,Doug Niedrich\doug-niedrich-1,2013-14,Wake Forest,F,4,0,5,0,1,.000,0,1,.000,0,0,,0,0,,0,2,2,1,0,0,0,1,0,0.1
8624,Matt Banas\matt-banas-1,2013-14,Bucknell,F,3,0,6,0,0,,0,0,,0,0,,0,0,,0,1,1,0,0,0,0,1,0,0.0
8625,Codey McElroy\codey-mcelroy-1,2015-16,Oklahoma State,F,4,1,5,0,2,.000,0,0,,0,2,.000,0,0,,0,0,0,0,0,0,1,2,0,-0.8
8626,Michael Dowdy\michael-dowdy-1,2016-17,Seton Hall,F,6,1,9,0,0,,0,0,,0,0,,0,0,,0,1,1,0,0,0,0,0,0,0.1
8627,Rodney Hunter\rodney-hunter-1,2015-16,Columbia,F,1,0,0,0,0,,0,0,,0,0,,0,0,,0,0,0,0,0,0,1,0,0,-1.0
8628,Deon Franklin\deon-franklin-1,2016-17,Marquette,F,8,0,16,0,2,.000,0,1,.000,0,1,.000,0,0,,0,3,3,0,1,1,1,4,0,-0.2
8629,Tim Jensen\tim-jensen-1,2014-15,Oregon,F,7,0,23,0,3,.000,0,3,.000,0,0,,0,0,,2,3,5,0,0,1,1,3,0,-0.2
8630,Kobe Wilson\kobe-wilson-1,2016-17,Alcorn State,F,5,0,23,0,3,.000,0,1,.000,0,2,.000,0,0,,2,4,6,0,0,0,1,1,0,-0.2
8631,Luke Sasser\luke-sasser-1,2017-18,George Washington,F,7,0,10,0,0,,0,0,,0,0,,0,0,,0,0,0,1,0,0,0,0,0,0.1
8632,Yeskin Walker-Williams\yeskin-walker-williams-1,2017-18,South Carolina Upstate,F,2,0,5,0,1,.000,0,1,.000,0,0,,0,0,,0,0,0,0,0,0,1,2,0,-1.3
8633,Matt LeBato\matt-lebato-1,2014-15,Northwestern State,F,5,0,19,0,9,.000,0,3,.000,0,6,.000,0,0,,1,4,5,0,1,0,0,4,0,-1.0
8634,Isaiah Watkins\isaiah-watkins-1,2015-16,Furman,F,1,0,0,0,1,.000,0,1,.000,0,0,,0,0,,0,0,0,0,0,0,0,0,0,-0.7
8635,Victor Haywood-Harris\victor-haywood-harris-1,2013-14,Texas Southern,F,5,0,7,0,0,,0,0,,0,0,,0,0,,0,0,0,0,0,1,0,1,0,0.1
8636,Charlie Hall\charlie-hall-1,2015-16,Northwestern,F,8,0,12,0,0,,0,0,,0,0,,0,0,,0,0,0,0,0,0,0,1,0,-0.1
8637,Christian Clark\christian-clark-1,2015-16,Alabama,F,9,0,13,0,1,.000,0,1,.000,0,0,,0,0,,2,0,2,0,0,0,2,1,0,-0.2
8638,Mohamed Farih\mohamed-farih-1,2013-14,Saint Peter's,F,1,0,1,0,0,,0,0,,0,0,,0,0,,0,0,0,0,0,0,0,0,0,0.0
8639,Greg Sequele\greg-sequele-1,2014-15,DePaul,F,5,0,22,0,2,.000,0,2,.000,0,0,,0,2,.000,3,1,4,0,1,0,2,7,0,-0.7
8640,Trey Tate\trey-tate-1,2015-16,Auburn,F,1,0,2,0,0,,0,0,,0,0,,0,0,,0,1,1,0,0,0,0,0,0,0.3
8641,Jordan Lumpkins\jordan-lumpkins-1,2015-16,Prairie View,F,1,0,0,0,1,.000,0,1,.000,0,0,,0,0,,0,0,0,0,0,0,0,0,0,-0.7
8642,Zach Turcotte\zach-turcotte-1,2016-17,Massachusetts,F,3,1,4,0,1,.000,0,0,,0,1,.000,0,0,,0,0,0,0,0,0,0,1,0,-0.4
8643,Cullen Barr\cullen-barr-1,2016-17,Xavier,F,9,0,8,0,2,.000,0,1,.000,0,1,.000,0,0,,0,0,0,0,0,0,0,0,0,-0.2
8644,Khris Lane\khris-lane-1,2013-14,Drexel,F,4,0,7,0,1,.000,0,1,.000,0,0,,0,0,,0,0,0,0,1,0,0,0,0,0.1
8645,Will Weethee\will-weethee-1,2016-17,Virginia Military Institute,F,2,0,3,0,1,.000,0,0,,0,1,.000,0,0,,0,1,1,0,0,0,0,1,0,-0.4
8646,Emil Knighton\emil-knighton-1,2015-16,Denver,F,1,0,0,0,1,.000,0,0,,0,1,.000,0,0,,0,0,0,0,0,0,0,0,0,-0.7
