Rk,Player,Season,Pos,G,GS,MP,FG,FGA,FG%,2P,2PA,2P%,3P,3PA,3P%,FT,FTA,FT%,ORB,DRB,TRB,AST,STL,BLK,TOV,PF,PTS,GmSc
1,LeBron James\jamesle01,2017-18,F-G,82,82,3026,857,1580,.542,708,1174,.603,149,406,.367,388,531,.731,97,612,709,747,116,71,347,136,2251,24.0
2,Paul George\georgpa01,2018-19,F,77,77,2841,707,1614,.438,415,857,.484,292,757,.386,453,540,.839,105,523,628,318,170,34,205,214,2159,21.2
3,Anthony Davis\davisan02,2017-18,F-C,75,75,2727,780,1462,.534,725,1300,.558,55,162,.340,495,598,.828,187,645,832,174,115,193,162,159,2110,24.4
4,Anthony Davis\davisan02,2016-17,F-C,75,75,2708,770,1526,.505,730,1392,.524,40,134,.299,519,647,.802,172,712,884,157,94,167,181,168,2099,22.6
5,Kevin Durant\duranke01,2015-16,F-G,72,72,2578,698,1381,.505,512,900,.569,186,481,.387,447,498,.898,45,544,589,361,69,85,250,137,2029,22.1
6,Kevin Durant\duranke01,2018-19,F-G,78,78,2702,721,1383,.521,584,995,.587,137,388,.353,448,506,.885,33,464,497,457,58,84,225,155,2027,21.0
7,Giannis Antetokounmpo\antetgi01,2017-18,F-G,75,75,2756,742,1402,.529,699,1262,.554,43,140,.307,487,641,.760,156,597,753,361,109,106,223,231,2014,22.4
8,Giannis Antetokounmpo\antetgi01,2018-19,F-G,72,72,2358,721,1247,.578,669,1044,.641,52,203,.256,500,686,.729,159,739,898,424,92,110,268,232,1994,24.6
9,LeBron James\jamesle01,2016-17,F-G,74,74,2794,736,1344,.548,612,1002,.611,124,342,.363,358,531,.674,97,542,639,646,92,44,303,134,1954,22.8
10,Andrew Wiggins\wiggian01,2016-17,F-G,82,82,3048,709,1570,.452,606,1281,.473,103,289,.356,412,542,.760,102,226,328,189,82,30,187,183,1933,14.4
11,LeBron James\jamesle01,2015-16,F-G,76,76,2709,737,1416,.520,650,1134,.573,87,282,.309,359,491,.731,111,454,565,514,104,49,249,143,1920,20.7
12,Kawhi Leonard\leonaka01,2016-17,F,74,74,2474,636,1312,.485,489,925,.529,147,387,.380,469,533,.880,80,350,430,260,133,55,154,122,1888,20.4
13,Paul George\georgpa01,2015-16,F,81,81,2819,605,1449,.418,395,883,.447,210,566,.371,454,528,.860,79,484,563,329,152,29,265,230,1874,16.3
14,Blake Griffin\griffbl01,2018-19,F,75,75,2622,619,1341,.462,430,819,.525,189,522,.362,414,550,.753,100,465,565,402,52,28,253,199,1841,17.7
15,Giannis Antetokounmpo\antetgi01,2016-17,F-G,80,80,2845,656,1259,.521,607,1079,.563,49,180,.272,471,612,.770,142,558,700,434,131,151,234,246,1832,20.4
16,Jimmy Butler\butleji01,2016-17,F-G,76,75,2809,570,1252,.455,479,1004,.477,91,248,.367,585,676,.865,129,341,470,417,143,32,159,112,1816,20.8
17,Kevin Durant\duranke01,2017-18,F-G,68,68,2325,630,1222,.516,457,809,.565,173,413,.419,359,404,.889,31,433,464,366,50,119,207,133,1792,21.3
18,Paul George\georgpa01,2016-17,F,75,75,2689,622,1348,.461,427,852,.501,195,496,.393,336,374,.898,58,434,492,251,119,27,220,206,1775,16.6
19,LeBron James\jamesle01,2014-15,F-G,69,69,2493,624,1279,.488,504,940,.536,120,339,.354,375,528,.710,51,365,416,511,109,49,272,135,1743,19.7
20,LaMarcus Aldridge\aldrila01,2017-18,F-C,75,75,2509,687,1347,.510,660,1255,.526,27,92,.293,334,399,.837,246,389,635,152,43,90,111,161,1735,18.2
21,Paul George\georgpa01,2017-18,F,79,79,2891,576,1340,.430,332,731,.454,244,609,.401,338,411,.822,72,375,447,263,161,39,212,233,1734,15.5
22,LaMarcus Aldridge\aldrila01,2018-19,F-C,81,81,2687,684,1319,.519,674,1277,.528,10,42,.238,349,412,.847,251,493,744,194,43,107,144,179,1727,17.5
23,Andrew Wiggins\wiggian01,2015-16,F-G,81,81,2845,594,1294,.459,537,1104,.486,57,190,.300,430,565,.761,105,186,291,164,78,46,182,165,1675,13.1
24,LaMarcus Aldridge\aldrila01,2014-15,F-C,71,71,2512,659,1415,.466,622,1310,.475,37,105,.352,306,362,.845,177,549,726,124,48,68,122,125,1661,17.1
25,Carmelo Anthony\anthoca01,2016-17,F,74,74,2538,602,1389,.433,451,968,.466,151,421,.359,304,365,.833,62,376,438,213,60,34,153,198,1659,14.3
26,Anthony Davis\davisan02,2014-15,F-C,68,68,2455,642,1199,.535,641,1187,.540,1,12,.083,371,461,.805,173,523,696,149,100,200,95,141,1656,22.2
27,Khris Middleton\middlkh01,2017-18,F-G,82,82,2982,593,1272,.466,447,865,.517,146,407,.359,320,362,.884,45,384,429,328,119,21,191,270,1652,14.5
28,Tobias Harris\harrito02,2018-19,F,82,82,2848,611,1254,.487,455,861,.528,156,393,.397,266,307,.866,69,576,645,229,51,37,151,184,1644,15.0
29,Gordon Hayward\haywago01,2016-17,F-G,73,73,2516,545,1156,.471,396,782,.506,149,374,.398,362,429,.844,49,345,394,252,73,20,140,117,1601,16.4
30,Kawhi Leonard\leonaka01,2018-19,F,60,60,2040,560,1129,.496,448,827,.542,112,302,.371,364,426,.854,78,361,439,199,106,24,121,87,1596,21.2
31,Gordon Hayward\haywago01,2015-16,F-G,80,80,2893,521,1202,.433,378,792,.477,143,410,.349,393,477,.824,61,336,397,296,95,27,202,183,1578,13.8
32,Carmelo Anthony\anthoca01,2015-16,F,72,72,2530,567,1307,.434,462,997,.463,105,310,.339,334,403,.829,98,458,556,299,62,38,176,180,1573,15.5
33,Julius Randle\randlju01,2018-19,F-C,73,49,2232,571,1089,.524,504,894,.564,67,195,.344,356,487,.731,162,472,634,229,52,45,208,246,1565,16.0
34,Kevin Durant\duranke01,2016-17,F-G,62,62,2070,551,1026,.537,434,714,.608,117,312,.375,336,384,.875,39,474,513,300,66,99,138,117,1555,22.1
35,Kawhi Leonard\leonaka01,2015-16,F,72,72,2380,551,1090,.506,422,799,.528,129,291,.443,292,334,.874,95,398,493,186,128,71,105,133,1523,18.0
36,Harrison Barnes\barneha02,2016-17,F,79,79,2803,599,1280,.468,521,1058,.492,78,222,.351,242,281,.861,93,301,394,116,65,15,102,128,1518,12.7
37,LeBron James\jamesle01,2018-19,F-G,55,55,1937,558,1095,.510,447,768,.582,111,327,.339,278,418,.665,57,408,465,454,72,33,197,94,1505,22.7
38,Tobias Harris\harrito02,2017-18,F,80,80,2668,562,1221,.460,379,776,.488,183,445,.411,179,216,.829,58,379,437,192,71,35,105,164,1486,13.2
39,Anthony Davis\davisan02,2015-16,F-C,61,61,2164,560,1136,.493,525,1028,.511,35,108,.324,326,430,.758,130,497,627,116,78,125,121,148,1481,19.3
40,Blake Griffin\griffbl01,2014-15,F,67,67,2356,574,1144,.502,564,1119,.504,10,25,.400,311,427,.728,126,382,508,354,63,35,152,196,1469,17.3
41,Gordon Hayward\haywago01,2014-15,F-G,76,76,2618,484,1087,.445,364,757,.481,120,330,.364,375,462,.812,54,319,373,313,108,30,206,131,1463,14.3
42,Harrison Barnes\barneha02,2017-18,F,77,77,2634,537,1208,.445,418,875,.478,119,333,.357,259,313,.827,77,391,468,152,49,14,118,94,1452,12.7
43,Anthony Davis\davisan02,2018-19,F-C,56,56,1850,530,1026,.517,482,881,.547,48,145,.331,344,433,.794,174,498,672,218,88,135,112,132,1452,24.1
44,Andrew Wiggins\wiggian01,2017-18,F-G,82,82,2979,569,1300,.438,457,962,.475,112,338,.331,202,314,.643,82,276,358,160,91,51,138,163,1452,11.0
45,Pau Gasol\gasolpa01,2014-15,F-C,78,78,2681,570,1153,.494,558,1127,.495,12,26,.462,294,366,.803,220,699,919,210,25,147,158,147,1446,16.2
46,Khris Middleton\middlkh01,2015-16,F-G,79,79,2852,507,1142,.444,364,781,.466,143,361,.396,277,312,.888,44,258,302,331,131,19,180,204,1434,13.2
47,Rudy Gay\gayru01,2014-15,F,68,67,2408,508,1116,.455,429,896,.479,79,220,.359,337,393,.858,98,301,399,250,71,41,183,157,1432,15.0
48,Khris Middleton\middlkh01,2018-19,F-G,77,77,2393,506,1148,.441,327,674,.485,179,474,.378,216,258,.837,50,411,461,331,80,7,174,172,1407,13.3
49,Jimmy Butler\butleji01,2015-16,F-G,67,67,2474,470,1035,.454,406,830,.489,64,205,.312,395,475,.832,79,279,358,321,110,43,132,124,1399,17.2
50,Andrew Wiggins\wiggian01,2014-15,F-G,82,82,2969,497,1137,.437,458,1011,.453,39,126,.310,354,466,.760,134,240,374,170,86,50,177,190,1387,11.0
51,Paul Millsap\millspa01,2015-16,F,81,81,2647,501,1066,.470,427,834,.512,74,232,.319,309,408,.757,198,534,732,265,147,139,191,237,1385,15.3
52,Dirk Nowitzki\nowitdi01,2015-16,F,75,75,2364,498,1112,.448,372,770,.483,126,342,.368,250,280,.893,52,437,489,132,52,52,84,161,1372,13.1
53,Montrezl Harrell\harremo01,2018-19,F-C,82,5,2158,546,888,.615,543,871,.623,3,17,.176,266,414,.643,184,351,535,162,71,110,132,255,1361,14.1
54,Pascal Siakam\siakapa01,2018-19,F,80,79,2548,519,945,.549,440,731,.602,79,214,.369,237,302,.785,124,425,549,248,73,52,154,241,1354,14.0
55,Giannis Antetokounmpo\antetgi01,2015-16,F-G,80,79,2823,513,1013,.506,485,904,.537,28,109,.257,296,409,.724,113,499,612,345,94,113,208,258,1350,14.2
56,Danilo Gallinari\gallida01,2018-19,F,68,68,2059,409,884,.463,248,512,.484,161,372,.433,367,406,.904,54,363,417,178,49,23,99,129,1346,15.6
57,Dirk Nowitzki\nowitdi01,2014-15,F,77,77,2282,487,1062,.459,383,788,.486,104,274,.380,255,289,.882,44,413,457,143,39,33,82,160,1333,12.2
58,LaMarcus Aldridge\aldrila01,2015-16,F-C,74,74,2261,536,1045,.513,536,1029,.521,0,16,.000,259,302,.858,176,456,632,110,38,81,99,151,1331,14.4
59,Julius Randle\randlju01,2017-18,F-C,82,49,2190,504,904,.558,494,859,.575,10,45,.222,305,425,.718,181,473,654,210,43,45,213,274,1323,12.3
60,Tobias Harris\harrito02,2016-17,F,82,48,2567,511,1063,.481,402,749,.537,109,314,.347,190,226,.841,63,353,416,142,60,39,96,133,1321,11.6
61,Andrew Wiggins\wiggian01,2018-19,F-G,73,73,2543,498,1209,.412,380,861,.441,118,348,.339,207,296,.699,83,269,352,184,70,48,138,153,1321,11.1
62,Blake Griffin\griffbl01,2016-17,F,61,61,2076,479,971,.493,441,858,.514,38,113,.336,320,421,.760,112,385,497,300,57,22,142,157,1316,17.4
63,Kyle Kuzma\kuzmaky01,2018-19,F,70,68,2314,496,1087,.456,368,665,.553,128,422,.303,188,250,.752,60,322,382,178,41,26,133,170,1308,12.0
64,Jimmy Butler\butleji01,2017-18,F-G,59,59,2164,437,921,.474,367,721,.509,70,200,.350,363,425,.854,79,235,314,288,116,24,108,78,1307,19.2
65,Jimmy Butler\butleji01,2014-15,F-G,65,65,2513,421,912,.462,348,719,.484,73,193,.378,386,463,.834,114,265,379,212,114,36,93,108,1301,17.1
66,T.J. Warren\warretj01,2017-18,F,65,65,2142,529,1063,.498,509,973,.523,20,90,.222,193,255,.757,125,208,333,85,65,41,85,149,1271,13.4
67,Harrison Barnes\barneha02,2018-19,F,77,77,2533,431,1027,.420,257,586,.439,174,441,.395,229,278,.824,57,304,361,115,50,13,98,122,1265,10.7
68,Carmelo Anthony\anthoca01,2017-18,F,78,78,2501,472,1168,.404,303,694,.437,169,474,.357,148,193,.767,67,386,453,103,47,49,99,197,1261,9.6
69,Markieff Morris\morrima02,2014-15,F,82,82,2581,512,1100,.465,455,921,.494,57,179,.318,177,232,.763,110,396,506,192,101,39,170,245,1258,10.5
70,Aaron Gordon\gordoaa01,2018-19,F,78,78,2633,470,1046,.449,349,699,.499,121,347,.349,185,253,.731,129,445,574,289,57,56,162,172,1246,12.4
71,Paul Millsap\millspa01,2016-17,F,69,67,2343,430,972,.442,355,731,.486,75,241,.311,311,405,.768,111,422,533,252,90,62,158,186,1246,14.2
72,LaMarcus Aldridge\aldrila01,2016-17,F-C,72,72,2335,500,1049,.477,477,993,.480,23,56,.411,220,271,.812,172,351,523,139,46,88,98,158,1243,13.3
73,Jayson Tatum\tatumja01,2018-19,F,79,79,2455,466,1036,.450,350,725,.483,116,311,.373,195,228,.855,70,407,477,168,84,57,122,168,1243,11.6
74,Blake Griffin\griffbl01,2017-18,F,58,58,1970,436,996,.438,325,674,.482,111,322,.345,259,330,.785,73,355,428,334,41,18,165,139,1242,15.8
75,Kyle Kuzma\kuzmaky01,2017-18,F,77,37,2401,468,1039,.450,309,605,.511,159,434,.366,147,208,.707,88,395,483,141,49,34,140,160,1242,10.7
76,Kevin Love\loveke01,2015-16,F,77,77,2424,409,977,.419,251,538,.467,158,439,.360,258,314,.822,149,613,762,186,58,41,142,159,1234,12.9
77,Kevin Love\loveke01,2014-15,F,75,75,2532,413,952,.434,269,560,.480,144,392,.367,258,321,.804,142,589,731,168,51,39,122,140,1228,13.3
78,Terrence Ross\rosste01,2018-19,F-G,81,0,2150,440,1027,.428,223,461,.484,217,566,.383,126,144,.875,27,253,280,135,72,29,90,119,1223,10.1
79,Paul Millsap\millspa01,2014-15,F,73,73,2390,443,930,.476,366,714,.513,77,216,.356,255,337,.757,139,431,570,223,130,69,166,201,1218,14.1
80,Jimmy Butler\butleji01,2018-19,F-G,65,65,2185,418,904,.462,351,711,.494,67,193,.347,312,365,.855,121,221,342,263,123,39,95,111,1215,16.5
81,Rudy Gay\gayru01,2015-16,F,70,70,2379,466,1007,.463,392,792,.495,74,215,.344,198,254,.780,103,353,456,120,100,51,139,184,1204,12.1
82,Kristaps Porziņģis\porzikr01,2016-17,F-C,66,65,2164,443,985,.450,331,671,.493,112,314,.357,198,252,.786,111,364,475,97,47,129,118,244,1196,12.7
83,John Collins\collijo01,2018-19,F,61,59,1829,465,831,.560,410,673,.609,55,158,.348,203,266,.763,219,376,595,121,22,39,120,199,1188,15.9
84,Derrick Favors\favorde01,2014-15,F-C,74,74,2280,482,918,.525,481,912,.527,1,6,.167,222,332,.669,196,411,607,112,60,123,121,210,1187,13.2
85,Pau Gasol\gasolpa01,2015-16,F-C,72,72,2291,467,995,.469,443,926,.478,24,69,.348,229,289,.792,155,638,793,294,42,146,164,148,1187,15.0
86,Serge Ibaka\ibakase01,2016-17,F-C,79,79,2422,471,982,.480,347,665,.522,124,317,.391,107,125,.856,129,409,538,75,41,124,105,215,1173,11.0
87,Jeff Green\greenje02,2014-15,F,78,70,2455,416,967,.430,319,675,.473,97,292,.332,239,287,.833,64,264,328,134,53,34,108,147,1168,9.8
88,Nicolas Batum\batumni01,2016-17,F-G,77,77,2617,393,975,.403,258,570,.453,135,405,.333,243,284,.856,46,435,481,456,86,29,194,109,1164,12.6
89,Tobias Harris\harrito02,2014-15,F,68,63,2369,442,949,.466,355,710,.500,87,239,.364,193,245,.788,73,357,430,124,69,36,115,134,1164,12.2
90,Taurean Waller-Prince\princta02,2017-18,F,82,82,2464,415,975,.426,239,518,.461,176,457,.385,152,180,.844,50,339,389,214,85,42,191,168,1158,9.4
91,Danilo Gallinari\gallida01,2016-17,F,63,63,2134,335,750,.447,209,426,.491,126,324,.389,349,387,.902,39,286,325,135,40,15,82,93,1145,13.9
92,Zach Randolph\randoza01,2014-15,F-C,71,71,2304,454,932,.487,447,912,.490,7,20,.350,228,298,.765,225,522,747,153,69,14,156,175,1143,12.9
93,Kevin Love\loveke01,2016-17,F,60,60,1885,370,867,.427,225,478,.471,145,389,.373,257,295,.871,148,518,666,116,53,21,122,125,1142,15.1
94,Dario Šarić\saricda01,2017-18,F,78,73,2310,403,890,.453,246,491,.501,157,399,.393,178,207,.860,154,366,520,202,51,20,148,160,1141,11.3
95,Otto Porter\porteot01,2017-18,F,77,77,2432,445,885,.503,307,572,.537,138,313,.441,106,128,.828,103,389,492,157,116,41,75,151,1134,12.9
96,Draymond Green\greendr01,2015-16,F,81,81,2808,401,819,.490,301,561,.537,100,258,.388,229,329,.696,134,635,769,598,119,113,259,240,1131,15.1
97,Marcus Morris\morrima03,2015-16,F,80,80,2856,410,945,.434,302,647,.467,108,298,.362,203,271,.749,91,313,404,201,67,23,140,170,1131,9.7
98,Ryan Anderson\anderry01,2015-16,F,66,7,2008,397,929,.427,266,571,.466,131,358,.366,199,228,.873,131,265,396,73,38,25,90,109,1124,11.6
99,Wilson Chandler\chandwi01,2016-17,F,71,33,2197,433,939,.461,323,613,.527,110,326,.337,141,194,.727,103,357,460,141,51,30,114,172,1117,11.0
100,Tobias Harris\harrito02,2015-16,F,76,74,2513,417,889,.469,337,650,.518,80,239,.335,202,243,.831,96,414,510,169,65,40,108,153,1116,11.5
101,Serge Ibaka\ibakase01,2018-19,F-C,74,51,2010,464,877,.529,415,708,.586,49,169,.290,135,177,.763,156,445,601,99,29,103,114,211,1112,11.9
102,Jayson Tatum\tatumja01,2017-18,F,80,80,2443,397,835,.475,292,593,.492,105,242,.434,213,258,.826,50,352,402,128,83,58,114,170,1112,10.5
103,Marcus Morris\morrima03,2016-17,F,79,79,2565,421,1007,.418,303,650,.466,118,357,.331,145,185,.784,77,289,366,160,52,25,87,168,1105,9.1
104,Thaddeus Young\youngth01,2015-16,F,73,73,2407,495,963,.514,488,933,.523,7,30,.233,105,163,.644,176,484,660,135,112,37,136,182,1102,12.3
105,Jerami Grant\grantje01,2018-19,F,80,77,2612,409,823,.497,294,530,.555,115,293,.392,157,221,.710,96,321,417,79,61,100,67,214,1090,10.6
106,Kristaps Porziņģis\porzikr01,2017-18,F-C,48,48,1553,390,889,.439,300,661,.454,90,228,.395,218,275,.793,62,254,316,57,36,115,93,141,1088,15.1
107,Wilson Chandler\chandwi01,2014-15,F,78,75,2471,418,975,.429,279,569,.490,139,406,.342,110,142,.775,96,379,475,134,58,29,110,231,1085,9.1
108,Otto Porter\porteot01,2016-17,F,80,80,2605,414,803,.516,266,462,.576,148,341,.434,99,119,.832,118,396,514,121,116,42,44,193,1075,12.3
109,Ersan İlyasova\ilyaser01,2016-17,F,82,52,2142,384,890,.431,242,488,.496,142,402,.353,161,207,.778,115,366,481,141,58,23,116,211,1071,9.1
110,Thaddeus Young\youngth01,2014-15,F,76,68,2434,451,968,.466,413,853,.484,38,115,.330,131,200,.655,127,284,411,173,124,25,117,171,1071,10.5
111,Tim Duncan\duncati01,2014-15,F-C,77,77,2227,419,819,.512,417,812,.514,2,7,.286,230,311,.740,170,534,704,230,63,151,131,165,1070,13.6
112,Jabari Parker\parkeja01,2015-16,F,76,72,2408,443,899,.493,434,864,.502,9,35,.257,175,228,.768,123,272,395,130,69,29,116,154,1070,10.1
113,Markieff Morris\morrima02,2016-17,F,76,76,2374,406,889,.457,335,693,.483,71,196,.362,180,215,.837,107,386,493,126,82,42,129,254,1063,9.9
114,Kawhi Leonard\leonaka01,2014-15,F,64,64,2033,394,822,.479,327,630,.519,67,192,.349,202,252,.802,85,376,461,161,148,48,97,128,1057,14.7
115,Khris Middleton\middlkh01,2014-15,F-G,79,58,2378,406,869,.467,297,601,.494,109,268,.407,134,156,.859,48,299,347,182,122,11,113,183,1055,10.1
116,Trevor Ariza\arizatr01,2014-15,F,82,82,2930,366,910,.402,172,355,.485,194,555,.350,122,143,.853,77,382,459,209,152,17,141,186,1048,9.9
117,Kelly Oubre\oubreke01,2018-19,F,69,19,1935,375,842,.445,267,504,.530,108,338,.320,189,244,.775,71,254,325,84,84,59,103,181,1047,10.4
118,Nicolas Batum\batumni01,2015-16,F-G,70,70,2448,372,873,.426,233,474,.492,139,399,.348,163,192,.849,55,373,428,403,65,43,205,114,1046,12.1
119,Marcus Morris\morrima03,2018-19,F,75,53,2091,377,844,.447,231,455,.508,146,389,.375,146,173,.844,76,382,458,109,43,25,92,181,1046,9.8
120,Domantas Sabonis\sabondo01,2018-19,F-C,74,5,1838,413,700,.590,404,683,.592,9,17,.529,208,291,.715,186,504,690,212,48,30,160,239,1043,12.5
121,Zach Randolph\randoza01,2015-16,F-C,68,53,2016,431,907,.475,425,881,.482,6,26,.231,172,216,.796,179,350,529,142,43,13,105,146,1040,11.4
122,Dario Šarić\saricda01,2016-17,F,81,36,2129,381,927,.411,275,586,.469,106,341,.311,172,220,.782,112,401,513,182,57,30,183,162,1040,8.4
123,Kevin Love\loveke01,2017-18,F,59,59,1651,334,729,.458,197,399,.494,137,330,.415,234,266,.880,101,445,546,103,43,24,90,120,1039,14.4
124,Jae Crowder\crowdja01,2015-16,F,73,73,2308,360,813,.443,238,450,.529,122,363,.336,196,239,.820,70,303,373,135,126,35,83,198,1038,11.2
125,Chandler Parsons\parsoch01,2014-15,F,66,66,2186,383,829,.462,251,482,.521,132,347,.380,139,193,.720,64,259,323,161,69,19,96,140,1037,11.4
126,Danilo Gallinari\gallida01,2015-16,F,53,53,1839,287,700,.410,200,461,.434,87,239,.364,375,432,.868,52,229,281,135,42,19,77,87,1036,14.7
127,Lauri Markkanen\markkla01,2017-18,F-C,68,68,2020,374,862,.434,229,461,.497,145,401,.362,140,166,.843,79,429,508,79,39,40,83,103,1033,11.0
128,Giannis Antetokounmpo\antetgi01,2014-15,F-G,81,71,2541,383,780,.491,376,736,.511,7,44,.159,257,347,.741,100,442,542,207,73,85,173,254,1030,10.0
129,Kristaps Porziņģis\porzikr01,2015-16,F-C,72,72,2047,373,886,.421,292,643,.454,81,243,.333,201,240,.838,132,394,526,94,53,134,121,205,1028,10.6
130,Zach Randolph\randoza01,2016-17,F-C,73,5,1786,433,964,.449,412,870,.474,21,94,.223,141,193,.731,182,416,598,122,38,10,99,136,1028,10.1
131,Josh Smith\smithjo03,2014-15,F,83,35,2301,414,987,.419,342,759,.451,72,228,.316,127,255,.498,152,378,530,277,87,116,206,228,1027,8.9
132,Trevor Ariza\arizatr01,2015-16,F,81,81,2859,357,859,.416,172,360,.478,185,499,.371,126,161,.783,67,299,366,188,160,26,113,177,1025,10.1
133,Jabari Parker\parkeja01,2016-17,F,51,50,1728,399,814,.490,334,636,.525,65,178,.365,162,218,.743,79,235,314,142,50,22,93,111,1025,14.6
134,Thaddeus Young\youngth01,2018-19,F,81,81,2489,443,841,.527,392,695,.564,51,146,.349,87,135,.644,192,331,523,204,123,36,123,194,1024,11.3
135,Aaron Gordon\gordoaa01,2017-18,F,58,57,1909,375,865,.434,260,523,.497,115,342,.336,157,225,.698,87,370,457,136,59,45,107,111,1022,12.9
136,Aaron Gordon\gordoaa01,2016-17,F,80,72,2298,393,865,.454,316,598,.528,77,267,.288,156,217,.719,116,289,405,150,65,40,89,172,1019,9.4
137,Jaylen Brown\brownja02,2017-18,F-G,70,70,2152,373,803,.465,252,497,.507,121,306,.395,150,233,.644,66,280,346,114,70,26,124,181,1017,9.6
138,Derrick Favors\favorde01,2015-16,F-C,62,59,1983,418,811,.515,418,807,.518,0,4,.000,180,254,.709,169,334,503,94,74,91,104,150,1016,13.6
139,Josh Jackson\jacksjo02,2017-18,F-G,77,35,1959,389,932,.417,332,715,.464,57,217,.263,177,279,.634,95,256,351,119,80,35,146,218,1012,7.4
140,Chris Bosh\boshch01,2015-16,F-C,53,53,1778,358,767,.467,277,545,.508,81,222,.365,213,268,.795,48,342,390,128,36,34,78,101,1010,14.4
141,Robert Covington\covinro01,2017-18,F,80,80,2532,345,836,.413,142,286,.497,203,550,.369,116,136,.853,55,378,433,156,137,72,126,238,1009,9.8
142,Luol Deng\denglu01,2014-15,F,72,72,2421,369,787,.469,291,567,.513,78,220,.355,191,251,.761,103,273,376,139,65,22,108,109,1007,10.6
143,Jae Crowder\crowdja01,2016-17,F,72,72,2335,333,720,.463,176,326,.540,157,394,.398,176,217,.811,48,367,415,155,73,23,80,161,999,11.2
144,Taj Gibson\gibsota01,2017-18,F,82,82,2726,425,737,.577,418,702,.595,7,35,.200,142,185,.768,194,390,584,99,62,59,89,218,999,10.8
145,Joe Ingles\inglejo01,2018-19,F-G,82,82,2568,359,802,.448,170,319,.533,189,483,.391,87,123,.707,35,295,330,469,98,20,193,180,994,10.4
146,Cedi Osman\osmande01,2018-19,F,76,75,2444,360,844,.427,230,470,.489,130,374,.348,141,181,.779,45,312,357,195,60,11,114,195,991,8.8
147,DeMarre Carroll\carrode01,2017-18,F,73,73,2180,325,785,.414,180,394,.457,145,391,.371,188,246,.764,105,374,479,147,59,30,103,165,983,10.1
148,Serge Ibaka\ibakase01,2015-16,F-C,78,78,2500,416,869,.479,356,685,.520,60,184,.326,91,121,.752,141,392,533,66,38,148,108,211,983,9.5
149,Ryan Anderson\anderry01,2016-17,F,72,72,2116,323,773,.418,119,267,.446,204,506,.403,129,150,.860,112,218,330,68,31,14,55,142,979,9.4
150,Michael Beasley\beaslmi01,2017-18,F,74,30,1653,409,807,.507,375,721,.520,34,86,.395,124,159,.780,97,317,414,123,36,43,143,145,976,9.1
151,James Johnson\johnsja01,2016-17,F,76,5,2085,368,769,.479,281,513,.548,87,256,.340,152,215,.707,66,310,376,276,76,86,171,197,975,10.2
152,Julius Randle\randlju01,2016-17,F-C,74,73,2132,377,773,.488,360,710,.507,17,63,.270,204,282,.723,150,486,636,264,49,37,173,248,975,10.7
153,Lauri Markkanen\markkla01,2018-19,F-C,52,51,1682,342,795,.430,222,463,.479,120,332,.361,170,195,.872,74,396,470,75,37,33,85,122,974,13.3
154,Carmelo Anthony\anthoca01,2014-15,F,40,40,1428,358,806,.444,297,627,.474,61,179,.341,189,237,.797,72,192,264,122,40,17,89,87,966,16.2
155,Willie Cauley-Stein\caulewi01,2018-19,F-C,81,81,2213,412,741,.556,411,739,.556,1,2,.500,140,254,.551,181,497,678,194,96,51,84,227,965,11.5
156,Mirza Teletović\teletmi01,2015-16,F,79,1,1685,332,777,.427,151,317,.476,181,460,.393,120,155,.774,55,247,302,89,32,21,84,159,965,7.8
157,Jaylen Brown\brownja02,2018-19,F-G,74,25,1913,368,792,.465,273,516,.529,95,276,.344,133,202,.658,65,248,313,100,69,32,99,186,964,8.6
158,Bobby Portis\portibo01,2017-18,F,73,4,1643,382,811,.471,302,588,.514,80,223,.359,120,156,.769,159,339,498,123,50,23,103,130,964,10.2
159,Kevin Knox\knoxke01,2018-19,F,75,57,2158,338,914,.370,213,550,.387,125,364,.343,162,226,.717,61,274,335,82,43,24,114,175,963,6.5
160,Serge Ibaka\ibakase01,2017-18,F-C,76,76,2093,379,784,.483,272,487,.559,107,297,.360,94,118,.797,78,400,478,62,29,99,90,209,959,9.1
161,Thaddeus Young\youngth01,2017-18,F,81,81,2607,421,864,.487,363,683,.531,58,181,.320,55,92,.598,184,328,512,152,135,36,105,175,955,10.2
162,Kelly Oubre\oubreke01,2017-18,F,81,11,2231,318,790,.403,192,421,.456,126,369,.341,191,233,.820,59,304,363,98,80,35,90,234,953,7.8
163,Jae Crowder\crowdja01,2018-19,F,80,11,2166,318,797,.399,145,275,.527,173,522,.331,142,197,.721,60,324,384,133,64,31,85,170,951,8.3
164,T.J. Warren\warretj01,2016-17,F,66,59,2048,403,814,.495,377,716,.527,26,98,.265,119,154,.773,125,214,339,75,76,39,57,175,951,10.7
165,Brandon Ingram\ingrabr01,2018-19,F,52,52,1760,362,729,.497,331,635,.521,31,94,.330,195,289,.675,41,226,267,154,28,31,129,149,950,11.8
166,Brandon Ingram\ingrabr01,2017-18,F,59,59,1975,358,761,.470,317,656,.483,41,105,.390,192,282,.681,57,257,314,230,45,43,149,163,949,11.2
167,Marvin Williams\willima02,2015-16,F,81,81,2338,338,747,.452,186,369,.504,152,378,.402,120,144,.833,127,394,521,110,58,77,62,133,948,10.3
168,Kenneth Faried\farieke01,2014-15,F,75,71,2086,373,736,.507,372,728,.511,1,8,.125,199,288,.691,242,426,668,89,62,57,118,211,946,10.7
169,Rudy Gay\gayru01,2018-19,F,69,51,1842,376,746,.504,302,562,.537,74,184,.402,120,147,.816,63,407,470,182,54,34,114,159,946,11.0
170,Jeff Green\greenje02,2018-19,F,77,44,2097,326,687,.475,215,367,.586,111,320,.347,183,206,.888,57,252,309,137,43,39,101,160,946,9.1
171,Rondae Hollis-Jefferson\holliro01,2017-18,F,68,59,1920,342,724,.472,329,670,.491,13,54,.241,249,316,.788,101,358,459,167,65,48,121,145,946,11.2
172,Derrick Favors\favorde01,2017-18,F-C,77,77,2153,395,702,.563,381,639,.596,14,63,.222,140,215,.651,198,354,552,102,54,82,88,164,944,11.1
173,Robert Covington\covinro01,2014-15,F,70,49,1956,299,756,.396,132,310,.426,167,446,.374,178,217,.820,65,251,316,105,97,31,128,189,943,9.0
174,Joe Ingles\inglejo01,2017-18,F-G,82,81,2578,335,718,.467,131,254,.516,204,464,.440,66,83,.795,24,320,344,392,90,20,159,178,940,10.1
175,Jeff Green\greenje02,2015-16,F,80,41,2253,354,824,.430,287,611,.470,67,213,.315,164,220,.745,74,258,332,138,58,40,93,164,939,7.9
176,Trevor Ariza\arizatr01,2016-17,F,80,80,2773,326,798,.409,135,243,.556,191,555,.344,93,126,.738,54,404,458,175,147,20,73,133,936,10.1
177,Willie Cauley-Stein\caulewi01,2017-18,F-C,73,57,2044,388,773,.502,385,761,.506,3,12,.250,153,247,.619,131,379,510,172,77,67,109,185,932,10.6
178,Jabari Parker\parkeja01,2018-19,F,64,17,1724,369,749,.493,308,554,.556,61,195,.313,131,184,.712,79,342,421,152,46,30,151,145,930,10.2
179,Chris Bosh\boshch01,2014-15,F-C,44,44,1556,343,745,.460,280,577,.485,63,168,.375,179,232,.772,46,264,310,95,41,25,95,69,928,14.5
180,Dirk Nowitzki\nowitdi01,2017-18,F,77,77,1900,346,758,.456,208,421,.494,138,337,.409,97,108,.898,22,416,438,120,43,45,51,146,927,9.3
181,Marvin Bagley\baglema01,2018-19,F,62,4,1567,356,706,.504,326,610,.534,30,96,.313,181,262,.691,162,309,471,62,33,59,98,120,923,11.6
182,Draymond Green\greendr01,2014-15,F,79,79,2490,339,765,.443,228,436,.523,111,329,.337,132,200,.660,114,533,647,291,123,99,133,253,921,11.3
183,Julius Randle\randlju01,2015-16,F-C,81,60,2286,358,835,.429,348,799,.436,10,36,.278,193,270,.715,172,657,829,144,53,29,149,242,919,8.6
184,Corey Brewer\breweco01,2014-15,F-G,80,17,2087,343,805,.426,280,570,.491,63,235,.268,168,226,.743,80,217,297,173,114,19,131,173,917,8.0
185,Serge Ibaka\ibakase01,2014-15,F-C,64,64,2116,374,786,.476,297,581,.511,77,205,.376,92,110,.836,135,364,499,55,30,155,97,194,917,11.2
186,Luol Deng\denglu01,2015-16,F,74,73,2394,339,745,.455,251,489,.513,88,256,.344,145,192,.755,108,335,443,140,74,29,81,122,911,10.1
187,Josh Jackson\jacksjo02,2018-19,F-G,79,29,1988,347,841,.413,274,616,.445,73,225,.324,143,213,.671,66,281,347,183,74,56,173,209,910,6.9
188,Dillon Brooks\brookdi01,2017-18,F-G,82,74,2350,340,772,.440,246,508,.484,94,264,.356,124,166,.747,49,208,257,135,73,17,124,233,898,6.5
189,Derrick Favors\favorde01,2018-19,F-C,76,70,1766,363,619,.586,346,541,.640,17,78,.218,154,228,.675,207,353,560,89,56,106,84,163,897,11.5
190,DeMarre Carroll\carrode01,2014-15,F,70,69,2189,318,653,.487,198,349,.567,120,304,.395,127,181,.702,99,273,372,118,94,17,75,154,883,10.5
191,Paul Millsap\millspa01,2018-19,F,70,65,1895,322,665,.484,264,506,.522,58,159,.365,181,249,.727,153,352,505,141,83,54,95,183,883,11.2
192,Justin Holiday\holidju01,2017-18,F,72,72,2265,290,782,.371,129,333,.387,161,449,.359,135,164,.823,31,260,291,153,80,31,93,134,876,8.3
193,Frank Kaminsky\kaminfr01,2016-17,F-C,75,16,1954,320,802,.399,204,448,.455,116,354,.328,118,156,.756,57,279,336,162,46,34,76,139,874,8.0
194,Frank Kaminsky\kaminfr01,2017-18,F-C,79,4,1835,307,716,.429,203,442,.459,104,274,.380,155,194,.799,46,242,288,129,36,19,66,95,873,7.8
195,Otto Porter\porteot01,2015-16,F,75,73,2276,339,717,.473,241,450,.536,98,267,.367,95,126,.754,97,294,391,120,105,32,70,163,871,9.7
196,Paul Pierce\piercpa01,2014-15,F-G,73,73,1914,293,656,.447,175,353,.496,118,303,.389,164,210,.781,45,249,294,144,46,24,92,160,868,8.5
197,Brandon Bass\bassbr01,2014-15,F,82,43,1929,344,683,.504,335,651,.515,9,32,.281,169,214,.790,139,259,398,104,41,32,83,140,866,8.3
198,Robert Covington\covinro01,2016-17,F,67,67,2119,292,732,.399,155,320,.484,137,412,.333,143,174,.822,92,344,436,102,127,69,131,203,864,9.8
199,Trevor Ariza\arizatr01,2018-19,F,69,69,2349,294,736,.399,149,302,.493,145,434,.334,130,164,.793,50,321,371,252,91,21,106,130,863,10.2
200,Shabazz Muhammad\muhamsh01,2015-16,F-G,82,0,1682,317,681,.465,273,529,.516,44,152,.289,185,242,.764,100,167,267,52,24,7,70,94,863,6.9
201,Domantas Sabonis\sabondo01,2017-18,F-C,74,19,1810,340,661,.514,327,624,.524,13,37,.351,168,224,.750,165,407,572,151,40,32,137,220,861,9.4
202,Nikola Mirotić\mirotni01,2017-18,F,55,14,1494,306,684,.447,171,326,.525,135,358,.377,112,137,.818,59,346,405,80,44,39,62,108,859,12.0
203,Robert Covington\covinro01,2015-16,F,67,49,1903,274,712,.385,104,230,.452,170,482,.353,140,177,.791,65,354,419,97,105,40,143,232,858,8.5
204,Terrence Ross\rosste01,2016-17,F-G,78,24,1955,326,746,.437,184,355,.518,142,391,.363,64,77,.831,18,188,206,88,87,33,68,143,858,7.4
205,Dario Šarić\saricda01,2018-19,F,81,41,2022,304,696,.437,186,373,.499,118,323,.365,132,150,.880,126,331,457,127,45,9,97,182,858,7.9
206,Justin Holiday\holidju01,2018-19,F,82,77,2607,300,777,.386,138,312,.442,162,465,.348,95,106,.896,46,277,323,146,121,36,104,164,857,7.6
207,Zach Randolph\randoza01,2017-18,F-C,59,58,1508,361,763,.473,310,616,.503,51,147,.347,84,107,.785,97,300,397,127,42,10,116,119,857,10.0
208,Donatas Motiejūnas\motiedo01,2014-15,F-C,71,62,2037,353,700,.504,304,567,.536,49,133,.368,100,166,.602,137,284,421,130,56,34,123,203,855,8.8
209,Marvin Williams\willima02,2016-17,F,76,76,2295,297,704,.422,173,350,.494,124,354,.350,131,150,.873,89,411,500,106,58,53,60,134,849,9.3
210,Taj Gibson\gibsota01,2016-17,F,78,71,1989,365,709,.515,362,696,.520,3,13,.231,113,158,.715,158,327,485,73,41,65,105,163,846,8.4
211,Jeff Green\greenje02,2017-18,F,78,14,1828,295,618,.477,242,448,.540,53,170,.312,203,234,.868,60,186,246,99,41,34,75,149,846,7.9
212,Marcus Morris\morrima03,2014-15,F,81,35,2045,331,763,.434,219,450,.487,112,313,.358,71,113,.628,73,312,385,133,63,16,73,188,845,7.3
213,Markieff Morris\morrima02,2017-18,F,73,73,1968,330,687,.480,254,480,.529,76,207,.367,105,128,.820,75,334,409,142,56,38,127,216,841,8.3
214,Al-Farouq Aminu\aminual01,2015-16,F,82,82,2341,299,719,.416,173,370,.468,126,349,.361,115,156,.737,98,401,499,138,72,53,120,171,839,7.9
215,Chandler Parsons\parsoch01,2015-16,F,61,51,1799,320,651,.492,216,400,.540,104,251,.414,93,136,.684,29,256,285,169,46,21,95,114,837,10.3
216,Carlos Boozer\boozeca01,2014-15,F-C,71,26,1692,371,743,.499,371,743,.499,0,0,,94,150,.627,111,371,482,95,41,12,92,184,836,8.2
217,Montrezl Harrell\harremo01,2017-18,F-C,76,3,1293,348,548,.635,347,541,.641,1,7,.143,139,222,.626,103,203,306,74,36,52,68,143,836,9.1
218,Kenneth Faried\farieke01,2015-16,F,67,64,1694,349,626,.558,348,624,.558,1,2,.500,136,222,.613,235,346,581,79,32,60,91,169,835,11.1
219,Jared Sullinger\sullija01,2015-16,F,81,73,1915,351,806,.435,322,703,.458,29,103,.282,103,161,.640,194,479,673,187,75,47,102,209,834,8.9
220,Ryan Anderson\anderry01,2014-15,F,61,5,1675,291,729,.399,169,370,.457,122,359,.340,129,151,.854,108,187,295,55,33,20,62,113,833,8.9
221,Nikola Mirotić\mirotni01,2014-15,F,82,3,1654,253,624,.405,154,311,.495,99,313,.316,228,284,.803,63,341,404,97,54,54,89,172,833,7.6
222,Tyler Zeller\zellety01,2014-15,F-C,82,59,1731,340,619,.549,340,619,.549,0,0,,153,186,.823,146,319,465,113,18,52,76,205,833,8.5
223,Justise Winslow\winslju01,2018-19,F,66,52,1959,324,749,.433,228,493,.462,96,256,.375,86,137,.628,63,292,355,282,72,19,142,177,830,9.3
224,Harrison Barnes\barneha02,2014-15,F,82,82,2318,316,656,.482,229,441,.519,87,215,.405,108,150,.720,117,336,453,116,61,19,71,146,827,8.4
225,Gordon Hayward\haywago01,2018-19,F-G,72,18,1863,296,635,.466,219,404,.542,77,231,.333,156,187,.834,51,271,322,244,62,23,105,104,825,9.8
226,Dwight Powell\poweldw01,2018-19,F-C,77,22,1662,290,486,.597,251,359,.699,39,127,.307,196,254,.772,140,271,411,112,44,50,67,201,815,9.8
227,Thaddeus Young\youngth01,2016-17,F,74,74,2237,362,687,.527,317,569,.557,45,118,.381,45,86,.523,131,317,448,122,113,29,95,135,814,9.7
228,Omri Casspi\casspom01,2015-16,F,69,21,1880,299,622,.481,187,348,.537,112,274,.409,103,159,.648,58,352,410,95,56,17,94,154,813,8.7
229,Terrence Ross\rosste01,2014-15,F-G,82,61,2092,309,753,.410,164,363,.452,145,390,.372,44,56,.786,32,194,226,86,53,25,69,136,807,5.9
230,Jaren Jackson\jacksja02,2018-19,F,58,56,1515,298,589,.506,247,447,.553,51,142,.359,151,197,.766,73,199,272,64,52,82,98,220,798,9.8
231,Pau Gasol\gasolpa01,2016-17,F-C,64,39,1627,303,604,.502,247,500,.494,56,104,.538,130,184,.707,107,394,501,150,24,70,81,110,792,11.2
232,James Johnson\johnsja01,2017-18,F,73,41,1943,309,614,.503,252,429,.587,57,185,.308,113,162,.698,61,297,358,280,70,51,141,192,788,9.3
233,Trevor Ariza\arizatr01,2017-18,F,67,67,2269,268,651,.412,98,189,.519,170,462,.368,76,89,.854,33,261,294,105,98,13,52,132,782,9.0
234,Otto Porter\porteot01,2018-19,F,56,43,1684,299,643,.465,195,387,.504,104,256,.406,78,96,.813,54,260,314,120,82,31,65,108,780,11.4
235,John Collins\collijo01,2017-18,F,74,26,1785,314,545,.576,298,498,.598,16,47,.340,133,186,.715,176,365,541,98,47,80,105,215,777,9.6
236,Nikola Mirotić\mirotni01,2015-16,F,66,38,1646,248,609,.407,113,263,.430,135,346,.390,146,181,.807,58,304,362,100,58,46,102,151,777,8.6
237,Draymond Green\greendr01,2016-17,F,76,76,2471,272,650,.418,191,387,.494,81,263,.308,151,213,.709,98,501,599,533,154,106,184,217,776,12.6
238,Pau Gasol\gasolpa01,2017-18,F-C,77,63,1812,287,627,.458,244,507,.481,43,120,.358,158,209,.756,129,490,619,238,24,79,108,121,775,9.8
239,Harrison Barnes\barneha02,2015-16,F,66,59,2042,295,633,.466,213,419,.508,82,214,.383,102,134,.761,77,248,325,117,41,10,57,136,774,8.8
240,Jae Crowder\crowdja01,2017-18,F,80,47,2090,271,671,.404,161,330,.488,110,341,.323,121,148,.818,59,216,275,99,64,21,74,187,773,6.3
241,Draymond Green\greendr01,2017-18,F,70,70,2287,281,619,.454,204,363,.562,77,256,.301,134,173,.775,75,460,535,508,95,91,202,185,773,12.4
242,Maurice Harkless\harklma01,2016-17,F-G,77,69,2223,314,624,.503,246,430,.572,68,194,.351,77,124,.621,125,216,341,88,85,70,86,214,773,8.0
243,Shabazz Muhammad\muhamsh01,2016-17,F-G,78,1,1516,288,598,.482,239,453,.528,49,145,.338,147,190,.774,84,136,220,35,22,6,56,86,772,6.6
244,T.J. Warren\warretj01,2018-19,F,43,36,1360,297,611,.486,220,431,.510,77,180,.428,101,124,.815,31,143,174,64,51,29,52,119,772,12.4
245,Jared Sullinger\sullija01,2014-15,F,58,49,1566,311,708,.439,259,524,.494,52,184,.283,96,129,.744,147,294,441,134,44,42,78,153,770,10.4
246,Dirk Nowitzki\nowitdi01,2016-17,F,54,54,1424,296,678,.437,217,469,.463,79,209,.378,98,112,.875,23,330,353,82,30,38,51,113,769,10.0
247,David West\westda01,2014-15,F-C,66,66,1895,323,686,.471,319,666,.479,4,20,.200,119,161,.739,108,341,449,223,48,48,120,160,769,9.6
248,Ersan İlyasova\ilyaser01,2015-16,F,74,56,1880,280,661,.424,184,402,.458,96,259,.371,111,154,.721,144,259,403,67,52,33,71,171,767,7.6
249,Jon Leuer\leuerjo01,2016-17,F,75,34,1944,310,646,.480,261,479,.545,49,167,.293,98,113,.867,102,300,402,111,31,26,66,145,767,8.0
250,Markieff Morris\morrima02,2015-16,F,64,45,1629,305,718,.425,258,563,.458,47,155,.303,108,147,.735,73,279,352,124,58,34,135,184,765,7.2
251,Matt Barnes\barnema02,2014-15,F,76,74,2271,277,624,.444,141,248,.569,136,376,.362,74,95,.779,51,251,302,114,67,50,87,240,764,7.1
252,Doug McDermott\mcderdo01,2015-16,F,81,4,1861,291,644,.452,181,385,.470,110,259,.425,72,84,.857,37,158,195,59,14,6,53,127,764,5.6
253,Luis Scola\scolalu01,2014-15,F,81,16,1659,300,642,.467,295,622,.474,5,20,.250,158,226,.699,138,388,526,105,47,18,94,192,763,7.2
254,Al-Farouq Aminu\aminual01,2018-19,F,81,81,2292,257,593,.433,161,313,.514,96,280,.343,150,173,.867,112,498,610,104,68,33,72,143,760,8.7
255,Matt Barnes\barnema02,2015-16,F,76,45,2190,264,693,.381,145,323,.449,119,370,.322,111,138,.804,84,336,420,163,78,57,121,234,758,7.2
256,Marvin Williams\willima02,2018-19,F,75,75,2133,275,652,.422,135,270,.500,140,382,.366,66,86,.767,76,331,407,92,71,61,47,156,756,8.3
257,Marquese Chriss\chrisma01,2016-17,F,82,75,1743,284,632,.449,212,408,.520,72,224,.321,113,181,.624,96,252,348,60,67,70,108,263,753,5.9
258,Taj Gibson\gibsota01,2018-19,F,70,57,1686,304,537,.566,293,503,.583,11,34,.324,134,177,.757,172,286,458,84,53,39,73,186,753,9.7
259,Wesley Johnson\johnswe01,2014-15,F-G,76,59,2245,286,691,.414,195,432,.451,91,259,.351,90,112,.804,67,252,319,124,59,45,87,162,753,6.9
260,Ersan İlyasova\ilyaser01,2017-18,F,69,43,1730,277,613,.452,186,360,.517,91,253,.360,105,135,.778,118,287,405,90,61,26,72,157,750,8.6
261,Jerami Grant\grantje01,2015-16,F,77,52,2066,251,599,.419,216,453,.477,35,146,.240,212,322,.658,99,262,361,135,54,127,110,215,749,7.5
262,Blake Griffin\griffbl01,2015-16,F,35,35,1170,301,603,.499,295,585,.504,6,18,.333,141,194,.727,51,243,294,170,28,17,83,95,749,16.4
263,Derrick Williams\willide02,2015-16,F,80,9,1435,254,565,.450,210,415,.506,44,150,.293,194,256,.758,47,249,296,75,29,9,61,69,746,6.7
264,DeMarre Carroll\carrode01,2018-19,F,67,8,1703,227,575,.395,121,265,.457,106,310,.342,184,242,.760,68,281,349,85,31,10,73,114,744,7.8
265,Nikola Mirotić\mirotni01,2016-17,F,70,15,1679,258,625,.413,129,248,.520,129,377,.342,99,128,.773,61,323,384,75,53,55,80,128,744,7.9
266,Marvin Williams\willima02,2017-18,F,78,78,2006,258,563,.458,132,258,.512,126,305,.413,102,123,.829,74,296,370,96,56,38,66,116,744,8.0
267,Michael Kidd-Gilchrist\kiddgmi01,2016-17,F,81,81,2349,295,618,.477,294,609,.483,1,9,.111,152,194,.784,156,409,565,114,81,77,56,187,743,9.0
268,Taurean Waller-Prince\princta02,2018-19,F,55,47,1552,262,594,.441,139,279,.498,123,315,.390,95,116,.819,22,177,199,118,53,19,100,141,742,8.8
269,Nemanja Bjelica\bjeline01,2018-19,F,77,70,1788,284,593,.479,181,336,.539,103,257,.401,70,92,.761,125,319,444,147,54,56,82,197,741,8.4
270,Nicolas Batum\batumni01,2017-18,F-G,64,64,1981,270,650,.415,178,376,.473,92,274,.336,108,130,.831,57,249,306,349,65,23,131,72,740,10.4
271,Brandon Ingram\ingrabr01,2016-17,F,79,40,2279,276,686,.402,221,499,.443,55,187,.294,133,214,.621,60,256,316,166,50,36,116,158,740,5.9
272,Wilson Chandler\chandwi01,2017-18,F,74,71,2346,281,631,.445,193,385,.501,88,246,.358,88,114,.772,102,296,398,159,43,39,92,156,738,7.9
273,Nenê Hilário\hilarne01,2014-15,F-C,67,58,1693,307,601,.511,306,596,.513,1,5,.200,122,202,.604,84,261,345,123,66,22,124,180,737,7.7
274,Danilo Gallinari\gallida01,2014-15,F,59,27,1426,228,568,.401,121,267,.453,107,301,.355,171,191,.895,31,187,218,83,47,20,57,94,734,8.8
275,Marcus Morris\morrima03,2017-18,F,54,21,1442,262,611,.429,176,377,.467,86,234,.368,124,154,.805,43,246,289,72,35,12,65,100,734,9.1
276,Solomon Hill\hillso01,2014-15,F,82,78,2381,251,634,.396,183,426,.430,68,208,.327,159,193,.824,70,244,314,184,66,18,115,177,729,6.3
277,Trey Lyles\lylestr01,2017-18,F,73,2,1391,270,550,.491,187,332,.563,83,218,.381,101,143,.706,55,292,347,91,30,34,61,111,724,7.8
278,Mario Hezonja\hezonma01,2017-18,F-G,75,30,1657,273,617,.442,183,350,.523,90,267,.337,86,105,.819,41,240,281,106,81,31,86,134,722,7.1
279,Jonathan Isaac\isaacjo01,2018-19,F,75,64,1996,262,611,.429,176,345,.510,86,266,.323,110,135,.815,99,312,411,80,59,98,75,143,720,8.0
280,Terrence Ross\rosste01,2015-16,F-G,73,7,1747,270,626,.431,139,287,.484,131,339,.386,49,62,.790,21,164,185,56,54,25,46,120,720,6.4
281,Aaron Gordon\gordoaa01,2015-16,F,78,37,1863,274,579,.473,232,437,.531,42,142,.296,129,193,.668,154,353,507,128,59,55,66,153,719,8.6
282,P.J. Tucker\tuckepj01,2014-15,F,78,63,2383,261,596,.438,174,344,.506,87,252,.345,104,143,.727,114,388,502,122,107,23,96,179,713,8.0
283,Bobby Portis\portibo01,2018-19,F,50,28,1298,279,628,.444,204,437,.467,75,191,.393,77,97,.794,109,294,403,72,35,20,74,145,710,10.1
284,Trevor Booker\booketr01,2016-17,F,71,43,1754,305,591,.516,280,513,.546,25,78,.321,74,110,.673,143,428,571,138,75,28,127,152,709,8.9
285,Boris Diaw\diawbo01,2014-15,F-C,81,15,1984,291,632,.460,237,463,.512,54,169,.320,72,93,.774,78,270,348,233,36,23,126,148,708,6.7
286,Anthony Tolliver\tollian01,2017-18,F-C,79,14,1757,219,472,.464,60,107,.561,159,365,.436,106,133,.797,50,191,241,90,32,21,58,144,703,6.8
287,Nicolas Batum\batumni01,2018-19,F-G,75,72,2354,253,562,.450,137,264,.519,116,298,.389,77,89,.865,71,319,390,247,71,43,117,140,699,8.6
288,Nikola Mirotić\mirotni01,2018-19,F,46,25,1245,238,542,.439,122,224,.545,116,318,.365,105,124,.847,60,279,339,55,31,34,48,107,697,11.6
289,Amir Johnson\johnsam01,2014-15,F-C,75,72,1979,298,519,.574,279,473,.590,19,46,.413,79,129,.612,159,297,456,117,44,59,110,225,694,8.0
290,Tristan Thompson\thomptr01,2014-15,F-C,82,15,2194,267,488,.547,267,488,.547,0,0,,159,248,.641,274,383,657,39,34,61,83,189,693,8.2
291,JaMychal Green\greenja01,2016-17,F,77,75,2101,250,500,.500,195,355,.549,55,145,.379,134,167,.802,167,377,544,84,47,34,94,248,689,7.7
292,DeAndre' Bembry\bembrde01,2018-19,F,82,15,1931,275,616,.446,225,443,.508,50,173,.289,87,136,.640,54,304,358,202,105,41,142,190,687,6.5
293,Kevin Durant\duranke01,2014-15,F-G,27,27,913,238,467,.510,174,308,.565,64,159,.403,146,171,.854,16,162,178,110,24,25,74,40,686,19.7
294,Jerami Grant\grantje01,2017-18,F,81,1,1647,244,456,.535,212,346,.613,32,110,.291,162,240,.675,86,233,319,57,31,77,54,155,682,7.0
295,Michael Kidd-Gilchrist\kiddgmi01,2017-18,F,74,74,1850,282,560,.504,282,558,.505,0,2,.000,117,171,.684,84,218,302,71,51,32,53,143,681,7.0
296,Amar'e Stoudemire\stoudam01,2014-15,F-C,59,15,1244,273,490,.557,273,486,.562,0,4,.000,134,186,.720,110,219,329,45,29,38,78,161,680,8.7
297,Rondae Hollis-Jefferson\holliro01,2016-17,F,78,50,1761,235,542,.434,220,475,.463,15,67,.224,190,253,.751,96,356,452,154,82,44,116,177,675,7.3
298,Dwight Powell\poweldw01,2017-18,F-C,79,24,1672,255,430,.593,227,346,.656,28,84,.333,133,185,.719,135,309,444,91,67,32,59,186,671,8.3
299,Ersan İlyasova\ilyaser01,2014-15,F,58,36,1319,263,557,.472,189,367,.515,74,190,.389,69,107,.645,80,197,277,56,36,19,45,149,669,8.1
300,Mike Scott\scottmi01,2017-18,F,76,1,1406,276,524,.527,210,361,.582,66,163,.405,50,76,.658,50,197,247,80,23,10,79,148,668,5.8
301,Nicolas Batum\batumni01,2014-15,F-G,71,71,2380,240,600,.400,140,291,.481,100,309,.324,84,98,.857,62,354,416,341,78,40,132,106,664,9.2
302,Luis Scola\scolalu01,2015-16,F,76,76,1636,269,598,.450,204,437,.467,65,161,.404,61,84,.726,84,276,360,66,46,27,68,178,664,6.0
303,Luc Mbah a Moute\mbahalu01,2014-15,F,67,61,1916,251,636,.395,189,434,.435,62,202,.307,96,163,.589,82,246,328,106,81,21,99,104,660,6.7
304,Ed Davis\davised01,2014-15,F,79,24,1840,282,469,.601,282,469,.601,0,0,,92,189,.487,230,370,600,94,49,98,58,202,656,9.1
305,Jason Smith\smithja02,2014-15,F-C,82,31,1785,257,592,.434,242,550,.440,15,42,.357,127,153,.830,98,226,324,140,32,44,104,205,656,5.4
306,Rudy Gay\gayru01,2017-18,F,57,6,1231,253,537,.471,216,419,.516,37,118,.314,112,145,.772,76,215,291,73,46,38,78,98,655,8.6
307,P.J. Tucker\tuckepj01,2015-16,F,82,80,2540,239,582,.411,171,376,.455,68,206,.330,106,142,.746,165,347,512,177,106,20,111,202,652,7.3
308,Patrick Patterson\pattepa01,2014-15,F,81,4,2156,240,535,.449,135,252,.536,105,283,.371,63,80,.788,127,306,433,155,60,44,54,149,648,7.8
309,Al-Farouq Aminu\aminual01,2017-18,F,69,67,2072,230,582,.395,105,243,.432,125,339,.369,59,80,.738,97,428,525,84,79,40,79,136,644,8.0
310,Tristan Thompson\thomptr01,2015-16,F-C,82,34,2269,247,420,.588,247,420,.588,0,0,,149,242,.616,268,470,738,62,38,51,61,202,643,8.7
311,Taj Gibson\gibsota01,2014-15,F,62,17,1692,254,506,.502,254,506,.502,0,0,,132,184,.717,162,234,396,71,36,75,77,162,640,8.8
312,DeMarre Carroll\carrode01,2016-17,F,72,72,1882,220,550,.400,111,230,.483,109,320,.341,89,117,.761,63,212,275,74,81,27,54,143,638,6.6
313,Jared Dudley\dudleja01,2015-16,F-G,81,41,2098,233,487,.478,133,249,.534,100,238,.420,72,98,.735,54,232,286,170,75,18,80,190,638,6.6
314,Jeff Green\greenje02,2016-17,F,69,11,1534,220,558,.394,167,365,.458,53,193,.275,145,168,.863,39,175,214,81,37,13,75,103,638,5.7
315,Darius Miller\milleda01,2017-18,F,82,3,1944,216,487,.444,69,129,.535,147,358,.411,58,67,.866,18,146,164,111,28,17,58,160,637,5.3
316,Doug McDermott\mcderdo01,2017-18,F,81,4,1768,237,508,.467,145,292,.497,92,216,.426,64,81,.790,40,160,200,79,19,16,56,122,630,5.2
317,Tristan Thompson\thomptr01,2016-17,F-C,78,78,2336,262,437,.600,262,434,.604,0,3,.000,106,213,.498,286,429,715,77,39,84,64,176,630,9.4
318,Justin Holiday\holidju01,2016-17,F,82,4,1639,233,538,.433,136,265,.513,97,273,.355,66,80,.825,27,198,225,102,65,31,66,109,629,5.7
319,Jae Crowder\crowdja01,2014-15,F,82,17,1647,229,545,.420,168,337,.499,61,208,.293,109,141,.773,72,221,293,94,72,25,49,137,628,6.0
320,Taj Gibson\gibsota01,2015-16,F,73,55,1936,263,500,.526,263,497,.529,0,3,.000,101,146,.692,206,298,504,106,47,77,78,180,627,8.5
321,Larry Nance\nancela02,2018-19,F-C,67,30,1795,249,479,.520,216,381,.567,33,98,.337,96,134,.716,168,384,552,214,100,40,97,192,627,10.6
322,Ryan Anderson\anderry01,2017-18,F,66,50,1725,207,480,.431,76,141,.539,131,339,.386,72,93,.774,94,237,331,60,24,21,42,126,617,7.3
323,Derrick Williams\willide02,2014-15,F,74,6,1462,217,485,.447,168,329,.511,49,156,.314,134,196,.684,41,161,202,50,34,4,56,67,617,5.5
324,Willie Cauley-Stein\caulewi01,2016-17,F-C,75,21,1421,255,481,.530,255,479,.532,0,2,.000,101,151,.669,85,254,339,80,53,44,69,147,611,6.7
325,JaMychal Green\greenja01,2018-19,F,65,6,1371,230,476,.483,159,300,.530,71,176,.403,80,101,.792,104,305,409,50,45,34,87,193,611,7.2
326,Nenê Hilário\hilarne01,2016-17,F-C,67,8,1198,245,397,.617,242,388,.624,3,9,.333,116,197,.589,95,187,282,65,56,39,73,163,609,7.6
327,Dorian Finney-Smith\finnedo01,2018-19,F,81,26,1985,228,528,.432,149,274,.544,79,254,.311,73,103,.709,138,251,389,95,69,36,74,186,608,6.2
328,Dāvis Bertāns\bertada01,2018-19,F,76,12,1632,204,453,.450,59,115,.513,145,338,.429,53,60,.883,23,241,264,100,35,33,43,133,606,6.4
329,Frank Kaminsky\kaminfr01,2015-16,F-C,81,3,1708,215,525,.410,147,323,.455,68,202,.337,108,148,.730,69,266,335,98,38,43,58,126,606,5.7
330,P.J. Tucker\tuckepj01,2018-19,F,82,82,2802,207,523,.396,61,136,.449,146,387,.377,41,59,.695,121,358,479,96,132,39,63,252,601,6.9
331,Stanley Johnson\johnsst04,2017-18,F,69,50,1894,210,560,.375,143,326,.439,67,234,.286,112,145,.772,33,219,252,112,95,14,77,169,599,5.9
332,Michael Kidd-Gilchrist\kiddgmi01,2014-15,F,55,52,1587,224,482,.465,224,482,.465,0,0,,150,214,.701,109,307,416,77,30,38,63,115,598,9.0
333,Mike Dunleavy\dunlemi02,2014-15,F-G,63,63,1838,209,481,.435,102,218,.468,107,263,.407,70,87,.805,28,220,248,114,39,21,60,123,595,7.1
334,Omri Casspi\casspom01,2014-15,F,67,19,1416,209,427,.489,174,340,.512,35,87,.402,140,191,.733,54,206,260,102,31,9,88,107,593,6.5
335,Stanley Johnson\johnsst04,2015-16,F,73,6,1687,225,600,.375,162,395,.410,63,205,.307,80,102,.784,58,248,306,118,55,12,114,178,593,4.5
336,Doug McDermott\mcderdo01,2016-17,F,66,5,1508,222,497,.447,145,289,.502,77,208,.370,71,84,.845,20,159,179,58,13,5,38,79,592,5.7
337,Corey Brewer\breweco01,2015-16,F-G,82,12,1669,212,552,.384,151,328,.460,61,224,.272,105,140,.750,42,157,199,109,84,19,78,168,590,4.6
338,Pascal Siakam\siakapa01,2017-18,F,81,5,1679,253,498,.508,224,366,.612,29,132,.220,54,87,.621,79,285,364,159,62,42,67,166,589,6.6
339,Kenneth Faried\farieke01,2016-17,F,61,34,1296,228,416,.548,228,410,.556,0,6,.000,131,189,.693,183,279,462,55,43,40,59,124,587,9.5
340,Kyle Anderson\anderky01,2017-18,F-G,74,67,1978,231,438,.527,212,381,.556,19,57,.333,104,146,.712,84,312,396,202,115,60,94,114,585,9.0
341,Terrence Jones\joneste01,2016-17,F,54,12,1271,231,492,.470,212,417,.508,19,75,.253,103,170,.606,65,241,306,59,40,54,48,67,584,8.7
342,Joe Ingles\inglejo01,2016-17,F-G,82,26,1972,204,451,.452,81,172,.471,123,279,.441,50,68,.735,23,238,261,225,96,8,107,163,581,6.3
343,Rasual Butler\butlera01,2014-15,F-G,75,1,1505,218,517,.422,127,282,.450,91,235,.387,53,67,.791,27,170,197,63,29,22,48,98,580,4.9
344,JaMychal Green\greenja01,2015-16,F,78,15,1446,230,495,.465,215,450,.478,15,45,.333,103,137,.752,139,234,373,67,46,33,83,189,578,5.6
345,Amir Johnson\johnsam01,2015-16,F-C,79,76,1800,249,426,.585,239,383,.624,10,43,.233,69,121,.570,178,327,505,138,52,83,94,214,577,7.7
346,Marvin Williams\willima02,2014-15,F,78,37,2035,210,495,.424,115,230,.500,95,265,.358,62,87,.713,58,328,386,100,69,36,60,146,577,6.3
347,David Lee\leeda02,2016-17,F,79,10,1477,248,420,.590,248,420,.590,0,0,,80,113,.708,149,292,441,124,31,40,82,125,576,7.3
348,Larry Nance\nancela02,2017-18,F-C,66,26,1421,240,413,.581,238,401,.594,2,12,.167,91,137,.664,161,291,452,82,88,38,51,172,573,9.3
349,Richaun Holmes\holmeri01,2018-19,F-C,70,4,1184,222,365,.608,222,365,.608,0,0,,128,175,.731,115,216,331,60,42,79,52,194,572,7.7
350,Noah Vonleh\vonleno01,2018-19,F,68,57,1722,207,440,.470,161,303,.531,46,137,.336,111,156,.712,113,415,528,129,46,51,88,174,571,8.0
351,JaMychal Green\greenja01,2017-18,F,55,54,1542,223,488,.457,180,361,.499,43,127,.339,80,111,.721,147,317,464,79,32,25,76,153,569,8.5
352,Trevor Booker\booketr01,2014-15,F,79,5,1564,226,464,.487,197,380,.518,29,84,.345,86,148,.581,139,258,397,83,43,41,88,144,567,5.9
353,Jon Leuer\leuerjo01,2015-16,F,67,27,1255,224,466,.481,182,356,.511,42,110,.382,77,101,.762,76,297,373,72,38,30,75,125,567,6.7
354,Darius Miller\milleda01,2018-19,F,69,15,1757,189,484,.390,56,120,.467,133,364,.365,56,71,.789,14,114,128,146,40,23,59,165,567,5.4
355,Jarell Martin\martija01,2017-18,F,73,36,1661,221,496,.446,187,398,.470,34,98,.347,89,116,.767,97,221,318,73,39,49,86,211,565,5.3
356,Doug McDermott\mcderdo01,2018-19,F,77,1,1340,207,422,.491,123,216,.569,84,206,.408,66,79,.835,17,92,109,67,18,8,42,104,564,4.8
357,Solomon Hill\hillso01,2016-17,F,80,71,2374,183,478,.383,89,208,.428,94,270,.348,103,128,.805,51,256,307,141,72,32,82,182,563,5.5
358,Rudy Gay\gayru01,2016-17,F,30,30,1013,201,442,.455,159,329,.483,42,113,.372,118,138,.855,35,155,190,83,44,26,74,79,562,13.7
359,Richaun Holmes\holmeri01,2016-17,F-C,57,17,1193,230,412,.558,203,335,.606,27,77,.351,72,103,.699,94,217,311,58,42,55,55,136,559,8.6
360,Marquese Chriss\chrisma01,2017-18,F,72,49,1527,202,477,.423,146,287,.509,56,190,.295,96,158,.608,76,319,395,83,51,70,107,205,556,5.5
361,Paul Millsap\millspa01,2017-18,F,38,37,1143,202,435,.464,163,322,.506,39,113,.345,112,161,.696,65,180,245,105,39,44,73,99,555,11.6
362,James Johnson\johnsja01,2014-15,F,70,17,1370,238,404,.589,227,353,.643,11,51,.216,67,102,.657,61,196,257,95,54,70,79,155,554,6.9
363,David West\westda01,2015-16,F-C,78,19,1404,244,448,.545,241,441,.546,3,7,.429,63,80,.788,72,237,309,143,44,55,68,142,554,6.5
364,J.J. Hickson\hicksjj01,2014-15,F-C,73,8,1411,218,459,.475,218,457,.477,0,2,.000,116,201,.577,150,302,452,57,36,35,96,136,552,5.9
365,Kyle O'Quinn\oquinky01,2017-18,F-C,77,10,1387,224,384,.583,220,367,.599,4,17,.235,98,127,.772,121,349,470,158,36,98,100,192,550,7.6
366,Wesley Johnson\johnswe01,2015-16,F-G,80,9,1666,208,515,.404,105,206,.510,103,309,.333,30,46,.652,37,211,248,49,89,56,54,173,549,4.9
367,Markieff Morris\morrima02,2018-19,F,58,16,1271,204,484,.421,136,281,.484,68,203,.335,71,92,.772,61,204,265,79,36,22,54,175,547,6.3
368,Trey Lyles\lylestr01,2018-19,F,64,2,1120,207,495,.418,156,295,.529,51,200,.255,81,116,.698,44,202,246,87,30,23,68,93,546,5.6
369,Jason Smith\smithja02,2015-16,F-C,76,2,1181,244,503,.485,240,487,.493,4,16,.250,54,67,.806,53,166,219,62,33,65,57,163,546,4.9
370,Brandan Wright\wrighbr03,2014-15,F-C,75,7,1449,233,363,.642,233,360,.647,0,3,.000,78,112,.696,128,193,321,41,50,94,34,102,544,7.8
371,Patrick Patterson\pattepa01,2015-16,F,79,0,2020,204,493,.414,98,200,.490,106,293,.362,29,34,.853,77,265,342,94,53,32,65,128,543,5.5
372,Jake Layman\laymaja01,2018-19,F,71,33,1327,216,424,.509,157,243,.646,59,181,.326,50,71,.704,56,161,217,53,31,30,46,116,541,5.7
373,P.J. Tucker\tuckepj01,2016-17,F,81,21,2236,199,482,.413,129,286,.451,70,196,.357,72,93,.774,117,354,471,99,116,19,66,196,540,6.4
374,Rodions Kurucs\kurucro01,2018-19,F,63,46,1294,202,449,.450,144,265,.543,58,184,.315,72,92,.783,56,190,246,52,41,25,77,146,534,5.5
375,Al-Farouq Aminu\aminual01,2016-17,F,61,25,1773,183,466,.393,113,254,.445,70,212,.330,96,136,.706,77,374,451,99,60,44,94,102,532,7.4
376,Dragan Bender\bendedr01,2017-18,F,82,37,2069,187,484,.386,69,162,.426,118,322,.366,39,51,.765,40,321,361,130,22,53,112,166,531,4.4
377,Mike Scott\scottmi01,2014-15,F,68,0,1123,201,453,.444,135,261,.517,66,192,.344,61,77,.792,45,154,199,75,25,3,39,83,529,5.5
378,Justise Winslow\winslju01,2017-18,F,68,25,1680,207,488,.424,158,359,.440,49,129,.380,66,104,.635,64,306,370,148,54,33,77,140,529,6.5
379,Michael Beasley\beaslmi01,2016-17,F,56,6,935,216,406,.532,198,363,.545,18,43,.419,78,105,.743,40,153,193,53,27,27,66,92,528,6.7
380,Darrell Arthur\arthuda01,2015-16,F,70,16,1516,221,489,.452,176,372,.473,45,117,.385,40,53,.755,86,207,293,96,53,48,66,185,527,5.8
381,Matt Barnes\barnema02,2016-17,F,74,18,1776,185,473,.391,98,210,.467,87,263,.331,70,89,.787,70,314,384,195,48,26,107,185,527,5.8
382,Montrezl Harrell\harremo01,2016-17,F-C,58,14,1064,225,345,.652,224,338,.663,1,7,.143,76,121,.628,81,138,219,64,20,42,44,126,527,7.9
383,Rondae Hollis-Jefferson\holliro01,2018-19,F,59,21,1234,200,487,.411,191,438,.436,9,49,.184,118,183,.645,83,227,310,96,44,27,68,107,527,6.5
384,Ed Davis\davised01,2015-16,F,81,0,1684,206,337,.611,206,337,.611,0,0,,114,204,.559,224,375,599,88,57,72,64,202,526,7.8
385,Nenê Hilário\hilarne01,2015-16,F-C,57,11,1094,209,384,.544,209,381,.549,0,3,.000,107,185,.578,52,207,259,97,54,26,76,156,525,7.2
386,Skal Labissière\labissk01,2017-18,F,60,29,1240,205,458,.448,187,407,.459,18,51,.353,95,118,.805,99,189,288,72,25,49,73,132,523,6.4
387,Tim Duncan\duncati01,2015-16,F-C,61,60,1536,215,441,.488,215,439,.490,0,2,.000,92,131,.702,115,332,447,163,47,78,90,125,522,8.8
388,Amir Johnson\johnsam01,2016-17,F-C,80,77,1608,213,370,.576,186,304,.612,27,66,.409,67,100,.670,118,248,366,140,51,62,77,211,520,6.5
389,Kevin Séraphin\serapke01,2014-15,F,79,0,1235,231,450,.513,231,448,.516,0,2,.000,58,82,.707,87,201,288,59,10,59,98,197,520,4.1
390,Jared Dudley\dudleja01,2014-15,F-G,72,22,1717,198,423,.468,124,231,.537,74,192,.385,48,67,.716,45,175,220,130,72,11,62,113,518,6.1
391,Dwight Powell\poweldw01,2016-17,F-C,77,3,1333,194,377,.515,173,303,.571,21,74,.284,107,141,.759,93,213,306,49,61,39,34,135,516,6.2
392,Jaylen Brown\brownja02,2016-17,F-G,78,20,1341,192,423,.454,146,288,.507,46,135,.341,85,124,.685,45,175,220,64,35,18,68,142,515,4.3
393,T.J. Warren\warretj01,2015-16,F,47,4,1070,221,441,.501,193,371,.520,28,70,.400,45,64,.703,57,90,147,44,37,16,32,94,515,7.7
394,James Ennis\ennisja01,2017-18,F,72,22,1604,182,384,.474,131,231,.567,51,153,.333,97,116,.836,73,151,224,71,47,18,56,134,512,5.6
395,Shabazz Muhammad\muhamsh01,2014-15,F-G,38,13,866,194,397,.489,174,346,.503,20,51,.392,104,145,.717,63,91,154,44,18,7,35,49,512,9.6
396,Mario Hezonja\hezonma01,2018-19,F-G,58,24,1206,191,464,.412,149,312,.478,42,152,.276,87,114,.763,28,211,239,88,57,8,88,110,511,5.6
397,Kris Humphries\humphkr01,2014-15,F-C,64,17,1345,211,446,.473,211,439,.481,0,7,.000,87,117,.744,118,298,416,57,34,25,46,130,509,6.8
398,Sam Dekker\dekkesa01,2016-17,F,77,2,1419,203,429,.473,143,242,.591,60,187,.321,38,68,.559,94,190,284,76,38,21,41,83,504,5.6
399,Carl Landry\landrca01,2014-15,F,70,15,1192,190,369,.515,190,369,.515,0,0,,123,150,.820,99,169,268,26,15,17,54,132,503,5.3
400,P.J. Tucker\tuckepj01,2017-18,F,82,34,2281,172,441,.390,57,131,.435,115,310,.371,43,60,.717,93,364,457,77,78,26,74,205,502,5.2
401,Justise Winslow\winslju01,2015-16,F,78,8,2232,195,462,.422,163,346,.471,32,116,.276,80,117,.684,81,322,403,117,68,26,95,184,502,5.1
402,Kelly Oubre\oubreke01,2016-17,F,79,5,1605,186,442,.421,132,254,.520,54,188,.287,75,99,.758,61,200,261,47,58,17,50,195,501,4.2
403,Kevon Looney\looneke01,2018-19,F-C,80,24,1481,217,347,.625,216,337,.641,1,10,.100,65,105,.619,194,223,417,123,46,53,51,211,500,7.1
404,Maurice Harkless\harklma01,2015-16,F-G,78,14,1457,195,411,.474,156,271,.576,39,140,.279,69,111,.622,101,179,280,67,49,35,62,124,498,5.2
405,Kyle O'Quinn\oquinky01,2016-17,F-C,79,8,1229,215,413,.521,213,396,.538,2,17,.118,64,83,.771,157,282,439,117,36,104,76,174,496,6.6
406,David West\westda01,2017-18,F-C,73,0,999,216,378,.571,213,370,.576,3,8,.375,60,79,.759,64,174,238,138,47,75,80,120,495,6.5
407,Jason Thompson\thompja02,2014-15,F-C,81,63,1991,201,428,.470,201,427,.471,0,1,.000,89,143,.622,139,391,530,85,33,57,84,239,491,5.2
408,Trey Lyles\lylestr01,2015-16,F,80,33,1382,191,436,.438,142,308,.461,49,128,.383,57,82,.695,59,240,299,59,26,18,65,114,488,4.1
409,Draymond Green\greendr01,2018-19,F,66,66,2065,188,422,.445,141,257,.549,47,165,.285,63,91,.692,60,421,481,454,95,70,169,197,486,9.7
410,Boris Diaw\diawbo01,2015-16,F-C,76,4,1386,202,383,.527,177,314,.564,25,69,.362,56,76,.737,58,175,233,176,26,21,97,102,485,5.4
411,Maxi Kleber\klebima01,2018-19,F,71,18,1502,175,386,.453,98,168,.583,77,218,.353,58,74,.784,90,239,329,70,36,78,54,143,485,6.2
412,Dante Cunningham\cunnida01,2015-16,F,80,46,1971,186,412,.451,131,238,.550,55,174,.316,57,82,.695,57,179,236,77,42,33,41,173,484,4.5
413,Luc Mbah a Moute\mbahalu01,2016-17,F,80,76,1787,191,378,.505,148,268,.552,43,110,.391,59,87,.678,44,126,170,39,81,35,46,122,484,4.9
414,Lance Thomas\thomala01,2015-16,F,59,5,1313,169,382,.442,125,273,.458,44,109,.404,102,119,.857,34,97,131,53,22,7,57,109,484,5.0
415,Anthony Tolliver\tollian01,2014-15,F-C,76,11,1433,161,393,.410,55,103,.534,106,290,.366,54,69,.783,51,185,236,59,24,16,51,137,482,4.3
416,Kyle Singler\singlky01,2014-15,F,80,58,1744,172,446,.386,76,205,.371,96,241,.398,40,52,.769,33,161,194,85,47,21,55,153,480,3.9
417,Domantas Sabonis\sabondo01,2016-17,F-C,81,66,1632,192,481,.399,141,322,.438,51,159,.321,44,67,.657,46,242,288,82,39,32,83,200,479,3.3
418,Mario Hezonja\hezonma01,2015-16,F-G,79,9,1413,181,418,.433,114,226,.504,67,192,.349,49,54,.907,28,148,176,109,39,17,97,124,478,3.8
419,Derrick Favors\favorde01,2016-17,F-C,50,39,1186,203,417,.487,200,407,.491,3,10,.300,67,109,.615,92,213,305,56,45,40,60,103,476,7.8
420,Brandon Bass\bassbr01,2015-16,F,66,0,1342,174,317,.549,174,315,.552,0,2,.000,125,148,.845,104,181,285,74,33,55,42,125,473,7.1
421,Ed Davis\davised01,2018-19,F,81,1,1446,186,302,.616,186,300,.620,0,2,.000,100,162,.617,216,478,694,61,35,33,64,226,472,6.8
422,Tristan Thompson\thomptr01,2018-19,F-C,43,40,1198,201,380,.529,201,380,.529,0,0,,68,106,.642,173,265,438,86,28,16,59,89,470,11.0
423,OG Anunoby\anunoog01,2018-19,F,67,6,1352,183,404,.453,116,202,.574,67,202,.332,36,62,.581,58,139,197,47,46,22,55,140,469,4.7
424,Robert Covington\covinro01,2018-19,F,35,35,1203,156,362,.431,71,137,.518,85,225,.378,68,89,.764,28,165,193,46,74,47,47,126,465,10.8
425,Mike Scott\scottmi01,2015-16,F,75,0,1146,176,376,.468,114,218,.523,62,158,.392,50,63,.794,53,153,206,78,25,17,42,102,464,4.8
426,Trevor Booker\booketr01,2015-16,F,79,2,1632,190,388,.490,178,347,.513,12,41,.293,71,106,.670,166,286,452,84,59,41,81,169,463,5.7
427,Willie Cauley-Stein\caulewi01,2015-16,F-C,66,39,1412,191,339,.563,191,337,.567,0,2,.000,81,125,.648,134,218,352,37,48,66,46,146,463,7.0
428,Anthony Tolliver\tollian01,2016-17,F-C,65,9,1477,155,351,.442,65,121,.537,90,230,.391,61,82,.744,51,186,237,77,34,20,56,109,461,5.6
429,Caron Butler\butleca01,2014-15,F,78,21,1623,161,396,.407,78,177,.441,83,219,.379,55,61,.902,21,175,196,79,43,4,49,120,460,4.1
430,Maurice Harkless\harklma01,2018-19,F-G,60,53,1415,189,388,.487,156,268,.582,33,120,.275,49,73,.671,77,192,269,74,67,53,45,163,460,6.9
431,Luc Mbah a Moute\mbahalu01,2017-18,F,61,15,1564,166,345,.481,103,172,.599,63,173,.364,65,95,.684,22,164,186,55,72,25,68,100,460,5.9
432,Jonas Jerebko\jerebjo01,2018-19,F,73,6,1218,163,355,.459,94,167,.563,69,188,.367,64,80,.800,72,216,288,96,27,18,43,137,459,5.4
433,Mike Scott\scottmi01,2018-19,F,79,3,1396,168,420,.400,67,168,.399,101,252,.401,22,33,.667,43,233,276,66,26,13,44,156,459,3.8
434,Ante Žižić\zizican01,2018-19,F-C,59,25,1082,183,331,.553,183,331,.553,0,0,,93,132,.705,108,212,320,53,13,22,61,113,459,6.5
435,Chase Budinger\budinch01,2014-15,F,67,4,1286,169,390,.433,117,247,.474,52,143,.364,67,81,.827,33,165,198,64,44,10,49,72,457,5.0
436,Dāvis Bertāns\bertada01,2017-18,F,77,10,1086,161,366,.440,67,114,.588,94,252,.373,40,49,.816,18,135,153,74,26,28,36,93,456,4.4
437,Nemanja Bjelica\bjeline01,2017-18,F,67,21,1371,171,371,.461,95,188,.505,76,183,.415,36,45,.800,53,221,274,86,50,16,52,141,454,5.6
438,Stanley Johnson\johnsst04,2018-19,F,66,7,1207,171,440,.389,109,225,.484,62,215,.288,50,64,.781,34,183,217,88,60,14,81,114,454,4.4
439,Ersan İlyasova\ilyaser01,2018-19,F,67,7,1231,167,381,.438,109,221,.493,58,160,.363,61,74,.824,94,208,302,52,32,20,48,172,453,5.1
440,Mirza Teletović\teletmi01,2016-17,F,70,2,1133,156,418,.373,52,113,.460,104,305,.341,35,45,.778,11,151,162,48,12,13,37,109,451,3.5
441,Mike Muscala\muscami01,2018-19,F-C,64,10,1306,145,361,.402,56,105,.533,89,256,.348,70,85,.824,57,187,244,76,22,38,48,130,449,5.4
442,Larry Nance\nancela02,2016-17,F-C,63,7,1442,190,361,.526,180,325,.554,10,36,.278,59,80,.738,120,249,369,96,82,39,56,149,449,7.7
443,Richard Jefferson\jefferi01,2016-17,F,79,13,1614,153,343,.446,91,157,.580,62,186,.333,80,108,.741,28,175,203,78,26,10,52,153,448,3.9
444,Jonas Jerebko\jerebjo01,2014-15,F,75,0,1230,169,379,.446,115,239,.481,54,140,.386,56,66,.848,93,189,282,71,46,18,44,135,448,5.0
445,Timothé Luwawu-Cabarrot\luwawti01,2016-17,F,69,19,1190,145,361,.402,95,200,.475,50,161,.311,105,123,.854,25,124,149,75,32,10,73,154,445,3.7
446,Patrick Patterson\pattepa01,2016-17,F,65,8,1599,154,384,.401,60,131,.458,94,253,.372,43,60,.717,62,231,293,76,40,23,38,120,445,5.6
447,Otto Porter\porteot01,2014-15,F,74,13,1432,176,391,.450,141,287,.491,35,104,.337,58,79,.734,70,151,221,65,44,30,52,97,445,4.7
448,Lance Thomas\thomala01,2014-15,F,62,37,1491,182,442,.412,175,420,.417,7,22,.318,72,99,.727,65,130,195,69,37,8,74,101,443,4.1
449,Tyler Zeller\zellety01,2017-18,F-C,66,34,1108,187,334,.560,177,306,.578,10,28,.357,57,79,.722,110,195,305,47,15,35,47,126,441,5.8
450,Trey Lyles\lylestr01,2016-17,F,71,4,1158,159,439,.362,94,235,.400,65,204,.319,57,79,.722,48,187,235,69,26,20,64,97,440,3.7
451,OG Anunoby\anunoog01,2017-18,F,74,62,1481,163,346,.471,90,149,.604,73,197,.371,39,62,.629,44,140,184,55,52,14,45,130,438,4.4
452,Jerami Grant\grantje01,2016-17,F,80,4,1531,152,328,.463,109,212,.514,43,116,.371,90,147,.612,38,167,205,46,33,79,44,149,437,4.2
453,Bobby Portis\portibo01,2016-17,F,64,13,1000,183,375,.488,151,279,.541,32,96,.333,39,59,.661,75,221,296,35,16,11,37,94,437,5.2
454,Bobby Portis\portibo01,2015-16,F,62,4,1102,186,436,.427,170,384,.443,16,52,.308,48,66,.727,123,214,337,52,25,22,54,100,436,5.3
455,Dante Cunningham\cunnida01,2016-17,F,66,35,1649,174,359,.485,103,178,.579,71,181,.392,16,27,.593,56,221,277,37,39,28,28,100,435,5.6
456,Mike Muscala\muscami01,2016-17,F-C,70,3,1237,170,337,.504,124,227,.546,46,110,.418,49,64,.766,76,164,240,95,30,41,55,97,435,5.6
457,Jared Dudley\dudleja01,2016-17,F-G,64,7,1362,157,346,.454,80,143,.559,77,203,.379,43,65,.662,31,194,225,121,42,16,73,154,434,5.1
458,Terrence Jones\joneste01,2015-16,F,50,11,1044,166,367,.452,141,288,.490,25,79,.316,77,116,.664,62,149,211,41,23,39,49,86,434,6.2
459,Tayshaun Prince\princta01,2014-15,F,58,16,1397,177,402,.440,146,335,.436,31,67,.463,49,65,.754,52,158,210,93,29,16,35,55,434,6.0
460,Richard Jefferson\jefferi01,2014-15,F,74,18,1244,144,324,.444,78,169,.462,66,155,.426,78,114,.684,25,158,183,61,32,11,52,115,432,4.0
461,Andrea Bargnani\bargnan01,2014-15,F-C,29,22,785,164,361,.454,149,320,.466,15,41,.366,87,107,.813,32,95,127,46,2,27,42,53,430,9.5
462,James Ennis\ennisja01,2016-17,F,64,28,1501,146,321,.455,95,184,.516,51,137,.372,86,110,.782,69,190,259,64,46,19,59,165,429,5.3
463,Jonas Jerebko\jerebjo01,2017-18,F,74,19,1134,159,341,.466,94,184,.511,65,157,.414,46,57,.807,53,193,246,42,24,12,27,127,429,4.4
464,Lavoy Allen\allenla01,2015-16,F-C,79,28,1599,191,370,.516,191,370,.516,0,0,,46,73,.630,162,262,424,76,26,42,69,147,428,5.2
465,Trevor Booker\booketr01,2017-18,F,68,7,1158,177,343,.516,169,310,.545,8,33,.242,66,93,.710,117,201,318,82,28,21,59,119,428,5.6
466,James Johnson\johnsja01,2018-19,F,55,33,1164,164,379,.433,114,230,.496,50,149,.336,50,70,.714,22,154,176,135,35,27,74,114,428,5.6
467,Tiago Splitter\splitti01,2014-15,F-C,52,35,1030,169,303,.558,169,303,.558,0,0,,90,120,.750,91,161,252,78,35,37,60,103,428,7.7
468,Michael Kidd-Gilchrist\kiddgmi01,2018-19,F,64,3,1179,158,332,.476,142,285,.498,16,47,.340,95,123,.772,88,158,246,61,32,39,43,156,427,5.5
469,David Lee\leeda02,2015-16,F,55,5,903,178,335,.531,178,334,.533,0,1,.000,71,93,.763,101,204,305,84,22,28,66,114,427,6.8
470,Khris Middleton\middlkh01,2016-17,F-G,29,23,889,150,333,.450,105,229,.459,45,104,.433,81,92,.880,11,112,123,99,41,7,65,79,426,10.6
471,Royce O'Neale\onealro01,2018-19,F,82,16,1671,163,343,.475,95,167,.569,68,176,.386,32,42,.762,22,263,285,124,54,24,70,172,426,4.4
472,Luol Deng\denglu01,2016-17,F,56,49,1486,164,424,.387,113,259,.436,51,165,.309,46,63,.730,63,232,295,74,48,20,43,61,425,6.2
473,Mindaugas Kuzminskas\kuzmimi01,2016-17,F,68,5,1016,158,369,.428,104,201,.517,54,168,.321,55,68,.809,47,79,126,69,29,11,51,79,425,4.2
474,Derrick Jones\jonesde02,2018-19,F,60,14,1153,160,324,.494,132,233,.567,28,91,.308,74,122,.607,96,144,240,37,46,42,43,123,422,6.0
475,Jason Smith\smithja02,2016-17,F-C,74,3,1068,174,329,.529,137,251,.546,37,78,.474,35,51,.686,64,194,258,37,21,54,58,168,420,4.3
476,Dante Cunningham\cunnida01,2017-18,F,73,25,1562,164,364,.451,106,196,.541,58,168,.345,31,52,.596,78,220,298,48,39,30,33,111,417,4.9
477,Paul Pierce\piercpa01,2015-16,F-G,68,38,1231,144,397,.363,69,155,.445,75,242,.310,54,66,.818,12,174,186,71,33,17,58,129,417,3.5
478,Ed Davis\davised01,2017-18,F,78,0,1471,170,292,.582,170,291,.584,0,1,.000,74,111,.667,183,392,575,40,32,52,66,188,414,5.9
479,Al-Farouq Aminu\aminual01,2014-15,F,74,3,1366,147,357,.412,113,233,.485,34,124,.274,84,118,.712,114,228,342,59,70,62,55,137,412,5.4
480,Quincy Acy\acyqu01,2017-18,F-C,70,8,1359,130,365,.356,28,73,.384,102,292,.349,49,60,.817,40,217,257,57,33,29,60,149,411,3.9
481,Jerami Grant\grantje01,2014-15,F,65,11,1377,124,352,.352,75,196,.383,49,156,.314,114,193,.591,49,149,198,79,40,68,85,144,411,4.0
482,Richard Jefferson\jefferi01,2015-16,F,74,5,1326,143,312,.458,77,139,.554,66,173,.382,58,87,.667,15,113,128,59,33,14,43,129,410,3.7
483,Harry Giles\gilesha01,2018-19,F-C,58,0,820,175,348,.503,175,342,.512,0,6,.000,58,91,.637,66,156,222,85,31,22,73,150,408,5.0
484,Juan Hernangómez\hernaju01,2018-19,F,70,25,1358,138,314,.439,72,133,.541,66,181,.365,66,86,.767,64,201,265,55,27,24,37,94,408,5.0
485,Frank Kaminsky\kaminfr01,2018-19,F-C,47,0,755,138,298,.463,88,159,.553,50,139,.360,79,107,.738,39,124,163,63,12,12,41,68,405,6.4
486,Mike Muscala\muscami01,2017-18,F-C,53,7,1060,143,312,.458,81,145,.559,62,167,.371,57,62,.919,56,174,230,51,31,27,42,80,405,6.5
487,Nemanja Bjelica\bjeline01,2016-17,F,65,1,1190,151,356,.424,95,179,.531,56,177,.316,45,61,.738,57,187,244,79,40,20,59,154,403,4.5
488,Wesley Johnson\johnswe01,2017-18,F-G,74,40,1486,150,368,.408,90,191,.471,60,177,.339,43,58,.741,29,187,216,61,76,62,55,146,403,4.4
489,Charlie Villanueva\villach01,2014-15,F,64,1,678,150,362,.414,67,141,.475,83,221,.376,20,35,.571,30,119,149,19,15,22,28,64,403,3.9
490,Dwight Powell\poweldw01,2015-16,F-C,69,2,992,146,296,.493,144,280,.514,2,16,.125,105,142,.739,84,189,273,44,36,24,40,118,399,5.0
491,Quincy Acy\acyqu01,2014-15,F-C,68,22,1287,152,331,.459,134,271,.494,18,60,.300,76,97,.784,79,222,301,68,27,22,60,147,398,4.6
492,Joe Ingles\inglejo01,2014-15,F-G,79,32,1673,147,354,.415,75,152,.493,72,202,.356,30,40,.750,22,153,175,182,72,10,98,124,396,4.1
493,Jabari Parker\parkeja01,2017-18,F,31,3,743,160,332,.482,129,251,.514,31,81,.383,40,54,.741,42,109,151,59,25,10,45,50,391,9.3
494,James Ennis\ennisja01,2018-19,F,58,27,1230,138,294,.469,83,138,.601,55,156,.353,58,81,.716,60,122,182,41,41,23,34,150,389,5.2
495,David Lee\leeda02,2014-15,F,49,4,904,160,313,.511,160,311,.514,0,2,.000,68,104,.654,81,176,257,85,31,26,49,83,388,7.2
496,Cheick Diallo\diallch01,2018-19,F,64,1,896,168,271,.620,167,267,.625,1,4,.250,50,67,.746,75,257,332,33,29,33,49,113,387,5.8
497,Terrence Jones\joneste01,2014-15,F,33,24,889,158,299,.528,145,262,.553,13,37,.351,57,94,.606,78,142,220,36,18,59,37,78,386,10.3
498,Maxi Kleber\klebima01,2017-18,F,72,35,1206,151,309,.489,111,181,.613,40,128,.313,44,59,.746,71,163,234,51,26,47,30,114,386,4.7
499,Maurice Harkless\harklma01,2017-18,F-G,59,37,1264,147,297,.495,98,179,.547,49,118,.415,42,59,.712,46,116,162,53,48,43,40,103,385,5.6
500,Kenneth Faried\farieke01,2018-19,F,37,13,728,156,265,.589,148,240,.617,8,25,.320,64,99,.646,97,153,250,20,17,23,33,82,384,9.2
501,Andrew Nicholson\nichoan01,2015-16,F,56,0,823,146,310,.471,105,196,.536,41,114,.360,51,65,.785,34,167,201,25,10,22,41,69,384,4.8
502,Anthony Tolliver\tollian01,2015-16,F-C,72,5,1341,128,332,.386,30,60,.500,98,272,.360,29,47,.617,39,190,229,52,26,16,28,86,383,4.0
503,Darrell Arthur\arthuda01,2014-15,F,58,4,988,155,384,.404,129,274,.471,26,110,.236,46,59,.780,53,118,171,57,48,26,47,146,382,4.2
504,Corey Brewer\breweco01,2017-18,F-G,72,18,1209,142,316,.449,111,206,.539,31,110,.282,65,90,.722,43,111,154,65,79,14,49,139,380,4.1
505,Kevin Love\loveke01,2018-19,F,22,21,598,109,283,.385,56,136,.412,53,147,.361,103,114,.904,33,206,239,48,6,5,42,54,374,12.7
506,Willie Reed\reedwi02,2016-17,F-C,71,5,1031,162,285,.568,161,281,.573,1,4,.250,49,88,.557,129,203,332,26,18,47,31,137,374,5.0
507,Dirk Nowitzki\nowitdi01,2018-19,F,51,20,795,135,376,.359,71,171,.415,64,205,.312,39,50,.780,5,153,158,35,9,18,18,76,373,4.0
508,Corey Brewer\breweco01,2016-17,F-G,82,11,1281,147,348,.422,120,230,.522,27,118,.229,50,68,.735,32,134,166,97,61,20,55,133,371,3.4
509,Tyler Zeller\zellety01,2015-16,F-C,60,3,710,138,290,.476,138,290,.476,0,0,,88,108,.815,62,116,178,29,10,22,46,97,364,4.1
510,Thon Maker\makerth01,2017-18,F-C,74,12,1238,130,316,.411,99,212,.467,31,104,.298,65,93,.699,75,150,225,46,38,53,44,162,356,3.7
511,Carl Landry\landrca01,2015-16,F,36,12,569,139,250,.556,133,237,.561,6,13,.462,67,91,.736,49,97,146,32,12,9,22,69,351,7.7
512,Kyle Anderson\anderky01,2015-16,F-G,78,11,1245,138,295,.468,126,258,.488,12,37,.324,62,83,.747,25,219,244,123,60,29,59,97,350,4.4
513,Dorian Finney-Smith\finnedo01,2016-17,F,81,35,1642,124,333,.372,68,142,.479,56,191,.293,46,61,.754,55,167,222,67,52,25,45,125,350,3.3
514,Larry Nance\nancela02,2015-16,F-C,63,22,1266,158,300,.527,157,290,.541,1,10,.100,32,47,.681,101,211,312,44,54,23,41,124,349,5.4
515,Kyle Anderson\anderky01,2018-19,F-G,43,40,1281,150,276,.543,141,242,.583,9,34,.265,37,64,.578,48,203,251,128,54,37,58,112,346,8.4
516,Alan Williams\willial03,2016-17,F-C,47,0,708,138,267,.517,138,266,.519,0,1,.000,70,112,.625,94,198,292,23,27,32,37,125,346,6.4
517,Kris Humphries\humphkr01,2015-16,F-C,53,17,835,121,295,.410,87,187,.465,34,108,.315,67,84,.798,57,161,218,36,16,23,38,94,343,4.7
518,Royce O'Neale\onealro01,2017-18,F,69,4,1150,120,284,.423,78,166,.470,42,118,.356,61,76,.803,25,211,236,95,36,16,55,105,343,4.1
519,Joe Ingles\inglejo01,2015-16,F-G,81,2,1241,124,291,.426,43,81,.531,81,210,.386,13,18,.722,19,132,151,96,55,4,65,98,342,3.2
520,Amir Johnson\johnsam01,2017-18,F-C,74,18,1171,140,260,.538,130,228,.570,10,32,.313,52,85,.612,123,207,330,118,45,44,55,192,342,5.1
521,Shawne Williams\willish03,2014-15,F,63,22,1087,121,300,.403,57,122,.467,64,178,.360,35,40,.875,36,130,166,44,25,21,30,135,341,3.6
522,Dante Cunningham\cunnida01,2014-15,F,66,27,1652,155,339,.457,154,329,.468,1,10,.100,29,47,.617,70,186,256,50,46,37,35,101,340,4.5
523,Nenê Hilário\hilarne01,2017-18,F-C,52,4,758,136,239,.569,136,237,.574,0,2,.000,68,107,.636,54,122,176,45,28,14,38,123,340,5.2
524,Jonas Jerebko\jerebjo01,2015-16,F,78,0,1176,118,286,.413,75,178,.421,43,108,.398,61,78,.782,77,211,288,62,20,24,52,137,340,3.5
525,Wesley Iwundu\iwundwe01,2018-19,F,68,13,1233,113,274,.412,84,195,.431,29,79,.367,84,103,.816,37,147,184,73,28,22,44,123,339,3.8
526,Stanley Johnson\johnsst04,2016-17,F,77,1,1371,129,365,.353,84,211,.398,45,154,.292,36,53,.679,36,153,189,105,56,24,71,121,339,2.9
527,Mirza Teletović\teletmi01,2014-15,F,40,4,892,122,319,.382,60,126,.476,62,193,.321,33,46,.717,27,167,194,46,14,16,53,74,339,5.1
528,Boris Diaw\diawbo01,2016-17,F-C,73,33,1283,146,327,.446,126,246,.512,20,81,.247,26,35,.743,46,112,158,170,18,9,87,83,338,3.5
529,Alfonzo McKinnie\mckinal01,2018-19,F,72,5,1003,134,275,.487,92,157,.586,42,118,.356,27,48,.563,81,166,247,31,18,15,30,134,337,3.7
530,Taurean Waller-Prince\princta02,2016-17,F,59,10,981,114,285,.400,81,183,.443,33,102,.324,74,94,.787,25,132,157,55,43,27,61,96,335,3.9
531,Ryan Kelly\kellyry01,2014-15,F,52,34,1233,104,309,.337,59,175,.337,45,134,.336,79,95,.832,13,133,146,92,30,24,37,118,332,4.4
532,Josh Smith\smithjo03,2015-16,F,55,7,880,127,349,.364,86,206,.417,41,143,.287,37,67,.552,51,141,192,90,34,47,77,118,332,3.8
533,Luke Babbitt\babbilu01,2015-16,F,47,13,845,122,289,.422,78,180,.433,44,109,.404,39,50,.780,25,123,148,53,11,7,23,90,327,4.6
534,Noah Vonleh\vonleno01,2016-17,F,74,41,1265,130,270,.481,123,250,.492,7,20,.350,60,94,.638,131,256,387,31,30,27,64,154,327,3.9
535,Anthony Tolliver\tollian01,2018-19,F-C,65,0,1079,99,259,.382,18,44,.409,81,215,.377,47,60,.783,15,162,177,46,17,21,36,91,326,3.5
536,Luke Babbitt\babbilu01,2016-17,F,68,55,1065,113,281,.402,26,71,.366,87,210,.414,11,15,.733,12,129,141,36,20,11,25,118,324,2.9
537,Kevin Garnett\garneke01,2014-15,F-C,47,47,952,143,306,.467,142,299,.475,1,7,.143,36,45,.800,48,263,311,77,46,17,46,109,323,6.3
538,Thon Maker\makerth01,2018-19,F-C,64,5,972,109,268,.407,60,115,.522,49,153,.320,56,84,.667,41,161,202,45,21,51,33,105,323,4.0
539,Damjan Rudež\rudezda01,2014-15,F,68,2,1047,119,263,.452,50,93,.538,69,170,.406,16,23,.696,8,39,47,53,16,5,47,79,323,2.6
540,Luke Kornet\kornelu01,2018-19,F,46,18,784,107,283,.378,37,90,.411,70,193,.363,38,46,.826,28,107,135,54,27,42,25,41,322,5.8
541,Danilo Gallinari\gallida01,2017-18,F,21,21,671,102,256,.398,66,145,.455,36,111,.324,81,87,.931,9,92,101,41,12,10,26,30,321,10.7
542,Charlie Villanueva\villach01,2015-16,F,62,4,665,125,327,.382,78,155,.503,47,172,.273,22,24,.917,24,128,152,24,18,15,31,71,319,2.9
543,Patrick Patterson\pattepa01,2017-18,F,82,3,1270,106,266,.398,40,95,.421,66,171,.386,40,46,.870,32,161,193,57,48,23,33,87,318,3.4
544,Mario Hezonja\hezonma01,2016-17,F-G,65,2,960,117,330,.355,74,186,.398,43,144,.299,40,50,.800,20,126,146,62,30,15,58,74,317,2.7
545,Cristiano Felício\feliccr01,2016-17,F-C,66,0,1040,128,221,.579,128,221,.579,0,0,,60,93,.645,124,187,311,40,25,17,33,110,316,5.0
546,David West\westda01,2016-17,F-C,68,0,854,135,252,.536,132,244,.541,3,8,.375,43,56,.768,47,156,203,151,42,48,78,105,316,4.8
547,Lavoy Allen\allenla01,2014-15,F-C,63,0,1070,141,299,.472,141,299,.472,0,0,,33,47,.702,123,200,323,73,15,42,40,102,315,5.0
548,James Ennis\ennisja01,2014-15,F,62,3,1051,101,247,.409,70,152,.461,31,95,.326,79,94,.840,51,125,176,48,25,17,39,89,312,3.9
549,Richaun Holmes\holmeri01,2017-18,F-C,48,2,746,135,241,.560,131,210,.624,4,31,.129,37,56,.661,57,154,211,61,20,29,25,97,311,6.1
550,Chris Copeland\copelch01,2014-15,F,50,12,828,112,310,.361,60,143,.420,52,167,.311,33,45,.733,23,88,111,51,11,11,59,78,309,2.8
551,Kyle O'Quinn\oquinky01,2015-16,F-C,65,1,764,129,271,.476,124,249,.498,5,22,.227,46,60,.767,76,174,250,72,20,49,61,107,309,4.2
552,Nemanja Bjelica\bjeline01,2015-16,F,60,0,1075,110,235,.468,62,110,.564,48,125,.384,40,55,.727,49,161,210,83,26,21,47,154,308,4.2
553,Cristiano Felício\feliccr01,2017-18,F-C,55,16,977,127,215,.591,127,213,.596,0,2,.000,54,81,.667,83,150,233,55,16,11,54,104,308,4.9
554,Jabari Parker\parkeja01,2014-15,F,25,25,738,129,263,.490,125,247,.506,4,16,.250,46,66,.697,50,88,138,42,31,5,47,42,308,9.2
555,Thomas Robinson\robinth01,2014-15,F,54,4,798,126,260,.485,126,258,.488,0,2,.000,56,106,.528,95,208,303,33,32,20,59,104,308,4.7
556,Quincy Acy\acyqu01,2015-16,F-C,59,29,876,119,214,.556,100,165,.606,19,49,.388,50,68,.735,65,123,188,27,29,24,27,103,307,4.7
557,Thomas Robinson\robinth01,2015-16,F,71,7,916,130,291,.447,130,290,.448,0,1,.000,47,109,.431,136,223,359,46,39,36,69,111,307,3.9
558,Tristan Thompson\thomptr01,2017-18,F-C,53,22,1072,132,235,.562,132,235,.562,0,0,,43,79,.544,126,226,352,33,16,17,36,102,307,5.9
559,Wilson Chandler\chandwi01,2018-19,F,51,33,1176,114,273,.418,55,115,.478,59,158,.373,18,25,.720,48,167,215,82,25,21,46,123,305,4.8
560,Juan Hernangómez\hernaju01,2016-17,F,62,9,842,101,224,.451,55,111,.495,46,113,.407,57,76,.750,43,144,187,29,30,12,31,62,305,4.1
561,Andrea Bargnani\bargnan01,2015-16,F-C,46,0,634,127,279,.455,124,263,.471,3,16,.188,47,57,.825,28,69,97,18,4,9,26,61,304,3.7
562,Derrick Williams\willide02,2016-17,F,50,11,804,108,244,.443,78,147,.531,30,97,.309,58,89,.652,19,111,130,28,14,7,28,60,304,3.9
563,Dāvis Bertāns\bertada01,2016-17,F,67,6,808,103,234,.440,34,61,.557,69,173,.399,28,34,.824,22,76,98,46,20,28,32,75,303,3.4
564,Sam Dekker\dekkesa01,2017-18,F,73,1,883,128,259,.494,118,199,.593,10,60,.167,37,56,.661,44,130,174,38,24,9,33,71,303,3.2
565,Omri Casspi\casspom01,2017-18,F,53,7,742,120,207,.580,110,185,.595,10,22,.455,50,69,.725,30,170,200,51,18,19,37,71,300,5.1
566,Amar'e Stoudemire\stoudam01,2015-16,F-C,52,36,762,125,221,.566,125,221,.566,0,0,,50,67,.746,65,157,222,27,18,41,47,92,300,5.1
567,Jonas Jerebko\jerebjo01,2016-17,F,78,6,1232,114,262,.435,69,132,.523,45,130,.346,26,37,.703,59,213,272,71,25,17,39,122,299,3.3
568,Timothé Luwawu-Cabarrot\luwawti01,2017-18,F,52,7,807,100,267,.375,47,109,.431,53,158,.335,46,58,.793,14,58,72,54,12,5,38,97,299,2.9
569,Anthony Bennett\bennean01,2014-15,F,57,3,894,125,297,.421,118,274,.431,7,23,.304,41,64,.641,52,164,216,48,27,16,36,87,298,3.8
570,Lance Thomas\thomala01,2017-18,F,73,31,1353,102,267,.382,52,143,.364,50,124,.403,44,53,.830,44,131,175,44,30,14,40,134,298,2.7
571,Glen Davis\davisgl01,2014-15,F-C,74,0,904,117,255,.459,117,251,.466,0,4,.000,60,95,.632,43,126,169,39,41,21,39,132,294,2.8
572,Kyle O'Quinn\oquinky01,2014-15,F-C,51,17,824,119,242,.492,107,199,.538,12,43,.279,44,57,.772,46,153,199,59,31,39,55,110,294,4.8
573,Brandon Bass\bassbr01,2016-17,F,52,0,577,107,186,.575,106,183,.579,1,3,.333,77,88,.875,43,86,129,21,14,11,29,45,292,4.7
574,Skal Labissière\labissk01,2016-17,F,33,12,612,117,218,.537,114,210,.543,3,8,.375,52,74,.703,51,111,162,27,16,13,37,64,289,6.8
575,Sam Dekker\dekkesa01,2018-19,F,47,5,789,120,256,.469,101,194,.521,19,62,.306,28,46,.609,53,95,148,46,38,7,24,47,287,5.2
576,Jared Dudley\dudleja01,2018-19,F-G,59,25,1220,101,239,.423,48,88,.545,53,151,.351,32,46,.696,34,121,155,83,36,16,43,131,287,3.8
577,Richaun Holmes\holmeri01,2015-16,F-C,51,1,702,114,222,.514,106,178,.596,8,44,.182,51,74,.689,62,73,135,33,19,40,32,92,287,4.6
578,James Johnson\johnsja01,2015-16,F,57,32,926,114,240,.475,94,174,.540,20,66,.303,39,68,.574,28,98,126,67,29,33,54,84,287,3.7
579,DeMarre Carroll\carrode01,2015-16,F,26,22,786,105,270,.389,59,152,.388,46,118,.390,30,50,.600,31,91,122,27,44,6,28,63,286,7.5
580,Jon Leuer\leuerjo01,2014-15,F,63,6,824,121,273,.443,114,244,.467,7,29,.241,37,59,.627,50,157,207,46,17,9,35,86,286,3.2
581,Chandler Parsons\parsoch01,2017-18,F,36,8,691,108,234,.462,57,113,.504,51,121,.421,17,27,.630,14,76,90,69,18,11,35,53,284,5.8
582,Ivan Rabb\rabbiv01,2018-19,F,49,13,721,116,212,.547,113,197,.574,3,15,.200,49,69,.710,70,136,206,54,17,14,35,90,284,5.3
583,Noah Vonleh\vonleno01,2015-16,F,78,56,1174,117,278,.421,106,232,.457,11,46,.239,38,51,.745,91,214,305,30,27,26,50,152,283,2.7
584,Bruno Caboclo\cabocbr01,2018-19,F,34,19,800,96,225,.427,48,95,.505,48,130,.369,42,50,.840,42,116,158,50,14,33,38,81,282,6.6
585,D.J. Wilson\wilsodj01,2018-19,F,48,3,882,104,251,.414,58,124,.468,46,127,.362,26,47,.553,45,177,222,52,18,20,32,85,280,4.7
586,Drew Gooden\goodedr01,2014-15,F,51,7,864,110,276,.399,87,217,.401,23,59,.390,34,44,.773,72,151,223,49,21,9,28,91,277,4.2
587,Shawn Marion\mariosh01,2014-15,F,57,24,1101,119,267,.446,107,221,.484,12,46,.261,26,34,.765,64,138,202,51,27,27,33,58,276,4.3
588,Mike Dunleavy\dunlemi02,2016-17,F-G,53,2,841,93,220,.423,40,86,.465,53,134,.396,36,45,.800,18,97,115,50,15,7,28,67,275,3.7
589,Lance Thomas\thomala01,2016-17,F,46,15,968,97,244,.398,59,159,.371,38,85,.447,43,51,.843,32,110,142,35,21,5,25,85,275,4.0
590,Nick Collison\collini01,2014-15,F,66,2,1101,106,253,.419,90,193,.466,16,60,.267,45,65,.692,90,160,250,90,35,25,45,156,273,3.8
591,Omari Spellman\spellom01,2018-19,F,46,11,805,98,244,.402,54,116,.466,44,128,.344,32,45,.711,72,122,194,47,26,25,31,67,272,5.2
592,Chase Budinger\budinch01,2015-16,F,66,2,930,104,239,.435,80,153,.523,24,86,.279,39,56,.696,43,107,150,64,32,10,44,62,271,3.3
593,Tyler Hansbrough\hansbty01,2014-15,F,74,8,1058,86,165,.521,85,158,.538,1,7,.143,97,139,.698,106,159,265,21,30,15,20,141,270,3.7
594,Kevon Looney\looneke01,2017-18,F-C,66,4,910,112,193,.580,111,188,.590,1,5,.200,42,77,.545,83,132,215,42,34,56,31,106,267,4.4
595,Matt Bonner\bonnema01,2014-15,F,72,19,935,94,230,.409,48,104,.462,46,126,.365,30,37,.811,29,86,115,47,10,12,11,65,264,2.8
596,Noah Vonleh\vonleno01,2017-18,F,54,16,876,104,234,.444,84,168,.500,20,66,.303,36,58,.621,70,241,311,34,19,17,31,68,264,4.6
597,Darrell Arthur\arthuda01,2016-17,F,41,7,639,95,215,.442,42,98,.429,53,117,.453,19,22,.864,25,87,112,42,19,21,36,76,262,4.6
598,Jordan Bell\belljo01,2017-18,F,57,13,809,116,185,.627,116,181,.641,0,4,.000,30,44,.682,60,147,207,102,35,56,51,92,262,5.6
599,Udonis Haslem\hasleud01,2014-15,F-C,62,25,995,107,239,.448,105,229,.459,2,10,.200,45,64,.703,71,187,258,46,21,13,41,113,261,3.4
600,Lou Amundson\amundlo01,2014-15,F-C,53,35,937,109,255,.427,109,254,.429,0,1,.000,41,87,.471,94,174,268,70,22,52,62,126,259,4.1
601,Luke Babbitt\babbilu01,2017-18,F,50,14,715,91,215,.423,31,59,.525,60,156,.385,17,22,.773,7,89,96,31,8,7,19,54,259,3.4
602,Kris Humphries\humphkr01,2016-17,F-C,56,4,689,87,214,.407,68,160,.425,19,54,.352,64,82,.780,60,146,206,29,15,21,28,69,257,3.8
603,Luke Babbitt\babbilu01,2014-15,F,63,19,830,92,192,.479,33,77,.429,59,115,.513,13,19,.684,12,99,111,24,17,11,26,63,256,2.9
604,Michael Beasley\beaslmi01,2015-16,F,20,0,363,107,205,.522,104,196,.531,3,9,.333,38,49,.776,29,69,98,16,11,9,24,39,255,9.0
605,Anderson Varejão\varejan01,2014-15,F-C,26,26,636,111,200,.555,111,198,.561,0,2,.000,33,45,.733,57,113,170,35,19,16,35,58,255,8.7
606,Cheick Diallo\diallch01,2017-18,F,52,0,581,102,176,.580,102,176,.580,0,0,,50,66,.758,47,164,211,19,11,21,28,82,254,4.3
607,Justin Holiday\holidju01,2014-15,F,59,4,657,91,235,.387,56,126,.444,35,109,.321,37,45,.822,12,61,73,48,40,12,29,54,254,3.1
608,James Jones\jonesja02,2014-15,F-G,57,2,669,74,201,.368,11,26,.423,63,175,.360,39,46,.848,9,53,62,24,13,8,13,67,250,2.7
609,Kyle Anderson\anderky01,2016-17,F-G,72,14,1020,93,209,.445,78,169,.462,15,40,.375,45,57,.789,33,175,208,91,51,26,39,63,246,3.8
610,Solomon Hill\hillso01,2015-16,F,59,3,866,93,208,.447,69,134,.515,24,74,.324,36,42,.857,39,127,166,57,37,11,33,68,246,3.8
611,T.J. Warren\warretj01,2014-15,F,40,1,614,113,214,.528,108,193,.560,5,21,.238,14,19,.737,41,44,85,25,18,9,27,51,245,4.4
612,Aaron Gordon\gordoaa01,2014-15,F,47,8,797,93,208,.447,80,160,.500,13,48,.271,44,61,.721,46,123,169,33,21,22,38,83,243,3.9
613,Abdel Nader\naderab01,2018-19,F,61,1,694,91,215,.423,59,115,.513,32,100,.320,27,36,.750,14,102,116,20,20,12,26,68,241,2.5
614,Thomas Robinson\robinth01,2016-17,F,48,1,560,105,196,.536,105,195,.538,0,1,.000,31,66,.470,84,139,223,31,26,9,46,76,241,4.4
615,Cristiano Felício\feliccr01,2018-19,F-C,60,0,746,95,179,.531,95,175,.543,0,4,.000,50,73,.685,79,139,218,37,11,7,33,69,240,3.7
616,Justin Holiday\holidju01,2015-16,F,53,5,773,88,228,.386,52,123,.423,36,105,.343,27,37,.730,12,78,90,56,32,19,39,61,239,3.1
617,Cedi Osman\osmande01,2017-18,F,61,12,672,90,186,.484,58,99,.586,32,87,.368,26,46,.565,19,101,120,41,22,3,32,78,238,2.8
618,Kelly Oubre\oubreke01,2015-16,F,63,9,671,90,211,.427,65,132,.492,25,79,.316,31,49,.633,25,108,133,13,22,7,34,100,236,2.0
619,Georges Niang\niangge01,2018-19,F,59,0,516,86,181,.475,43,76,.566,43,105,.410,20,24,.833,11,76,87,35,10,6,23,57,235,2.8
620,Kevin Séraphin\serapke01,2016-17,F,49,3,559,109,198,.551,109,196,.556,0,2,.000,14,22,.636,41,101,142,23,7,20,29,66,232,3.6
621,Hedo Türkoğlu\turkohe01,2014-15,F,62,2,705,83,188,.441,23,49,.469,60,139,.432,6,11,.545,5,94,99,37,19,7,29,66,232,2.5
622,Timothé Luwawu-Cabarrot\luwawti01,2018-19,F,50,7,669,82,218,.376,46,102,.451,36,116,.310,31,41,.756,11,86,97,26,19,8,21,73,231,2.7
623,Luc Mbah a Moute\mbahalu01,2015-16,F,75,61,1274,94,207,.454,81,167,.485,13,40,.325,30,57,.526,60,111,171,30,44,19,34,100,231,2.6
624,Kyle Singler\singlky01,2015-16,F,68,2,977,86,221,.389,56,124,.452,30,97,.309,29,44,.659,50,91,141,24,30,9,32,120,231,2.1
625,Dragan Bender\bendedr01,2018-19,F,46,27,826,88,197,.447,66,96,.688,22,101,.218,32,54,.593,34,149,183,56,18,22,37,90,230,4.1
626,Donatas Motiejūnas\motiedo01,2015-16,F-C,37,22,547,90,205,.439,74,148,.500,16,57,.281,34,53,.642,37,72,109,41,17,5,44,69,230,3.8
627,Wesley Iwundu\iwundwe01,2017-18,F,62,12,1020,93,218,.427,84,172,.488,9,46,.196,34,47,.723,36,101,137,57,33,12,30,81,229,2.9
628,Patrick Patterson\pattepa01,2018-19,F,63,5,861,82,219,.374,36,82,.439,46,137,.336,19,30,.633,42,105,147,31,16,13,22,46,229,2.7
629,Pascal Siakam\siakapa01,2016-17,F,55,38,859,103,205,.502,102,198,.515,1,7,.143,22,32,.688,64,121,185,17,26,45,33,109,229,3.6
630,Omri Casspi\casspom01,2018-19,F,36,0,520,86,161,.534,71,118,.602,15,43,.349,39,58,.672,17,98,115,26,20,9,23,35,226,5.2
631,Thon Maker\makerth01,2016-17,F-C,57,34,562,83,181,.459,55,107,.514,28,74,.378,32,49,.653,40,74,114,23,10,26,17,84,226,3.0
632,T.J. Leaf\leaftj01,2018-19,F,58,1,522,99,183,.541,91,152,.599,8,31,.258,19,31,.613,43,82,125,24,9,19,12,35,225,3.4
633,Jordan Bell\belljo01,2018-19,F,68,3,788,99,192,.516,99,190,.521,0,2,.000,25,41,.610,55,129,184,76,20,51,42,80,223,3.4
634,Quincy Acy\acyqu01,2016-17,F-C,38,1,558,70,170,.412,33,80,.413,37,90,.411,45,60,.750,20,95,115,18,14,15,21,67,222,4.1
635,Mike Dunleavy\dunlemi02,2015-16,F-G,31,30,703,77,188,.410,38,89,.427,39,99,.394,29,37,.784,8,75,83,39,14,10,26,66,222,4.6
636,Tayshaun Prince\princta01,2015-16,F,77,44,1462,102,229,.445,98,206,.476,4,23,.174,13,19,.684,32,115,147,73,36,13,27,62,221,2.6
637,Dorell Wright\wrighdo01,2014-15,F-G,48,2,592,72,190,.379,31,82,.378,41,108,.380,34,42,.810,14,97,111,41,20,11,18,55,219,3.5
638,Shabazz Muhammad\muhamsh01,2017-18,F-G,43,2,418,84,188,.447,77,161,.478,7,27,.259,39,50,.780,23,53,76,14,9,3,6,30,214,3.4
639,Adreian Payne\paynead01,2014-15,F-C,32,22,740,91,220,.414,90,211,.427,1,9,.111,30,46,.652,48,114,162,30,19,9,44,88,213,3.9
640,Michael Beasley\beaslmi01,2014-15,F,24,1,505,92,212,.434,84,178,.472,8,34,.235,20,26,.769,12,77,89,32,15,13,37,66,212,4.7
641,Cleanthony Early\earlycl01,2014-15,F,39,7,647,76,214,.355,54,130,.415,22,84,.262,36,48,.750,22,75,97,36,24,12,40,57,210,3.0
642,Chandler Parsons\parsoch01,2016-17,F,34,34,675,75,222,.338,50,129,.388,25,93,.269,35,43,.814,6,78,84,55,20,5,24,52,210,3.7
643,Terrence Ross\rosste01,2017-18,F-G,24,20,600,76,191,.398,46,98,.469,30,93,.323,27,36,.750,10,63,73,38,27,11,29,45,209,5.9
644,Jonah Bolden\boldejo01,2018-19,F,44,10,639,80,162,.494,46,66,.697,34,96,.354,13,27,.481,47,118,165,40,17,39,36,99,207,4.2
645,Moritz Wagner\wagnemo01,2018-19,F-C,43,5,446,71,171,.415,49,94,.521,22,77,.286,43,53,.811,17,68,85,24,11,13,39,57,207,2.8
646,J.J. Hickson\hicksjj01,2015-16,F-C,35,9,437,80,155,.516,80,154,.519,0,1,.000,46,103,.447,39,93,132,23,15,14,25,47,206,4.5
647,Chris Johnson\johnsch04,2015-16,F-G,70,2,857,72,194,.371,45,95,.474,27,99,.273,34,42,.810,27,105,132,45,32,20,40,100,205,2.0
648,Lance Thomas\thomala01,2018-19,F,46,17,783,78,197,.396,56,118,.475,22,79,.278,27,36,.750,21,96,117,27,17,7,24,83,205,2.6
649,Jason Maxiell\maxieja01,2014-15,F,61,0,878,81,192,.422,81,192,.422,0,0,,41,71,.577,86,117,203,19,18,44,29,96,203,2.9
650,Amir Johnson\johnsam01,2018-19,F-C,51,6,529,79,157,.503,67,117,.573,12,40,.300,31,41,.756,47,100,147,60,16,13,45,99,201,3.2
651,Mitch McGary\mcgarmi01,2014-15,F-C,32,2,485,88,165,.533,88,163,.540,0,2,.000,25,40,.625,53,112,165,14,16,16,31,72,201,5.1
652,Ivan Rabb\rabbiv01,2017-18,F,36,5,516,86,152,.566,86,152,.566,0,0,,29,36,.806,53,105,158,32,12,13,35,55,201,5.0
653,Tiago Splitter\splitti01,2015-16,F-C,36,2,579,81,155,.523,81,153,.529,0,2,.000,39,48,.813,45,75,120,30,20,12,24,71,201,4.8
654,Ed Davis\davised01,2016-17,F,46,12,789,75,142,.528,75,142,.528,0,0,,50,81,.617,96,148,244,26,15,22,37,137,200,4.1
655,Johnny O'Bryant\obryajo01,2015-16,F-C,66,4,857,86,209,.411,85,208,.409,1,1,1.000,27,40,.675,65,111,176,32,18,8,31,100,200,2.1
656,Travis Wear\weartr01,2014-15,F,51,1,672,84,209,.402,73,179,.408,11,30,.367,20,26,.769,31,75,106,40,15,11,35,55,199,2.4
657,Robbie Hummel\hummero01,2014-15,F,45,4,742,79,172,.459,63,121,.521,16,51,.314,24,29,.828,31,103,134,27,16,9,18,86,198,3.3
658,Mike Muscala\muscami01,2014-15,F-C,40,8,502,83,151,.550,74,129,.574,9,22,.409,22,25,.880,52,67,119,25,16,19,21,52,197,4.6
659,Justise Winslow\winslju01,2016-17,F,18,15,625,80,225,.356,73,190,.384,7,35,.200,29,47,.617,23,71,94,66,26,6,33,52,196,6.9
660,Mike Muscala\muscami01,2015-16,F-C,60,0,565,76,152,.500,64,113,.566,12,39,.308,31,39,.795,38,79,117,34,13,27,27,72,195,2.8
661,Semi Ojeleye\ojelese01,2017-18,F,73,0,1150,65,188,.346,25,63,.397,40,125,.320,25,41,.610,37,124,161,20,21,4,25,91,195,1.7
662,Willie Reed\reedwi02,2017-18,F-C,42,5,428,81,121,.669,80,119,.672,1,2,.500,32,55,.582,35,86,121,10,9,22,19,56,195,4.1
663,Dante Cunningham\cunnida01,2018-19,F,64,21,928,75,158,.475,45,93,.484,30,65,.462,14,18,.778,48,140,188,50,27,13,22,71,194,3.3
664,Andrew Nicholson\nichoan01,2014-15,F,40,3,492,83,190,.437,70,149,.470,13,41,.317,15,25,.600,17,65,82,22,6,12,24,51,194,2.7
665,Solomon Hill\hillso01,2018-19,F,44,15,878,68,178,.382,36,77,.468,32,101,.317,23,32,.719,34,99,133,55,23,10,31,80,191,3.4
666,Brandan Wright\wrighbr03,2016-17,F-C,28,5,447,83,135,.615,83,134,.619,0,1,.000,23,35,.657,31,47,78,15,11,20,10,42,189,6.0
667,Kenneth Faried\farieke01,2017-18,F,32,7,461,76,148,.514,76,147,.517,0,1,.000,36,51,.706,68,85,153,18,12,13,23,51,188,5.4
668,Danny Granger\grangda01,2014-15,F,30,6,613,65,162,.401,35,78,.449,30,84,.357,28,37,.757,20,60,80,17,13,6,24,67,188,3.6
669,Chandler Parsons\parsoch01,2018-19,F,25,3,496,68,182,.374,39,88,.443,29,94,.309,22,25,.880,4,66,70,43,19,5,32,45,187,4.4
670,Kevin Séraphin\serapke01,2015-16,F,48,0,526,84,205,.410,84,203,.414,0,2,.000,19,23,.826,31,95,126,47,8,36,43,67,187,2.5
671,Omri Casspi\casspom01,2016-17,F,36,2,642,77,164,.470,62,121,.512,15,43,.349,17,29,.586,27,85,112,37,23,3,29,50,186,4.0
672,Wesley Johnson\johnswe01,2016-17,F-G,68,3,810,73,200,.365,44,82,.537,29,118,.246,11,17,.647,26,155,181,23,29,30,18,83,186,2.2
673,Semi Ojeleye\ojelese01,2018-19,F,56,3,594,67,158,.424,39,69,.565,28,89,.315,24,39,.615,24,62,86,23,10,4,19,43,186,2.2
674,Troy Williams\willitr02,2016-17,F,30,16,557,73,167,.437,55,105,.524,18,62,.290,21,32,.656,15,54,69,25,27,10,32,60,185,3.8
675,Joey Dorsey\dorsejo01,2014-15,F,69,17,854,80,145,.552,80,144,.556,0,1,.000,24,83,.289,103,176,279,25,40,25,41,157,184,2.7
676,Perry Jones\jonespe01,2014-15,F,43,13,631,73,184,.397,59,124,.476,14,60,.233,24,37,.649,6,70,76,18,17,8,24,50,184,2.2
677,Luis Scola\scolalu01,2016-17,F,36,1,461,71,151,.470,54,101,.535,17,50,.340,25,37,.676,51,88,139,37,14,4,34,63,184,4.1
678,Tyler Cavanaugh\cavanty01,2017-18,F,39,1,518,67,152,.441,35,63,.556,32,89,.360,17,21,.810,45,82,127,27,9,4,14,61,183,3.9
679,Cory Jefferson\jeffeco01,2014-15,F,50,1,531,75,167,.449,73,152,.480,2,15,.133,31,54,.574,47,98,145,16,10,21,20,61,183,2.8
680,Marquese Chriss\chrisma01,2018-19,F,43,2,499,67,180,.372,51,108,.472,16,72,.222,32,45,.711,40,102,142,22,17,11,36,81,182,2.5
681,Kostas Papanikolaou\papanko01,2014-15,F,43,1,795,69,197,.350,38,91,.418,31,106,.292,13,18,.722,39,79,118,85,29,13,55,71,182,3.1
682,Willie Reed\reedwi02,2015-16,F-C,39,2,426,76,133,.571,76,133,.571,0,0,,30,55,.545,49,73,122,10,6,30,16,47,182,4.2
683,Michael Beasley\beaslmi01,2018-19,F,26,2,277,75,153,.490,72,136,.529,3,17,.176,28,39,.718,13,47,60,25,9,10,27,42,181,4.3
684,James Jones\jonesja02,2015-16,F-G,48,0,463,58,142,.408,17,38,.447,41,104,.394,21,26,.808,8,42,50,14,11,10,13,50,178,2.4
685,Tyler Zeller\zellety01,2016-17,F-C,51,5,525,78,158,.494,78,157,.497,0,1,.000,22,39,.564,43,81,124,42,7,21,20,61,178,3.0
686,Lavoy Allen\allenla01,2016-17,F-C,61,5,871,77,168,.458,77,167,.461,0,1,.000,23,33,.697,105,114,219,57,18,24,29,78,177,3.4
687,Reggie Evans\evansre01,2014-15,F,47,7,764,58,137,.423,58,135,.430,0,2,.000,60,97,.619,97,202,299,32,22,5,45,91,176,3.9
688,Metta World Peace\artesro01,2015-16,F,35,5,590,55,177,.311,29,93,.312,26,84,.310,40,57,.702,19,70,89,27,22,11,15,67,176,3.1
689,Henry Walker\walkebi01,2014-15,F,24,13,628,58,168,.345,13,36,.361,45,132,.341,14,18,.778,7,75,82,29,24,9,24,76,175,4.3
690,Christian Wood\woodch01,2018-19,F,21,2,250,61,117,.521,52,91,.571,9,26,.346,41,56,.732,17,66,83,8,7,10,17,17,172,6.5
691,Johnny O'Bryant\obryajo01,2017-18,F-C,36,0,379,68,171,.398,54,128,.422,14,43,.326,21,25,.840,29,64,93,14,9,6,15,45,171,3.0
692,Joel Freeland\freeljo01,2014-15,F-C,48,8,617,74,151,.490,74,151,.490,0,0,,21,25,.840,62,129,191,16,9,23,23,93,169,3.1
693,Derrick Jones\jonesde02,2016-17,F,32,8,545,68,121,.562,65,110,.591,3,11,.273,29,41,.707,39,40,79,12,14,13,13,63,168,4.3
694,Ryan Broekhoff\broekry01,2018-19,F,42,0,453,57,126,.452,19,33,.576,38,93,.409,15,19,.789,8,55,63,22,6,4,16,35,167,2.8
695,Rondae Hollis-Jefferson\holliro01,2015-16,F,29,17,615,63,138,.457,59,124,.476,4,14,.286,37,52,.712,39,115,154,43,39,16,26,61,167,6.3
696,Chris Johnson\johnsch04,2014-15,F-G,29,2,527,62,154,.403,34,59,.576,28,95,.295,14,16,.875,8,47,55,15,26,7,15,44,166,3.8
697,Jarell Martin\martija01,2016-17,F,42,3,558,58,151,.384,49,126,.389,9,25,.360,40,50,.800,42,120,162,8,17,9,28,91,165,2.6
698,James Ennis\ennisja01,2015-16,F,22,5,329,54,113,.478,28,55,.509,26,58,.448,25,34,.735,21,21,42,21,16,5,19,28,159,5.6
699,Josh Huestis\huestjo01,2017-18,F,69,10,982,60,182,.330,27,67,.403,33,115,.287,6,20,.300,42,119,161,20,15,43,26,82,159,1.7
700,Maurice Harkless\harklma01,2014-15,F-G,45,4,674,63,158,.399,53,102,.520,10,56,.179,22,41,.537,38,68,106,25,32,9,27,66,158,2.5
701,Luol Deng\denglu01,2018-19,F,22,2,392,59,118,.500,45,74,.608,14,44,.318,25,35,.714,20,53,73,18,15,8,14,24,157,6.1
702,Johnathan Williams\willijo04,2018-19,F,24,0,372,65,110,.591,65,108,.602,0,2,.000,27,48,.563,48,51,99,13,8,7,16,62,157,5.3
703,T.J. Leaf\leaftj01,2017-18,F,53,0,459,64,136,.471,46,94,.489,18,42,.429,10,16,.625,29,53,82,9,5,4,10,45,156,2.0
704,Jon Leuer\leuerjo01,2018-19,F,41,1,402,66,113,.584,65,102,.637,1,11,.091,23,31,.742,27,70,97,14,12,4,23,60,156,2.9
705,Kyle O'Quinn\oquinky01,2018-19,F-C,45,3,371,69,136,.507,68,124,.548,1,12,.083,17,21,.810,29,90,119,56,9,25,31,68,156,3.1
706,Jarell Martin\martija01,2015-16,F,27,0,380,54,116,.466,54,114,.474,0,2,.000,45,62,.726,39,47,86,15,8,7,19,58,153,4.0
707,Jared Dudley\dudleja01,2017-18,F-G,48,0,686,48,122,.393,19,42,.452,29,80,.363,27,35,.771,8,86,94,78,24,11,28,85,152,2.9
708,Ryan Kelly\kellyry01,2015-16,F,36,0,470,55,149,.369,50,112,.446,5,37,.135,37,54,.685,21,100,121,20,13,10,18,39,152,3.0
709,Keita Bates-Diop\bateske01,2018-19,F,30,3,503,60,142,.423,47,90,.522,13,52,.250,18,28,.643,16,67,83,17,18,14,14,29,151,3.9
710,Corey Brewer\breweco01,2018-19,F-G,31,3,492,53,123,.431,39,79,.494,14,44,.318,31,43,.721,26,50,76,39,32,7,19,63,151,4.3
711,Henry Ellenson\ellenhe01,2017-18,F,38,0,329,53,146,.363,33,86,.384,20,60,.333,25,29,.862,10,71,81,20,5,0,18,22,151,2.3
712,Nenê Hilário\hilarne01,2018-19,F-C,42,2,546,60,116,.517,60,113,.531,0,3,.000,31,47,.660,34,89,123,26,18,15,11,87,151,3.3
713,Josh McRoberts\mcrobjo01,2015-16,F,42,1,595,55,148,.372,43,99,.434,12,49,.245,28,40,.700,22,83,105,81,18,7,30,68,150,3.0
714,Donatas Motiejūnas\motiedo01,2016-17,F-C,34,0,479,57,138,.413,46,91,.505,11,47,.234,25,49,.510,26,75,101,32,18,11,31,55,150,3.0
715,Gary Clark\clarkga01,2018-19,F,51,2,641,50,151,.331,9,13,.692,41,138,.297,7,7,1.000,24,92,116,18,20,26,7,47,148,2.6
716,James Michael McAdoo\mcadoja01,2016-17,F,52,2,457,62,117,.530,60,109,.550,2,8,.250,21,42,.500,34,57,91,18,18,29,19,47,147,2.6
717,Jason Thompson\thompja02,2015-16,F-C,47,7,471,52,108,.481,47,93,.505,5,15,.333,38,54,.704,32,102,134,29,12,20,15,80,147,2.9
718,Dragan Bender\bendedr01,2016-17,F,43,0,574,57,161,.354,29,60,.483,28,101,.277,4,11,.364,23,80,103,23,10,22,32,74,146,1.7
719,Kawhi Leonard\leonaka01,2017-18,F,9,9,210,52,111,.468,41,76,.539,11,35,.314,31,38,.816,6,36,42,21,18,9,16,9,146,13.4
720,Abdel Nader\naderab01,2017-18,F,48,1,522,50,149,.336,27,84,.321,23,65,.354,23,39,.590,13,58,71,26,15,10,34,45,146,1.5
721,Jonathan Isaac\isaacjo01,2017-18,F,27,10,536,55,145,.379,39,99,.394,16,46,.348,19,25,.760,16,83,99,18,33,30,27,48,145,4.4
722,Eric Moreland\moreler01,2017-18,F-C,67,3,805,66,122,.541,66,122,.541,0,0,,11,29,.379,81,197,278,78,31,51,42,116,143,3.4
723,Brandon Davies\daviebr01,2014-15,F,27,6,423,55,137,.401,47,103,.456,8,34,.235,24,37,.649,38,45,83,30,18,7,29,59,142,3.5
724,Montrezl Harrell\harremo01,2015-16,F-C,39,1,379,58,90,.644,58,89,.652,0,1,.000,24,46,.522,25,40,65,17,11,11,17,48,140,3.0
725,Brandan Wright\wrighbr03,2017-18,F-C,28,1,381,59,102,.578,59,102,.578,0,0,,21,33,.636,33,62,95,13,13,26,8,32,139,5.3
726,Anderson Varejão\varejan01,2015-16,F-C,53,0,496,53,124,.427,53,123,.431,0,1,.000,32,50,.640,37,104,141,35,16,10,22,70,138,2.3
727,Jeff Ayres\pendeje02,2014-15,F,51,0,383,55,95,.579,55,95,.579,0,0,,27,36,.750,37,80,117,14,8,8,26,60,137,2.2
728,DeAndre' Bembry\bembrde01,2017-18,F,26,3,455,53,128,.414,42,98,.429,11,30,.367,19,33,.576,8,64,72,49,21,12,47,38,136,3.4
729,Dillon Brooks\brookdi01,2018-19,F-G,18,0,330,49,122,.402,34,82,.415,15,40,.375,22,30,.733,9,22,31,16,10,4,19,50,135,3.6
730,Kevon Looney\looneke01,2016-17,F-C,53,4,447,56,107,.523,54,98,.551,2,9,.222,21,34,.618,44,80,124,29,15,17,17,64,135,2.6
731,Carmelo Anthony\anthoca01,2018-19,F,10,2,294,49,121,.405,28,57,.491,21,64,.328,15,22,.682,9,45,54,5,4,7,8,32,134,7.8
732,Luke Kornet\kornelu01,2017-18,F,20,1,326,49,125,.392,21,46,.457,28,79,.354,8,11,.727,11,53,64,26,6,16,12,28,134,5.0
733,Troy Williams\willitr02,2017-18,F,21,1,307,51,109,.468,40,71,.563,11,38,.289,20,30,.667,22,41,63,16,20,4,19,34,133,4.9
734,James Jones\jonesja02,2016-17,F-G,48,2,381,44,92,.478,13,26,.500,31,66,.470,13,20,.650,3,34,37,14,6,10,10,37,132,1.9
735,Adreian Payne\paynead01,2015-16,F-C,52,2,486,53,145,.366,44,113,.389,9,32,.281,17,26,.654,20,91,111,29,16,11,36,77,132,1.3
736,Damian Jones\jonesda03,2018-19,F-C,24,22,410,53,74,.716,53,74,.716,0,0,,24,37,.649,31,44,75,28,12,25,16,63,130,5.7
737,Austin Daye\dayeau01,2014-15,F,34,4,344,50,141,.355,26,70,.371,24,71,.338,5,6,.833,10,65,75,17,12,5,23,39,129,1.9
738,Wesley Johnson\johnswe01,2018-19,F-G,38,13,534,45,128,.352,20,52,.385,25,76,.329,13,19,.684,12,60,72,23,14,12,18,63,128,2.0
739,Jeffery Taylor\tayloje03,2014-15,F,29,13,430,45,114,.395,34,78,.436,11,36,.306,26,41,.634,14,39,53,22,12,1,19,36,127,2.6
740,Rasual Butler\butlera01,2015-16,F-G,46,0,432,49,104,.471,34,55,.618,15,49,.306,11,16,.688,3,53,56,24,13,23,8,11,124,2.6
741,Nick Collison\collini01,2015-16,F,59,4,699,50,109,.459,50,107,.467,0,2,.000,23,33,.697,68,103,171,52,15,16,50,107,123,1.9
742,Dorian Finney-Smith\finnedo01,2017-18,F,21,13,448,46,121,.380,26,54,.481,20,67,.299,11,15,.733,22,53,75,26,10,4,21,43,123,3.8
743,Kevin Garnett\garneke01,2015-16,F-C,38,38,556,54,115,.470,54,114,.474,0,1,.000,14,21,.667,15,135,150,62,28,10,16,70,122,3.8
744,Ante Žižić\zizican01,2017-18,F-C,32,2,214,49,67,.731,49,67,.731,0,0,,21,29,.724,24,36,60,5,2,13,11,30,119,3.4
745,Pau Gasol\gasolpa01,2018-19,F-C,30,6,361,42,94,.447,36,81,.444,6,13,.462,28,40,.700,22,115,137,52,5,15,16,29,118,4.6
746,James Michael McAdoo\mcadoja01,2015-16,F,41,1,262,45,84,.536,44,82,.537,1,2,.500,26,49,.531,30,28,58,17,10,8,16,39,117,2.3
747,Anthony Bennett\bennean01,2016-17,F,23,1,264,38,92,.413,25,44,.568,13,48,.271,26,36,.722,25,53,78,12,5,3,12,18,115,4.0
748,Anthony Brown\brownan02,2015-16,F-G,29,11,599,39,126,.310,19,56,.339,20,70,.286,17,20,.850,9,61,70,19,14,5,15,34,115,2.3
749,Jarell Martin\martija01,2018-19,F,42,1,328,43,104,.413,23,47,.489,20,57,.351,9,11,.818,11,62,73,18,3,8,11,51,115,1.8
750,Jaron Blossomgame\blossja01,2018-19,F,27,4,439,47,106,.443,37,67,.552,10,39,.256,10,13,.769,26,72,98,13,7,8,11,20,114,3.7
751,Henry Ellenson\ellenhe01,2018-19,F,19,0,259,39,95,.411,22,57,.386,17,38,.447,19,25,.760,5,61,66,16,7,2,9,27,114,4.3
752,Jason Smith\smithja02,2017-18,F-C,33,2,285,45,115,.391,41,83,.494,4,32,.125,19,21,.905,18,35,53,14,3,13,16,44,113,1.9
753,Chris McCullough\mcculch01,2015-16,F,24,4,362,44,109,.404,31,75,.413,13,34,.382,11,23,.478,25,43,68,9,28,12,15,39,112,3.8
754,Troy Williams\willitr02,2018-19,F,21,0,312,44,98,.449,30,54,.556,14,44,.318,9,15,.600,12,47,59,11,10,8,9,37,111,3.8
755,Doug McDermott\mcderdo01,2014-15,F,36,0,321,43,107,.402,30,66,.455,13,41,.317,10,15,.667,6,37,43,6,4,1,17,29,109,1.2
756,Mike Miller\millemi01,2014-15,F-G,52,15,701,37,114,.325,5,16,.313,32,98,.327,3,4,.750,4,87,91,46,14,4,23,74,109,1.3
757,Myke Henry\henrymy01,2017-18,F,20,0,378,41,109,.376,22,51,.431,19,58,.328,6,10,.600,10,28,38,22,31,6,19,28,107,4.1
758,Josh McRoberts\mcrobjo01,2016-17,F,22,14,381,44,118,.373,31,87,.356,13,31,.419,6,9,.667,23,51,74,50,10,4,23,31,107,3.8
759,Alex Poythress\poythal01,2018-19,F,21,1,305,40,81,.494,31,58,.534,9,23,.391,18,29,.621,29,47,76,17,4,10,13,47,107,4.2
760,Luigi Datome\datomlu01,2014-15,F,21,1,209,43,89,.483,25,49,.510,18,40,.450,1,1,1.000,3,26,29,9,2,7,9,15,105,3.2
761,Cristiano Felício\feliccr01,2015-16,F-C,31,4,321,40,72,.556,40,68,.588,0,4,.000,25,35,.714,30,72,102,26,6,13,13,31,105,3.8
762,Jamil Wilson\wilsoja02,2017-18,F,15,10,274,38,81,.469,11,18,.611,27,63,.429,2,4,.500,3,29,32,10,5,8,8,34,105,4.6
763,Tyler Hansbrough\hansbty01,2015-16,F,44,0,343,32,71,.451,30,68,.441,2,3,.667,38,65,.585,40,49,89,8,12,7,12,55,104,2.0
764,Johnathan Motley\motlejo01,2018-19,F,22,0,156,39,73,.534,39,70,.557,0,3,.000,24,40,.600,18,33,51,11,5,3,16,27,102,3.2
765,DeAndre' Bembry\bembrde01,2016-17,F,38,1,371,47,98,.480,46,80,.575,1,18,.056,6,16,.375,14,45,59,28,8,5,16,21,101,2.0
766,Andrew Nicholson\nichoan01,2016-17,F,38,0,342,43,111,.387,38,84,.452,5,27,.185,9,14,.643,15,46,61,10,16,6,17,55,100,1.3
767,Johnny O'Bryant\obryajo01,2014-15,F-C,34,15,368,44,120,.367,44,120,.367,0,0,,12,27,.444,26,38,64,17,5,4,25,44,100,1.0
768,Maurice Ndour\ndourma01,2016-17,F,32,4,331,39,86,.453,38,79,.481,1,7,.143,19,26,.731,22,42,64,8,15,8,12,30,98,2.5
769,Okaro White\whiteok01,2016-17,F,35,0,471,33,87,.379,21,53,.396,12,34,.353,20,22,.909,25,57,82,21,10,10,18,52,98,2.2
770,Elton Brand\brandel01,2014-15,F,36,4,486,42,95,.442,42,94,.447,0,1,.000,12,23,.522,28,72,100,22,17,25,18,54,96,2.6
771,Johnathan Motley\motlejo01,2017-18,F,11,4,176,40,75,.533,39,69,.565,1,6,.167,15,28,.536,14,35,49,7,3,2,9,18,96,6.2
772,Guerschon Yabusele\yabusgu01,2018-19,F,41,1,251,35,77,.455,26,49,.531,9,28,.321,15,22,.682,23,30,53,15,8,7,15,32,94,1.8
773,Furkan Aldemir\aldemfu01,2014-15,F-C,41,9,540,40,78,.513,40,73,.548,0,5,.000,13,27,.481,78,98,176,28,17,16,17,96,93,3.1
774,Chris Boucher\bouchch01,2018-19,F,28,0,163,34,76,.447,22,39,.564,12,37,.324,13,15,.867,16,40,56,2,6,24,7,31,93,2.9
775,Jordan Mickey\mickejo01,2017-18,F,23,3,284,39,82,.476,37,66,.561,2,16,.125,13,19,.684,18,63,81,9,6,10,18,36,93,2.9
776,Jeremy Evans\evansje01,2014-15,F,38,0,266,32,58,.552,30,53,.566,2,5,.400,24,29,.828,26,45,71,13,11,12,5,29,90,2.7
777,Dwight Powell\poweldw01,2014-15,F-C,29,0,236,31,67,.463,28,56,.500,3,11,.273,25,33,.758,18,32,50,9,9,6,11,40,90,2.3
778,Michael Kidd-Gilchrist\kiddgmi01,2015-16,F,7,7,205,33,61,.541,30,54,.556,3,7,.429,20,29,.690,12,33,45,9,3,3,8,9,89,10.6
779,Kyle Singler\singlky01,2016-17,F,32,2,385,34,83,.410,27,46,.587,7,37,.189,13,17,.765,8,40,48,9,7,5,11,29,88,1.7
780,Cheick Diallo\diallch01,2016-17,F,17,0,199,36,76,.474,36,76,.474,0,0,,15,21,.714,23,50,73,4,4,7,7,17,87,4.4
781,Noah Vonleh\vonleno01,2014-15,F,25,0,259,30,76,.395,25,63,.397,5,13,.385,18,26,.692,28,58,86,4,4,9,11,20,83,2.8
782,Brandan Wright\wrighbr03,2015-16,F-C,12,2,212,35,52,.673,35,52,.673,0,0,,13,24,.542,14,29,43,6,5,15,10,21,83,6.3
783,Drew Gooden\goodedr01,2015-16,F,30,0,305,33,103,.320,26,62,.419,7,41,.171,9,14,.643,28,57,85,13,8,11,13,40,82,1.8
784,Juan Hernangómez\hernaju01,2017-18,F,25,3,277,29,75,.387,15,25,.600,14,50,.280,10,12,.833,18,36,54,12,6,3,9,25,82,2.4
785,Alec Peters\peteral01,2017-18,F,20,0,225,28,74,.378,10,16,.625,18,58,.310,8,10,.800,8,29,37,12,2,2,4,13,82,2.9
786,Damjan Rudež\rudezda01,2016-17,F,45,0,314,31,88,.352,11,24,.458,20,64,.313,0,0,,5,20,25,20,12,1,9,31,82,1.1
787,Paul Pierce\piercpa01,2016-17,F-G,25,7,277,28,70,.400,13,27,.481,15,43,.349,10,13,.769,1,47,48,10,4,5,16,40,81,1.6
788,Robert Williams\williro04,2018-19,F,32,2,283,36,51,.706,36,51,.706,0,0,,9,15,.600,27,54,81,7,9,40,10,36,81,3.4
789,Isaiah Hicks\hicksis01,2017-18,F,18,0,240,33,72,.458,31,63,.492,2,9,.222,12,18,.667,10,31,41,16,2,4,16,45,80,2.2
790,Guerschon Yabusele\yabusgu01,2017-18,F,33,4,235,26,61,.426,14,24,.583,12,37,.324,15,22,.682,17,35,52,16,4,5,12,23,79,1.9
791,Jake Layman\laymaja01,2016-17,F,35,1,249,26,89,.292,13,38,.342,13,51,.255,13,17,.765,6,18,24,11,9,3,11,22,78,0.9
792,Matt Bonner\bonnema01,2015-16,F,30,2,206,29,57,.509,14,23,.609,15,34,.441,3,4,.750,3,24,27,9,6,1,3,16,76,2.0
793,Damjan Rudež\rudezda01,2015-16,F,33,0,277,25,62,.403,8,12,.667,17,50,.340,8,8,1.000,5,15,20,11,3,1,13,33,75,1.1
794,Travis Wear\weartr01,2017-18,F,17,0,228,25,72,.347,8,25,.320,17,47,.362,8,8,1.000,0,38,38,7,4,5,6,30,75,2.4
795,Kyle Anderson\anderky01,2014-15,F-G,33,8,358,31,89,.348,28,78,.359,3,11,.273,9,14,.643,5,67,72,28,15,7,10,28,74,1.9
796,Josh McRoberts\mcrobjo01,2014-15,F,17,4,296,28,53,.528,20,34,.588,8,19,.421,8,13,.615,7,38,45,33,12,3,22,41,72,3.5
797,Jeremy Evans\evansje01,2015-16,F,30,2,251,26,48,.542,22,32,.688,4,16,.250,15,21,.714,11,43,54,2,6,9,7,19,71,2.2
798,Mirza Teletović\teletmi01,2017-18,F,10,0,159,25,57,.439,4,12,.333,21,45,.467,0,0,,3,20,23,10,4,1,7,14,71,4.8
799,Elton Brand\brandel01,2015-16,F,17,1,225,31,72,.431,31,71,.437,0,1,.000,8,9,.889,9,54,63,18,9,8,11,32,70,3.4
800,Skal Labissière\labissk01,2018-19,F,22,1,176,26,49,.531,20,36,.556,6,13,.462,9,17,.529,9,34,43,11,5,6,11,29,67,2.3
801,Kostas Papanikolaou\papanko01,2015-16,F,26,6,294,24,66,.364,14,34,.412,10,32,.313,9,14,.643,8,32,40,16,13,5,21,24,67,1.6
802,Jason Smith\smithja02,2018-19,F-C,20,1,191,21,59,.356,12,33,.364,9,26,.346,14,16,.875,16,36,52,14,3,7,13,30,65,2.3
803,Alex Poythress\poythal01,2016-17,F,6,1,157,25,54,.463,19,35,.543,6,19,.316,8,10,.800,11,18,29,5,3,2,3,14,64,8.0
804,Ryan Anderson\anderry01,2018-19,F,25,8,321,21,69,.304,12,29,.414,9,40,.225,12,16,.750,18,36,54,19,4,1,14,25,63,1.6
805,Caron Butler\butleca01,2015-16,F,17,1,176,25,59,.424,22,41,.537,3,18,.167,10,12,.833,5,17,22,10,9,1,3,19,63,2.7
806,Mike Miller\millemi01,2015-16,F-G,47,2,373,22,62,.355,3,10,.300,19,52,.365,0,0,,6,47,53,40,13,4,17,53,63,1.1
807,Steve Novak\novakst01,2014-15,F,35,0,197,22,56,.393,3,8,.375,19,48,.396,0,2,.000,2,20,22,11,0,2,5,23,63,1.0
808,Adreian Payne\paynead01,2016-17,F-C,18,0,135,23,54,.426,20,39,.513,3,15,.200,14,19,.737,9,24,33,7,8,7,8,32,63,2.4
809,JaMychal Green\greenja01,2014-15,F,24,1,164,27,47,.574,27,41,.659,0,6,.000,8,10,.800,19,26,45,4,5,5,14,25,62,2.0
810,James Michael McAdoo\mcadoja01,2014-15,F,15,0,137,24,44,.545,24,44,.545,0,0,,14,25,.560,15,22,37,2,5,9,6,21,62,3.5
811,DeJuan Blair\blairde01,2015-16,F-C,29,0,218,28,68,.412,28,67,.418,0,1,.000,5,13,.385,20,37,57,11,8,2,15,53,61,0.9
812,Derrick Jones\jonesde02,2017-18,F,20,8,245,21,53,.396,18,35,.514,3,18,.167,16,24,.667,21,17,38,9,4,13,7,24,61,2.6
813,Caleb Swanigan\swanica01,2017-18,F,27,3,189,24,60,.400,23,52,.442,1,8,.125,12,18,.667,15,39,54,14,5,3,18,37,61,1.2
814,Christian Wood\woodch01,2015-16,F,17,0,145,22,53,.415,18,42,.429,4,11,.364,13,21,.619,13,25,38,3,5,7,2,11,61,3.0
815,Jeff Adrien\adrieje01,2014-15,F,17,0,215,19,44,.432,19,44,.432,0,0,,22,38,.579,23,54,77,15,4,9,9,30,60,3.7
816,Henry Ellenson\ellenhe01,2016-17,F,19,2,146,23,64,.359,13,29,.448,10,35,.286,4,8,.500,8,33,41,7,1,1,14,6,60,1.5
817,Rakeem Christmas\chrisra01,2016-17,F,29,0,219,19,43,.442,19,43,.442,0,0,,21,29,.724,26,30,56,4,3,6,8,37,59,1.6
818,Udonis Haslem\hasleud01,2015-16,F-C,37,0,260,23,61,.377,22,52,.423,1,9,.111,12,16,.750,10,65,75,14,5,2,5,25,59,1.4
819,Jarnell Stokes\stokeja01,2014-15,F-C,19,2,126,21,37,.568,21,37,.568,0,0,,15,28,.536,16,18,34,4,5,5,7,25,57,2.4
820,Shayne Whittington\whittsh01,2014-15,F-C,20,0,108,19,42,.452,18,36,.500,1,6,.167,18,23,.783,10,19,29,6,5,2,5,18,57,2.2
821,Metta World Peace\artesro01,2016-17,F,25,2,160,19,68,.279,10,30,.333,9,38,.237,10,16,.625,5,15,20,11,10,2,7,18,57,1.1
822,DeJuan Blair\blairde01,2014-15,F-C,29,0,180,26,57,.456,26,57,.456,0,0,,4,6,.667,16,40,56,3,7,1,13,41,56,1.0
823,Darrell Arthur\arthuda01,2017-18,F,19,1,141,22,47,.468,14,24,.583,8,23,.348,2,3,.667,3,12,15,9,8,3,15,22,54,1.5
824,Ray Spalding\spaldra01,2018-19,F,14,3,148,25,47,.532,25,44,.568,0,3,.000,4,12,.333,15,33,48,5,9,8,9,23,54,3.4
825,Paul George\georgpa01,2014-15,F,6,0,91,18,49,.367,9,27,.333,9,22,.409,8,11,.727,4,18,22,6,5,1,12,11,53,4.4
826,Isaiah Hartenstein\harteis01,2018-19,F,28,0,221,20,41,.488,18,35,.514,2,6,.333,11,14,.786,21,26,47,15,7,12,13,56,53,1.6
827,Lou Amundson\amundlo01,2015-16,F-C,29,0,204,19,53,.358,19,53,.358,0,0,,14,27,.519,23,26,49,12,6,7,15,44,52,1.0
828,Chimezie Metu\metuch01,2018-19,F,29,0,145,19,58,.328,19,56,.339,0,2,.000,13,17,.765,9,27,36,13,6,2,15,14,51,0.9
829,Chris Copeland\copelch01,2015-16,F,24,1,156,17,51,.333,7,15,.467,10,36,.278,6,7,.857,1,9,10,11,2,0,6,17,50,0.9
830,Chuck Hayes\hayesch01,2014-15,F-C,29,0,255,22,46,.478,22,46,.478,0,0,,6,11,.545,18,33,51,20,10,4,8,37,50,1.8
831,Devin Robinson\robinde01,2018-19,F,7,0,95,19,32,.594,19,30,.633,0,2,.000,9,14,.643,6,14,20,6,4,6,2,11,47,6.4
832,Marcus Derrickson\derrima01,2018-19,F,11,0,67,16,33,.485,6,13,.462,10,20,.500,4,5,.800,8,5,13,1,0,1,3,9,46,2.8
833,Landry Fields\fieldla01,2014-15,F,26,9,216,20,41,.488,19,39,.487,1,2,.500,5,6,.833,10,16,26,15,11,0,8,9,46,1.8
834,Chris McCullough\mcculch01,2017-18,F,19,0,90,18,42,.429,17,34,.500,1,8,.125,9,14,.643,7,18,25,4,0,5,2,8,46,1.7
835,Tyler Zeller\zellety01,2018-19,F-C,6,1,93,16,30,.533,16,29,.552,0,1,.000,14,18,.778,11,13,24,4,1,3,4,20,46,5.9
836,Francisco García\garcifr01,2014-15,F-G,14,0,200,17,63,.270,7,18,.389,10,45,.222,1,4,.250,3,14,17,15,9,5,10,20,45,1.3
837,Mike Scott\scottmi01,2016-17,F,18,0,195,17,59,.288,13,32,.406,4,27,.148,7,8,.875,10,27,37,17,4,3,8,12,45,1.7
838,Malcolm Thomas\thomama01,2014-15,F,17,0,194,18,40,.450,18,33,.545,0,7,.000,9,13,.692,16,40,56,7,3,1,13,17,45,2.0
839,Anthony Brown\brownan02,2016-17,F-G,11,0,159,18,50,.360,11,23,.478,7,27,.259,0,0,,8,25,33,8,5,1,6,15,43,2.5
840,Brice Johnson\johnsbr02,2017-18,F,18,0,98,20,42,.476,20,41,.488,0,1,.000,3,5,.600,9,22,31,2,9,6,5,13,43,2.1
841,Jon Leuer\leuerjo01,2017-18,F,8,0,136,15,36,.417,15,33,.455,0,3,.000,13,15,.867,7,25,32,5,1,3,7,16,43,3.6
842,Caleb Swanigan\swanica01,2018-19,F,21,0,178,18,53,.340,17,46,.370,1,7,.143,6,9,.667,17,47,64,11,6,1,18,28,43,1.1
843,Drew Eubanks\eubandr01,2018-19,F,23,0,113,15,26,.577,15,26,.577,0,0,,11,13,.846,6,28,34,7,2,5,8,11,41,1.7
844,Jack Cooley\cooleja01,2017-18,F-C,7,0,87,13,27,.481,13,27,.481,0,0,,14,19,.737,14,16,30,6,1,0,3,13,40,5.1
845,Jarrod Uthoff\uthofja01,2016-17,F,9,0,115,16,38,.421,13,29,.448,3,9,.333,5,7,.714,8,14,22,9,2,4,3,8,40,3.7
846,Julian Washburn\washbju01,2018-19,F,18,3,254,16,48,.333,11,24,.458,5,24,.208,3,4,.750,8,33,41,14,13,2,7,16,40,2.2
847,Bonzie Colson\colsobo01,2018-19,F,8,2,98,13,39,.333,8,18,.444,5,21,.238,8,9,.889,8,22,30,3,5,1,3,3,39,4.0
848,Tiago Splitter\splitti01,2016-17,F-C,8,0,76,14,31,.452,12,25,.480,2,6,.333,9,11,.818,8,14,22,4,1,1,6,8,39,3.4
849,Yuta Watanabe\watanyu01,2018-19,F,15,0,174,15,51,.294,13,35,.371,2,16,.125,7,10,.700,4,27,31,8,4,1,6,11,39,1.3
850,Jordan Mickey\mickejo01,2016-17,F,25,1,141,15,34,.441,15,33,.455,0,1,.000,8,14,.571,13,21,34,7,3,6,9,12,38,1.3
851,Malcolm Miller\millema01,2017-18,F,15,4,126,13,28,.464,5,7,.714,8,21,.381,4,4,1.000,4,11,15,3,1,2,5,10,38,1.7
852,Johnny O'Bryant\obryajo01,2016-17,F-C,11,0,81,15,30,.500,12,24,.500,3,6,.500,5,6,.833,9,10,19,6,0,1,6,10,38,2.4
853,Jared Sullinger\sullija01,2016-17,F,11,1,118,15,47,.319,12,29,.414,3,18,.167,4,8,.500,10,17,27,3,4,1,4,17,37,1.5
854,Reggie Williams\willire02,2014-15,F,20,0,105,15,39,.385,12,20,.600,3,19,.158,4,4,1.000,5,12,17,10,1,0,2,12,37,1.2
855,Damien Inglis\inglida01,2015-16,F,20,1,156,13,37,.351,10,24,.417,3,13,.231,7,8,.875,2,29,31,10,6,3,11,11,36,1.2
856,Cartier Martin\martica01,2014-15,F,23,0,198,15,53,.283,9,20,.450,6,33,.182,0,0,,0,20,20,11,3,1,5,20,36,0.4
857,Chris McCullough\mcculch01,2016-17,F,16,0,80,16,32,.500,15,25,.600,1,7,.143,3,5,.600,9,10,19,2,2,2,3,7,36,1.7
858,James Nunnally\nunnaja01,2018-19,F,15,0,102,12,34,.353,4,9,.444,8,25,.320,4,4,1.000,0,5,5,7,1,0,1,10,36,1.3
859,Malcolm Miller\millema01,2018-19,F,10,0,67,11,26,.423,1,5,.200,10,21,.476,3,4,.750,1,4,5,1,1,1,1,5,35,2.2
860,Gerald Wallace\wallage01,2014-15,F,32,0,286,14,34,.412,13,31,.419,1,3,.333,6,15,.400,17,40,57,11,15,4,18,19,35,1.2
861,Christian Wood\woodch01,2016-17,F,13,0,107,12,23,.522,12,18,.667,0,5,.000,11,15,.733,14,15,29,2,3,6,7,11,35,2.6
862,Cameron Bairstow\bairsca01,2015-16,F-C,18,2,103,13,40,.325,12,35,.343,1,5,.200,7,8,.875,4,24,28,6,2,3,4,19,34,1.0
863,Jake Layman\laymaja01,2017-18,F,35,1,160,14,47,.298,10,27,.370,4,20,.200,2,3,.667,4,12,16,11,6,4,5,13,34,0.5
864,Nick Collison\collini01,2016-17,F,20,0,128,14,23,.609,14,22,.636,0,1,.000,5,8,.625,9,22,31,12,2,2,4,17,33,1.8
865,Damien Wilkins\wilkida02,2017-18,F-G,19,1,152,13,39,.333,9,21,.429,4,18,.222,3,4,.750,5,11,16,9,2,1,5,7,33,1.0
866,Deng Adel\adelde01,2018-19,F,19,3,194,11,36,.306,5,13,.385,6,23,.261,4,4,1.000,3,16,19,5,1,4,6,13,32,0.7
867,Nick Collison\collini01,2017-18,F,15,0,75,13,19,.684,13,19,.684,0,0,,5,13,.385,7,13,20,4,0,0,7,7,31,1.4
868,Cleanthony Early\earlycl01,2015-16,F,17,2,154,12,40,.300,8,25,.320,4,15,.267,3,4,.750,4,22,26,6,2,3,9,16,31,0.6
869,Udonis Haslem\hasleud01,2016-17,F-C,16,0,130,11,23,.478,11,20,.550,0,3,.000,9,15,.600,8,28,36,6,6,1,8,22,31,1.6
870,Jeff Ayres\pendeje02,2015-16,F,17,0,107,12,23,.522,12,22,.545,0,1,.000,6,6,1.000,4,18,22,5,0,3,6,18,30,1.1
871,Richard Jefferson\jefferi01,2017-18,F,20,0,163,12,27,.444,10,20,.500,2,7,.286,4,7,.571,2,15,17,15,2,1,5,11,30,1.2
872,Solomon Hill\hillso01,2017-18,F,12,1,187,11,41,.268,7,20,.350,4,21,.190,3,6,.500,9,27,36,22,7,1,9,22,29,1.9
873,Quincy Miller\millequ01,2014-15,F,10,0,120,9,38,.237,6,20,.300,3,18,.167,8,11,.727,4,16,20,8,7,5,5,9,29,2.0
874,Alan Williams\willial03,2015-16,F-C,10,0,68,10,24,.417,10,24,.417,0,0,,9,14,.643,14,24,38,5,4,5,6,15,29,3.0
875,Anthony Bennett\bennean01,2015-16,F,19,0,84,8,27,.296,5,13,.385,3,14,.214,9,10,.900,6,17,23,0,5,0,4,8,28,1.0
876,Mike Miller\millemi01,2016-17,F-G,20,0,151,9,23,.391,1,3,.333,8,20,.400,2,2,1.000,2,36,38,22,2,0,13,9,28,1.4
877,Earl Clark\clarkea01,2014-15,F,10,0,93,11,30,.367,7,16,.438,4,14,.286,1,4,.250,1,22,23,3,3,4,6,12,27,1.4
878,Jack Cooley\cooleja01,2014-15,F-C,16,0,87,9,22,.409,9,22,.409,0,0,,9,21,.429,10,15,25,1,6,3,3,23,27,1.2
879,Nigel Hayes\hayesni01,2017-18,F,9,0,122,11,33,.333,7,17,.412,4,16,.250,1,3,.333,4,18,22,6,2,3,2,8,27,2.1
880,Amile Jefferson\jeffeam01,2018-19,F,12,0,68,10,16,.625,10,16,.625,0,0,,7,8,.875,6,15,21,3,3,3,1,8,27,2.6
881,Jemerrio Jones\jonesje01,2018-19,F,6,2,143,12,33,.364,10,23,.435,2,10,.200,1,2,.500,16,33,49,13,7,5,5,10,27,6.7
882,Reggie Williams\willire02,2016-17,F,6,0,79,8,23,.348,3,12,.250,5,11,.455,6,7,.857,2,4,6,4,3,0,0,2,27,3.6
883,Bruno Caboclo\cabocbr01,2017-18,F,12,0,106,9,31,.290,6,14,.429,3,17,.176,5,6,.833,7,15,22,4,3,4,4,8,26,1.5
884,Mitch McGary\mcgarmi01,2015-16,F-C,20,0,72,11,23,.478,11,19,.579,0,4,.000,4,10,.400,4,14,18,3,1,2,7,10,26,0.6
885,Alex Poythress\poythal01,2017-18,F,25,0,104,11,26,.423,7,15,.467,4,11,.364,0,0,,7,10,17,2,3,1,2,16,26,0.7
886,Udonis Haslem\hasleud01,2018-19,F-C,10,1,74,11,33,.333,11,21,.524,0,12,.000,3,4,.750,3,24,27,2,0,0,3,9,25,1.0
887,Damian Jones\jonesda03,2017-18,F-C,15,0,89,11,22,.500,11,22,.500,0,0,,3,5,.600,5,9,14,2,1,3,4,14,25,1.0
888,Ryan Kelly\kellyry01,2016-17,F,16,0,110,8,28,.286,4,18,.222,4,10,.400,5,6,.833,1,17,18,8,4,5,4,5,25,1.3
889,Victor Claver\clavevi01,2014-15,F,10,0,76,9,20,.450,3,9,.333,6,11,.545,0,0,,3,17,20,1,1,1,4,12,24,1.4
890,Steve Novak\novakst01,2015-16,F,10,0,44,8,18,.444,1,3,.333,7,15,.467,1,1,1.000,0,5,5,0,0,0,1,3,24,1.4
891,Shavlik Randolph\randosh01,2014-15,F,21,0,126,9,35,.257,9,30,.300,0,5,.000,6,12,.500,16,22,38,4,5,3,3,16,24,0.9
892,Jarred Vanderbilt\vandeja01,2018-19,F,17,0,69,9,19,.474,9,18,.500,0,1,.000,6,10,.600,7,16,23,3,6,1,8,8,24,1.2
893,Tyler Lydon\lydonty01,2018-19,F,25,0,94,9,18,.500,5,8,.625,4,10,.400,1,3,.333,7,11,18,6,2,0,4,10,23,0.8
894,Kyle Singler\singlky01,2017-18,F,12,0,59,7,21,.333,5,16,.313,2,5,.400,7,13,.538,1,9,10,2,1,0,3,4,23,0.8
895,Joel Bolomboy\bolomjo01,2016-17,F,12,0,53,9,16,.563,8,12,.667,1,4,.250,3,6,.500,4,13,17,2,1,2,2,1,22,1.8
896,Cory Jefferson\jeffeco01,2015-16,F,8,0,50,9,22,.409,9,21,.429,0,1,.000,4,6,.667,6,10,16,0,0,1,0,8,22,1.8
897,Omari Johnson\johnsom01,2017-18,F,4,0,75,9,21,.429,5,9,.556,4,12,.333,0,0,,4,7,11,7,2,0,3,6,22,4.3
898,Zhou Qi\qizh01,2017-18,F-C,18,0,124,6,32,.188,4,13,.308,2,19,.105,8,12,.667,6,16,22,2,2,14,10,14,22,0.4
899,Alex Stepheson\stephal01,2015-16,F,8,0,72,9,27,.333,9,27,.333,0,0,,4,12,.333,19,9,28,2,1,5,0,12,22,2.6
900,Alfonzo McKinnie\mckinal01,2017-18,F,14,0,53,8,15,.533,5,6,.833,3,9,.333,2,3,.667,1,6,7,1,1,1,3,8,21,0.9
901,Jordan Mickey\mickejo01,2015-16,F,16,0,57,8,22,.364,8,22,.364,0,0,,5,10,.500,6,7,13,1,0,11,1,5,21,1.2
902,Georges Niang\niangge01,2016-17,F,23,0,93,9,36,.250,8,24,.333,1,12,.083,2,2,1.000,2,15,17,5,3,0,5,6,21,0.2
903,Adreian Payne\paynead01,2017-18,F-C,5,0,43,7,10,.700,5,7,.714,2,3,.667,5,6,.833,2,7,9,0,2,0,2,6,21,3.5
904,D.J. Wilson\wilsodj01,2017-18,F,22,0,71,9,16,.563,7,11,.636,2,5,.400,1,2,.500,2,8,10,3,3,1,4,7,21,0.7
905,Kenyon Martin\martike01,2014-15,F,11,0,104,9,22,.409,9,22,.409,0,0,,2,2,1.000,6,13,19,5,5,6,3,13,20,1.9
906,Luc Mbah a Moute\mbahalu01,2018-19,F,4,0,61,8,18,.444,6,12,.500,2,6,.333,2,5,.400,2,5,7,2,1,1,2,8,20,2.6
907,Okaro White\whiteok01,2017-18,F,6,4,80,7,16,.438,3,5,.600,4,11,.364,2,3,.667,3,8,11,2,1,1,1,6,20,2.6
908,Alan Williams\willial03,2017-18,F-C,5,0,70,7,18,.389,7,18,.389,0,0,,6,9,.667,3,19,22,8,5,1,7,13,20,3.2
909,Damian Jones\jonesda03,2016-17,F-C,10,0,85,8,16,.500,8,16,.500,0,0,,3,10,.300,9,14,23,0,1,4,6,15,19,1.1
910,Anderson Varejão\varejan01,2016-17,F-C,14,1,92,5,14,.357,5,14,.357,0,0,,8,11,.727,12,15,27,10,3,3,8,16,18,1.4
911,Alan Williams\willial03,2018-19,F-C,5,0,26,8,13,.615,8,12,.667,0,1,.000,2,4,.500,4,15,19,3,1,0,1,2,18,4.0
912,Quincy Acy\acyqu01,2018-19,F-C,10,0,123,4,18,.222,2,3,.667,2,15,.133,7,10,.700,3,22,25,8,1,4,4,24,17,0.9
913,Tony Bradley\bradlto01,2018-19,F-C,3,0,36,8,16,.500,8,16,.500,0,0,,1,2,.500,9,6,15,1,2,2,3,6,17,5.1
914,Drew Gordon\gordodr01,2014-15,F,9,0,71,8,19,.421,8,16,.500,0,3,.000,1,2,.500,7,11,18,2,1,0,8,7,17,0.7
915,Jameel Warney\warneja01,2017-18,F,3,0,27,7,12,.583,7,12,.583,0,0,,3,5,.600,4,5,9,0,0,0,1,2,17,4.4
916,Grant Jerrett\jerregr01,2014-15,F,8,0,51,7,26,.269,6,11,.545,1,15,.067,1,1,1.000,2,7,9,3,2,2,3,11,16,0.3
917,James Webb\webbja01,2017-18,F,10,0,120,6,24,.250,2,5,.400,4,19,.211,0,0,,8,16,24,4,1,0,4,10,16,0.8
918,Bruno Caboclo\cabocbr01,2016-17,F,9,0,40,6,16,.375,4,10,.400,2,6,.333,0,0,,5,5,10,4,2,1,2,4,14,1.3
919,Josh Huestis\huestjo01,2015-16,F,5,0,55,5,12,.417,1,6,.167,4,6,.667,0,4,.000,2,8,10,0,1,2,3,3,14,1.6
920,Josh Huestis\huestjo01,2016-17,F,2,0,31,6,11,.545,4,7,.571,2,4,.500,0,1,.000,4,5,9,3,0,3,0,0,14,8.4
921,Chinanu Onuaku\onuakch01,2016-17,F-C,5,1,52,5,7,.714,5,7,.714,0,0,,4,4,1.000,2,8,10,3,3,1,4,6,14,2.9
922,Ike Anigbogu\anigbik01,2017-18,F-C,11,0,30,4,9,.444,4,9,.444,0,0,,5,6,.833,5,4,9,0,1,3,2,1,13,1.2
923,Justin Harper\harpeju01,2015-16,F,5,0,35,4,10,.400,0,1,.000,4,9,.444,1,2,.500,0,1,1,0,1,0,2,3,13,1.1
924,Alize Johnson\johnsal02,2018-19,F,14,0,64,4,16,.250,3,14,.214,1,2,.500,4,8,.500,4,15,19,1,1,3,0,7,13,0.7
925,Kyle Wiltjer\wiltjky01,2016-17,F,14,0,44,4,14,.286,0,1,.000,4,13,.308,1,2,.500,4,6,10,2,3,1,5,4,13,0.5
926,Justin Harper\harpeju01,2016-17,F,3,0,31,5,12,.417,3,5,.600,2,7,.286,0,0,,2,3,5,2,0,0,4,2,12,1.5
927,Isaiah Hicks\hicksis01,2018-19,F,3,0,32,4,8,.500,4,8,.500,0,0,,4,5,.800,2,5,7,2,1,3,1,5,12,4.0
928,Shayne Whittington\whittsh01,2015-16,F-C,7,0,41,5,11,.455,5,9,.556,0,2,.000,1,2,.500,5,7,12,3,1,1,5,7,11,0.9
929,Cliff Alexander\alexacl01,2015-16,F,8,0,36,5,10,.500,5,10,.500,0,0,,0,0,,2,4,6,0,1,2,1,1,10,1.1
930,Cameron Bairstow\bairsca01,2014-15,F-C,18,1,64,3,14,.214,3,14,.214,0,0,,4,5,.800,6,2,8,1,2,1,3,8,10,0.2
931,Bruno Caboclo\cabocbr01,2014-15,F,8,0,23,4,12,.333,2,9,.222,2,3,.667,0,0,,1,1,2,0,0,1,4,3,10,0.0
932,Emanuel Terry\terryem01,2018-19,F,3,0,23,4,7,.571,4,7,.571,0,0,,2,4,.500,3,4,7,2,3,0,2,4,10,3.3
933,Joel Bolomboy\bolomjo01,2017-18,F,6,0,38,3,6,.500,3,5,.600,0,1,.000,3,6,.500,6,4,10,0,2,0,2,3,9,1.5
934,Tyler Cavanaugh\cavanty01,2018-19,F,11,0,39,3,10,.300,2,5,.400,1,5,.200,2,2,1.000,3,5,8,1,0,0,1,3,9,0.5
935,Haywood Highsmith\highsha01,2018-19,F,5,0,40,4,10,.400,3,5,.600,1,5,.200,0,2,.000,0,5,5,2,1,0,1,1,9,1.1
936,Kevon Looney\looneke01,2015-16,F-C,5,0,21,4,7,.571,3,5,.600,1,2,.500,0,0,,4,6,10,0,0,0,1,2,9,1.7
937,Georges Niang\niangge01,2017-18,F,9,0,32,4,11,.364,4,7,.571,0,4,.000,1,2,.500,3,6,9,3,2,0,3,1,9,0.8
938,Tony Bradley\bradlto01,2017-18,F-C,9,0,29,3,11,.273,3,10,.300,0,1,.000,2,2,1.000,4,7,11,1,0,0,0,1,8,0.7
939,Udonis Haslem\hasleud01,2017-18,F-C,14,0,72,3,15,.200,2,7,.286,1,8,.125,1,2,.500,3,7,10,5,0,2,2,3,8,0.3
940,James Michael McAdoo\mcadoja01,2017-18,F,3,0,18,2,7,.286,0,0,,2,7,.286,2,2,1.000,0,2,2,0,0,1,1,1,8,1.3
941,Eric Moreland\moreler01,2015-16,F-C,8,0,48,3,6,.500,3,6,.500,0,0,,2,4,.500,3,8,11,1,0,4,3,4,8,1.0
942,Eric Moreland\moreler01,2018-19,F-C,5,0,43,3,7,.429,2,6,.333,1,1,1.000,0,0,,4,16,20,4,1,1,5,9,7,1.4
943,Jarnell Stokes\stokeja01,2015-16,F-C,7,0,19,3,5,.600,3,5,.600,0,0,,1,2,.500,1,3,4,1,1,0,0,1,7,1.0
944,Thanasis Antetokounmpo\antetth01,2015-16,F,2,0,6,3,4,.750,3,3,1.000,0,1,.000,0,0,,0,1,1,0,0,0,0,2,6,2.0
945,Coty Clarke\clarkco01,2015-16,F,3,0,6,2,4,.500,0,2,.000,2,2,1.000,0,0,,0,1,1,0,0,0,1,0,6,1.1
946,Duje Dukan\dukandu01,2015-16,F,1,0,24,2,10,.200,0,5,.000,2,5,.400,0,0,,2,2,4,1,1,0,0,2,6,2.7
947,Vince Hunter\huntevi01,2017-18,F,4,0,7,3,5,.600,3,5,.600,0,0,,0,0,,2,1,3,0,0,1,1,0,6,1.3
948,Donatas Motiejūnas\motiedo01,2018-19,F-C,3,0,13,3,6,.500,3,6,.500,0,0,,0,2,.000,2,1,3,1,0,1,3,6,6,0.0
949,Branden Dawson\dawsobr01,2015-16,F,6,0,29,2,5,.400,2,5,.400,0,0,,1,1,1.000,2,2,4,0,0,1,0,2,5,0.7
950,Steve Novak\novakst01,2016-17,F,8,0,22,2,7,.286,1,1,1.000,1,6,.167,0,0,,0,3,3,0,0,0,0,1,5,0.2
951,Rakeem Christmas\chrisra01,2015-16,F,1,0,6,2,2,1.000,2,2,1.000,0,0,,0,0,,1,0,1,0,0,0,0,1,4,3.7
952,Matt Costello\costema01,2017-18,F,4,0,32,2,4,.500,2,4,.500,0,0,,0,0,,1,8,9,2,2,2,1,7,4,1.5
953,Chuck Hayes\hayesch01,2015-16,F-C,2,0,24,1,2,.500,1,2,.500,0,0,,2,2,1.000,0,8,8,2,0,0,3,6,4,0.7
954,Brice Johnson\johnsbr02,2016-17,F,3,0,9,2,7,.286,2,7,.286,0,0,,0,0,,1,2,3,1,2,1,1,0,4,1.2
955,Chinanu Onuaku\onuakch01,2017-18,F-C,1,0,22,2,5,.400,2,5,.400,0,0,,0,0,,1,3,4,1,0,0,3,4,4,-1.0
956,Tyrus Thomas\thomaty01,2014-15,F,2,0,7,1,1,1.000,1,1,1.000,0,0,,2,2,1.000,0,0,0,1,0,0,0,0,4,2.2
957,Jacob Wiley\wileyja01,2017-18,F,5,0,33,1,4,.250,0,2,.000,1,2,.500,1,2,.500,2,9,11,2,1,0,0,4,4,1.2
958,Anthony Brown\brownan02,2017-18,F-G,1,0,4,1,1,1.000,0,0,,1,1,1.000,0,0,,0,0,0,1,0,0,0,0,3,3.4
959,Bruno Caboclo\cabocbr01,2015-16,F,6,1,43,1,12,.083,0,5,.000,1,7,.143,0,0,,1,1,2,1,2,1,4,2,3,-0.9
960,Vince Edwards\edwarvi01,2018-19,F,2,0,16,1,4,.250,0,0,,1,4,.250,0,0,,1,1,2,0,0,0,0,0,3,0.8
961,Andrei Kirilenko\kirilan01,2014-15,F,7,0,36,0,5,.000,0,5,.000,0,0,,3,4,.750,2,6,8,1,1,0,1,1,3,0.4
962,Jarnell Stokes\stokeja01,2016-17,F-C,2,0,7,1,1,1.000,1,1,1.000,0,0,,1,2,.500,1,1,2,2,1,0,0,3,3,2.3
963,Kostas Antetokounmpo\antetko01,2018-19,F,2,0,11,0,3,.000,0,3,.000,0,0,,2,4,.500,0,1,1,0,2,0,1,0,2,0.2
964,Luol Deng\denglu01,2017-18,F,1,1,13,1,2,.500,1,2,.500,0,0,,0,0,,0,0,0,1,1,0,1,0,2,1.7
965,Jeremy Evans\evansje01,2017-18,F,1,0,5,1,1,1.000,1,1,1.000,0,0,,0,0,,1,0,1,0,0,0,1,1,2,1.0
966,Gordon Hayward\haywago01,2017-18,F-G,1,1,5,1,2,.500,1,1,1.000,0,1,.000,0,0,,0,1,1,0,0,0,0,1,2,0.9
967,Terrence Jones\joneste01,2018-19,F,2,0,5,1,4,.250,1,2,.500,0,2,.000,0,1,.000,0,4,4,0,0,0,1,1,2,-0.5
968,Yante Maten\matenya01,2018-19,F,2,0,13,1,4,.250,1,3,.333,0,1,.000,0,0,,1,2,3,0,1,0,0,0,2,1.0
969,Darius Miller\milleda01,2014-15,F,5,1,43,1,7,.143,1,6,.167,0,1,.000,0,0,,0,1,1,2,1,0,1,8,2,-0.8
970,Eric Moreland\moreler01,2014-15,F-C,3,0,2,1,1,1.000,1,1,1.000,0,0,,0,0,,0,1,1,0,0,0,0,1,2,0.5
971,Zhou Qi\qizh01,2018-19,F-C,1,0,1,1,1,1.000,1,1,1.000,0,0,,0,0,,0,0,0,0,0,0,0,0,2,1.7
972,Julius Randle\randlju01,2014-15,F-C,1,0,14,1,3,.333,1,3,.333,0,0,,0,2,.000,0,0,0,0,0,0,1,1,2,-1.9
973,Devin Robinson\robinde01,2017-18,F,1,0,13,1,3,.333,1,3,.333,0,0,,0,0,,2,3,5,0,1,0,0,2,2,2.8
974,Josh Smith\smithjo03,2017-18,F,3,0,12,1,4,.250,1,4,.250,0,0,,0,0,,3,1,4,0,0,0,0,3,2,0.3
975,Derrick Williams\willide02,2017-18,F,2,0,9,1,4,.250,1,2,.500,0,2,.000,0,0,,0,1,1,0,0,0,0,0,2,-0.1
976,Ike Anigbogu\anigbik01,2018-19,F-C,3,0,6,0,3,.000,0,3,.000,0,0,,0,0,,1,2,3,1,0,1,1,0,0,-0.1
977,Jerrelle Benimon\benimje01,2014-15,F,2,0,3,0,0,,0,0,,0,0,,0,0,,1,2,3,0,0,0,1,0,0,0.2
978,Ben Bentil\bentibe01,2016-17,F,3,0,10,0,3,.000,0,2,.000,0,1,.000,0,0,,0,2,2,0,0,0,1,1,0,-1.0
979,Chris Boucher\bouchch01,2017-18,F,1,0,1,0,1,.000,0,0,,0,1,.000,0,0,,0,1,1,0,0,0,0,0,0,-0.4
980,Sam Dekker\dekkesa01,2015-16,F,3,0,6,0,0,,0,0,,0,0,,0,0,,0,1,1,0,1,0,0,0,0,0.4
981,Donte Grantham\grantdo01,2018-19,F,3,0,2,0,2,.000,0,0,,0,2,.000,0,0,,0,0,0,0,0,0,0,0,0,-0.5
982,Mindaugas Kuzminskas\kuzmimi01,2017-18,F,1,0,2,0,2,.000,0,2,.000,0,0,,0,0,,0,0,0,0,0,0,0,0,0,-1.4
983,Tyler Lydon\lydonty01,2017-18,F,1,0,2,0,0,,0,0,,0,0,,0,0,,0,0,0,0,0,0,0,0,0,0.0
984,Erik McCree\mccreer01,2017-18,F,4,0,8,0,2,.000,0,1,.000,0,1,.000,0,0,,0,1,1,0,1,0,1,0,0,-0.3
985,Josh McRoberts\mcrobjo01,2017-18,F,2,0,6,0,1,.000,0,0,,0,1,.000,0,0,,0,0,0,0,0,0,0,2,0,-0.8
986,Ben Moore\moorebe01,2017-18,F,2,0,9,0,0,,0,0,,0,0,,0,0,,0,1,1,1,0,0,0,4,0,-0.3
987,J.J. O'Brien\obriejj01,2015-16,F,2,0,6,0,1,.000,0,1,.000,0,0,,0,0,,0,1,1,0,1,0,0,1,0,0.1
988,Ronny Turiaf\turiaro01,2014-15,F,2,0,19,0,0,,0,0,,0,0,,0,0,,0,1,1,2,0,0,0,0,0,0.9
989,David Wear\wearda01,2014-15,F,2,0,7,0,2,.000,0,1,.000,0,1,.000,0,0,,2,0,2,1,0,0,0,1,0,0.2
990,Okaro White\whiteok01,2018-19,F,3,0,6,0,2,.000,0,0,,0,2,.000,0,0,,1,1,2,0,0,0,0,0,0,-0.1
