Rk,Player,Season,School,Pos,G,GS,MP,FG,FGA,FG%,2P,2PA,2P%,3P,3PA,3P%,FT,FTA,FT%,ORB,DRB,TRB,AST,STL,BLK,TOV,PF,PTS,GmSc
1,Marcus Keene\marcus-keene-1,2016-17,Central Michigan,G,32,31,1179,313,700,.447,188,360,.522,125,340,.368,208,254,.819,22,121,143,156,26,0,145,63,959,18.5
2,Buddy Hield\buddy-hield-1,2015-16,Oklahoma,G,37,37,1309,301,601,.501,154,279,.552,147,322,.457,176,200,.880,46,166,212,75,42,18,113,76,925,17.9
3,Chris Clemons\chris-clemons-2,2016-17,Campbell,G,36,34,1205,301,673,.447,183,341,.537,118,332,.355,184,223,.825,18,149,167,92,70,18,100,69,904,17.1
4,Jordan Howard\jordan-howard-2,2017-18,Central Arkansas,G,35,34,1259,280,613,.457,167,326,.512,113,287,.394,207,233,.888,10,115,125,93,36,0,80,41,880,17.1
5,Trae Young\trae-young-1,2017-18,Oklahoma,G,32,32,1133,261,618,.422,143,290,.493,118,328,.360,236,274,.861,14,111,125,279,54,8,167,57,876,20.0
6,Andre Spight\andre-spight-1,2017-18,Northern Colorado,G,38,38,1285,293,661,.443,165,341,.484,128,320,.400,141,180,.783,20,128,148,139,44,10,112,73,855,14.6
7,Kay Felder\kahlil-felder-1,2015-16,Oakland,G,35,35,1286,269,612,.440,193,398,.485,76,214,.355,239,282,.848,26,123,149,324,69,7,120,104,853,20.3
8,Antoine Mason\antoine-mason-1,2013-14,Niagara,G,33,33,1242,269,612,.440,221,444,.498,48,168,.286,260,357,.728,32,86,118,51,40,5,91,95,846,14.7
9,Trey Freeman\trey-freeman-2,2015-16,Old Dominion,G,38,38,1333,323,753,.429,272,607,.448,51,146,.349,141,170,.829,21,139,160,115,39,4,48,68,838,14.0
10,Billy Baron\billy-baron-1,2013-14,Canisius,G,34,34,1325,247,532,.464,140,278,.504,107,254,.421,220,249,.884,17,149,166,180,56,1,101,38,821,19.4
11,Jon Elmore\jon-elmore-1,2017-18,Marshall,G,36,35,1380,243,554,.439,145,279,.520,98,275,.356,232,281,.826,16,194,210,244,58,13,132,56,816,18.3
12,James Daniel\james-daniel-1,2015-16,Howard,G,30,30,1115,226,582,.388,146,341,.428,80,241,.332,280,331,.846,22,44,66,84,59,7,123,62,812,15.9
13,Dallas Moore\dallas-moore-1,2016-17,North Florida,G,34,34,1192,299,613,.488,199,362,.550,100,251,.398,114,138,.826,26,81,107,135,39,3,82,39,812,16.9
14,RJ Cole\rj-cole-1,2017-18,Howard,G,33,32,1252,241,612,.394,132,308,.429,109,304,.359,191,248,.770,27,103,130,200,57,0,127,87,782,15.5
15,Randy Onwuasor\randy-onwuasor-1,2016-17,Southern Utah,G,33,32,1155,253,619,.409,194,426,.455,59,193,.306,215,260,.827,52,165,217,107,50,14,113,104,780,15.0
16,Grayson Allen\grayson-allen-1,2015-16,Duke,G,36,35,1317,239,513,.466,149,297,.502,90,216,.417,211,252,.837,24,141,165,127,47,5,72,98,779,16.3
17,Kendrick Nunn\kendrick-nunn-1,2017-18,Oakland,G,30,26,1136,262,602,.435,128,262,.489,134,340,.394,119,142,.838,27,115,142,113,45,11,88,67,777,17.4
18,Anthony Barber\anthony-cat-barber-1,2015-16,North Carolina State,G,33,33,1278,248,572,.434,205,453,.453,43,119,.361,237,274,.865,21,130,151,147,21,2,85,71,776,15.9
19,Tyler Haws\tyler-haws-1,2014-15,Brigham Young,G,35,35,1125,258,538,.480,204,391,.522,54,147,.367,206,236,.873,46,110,156,83,33,9,69,48,776,16.1
20,Chris Clemons\chris-clemons-2,2017-18,Campbell,G,31,30,1055,233,515,.452,138,259,.533,95,256,.371,211,245,.861,10,132,142,95,49,10,83,58,772,17.9
21,Tyler Haws\tyler-haws-1,2013-14,Brigham Young,G,33,33,1143,252,544,.463,212,445,.476,40,99,.404,223,253,.881,33,93,126,49,34,9,63,75,767,15.4
22,Bryce Cotton\bryce-cotton-1,2013-14,Providence,G,35,35,1398,230,549,.419,153,339,.451,77,210,.367,226,265,.853,19,105,124,205,35,3,85,51,763,16.4
23,Jalen Brunson\jalen-brunson-1,2017-18,Villanova,G,40,40,1272,270,518,.521,184,307,.599,86,211,.408,130,162,.802,12,110,122,184,37,1,71,78,756,14.9
24,Justin Wright-Foreman\justin-wright-foreman-1,2017-18,Hofstra,G,31,30,1171,264,588,.449,168,326,.515,96,262,.366,131,164,.799,10,93,103,100,25,7,69,62,755,15.4
25,Malik Monk\malik-monk-1,2016-17,Kentucky,G,38,37,1218,251,558,.450,147,296,.497,104,262,.397,148,180,.822,12,83,95,87,36,19,75,72,754,12.9
26,Frank Mason\frank-mason-1,2016-17,Kansas,G,36,36,1301,241,492,.490,159,318,.500,82,174,.471,189,238,.794,22,128,150,187,47,2,86,73,753,16.8
27,D.J. Balentine\dj-balentine-1,2013-14,Evansville,G,33,33,1252,229,528,.434,151,332,.455,78,196,.398,216,255,.847,16,72,88,139,19,4,84,56,752,15.3
28,Fletcher Magee\fletcher-magee-1,2017-18,Wofford,G,34,34,1143,253,523,.484,105,186,.565,148,337,.439,97,107,.907,9,91,100,58,31,3,57,62,751,14.9
29,Josh Adams\josh-adams-1,2015-16,Wyoming,G,31,31,1125,220,498,.442,122,239,.510,98,259,.378,211,257,.821,18,155,173,134,44,18,115,86,749,17.1
30,Bryson Scott\bryson-scott-1,2017-18,Purdue-Fort Wayne,G,33,33,1026,247,541,.457,197,372,.530,50,169,.296,202,247,.818,20,128,148,86,65,5,91,65,746,15.5
31,Joe Young\joseph-young-1,2014-15,Oregon,G,36,35,1322,265,592,.448,174,337,.516,91,255,.357,124,134,.925,19,141,160,135,41,1,87,51,745,14.4
32,D'Marcus Simonds\dmarcus-simonds-1,2017-18,Georgia State,G,35,35,1223,277,601,.461,235,457,.514,42,144,.292,146,208,.702,46,155,201,153,60,24,127,100,742,14.4
33,Roosevelt Smart\roosevelt-smart-1,2017-18,North Texas,G,38,38,1274,221,557,.397,88,205,.429,133,352,.378,167,188,.888,17,141,158,35,23,10,65,86,742,11.6
34,Tyler Hall\tyler-hall-2,2016-17,Montana State,G,32,32,1101,240,504,.476,120,224,.536,120,280,.429,139,166,.837,17,155,172,90,34,11,65,78,739,16.8
35,Tyler Harvey\tyler-harvey-1,2014-15,Eastern Washington,G,32,32,1182,230,490,.469,102,193,.528,128,297,.431,150,176,.852,20,96,116,82,36,4,64,60,738,16.5
36,Tyler Nelson\tyler-nelson-1,2017-18,Fairfield,G,33,33,1205,230,547,.420,126,252,.500,104,295,.353,168,191,.880,18,120,138,110,45,3,82,55,732,15.2
37,Stefan Moody\stefan-moody-1,2015-16,Mississippi,G,31,31,1072,208,510,.408,105,238,.441,103,272,.379,212,256,.828,31,69,100,133,46,3,118,75,731,15.3
38,Tony Carr\tony-carr-1,2017-18,Penn State,G,37,37,1308,245,600,.408,157,397,.395,88,203,.433,147,184,.799,33,150,183,186,30,11,85,68,725,13.8
39,Jack Gibbs\jack-gibbs-1,2015-16,Davidson,G,31,30,1099,243,564,.431,162,320,.506,81,244,.332,158,188,.840,28,100,128,152,56,2,100,59,725,16.3
40,Marvelle Harris\marvelle-harris-2,2015-16,Fresno State,G,35,34,1284,240,589,.407,174,386,.451,66,203,.325,179,238,.752,19,144,163,156,76,21,77,102,725,15.0
41,Chasson Randle\chasson-randle-1,2014-15,Stanford,G,37,37,1347,217,539,.403,127,291,.436,90,248,.363,200,228,.877,11,112,123,112,50,5,75,82,724,13.2
42,Jonathan Stark\jonathan-stark-1,2016-17,Murray State,G,33,33,1207,249,568,.438,141,314,.449,108,254,.425,117,141,.830,9,119,128,172,43,1,95,75,723,15.0
43,D.J. Balentine\dj-balentine-1,2014-15,Evansville,G,36,36,1318,245,563,.435,171,374,.457,74,189,.392,159,212,.750,18,96,114,116,29,7,78,35,723,13.1
44,Luke Kennard\luke-kennard-1,2016-17,Duke,G,37,36,1314,237,484,.490,149,283,.527,88,201,.438,160,187,.856,43,145,188,91,31,13,59,83,722,14.9
45,Shabazz Napier\shabazz-napier-1,2013-14,Connecticut,G,40,40,1404,213,496,.429,126,281,.448,87,215,.405,207,238,.870,38,196,234,195,73,13,114,84,720,15.1
46,Jamal Murray\jamal-murray-1,2015-16,Kentucky,G,36,36,1267,244,538,.454,131,261,.502,113,277,.408,119,152,.783,53,133,186,79,35,11,84,75,720,13.6
47,Jeremy Senglin\jeremy-senglin-1,2016-17,Weber State,G,34,34,1198,233,489,.476,101,194,.521,132,295,.447,121,158,.766,6,125,131,96,38,1,81,73,719,14.5
48,Joel Hernandez\joel-hernandez-1,2017-18,Long Island University,G,35,34,1152,256,555,.461,198,400,.495,58,155,.374,148,223,.664,65,138,203,90,19,17,104,90,718,12.6
49,Zach Thomas\zach-thomas-1,2017-18,Bucknell,G,35,35,1113,206,446,.462,143,281,.509,63,165,.382,241,310,.777,45,272,317,74,35,24,103,71,716,15.5
50,Andrew Rowsey\andrew-rowsey-1,2017-18,Marquette,G,35,32,1143,208,495,.420,83,194,.428,125,301,.415,175,194,.902,14,91,105,169,32,7,99,83,716,14.4
51,Keon Johnson\keon-johnson-1,2016-17,Winthrop,G,32,30,1124,221,510,.433,119,256,.465,102,254,.402,171,197,.868,14,113,127,83,22,0,74,60,715,14.4
52,Garrison Mathews\garrison-matthews-1,2017-18,Lipscomb,G,33,32,1003,213,458,.465,123,222,.554,90,236,.381,199,249,.799,41,139,180,58,32,9,71,83,715,15.3
53,Patrick Miller\patrick-miller-2,2013-14,Tennessee State,G,30,30,1132,230,514,.447,186,383,.486,44,131,.336,208,268,.776,45,89,134,123,49,5,100,88,712,16.1
54,Tyus Battle\tyus-battle-1,2017-18,Syracuse,G,37,37,1443,234,586,.399,157,347,.452,77,239,.322,167,199,.839,17,91,108,76,54,7,87,74,712,11.3
55,Andrew Andrews\andrew-andrews-1,2015-16,Washington,G,34,34,1150,181,461,.393,104,269,.387,77,192,.401,273,321,.850,50,145,195,165,47,1,95,96,712,16.2
56,Cameron Morse\cameron-morse-1,2016-17,Youngstown State,G,31,28,1123,260,627,.415,184,389,.473,76,238,.319,115,156,.737,16,84,100,96,32,3,66,44,711,13.3
57,Zeek Woodley\zikiteran-woodley-1,2014-15,Northwestern State,G,32,32,1009,262,468,.560,223,370,.603,39,98,.398,148,182,.813,55,105,160,34,33,22,38,73,711,17.2
58,Karvel Anderson\karvel-anderson-1,2013-14,Robert Morris,G,36,36,1100,248,486,.510,129,229,.563,119,257,.463,95,113,.841,27,93,120,50,48,8,44,72,710,14.6
59,Ty Greene\ty-greene-1,2014-15,South Carolina Upstate,G,35,35,1191,232,522,.444,129,269,.480,103,253,.407,142,189,.751,30,78,108,74,74,7,45,56,709,15.0
60,Jeremy Ingram\jeremy-ingram-2,2013-14,North Carolina Central,G,34,34,1170,212,483,.439,144,299,.482,68,184,.370,216,280,.771,33,97,130,41,54,22,70,90,708,13.9
61,Cameron Payne\cameron-payne-1,2014-15,Murray State,G,35,35,1127,245,537,.456,161,314,.513,84,223,.377,133,169,.787,21,108,129,209,68,17,87,72,707,16.3
62,D.J. Newbill\dj-newbill-1,2014-15,Penn State,G,34,34,1261,243,540,.450,182,375,.485,61,165,.370,157,207,.758,37,123,160,105,44,7,90,73,704,13.8
63,Junior Robinson\lamont-robinson-1,2017-18,Mount St. Mary's,G,32,32,1162,228,511,.446,150,310,.484,78,201,.388,169,188,.899,19,73,92,154,37,1,89,87,703,15.2
64,C.J. Burks\cj-burks-1,2017-18,Marshall,G,35,34,1256,260,551,.472,174,315,.552,86,236,.364,96,108,.889,18,126,144,107,36,4,108,74,702,12.6
65,Sean Kilpatrick\sean-kilpatrick-1,2013-14,Cincinnati,G,34,33,1149,214,506,.423,121,239,.506,93,267,.348,180,213,.845,36,110,146,86,48,1,70,46,701,14.6
66,D.J. Balentine\dj-balentine-1,2015-16,Evansville,G,34,34,1253,240,543,.442,182,372,.489,58,171,.339,160,204,.784,26,87,113,148,24,9,92,58,698,13.5
67,Jabari Brown\jabari-brown-1,2013-14,Missouri,G,35,35,1295,203,435,.467,123,240,.513,80,195,.410,212,266,.797,17,138,155,67,22,5,82,57,698,13.5
68,Markus Howard\markus-howard-1,2017-18,Marquette,G,34,31,1071,239,515,.464,128,240,.533,111,275,.404,105,112,.938,13,95,108,94,33,2,85,85,694,13.1
69,Elijah Brown\elijah-brown-1,2015-16,New Mexico,G,32,29,1077,194,453,.428,105,227,.463,89,226,.394,217,255,.851,22,154,176,101,35,2,108,64,694,14.8
70,Cane Broome\cane-broome-1,2015-16,Sacred Heart,G,30,30,1126,236,530,.445,170,318,.535,66,212,.311,156,203,.768,17,131,148,88,51,0,115,71,694,14.0
71,Justin Robinson\justin-robinson-2,2015-16,Monmouth,G,36,36,1184,214,488,.439,134,285,.470,80,203,.394,185,219,.845,21,115,136,132,79,0,80,55,693,15.1
72,Austin McBroom\austin-mcbroom-1,2015-16,Eastern Washington,G,33,33,1235,212,488,.434,97,202,.480,115,286,.402,153,184,.832,21,63,84,121,35,0,93,52,692,14.0
73,Jordan McRae\jordan-mcrae-1,2013-14,Tennessee,G,37,37,1190,223,512,.436,144,287,.502,79,225,.351,167,212,.788,26,102,128,91,25,38,77,78,692,12.5
74,Kahlil Dukes\kahlil-dukes-1,2017-18,Niagara,G,33,32,1120,224,482,.465,129,254,.508,95,228,.417,149,164,.909,6,66,72,108,27,1,83,56,692,13.9
75,Jaylon Brown\jaylon-brown-1,2016-17,Evansville,G,33,32,1215,220,475,.463,182,386,.472,38,89,.427,211,246,.858,16,129,145,101,34,3,82,80,689,14.3
76,Jon Elmore\jon-elmore-1,2016-17,Marshall,G,35,34,1230,209,507,.412,126,271,.465,83,236,.352,188,233,.807,21,131,152,207,40,7,109,63,689,14.6
77,Marcus Marshall\marcus-marshall-1,2016-17,Nevada,G,35,35,1240,205,487,.421,90,184,.489,115,303,.380,164,198,.828,12,75,87,128,30,2,60,72,689,13.7
78,R.J. Hunter\rj-hunter-1,2014-15,Georgia State,G,35,35,1294,203,514,.395,123,252,.488,80,262,.305,202,230,.878,27,138,165,126,75,35,77,85,688,15.3
79,Marcus Evans\marcus-evans-2,2015-16,Rice,G,32,32,1073,224,475,.472,171,304,.563,53,171,.310,186,233,.798,28,100,128,91,70,6,100,92,687,14.9
80,Carsen Edwards\carsen-edwards-1,2017-18,Purdue,G,37,37,1094,229,500,.458,132,261,.506,97,239,.406,131,159,.824,13,129,142,104,42,8,64,65,686,13.4
81,Jack Gibbs\jack-gibbs-1,2016-17,Davidson,G,31,31,1122,215,503,.427,121,263,.460,94,240,.392,161,202,.797,22,103,125,127,41,0,82,77,685,15.0
82,Jonathan Stark\jonathan-stark-1,2017-18,Murray State,G,32,32,1165,221,490,.451,111,214,.519,110,276,.399,133,149,.893,12,73,85,126,43,6,78,56,685,15.3
83,A.J. English\aj-english-1,2014-15,Iona,G,34,34,1272,212,491,.432,106,217,.488,106,274,.387,155,197,.787,26,148,174,172,49,18,128,91,685,14.4
84,Kendrick Perry\kendrick-perry-1,2013-14,Youngstown State,G,32,32,1168,215,425,.506,153,251,.610,62,174,.356,190,258,.736,29,103,132,140,76,10,60,85,682,18.2
85,Jerrick Harding\jerrick-harding-1,2017-18,Weber State,G,31,31,1019,249,470,.530,192,336,.571,57,134,.425,127,144,.882,19,87,106,53,33,5,74,57,682,14.9
86,Travis Bader\travis-bader-1,2013-14,Oakland,G,33,33,1242,185,479,.386,38,119,.319,147,360,.408,164,174,.943,10,81,91,47,29,3,43,100,681,13.0
87,Davon Usher\davon-usher-1,2013-14,Delaware,G,35,35,1282,216,479,.451,131,245,.535,85,234,.363,162,218,.743,51,161,212,62,62,14,71,91,679,14.3
88,Braylon Rayson\braylon-rayson-1,2016-17,Central Michigan,G,32,31,1191,209,549,.381,116,291,.399,93,258,.360,168,198,.848,25,115,140,101,39,1,86,69,679,13.0
89,Luwane Pipkins\luwane-pipkins-1,2017-18,Massachusetts,G,32,29,1114,228,530,.430,121,279,.434,107,251,.426,115,146,.788,15,99,114,128,48,0,108,68,678,13.4
90,Tyler Harvey\tyler-harvey-1,2013-14,Eastern Washington,G,31,31,1158,206,465,.443,97,213,.455,109,252,.433,156,174,.897,21,108,129,84,35,9,66,71,677,15.5
91,Malcolm Brogdon\malcolm-brogdon-1,2015-16,Virginia,G,37,37,1263,230,503,.457,155,311,.498,75,192,.391,140,156,.897,19,131,150,115,35,9,52,76,675,13.5
92,Devonte' Graham\devonte-graham-1,2017-18,Kansas,G,39,39,1474,199,498,.400,89,227,.392,110,271,.406,167,202,.827,24,133,157,282,62,2,109,56,675,14.8
93,D'Angelo Russell\dangelo-russell-1,2014-15,Ohio State,G,35,34,1188,231,515,.449,136,284,.479,95,231,.411,118,156,.756,35,163,198,175,55,11,102,74,675,14.8
94,Chasson Randle\chasson-randle-1,2013-14,Stanford,G,36,36,1263,218,460,.474,150,285,.526,68,175,.389,171,223,.767,20,109,129,77,37,2,88,93,675,12.0
95,Russ Smith\russ-smith-1,2013-14,Louisville,G,37,36,1084,225,481,.468,155,300,.517,70,181,.387,153,217,.705,29,93,122,172,74,4,105,92,673,13.6
96,Chase Fischer\chase-fischer-1,2015-16,Brigham Young,G,37,37,1257,209,509,.411,97,204,.475,112,305,.367,143,173,.827,14,88,102,77,41,2,55,63,673,11.9
97,Charles Williams\charles-williams-5,2017-18,Howard,G,33,33,1173,253,567,.446,179,386,.464,74,181,.409,93,119,.782,23,89,112,19,28,10,58,72,673,11.2
98,Josh Hart\josh-hart-1,2016-17,Villanova,G,36,35,1193,236,463,.510,162,280,.579,74,183,.404,127,170,.747,51,179,230,106,55,10,71,81,673,15.2
99,Dallas Moore\dallas-moore-1,2015-16,North Florida,G,34,34,1211,256,496,.516,192,334,.575,64,162,.395,96,135,.711,20,115,135,205,31,5,64,28,672,16.6
100,Elfrid Payton\elfrid-payton-1,2013-14,Louisiana,G,35,34,1258,237,466,.509,223,412,.541,14,54,.259,184,302,.609,81,129,210,208,80,21,127,83,672,16.3
101,Aaron Holiday\aaron-holiday-1,2017-18,UCLA,G,33,33,1244,212,460,.461,124,255,.486,88,205,.429,159,192,.828,17,104,121,192,42,8,125,87,671,14.7
102,Amere May\amere-may-1,2014-15,Delaware State,G,32,29,1095,227,543,.418,138,313,.441,89,230,.387,128,156,.821,32,101,133,85,32,6,93,57,671,12.6
103,Victor Sanders\victor-sanders-1,2016-17,Idaho,G,32,31,1052,206,453,.455,105,223,.471,101,230,.439,157,201,.781,12,94,106,106,55,11,103,91,670,14.1
104,Nick Dixon\nick-dixon-1,2017-18,Texas-Rio Grande Valley,G,33,32,978,197,440,.448,143,287,.498,54,153,.353,222,279,.796,52,94,146,78,47,6,82,63,670,14.6
105,Justin Robinson\justin-robinson-2,2016-17,Monmouth,G,34,34,1128,212,508,.417,116,270,.430,96,238,.403,149,174,.856,20,109,129,162,49,3,89,54,669,14.4
106,Obi Emegano\obi-emegano-2,2015-16,Oral Roberts,G,29,29,1026,210,484,.434,159,350,.454,51,134,.381,198,232,.853,28,121,149,53,33,10,51,69,669,15.7
107,T.J. Cromer\tj-cromer-1,2016-17,East Tennessee State,G,35,33,1110,224,491,.456,118,230,.513,106,261,.406,114,139,.820,16,83,99,111,36,14,97,83,668,12.4
108,Marcus Evans\marcus-evans-2,2016-17,Rice,G,35,34,1110,197,464,.425,111,235,.472,86,229,.376,187,237,.789,14,101,115,131,40,5,128,91,667,11.8
109,Jairus Lyles\jairus-lyles-1,2017-18,Maryland-Baltimore County,G,33,32,1152,225,512,.439,147,312,.471,78,200,.390,137,173,.792,23,160,183,117,68,6,103,65,665,14.3
110,QJ Peterson\qj-peterson-1,2013-14,Virginia Military Institute,G,35,35,1152,218,549,.397,140,305,.459,78,244,.320,150,198,.758,63,133,196,72,59,12,76,81,664,12.6
111,Donte Clark\donte-clark-1,2017-18,Texas Southern,G,36,36,1252,203,506,.401,161,357,.451,42,149,.282,216,279,.774,39,148,187,93,39,12,102,113,664,11.2
112,Sindarius Thornwell\sindarius-thornwell-1,2016-17,South Carolina,G,31,31,1051,195,438,.445,137,291,.471,58,147,.395,215,259,.830,78,144,222,87,66,30,76,71,663,18.0
113,Zach Lofton\zach-lofton-1,2017-18,New Mexico State,G,33,31,1054,217,476,.456,130,247,.526,87,229,.380,142,184,.772,37,129,166,56,35,4,71,67,663,13.4
114,Roberto Nelson\roberto-nelson-1,2013-14,Oregon State,G,32,32,1052,200,447,.447,143,304,.470,57,143,.399,206,250,.824,35,73,108,115,31,1,98,70,663,13.9
115,Saah Nimley\saah-nimley-1,2014-15,Charleston Southern,G,31,31,1106,183,477,.384,73,170,.429,110,307,.358,187,228,.820,17,110,127,126,28,1,85,68,663,14.0
116,Lamond Murray\lamond-murray-2,2016-17,Pepperdine,G,31,30,1060,251,528,.475,200,394,.508,51,134,.381,109,140,.779,36,140,176,40,35,12,81,64,662,13.3
117,J.J. Mann\jj-mann-1,2013-14,Belmont,G,36,36,1266,218,474,.460,129,246,.524,89,228,.390,135,155,.871,15,157,172,92,77,3,61,51,660,14.6
118,Rodney Glasgow\rodney-glasgow-1,2013-14,Virginia Military Institute,G,35,35,1291,232,483,.480,146,266,.549,86,217,.396,110,126,.873,32,107,139,205,46,0,62,61,660,16.2
119,Jelani Hewitt\jelani-hewitt-1,2013-14,Georgia Southern,G,34,33,1152,211,520,.406,126,284,.444,85,236,.360,153,184,.832,31,120,151,104,75,5,103,78,660,13.0
120,Marcus Thornton\marcus-thornton-3,2014-15,William & Mary,G,33,33,1210,215,472,.456,113,218,.518,102,254,.402,127,153,.830,9,83,92,95,21,4,77,36,659,13.2
121,Eugene German\eugene-german-1,2017-18,Northern Illinois,G,32,31,991,243,516,.471,181,333,.544,62,183,.339,111,145,.766,13,110,123,54,28,5,66,53,659,12.7
122,Jonathan Wade\jonathan-wade-1,2016-17,Norfolk State,G,34,32,1187,217,448,.484,156,289,.540,61,159,.384,163,218,.748,53,178,231,63,22,3,110,73,658,12.6
123,Kendrick Ray\kendrick-ray-1,2016-17,Kennesaw State,G,31,31,1049,244,543,.449,158,325,.486,86,218,.394,82,104,.788,30,84,114,97,22,10,81,75,656,12.8
124,Alex Hamilton\alex-hamilton-1,2015-16,Louisiana Tech,G,33,33,1166,213,428,.498,179,314,.570,34,114,.298,196,277,.708,34,155,189,205,65,16,104,54,656,17.4
125,Robert Gray Jr.\robert-grayjr-1,2017-18,Houston,G,34,34,1084,218,488,.447,157,318,.494,61,170,.359,158,197,.802,23,102,125,148,38,4,79,53,655,14.0
126,Zeke Upshaw\zeke-upshaw-1,2013-14,Hofstra,G,33,33,1206,197,489,.403,106,228,.465,91,261,.349,170,225,.756,33,104,137,61,25,7,94,70,655,11.3
127,Marcus Foster\marcus-foster-1,2017-18,Creighton,G,33,33,1044,246,509,.483,151,279,.541,95,230,.413,67,90,.744,22,107,129,89,34,4,71,56,654,13.3
128,Troy Huff\troy-huff-1,2013-14,North Dakota,G,34,33,993,210,467,.450,168,328,.512,42,139,.302,190,250,.760,96,135,231,41,79,10,64,57,652,15.3
129,Garrison Mathews\garrison-matthews-1,2016-17,Lipscomb,G,32,32,1002,202,441,.458,113,188,.601,89,253,.352,159,219,.726,39,140,179,73,27,6,74,83,652,13.9
130,Reed Timmer\reed-timmer-1,2017-18,Drake,G,34,33,1134,188,422,.445,95,197,.482,93,225,.413,183,212,.863,18,103,121,79,21,3,65,57,652,13.4
131,Jermaine Marrow\jermaine-marrow-1,2017-18,Hampton,G,34,33,1175,228,573,.398,187,434,.431,41,139,.295,153,192,.797,31,139,170,184,43,1,117,88,650,12.0
132,Martaveous McKnight\martaveous-mcknight-1,2017-18,Arkansas-Pine Bluff,G,35,34,1194,217,480,.452,153,298,.513,64,182,.352,152,210,.724,16,134,150,124,68,5,92,31,650,13.8
133,Ge'Lawn Guyn\gelawn-guyn-1,2015-16,East Tennessee State,G,35,35,1141,220,509,.432,126,286,.441,94,223,.422,115,153,.752,21,120,141,65,39,27,68,74,649,12.1
134,Ike Smith\ike-smith-1,2016-17,Georgia Southern,G,33,33,1005,230,461,.499,169,307,.550,61,154,.396,127,195,.651,35,137,172,56,47,21,72,74,648,13.8
135,K.T. Harrell\kt-harrell-1,2014-15,Auburn,G,35,35,1156,194,428,.453,96,202,.475,98,226,.434,162,199,.814,32,72,104,52,33,2,86,80,648,11.7
136,Jeff Short\jeffrey-short-1,2014-15,Norfolk State,G,34,33,1153,212,426,.498,143,251,.570,69,175,.394,155,189,.820,24,118,142,66,32,14,96,63,648,12.9
137,Andrew Rowsey\andrew-rowsey-1,2013-14,North Carolina-Asheville,G,32,32,1156,202,471,.429,96,209,.459,106,262,.405,138,165,.836,14,104,118,94,42,3,102,63,648,12.9
138,Jordan Downing\jordan-downing-1,2013-14,Presbyterian,G,32,32,1191,235,541,.434,155,323,.480,80,218,.367,97,119,.815,21,123,144,60,32,12,72,67,647,12.1
139,Shamorie Ponds\shamorie-ponds-1,2017-18,St. John's (NY),G,30,30,1110,225,536,.420,178,350,.509,47,186,.253,150,175,.857,36,115,151,142,70,3,82,53,647,16.0
140,Deonte Burton\deonte-burton-1,2013-14,Nevada,G,32,31,1236,215,456,.471,166,300,.553,49,156,.314,164,221,.742,12,125,137,142,48,17,65,71,643,15.6
141,Joe Young\joseph-young-1,2013-14,Oregon,G,34,34,1059,206,429,.480,130,246,.528,76,183,.415,155,176,.881,26,70,96,66,44,1,39,47,643,14.4
142,Damon Lynn\damon-lynn-1,2015-16,NJIT,G,35,35,1323,196,524,.374,80,174,.460,116,350,.331,134,161,.832,11,95,106,114,56,2,71,44,642,12.2
143,T.J. Williams\tj-williams-4,2016-17,Northeastern,G,30,28,1145,202,436,.463,166,328,.506,36,108,.333,202,265,.762,23,118,141,158,31,4,101,67,642,15.4
144,Quinton Hooker\quinton-hooker-1,2015-16,North Dakota,G,32,31,1136,211,433,.487,160,300,.533,51,133,.383,169,197,.858,37,119,156,112,60,8,58,72,642,16.6
145,Jalan West\jalan-west-1,2014-15,Northwestern State,G,32,32,1104,193,423,.456,107,219,.489,86,204,.422,169,196,.862,18,122,140,246,66,11,90,63,641,18.5
146,Nigel Williams-Goss\nigel-williams-goss-1,2016-17,Gonzaga,G,38,38,1248,220,453,.486,177,336,.527,43,117,.368,157,181,.867,22,205,227,179,64,3,81,60,640,14.9
147,Jared Brownridge\jared-brownridge-1,2015-16,Santa Clara,G,31,31,1110,195,491,.397,104,255,.408,91,236,.386,159,191,.832,11,87,98,72,22,6,58,67,640,12.5
148,J.J. Frazier\jj-frazier-1,2016-17,Georgia,G,34,34,1178,199,490,.406,144,309,.466,55,181,.304,187,211,.886,12,117,129,141,63,4,80,81,640,13.6
149,Jevon Carter\jevon-carter-1,2017-18,West Virginia,G,37,37,1283,215,509,.422,138,313,.441,77,196,.393,133,155,.858,29,143,172,246,112,13,98,111,640,15.5
150,Marcus Foster\marcus-foster-1,2016-17,Creighton,G,35,35,1081,245,531,.461,172,318,.541,73,213,.343,75,107,.701,9,92,101,85,22,2,78,68,638,10.4
151,Robert Gray Jr.\robert-grayjr-1,2016-17,Houston,G,31,29,1002,233,492,.474,170,328,.518,63,164,.384,109,134,.813,33,83,116,91,37,5,70,57,638,14.1
152,Max Landis\max-landis-1,2015-16,Purdue-Fort Wayne,G,33,33,1228,196,433,.453,71,159,.447,125,274,.456,121,149,.812,5,65,70,121,30,1,72,44,638,13.7
153,Matt Mooney\matt-mooney-1,2017-18,South Dakota,G,34,34,1040,227,510,.445,151,294,.514,76,216,.352,107,129,.829,22,116,138,105,67,4,82,67,637,13.1
154,Glenn Cosey\glenn-cosey-1,2013-14,Eastern Kentucky,G,34,34,1234,187,435,.430,72,165,.436,115,270,.426,148,176,.841,20,89,109,142,42,2,63,59,637,14.5
155,Patrick Cole\patrick-cole-1,2016-17,North Carolina Central,G,33,30,1166,203,529,.384,137,335,.409,66,194,.340,164,217,.756,39,191,230,184,31,8,124,79,636,12.7
156,Peter Jok\peter-jok-1,2016-17,Iowa,G,32,32,983,199,466,.427,115,245,.469,84,221,.380,154,169,.911,31,146,177,84,34,3,81,70,636,13.6
157,Elijah Bryant\elijah-bryant-1,2017-18,Brigham Young,G,35,34,1215,202,409,.494,117,204,.574,85,205,.415,147,173,.850,16,206,222,81,44,19,80,83,636,14.1
158,Egor Koulechov\egor-koulechov-1,2016-17,Rice,G,35,35,1201,208,439,.474,127,268,.474,81,171,.474,138,169,.817,63,247,310,75,29,11,71,70,635,14.5
159,Zane Martin\zane-martin-1,2017-18,Towson,G,32,32,966,226,493,.458,155,306,.507,71,187,.380,112,161,.696,18,95,113,85,25,6,76,66,635,12.1
160,Matt Mooney\matt-mooney-1,2016-17,South Dakota,G,34,34,1059,222,483,.460,146,276,.529,76,207,.367,114,159,.717,14,138,152,71,76,5,86,65,634,12.8
161,Gary Blackston\gary-blackston-1,2017-18,Prairie View,G,33,29,1064,217,494,.439,173,371,.466,44,123,.358,156,217,.719,48,128,176,116,51,3,100,110,634,12.5
162,Xavier Thames\xavier-thames-1,2013-14,San Diego State,G,36,36,1126,188,457,.411,127,294,.432,61,163,.374,196,235,.834,21,83,104,116,59,5,51,71,633,13.2
163,Keenan Evans\keenan-evans-1,2017-18,Texas Tech,G,36,35,1063,194,412,.471,146,262,.557,48,150,.320,197,241,.817,11,98,109,116,41,11,70,65,633,13.2
164,Collin Sexton\collin-sexton-1,2017-18,Alabama,G,33,32,987,196,438,.447,152,307,.495,44,131,.336,196,252,.778,34,90,124,119,28,3,92,81,632,12.8
165,Brandon Goodwin\brandon-goodwin-1,2017-18,Florida Gulf Coast,G,34,33,1135,223,474,.470,181,321,.564,42,153,.275,144,192,.750,38,150,188,162,46,4,100,53,632,14.2
166,A.J. English\aj-english-1,2015-16,Iona,G,28,28,1005,190,439,.433,96,185,.519,94,254,.370,158,189,.836,15,126,141,174,44,14,101,60,632,17.4
167,David Brown\david-brown-2,2013-14,Western Michigan,G,33,33,1123,176,428,.411,96,181,.530,80,247,.324,199,258,.771,19,98,117,61,47,5,92,93,631,11.7
168,Matt Morgan\matt-morgan-1,2017-18,Cornell,G,28,28,969,204,415,.492,129,212,.608,75,203,.369,147,180,.817,11,118,129,90,23,9,69,48,630,16.3
169,Nik Stauskas\nik-stauskas-1,2013-14,Michigan,G,36,36,1281,185,394,.470,93,186,.500,92,208,.442,168,204,.824,15,90,105,118,20,11,67,47,630,13.2
170,Demontrae Jefferson\demontrae-jefferson-1,2017-18,Texas Southern,G,27,27,1016,207,493,.420,122,277,.440,85,216,.394,130,158,.823,18,66,84,123,36,0,85,68,629,14.7
171,Brandon Goodwin\brandon-goodwin-1,2016-17,Florida Gulf Coast,G,34,34,1073,219,428,.512,164,272,.603,55,156,.353,136,172,.791,28,126,154,139,41,2,72,72,629,14.7
172,Roddy Peters\roddy-peters-1,2017-18,Nicholls State,G,32,10,858,229,445,.515,218,407,.536,11,38,.289,160,210,.762,28,160,188,135,44,6,121,79,629,14.0
173,Melvin Johnson\melvin-johnson-2,2015-16,Virginia Commonwealth,G,36,36,1134,224,536,.418,114,246,.463,110,290,.379,70,86,.814,21,75,96,78,45,2,54,47,628,11.2
174,Jonathan Williams\jonathan-williams-2,2016-17,Toledo,G,32,30,1097,212,479,.443,146,272,.537,66,207,.319,138,169,.817,22,75,97,102,25,4,87,67,628,12.1
175,Andrew White III\andrew-whiteiii-1,2016-17,Syracuse,G,34,34,1266,199,453,.439,87,173,.503,112,280,.400,118,141,.837,28,130,158,38,55,12,56,72,628,13.1
176,Jerian Grant\jerian-grant-1,2014-15,Notre Dame,G,38,38,1408,204,427,.478,154,269,.572,50,158,.316,170,218,.780,13,102,115,253,63,19,82,75,628,15.1
177,Jaylen Barford\jaylen-barford-1,2017-18,Arkansas,G,35,35,1094,224,477,.470,137,275,.498,87,202,.431,93,129,.721,35,102,137,89,35,10,67,88,628,12.2
178,Nisre Zouzoua\nisre-zouzoua-1,2016-17,Bryant,G,31,26,1102,208,507,.410,116,257,.451,92,250,.368,120,156,.769,29,100,129,48,45,13,59,83,628,12.5
179,Jordan Adams\jordan-adams-1,2013-14,UCLA,G,36,36,1082,208,429,.485,156,283,.551,52,146,.356,158,189,.836,67,125,192,84,95,5,54,78,626,15.4
180,Ethan Telfair\ethan-telfair-1,2015-16,Idaho State,G,31,29,1108,179,450,.398,116,287,.404,63,163,.387,205,236,.869,27,96,123,167,74,4,112,78,626,15.1
181,Jeremy Senglin\jeremy-senglin-1,2015-16,Weber State,G,35,35,1220,212,435,.487,106,191,.555,106,244,.434,95,154,.617,12,110,122,97,23,3,77,62,625,11.8
182,Olivier Hanlan\olivier-hanlan-1,2014-15,Boston College,G,32,31,1204,225,496,.454,160,312,.513,65,184,.353,110,145,.759,24,111,135,135,41,1,85,68,625,13.4
183,David Nichols\david-nichols-1,2016-17,Albany (NY),G,35,34,1182,248,560,.443,197,416,.474,51,144,.354,78,94,.830,14,107,121,111,43,3,93,97,625,10.2
184,Brandon Ingram\brandon-ingram-1,2015-16,Duke,G,36,34,1246,214,484,.442,134,289,.464,80,195,.410,116,170,.682,67,177,244,72,41,49,72,74,624,13.1
185,Lawrence Alexander\lawrence-alexander-1,2014-15,North Dakota State,G,33,33,1271,203,472,.430,99,236,.419,104,236,.441,114,141,.809,14,136,150,56,29,7,65,45,624,12.3
186,Denzel Livingston\denzel-livingston-1,2014-15,Incarnate Word,G,29,28,1071,190,418,.455,144,284,.507,46,134,.343,198,246,.805,43,129,172,85,74,38,80,86,624,17.3
187,LaVell Boyd\lavell-boyd-1,2016-17,Missouri-Kansas City,G,35,35,1086,189,461,.410,102,245,.416,87,216,.403,158,190,.832,19,123,142,136,37,1,89,95,623,12.0
188,Carrington Love\carrington-love-1,2015-16,Green Bay,G,36,35,1174,204,485,.421,119,240,.496,85,245,.347,130,218,.596,20,78,98,129,94,10,61,68,623,13.1
189,Jordan Howard\jordan-howard-2,2016-17,Central Arkansas,G,32,31,1098,189,439,.431,88,212,.415,101,227,.445,144,162,.889,9,107,116,93,36,2,80,34,623,13.5
190,Kyle Allman\kyle-allman-1,2017-18,Cal State Fullerton,G,32,30,1053,198,405,.489,153,300,.510,45,105,.429,182,244,.746,11,100,111,75,36,6,74,68,623,13.2
191,Obi Emegano\obi-emegano-2,2014-15,Oral Roberts,G,34,34,1168,194,434,.447,165,359,.460,29,75,.387,205,260,.788,26,134,160,76,57,6,87,70,622,12.7
192,Zeek Woodley\zikiteran-woodley-1,2015-16,Northwestern State,G,28,28,925,216,407,.531,159,267,.596,57,140,.407,133,150,.887,47,98,145,44,27,16,55,67,622,16.7
193,Cameron Young\cameron-young-1,2017-18,Quinnipiac,G,33,32,1124,187,443,.422,123,232,.530,64,211,.303,184,244,.754,61,165,226,91,43,10,93,85,622,13.4
194,Derrick Marks\derrick-marks-1,2014-15,Boise State,G,32,32,998,231,468,.494,163,312,.522,68,156,.436,91,118,.771,16,102,118,96,59,14,68,72,621,14.3
195,Joe Chealey\joe-chealey-1,2016-17,College of Charleston,G,35,33,1184,174,404,.431,109,238,.458,65,166,.392,208,253,.822,16,107,123,111,35,1,60,82,621,13.0
196,Jordan Davis\jordan-davis-2,2017-18,Northern Colorado,G,38,37,1103,236,458,.515,220,391,.563,16,67,.239,132,207,.638,40,143,183,121,36,15,118,104,620,10.7
197,Jaylen Adams\jaylen-adams-1,2016-17,St. Bonaventure,G,30,29,1123,168,401,.419,91,185,.492,77,216,.356,206,251,.821,18,94,112,195,62,5,103,84,619,16.5
198,Chandler Hutchison\chandler-hutchison-1,2017-18,Boise State,G,31,31,961,205,432,.475,159,304,.523,46,128,.359,163,224,.728,27,211,238,107,46,8,104,74,619,14.5
199,Isaiah Whitehead\isaiah-whitehead-1,2015-16,Seton Hall,G,34,33,1098,194,512,.379,113,290,.390,81,222,.365,149,196,.760,18,104,122,173,40,49,119,78,618,12.0
200,Josh Hart\josh-hart-1,2015-16,Villanova,G,40,39,1255,230,448,.513,175,294,.595,55,154,.357,103,137,.752,74,196,270,77,46,10,66,87,618,12.5
201,Nick Johnson\nick-johnson-1,2013-14,Arizona,G,38,38,1257,205,474,.432,143,305,.469,62,169,.367,146,187,.781,31,123,154,107,43,25,64,76,618,11.9
202,Joel Berry\joel-berry-1,2017-18,North Carolina,G,36,36,1193,208,525,.396,115,255,.451,93,270,.344,108,121,.893,20,107,127,116,42,12,68,58,617,11.5
203,Anthony Beane\anthony-beane-1,2015-16,Southern Illinois,G,32,32,1097,208,481,.432,136,287,.474,72,194,.371,129,167,.772,22,101,123,57,36,0,86,88,617,10.9
204,Lamar Patterson\lamar-patterson-1,2013-14,Pittsburgh,G,36,36,1174,202,458,.441,122,252,.484,80,206,.388,132,175,.754,35,140,175,154,51,12,93,73,616,13.1
205,Thomas Wilder\thomas-wilder-1,2016-17,Western Michigan,G,32,32,1014,197,430,.458,134,288,.465,63,142,.444,159,191,.832,14,123,137,121,42,12,64,78,616,14.6
206,Ky Bowman\ky-bowman-1,2017-18,Boston College,G,35,35,1337,220,521,.422,140,300,.467,80,221,.362,96,119,.807,29,210,239,165,51,12,112,90,616,12.6
207,Quinton Hooker\quinton-hooker-1,2016-17,North Dakota,G,32,31,1156,202,432,.468,118,243,.486,84,189,.444,128,148,.865,24,122,146,115,56,5,56,69,616,15.5
208,Matt Mobley\matt-mobley-1,2017-18,St. Bonaventure,G,34,32,1277,187,447,.418,82,165,.497,105,282,.372,137,159,.862,20,149,169,83,38,4,82,87,616,12.1
209,Derrick White\derrick-white-1,2016-17,Colorado,G,34,32,1116,205,404,.507,148,260,.569,57,144,.396,148,182,.813,35,104,139,148,42,49,81,73,615,15.5
210,Terry Rozier\terry-rozier-1,2014-15,Louisville,G,36,35,1260,214,521,.411,166,364,.456,48,157,.306,139,176,.790,43,157,200,108,72,6,79,62,615,12.4
211,Malcolm Hill\malcolm-hill-1,2015-16,Illinois,G,34,33,1195,192,440,.436,155,322,.481,37,118,.314,193,235,.821,43,180,223,112,42,15,75,88,614,13.8
212,DeAndre Kane\deandre-kane-1,2013-14,Iowa State,G,36,36,1240,208,431,.483,165,323,.511,43,108,.398,155,244,.635,49,196,245,213,44,10,104,79,614,14.4
213,Thomas Walkup\thomas-walkup-1,2015-16,Stephen F. Austin,G,34,34,1002,217,369,.588,207,330,.627,10,39,.256,170,208,.817,79,154,233,153,71,16,58,93,614,18.3
214,Torian Graham\torian-graham-1,2016-17,Arizona State,G,33,23,1147,230,513,.448,122,234,.521,108,279,.387,46,56,.821,19,120,139,39,31,11,44,51,614,11.9
215,Keifer Sykes\keifer-sykes-1,2014-15,Green Bay,G,33,33,1156,213,471,.452,167,323,.517,46,148,.311,142,182,.780,25,123,148,129,55,5,71,72,614,13.8
216,Jahii Carson\jahii-carson-1,2013-14,Arizona State,G,33,33,1168,211,487,.433,175,395,.443,36,92,.391,156,217,.719,24,109,133,153,23,2,116,72,614,11.2
217,Desmar Jackson\desmar-jackson-1,2013-14,Southern Illinois,G,33,33,1087,212,455,.466,190,373,.509,22,82,.268,167,214,.780,50,133,183,68,80,14,98,92,613,13.3
218,Mikh McKinney\mikh-mckinney-1,2014-15,Sacramento State,G,32,32,1183,219,432,.507,154,281,.548,65,151,.430,110,137,.803,16,75,91,156,78,4,68,57,613,16.3
219,Fletcher Magee\fletcher-magee-1,2016-17,Wofford,G,33,32,1099,196,448,.438,84,183,.459,112,265,.423,109,122,.893,9,98,107,58,23,4,55,45,613,12.2
220,Grant Riller\grant-riller-1,2017-18,College of Charleston,G,33,32,1110,230,422,.545,174,280,.621,56,142,.394,97,133,.729,13,78,91,67,42,14,64,69,613,13.2
221,Jawun Evans\jawun-evans-1,2016-17,Oklahoma State,G,32,32,936,211,482,.438,175,387,.452,36,95,.379,155,191,.812,24,86,110,204,57,4,90,74,613,14.7
222,Max Heidegger\max-heidegger-1,2017-18,UC-Santa Barbara,G,32,30,1053,195,451,.432,100,216,.463,95,235,.404,127,166,.765,11,68,79,79,19,2,50,69,612,12.0
223,Jordan Clarkson\jordan-clarkson-1,2013-14,Missouri,G,35,35,1228,209,467,.448,177,353,.501,32,114,.281,162,195,.831,28,106,134,118,38,6,93,76,612,11.7
224,Akeem Richmond\akeem-richmond-1,2013-14,East Carolina,G,34,34,1199,181,451,.401,26,59,.441,155,392,.395,95,112,.848,20,75,95,54,45,1,57,40,612,12.0
225,Joe Chealey\joe-chealey-1,2017-18,College of Charleston,G,34,34,1202,169,430,.393,107,252,.425,62,178,.348,211,246,.858,22,136,158,122,29,4,59,78,611,13.1
226,C.J. Massinburg\cj-massinburg-1,2017-18,Buffalo,G,36,35,1223,196,419,.468,107,199,.538,89,220,.405,130,175,.743,80,184,264,87,40,16,58,75,611,14.3
227,Buddy Hield\buddy-hield-1,2014-15,Oklahoma,G,35,35,1135,205,498,.412,112,239,.469,93,259,.359,107,130,.823,56,134,190,67,47,8,68,61,610,12.0
228,Ehab Amin\ehab-amin-1,2016-17,Texas A&M-Corpus Christi,G,36,34,1213,225,487,.462,182,338,.538,43,149,.289,116,162,.716,71,166,237,105,124,13,99,102,609,14.1
229,Nick Faust\nick-faust-1,2015-16,Cal State Long Beach,G,35,33,1082,205,470,.436,119,235,.506,86,235,.366,113,165,.685,50,162,212,78,51,17,81,90,609,12.2
230,Ronshad Shabazz\ronshad-shabazz-1,2017-18,Appalachian State,G,33,33,1079,206,515,.400,126,282,.447,80,233,.343,117,170,.688,19,64,83,100,36,2,79,58,609,10.5
231,Derrick Colter\derrick-colter-1,2015-16,Duquesne,G,34,33,1220,193,479,.403,113,246,.459,80,233,.343,143,173,.827,17,105,122,156,34,7,108,67,609,11.6
232,Marcus Posley\marcus-posley-1,2015-16,St. Bonaventure,G,31,31,1154,197,471,.418,115,243,.473,82,228,.360,133,165,.806,21,85,106,113,39,3,75,76,609,12.9
233,Jarekious Bradley\jarekious-bradley-1,2013-14,Southeast Missouri State,G,32,25,1003,218,438,.498,143,237,.603,75,201,.373,97,125,.776,48,153,201,52,38,30,57,95,608,14.3
234,Keifer Sykes\keifer-sykes-1,2013-14,Green Bay,G,30,30,1029,195,416,.469,165,319,.517,30,97,.309,188,232,.810,22,111,133,147,37,0,64,52,608,16.0
235,Mark Alstork\mark-alstork-1,2016-17,Wright State,G,32,30,965,181,452,.400,111,271,.410,70,181,.387,176,208,.846,26,124,150,112,25,19,136,92,608,11.0
236,Cameron Morse\cameron-morse-1,2015-16,Youngstown State,G,30,20,1006,201,427,.471,137,272,.504,64,155,.413,142,175,.811,10,72,82,92,46,2,52,47,608,14.9
237,Reger Dowell\reger-dowell-1,2013-14,Texas-Arlington,G,30,26,928,194,479,.405,98,208,.471,96,271,.354,124,162,.765,8,67,75,66,21,2,74,74,608,10.9
238,Micah Mason\micah-mason-1,2015-16,Duquesne,G,33,32,1177,207,441,.469,89,162,.549,118,279,.423,76,91,.835,7,94,101,148,31,2,69,63,608,13.7
239,C.J. Bryce\cj-bryce-1,2016-17,North Carolina-Wilmington,G,35,34,1199,231,477,.484,189,350,.540,42,127,.331,104,153,.680,60,130,190,104,33,7,66,80,608,12.6
240,Josh Robinson\josh-robinson-3,2015-16,Austin Peay,G,36,36,1228,185,462,.400,113,250,.452,72,212,.340,166,199,.834,14,98,112,92,36,0,97,49,608,10.2
241,Devin Watson\devin-watson-1,2015-16,San Francisco,G,30,30,1041,192,459,.418,127,273,.465,65,186,.349,159,217,.733,9,65,74,146,27,0,89,53,608,12.8
242,Yogi Ferrell\kevin-ferrell-1,2015-16,Indiana,G,35,35,1215,196,428,.458,117,240,.488,79,188,.420,136,164,.829,34,99,133,195,38,1,88,58,607,14.1
243,Tyler Ulis\tyler-ulis-1,2015-16,Kentucky,G,35,35,1288,192,442,.434,137,282,.486,55,160,.344,167,195,.856,19,86,105,246,51,4,69,64,606,15.2
244,Justin James\justin-james-2,2017-18,Wyoming,G,32,32,996,210,445,.472,170,315,.540,40,130,.308,146,201,.726,19,172,191,98,36,16,81,81,606,13.2
245,Juan'ya Green\juanya-green-1,2015-16,Hofstra,G,34,34,1282,173,435,.398,105,247,.425,68,188,.362,192,240,.800,25,123,148,243,56,17,101,78,606,15.1
246,Paul Miller\paul-miller-2,2017-18,North Dakota State,G,31,31,1048,208,461,.451,141,264,.534,67,197,.340,122,146,.836,15,165,180,105,31,10,95,50,605,13.3
247,Quincy McKnight\quincy-mcknight-1,2016-17,Sacred Heart,G,32,31,1040,203,473,.429,176,389,.452,27,84,.321,172,222,.775,26,130,156,95,52,5,148,94,605,10.3
248,Tookie Brown\tookie-brown-1,2017-18,Georgia Southern,G,32,29,1035,189,355,.532,140,251,.558,49,104,.471,177,235,.753,20,110,130,137,56,10,80,79,604,15.7
249,Raiquan Clark\raiquan-clark-1,2017-18,Long Island University,G,35,35,1127,207,372,.556,200,343,.583,7,29,.241,183,244,.750,74,171,245,53,40,14,143,111,604,11.6
250,Ryan Harrow\ryan-harrow-1,2013-14,Georgia State,G,34,34,1152,222,498,.446,192,394,.487,30,104,.288,130,155,.839,23,66,89,144,43,2,57,43,604,13.0
251,Martez Walker\martez-walker-1,2016-17,Oakland,G,34,34,1146,195,446,.437,124,221,.561,71,225,.316,143,172,.831,48,89,137,49,30,12,63,61,604,11.9
252,Tyler Nelson\tyler-nelson-1,2016-17,Fairfield,G,31,30,1119,196,442,.443,115,235,.489,81,207,.391,131,153,.856,23,75,98,112,35,4,69,53,604,13.8
253,Jairus Lyles\jairus-lyles-1,2016-17,Maryland-Baltimore County,G,32,31,1107,210,475,.442,165,334,.494,45,141,.319,139,191,.728,42,169,211,83,54,1,71,50,604,13.6
254,R.J. Hunter\rj-hunter-1,2013-14,Georgia State,G,33,32,1106,181,408,.444,81,155,.523,100,253,.395,142,161,.882,11,140,151,57,63,31,39,77,604,14.8
255,D.J. Newbill\dj-newbill-1,2013-14,Penn State,G,34,34,1171,209,462,.452,163,321,.508,46,141,.326,140,186,.753,61,106,167,58,27,11,72,96,604,11.3
256,Thomas Wilder\thomas-wilder-1,2017-18,Western Michigan,G,32,32,1050,191,443,.431,144,298,.483,47,145,.324,174,207,.841,23,118,141,138,62,10,79,72,603,14.5
257,Dwayne Bacon\dwayne-bacon-1,2016-17,Florida State,G,35,35,1008,221,489,.452,164,318,.516,57,171,.333,104,138,.754,35,112,147,61,35,4,71,55,603,10.9
258,Nick Dixon\nick-dixon-1,2016-17,Texas-Rio Grande Valley,G,32,28,877,201,386,.521,173,300,.577,28,86,.326,173,226,.765,49,113,162,109,60,2,93,75,603,14.8
259,Malcolm Hill\malcolm-hill-1,2016-17,Illinois,G,35,35,1164,189,435,.434,124,252,.492,65,183,.355,160,204,.784,35,145,180,102,42,13,66,74,603,12.9
260,Khalil Small\khalil-small-1,2017-18,Green Bay,G,33,31,1130,201,454,.443,148,316,.468,53,138,.384,147,177,.831,69,153,222,110,43,4,88,85,602,13.6
261,Devin Sibley\devin-sibley-1,2016-17,Furman,G,34,33,1093,201,385,.522,122,209,.584,79,176,.449,121,162,.747,9,131,140,78,26,7,91,68,602,12.0
262,Langston Galloway\langston-galloway-1,2013-14,Saint Joseph's,G,34,34,1231,190,428,.444,82,184,.446,108,244,.443,114,138,.826,28,117,145,53,36,17,28,81,602,13.2
263,James Sinclair\james-sinclair-1,2014-15,Western Carolina,G,31,31,1180,214,532,.402,163,370,.441,51,162,.315,122,159,.767,58,129,187,90,67,14,76,65,601,13.4
264,De'Aaron Fox\deaaron-fox-1,2016-17,Kentucky,G,36,34,1064,214,448,.478,197,379,.520,17,69,.246,156,211,.739,20,122,142,165,53,7,87,90,601,12.6
265,Stephan Hicks\stephen-hicks-1,2013-14,Cal State Northridge,G,35,35,1198,206,397,.519,196,364,.538,10,33,.303,179,218,.821,73,164,237,37,47,10,55,86,601,13.7
266,Jalan West\jalan-west-1,2013-14,Northwestern State,G,31,29,1021,184,397,.463,114,226,.504,70,171,.409,163,186,.876,14,111,125,197,78,8,84,75,601,17.4
267,Keon Johnson\keon-johnson-1,2015-16,Winthrop,G,32,31,1100,178,394,.452,100,196,.510,78,198,.394,165,198,.833,17,116,133,81,29,0,69,62,599,13.1
268,Trey Davis\trey-davis-1,2015-16,Massachusetts,G,32,32,1087,184,470,.391,101,243,.416,83,227,.366,148,169,.876,20,127,147,103,38,4,91,64,599,12.0
269,Marcus Thornton\marcus-thornton-3,2013-14,William & Mary,G,32,30,1139,195,448,.435,102,217,.470,93,231,.403,116,149,.779,7,66,73,90,34,7,76,57,599,11.8
270,Juwan Staten\juwan-staten-1,2013-14,West Virginia,G,33,33,1231,205,423,.485,199,408,.488,6,15,.400,182,253,.719,28,158,186,193,41,3,69,52,598,15.5
271,Allonzo Trier\allonzo-trier-1,2017-18,Arizona,G,33,33,1124,184,368,.500,114,184,.620,70,184,.380,160,185,.865,11,89,100,107,21,11,70,57,598,13.6
272,Quinn Cook\quinn-cook-1,2014-15,Duke,G,39,39,1396,199,439,.453,97,181,.536,102,258,.395,98,110,.891,15,116,131,103,39,1,47,76,598,11.4
273,Travis Trice\travis-trice-1,2014-15,Michigan State,G,39,33,1309,195,491,.397,105,247,.425,90,244,.369,118,165,.715,18,105,123,197,40,6,69,70,598,11.4
274,Tre'Shaun Fletcher\treshaun-fletcher-1,2017-18,Toledo,G,33,33,1087,205,443,.463,156,303,.515,49,140,.350,139,195,.713,59,205,264,142,27,7,79,75,598,14.3
275,Eric Eaves\eric-eaves-1,2015-16,South Carolina State,G,34,8,961,196,376,.521,170,304,.559,26,72,.361,180,236,.763,26,69,95,66,27,8,79,69,598,11.8
276,Kay Felder\kahlil-felder-1,2014-15,Oakland,G,33,32,1272,183,434,.422,136,295,.461,47,139,.338,185,224,.826,25,133,158,252,66,8,137,83,598,14.8
277,Denzel Mahoney\denzel-mahoney-1,2017-18,Southeast Missouri State,G,31,30,970,176,380,.463,112,225,.498,64,155,.413,182,218,.835,45,113,158,39,28,5,51,91,598,13.7
278,Andrew Wiggins\andrew-wiggins-1,2013-14,Kansas,G,35,35,1148,189,422,.448,146,296,.493,43,126,.341,176,227,.775,76,129,205,54,41,34,80,94,597,12.4
279,Jimmy Gavin\jimmy-gavin-1,2015-16,Winthrop,G,32,31,1080,196,410,.478,102,181,.564,94,229,.410,111,134,.828,16,78,94,95,26,2,66,57,597,13.1
280,Rodrick Sikes\rodrick-sikes-1,2017-18,South Alabama,G,32,24,998,178,421,.423,90,183,.492,88,238,.370,153,197,.777,13,86,99,27,30,7,60,60,597,11.3
281,Jared Brownridge\jared-brownridge-1,2016-17,Santa Clara,G,33,32,1223,190,464,.409,84,177,.475,106,287,.369,111,137,.810,9,80,89,93,32,4,55,69,597,11.7
282,Jordan Price\jordan-price-1,2015-16,La Salle,G,31,31,1170,195,500,.390,106,256,.414,89,244,.365,117,163,.718,23,149,172,92,35,13,102,68,596,11.2
283,Marcus Paige\marcus-paige-1,2013-14,North Carolina,G,34,33,1211,191,434,.440,105,213,.493,86,221,.389,128,146,.877,18,91,109,143,51,7,73,68,596,13.4
284,Chavaughn Lewis\chavaughn-lewis-1,2014-15,Marist,G,29,29,1034,203,491,.413,162,349,.464,41,142,.289,149,224,.665,26,129,155,78,67,22,104,71,596,12.6
285,Davion Berry\davion-berry-1,2013-14,Weber State,G,31,31,1031,163,351,.464,102,194,.526,61,157,.389,209,254,.823,13,118,131,122,30,6,86,70,596,14.4
286,Josh Okogie\josh-okogie-1,2016-17,Georgia Tech,G,37,37,1141,194,428,.453,166,355,.468,28,73,.384,180,241,.747,55,146,201,61,48,27,77,94,596,11.5
287,Andrew Rowsey\andrew-rowsey-1,2014-15,North Carolina-Asheville,G,31,31,1010,177,449,.394,75,182,.412,102,267,.382,140,152,.921,19,67,86,89,44,2,70,67,596,12.6
288,Anthony Ireland\anthony-ireland-1,2013-14,Loyola Marymount,G,32,32,1127,192,470,.409,150,336,.446,42,134,.313,170,208,.817,39,80,119,173,53,3,90,76,596,13.6
289,Angelo Warner\angelo-warner-1,2013-14,Morehead State,G,34,34,1184,183,410,.446,127,238,.534,56,172,.326,174,212,.821,54,109,163,103,67,10,89,96,596,13.4
290,Denzel Valentine\denzel-valentine-1,2015-16,Michigan State,G,31,30,1022,205,444,.462,101,210,.481,104,234,.444,81,95,.853,25,208,233,241,32,7,85,52,595,17.4
291,QJ Peterson\qj-peterson-1,2015-16,Virginia Military Institute,G,30,27,1006,189,467,.405,106,237,.447,83,230,.361,134,148,.905,49,140,189,83,42,15,82,67,595,13.9
292,Corey Walden\corey-walden-2,2014-15,Eastern Kentucky,G,32,31,1108,198,362,.547,147,222,.662,51,140,.364,147,180,.817,27,100,127,123,99,5,71,79,594,16.9
293,Kori Babineaux\kori-babineaux-1,2015-16,Jacksonville,G,32,32,1149,257,549,.468,248,516,.481,9,33,.273,71,113,.628,22,133,155,123,31,5,90,75,594,11.0
294,Kellan Grady\kellan-grady-1,2017-18,Davidson,G,33,32,1163,219,437,.501,146,241,.606,73,196,.372,82,102,.804,23,85,108,64,27,3,32,68,593,12.8
295,Matt Mobley\matt-mobley-1,2016-17,St. Bonaventure,G,32,30,1226,176,419,.420,90,192,.469,86,227,.379,155,180,.861,16,171,187,82,50,10,74,78,593,13.5
296,Dewayne Russell\dewayne-russell-1,2016-17,Grand Canyon,G,28,27,1072,197,492,.400,145,361,.402,52,131,.397,147,194,.758,13,92,105,151,41,4,75,60,593,14.1
297,Ahmad Thomas\ahmad-thomas-1,2016-17,North Carolina-Asheville,G,33,32,1088,243,447,.544,206,366,.563,37,81,.457,70,123,.569,46,159,205,77,99,16,69,85,593,15.1
298,Sidney Sanders\sidney-sanders-1,2013-14,Fairleigh Dickinson,G,31,31,1041,202,486,.416,171,397,.431,31,89,.348,158,210,.752,32,85,117,181,67,0,78,84,593,14.3
299,Keon Moore\keon-moore-1,2014-15,Winthrop,G,32,32,1058,188,424,.443,87,190,.458,101,234,.432,116,135,.859,25,141,166,56,44,8,59,62,593,13.4
300,Justin James\justin-james-2,2016-17,Wyoming,G,37,6,974,198,428,.463,149,311,.479,49,117,.419,147,193,.762,43,141,184,80,29,20,92,95,592,10.7
301,Vasa Pusica\vasa-pusica-1,2017-18,Northeastern,G,33,33,1132,189,375,.504,113,197,.574,76,178,.427,138,171,.807,9,111,120,168,36,4,113,74,592,13.5
302,Ryan Boatright\ryan-boatright-1,2014-15,Connecticut,G,34,34,1216,182,430,.423,96,221,.434,86,209,.411,142,167,.850,15,124,139,129,46,8,81,64,592,12.8
303,Olivier Hanlan\olivier-hanlan-1,2013-14,Boston College,G,32,31,1160,173,387,.447,112,211,.531,61,176,.347,185,228,.811,12,98,110,93,25,2,78,82,592,12.2
304,David Walker\david-walker-3,2015-16,Northeastern,G,33,32,1263,179,399,.449,82,164,.500,97,235,.413,136,157,.866,19,108,127,131,47,12,62,30,591,15.0
305,Maodo Lo\maodo-lo-1,2015-16,Columbia,G,35,35,1144,212,467,.454,116,210,.552,96,257,.374,71,101,.703,27,108,135,100,78,14,75,73,591,12.6
306,Norman Powell\norman-powell-1,2014-15,UCLA,G,36,36,1244,213,467,.456,175,348,.503,38,119,.319,127,169,.751,21,148,169,75,66,16,80,91,591,11.2
307,Trey Freeman\trey-freeman-2,2014-15,Old Dominion,G,35,35,1131,221,502,.440,174,370,.470,47,132,.356,102,140,.729,20,132,152,125,46,4,59,54,591,12.1
308,Josh Robinson\josh-robinson-3,2016-17,Austin Peay,G,29,28,1062,187,426,.439,116,232,.500,71,194,.366,145,176,.824,10,76,86,101,28,4,74,55,590,13.4
309,Stuckey Mosley\stuckey-mosley-1,2017-18,James Madison,G,32,32,1140,199,482,.413,114,251,.454,85,231,.368,107,127,.843,24,119,143,68,46,7,63,80,590,11.9
310,Barry Brown\barry-brown-1,2017-18,Kansas State,G,37,37,1285,203,453,.448,161,321,.502,42,132,.318,142,184,.772,22,94,116,120,67,5,95,81,590,11.0
311,QJ Peterson\qj-peterson-1,2016-17,Virginia Military Institute,G,30,28,951,200,464,.431,122,252,.484,78,212,.368,111,156,.712,51,143,194,73,47,2,77,61,589,13.4
312,Rashawn Rembert\rashawn-rembert-1,2013-14,East Tennessee State,G,35,35,1262,182,405,.449,74,151,.490,108,254,.425,117,139,.842,29,78,107,61,43,12,54,49,589,12.4
313,Victor Sanders\victor-sanders-1,2017-18,Idaho,G,31,31,953,182,398,.457,101,189,.534,81,209,.388,144,185,.778,18,89,107,102,32,15,97,78,589,12.6
314,Derrick Walton\derrick-walton-1,2016-17,Michigan,G,38,37,1323,171,392,.436,73,160,.456,98,232,.422,149,170,.876,17,165,182,188,43,1,66,66,589,13.7
315,Daniel Mullings\daniel-mullings-1,2013-14,New Mexico State,G,35,35,1173,201,431,.466,183,366,.500,18,65,.277,168,231,.727,50,123,173,123,65,16,90,87,588,12.9
316,Jon Davis\jon-davis-1,2016-17,Charlotte,G,30,30,1056,196,407,.482,147,278,.529,49,129,.380,147,188,.782,9,94,103,126,33,8,94,48,588,13.8
317,Jalen Riley\jalen-riley-1,2014-15,East Tennessee State,G,29,7,798,165,426,.387,85,212,.401,80,214,.374,177,214,.827,12,54,66,77,49,2,82,95,587,12.0
318,Tramaine Isabell\tramaine-isabell-1,2017-18,Drexel,G,28,20,963,202,426,.474,152,279,.545,50,147,.340,133,174,.764,30,180,210,96,34,0,80,52,587,15.3
319,Zach Lofton\zach-lofton-1,2016-17,Texas Southern,G,35,31,1140,185,440,.420,152,312,.487,33,128,.258,184,234,.786,29,105,134,84,47,11,81,100,587,10.8
320,Isiah Umipig\isiah-umipig-1,2013-14,Seattle,G,30,30,993,185,475,.389,79,188,.420,106,287,.369,111,134,.828,19,63,82,107,32,1,98,78,587,11.0
321,James Daniel\james-daniel-1,2013-14,Howard,G,28,26,891,155,421,.368,64,190,.337,91,231,.394,186,233,.798,15,54,69,44,37,1,93,64,587,11.1
322,C.J. Wilcox\cj-wilcox-1,2013-14,Washington,G,32,31,1116,197,435,.453,107,205,.522,90,230,.391,103,118,.873,22,97,119,81,32,32,54,75,587,13.3
323,ShawnDre' Jones\shawndre-jones-1,2016-17,Richmond,G,35,33,1269,198,428,.463,129,252,.512,69,176,.392,122,149,.819,12,61,73,136,32,1,68,76,587,11.8
324,Justin Black\justin-black-1,2013-14,Morgan State,G,31,30,1052,200,442,.452,148,265,.558,52,177,.294,135,225,.600,54,105,159,87,56,2,98,91,587,12.1
325,Daryl Macon\daryl-macon-1,2017-18,Arkansas,G,35,30,1082,174,389,.447,89,187,.476,85,202,.421,154,176,.875,13,88,101,138,36,2,63,62,587,13.1
326,Corey Hawkins\corey-hawkins-1,2014-15,UC-Davis,G,28,28,934,188,374,.503,107,208,.514,81,166,.488,129,157,.822,19,119,138,94,39,6,84,53,586,15.8
327,Ray Lee\ray-lee-2,2014-15,Eastern Michigan,G,35,32,981,190,429,.443,120,235,.511,70,194,.361,136,171,.795,25,42,67,54,50,7,101,78,586,9.7
328,Frank Bartley\frank-bartley-1,2017-18,Louisiana,G,33,32,1014,179,413,.433,92,186,.495,87,227,.383,141,164,.860,21,97,118,65,45,3,63,65,586,12.3
329,Gary Harris\gary-harris-1,2013-14,Michigan State,G,35,34,1131,195,455,.429,114,225,.507,81,230,.352,115,142,.810,37,103,140,94,63,15,60,73,586,12.6
330,Nick Emery\nick-emery-1,2015-16,Brigham Young,G,36,32,1132,203,478,.425,106,225,.471,97,253,.383,82,96,.854,18,108,126,91,52,4,53,100,585,11.0
331,Alec Wintering\alec-wintering-1,2015-16,Portland,G,32,32,1010,182,410,.444,139,302,.460,43,108,.398,177,227,.780,18,88,106,158,49,1,102,87,584,12.9
332,Markel Brown\markel-brown-1,2013-14,Oklahoma State,G,34,34,1201,190,402,.473,135,257,.525,55,145,.379,149,194,.768,36,143,179,99,34,35,55,86,584,13.7
333,Ahmaad Rorie\ahmaad-rorie-1,2017-18,Montana,G,34,34,1218,206,488,.422,147,314,.468,59,174,.339,113,133,.850,32,101,133,125,42,5,67,64,584,12.1
334,Fred Sims Jr.\fred-simsjr-1,2016-17,Chicago State,G,31,30,1069,210,582,.361,139,356,.390,71,226,.314,92,114,.807,22,122,144,45,32,9,69,51,583,9.1
335,Rashad Whack\rashad-whack-1,2013-14,Mount St. Mary's,G,33,30,1098,182,437,.416,99,210,.471,83,227,.366,135,171,.789,30,113,143,43,54,13,70,77,582,11.6
336,Tra Holder\tra-holder-1,2017-18,Arizona State,G,32,32,1124,177,435,.407,108,248,.435,69,187,.369,159,190,.837,30,104,134,110,42,1,78,64,582,12.6
337,Johnny Dee\johnny-dee-2,2013-14,San Diego,G,35,35,1136,184,425,.433,90,200,.450,94,225,.418,120,127,.945,9,88,97,49,38,0,47,57,582,11.2
338,Elijah Brown\elijah-brown-1,2016-17,New Mexico,G,31,28,1000,166,438,.379,98,232,.422,68,206,.330,182,220,.827,13,148,161,95,41,4,95,63,582,11.9
339,Wesley Person\wesley-person-2,2017-18,Troy,G,33,31,1123,174,416,.418,77,160,.481,97,256,.379,137,167,.820,21,75,96,59,24,1,61,63,582,11.1
340,Brynton Lemar\brynton-lemar-1,2016-17,UC-Davis,G,36,36,1189,179,432,.414,99,224,.442,80,208,.385,143,185,.773,22,98,120,95,28,4,64,74,581,10.6
341,Evan Bradds\evan-bradds-1,2016-17,Belmont,G,29,29,925,233,373,.625,229,364,.629,4,9,.444,111,148,.750,56,189,245,68,13,6,83,74,581,15.4
342,Adrian Rodgers\adrian-rogers-2,2015-16,Southern,G,35,35,1131,201,492,.409,121,274,.442,80,218,.367,98,124,.790,35,153,188,47,37,4,58,62,580,10.5
343,Justin Wright-Foreman\justin-wright-foreman-1,2016-17,Hofstra,G,32,17,905,208,422,.493,141,242,.583,67,180,.372,97,127,.764,21,93,114,52,24,2,45,59,580,12.2
344,D'Vauntes Smith-Rivera\dvauntes-smith-rivera-1,2013-14,Georgetown,G,33,32,1172,178,400,.445,112,232,.483,66,168,.393,158,181,.873,43,121,164,90,41,5,57,64,580,13.7
345,Juan'ya Green\juanya-green-1,2014-15,Hofstra,G,34,34,1238,158,414,.382,97,232,.418,61,182,.335,203,246,.825,18,128,146,220,48,9,86,73,580,14.1
346,Demetrius Dyson\demetrius-dyson-1,2016-17,Samford,G,36,36,1110,195,394,.495,109,207,.527,86,187,.460,104,143,.727,36,136,172,40,24,6,79,85,580,10.4
347,Dennis Smith Jr.\dennis-smithjr-1,2016-17,North Carolina State,G,32,32,1114,191,420,.455,136,267,.509,55,153,.359,143,200,.715,26,120,146,197,62,14,108,67,580,14.6
348,Retin Obasohan\retin-obasohan-1,2015-16,Alabama,G,33,33,1067,193,410,.471,145,281,.516,48,129,.372,146,209,.699,19,107,126,87,45,10,82,83,580,11.8
349,Terran Petteway\terran-petteway-1,2013-14,Nebraska,G,32,32,1014,182,427,.426,134,280,.479,48,147,.327,167,204,.819,29,126,155,52,29,24,88,102,579,10.9
350,Mike Brown\mike-brown-5,2015-16,Western Carolina,G,34,34,1167,188,466,.403,144,328,.439,44,138,.319,159,198,.803,75,125,200,110,52,12,108,114,579,11.4
351,Kendrick Ray\kendrick-ray-1,2015-16,Kennesaw State,G,31,30,1059,214,441,.485,173,327,.529,41,114,.360,110,154,.714,44,130,174,85,44,7,76,95,579,13.0
352,Markelle Fultz\markelle-fultz-1,2016-17,Washington,G,25,25,892,209,439,.476,157,313,.502,52,126,.413,109,168,.649,33,110,143,148,39,30,80,63,579,17.8
353,Frank Eaves\frank-eaves-1,2015-16,Appalachian State,G,31,30,965,170,446,.381,87,230,.378,83,216,.384,156,191,.817,20,96,116,68,26,1,70,71,579,11.0
354,Jordan Sibert\jordan-sibert-1,2014-15,Dayton,G,36,35,1215,177,388,.456,97,159,.610,80,229,.349,145,184,.788,8,110,118,71,62,5,65,73,579,11.7
355,Yonel Brown\yonel-brown-1,2015-16,Kennesaw State,G,31,30,1203,198,478,.414,119,261,.456,79,217,.364,103,130,.792,22,83,105,76,35,0,79,61,578,10.9
356,Damon Lynn\damon-lynn-1,2014-15,NJIT,G,33,33,1203,182,499,.365,56,149,.376,126,350,.360,88,114,.772,15,83,98,123,58,2,92,67,578,10.7
357,Semaj Christon\semaj-christon-1,2013-14,Xavier,G,34,34,1200,201,420,.479,182,371,.491,19,49,.388,157,235,.668,15,76,91,142,45,8,89,72,578,11.7
358,Tyler Hall\tyler-hall-2,2015-16,Montana State,G,31,31,993,202,442,.457,106,219,.484,96,223,.430,78,90,.867,26,137,163,51,28,8,56,68,578,12.6
359,Damion Lee\damion-lee-1,2014-15,Drexel,G,27,27,1029,170,388,.438,105,219,.479,65,169,.385,173,195,.887,24,141,165,63,41,9,50,60,578,16.4
360,Reggie Johnson\reggie-johnson-3,2015-16,Hampton,G,32,32,1153,192,519,.370,138,334,.413,54,185,.292,140,194,.722,39,77,116,129,53,3,90,96,578,10.5
361,Devin Patterson\devin-patterson-1,2015-16,Omaha,G,32,31,1046,182,425,.428,124,260,.477,58,165,.352,156,194,.804,12,68,80,101,59,0,85,82,578,11.8
362,Sean Armand\sean-armand-1,2013-14,Iona,G,33,33,1184,190,391,.486,94,174,.540,96,217,.442,101,128,.789,28,78,106,135,39,9,80,93,577,13.2
363,Rodney Pryor\rodney-pryor-1,2016-17,Georgetown,G,32,32,1044,212,440,.482,128,237,.540,84,203,.414,69,94,.734,34,127,161,41,25,22,55,73,577,12.2
364,Michael Bryson\michael-bryson-1,2015-16,UC-Santa Barbara,G,32,32,1080,202,423,.478,130,235,.553,72,188,.383,101,123,.821,51,154,205,78,26,19,81,75,577,13.1
365,Kevin Punter\kevin-punter-1,2015-16,Tennessee,G,26,26,886,177,385,.460,119,228,.522,58,157,.369,165,202,.817,5,84,89,91,36,6,66,73,577,15.4
366,D'Angelo Harrison\dangelo-harrison-1,2014-15,St. John's (NY),G,33,33,1150,178,429,.415,112,250,.448,66,179,.369,155,194,.799,38,143,181,64,37,14,55,114,577,11.9
367,Thomas Wilder\thomas-wilder-1,2015-16,Western Michigan,G,32,32,1018,172,405,.425,127,290,.438,45,115,.391,188,238,.790,21,113,134,98,52,4,66,85,577,12.9
368,Martez Harrison\martez-harrison-1,2014-15,Missouri-Kansas City,G,33,33,1057,176,448,.393,129,280,.461,47,168,.280,178,238,.748,19,60,79,129,60,0,86,89,577,11.2
369,Dyami Starks\dyami-starks-1,2014-15,Bryant,G,31,31,1183,187,496,.377,89,210,.424,98,286,.343,105,115,.913,16,89,105,47,27,7,66,60,577,10.1
370,Isiah Umipig\isiah-umipig-1,2014-15,Seattle,G,34,34,1155,178,440,.405,55,146,.377,123,294,.418,98,116,.845,12,95,107,98,45,0,73,73,577,11.2
371,Jeffrey Carroll\jeffrey-carroll-2,2016-17,Oklahoma State,G,33,21,960,198,369,.537,139,236,.589,59,133,.444,121,150,.807,64,153,217,40,29,5,52,64,576,13.9
372,Anthony Odunsi\anthony-odunsi-1,2015-16,Houston Baptist,G,33,33,950,154,324,.475,141,285,.495,13,39,.333,255,304,.839,26,125,151,122,40,1,116,69,576,13.0
373,Daniel Dixon\daniel-dixon-1,2016-17,William & Mary,G,30,25,884,188,390,.482,115,197,.584,73,193,.378,127,146,.870,26,115,141,75,22,9,67,83,576,13.5
374,Jalen Ross\jalen-ross-1,2016-17,Hartford,G,29,28,1003,173,452,.383,104,260,.400,69,192,.359,161,195,.826,8,92,100,61,37,1,84,41,576,11.3
375,Marquise Moore\marquise-moore-1,2016-17,George Mason,G,34,33,1188,202,418,.483,192,385,.499,10,33,.303,162,231,.701,58,311,369,119,32,26,95,69,576,14.2
376,D'Angelo Harrison\dangelo-harrison-1,2013-14,St. John's (NY),G,33,33,1086,169,443,.381,105,270,.389,64,173,.370,174,202,.861,29,132,161,62,32,16,48,83,576,11.7
377,Monte Morris\monte-morris-1,2016-17,Iowa State,G,35,35,1237,216,465,.465,162,322,.503,54,143,.378,89,111,.802,40,129,169,217,53,10,42,51,575,15.5
378,Walt Lemon\walt-lemon--1,2013-14,Bradley,G,32,31,1135,210,495,.424,181,395,.458,29,100,.290,126,169,.746,8,90,98,124,78,3,115,76,575,10.9
379,Ryan Bowie\ryan-bowie-1,2015-16,Texas-San Antonio,G,32,32,1107,188,425,.442,107,224,.478,81,201,.403,118,152,.776,51,161,212,50,27,7,71,88,575,12.0
380,Kendall Anthony\kendall-anthony-1,2014-15,Richmond,G,35,35,1276,203,455,.446,143,302,.474,60,153,.392,109,138,.790,10,53,63,89,33,1,54,74,575,10.3
381,Trevor Releford\trevor-releford-1,2013-14,Alabama,G,31,29,1078,187,377,.496,115,194,.593,72,183,.393,128,151,.848,19,89,108,97,69,3,82,84,574,14.2
382,Michael Qualls\michael-qualls-1,2014-15,Arkansas,G,36,34,1086,180,413,.436,125,248,.504,55,165,.333,158,204,.775,59,133,192,60,32,17,61,62,573,11.6
383,J.J. Frazier\jj-frazier-1,2015-16,Georgia,G,34,29,1090,169,413,.409,93,216,.431,76,197,.386,159,193,.824,17,137,154,151,49,3,55,92,573,13.4
384,Shamorie Ponds\shamorie-ponds-1,2016-17,St. John's (NY),G,33,33,1109,191,435,.439,116,235,.494,75,200,.375,116,141,.823,38,108,146,102,68,8,62,58,573,13.7
385,James Young\james-young-1,2013-14,Kentucky,G,40,39,1296,183,450,.407,101,215,.470,82,235,.349,125,177,.706,41,130,171,67,30,8,75,83,573,8.8
386,Nick Kellogg\nick-kellogg-1,2013-14,Ohio,G,37,37,1206,196,424,.462,109,202,.540,87,222,.392,94,106,.887,22,112,134,109,39,1,55,77,573,11.6
387,Khallid Hart\khallid-hart-1,2016-17,Marist,G,32,32,1135,186,407,.457,122,233,.524,64,174,.368,137,173,.792,11,74,85,73,36,8,50,68,573,12.3
388,Chris Denson\chris-denson-1,2013-14,Auburn,G,30,30,961,187,406,.461,165,323,.511,22,83,.265,176,268,.657,37,93,130,71,30,3,54,64,572,12.7
389,Cameron Payne\cameron-payne-1,2013-14,Murray State,G,34,34,1111,190,470,.404,118,259,.456,72,211,.341,120,155,.774,10,113,123,185,57,20,110,96,572,11.7
390,Grayson Allen\grayson-allen-1,2017-18,Duke,G,37,37,1316,181,433,.418,79,157,.503,102,276,.370,108,127,.850,20,103,123,172,64,2,79,79,572,12.3
391,Josh Jackson\josh-jackson-2,2016-17,Kansas,G,35,35,1077,220,429,.513,186,339,.549,34,90,.378,98,173,.566,81,177,258,104,59,37,97,104,572,13.1
392,Stephen Croone\stephen-croone-1,2013-14,Furman,G,30,29,998,175,374,.468,145,281,.516,30,93,.323,192,256,.750,10,122,132,112,50,8,108,64,572,13.3
393,Jared Terrell\jared-terrell-1,2017-18,Rhode Island,G,34,34,1128,191,447,.427,116,266,.436,75,181,.414,115,140,.821,32,87,119,80,50,7,59,78,572,11.6
394,T.T. Carey\tt-carey-1,2013-14,Longwood,G,31,31,1013,206,470,.438,112,232,.483,94,238,.395,66,84,.786,30,174,204,24,46,11,49,73,572,12.4
395,Tyler Dorsey\tyler-dorsey-1,2016-17,Oregon,G,39,39,1169,189,405,.467,101,197,.513,88,208,.423,105,139,.755,33,102,135,67,30,4,59,57,571,10.3
396,Dylan Windler\dylan-windler-1,2017-18,Belmont,G,33,33,1168,204,365,.559,135,203,.665,69,162,.426,94,131,.718,57,250,307,90,34,31,78,86,571,15.3
397,Joe Cremo\joe-cremo-1,2017-18,Albany (NY),G,32,32,1128,182,397,.458,106,231,.459,76,166,.458,131,160,.819,20,112,132,120,27,9,68,70,571,13.2
398,Marshall Henderson\marshall-henderson-1,2013-14,Mississippi,G,30,22,934,172,487,.353,43,110,.391,129,377,.342,98,120,.817,9,48,57,61,45,2,55,50,571,10.8
399,Otis Livingston II\otis-livingstonii-1,2017-18,George Mason,G,33,32,1198,193,443,.436,128,273,.469,65,170,.382,120,140,.857,7,100,107,144,33,2,86,43,571,12.0
400,Brandon Tabb\brandon-tabb-1,2016-17,Bethune-Cookman,G,32,32,1100,187,493,.379,81,186,.435,106,307,.345,90,109,.826,26,148,174,53,43,19,48,101,570,11.2
401,Pablo Bertone\pablo-bertone-1,2013-14,Florida Atlantic,G,30,30,1014,207,459,.451,155,304,.510,52,155,.335,104,143,.727,20,96,116,64,39,2,84,80,570,10.9
402,Sheldon McClellan\sheldon-mcclellan-1,2015-16,Miami (FL),G,35,34,1151,177,351,.504,121,213,.568,56,138,.406,160,191,.838,19,93,112,56,36,9,44,62,570,12.5
403,Kyle Wilson\kyle-wilson-5,2013-14,Army,G,31,30,959,189,427,.443,126,282,.447,63,145,.434,129,163,.791,15,65,80,45,17,3,64,50,570,10.6
404,Markel Starks\markel-starks-1,2013-14,Georgetown,G,33,33,1222,186,451,.412,129,276,.467,57,175,.326,141,162,.870,14,62,76,135,30,3,76,78,570,11.2
405,Jarvis Summers\jarvis-summers-1,2013-14,Mississippi,G,33,33,1011,190,391,.486,143,280,.511,47,111,.423,143,187,.765,12,67,79,126,31,10,76,93,570,12.0
406,Sviatoslav Mykhailiuk\sviatoslav-mykhailiuk-1,2017-18,Kansas,G,39,39,1346,205,472,.434,90,213,.423,115,259,.444,45,56,.804,44,109,153,107,46,12,65,97,570,10.4
407,Jahad Thomas\jahad-thomas-1,2017-18,Massachusetts-Lowell,G,27,27,979,211,410,.515,195,366,.533,16,44,.364,132,189,.698,69,157,226,107,48,8,95,70,570,16.5
408,Khallid Hart\khallid-hart-1,2015-16,Marist,G,28,28,1021,164,369,.444,92,181,.508,72,188,.383,169,201,.841,10,64,74,58,42,2,63,65,569,13.7
409,Deshon Taylor\deshon-taylor-1,2017-18,Fresno State,G,32,30,1083,155,353,.439,96,200,.480,59,153,.386,200,240,.833,12,89,101,83,49,5,79,72,569,12.7
410,Dennis Mavin\dennis-mavin-1,2014-15,Florida International,G,33,33,1174,198,452,.438,167,353,.473,31,99,.313,142,221,.643,27,147,174,103,41,1,118,47,569,10.3
411,MaCio Teague\macio-teague-1,2017-18,North Carolina-Asheville,G,34,32,1200,181,433,.418,84,205,.410,97,228,.425,110,127,.866,17,132,149,85,54,4,70,57,569,12.0
412,Melo Trimble\melo-trimble-1,2014-15,Maryland,G,35,35,1173,150,338,.444,89,190,.468,61,148,.412,207,240,.863,6,129,135,106,44,2,86,65,568,12.2
413,Brandon Tabb\brandon-tabb-1,2017-18,Bethune-Cookman,G,30,27,938,172,433,.397,75,145,.517,97,288,.337,127,139,.914,23,86,109,49,46,11,68,84,568,11.9
414,Jordan Price\jordan-price-1,2014-15,La Salle,G,33,33,1054,180,465,.387,111,262,.424,69,203,.340,139,174,.799,16,113,129,75,27,8,103,94,568,8.8
415,James Palmer\james-palmer-1,2017-18,Nebraska,G,33,33,1024,181,408,.444,138,269,.513,43,139,.309,163,221,.738,41,103,144,99,32,16,72,61,568,12.3
416,A.J. English\aj-english-1,2013-14,Iona,G,33,33,1207,170,419,.406,86,182,.473,84,237,.354,144,188,.766,22,108,130,142,33,14,92,80,568,11.9
417,Eron Harris\eron-harris-1,2013-14,West Virginia,G,33,32,1035,183,418,.438,94,207,.454,89,211,.422,113,132,.856,27,87,114,52,24,7,68,78,568,10.7
418,Kyle Collinsworth\kyle-collinsworth-1,2015-16,Brigham Young,G,37,36,1249,206,444,.464,197,407,.484,9,37,.243,146,224,.652,86,217,303,275,74,20,126,74,567,15.1
419,Jared Brownridge\jared-brownridge-1,2013-14,Santa Clara,G,33,33,1107,183,403,.454,88,185,.476,95,218,.436,106,123,.862,11,74,85,76,24,4,48,64,567,11.7
420,Jahad Thomas\jahad-thomas-1,2016-17,Massachusetts-Lowell,G,31,30,1051,224,380,.589,222,378,.587,2,2,1.000,117,173,.676,71,209,280,143,50,8,117,94,567,15.5
421,Denzel Valentine\denzel-valentine-1,2014-15,Michigan State,G,39,39,1295,197,445,.443,95,200,.475,102,245,.416,71,86,.826,46,199,245,167,35,9,92,85,567,11.6
422,Cortez Edwards\cortez-edwards-1,2017-18,Southern Mississippi,G,34,32,1219,221,449,.492,196,361,.543,25,88,.284,99,128,.773,70,147,217,98,71,14,62,54,566,14.3
423,Julian Norfleet\julian-norfleet-1,2013-14,Mount St. Mary's,G,33,32,1078,195,431,.452,139,269,.517,56,162,.346,120,162,.741,13,81,94,181,52,9,97,82,566,12.5
424,Jacolby Mobley\jacolby-mobley-1,2016-17,Tennessee-Martin,G,29,26,1025,182,432,.421,87,173,.503,95,259,.367,107,137,.781,22,62,84,60,30,3,58,57,566,12.1
425,Pancake Thomas\cleveland-thomas-1,2015-16,Hartford,G,30,28,1038,178,407,.437,97,217,.447,81,190,.426,129,156,.827,30,163,193,84,36,6,53,72,566,14.3
426,Dyami Starks\dyami-starks-1,2013-14,Bryant,G,30,29,1089,193,465,.415,105,226,.465,88,239,.368,92,107,.860,25,76,101,60,32,1,58,66,566,11.4
427,Kareem Jamar\kareem-jamar-1,2013-14,Montana,G,30,30,1086,182,386,.472,137,257,.533,45,129,.349,156,219,.712,25,144,169,121,27,15,67,74,565,14.3
428,George Beamon\george-beamon-1,2013-14,Manhattan,G,30,30,926,170,417,.408,117,274,.427,53,143,.371,172,208,.827,48,146,194,23,47,10,55,69,565,13.1
429,Jordan Howard\jordan-howard-2,2015-16,Central Arkansas,G,28,28,976,175,411,.426,80,189,.423,95,222,.428,120,137,.876,18,76,94,78,18,2,61,33,565,13.4
430,Branden Frazier\branden-frazier-1,2013-14,Fordham,G,31,31,1140,186,468,.397,141,309,.456,45,159,.283,148,173,.855,47,110,157,133,34,9,93,72,565,12.2
431,David Jenkins Jr.\david-jenkinsjr-1,2017-18,South Dakota State,G,35,21,1032,183,424,.432,99,204,.485,84,220,.382,115,144,.799,10,103,113,57,13,0,59,68,565,9.6
432,Evan Bradds\evan-bradds-1,2015-16,Belmont,G,32,32,980,210,295,.712,207,287,.721,3,8,.375,141,200,.705,69,226,295,70,10,8,78,91,564,15.1
433,Tyrone Wallace\tyrone-wallace-1,2014-15,University of California,G,33,33,1152,208,489,.425,180,401,.449,28,88,.318,120,198,.606,30,205,235,131,42,11,94,91,564,11.1
434,Taylor Braun\taylor-braun-1,2013-14,North Dakota State,G,32,31,1088,170,361,.471,129,262,.492,41,99,.414,183,233,.785,20,155,175,120,49,6,63,68,564,14.6
435,Joshua Braun\joshua-braun-1,2015-16,Grand Canyon,G,34,32,1045,144,329,.438,71,143,.497,73,186,.392,203,234,.868,56,122,178,37,26,23,44,71,564,13.2
436,Jonathan Williams\jonathan-williams-2,2015-16,Toledo,G,32,32,988,207,454,.456,137,268,.511,70,186,.376,80,115,.696,18,77,95,91,26,2,89,62,564,10.3
437,Torrance Rowe\torrance-rowe-1,2015-16,Tennessee Tech,G,31,31,1100,177,430,.412,96,194,.495,81,236,.343,129,149,.866,15,70,85,136,18,2,80,35,564,12.2
438,Terran Petteway\terran-petteway-1,2014-15,Nebraska,G,31,31,1086,184,465,.396,116,248,.468,68,217,.313,128,180,.711,17,136,153,87,35,27,104,94,564,10.2
439,Zach Johnson\zach-johnson-2,2017-18,Florida Gulf Coast,G,35,34,1134,203,433,.469,134,257,.521,69,176,.392,89,114,.781,15,100,115,104,70,5,79,72,564,11.7
440,Stephen Croone\stephen-croone-1,2015-16,Furman,G,33,31,999,161,375,.429,114,204,.559,47,171,.275,194,253,.767,11,105,116,84,38,10,84,79,563,11.2
441,Khadeen Carrington\khadeen-carrington-1,2016-17,Seton Hall,G,33,32,1099,189,446,.424,126,281,.448,63,165,.382,122,167,.731,19,83,102,97,38,10,75,62,563,10.9
442,Stefan Moody\stefan-moody-1,2014-15,Mississippi,G,34,33,975,168,433,.388,90,211,.427,78,222,.351,149,165,.903,31,85,116,80,57,3,68,88,563,11.2
443,Tookie Brown\tookie-brown-1,2016-17,Georgia Southern,G,33,33,1123,177,436,.406,116,259,.448,61,177,.345,148,193,.767,8,104,112,131,46,10,73,70,563,11.9
444,Jamaal King\jamaal-king-1,2017-18,Saint Francis (PA),G,31,31,959,195,412,.473,142,256,.555,53,156,.340,120,147,.816,12,84,96,108,37,1,96,70,563,11.8
445,Andrew White III\andrew-whiteiii-1,2015-16,Nebraska,G,34,34,1010,195,405,.481,108,194,.557,87,211,.412,86,111,.775,40,159,199,20,39,11,53,89,563,11.6
446,Dachon Burke\dachon-burke-1,2017-18,Robert Morris,G,32,30,1044,210,458,.459,166,328,.506,44,130,.338,98,156,.628,59,125,184,80,67,16,86,81,562,12.4
447,Jordan Gregory\jordan-gregory-1,2014-15,Montana,G,33,33,1189,176,437,.403,89,209,.426,87,228,.382,123,154,.799,18,93,111,107,20,1,70,53,562,10.9
448,Jordan Davis\jordan-davis-2,2016-17,Northern Colorado,G,29,28,978,211,430,.491,186,346,.538,25,84,.298,115,191,.602,20,120,140,162,35,15,126,84,562,12.6
449,Danuel House\danuel-house-1,2015-16,Texas A&M,G,36,34,1114,184,466,.395,109,222,.491,75,244,.307,118,165,.715,39,132,171,77,19,11,64,51,561,9.8
450,Kellen Dunham\kellen-dunham-1,2014-15,Butler,G,34,33,1153,171,399,.429,94,211,.445,77,188,.410,142,167,.850,18,69,87,31,19,1,51,47,561,10.1
451,Matt Scott\matt-scott-1,2016-17,Niagara,G,33,33,1139,187,430,.435,122,257,.475,65,173,.376,122,170,.718,56,175,231,99,45,14,87,79,561,12.5
452,Roy Devyn Marble\roy-devyn-marble-1,2013-14,Iowa,G,33,33,995,183,436,.420,131,287,.456,52,149,.349,142,199,.714,26,80,106,118,60,7,57,64,560,12.5
453,Lamont Middleton\lamont-middleton-1,2013-14,North Carolina A&T,G,32,30,1123,140,428,.327,90,263,.342,50,165,.303,229,291,.787,45,106,151,66,33,5,95,77,559,9.7
454,Josh Greene\josh-greene-1,2013-14,Cal State Northridge,G,35,34,1256,156,382,.408,78,201,.388,78,181,.431,169,185,.914,12,92,104,115,38,6,69,85,559,11.5
455,David Efianayi\david-efianayi-1,2017-18,Gardner-Webb,G,32,31,1042,183,419,.437,132,278,.475,51,141,.362,142,176,.807,19,97,116,81,40,7,82,54,559,11.4
456,Blake Hamilton\blake-hamilton-2,2016-17,Buffalo,G,32,29,974,189,437,.432,130,277,.469,59,160,.369,122,157,.777,27,171,198,141,32,15,111,92,559,11.8
457,Jaylen Shaw\jaylen-shaw-1,2016-17,Coastal Carolina,G,39,37,1194,203,441,.460,144,292,.493,59,149,.396,94,116,.810,15,114,129,148,53,5,88,73,559,10.5
458,Marvelle Harris\marvelle-harris-2,2013-14,Fresno State,G,39,39,1349,177,425,.416,122,272,.449,55,153,.359,150,194,.773,30,175,205,75,40,13,58,92,559,10.1
459,Joel Berry\joel-berry-1,2016-17,North Carolina,G,38,37,1155,182,425,.428,94,196,.480,88,229,.384,106,137,.774,16,102,118,138,53,5,71,84,558,10.8
460,Bryce Alford\bryce-alford-1,2016-17,UCLA,G,36,36,1188,173,387,.447,57,117,.487,116,270,.430,96,117,.821,11,78,89,92,19,5,35,51,558,11.4
461,Marcus Romain\marcus-romain-1,2015-16,Mississippi Valley State,G,30,20,869,188,429,.438,158,341,.463,30,88,.341,152,200,.760,30,131,161,71,34,11,108,69,558,11.0
462,Shavar Newkirk\shavar-newkirk-1,2017-18,Saint Joseph's,G,32,30,1092,172,443,.388,120,284,.423,52,159,.327,162,212,.764,25,114,139,125,50,7,56,57,558,12.9
463,Mo Evans\mo-evans-1,2016-17,Purdue-Fort Wayne,G,33,33,1054,197,425,.464,97,194,.500,100,231,.433,63,76,.829,14,88,102,205,51,5,103,80,557,13.1
464,Marcus Smart\marcus-smart-1,2013-14,Oklahoma State,G,31,31,1014,163,386,.422,114,222,.514,49,164,.299,182,250,.728,44,139,183,148,89,18,82,91,557,15.6
465,Isaiah Reese\isaiah-reese-1,2017-18,Canisius,G,33,32,1102,200,432,.463,117,201,.582,83,231,.359,74,84,.881,18,172,190,154,73,5,87,71,557,14.1
466,Garret Covington\garret-covington-1,2016-17,Western Illinois,G,28,28,974,178,428,.416,92,200,.460,86,228,.377,115,131,.878,10,91,101,89,21,2,80,50,557,12.2
467,Chandler Hutchison\chandler-hutchison-1,2016-17,Boise State,G,32,32,1014,207,418,.495,181,349,.519,26,69,.377,117,176,.665,38,212,250,84,39,6,86,87,557,12.3
468,Brandon Clark\brandon-clark-1,2013-14,Santa Clara,G,33,32,1058,178,419,.425,122,259,.471,56,160,.350,145,167,.868,26,61,87,116,46,4,62,88,557,12.0
469,Trey Sumler\trey-sumler-1,2013-14,Western Carolina,G,32,32,1138,177,422,.419,115,253,.455,62,169,.367,141,176,.801,32,95,127,138,36,0,72,75,557,12.5
470,Jeremy Harris\jeremy-harris-2,2017-18,Buffalo,G,36,36,1197,203,431,.471,111,211,.526,92,220,.418,59,75,.787,48,164,212,77,36,26,46,76,557,12.4
471,Rob Poole\rob-poole-1,2013-14,Siena,G,38,37,1289,177,429,.413,106,232,.457,71,197,.360,131,171,.766,48,142,190,61,41,5,66,83,556,9.9
472,Chris Clemons\chris-clemons-2,2015-16,Campbell,G,30,29,965,186,439,.424,94,193,.487,92,246,.374,92,109,.844,10,101,111,54,45,8,57,75,556,11.8
473,Tyler Johnson\tyler-johnson-2,2013-14,Fresno State,G,35,35,1177,196,409,.479,139,277,.502,57,132,.432,107,133,.805,56,200,256,103,36,13,47,98,556,13.4
474,Melo Trimble\melo-trimble-1,2016-17,Maryland,G,33,33,1059,180,413,.436,122,230,.530,58,183,.317,138,175,.789,9,110,119,121,36,5,100,59,556,11.0
475,Damyean Dotson\damyean-dotson-1,2016-17,Houston,G,32,32,1098,202,431,.469,94,186,.505,108,245,.441,44,53,.830,49,173,222,36,29,5,33,53,556,13.2
476,Zach Thomas\zach-thomas-1,2016-17,Bucknell,G,35,34,1041,180,381,.472,124,244,.508,56,137,.409,140,172,.814,39,191,230,120,39,17,108,82,556,12.2
477,Sam Merrill\sam-merrill-1,2017-18,Utah State,G,34,33,1202,192,381,.504,94,170,.553,98,211,.464,73,86,.849,7,104,111,107,35,7,62,75,555,12.3
478,Trey Lewis\trey-lewis-1,2014-15,Cleveland State,G,34,34,1203,186,417,.446,90,190,.474,96,227,.423,87,115,.757,26,122,148,97,42,5,78,66,555,11.5
479,Rayvonte Rice\rayvonte-rice-1,2013-14,Illinois,G,35,35,1146,192,447,.430,146,291,.502,46,156,.295,125,171,.731,44,166,210,53,58,12,55,86,555,11.3
480,Yogi Ferrell\kevin-ferrell-1,2014-15,Indiana,G,34,34,1186,181,412,.439,99,215,.460,82,197,.416,111,129,.860,21,89,110,166,24,1,65,59,555,12.5
481,Marquis Wright\marquis-wright-2,2016-17,Siena,G,33,32,1127,191,467,.409,138,316,.437,53,151,.351,120,163,.736,43,94,137,165,37,5,93,71,555,11.5
482,Matt Scott\matt-scott-1,2017-18,Niagara,G,29,27,959,179,422,.424,131,270,.485,48,152,.316,148,208,.712,69,144,213,75,33,14,63,59,554,14.0
483,Dallas Moore\dallas-moore-1,2014-15,North Florida,G,35,35,1139,211,439,.481,150,282,.532,61,157,.389,71,97,.732,33,78,111,128,35,1,82,42,554,11.2
484,Bryce Alford\bryce-alford-1,2014-15,UCLA,G,36,36,1307,171,432,.396,78,194,.402,93,238,.391,119,142,.838,6,108,114,176,34,1,89,54,554,11.0
485,Chris Flemmings\chris-flemmings-1,2016-17,North Carolina-Wilmington,G,35,35,1216,193,409,.472,123,210,.586,70,199,.352,98,127,.772,39,157,196,76,48,24,76,68,554,12.1
486,Treveon Graham\treveon-graham-1,2013-14,Virginia Commonwealth,G,35,33,989,185,423,.437,127,251,.506,58,172,.337,125,180,.694,69,176,245,70,32,6,63,83,553,11.4
487,Joe Cremo\joe-cremo-1,2016-17,Albany (NY),G,35,35,1241,185,409,.452,135,276,.489,50,133,.376,133,153,.869,27,157,184,134,37,5,92,60,553,11.9
488,Blake Francis\blake-francis-1,2017-18,Wagner,G,32,22,1046,182,423,.430,80,169,.473,102,254,.402,87,108,.806,20,40,60,54,52,1,48,81,553,11.2
489,Jaelan Sanford\jaelan-sanford-1,2017-18,Toledo,G,34,34,1175,186,412,.451,115,236,.487,71,176,.403,110,130,.846,21,96,117,101,20,19,62,61,553,11.5
490,Demetrius Jackson\demetrius-jackson-2,2015-16,Notre Dame,G,35,35,1258,193,428,.451,139,265,.525,54,163,.331,113,139,.813,31,90,121,164,43,10,76,68,553,12.3
491,Malik Newman\malik-newman-1,2017-18,Kansas,G,39,33,1234,186,402,.463,101,197,.513,85,205,.415,96,115,.835,20,176,196,82,42,6,57,61,553,11.0
492,Marcquise Reed\marcquise-reed-1,2017-18,Clemson,G,35,35,1221,183,426,.430,116,237,.489,67,189,.354,120,142,.845,26,139,165,116,58,0,80,67,553,11.8
493,Omar Prewitt\omar-prewitt-1,2015-16,William & Mary,G,31,31,998,188,381,.493,145,263,.551,43,118,.364,133,189,.704,26,136,162,77,24,16,59,71,552,12.9
494,Yogi Ferrell\kevin-ferrell-1,2013-14,Indiana,G,32,32,1083,169,409,.413,81,189,.429,88,220,.400,126,153,.824,9,86,95,125,24,1,84,54,552,11.3
495,Ledrick Eackles\ledrick-eackles-1,2013-14,McNeese State,G,31,31,979,159,435,.366,81,221,.367,78,214,.364,156,204,.765,37,116,153,73,48,5,91,78,552,10.7
496,Will Darley\will-darley-1,2016-17,Maryland-Baltimore County,G,34,34,1040,182,373,.488,92,170,.541,90,203,.443,98,110,.891,33,100,133,64,15,3,60,80,552,11.2
497,Erick Neal\erick-neal-1,2017-18,Texas-Arlington,G,33,31,1138,188,433,.434,95,191,.497,93,242,.384,83,109,.761,24,114,138,222,65,3,122,79,552,13.1
498,Devon Saddler\devon-saddler-1,2013-14,Delaware,G,28,19,1037,190,433,.439,143,305,.469,47,128,.367,125,176,.710,30,89,119,101,24,7,61,61,552,13.1
499,Temple Gibbs\temple-gibbs-1,2017-18,Notre Dame,G,36,36,1348,171,416,.411,90,215,.419,81,201,.403,129,154,.838,28,73,101,107,37,3,54,65,552,11.0
500,Giddy Potts\giddy-potts-1,2016-17,Middle Tennessee,G,36,33,1098,196,407,.482,120,209,.574,76,198,.384,84,104,.808,33,159,192,71,47,8,47,87,552,11.9
501,Gian Clavell\gian-clavell-1,2016-17,Colorado State,G,27,26,987,193,449,.430,115,247,.466,78,202,.386,88,127,.693,37,133,170,47,53,20,53,58,552,14.4
502,Jamie Adams\jamie-adams-1,2013-14,Florida A&M,G,32,29,969,157,399,.393,80,195,.410,77,204,.377,160,202,.792,17,63,80,118,48,1,103,84,551,10.7
503,Ian Baker\ian-baker-1,2016-17,New Mexico State,G,33,33,1079,164,421,.390,101,216,.468,63,205,.307,160,193,.829,17,123,140,137,42,4,74,55,551,12.2
504,Ameen Tanksley\ameen-tanksley-1,2014-15,Hofstra,G,34,34,1105,180,402,.448,106,216,.491,74,186,.398,117,169,.692,60,128,188,49,48,8,68,82,551,11.4
505,Tookie Brown\tookie-brown-1,2015-16,Georgia Southern,G,31,26,956,177,408,.434,127,274,.464,50,134,.373,147,181,.812,18,82,100,104,51,4,69,81,551,12.4
506,Trevor Lacey\trevor-lacey-1,2014-15,North Carolina State,G,35,35,1256,190,436,.436,112,237,.473,78,199,.392,93,126,.738,27,133,160,121,31,7,67,56,551,11.4
507,Tre Bussey\tre-bussey-1,2013-14,Georgia Southern,G,34,34,1186,197,431,.457,140,283,.495,57,148,.385,100,151,.662,36,92,128,66,33,3,51,40,551,11.0
508,Chris Fouch\chris-fouch-1,2013-14,Drexel,G,30,30,1062,186,466,.399,114,244,.467,72,222,.324,106,129,.822,20,77,97,60,26,3,38,83,550,10.8
509,Sheldon McClellan\sheldon-mcclellan-1,2014-15,Miami (FL),G,38,38,1278,192,397,.484,138,246,.561,54,151,.358,112,136,.824,32,146,178,74,34,7,49,59,550,11.1
510,Craig Bradshaw\craig-bradshaw-2,2014-15,Belmont,G,30,29,950,197,401,.491,115,207,.556,82,194,.423,74,99,.747,14,101,115,94,48,11,93,62,550,12.7
511,Chad Frazier\chad-frazier-1,2013-14,Alabama-Birmingham,G,31,29,1095,170,424,.401,109,244,.447,61,180,.339,148,203,.729,17,86,103,132,35,10,123,62,549,10.4
512,Aaron Harrison\aaron-harrison-1,2013-14,Kentucky,G,40,40,1303,174,411,.423,112,237,.473,62,174,.356,139,176,.790,25,93,118,74,43,12,65,85,549,9.1
513,Ladarius Tabb\ladarius-tabb-1,2015-16,Alabama A&M,G,29,29,1000,201,457,.440,156,304,.513,45,153,.294,102,160,.638,58,143,201,21,41,8,50,73,549,12.1
514,Quinton Upshur\quinton-upshur-1,2014-15,Northern Arizona,G,38,38,1131,172,454,.379,90,207,.435,82,247,.332,123,165,.745,20,110,130,44,33,41,48,106,549,8.7
515,Wesley Person\wesley-person-2,2016-17,Troy,G,37,34,1160,164,378,.434,70,143,.490,94,235,.400,127,155,.819,20,76,96,58,21,2,49,50,549,10.0
516,Zaid Hearst\zaid-hearst-1,2014-15,Quinnipiac,G,30,30,1106,197,456,.432,157,312,.503,40,144,.278,115,149,.772,69,113,182,76,15,10,67,66,549,12.0
517,Antonius Cleveland\antonius-cleveland-1,2016-17,Southeast Missouri State,G,33,33,1086,208,383,.543,180,310,.581,28,73,.384,105,159,.660,28,141,169,73,47,30,66,85,549,12.8
518,Craig Bradshaw\craig-bradshaw-2,2013-14,Belmont,G,35,35,1080,191,378,.505,126,214,.589,65,164,.396,102,126,.810,27,94,121,111,45,7,94,74,549,11.5
519,Denzel Livingston\denzel-livingston-1,2013-14,Incarnate Word,G,27,23,888,174,349,.499,120,212,.566,54,137,.394,146,189,.772,40,133,173,102,68,38,73,57,548,18.3
520,K.T. Harrell\kt-harrell-1,2013-14,Auburn,G,30,30,979,174,402,.433,108,218,.495,66,184,.359,134,154,.870,20,99,119,64,24,6,86,77,548,10.9
521,Tiwian Kendley\tiwan-kendley-1,2017-18,Morgan State,G,21,20,692,173,382,.453,141,265,.532,32,117,.274,170,226,.752,26,58,84,46,45,7,75,59,548,16.5
522,Dejounte Murray\dejounte-murray-1,2015-16,Washington,G,34,34,1139,202,486,.416,168,368,.457,34,118,.288,110,166,.663,48,155,203,151,62,10,110,90,548,11.0
523,Kamar Baldwin\kamar-baldwin-1,2017-18,Butler,G,35,35,1190,210,475,.442,161,327,.492,49,148,.331,79,102,.775,13,159,172,111,54,15,75,89,548,10.8
524,Kassius Robertson\kassius-robertson-1,2016-17,Canisius,G,34,33,1135,178,398,.447,80,159,.503,98,239,.410,94,117,.803,30,77,107,82,30,5,53,52,548,11.5
525,Anthony Brown\anthony-brown-5,2014-15,Stanford,G,37,36,1320,176,408,.431,97,229,.424,79,179,.441,116,146,.795,42,214,256,94,28,7,72,78,547,11.1
526,Zach Jackson\zach-jackson-1,2017-18,Omaha,G,31,30,986,192,367,.523,150,269,.558,42,98,.429,121,147,.823,47,150,197,29,35,12,68,71,547,13.0
527,Marcus Tyus\marcus-tyus-1,2016-17,Omaha,G,32,30,885,171,355,.482,99,194,.510,72,161,.447,133,163,.816,19,77,96,55,50,3,76,90,547,11.6
528,Francis Alonso\francis-alonso-1,2017-18,North Carolina-Greensboro,G,35,34,1026,175,425,.412,64,148,.432,111,277,.401,86,99,.869,16,67,83,103,36,2,87,82,547,9.6
529,Ahmaad Rorie\ahmaad-rorie-1,2016-17,Montana,G,31,29,1007,192,428,.449,129,264,.489,63,164,.384,100,120,.833,25,84,109,97,26,7,47,66,547,12.4
530,Jelani Hewitt\jelani-hewitt-1,2014-15,Georgia Southern,G,31,31,1087,149,424,.351,60,158,.380,89,266,.335,159,197,.807,31,99,130,114,77,10,80,57,546,13.1
531,Rodney Pryor\rodney-pryor-1,2014-15,Robert Morris,G,35,28,1028,201,418,.481,120,229,.524,81,189,.429,63,84,.750,41,123,164,62,41,11,50,79,546,11.5
532,J.P. Macura\jp-macura-1,2016-17,Xavier,G,38,37,1272,179,421,.425,115,231,.498,64,190,.337,124,157,.790,50,117,167,110,54,8,77,90,546,10.6
533,T.J. Price\tj-price-1,2014-15,Western Kentucky,G,32,32,1069,175,395,.443,94,199,.472,81,196,.413,115,141,.816,21,150,171,127,30,2,82,86,546,12.3
534,Stevie Browning\stevie-browning-1,2016-17,Marshall,G,34,33,1084,204,449,.454,134,272,.493,70,177,.395,68,83,.819,30,111,141,111,38,7,57,61,546,11.8
535,Jaylen Nowell\jaylen-nowell-1,2017-18,Washington,G,34,31,1106,203,450,.451,164,339,.484,39,111,.351,100,125,.800,33,102,135,92,36,9,85,96,545,9.9
536,Buddy Hield\buddy-hield-1,2013-14,Oklahoma,G,33,33,1059,196,440,.445,106,207,.512,90,233,.386,63,84,.750,58,88,146,62,46,5,60,72,545,11.5
537,Justin Cobbs\justin-cobbs-1,2013-14,University of California,G,35,34,1206,185,397,.466,153,301,.508,32,96,.333,143,175,.817,17,85,102,204,29,3,85,64,545,12.3
538,Kendall Williams\kendall-williams-1,2013-14,New Mexico,G,34,34,1200,151,351,.430,88,189,.466,63,162,.389,179,226,.792,25,96,121,168,53,2,68,61,544,13.7
539,Chavaughn Lewis\chavaughn-lewis-1,2013-14,Marist,G,31,29,1073,185,465,.398,157,374,.420,28,91,.308,146,196,.745,22,134,156,88,60,11,98,89,544,10.4
540,Tyler Hall\tyler-hall-2,2017-18,Montana State,G,31,29,995,174,428,.407,75,162,.463,99,266,.372,97,107,.907,23,93,116,86,25,12,56,53,544,11.9
541,Chris Hass\chris-hass-1,2014-15,Bucknell,G,34,34,1007,181,423,.428,99,215,.460,82,208,.394,99,119,.832,20,93,113,38,17,11,51,58,543,9.7
542,Issiah Grayson\issiah-grayson-1,2013-14,Cal State Bakersfield,G,32,30,1017,171,341,.501,100,195,.513,71,146,.486,130,160,.813,21,69,90,124,46,1,90,80,543,12.7
543,Xavier Cooks\xavier-cooks-1,2016-17,Winthrop,G,33,31,956,196,402,.488,158,293,.539,38,109,.349,113,162,.698,53,247,300,92,29,56,95,87,543,13.2
544,Preston Parks\preston-parks-1,2016-17,Citadel,G,31,9,841,185,455,.407,108,221,.489,77,234,.329,96,116,.828,30,63,93,116,60,5,78,62,543,12.0
545,Deandre Burnett\deandre-burnett-1,2016-17,Mississippi,G,33,27,989,139,391,.355,66,197,.335,73,194,.376,192,218,.881,15,55,70,104,34,6,94,60,543,10.1
546,Jalen Adams\jalen-adams-2,2017-18,Connecticut,G,30,30,1144,208,484,.430,160,336,.476,48,148,.324,78,98,.796,26,101,127,141,46,10,87,46,542,12.4
547,Jaaron Simmons\jaaron-simmons-1,2015-16,Ohio,G,35,34,1276,172,370,.465,140,292,.479,32,78,.410,166,213,.779,9,115,124,275,29,0,136,108,542,11.9
548,E.C. Matthews\ec-matthews-1,2014-15,Rhode Island,G,32,31,1052,172,420,.410,104,211,.493,68,209,.325,130,177,.734,34,112,146,63,24,17,115,68,542,9.2
549,Kris Dunn\kris-dunn-1,2015-16,Providence,G,33,32,1088,184,411,.448,142,298,.477,42,113,.372,132,190,.695,36,140,176,206,82,20,116,93,542,13.9
550,Matt Williams\matt-williams-4,2016-17,Central Florida,G,36,36,1315,178,455,.391,52,127,.409,126,328,.384,60,74,.811,16,138,154,69,25,1,65,64,542,9.0
551,KJ Feagin\kj-feagin-1,2017-18,Santa Clara,G,31,31,1085,201,454,.443,140,290,.483,61,164,.372,79,91,.868,12,53,65,125,26,3,72,69,542,11.0
552,Aaron Bacote\aaron-bacote-1,2013-14,Old Dominion,G,35,34,1033,163,407,.400,107,249,.430,56,158,.354,160,205,.780,16,89,105,102,26,5,100,67,542,9.0
553,Aaron Calixte\aaron-calixte-1,2017-18,Maine,G,32,32,1062,187,393,.476,126,235,.536,61,158,.386,107,119,.899,15,85,100,102,28,4,121,74,542,10.1
554,Antwan Scott\antwan-scott-2,2015-16,Colorado State,G,33,23,1007,173,406,.426,77,174,.443,96,232,.414,99,130,.762,9,133,142,70,21,2,58,85,541,10.3
555,Xavier Munford\xavier-munford-1,2013-14,Rhode Island,G,32,32,1139,184,458,.402,122,268,.455,62,190,.326,111,157,.707,20,108,128,78,36,13,88,63,541,9.6
556,Ashton Moore\ashton-moore-1,2014-15,Citadel,G,30,30,1129,173,420,.412,94,214,.439,79,206,.383,116,135,.859,15,82,97,109,29,5,102,44,541,11.1
557,Dalton Pepper\dalton-pepper-1,2013-14,Temple,G,31,31,1171,198,457,.433,114,233,.489,84,224,.375,61,70,.871,42,117,159,74,32,6,52,54,541,12.1
558,Joe Kilgore\joe-kilgore-1,2017-18,Texas A&M-Corpus Christi,G,29,29,1019,183,451,.406,146,343,.426,37,108,.343,137,173,.792,28,135,163,96,52,18,86,60,540,12.6
559,Elijah Mitrou-Long\elijah-mitrou-long-1,2016-17,Mount St. Mary's,G,36,35,1239,180,437,.412,133,314,.424,47,123,.382,133,180,.739,16,171,187,157,57,3,123,100,540,9.9
560,Jordan Barnes\jordan-barnes-1,2017-18,Indiana State,G,31,29,1044,168,405,.415,51,128,.398,117,277,.422,87,102,.853,10,111,121,113,37,2,86,78,540,11.6
561,Christian Keeling\christian-keeling-1,2016-17,Charleston Southern,G,31,28,968,184,401,.459,159,328,.485,25,73,.342,146,187,.781,41,179,220,43,28,9,53,53,539,12.5
562,Chris Fowler\chris-fowler-1,2013-14,Central Michigan,G,31,31,1026,184,370,.497,158,302,.523,26,68,.382,145,212,.684,18,77,95,163,60,1,87,93,539,13.3
563,Shannon Bogues\shannon-bogues-1,2017-18,Stephen F. Austin,G,35,3,842,201,398,.505,157,273,.575,44,125,.352,93,117,.795,24,61,85,48,46,6,49,40,539,11.0
564,Ameen Tanksley\ameen-tanksley-1,2015-16,Hofstra,G,34,34,1180,170,406,.419,108,234,.462,62,172,.360,137,173,.792,66,112,178,48,30,8,68,79,539,10.5
565,Corey Hawkins\corey-hawkins-1,2013-14,UC-Davis,G,30,30,1014,171,385,.444,133,267,.498,38,118,.322,159,210,.757,21,114,135,89,44,11,60,65,539,13.1
566,Sa'eed Nelson\saeed-nelson-1,2017-18,American,G,29,29,1074,191,431,.443,163,335,.487,28,96,.292,128,188,.681,25,79,104,147,52,5,109,77,538,12.0
567,Julius Brown\julius-brown-2,2014-15,Toledo,G,33,33,1098,193,416,.464,125,246,.508,68,170,.400,84,98,.857,10,63,73,144,31,11,74,44,538,11.9
568,Michael Williams\michael-williams-5,2013-14,Cal State Fullerton,G,31,31,1073,184,441,.417,113,243,.465,71,198,.359,99,139,.712,19,109,128,76,28,6,67,74,538,10.4
569,Kareem Canty\kareem-canty-1,2013-14,Marshall,G,33,31,1211,187,502,.373,122,288,.424,65,214,.304,99,136,.728,25,49,74,180,24,3,121,54,538,8.7
570,Isaac Hamilton\isaac-hamilton-1,2015-16,UCLA,G,32,32,1129,206,436,.472,146,277,.527,60,159,.377,66,82,.805,31,104,135,106,33,2,76,69,538,11.5
571,Alex Hamilton\alex-hamilton-1,2013-14,Louisiana Tech,G,37,37,1034,172,370,.465,142,258,.550,30,112,.268,164,226,.726,25,109,134,109,53,16,79,61,538,11.1
572,Jaylen Adams\jaylen-adams-1,2015-16,St. Bonaventure,G,30,30,1125,150,337,.445,66,145,.455,84,192,.438,153,175,.874,23,87,110,150,40,9,82,80,537,14.4
573,Donte DiVincenzo\donte-divincenzo-1,2017-18,Villanova,G,40,10,1170,188,391,.481,103,179,.575,85,212,.401,76,107,.710,46,144,190,139,42,8,79,83,537,10.9
574,Michael Oguine\michael-oguine-1,2017-18,Montana,G,34,34,1096,177,384,.461,131,255,.514,46,129,.357,137,186,.737,73,115,188,67,48,18,45,95,537,12.6
575,Jaylin Walker\jaylin-walker-1,2016-17,Kent State,G,34,21,1055,185,467,.396,97,203,.478,88,264,.333,79,101,.782,51,97,148,30,26,0,69,58,537,8.7
576,Raheem Appleby\raheem-appleby-1,2014-15,Louisiana Tech,G,36,35,1184,200,500,.400,129,284,.454,71,216,.329,66,86,.767,22,75,97,73,46,2,39,35,537,9.5
577,Kassius Robertson\kassius-robertson-1,2017-18,Missouri,G,33,33,1188,158,374,.422,53,131,.405,105,243,.432,116,146,.795,9,90,99,77,32,2,77,57,537,10.5
578,Darell Combs\darell-combs-1,2016-17,IUPUI,G,32,32,1029,187,441,.424,124,257,.482,63,184,.342,100,134,.746,16,62,78,92,24,4,81,82,537,9.3
579,Elijah Wilson\elijah-wilson-1,2013-14,Coastal Carolina,G,34,34,1107,200,464,.431,149,297,.502,51,167,.305,86,123,.699,41,99,140,30,32,8,46,84,537,9.3
580,Patricio Garino\patricio-garino-1,2015-16,George Washington,G,38,38,1217,203,398,.510,145,263,.551,58,135,.430,73,106,.689,52,109,161,56,52,31,72,98,537,10.5
581,Dwayne Bacon\dwayne-bacon-1,2015-16,Florida State,G,34,32,979,197,441,.447,165,327,.505,32,114,.281,110,154,.714,46,151,197,50,33,1,74,73,536,9.8
582,Jon Severe\jon-severe-1,2013-14,Fordham,G,31,23,1021,163,493,.331,84,262,.321,79,231,.342,131,165,.794,31,56,87,63,29,6,82,69,536,8.0
583,Gary Trent Jr.\gary-trentjr-1,2017-18,Duke,G,37,37,1249,177,427,.415,80,186,.430,97,241,.402,85,97,.876,31,126,157,52,43,5,38,62,536,10.3
584,Devin Carter\devin-carter-1,2015-16,Arkansas State,G,31,30,1110,183,400,.458,95,189,.503,88,211,.417,82,117,.701,30,105,135,60,22,10,56,86,536,11.2
585,Egor Koulechov\egor-koulechov-1,2015-16,Rice,G,32,32,1101,175,420,.417,95,187,.508,80,233,.343,106,123,.862,48,176,224,42,28,6,45,69,536,11.9
586,T.J. Cromer\tj-cromer-1,2015-16,East Tennessee State,G,36,36,1152,182,421,.432,112,229,.489,70,192,.365,102,128,.797,26,97,123,110,36,2,73,92,536,9.9
587,Manu Lecomte\manu-lecomte-1,2017-18,Baylor,G,33,33,1124,162,403,.402,71,164,.433,91,239,.381,121,136,.890,7,65,72,122,22,0,71,60,536,10.6
588,Tra Holder\tra-holder-1,2016-17,Arizona State,G,33,32,1175,169,390,.433,123,265,.464,46,125,.368,152,197,.772,38,83,121,106,29,1,66,68,536,11.4
589,LaVonte Dority\lavonte-dority-1,2013-14,Valparaiso,G,34,34,1062,163,367,.444,99,217,.456,64,150,.427,145,172,.843,18,68,86,83,22,2,72,58,535,10.3
590,Ron Curry\ron-curry-1,2015-16,James Madison,G,31,30,1035,167,379,.441,95,184,.516,72,195,.369,129,173,.746,13,114,127,112,31,12,46,63,535,13.2
591,Stephen Croone\stephen-croone-1,2014-15,Furman,G,31,31,992,155,346,.448,100,188,.532,55,158,.348,170,226,.752,26,119,145,80,51,6,75,78,535,12.6
592,Jaylen Adams\jaylen-adams-1,2017-18,St. Bonaventure,G,28,27,1036,153,350,.437,78,178,.438,75,172,.436,154,181,.851,12,83,95,146,43,7,86,80,535,14.5
593,Jay Wright\jay-wright-2,2016-17,Louisiana,G,33,32,1137,181,404,.448,130,254,.512,51,150,.340,122,170,.718,20,62,82,129,65,11,79,69,535,12.0
594,Kellen Dunham\kellen-dunham-1,2015-16,Butler,G,33,32,1069,166,379,.438,79,176,.449,87,203,.429,116,138,.841,15,67,82,50,22,3,50,55,535,10.5
595,Mike Caffey\michael-caffey-1,2014-15,Cal State Long Beach,G,33,33,1073,195,449,.434,133,274,.485,62,175,.354,83,114,.728,21,110,131,119,61,5,88,65,535,11.1
596,Terence Davis\terence-davis-1,2016-17,Mississippi,G,36,26,911,200,415,.482,151,268,.563,49,147,.333,86,119,.723,51,139,190,63,50,18,74,114,535,10.4
597,Bryant Crawford\bryant-crawford-1,2016-17,Wake Forest,G,33,33,1049,169,386,.438,115,230,.500,54,156,.346,142,172,.826,11,115,126,182,49,9,76,93,534,13.1
598,Matt Mobley\matt-mobley-1,2014-15,Central Connecticut State,G,31,31,1147,171,428,.400,97,221,.439,74,207,.357,118,156,.756,15,71,86,57,26,6,83,64,534,9.1
599,Melo Trimble\melo-trimble-1,2015-16,Maryland,G,36,36,1183,159,388,.410,101,203,.498,58,185,.314,158,183,.863,11,119,130,175,45,6,96,68,534,11.3
600,Marcus Paige\marcus-paige-1,2014-15,North Carolina,G,38,38,1263,172,416,.413,78,178,.438,94,238,.395,96,111,.865,14,96,110,170,65,8,73,62,534,11.5
601,Antonio Green\antonio-green-2,2016-17,Texas-Rio Grande Valley,G,32,30,972,177,448,.395,66,150,.440,111,298,.372,69,89,.775,21,85,106,56,19,4,87,46,534,8.7
602,Jhivvan Jackson\jhivvan-jackson-1,2017-18,Texas-San Antonio,G,29,9,745,174,404,.431,97,195,.497,77,209,.368,109,142,.768,9,85,94,52,30,2,70,70,534,10.7
603,Quinndary Weatherspoon\quinndary-weatherspoon-1,2017-18,Mississippi State,G,37,37,1161,187,386,.484,145,252,.575,42,134,.313,118,153,.771,56,166,222,123,52,12,99,86,534,11.5
604,Bryant McIntosh\bryant-mcintosh-1,2016-17,Northwestern,G,36,36,1231,199,493,.404,157,356,.441,42,137,.307,94,108,.870,9,91,100,188,26,4,96,74,534,9.2
605,James Batemon\james-batemon-1,2017-18,Loyola Marymount,G,30,29,1050,167,350,.477,124,240,.517,43,110,.391,157,196,.801,32,77,109,139,35,1,87,82,534,13.3
606,Quincy Taylor\quincy-taylor-1,2014-15,Longwood,G,31,31,1115,188,433,.434,102,254,.402,86,179,.480,72,98,.735,13,79,92,83,40,5,93,74,534,9.9
607,Frank Howard\franklin-howard-1,2017-18,Syracuse,G,37,37,1422,187,497,.376,120,292,.411,67,205,.327,92,128,.719,19,110,129,175,68,10,125,96,533,8.8
608,Antonio Blakeney\antonio-blakeney-1,2016-17,Louisiana State,G,31,30,1018,194,424,.458,141,276,.511,53,148,.358,92,127,.724,32,117,149,54,21,3,64,49,533,10.8
609,Chris Flemmings\chris-flemmings-1,2015-16,North Carolina-Wilmington,G,33,24,1052,180,353,.510,123,196,.628,57,157,.363,116,143,.811,44,148,192,52,45,23,44,68,533,13.6
610,Treveon Graham\treveon-graham-1,2014-15,Virginia Commonwealth,G,33,33,970,172,402,.428,108,234,.462,64,168,.381,125,181,.691,73,162,235,53,20,9,38,67,533,12.0
611,Ryan Taylor\ryan-taylor-2,2017-18,Evansville,G,25,24,879,195,458,.426,128,300,.427,67,158,.424,76,88,.864,12,84,96,28,20,6,57,57,533,11.3
612,Byron Wesley\byron-wesley-1,2013-14,Southern California,G,30,27,1038,191,409,.467,167,338,.494,24,71,.338,127,178,.713,46,147,193,69,27,10,61,51,533,12.7
613,Ria'n Holland\rian-holland-1,2016-17,Mercer,G,31,30,975,177,405,.437,100,201,.498,77,204,.377,102,121,.843,24,78,102,59,32,7,44,72,533,11.6
614,D'Vauntes Smith-Rivera\dvauntes-smith-rivera-1,2015-16,Georgetown,G,33,33,1168,172,416,.413,99,195,.508,73,221,.330,116,143,.811,22,98,120,150,48,10,69,78,533,12.3
615,Tyler Kalinoski\tyler-kalinoski-1,2014-15,Davidson,G,32,30,1112,191,410,.466,100,195,.513,91,215,.423,60,76,.789,48,133,181,130,39,13,44,85,533,14.1
616,Johnathan Jordan\johnathan-jordan-1,2014-15,Texas A&M-Corpus Christi,G,34,34,1219,167,373,.448,155,331,.468,12,42,.286,186,283,.657,28,104,132,178,63,3,88,71,532,12.4
617,Kory Holden\kory-holden-1,2015-16,Delaware,G,30,27,1088,181,458,.395,112,280,.400,69,178,.388,101,127,.795,16,75,91,126,12,2,88,62,532,9.9
618,Shawn Roundtree\shawn-roundtree-1,2017-18,Central Michigan,G,36,35,1187,166,416,.399,110,251,.438,56,165,.339,144,175,.823,21,84,105,151,23,1,113,61,532,9.1
619,Chris Hansen\chris-hansen-1,2014-15,Idaho State,G,30,28,998,157,389,.404,77,180,.428,80,209,.383,138,165,.836,11,90,101,70,39,0,59,45,532,11.9
620,Bryson Scott\bryson-scott-1,2016-17,Purdue-Fort Wayne,G,33,32,928,193,407,.474,135,235,.574,58,172,.337,88,127,.693,28,136,164,76,56,3,83,62,532,11.3
621,Askia Booker\askia-booker-1,2014-15,Colorado,G,31,28,936,173,447,.387,118,280,.421,55,167,.329,131,157,.834,15,88,103,99,44,2,70,56,532,10.9
622,Shai Gilgeous-Alexander\shai-gilgeous-alexander-1,2017-18,Kentucky,G,37,24,1248,183,377,.485,160,320,.500,23,57,.404,143,175,.817,33,120,153,189,61,18,100,62,532,12.7
623,Keith Braxton\keith-braxton-1,2017-18,Saint Francis (PA),G,31,31,1091,180,379,.475,140,270,.519,40,109,.367,132,166,.795,50,245,295,102,54,18,81,56,532,15.1
624,Le'Bryan Nash\lebryan-nash-1,2014-15,Oklahoma State,G,31,31,982,178,385,.462,176,365,.482,2,20,.100,174,220,.791,37,139,176,62,24,29,100,92,532,10.8
625,Charles Matthews\charles-matthews-1,2017-18,Michigan,G,41,41,1234,205,414,.495,171,307,.557,34,107,.318,87,156,.558,53,174,227,98,30,26,84,88,531,9.3
626,Geno Crandall\geno-crandall-1,2017-18,North Dakota,G,32,32,1068,179,356,.503,129,236,.547,50,120,.417,123,169,.728,32,107,139,114,67,3,105,97,531,12.3
627,JeQuan Lewis\jequan-lewis-1,2016-17,Virginia Commonwealth,G,35,35,1092,168,390,.431,85,164,.518,83,226,.367,112,137,.818,8,91,99,158,61,3,86,87,531,11.5
628,Khadeen Carrington\khadeen-carrington-1,2017-18,Seton Hall,G,34,34,1120,170,407,.418,117,263,.445,53,144,.368,138,167,.826,20,86,106,150,36,10,79,73,531,11.2
629,Will Cummings\will-cummings-1,2014-15,Temple,G,36,35,1224,159,396,.402,135,291,.464,24,105,.229,189,234,.808,33,114,147,151,67,7,71,86,531,11.9
630,Charles Williams\charles-williams-5,2016-17,Howard,G,34,25,1019,179,452,.396,113,259,.436,66,193,.342,107,141,.759,34,54,88,20,19,12,57,73,531,7.9
631,Anthony Beane\anthony-beane-1,2014-15,Southern Illinois,G,33,33,1148,187,442,.423,139,298,.466,48,144,.333,109,134,.813,18,69,87,36,41,10,59,72,531,9.2
632,Nazareth Mitrou-Long\nazareth-mitrou-long-1,2016-17,Iowa State,G,35,35,1164,185,391,.473,87,136,.640,98,255,.384,62,78,.795,24,136,160,93,43,1,59,75,530,11.5
633,Terry Taylor\terry-taylor-5,2017-18,Austin Peay,G,34,34,1070,196,362,.541,158,274,.577,38,88,.432,100,137,.730,133,158,291,25,20,34,61,85,530,13.1
634,Ryan Harrow\ryan-harrow-1,2014-15,Georgia State,G,29,27,923,208,413,.504,165,304,.543,43,109,.394,71,99,.717,11,49,60,104,42,3,55,43,530,13.1
635,Alex Hamilton\alex-hamilton-1,2014-15,Louisiana Tech,G,36,36,1099,170,395,.430,136,276,.493,34,119,.286,156,208,.750,28,91,119,94,62,9,76,63,530,10.6
636,Allerik Freeman\allerik-freeman-2,2017-18,North Carolina State,G,33,28,1135,164,425,.386,94,243,.387,70,182,.385,132,170,.776,20,117,137,85,40,0,82,56,530,9.9
637,Ike Nwamu\ike-nwamu-1,2014-15,Mercer,G,35,34,1163,171,400,.428,91,186,.489,80,214,.374,108,142,.761,24,91,115,56,26,14,75,62,530,9.3
638,Tyler Nelson\tyler-nelson-1,2015-16,Fairfield,G,33,33,1169,158,368,.429,92,177,.520,66,191,.346,147,167,.880,16,87,103,95,44,0,53,43,529,12.2
639,Malik Beasley\malik-beasley-1,2015-16,Florida State,G,34,33,1014,185,393,.471,130,251,.518,55,142,.387,104,128,.813,44,136,180,51,32,6,59,75,529,11.0
640,Pendarvis Williams\pendarvis-williams-1,2013-14,Norfolk State,G,34,33,1172,184,375,.491,123,203,.606,61,172,.355,100,120,.833,39,129,168,89,51,10,55,84,529,12.6
641,Thomas Walkup\thomas-walkup-1,2014-15,Stephen F. Austin,G,34,34,943,185,326,.567,174,284,.613,11,42,.262,148,199,.744,84,136,220,126,40,6,73,100,529,13.9
642,Shannon Evans\shannon-evans-1,2017-18,Arizona State,G,32,32,1117,156,412,.379,61,156,.391,95,256,.371,122,143,.853,11,93,104,112,44,9,53,60,529,11.9
643,Marcquise Reed\marcquise-reed-1,2014-15,Robert Morris,G,35,28,973,197,402,.490,164,322,.509,33,80,.413,102,131,.779,20,68,88,73,67,1,90,72,529,10.0
644,Dusty Hannahs\dusty-hannahs-1,2015-16,Arkansas,G,32,20,866,174,380,.458,93,193,.482,81,187,.433,100,115,.870,19,58,77,29,20,0,41,68,529,10.3
645,Donovan Mitchell\donovan-mitchell-1,2016-17,Louisville,G,34,33,1098,181,444,.408,101,218,.463,80,226,.354,87,108,.806,37,128,165,93,70,17,56,88,529,11.8
646,Jalen Brunson\jalen-brunson-1,2016-17,Villanova,G,36,36,1118,183,338,.541,141,227,.621,42,111,.378,120,137,.876,17,76,93,148,32,0,74,59,528,12.0
647,Ahmad Thomas\ahmad-thomas-1,2017-18,North Carolina-Asheville,G,32,32,1028,220,438,.502,203,376,.540,17,62,.274,71,107,.664,50,136,186,91,62,11,77,88,528,12.3
648,Cameron Reynolds\cameron-reynolds-1,2016-17,Tulane,G,31,29,1090,184,434,.424,106,233,.455,78,201,.388,82,103,.796,43,167,210,45,26,14,47,84,528,11.5
649,Jaylen Bland\jaylen-bland-1,2015-16,UC-Riverside,G,33,33,1120,165,421,.392,48,130,.369,117,291,.402,81,98,.827,15,109,124,59,47,5,74,69,528,9.9
650,Jalen Hudson\jalen-hudson-1,2017-18,Florida,G,34,19,904,179,394,.454,101,200,.505,78,194,.402,92,139,.662,13,119,132,36,26,20,40,72,528,10.2
651,Muhammad-Ali Abdur-Rahkman\muhammad-ali-abdur-rahkman-1,2017-18,Michigan,G,41,41,1432,179,415,.431,106,220,.482,73,195,.374,97,129,.752,27,131,158,132,35,7,30,64,528,10.5
652,James Woodard\james-woodard-1,2013-14,Tulsa,G,34,34,1101,162,370,.438,97,202,.480,65,168,.387,139,178,.781,53,148,201,60,32,6,46,76,528,11.8
653,Tai Webster\tai-webster-1,2016-17,Nebraska,G,31,31,1075,183,434,.422,143,299,.478,40,135,.296,122,164,.744,33,125,158,124,42,4,100,74,528,11.1
654,Lamond Murray\lamond-murray-2,2015-16,Pepperdine,G,32,32,1009,207,442,.468,176,363,.485,31,79,.392,83,110,.755,49,124,173,28,30,17,40,69,528,11.1
655,Kyan Anderson\kyan-anderson-1,2013-14,Texas Christian,G,31,31,1072,161,342,.471,115,229,.502,46,113,.407,159,187,.850,9,66,75,139,43,1,90,54,527,12.8
656,Johnny Dee\johnny-dee-2,2014-15,San Diego,G,31,31,965,167,390,.428,87,179,.486,80,211,.379,113,123,.919,11,96,107,40,36,2,32,45,527,11.9
657,Kyle Anderson\kyle-anderson-3,2013-14,UCLA,G,36,36,1196,181,377,.480,153,319,.480,28,58,.483,137,186,.737,45,270,315,233,64,27,110,60,527,15.0
658,Stephen Brown\stephen-brown-2,2017-18,Bucknell,G,35,35,1059,186,386,.482,122,215,.567,64,171,.374,91,109,.835,17,98,115,150,41,9,61,82,527,12.1
659,Deonte Burton\deonte-burton-2,2016-17,Iowa State,G,35,35,1034,203,445,.456,161,333,.483,42,112,.375,79,117,.675,40,178,218,62,60,49,80,105,527,10.8
660,Marcus Barham\marcus-barham-1,2017-18,Florida A&M,G,31,31,1115,169,431,.392,84,197,.426,85,234,.363,103,123,.837,32,101,133,59,25,6,92,60,526,9.4
661,Langston Hall\langston-hall-1,2013-14,Mercer,G,36,35,1157,152,380,.400,66,160,.413,86,220,.391,136,160,.850,14,97,111,201,52,5,85,51,526,12.2
662,Omega Harris\omega-harris-1,2016-17,Texas-El Paso,G,31,31,1127,183,403,.454,134,273,.491,49,130,.377,111,141,.787,11,100,111,66,40,5,86,67,526,10.3
663,Craig Bradshaw\craig-bradshaw-2,2015-16,Belmont,G,32,32,1034,176,399,.441,89,164,.543,87,235,.370,87,118,.737,25,101,126,103,40,12,77,80,526,11.4
664,Devin Carter\devin-carter-1,2016-17,Arkansas State,G,32,32,1055,177,410,.432,75,156,.481,102,254,.402,70,98,.714,23,92,115,25,29,5,39,76,526,10.1
665,Kendall Anthony\kendall-anthony-1,2013-14,Richmond,G,33,22,1028,166,429,.387,84,197,.426,82,232,.353,112,136,.824,14,36,50,54,21,1,46,75,526,8.7
666,Quenton DeCosey\quenton-decosey-1,2015-16,Temple,G,33,33,1142,164,407,.403,115,270,.426,49,137,.358,149,191,.780,42,157,199,85,41,13,73,65,526,11.4
667,Myles Powell\myles-powell-1,2017-18,Seton Hall,G,34,33,1078,171,395,.433,77,147,.524,94,248,.379,90,114,.789,17,73,90,94,34,8,68,82,526,10.2
668,Marvelle Harris\marvelle-harris-2,2014-15,Fresno State,G,32,31,1168,174,402,.433,121,237,.511,53,165,.321,125,169,.740,23,138,161,120,65,8,85,96,526,12.0
669,Mustapha Heron\mustapha-heron-1,2017-18,Auburn,G,32,32,916,172,392,.439,129,262,.492,43,130,.331,139,173,.803,41,129,170,30,38,2,66,82,526,10.5
670,Tayler Persons\tayler-persons-1,2016-17,Ball State,G,34,33,986,183,382,.479,139,277,.502,44,105,.419,116,152,.763,13,118,131,167,44,2,105,88,526,11.3
671,DaVonte Lacy\davonte-lacy-1,2014-15,Washington State,G,31,31,1005,158,389,.406,90,183,.492,68,206,.330,141,183,.770,22,59,81,66,20,4,56,68,525,10.3
672,Braylon Rayson\braylon-rayson-1,2015-16,Central Michigan,G,32,31,1024,182,434,.419,101,223,.453,81,211,.384,80,97,.825,21,96,117,55,29,0,60,57,525,9.9
673,Tre' Coggins\tre-coggins-1,2016-17,Cal State Fullerton,G,30,25,966,177,429,.413,88,179,.492,89,250,.356,82,98,.837,10,96,106,37,28,4,61,55,525,10.0
674,Michael Weathers\michael-weathers-1,2016-17,Miami (OH),G,32,28,906,175,405,.432,156,319,.489,19,86,.221,156,201,.776,26,110,136,150,60,44,146,109,525,11.0
675,Tremont Waters\tremont-waters-1,2017-18,Louisiana State,G,33,32,1089,168,403,.417,96,198,.485,72,205,.351,117,146,.801,10,101,111,198,67,3,96,74,525,12.7
676,J.C. Hampton\jc-hampton-1,2015-16,Lipscomb,G,33,33,1087,170,424,.401,99,223,.444,71,201,.353,113,136,.831,29,91,120,90,38,4,64,62,524,10.6
677,Jordon Talley\jordon-talley-1,2017-18,North Carolina-Wilmington,G,31,27,939,179,423,.423,104,236,.441,75,187,.401,91,113,.805,16,71,87,176,30,2,78,94,524,11.7
678,Lonzo Ball\lonzo-ball-1,2016-17,UCLA,G,36,36,1263,189,343,.551,109,149,.732,80,194,.412,66,98,.673,33,183,216,274,66,28,89,65,524,16.3
679,Bryce Brown\bryce-brown-1,2017-18,Auburn,G,33,33,1031,169,421,.401,62,141,.440,107,280,.382,79,102,.775,19,46,65,55,32,7,43,55,524,9.9
680,Josh Williams\josh-williams-4,2014-15,Lipscomb,G,31,31,978,177,369,.480,108,193,.560,69,176,.392,101,138,.732,50,102,152,61,42,5,72,87,524,11.9
681,Frantz Massenat\frank-massenat-1,2013-14,Drexel,G,30,30,1105,161,398,.405,119,279,.427,42,119,.353,160,222,.721,17,96,113,142,23,12,57,83,524,12.2
682,Wayne Selden\wayne-selden-1,2015-16,Kansas,G,38,37,1134,189,399,.474,115,210,.548,74,189,.392,71,116,.612,30,101,131,100,28,11,71,77,523,9.4
683,Payton Pritchard\payton-pritchard-1,2017-18,Oregon,G,36,35,1265,178,398,.447,93,192,.484,85,206,.413,82,106,.774,18,120,138,171,51,0,76,88,523,11.5
684,Bryant Crawford\bryant-crawford-1,2017-18,Wake Forest,G,31,30,987,164,397,.413,107,238,.450,57,159,.358,138,159,.868,12,79,91,152,48,5,101,74,523,11.7
685,Levi Randolph\levi-randolph-1,2014-15,Alabama,G,34,34,1200,169,351,.481,130,239,.544,39,112,.348,146,174,.839,32,142,174,84,50,6,48,72,523,12.8
686,Daniel Bejarano\daniel-bejarano-1,2013-14,Colorado State,G,32,32,1084,164,450,.364,103,260,.396,61,190,.321,134,169,.793,73,194,267,105,35,18,58,59,523,12.8
687,Bronson Koenig\bronson-koenig-1,2016-17,Wisconsin,G,36,35,1129,181,431,.420,78,170,.459,103,261,.395,57,63,.905,6,70,76,73,23,12,51,61,522,9.0
688,Jazz Johnson\jazz-johnson-1,2016-17,Portland,G,33,33,1158,177,399,.444,116,252,.460,61,147,.415,107,130,.823,11,83,94,75,28,2,78,76,522,9.4
689,D'Vauntes Smith-Rivera\dvauntes-smith-rivera-1,2014-15,Georgetown,G,32,32,1102,157,373,.421,85,187,.455,72,186,.387,136,158,.861,26,108,134,101,51,6,52,67,522,12.9
690,Rodney Pryor\rodney-pryor-1,2015-16,Robert Morris,G,29,24,931,178,410,.434,129,241,.535,49,169,.290,117,136,.860,52,179,231,48,42,25,83,73,522,12.7
691,Paul Jackson\paul-johnson-3,2017-18,Eastern Michigan,G,35,33,1225,193,469,.412,161,361,.446,32,108,.296,104,143,.727,12,62,74,162,48,2,99,83,522,8.9
692,Beau Beech\beau-beech-1,2015-16,North Florida,G,34,34,1082,168,369,.455,71,140,.507,97,229,.424,89,113,.788,40,177,217,67,42,17,55,100,522,12.0
693,Aaron Thomas\aaron-thomas-3,2013-14,Florida State,G,36,16,1135,172,379,.454,133,274,.485,39,105,.371,139,172,.808,36,116,152,65,57,11,88,88,522,10.0
694,Max Strus\max-strus-1,2017-18,DePaul,G,31,31,1106,171,419,.408,90,176,.511,81,243,.333,98,122,.803,48,127,175,85,40,16,82,90,521,11.3
695,Brandon Young\brandon-young-1,2013-14,DePaul,G,32,32,1114,178,411,.433,149,297,.502,29,114,.254,136,201,.677,20,115,135,113,57,9,99,61,521,10.8
696,Luke Nelson\luke-nelson-1,2015-16,UC-Irvine,G,38,36,1178,177,412,.430,94,180,.522,83,232,.358,84,97,.866,12,98,110,149,48,4,67,66,521,10.5
697,Wesley Person\wesley-person-2,2015-16,Troy,G,31,30,1089,171,403,.424,75,146,.514,96,257,.374,83,109,.761,17,92,109,46,7,5,38,42,521,10.5
698,Marcus Colbert\marcus-colbert-1,2015-16,Montana State,G,31,31,1040,187,444,.421,135,294,.459,52,150,.347,95,130,.731,26,69,95,158,34,3,83,96,521,10.8
699,Francis Alonso\francis-alonso-1,2016-17,North Carolina-Greensboro,G,35,33,1007,152,338,.450,50,117,.427,102,221,.462,114,130,.877,11,55,66,71,29,2,64,83,520,9.9
700,Reed Timmer\reed-timmer-1,2015-16,Drake,G,31,31,1025,166,359,.462,126,260,.485,40,99,.404,148,182,.813,13,99,112,78,19,0,75,61,520,10.8
701,David Brown\david-brown-2,2014-15,Western Michigan,G,34,34,1119,165,389,.424,80,152,.526,85,237,.359,105,143,.734,13,103,116,73,45,4,63,94,520,9.9
702,Matthew Wright\matthew-wright-1,2013-14,St. Bonaventure,G,32,31,1117,164,401,.409,96,213,.451,68,188,.362,124,144,.861,28,72,100,101,35,2,90,66,520,10.3
703,Divine Myles\divine-myles-1,2017-18,Stetson,G,31,29,1076,190,381,.499,156,272,.574,34,109,.312,106,145,.731,24,115,139,130,49,4,49,53,520,14.1
704,Kyle Wilson\kyle-wilson-5,2015-16,Army,G,33,33,1074,175,470,.372,75,169,.444,100,301,.332,70,87,.805,12,63,75,55,13,9,58,56,520,7.8
705,E.C. Matthews\ec-matthews-1,2016-17,Rhode Island,G,35,34,1024,172,403,.427,108,213,.507,64,190,.337,112,154,.727,21,128,149,53,19,12,66,59,520,9.1
706,Ken Williams\ken-williams-1,2014-15,South Alabama,G,33,27,1087,165,439,.376,78,204,.382,87,235,.370,102,129,.791,13,108,121,80,24,9,76,66,519,8.9
707,Justin Bibbins\justin-bibbins-1,2017-18,Utah,G,35,35,1222,154,337,.457,61,125,.488,93,212,.439,118,135,.874,13,91,104,163,45,4,71,88,519,12.3
708,Kevin Pangos\kevin-pangos-1,2013-14,Gonzaga,G,36,36,1239,159,370,.430,75,166,.452,84,204,.412,117,134,.873,8,110,118,128,37,1,60,70,519,11.0
709,D.J. Fenner\dj-fenner-1,2015-16,Nevada,G,38,36,1283,174,476,.366,121,299,.405,53,177,.299,118,138,.855,27,147,174,74,42,18,65,107,519,8.1
710,Karl Cochran\karl-cochran-1,2013-14,Wofford,G,33,22,1011,193,465,.415,115,261,.441,78,204,.382,54,80,.675,20,144,164,100,55,19,64,74,518,10.9
711,Tyler Kohl\tyler-kohl-1,2017-18,Central Connecticut State,G,31,28,1080,180,427,.422,137,279,.491,43,148,.291,115,146,.788,59,195,254,128,42,4,114,61,518,12.1
712,Brandon Clarke\brandon-clarke-1,2016-17,San Jose State,G,30,30,957,219,370,.592,218,367,.594,1,3,.333,79,138,.572,89,172,261,69,35,75,53,78,518,16.3
713,James Blackmon\james-blackmon-1,2014-15,Indiana,G,33,33,989,177,421,.420,100,222,.450,77,199,.387,87,108,.806,53,123,176,50,21,2,53,51,518,10.4
714,Lindell Wigginton\lindell-wigginton-1,2017-18,Iowa State,G,31,31,1022,171,413,.414,102,241,.423,69,172,.401,107,162,.660,20,96,116,88,28,13,92,78,518,9.5
715,Mike Caffey\michael-caffey-1,2013-14,Cal State Long Beach,G,32,31,1106,185,452,.409,143,307,.466,42,145,.290,106,160,.663,51,90,141,136,45,4,98,66,518,10.5
716,Steven Spieth\steven-spieth-1,2016-17,Brown,G,30,30,1037,153,314,.487,103,191,.539,50,123,.407,162,184,.880,43,137,180,100,43,11,101,85,518,13.6
717,Chris Fowler\chris-fowler-1,2014-15,Central Michigan,G,32,32,1093,183,361,.507,163,295,.553,20,66,.303,132,194,.680,16,83,99,194,49,7,91,77,518,13.1
718,Dusty Hannahs\dusty-hannahs-1,2016-17,Arkansas,G,36,23,890,168,383,.439,94,192,.490,74,191,.387,108,119,.908,19,42,61,42,16,4,60,63,518,8.4
719,Nate Mason\nate-mason-1,2016-17,Minnesota,G,34,32,1174,169,450,.376,115,300,.383,54,150,.360,126,156,.808,22,102,124,169,45,5,65,55,518,11.3
720,Marcus Posley\marcus-posley-1,2014-15,St. Bonaventure,G,31,29,1114,170,445,.382,94,209,.450,76,236,.322,101,129,.783,14,77,91,66,38,1,64,71,517,9.3
721,Darius Thompson\darius-thompson-1,2017-18,Western Kentucky,G,38,37,1354,177,382,.463,123,230,.535,54,152,.355,109,148,.736,23,136,159,181,58,18,66,69,517,12.2
722,Nate Mason\nate-mason-1,2017-18,Minnesota,G,31,31,1057,168,428,.393,91,231,.394,77,197,.391,104,134,.776,18,95,113,130,34,2,47,60,517,11.9
723,Corey Sanders\corey-sanders-2,2017-18,Rutgers,G,34,32,1127,205,511,.401,183,413,.443,22,98,.224,85,120,.708,18,129,147,106,44,9,76,54,517,9.0
724,Donte Clark\donte-clark-1,2015-16,Massachusetts,G,32,31,995,158,384,.411,96,201,.478,62,183,.339,139,184,.755,19,103,122,73,28,9,71,105,517,9.7
725,Ivy Smith Jr.\ivy-smithjr-1,2017-18,Grambling,G,31,30,1089,149,373,.399,124,304,.408,25,69,.362,194,241,.805,25,114,139,154,67,5,110,94,517,12.2
726,Derrick Henry\derrick-henry-1,2015-16,Citadel,G,32,15,838,152,355,.428,111,216,.514,41,139,.295,172,218,.789,34,96,130,43,37,0,51,63,517,11.1
727,Chris Hass\chris-hass-1,2015-16,Bucknell,G,30,30,945,163,385,.423,103,203,.507,60,182,.330,131,158,.829,24,97,121,48,34,14,63,65,517,11.2
728,Chaz Williams\chaz-williams-1,2013-14,Massachusetts,G,33,33,1163,162,402,.403,108,253,.427,54,149,.362,138,183,.754,27,65,92,229,52,7,113,97,516,11.7
729,Stephen Holt\stephen-holt--1,2013-14,Saint Mary's (CA),G,34,34,1275,148,328,.451,90,197,.457,58,131,.443,162,195,.831,39,89,128,134,26,0,65,79,516,12.0
730,Kameron Chatman\kameron-chatman-1,2017-18,Detroit Mercy,G,29,29,945,183,388,.472,123,243,.506,60,145,.414,90,106,.849,41,197,238,60,36,11,59,75,516,13.6
731,Ron Baker\ron-baker-1,2014-15,Wichita State,G,35,35,1145,171,395,.433,91,186,.489,80,209,.383,94,124,.758,31,126,157,88,45,27,39,60,516,11.9
732,Xavier Cooks\xavier-cooks-1,2017-18,Winthrop,G,30,29,894,194,385,.504,173,319,.542,21,66,.318,107,160,.669,64,199,263,108,30,64,98,72,516,14.4
733,Cameron Clark\cameron-clark-1,2013-14,Oklahoma,G,33,33,915,190,411,.462,153,326,.469,37,85,.435,99,124,.798,44,139,183,37,34,13,43,87,516,10.8
734,Maodo Lo\maodo-lo-1,2014-15,Columbia,G,28,28,957,181,370,.489,97,175,.554,84,195,.431,70,91,.769,13,109,122,65,43,16,69,62,516,13.2
735,Kris Dunn\kris-dunn-1,2014-15,Providence,G,33,33,1123,185,390,.474,158,313,.505,27,77,.351,118,172,.686,28,152,180,247,90,10,138,101,515,13.7
736,Nike Sibande\nike-sibande-1,2017-18,Miami (OH),G,34,33,1117,171,413,.414,94,193,.487,77,220,.350,96,131,.733,28,118,146,42,39,5,72,63,515,9.1
737,Bryce Alford\bryce-alford-1,2015-16,UCLA,G,32,32,1159,157,408,.385,84,209,.402,73,199,.367,128,154,.831,9,113,122,167,23,0,63,41,515,12.0
738,Martez Harrison\martez-harrison-1,2013-14,Missouri-Kansas City,G,30,27,973,159,362,.439,126,270,.467,33,92,.359,164,257,.638,22,78,100,114,50,0,92,89,515,11.0
739,Jordan Downing\jordan-downing-1,2014-15,Presbyterian,G,31,30,1007,184,445,.413,115,251,.458,69,194,.356,78,102,.765,21,112,133,36,19,5,63,67,515,8.8
740,Jaylin Walker\jaylin-walker-1,2017-18,Kent State,G,31,27,1043,171,450,.380,87,194,.448,84,256,.328,89,113,.788,38,82,120,62,32,4,80,49,515,9.3
741,Isaiah Sykes\isaiah-sykes-1,2013-14,Central Florida,G,30,29,958,198,417,.475,186,385,.483,12,32,.375,107,198,.540,88,129,217,105,51,5,110,80,515,11.7
742,Richard Carter\richard-carter-1,2013-14,Drake,G,31,31,969,157,367,.428,115,237,.485,42,130,.323,158,214,.738,16,82,98,117,55,0,76,75,514,11.7
743,Peter Jok\peter-jok-1,2015-16,Iowa,G,32,32,887,171,397,.431,91,198,.460,80,199,.402,92,108,.852,28,84,112,46,40,1,46,76,514,10.6
744,Seth Allen\seth-allen-1,2015-16,Virginia Tech,G,35,16,985,150,381,.394,106,224,.473,44,157,.280,170,219,.776,9,97,106,88,33,9,102,79,514,8.3
745,Jordan Parks\jordan-parks-1,2014-15,North Carolina Central,G,33,33,1042,212,321,.660,206,305,.675,6,16,.375,84,126,.667,87,186,273,22,35,31,61,98,514,13.5
746,Marcus Foster\marcus-foster-1,2013-14,Kansas State,G,33,33,969,177,418,.423,98,218,.450,79,200,.395,80,109,.734,26,80,106,84,19,7,73,79,513,9.1
747,Josh Richardson\josh-richardson-2,2014-15,Tennessee,G,32,32,1162,184,399,.461,138,271,.509,46,128,.359,99,124,.798,28,115,143,115,67,16,85,79,513,12.3
748,Colton Weisbrod\colton-weisbrod-1,2016-17,Lamar,G,34,34,1066,177,339,.522,176,333,.529,1,6,.167,158,222,.712,90,186,276,31,19,7,87,75,513,10.8
749,Jimmie Taylor\jimmie-taylor-2,2016-17,Rider,G,33,32,1180,170,399,.426,103,214,.481,67,185,.362,106,141,.752,46,115,161,61,37,9,48,86,513,10.8
750,Divine Myles\divine-myles-1,2016-17,Stetson,G,31,31,1045,189,372,.508,159,294,.541,30,78,.385,105,147,.714,26,120,146,122,29,3,65,63,513,12.6
751,Marqueze Coleman\marqueze-coleman-1,2015-16,Nevada,G,34,25,1003,151,369,.409,121,272,.445,30,97,.309,181,243,.745,24,121,145,111,41,5,88,92,513,10.0
752,Rion Brown\rion-brown-1,2013-14,Miami (FL),G,33,32,1167,174,403,.432,111,204,.544,63,199,.317,102,135,.756,47,146,193,76,27,4,51,62,513,11.2
753,Jordan Potts\jordan-potts-1,2015-16,Bethune-Cookman,G,32,32,1207,156,448,.348,71,183,.388,85,265,.321,116,149,.779,19,82,101,138,50,3,90,76,513,9.8
754,Delon Wright\delon-wright-1,2013-14,Utah,G,33,33,1202,174,310,.561,162,256,.633,12,54,.222,153,193,.793,42,182,224,174,82,43,84,61,513,16.9
755,Mikey Dixon\mikey-dixon-1,2016-17,Quinnipiac,G,31,20,924,171,377,.454,111,215,.516,60,162,.370,110,128,.859,35,81,116,72,23,2,68,59,512,11.0
756,Brian Parker\brian-parker-2,2017-18,Marist,G,30,29,972,165,350,.471,136,260,.523,29,90,.322,153,216,.708,27,132,159,101,14,3,121,75,512,10.1
757,Peter Hooley\peter-hooley-1,2013-14,Albany (NY),G,33,32,1157,143,359,.398,72,176,.409,71,183,.388,155,182,.852,10,79,89,87,27,0,67,51,512,10.3
758,Gabe York\gabe-york-1,2015-16,Arizona,G,34,34,1133,177,419,.422,79,186,.425,98,233,.421,59,78,.756,19,90,109,76,30,9,71,70,511,9.2
759,Javontae Hawkins\javontae-hawkins-1,2015-16,Eastern Kentucky,G,30,28,866,182,363,.501,149,264,.564,33,99,.333,114,149,.765,40,103,143,63,29,13,82,95,511,11.2
760,Rob Edwards\rob-edwards-1,2016-17,Cleveland State,G,31,30,964,167,404,.413,104,226,.460,63,178,.354,114,149,.765,29,110,139,54,41,5,95,68,511,9.5
761,Gary Payton\gary-payton-2,2015-16,Oregon State,G,32,32,1096,205,422,.486,183,352,.520,22,70,.314,79,123,.642,77,174,251,161,80,16,74,85,511,15.1
762,Stephan Hicks\stephen-hicks-1,2014-15,Cal State Northridge,G,32,32,1072,167,333,.502,151,293,.515,16,40,.400,161,198,.813,61,112,173,46,30,15,60,75,511,12.2
763,John Murry\john-murry-1,2016-17,Austin Peay,G,30,25,908,165,346,.477,124,227,.546,41,119,.345,140,173,.809,15,66,81,46,22,3,73,49,511,10.5
764,James Blackmon\james-blackmon-1,2016-17,Indiana,G,30,30,915,174,365,.477,83,150,.553,91,215,.423,72,86,.837,29,115,144,56,21,1,58,54,511,11.9
765,Ryan Daly\ryan-daly-1,2016-17,Delaware,G,32,21,1072,189,444,.426,127,261,.487,62,183,.339,71,104,.683,67,171,238,66,27,8,39,66,511,11.7
766,Wes Washpun\wes-washpun-1,2015-16,Northern Iowa,G,36,36,1241,177,379,.467,151,290,.521,26,89,.292,131,182,.720,9,138,147,190,42,25,93,94,511,11.3
767,Joel Berry\joel-berry-1,2015-16,North Carolina,G,40,39,1228,176,396,.444,108,218,.495,68,178,.382,91,105,.867,25,108,133,150,58,9,61,89,511,10.5
768,Jeremiah Martin\jeremiah-martin-1,2017-18,Memphis,G,27,26,936,157,354,.444,106,198,.535,51,156,.327,145,185,.784,20,95,115,103,61,17,73,52,510,14.9
769,Karl Cochran\karl-cochran-1,2014-15,Wofford,G,35,35,1091,182,468,.389,84,200,.420,98,268,.366,48,74,.649,29,176,205,94,63,36,57,67,510,11.1
770,Anthony Drmic\anthony-drmic-1,2013-14,Boise State,G,32,31,1048,171,388,.441,110,209,.526,61,179,.341,107,137,.781,32,112,144,55,36,3,60,87,510,10.4
771,Denzel Ingram\denzel-ingram-1,2016-17,North Carolina-Wilmington,G,35,35,1171,173,435,.398,64,139,.460,109,296,.368,55,78,.705,19,57,76,188,47,2,60,66,510,11.1
772,Kahlil Dukes\kahlil-dukes-1,2016-17,Niagara,G,33,32,1113,170,413,.412,105,256,.410,65,157,.414,105,114,.921,8,89,97,136,32,1,82,55,510,10.3
773,Kris Yanku\kris-yanku-1,2014-15,Northern Arizona,G,37,29,1111,130,393,.331,110,325,.338,20,68,.294,230,289,.796,22,143,165,189,43,1,115,94,510,9.3
774,Matt Morgan\matt-morgan-1,2015-16,Cornell,G,27,26,829,159,383,.415,89,170,.524,70,213,.329,122,151,.808,11,74,85,53,38,10,52,46,510,12.4
775,Jared Brownridge\jared-brownridge-1,2014-15,Santa Clara,G,32,32,1079,161,365,.441,68,150,.453,93,215,.433,94,109,.862,12,80,92,81,34,4,47,58,509,11.5
776,MaCio Teague\macio-teague-1,2016-17,North Carolina-Asheville,G,33,32,1124,169,361,.468,99,207,.478,70,154,.455,101,114,.886,18,133,151,90,36,6,31,46,509,12.9
777,Tucker Haymond\tucker-haymond-1,2015-16,Western Michigan,G,32,31,1019,169,398,.425,137,275,.498,32,123,.260,139,196,.709,61,125,186,73,21,1,74,70,509,10.2
778,Cezar Guerrero\cezar-guerrero-1,2013-14,Fresno State,G,39,38,1140,163,396,.412,92,190,.484,71,206,.345,112,128,.875,16,113,129,137,52,3,82,95,509,9.4
779,Eric Eaves\eric-eaves-1,2016-17,South Carolina State,G,31,24,921,175,377,.464,140,268,.522,35,109,.321,124,180,.689,40,84,124,78,20,11,60,51,509,11.2
780,Delon Wright\delon-wright-1,2014-15,Utah,G,35,35,1165,165,324,.509,139,251,.554,26,73,.356,153,183,.836,34,139,173,178,73,34,68,49,509,15.3
781,Tyree Griffin\tyree-griffin-1,2017-18,Southern Mississippi,G,34,34,1207,181,420,.431,126,266,.474,55,154,.357,92,132,.697,25,113,138,201,59,3,89,58,509,12.1
782,Jon Davis\jon-davis-1,2017-18,Charlotte,G,29,28,1051,159,406,.392,111,260,.427,48,146,.329,143,181,.790,25,85,110,160,27,9,114,44,509,11.4
783,Montrael Scott\montrael-scott-1,2013-14,Prairie View,G,34,32,1060,174,389,.447,100,212,.472,74,177,.418,86,114,.754,49,105,154,65,45,1,77,72,508,10.2
784,Tyron Criswell\tyron-criswell-1,2015-16,Nevada,G,38,18,1150,174,341,.510,161,295,.546,13,46,.283,147,205,.717,93,142,235,79,39,23,79,110,508,10.8
785,Marcus Burton\marcus-burton-1,2014-15,Wagner,G,29,29,979,174,434,.401,113,244,.463,61,190,.321,99,122,.811,15,62,77,46,33,0,66,57,508,9.3
786,Jeff Short\jeffrey-short-1,2015-16,Norfolk State,G,33,27,955,154,375,.411,87,189,.460,67,186,.360,133,162,.821,14,105,119,86,28,4,74,87,508,9.7
787,Kyle Wilson\kyle-wilson-5,2014-15,Army,G,29,26,939,171,445,.384,97,226,.429,74,219,.338,92,117,.786,14,69,83,54,23,3,77,51,508,8.7
788,Schadrac Casimir\schadrac-casimir-1,2014-15,Iona,G,35,34,1201,156,365,.427,62,143,.434,94,222,.423,102,114,.895,19,79,98,69,39,2,41,77,508,10.4
789,Brian Beard Jr.\brian-beardjr-1,2017-18,Florida International,G,31,30,1114,167,411,.406,131,265,.494,36,146,.247,138,213,.648,6,114,120,178,90,0,100,77,508,12.2
790,Tim Frazier\tim-frazier-1,2013-14,Penn State,G,34,34,1196,163,379,.430,138,293,.471,25,86,.291,157,200,.785,31,120,151,182,53,6,92,87,508,11.9
791,Junior Robinson\lamont-robinson-1,2016-17,Mount St. Mary's,G,36,34,1201,160,378,.423,90,202,.446,70,176,.398,118,136,.868,8,50,58,102,32,4,93,75,508,8.4
792,LaVone Holland\lavone-holland-1,2016-17,Northern Kentucky,G,35,33,1081,172,390,.441,116,237,.489,56,153,.366,108,164,.659,18,80,98,143,45,9,106,65,508,9.6
793,Elijah Wilson\elijah-wilson-1,2016-17,Coastal Carolina,G,39,38,1182,173,492,.352,73,187,.390,100,305,.328,62,83,.747,35,89,124,49,38,2,71,75,508,6.4
794,Jaron Martin\jaron-martin-1,2016-17,UC-Irvine,G,36,34,1082,185,422,.438,105,227,.463,80,195,.410,58,69,.841,14,89,103,113,29,1,62,49,508,9.6
795,Kellen Dunham\kellen-dunham-1,2013-14,Butler,G,31,31,1119,164,420,.390,86,200,.430,78,220,.355,102,127,.803,13,110,123,52,21,8,66,46,508,9.4
796,Ervin Mitchell\ervin-mitchell-2,2016-17,Grambling,G,30,27,963,166,352,.472,124,246,.504,42,106,.396,133,190,.700,26,83,109,30,39,12,66,85,507,10.5
797,Shannon Evans\shannon-evans-1,2014-15,Buffalo,G,33,33,1139,163,395,.413,97,222,.437,66,173,.382,115,144,.799,15,89,104,153,56,10,84,69,507,11.5
798,Brandon Clark\brandon-clark-1,2014-15,Santa Clara,G,32,32,1045,163,434,.376,113,257,.440,50,177,.282,131,153,.856,12,106,118,124,28,0,68,84,507,9.8
799,Tim Derksen\tim-derksen-1,2015-16,San Francisco,G,30,30,978,177,358,.494,127,245,.518,50,113,.442,103,141,.730,74,134,208,60,21,9,47,79,507,13.2
800,Jeffrey Carroll\jeffrey-carroll-2,2017-18,Oklahoma State,G,33,27,1012,167,411,.406,100,209,.478,67,202,.332,106,137,.774,52,152,204,59,27,9,64,56,507,10.4
801,Isaac Hamilton\isaac-hamilton-1,2016-17,UCLA,G,36,36,1080,193,426,.453,119,224,.531,74,202,.366,47,57,.825,30,98,128,99,25,6,71,63,507,9.3
802,Desmond Haymon\desmond-haymon-1,2013-14,Stephen F. Austin,G,35,34,1060,155,369,.420,94,202,.465,61,167,.365,136,204,.667,42,90,132,100,29,2,58,70,507,10.1
803,Desonta Bradford\desonta-bradford-1,2017-18,East Tennessee State,G,33,32,1075,180,380,.474,138,245,.563,42,135,.311,105,142,.739,26,165,191,116,62,15,72,64,507,12.8
804,Pookie Powell\rashawn-powell-1,2017-18,La Salle,G,30,30,1102,178,442,.403,122,265,.460,56,177,.316,95,118,.805,11,114,125,130,25,4,79,55,507,10.6
805,Jaleen Smith\jaleen-smith-1,2016-17,New Hampshire,G,32,31,1158,179,384,.466,131,250,.524,48,134,.358,100,128,.781,42,163,205,137,29,20,95,85,506,12.1
806,Matt Farrell\matt-farrell-1,2016-17,Notre Dame,G,36,36,1238,172,384,.448,91,191,.476,81,193,.420,81,102,.794,9,63,72,196,51,5,91,71,506,11.0
807,Matt Morgan\matt-morgan-1,2016-17,Cornell,G,28,27,906,165,362,.456,79,133,.594,86,229,.376,90,105,.857,13,116,129,60,22,6,71,60,506,11.8
808,Lee Moore\lee-moore-1,2015-16,Texas-El Paso,G,33,30,1053,156,345,.452,108,213,.507,48,132,.364,146,197,.741,50,128,178,116,46,10,70,70,506,12.6
809,Taveion Hollingsworth\taveion-hollingsworth-1,2017-18,Western Kentucky,G,38,37,1312,170,354,.480,125,235,.532,45,119,.378,121,153,.791,31,98,129,71,39,5,67,75,506,9.5
810,Emile Blackman\emile-blackman-1,2015-16,Niagara,G,32,31,1067,185,426,.434,143,282,.507,42,144,.292,94,117,.803,38,74,112,44,29,6,84,88,506,8.3
811,Julius Brown\julius-brown-2,2013-14,Toledo,G,34,34,1145,163,390,.418,104,224,.464,59,166,.355,121,139,.871,10,64,74,205,39,4,94,46,506,11.5
812,Derrick Marks\derrick-marks-1,2013-14,Boise State,G,34,33,961,173,392,.441,154,326,.472,19,66,.288,140,173,.809,15,99,114,89,51,10,89,99,505,9.4
813,Stephen Thompson Jr.\stephen-thompsonjr-1,2017-18,Oregon State,G,32,32,1172,187,406,.461,123,222,.554,64,184,.348,67,102,.657,25,75,100,104,55,11,67,72,505,11.3
814,Brenton Williams\brenton-williams-1,2013-14,South Carolina,G,34,25,1030,146,345,.423,53,127,.417,93,218,.427,120,129,.930,15,49,64,46,37,0,41,44,505,10.4
815,Jermaine Ruttley\jermaine-ruttley-1,2014-15,Florida A&M,G,29,29,956,181,401,.451,148,289,.512,33,112,.295,110,162,.679,40,154,194,62,46,2,69,88,505,11.6
816,Matt Farrell\matt-farrell-1,2017-18,Notre Dame,G,31,31,1111,168,410,.410,70,150,.467,98,260,.377,71,87,.816,6,69,75,169,32,2,74,46,505,11.7
817,Devin Martin\devin-martin-1,2015-16,Maryland-Eastern Shore,G,30,28,987,174,410,.424,107,224,.478,67,186,.360,90,119,.756,31,108,139,63,38,10,72,64,505,10.7
818,Sean McGonagill\sean-mcgonagill-1,2013-14,Brown,G,29,29,1084,162,405,.400,69,172,.401,93,233,.399,88,113,.779,17,108,125,109,38,1,50,72,505,12.3
819,Darell Combs\darell-combs-1,2015-16,IUPUI,G,31,27,950,165,386,.427,107,247,.433,58,139,.417,117,155,.755,12,58,70,68,31,1,101,93,505,8.1
820,Bryn Forbes\bryn-forbes-1,2015-16,Michigan State,G,35,34,982,165,343,.481,53,110,.482,112,233,.481,63,75,.840,12,61,73,52,14,1,30,51,505,10.1
821,KeVaughn Allen\kevaughn-allen-1,2016-17,Florida,G,36,36,1029,168,384,.438,90,173,.520,78,211,.370,91,103,.883,8,78,86,53,45,10,46,58,505,9.7
822,B.J. Taylor\bj-taylor-1,2016-17,Central Florida,G,29,28,1056,165,399,.414,117,258,.453,48,141,.340,126,175,.720,11,105,116,101,32,1,64,60,504,11.2
823,Frank Bartley\frank-bartley-1,2016-17,Louisiana,G,33,32,1068,162,367,.441,94,177,.531,68,190,.358,112,156,.718,28,114,142,85,55,3,64,79,504,11.2
824,Korey Billbury\korey-billbury-1,2013-14,Oral Roberts,G,33,32,1070,174,378,.460,150,314,.478,24,64,.375,132,182,.725,77,152,229,83,36,6,77,98,504,11.2
825,Anthony Cowan\anthony-cowan-1,2017-18,Maryland,G,32,32,1184,144,341,.422,90,194,.464,54,147,.367,162,191,.848,7,133,140,164,48,10,89,65,504,12.8
826,Carson Puriefoy\carson-puriefoy-1,2014-15,Stony Brook,G,35,34,1158,161,423,.381,110,255,.431,51,168,.304,131,173,.757,16,95,111,118,40,10,98,74,504,8.5
827,Jalen Jones\jalen-jones-1,2015-16,Texas A&M,G,33,28,902,175,412,.425,141,307,.459,34,105,.324,120,171,.702,64,172,236,21,22,9,53,94,504,9.5
828,Darian Anderson\darin-anderson-1,2015-16,Fairleigh Dickinson,G,33,33,1090,183,446,.410,136,306,.444,47,140,.336,90,113,.796,25,95,120,123,60,9,104,85,503,9.6
829,Marcel White\marcel-white-1,2015-16,Jacksonville,G,32,31,1022,160,380,.421,78,172,.453,82,208,.394,101,139,.727,36,143,179,45,25,20,52,67,503,10.8
830,Nic Moore\nic-moore-1,2013-14,Southern Methodist,G,37,37,1190,159,343,.464,87,178,.489,72,165,.436,113,137,.825,10,74,84,181,54,2,87,98,503,10.9
831,Anthony Myles\anthony-myles-2,2013-14,Rider,G,31,30,1024,146,350,.417,86,191,.450,60,159,.377,151,199,.759,27,106,133,69,22,10,68,74,503,10.6
832,Shavon Shields\shavon-shields-1,2015-16,Nebraska,G,30,30,921,181,385,.470,153,308,.497,28,77,.364,113,147,.769,39,114,153,80,38,10,72,55,503,12.0
833,Anthlon Bell\anthlon-bell-1,2015-16,Arkansas,G,32,30,917,172,402,.428,83,200,.415,89,202,.441,69,82,.841,22,71,93,39,20,7,35,70,502,9.7
834,Drew Crawford\drew-crawford-1,2013-14,Northwestern,G,32,32,1170,169,417,.405,119,264,.451,50,153,.327,114,146,.781,40,165,205,71,18,25,69,75,502,10.3
835,Ronshad Shabazz\ronshad-shabazz-1,2016-17,Appalachian State,G,30,29,929,176,442,.398,110,241,.456,66,201,.328,84,116,.724,16,90,106,51,23,2,52,57,502,9.1
836,Kendall Smith\kendall-smith-2,2016-17,Cal State Northridge,G,30,27,1003,171,382,.448,126,262,.481,45,120,.375,115,151,.762,22,98,120,143,40,7,82,62,502,12.4
837,Daishon Knight\daishon-knight-1,2014-15,Illinois State,G,35,35,1046,178,405,.440,133,282,.472,45,123,.366,101,117,.863,26,89,115,85,36,1,63,41,502,9.9
838,James Scott\james-scott-2,2017-18,Kennesaw State,G,29,29,923,188,452,.416,134,293,.457,54,159,.340,72,90,.800,16,53,69,65,50,6,77,66,502,9.6
839,Nijal Pearson\nijal-pearson-1,2017-18,Texas State,G,33,33,1077,172,437,.394,114,261,.437,58,176,.330,100,141,.709,67,130,197,80,44,13,80,75,502,10.1
840,Matej Kavas\matej-kavas-1,2017-18,Seattle,G,33,31,1038,171,361,.474,80,165,.485,91,196,.464,68,86,.791,38,131,169,41,13,7,67,100,501,9.5
841,Martin Hermannsson\martin-hermannsson-1,2015-16,Long Island University,G,31,31,1124,154,336,.458,118,236,.500,36,100,.360,157,178,.882,25,109,134,146,55,8,68,65,501,14.1
842,Ladarius Tabb\ladarius-tabb-1,2014-15,Alabama A&M,G,28,27,926,190,421,.451,144,262,.550,46,159,.289,75,124,.605,91,126,217,20,35,4,49,80,501,12.0
843,Tre Demps\tre-demps-1,2015-16,Northwestern,G,32,32,1185,189,475,.398,117,258,.453,72,217,.332,51,77,.662,16,98,114,104,21,1,39,28,501,10.0
844,Willie Mangum\willie-mangum-1,2016-17,Eastern Michigan,G,32,7,793,172,421,.409,79,174,.454,93,247,.377,64,90,.711,16,62,78,68,48,2,51,73,501,9.7
845,Darrun Hilliard\darrun-hilliard-1,2014-15,Villanova,G,35,35,1007,170,386,.440,91,182,.500,79,204,.387,82,103,.796,16,93,109,74,63,12,42,78,501,10.8
846,Paul Miller\paul-miller-2,2016-17,North Dakota State,G,30,29,998,161,358,.450,87,162,.537,74,196,.378,105,140,.750,16,141,157,54,28,12,62,67,501,11.3
847,Warren Gillis\warren-gillis-1,2013-14,Coastal Carolina,G,34,33,1115,167,358,.466,141,289,.488,26,69,.377,141,166,.849,21,99,120,106,56,3,94,79,501,10.5
848,PJ Dozier\pj-dozier-1,2016-17,South Carolina,G,36,36,1033,191,469,.407,149,328,.454,42,141,.298,77,129,.597,39,134,173,101,60,10,78,100,501,8.8
849,Jahmal McMurray\jahmal-mcmurray-1,2015-16,South Florida,G,33,26,1161,184,471,.391,111,260,.427,73,211,.346,59,74,.797,11,80,91,81,13,4,81,61,500,7.2
850,James Daniel\james-daniel-1,2014-15,Howard,G,30,30,972,140,414,.338,72,176,.409,68,238,.286,152,186,.817,15,50,65,81,55,0,108,56,500,8.6
851,Damon Lynn\damon-lynn-1,2013-14,NJIT,G,29,29,981,151,405,.373,44,123,.358,107,282,.379,91,117,.778,15,65,80,60,35,1,53,32,500,10.6
852,Charles Cooke\charles-cooke-1,2015-16,Dayton,G,32,31,1029,163,365,.447,104,216,.481,59,149,.396,115,167,.689,43,144,187,58,40,38,56,61,500,12.2
853,Louis Dabney\louis-dabney-1,2013-14,Tulane,G,33,33,1069,160,386,.415,131,283,.463,29,103,.282,151,214,.706,33,103,136,66,41,3,80,97,500,8.9
854,Maodo Lo\maodo-lo-1,2013-14,Columbia,G,34,34,1096,172,359,.479,96,189,.508,76,170,.447,80,96,.833,18,112,130,70,42,11,68,79,500,10.5
855,Jaylin Airington\jaylin-airington-1,2016-17,Cal State Bakersfield,G,35,35,1108,161,388,.415,117,268,.437,44,120,.367,134,168,.798,52,111,163,71,28,3,65,90,500,9.4
856,Eli Cain\eli-cain-1,2016-17,DePaul,G,32,32,1059,169,425,.398,118,277,.426,51,148,.345,111,154,.721,32,112,144,85,33,12,76,85,500,9.4
857,Jevon Carter\jevon-carter-1,2016-17,West Virginia,G,37,36,1184,166,378,.439,94,193,.487,72,185,.389,96,124,.774,38,146,184,137,92,9,67,95,500,12.2
858,Donte McGill\donte-mcgill-1,2015-16,Florida International,G,31,28,1006,189,391,.483,154,308,.500,35,83,.422,86,108,.796,47,96,143,39,24,3,66,48,499,10.4
859,Grant Benzinger\grant-benzinger-1,2017-18,Wright State,G,35,35,1219,156,404,.386,64,155,.413,92,249,.369,95,107,.888,48,141,189,41,25,7,38,82,499,9.6
860,Chris Thomas\chris-thomas-5,2015-16,Texas Southern,G,33,31,1123,189,376,.503,174,320,.544,15,56,.268,106,200,.530,57,112,169,143,33,12,121,102,499,9.9
861,Dexter McClanahan\dexter-mcclanahan-1,2017-18,Savannah State,G,32,27,945,166,407,.408,96,175,.549,70,232,.302,97,133,.729,37,98,135,61,39,6,56,60,499,10.2
862,Lucky Jones\lucky-jones-1,2013-14,Robert Morris,G,36,35,1069,152,388,.392,82,193,.425,70,195,.359,125,155,.806,59,187,246,57,45,16,76,105,499,9.8
863,Wesley Saunders\wesley-saunders-1,2014-15,Harvard,G,30,29,1032,164,362,.453,133,289,.460,31,73,.425,140,181,.773,51,131,182,128,55,11,78,66,499,13.9
864,Marcus Keene\marcus-keene-1,2014-15,Youngstown State,G,32,32,1117,167,372,.449,76,155,.490,91,217,.419,74,94,.787,13,100,113,88,35,3,68,80,499,10.5
865,Isaiah Bailey\isaiah-bailey-1,2017-18,Bethune-Cookman,G,31,23,998,149,352,.423,121,250,.484,28,102,.275,172,219,.785,42,123,165,149,27,8,123,91,498,10.8
866,Bryn Forbes\bryn-forbes-1,2013-14,Cleveland State,G,32,32,1102,154,355,.434,73,164,.445,81,191,.424,109,132,.826,23,76,99,54,25,1,50,50,498,10.4
867,Bernard Thompson\bernard-thompson-2,2013-14,Florida Gulf Coast,G,33,33,1013,167,388,.430,112,220,.509,55,168,.327,109,138,.790,32,103,135,57,48,7,63,79,498,10.1
868,Reggie Dillard\reggie-dillard-1,2017-18,Presbyterian,G,32,32,1074,175,401,.436,108,209,.517,67,192,.349,81,112,.723,17,86,103,56,23,9,84,72,498,8.4
869,Ryan Arcidiacono\ryan-arcidiacono-1,2015-16,Villanova,G,40,39,1282,165,371,.445,89,178,.500,76,193,.394,92,110,.836,15,102,117,169,54,1,61,60,498,10.7
870,Mikh McKinney\mikh-mckinney-1,2013-14,Sacramento State,G,30,30,1038,173,359,.482,135,249,.542,38,110,.345,114,139,.820,24,89,113,138,37,6,68,71,498,13.0
871,Rian Pearson\rian-pearson-1,2013-14,Toledo,G,34,34,1049,191,399,.479,162,331,.489,29,68,.426,87,130,.669,69,111,180,59,59,4,49,56,498,11.5
872,Trae Bell-Haynes\trae-bell-haynes-1,2017-18,Vermont,G,34,34,1089,166,325,.511,144,262,.550,22,63,.349,144,197,.731,21,125,146,138,38,4,106,80,498,10.8
873,Khyri Thomas\khyri-thomas-1,2017-18,Creighton,G,33,33,1046,184,342,.538,122,191,.639,62,151,.411,67,85,.788,35,109,144,92,56,8,59,62,497,12.8
874,Evan Payne\evan-payne-1,2013-14,Loyola Marymount,G,32,25,956,171,394,.434,133,284,.468,38,110,.345,117,139,.842,33,54,87,46,42,6,86,70,497,8.9
875,Marcus Ottey\marcus-ottey-1,2017-18,Illinois-Chicago,G,36,26,1003,184,355,.518,159,282,.564,25,73,.342,104,124,.839,19,101,120,65,32,15,69,79,497,9.6
876,Aaron Bacote\aaron-bacote-1,2015-16,Old Dominion,G,38,21,993,157,366,.429,110,229,.480,47,137,.343,136,167,.814,13,96,109,82,32,6,59,86,497,8.7
877,Matthew Butler\matthew-butler-1,2017-18,Tennessee-Martin,G,31,29,1169,180,450,.400,90,192,.469,90,258,.349,47,56,.839,10,71,81,92,29,2,100,62,497,8.0
878,Gabe DeVoe\gabe-devoe-1,2017-18,Clemson,G,35,35,1202,170,379,.449,84,162,.519,86,217,.396,71,91,.780,31,135,166,73,37,14,70,72,497,10.1
879,Isaiah Taylor\isaiah-taylor-1,2015-16,Texas,G,33,33,1019,159,379,.420,140,317,.442,19,62,.306,159,196,.811,14,78,92,164,29,7,61,88,496,11.1
880,Malachi Richardson\malachi-richardson-1,2015-16,Syracuse,G,37,37,1272,152,411,.370,73,187,.390,79,224,.353,113,157,.720,19,139,158,77,42,10,79,91,496,7.9
881,Zaid Hearst\zaid-hearst-1,2013-14,Quinnipiac,G,32,32,1067,147,334,.440,104,229,.454,43,105,.410,159,192,.828,84,127,211,61,22,12,52,83,496,12.3
882,Devonte Brown\devonte-brown-1,2015-16,Indiana State,G,32,31,1051,138,371,.372,116,276,.420,22,95,.232,197,260,.758,32,123,155,88,31,9,110,77,495,8.8
883,Zak Irvin\zak-irvin-1,2016-17,Michigan,G,38,38,1345,195,430,.453,141,273,.516,54,157,.344,51,76,.671,23,149,172,113,34,2,71,45,495,9.2
884,Jerome Garrison\jerome-garrison-1,2013-14,Grand Canyon,G,30,30,1134,128,306,.418,76,176,.432,52,130,.400,187,236,.792,18,66,84,64,14,10,60,75,495,10.7
885,Keron DeShields\keron-deshields-1,2015-16,Tennessee State,G,30,27,983,166,383,.433,118,250,.472,48,133,.361,115,154,.747,10,88,98,91,39,5,63,74,495,10.8
886,Deion Holmes\deion-holmes-1,2017-18,South Carolina Upstate,G,32,15,848,186,397,.469,134,244,.549,52,153,.340,71,92,.772,48,71,119,42,16,3,85,58,495,8.7
887,Eli Carter\eli-carter-1,2015-16,Boston College,G,31,30,1034,174,469,.371,110,242,.455,64,227,.282,83,106,.783,11,110,121,125,37,7,106,59,495,8.6
888,Jamel Waters\jamel-waters-1,2015-16,Alabama State,G,31,31,1057,160,390,.410,84,206,.408,76,184,.413,98,134,.731,32,102,134,134,54,2,81,65,494,11.8
889,Christian Keeling\christian-keeling-1,2017-18,Charleston Southern,G,28,24,941,169,397,.426,124,254,.488,45,143,.315,111,140,.793,22,123,145,57,37,12,67,69,494,11.3
890,Asante Gist\asante-gist-1,2016-17,Eastern Kentucky,G,31,29,986,158,422,.374,94,233,.403,64,189,.339,114,155,.735,10,69,79,112,29,1,105,96,494,7.7
891,Shannon Evans\shannon-evans-1,2016-17,Arizona State,G,33,33,1179,161,392,.411,89,191,.466,72,201,.358,100,120,.833,17,93,110,144,42,7,62,61,494,11.4
892,Jonathan Stark\jonathan-stark-1,2013-14,Tulane,G,34,34,1264,160,384,.417,115,266,.432,45,118,.381,129,173,.746,12,77,89,143,29,1,84,64,494,9.5
893,Jaaron Simmons\jaaron-simmons-1,2016-17,Ohio,G,31,31,1116,177,407,.435,140,300,.467,37,107,.346,103,142,.725,14,96,110,200,29,2,123,72,494,10.4
894,James Carlton\james-carlton-1,2014-15,Howard,G,31,31,980,181,384,.471,161,305,.528,20,79,.253,112,148,.757,59,183,242,31,31,32,84,87,494,10.8
895,Sam Hauser\sam-hauser-1,2017-18,Marquette,G,35,35,1141,174,349,.499,79,154,.513,95,195,.487,51,61,.836,35,165,200,100,35,16,42,73,494,12.4
896,Brenton Scott\brenton-scott-1,2016-17,Indiana State,G,31,29,980,165,441,.374,92,235,.391,73,206,.354,90,132,.682,10,141,151,74,50,5,57,63,493,9.9
897,James Woodard\james-woodard-1,2014-15,Tulsa,G,34,34,1174,158,388,.407,70,150,.467,88,238,.370,89,126,.706,18,149,167,38,30,8,46,55,493,9.5
898,Brent Jones\brent-jones-1,2014-15,St. Francis (NY),G,35,35,1188,157,396,.396,107,244,.439,50,152,.329,129,167,.772,28,91,119,184,66,3,120,68,493,10.3
899,Carson Puriefoy\carson-puriefoy-1,2015-16,Stony Brook,G,33,33,1113,156,398,.392,73,189,.386,83,209,.397,98,127,.772,21,85,106,103,40,13,81,75,493,9.6
900,Richaud Pack\richaud-pack-1,2013-14,North Carolina A&T,G,29,20,992,128,290,.441,76,154,.494,52,136,.382,185,230,.804,44,88,132,46,19,2,50,59,493,12.4
901,Justin Roberson\justin-roberson-1,2015-16,Louisiana-Monroe,G,34,34,1128,182,384,.474,140,283,.495,42,101,.416,87,127,.685,28,131,159,93,57,4,75,109,493,10.2
902,Myles Mack\myles-mack-1,2013-14,Rutgers,G,33,32,1008,156,387,.403,86,198,.434,70,189,.370,111,124,.895,19,71,90,142,54,6,87,70,493,10.8
903,Nic Moore\nic-moore-1,2014-15,Southern Methodist,G,34,34,1179,156,371,.420,79,186,.425,77,185,.416,104,117,.889,8,70,78,175,43,1,87,64,493,10.9
904,Donte McGill\donte-mcgill-1,2016-17,Florida International,G,27,24,912,181,412,.439,155,333,.465,26,79,.329,105,113,.929,50,46,96,30,37,3,58,64,493,11.1
905,Andre Walker\andre-walker-3,2016-17,Loyola (MD),G,33,30,1075,152,431,.353,70,215,.326,82,216,.380,107,124,.863,19,99,118,127,50,8,110,88,493,8.7
906,Quinton Rose\quinton-rose-1,2017-18,Temple,G,33,32,1064,190,438,.434,141,296,.476,49,142,.345,64,98,.653,24,118,142,75,49,6,80,56,493,9.2
907,Darius Jones-Gibson\derius-jones-gibson-1,2015-16,Samford,G,33,33,1078,157,327,.480,141,281,.502,16,46,.348,163,230,.709,15,79,94,114,32,7,101,82,493,9.6
908,Denzel Mahoney\denzel-mahoney-1,2016-17,Southeast Missouri State,G,33,33,976,152,339,.448,95,188,.505,57,151,.377,132,162,.815,47,93,140,40,23,4,45,106,493,10.1
909,Justin Turner\justin-turner-1,2017-18,Bowling Green State,G,31,31,1051,169,416,.406,119,284,.419,50,132,.379,104,128,.813,26,87,113,81,47,9,74,56,492,10.2
910,Maurice Watson Jr.\mo-watsonjr-1,2015-16,Creighton,G,35,35,1100,179,378,.474,160,314,.510,19,64,.297,115,161,.714,21,97,118,229,34,1,115,89,492,10.5
911,Robert Brown\robert-brown-4,2014-15,Alabama-Birmingham,G,36,36,1165,176,438,.402,115,251,.458,61,187,.326,79,107,.738,29,103,132,109,37,9,75,62,492,8.8
912,Emmett Naar\emmett-naar-1,2015-16,Saint Mary's (CA),G,35,34,1301,171,351,.487,115,217,.530,56,134,.418,94,108,.870,22,106,128,222,45,5,80,45,492,13.2
913,Cameron Morse\cameron-morse-1,2017-18,Youngstown State,G,32,29,1024,174,466,.373,95,229,.415,79,237,.333,65,83,.783,11,62,73,124,35,6,65,45,492,9.3
914,John Konchar\john-konchar-1,2016-17,Purdue-Fort Wayne,G,33,33,1153,188,295,.637,143,208,.688,45,87,.517,71,103,.689,79,209,288,126,55,15,51,61,492,16.5
915,Darian Anderson\darin-anderson-1,2016-17,Fairleigh Dickinson,G,29,29,971,165,396,.417,108,241,.448,57,155,.368,105,128,.820,21,89,110,94,58,7,61,75,492,12.1
916,Deondre Parks\deondre-parks-1,2015-16,South Dakota State,G,33,33,1069,164,388,.423,113,238,.475,51,150,.340,113,139,.813,25,127,152,50,26,7,56,74,492,9.4
917,Grayson Allen\grayson-allen-1,2016-17,Duke,G,34,25,1007,141,357,.395,60,135,.444,81,222,.365,129,159,.811,23,104,127,119,26,2,74,78,492,10.0
918,Ron Baker\ron-baker-1,2015-16,Wichita State,G,35,35,1106,160,377,.424,96,194,.495,64,183,.350,107,135,.793,19,149,168,113,53,21,54,50,491,11.7
919,Deondre Parks\deondre-parks-1,2014-15,South Dakota State,G,35,35,1113,167,391,.427,98,201,.488,69,190,.363,88,117,.752,17,125,142,67,22,3,62,85,491,8.5
920,James Bell\james-bell-1,2013-14,Villanova,G,34,33,1004,159,373,.426,74,144,.514,85,229,.371,88,108,.815,52,154,206,55,44,21,59,104,491,10.7
921,Earnest Ross\earnest-ross-1,2013-14,Missouri,G,35,35,1116,141,343,.411,84,160,.525,57,183,.311,152,196,.776,42,169,211,49,46,13,66,69,491,10.4
922,Quinton Upshur\quinton-upshur-1,2013-14,Northern Arizona,G,32,30,942,158,357,.443,85,166,.512,73,191,.382,102,142,.718,11,94,105,27,52,21,61,83,491,9.9
923,Davon Reed\davon-reed-1,2016-17,Miami (FL),G,33,33,1165,161,372,.433,82,173,.474,79,199,.397,90,108,.833,28,130,158,80,43,16,67,52,491,11.2
924,Connor Hill\connor-hill-1,2014-15,Idaho,G,30,30,921,164,365,.449,56,125,.448,108,240,.450,55,65,.846,15,53,68,20,15,0,30,56,491,10.0
925,Jason Dunne\jason-dunne-1,2017-18,Hartford,G,33,33,1172,169,406,.416,71,132,.538,98,274,.358,54,72,.750,17,106,123,92,42,8,74,76,490,9.6
926,C.J. Carter\cj-carter-1,2014-15,Omaha,G,29,29,995,176,388,.454,128,239,.536,48,149,.322,90,127,.709,13,54,67,78,43,19,85,70,490,10.2
927,Anthony Johnson\anthony-johnson-8,2015-16,Northern Colorado,G,31,23,896,157,350,.449,91,182,.500,66,168,.393,110,128,.859,38,104,142,26,22,8,61,74,490,10.1
928,John Konchar\john-konchar-1,2017-18,Purdue-Fort Wayne,G,33,31,1180,177,367,.482,111,195,.569,66,172,.384,70,108,.648,66,201,267,156,81,23,54,61,490,15.9
929,Troyce Manassa\troyce-manassa-1,2016-17,Savannah State,G,29,28,798,161,363,.444,97,182,.533,64,181,.354,104,145,.717,37,111,148,84,30,7,62,73,490,11.9
930,Elijah Brown\elijah-brown-1,2017-18,Oregon,G,36,34,1050,159,382,.416,67,129,.519,92,253,.364,80,86,.930,26,94,120,90,27,1,67,66,490,9.1
931,TJ Shorts II\tj-shortsii-1,2017-18,UC-Davis,G,33,32,1043,161,309,.521,151,280,.539,10,29,.345,158,212,.745,12,111,123,146,63,8,81,69,490,12.7
932,Milton Doyle\milton-doyle-1,2016-17,Loyola (IL),G,32,32,1044,169,376,.449,128,261,.490,41,115,.357,110,138,.797,19,142,161,142,55,22,92,77,489,12.0
933,Frank Mason\frank-mason-1,2015-16,Kansas,G,38,38,1272,155,357,.434,112,244,.459,43,113,.381,136,183,.743,27,136,163,175,50,3,73,84,489,10.8
934,Ryan Daly\ryan-daly-1,2017-18,Delaware,G,28,28,1049,178,413,.431,132,265,.498,46,148,.311,87,137,.635,40,133,173,67,33,3,35,60,489,12.2
935,Andre Hollins\andre-hollins-1,2013-14,Minnesota,G,36,36,1099,137,363,.377,70,171,.409,67,192,.349,148,176,.841,26,100,126,87,32,3,65,91,489,8.9
936,Marcel Mosley\marcel-mosley-1,2014-15,Arkansas-Pine Bluff,G,28,27,997,145,360,.403,76,179,.425,69,181,.381,130,159,.818,23,58,81,73,58,0,97,53,489,11.0
937,Malachi Flynn\malachi-flynn-1,2017-18,Washington State,G,31,30,1035,162,392,.413,85,164,.518,77,228,.338,88,104,.846,22,84,106,132,49,2,66,56,489,11.9
938,Will Cummings\will-cummings-1,2013-14,Temple,G,29,29,998,158,353,.448,126,249,.506,32,104,.308,140,178,.787,30,68,98,132,43,3,65,92,488,12.6
939,Ben Brust\ben-brust-1,2013-14,Wisconsin,G,38,38,1318,156,373,.418,60,129,.465,96,244,.393,80,89,.899,31,140,171,50,29,2,27,36,488,9.8
940,Isaiah Still\isaiah-still-1,2016-17,Robert Morris,G,31,30,1011,152,396,.384,92,212,.434,60,184,.326,124,197,.629,31,113,144,55,28,7,70,65,488,8.8
941,Jarred Jones\jarred-jones-1,2016-17,Loyola (MD),G,33,33,1020,182,398,.457,176,378,.466,6,20,.300,118,160,.738,49,166,215,63,44,36,93,88,488,10.1
942,Marcus Burk\marcus-burk-1,2017-18,Campbell,G,33,32,1048,173,353,.490,82,127,.646,91,226,.403,51,60,.850,21,99,120,38,42,8,45,58,488,10.8
943,Charles Cooper\charles-cooper-1,2015-16,Green Bay,G,36,36,962,160,340,.471,152,304,.500,8,36,.222,160,232,.690,59,139,198,53,37,6,75,65,488,9.6
944,Aleksa Jugovic\aleksa-jugovic-1,2016-17,Tennessee Tech,G,32,31,1123,148,371,.399,66,144,.458,82,227,.361,109,120,.908,12,69,81,66,26,5,59,48,487,9.6
945,Demetrius Dyson\demetrius-dyson-1,2017-18,Samford,G,32,31,985,161,358,.450,81,168,.482,80,190,.421,85,111,.766,34,126,160,35,30,9,68,66,487,10.0
946,Sam McDaniel\sam-mcdaniel-1,2017-18,Louisiana-Monroe,G,32,28,1074,162,381,.425,86,196,.439,76,185,.411,87,108,.806,38,146,184,66,33,9,70,79,487,10.3
947,Otis Livingston II\otis-livingstonii-1,2016-17,George Mason,G,34,34,1178,159,384,.414,114,250,.456,45,134,.336,124,135,.919,6,101,107,102,38,0,69,52,487,9.8
948,LaQuentin Miles\laquentin-miles-1,2013-14,Central Arkansas,G,21,19,702,175,357,.490,164,322,.509,11,35,.314,126,209,.603,48,109,157,58,29,9,84,42,487,15.0
949,Anthony Beane\anthony-beane-1,2013-14,Southern Illinois,G,33,33,1126,176,374,.471,124,242,.512,52,132,.394,82,107,.766,24,83,107,51,38,4,59,71,486,9.6
950,Damon Sherman-Newsome\damon-sherman-newsome-1,2014-15,Colgate,G,33,33,1026,175,380,.461,107,198,.540,68,182,.374,68,100,.680,18,93,111,60,20,5,60,51,486,9.2
951,Malcolm McMillan\malcolm-mcmillan-1,2015-16,Canisius,G,33,32,1132,132,313,.422,91,186,.489,41,127,.323,181,218,.830,17,85,102,135,22,17,60,79,486,11.5
952,Dajuan Graf\dajuan-graf-1,2016-17,North Carolina Central,G,34,32,1207,176,360,.489,144,279,.516,32,81,.395,102,130,.785,21,97,118,178,40,1,93,67,486,11.3
953,Darrun Hilliard\darrun-hilliard-1,2013-14,Villanova,G,34,34,991,157,323,.486,87,154,.565,70,169,.414,102,142,.718,30,94,124,90,44,17,76,68,486,10.9
954,Evan Payne\evan-payne-1,2014-15,Loyola Marymount,G,27,12,764,160,361,.443,123,256,.480,37,105,.352,129,163,.791,21,55,76,45,21,5,63,42,486,10.8
955,Julysses Nobles\julysses-nobles-1,2013-14,Jackson State,G,31,24,1096,153,396,.386,117,275,.425,36,121,.298,144,205,.702,14,116,130,112,44,4,98,79,486,9.2
956,Patrick McCaw\patrick-mccaw-1,2015-16,Nevada-Las Vegas,G,33,32,1113,168,361,.465,100,175,.571,68,186,.366,82,106,.774,38,131,169,128,81,13,68,73,486,13.3
957,Jaylen Franklin\jaylen-franklin-1,2015-16,Abilene Christian,G,30,23,883,176,343,.513,168,315,.533,8,28,.286,126,206,.612,23,92,115,82,52,4,85,84,486,10.7
958,Yonel Brown\yonel-brown-1,2014-15,Kennesaw State,G,32,32,1184,144,350,.411,81,185,.438,63,165,.382,135,150,.900,14,60,74,89,38,0,80,55,486,10.0
959,Jacobi Boykins\jacobi-boykins-1,2017-18,Louisiana Tech,G,33,33,1008,145,343,.423,47,95,.495,98,248,.395,97,106,.915,18,142,160,50,33,11,39,73,485,11.0
960,Melvin Johnson\melvin-johnson-1,2013-14,Arkansas State,G,32,28,947,156,330,.473,68,146,.466,88,184,.478,85,112,.759,15,126,141,42,27,2,65,62,485,10.1
961,A.J. Mosby\aj-mosby-1,2017-18,Alcorn State,G,32,31,1030,178,354,.503,120,209,.574,58,145,.400,71,82,.866,14,136,150,124,46,4,64,56,485,12.6
962,Scottie Lindsey\scottie-lindsey-1,2017-18,Northwestern,G,32,31,1026,169,424,.399,90,206,.437,79,218,.362,68,82,.829,24,99,123,54,15,14,52,82,485,8.6
963,Earl Potts\earl-potts-1,2015-16,Fairleigh Dickinson,G,33,32,1054,181,360,.503,115,195,.590,66,165,.400,57,79,.722,46,163,209,47,36,10,46,113,485,11.0
964,Mustapha Heron\mustapha-heron-1,2016-17,Auburn,G,32,32,901,152,344,.442,108,240,.450,44,104,.423,137,178,.770,52,143,195,41,27,6,77,87,485,9.9
965,Monte Morris\monte-morris-1,2015-16,Iowa State,G,35,35,1331,188,386,.487,150,280,.536,38,106,.358,70,96,.729,26,112,138,241,62,9,57,55,484,14.0
966,Connor Hill\connor-hill-1,2013-14,Idaho,G,34,34,1071,164,373,.440,66,131,.504,98,242,.405,58,77,.753,5,82,87,41,24,0,27,66,484,9.1
967,Mathieu Kamba\mathieu-kamba-1,2017-18,Central Arkansas,G,35,33,1059,171,330,.518,142,249,.570,29,81,.358,113,172,.657,70,144,214,80,39,35,80,81,484,11.3
968,Tiwian Kendley\tiwan-kendley-1,2016-17,Morgan State,G,23,20,744,139,373,.373,91,218,.417,48,155,.310,158,201,.786,42,82,124,28,28,10,99,64,484,10.7
969,Khalil Ahmad\khalil-ahmad-1,2017-18,Cal State Fullerton,G,32,30,1002,170,407,.418,113,229,.493,57,178,.320,87,105,.829,17,104,121,52,39,7,78,68,484,8.7
970,Tyler Dorsey\tyler-dorsey-1,2015-16,Oregon,G,36,35,1083,153,347,.441,86,182,.473,67,165,.406,111,156,.712,48,107,155,71,29,7,69,76,484,9.3
971,Devin Cannady\devin-cannady-1,2017-18,Princeton,G,29,28,1064,164,363,.452,84,160,.525,80,203,.394,76,86,.884,17,140,157,49,24,2,44,54,484,11.7
972,Kendall Stephens\kendall-stephens-1,2017-18,Nevada,G,37,36,1021,155,350,.443,29,58,.500,126,292,.432,47,51,.922,15,61,76,21,17,24,28,90,483,8.4
973,Sherrod Wright\sherrod-wright-1,2013-14,George Mason,G,31,30,958,162,362,.448,134,274,.489,28,88,.318,131,186,.704,21,79,100,25,26,5,76,67,483,8.2
974,Daryl Macon\daryl-macon-1,2016-17,Arkansas,G,36,21,908,141,311,.453,76,143,.531,65,168,.387,136,157,.866,19,76,95,80,41,2,65,65,483,9.9
975,Shaquille Harrison\shaquille-harrison-1,2015-16,Tulsa,G,32,32,1033,174,367,.474,166,326,.509,8,41,.195,127,200,.635,33,144,177,132,60,7,67,69,483,12.4
976,Garret Covington\garret-covington-1,2015-16,Western Illinois,G,27,27,911,159,358,.444,82,176,.466,77,182,.423,88,111,.793,12,99,111,53,23,5,59,47,483,11.5
977,Joe Rosga\joe-rosga-1,2017-18,Denver,G,30,30,1025,155,322,.481,82,156,.526,73,166,.440,100,111,.901,19,105,124,88,22,2,65,50,483,12.0
978,Trayvon Palmer\trayvon-palmer-1,2016-17,Chicago State,G,32,32,1151,172,379,.454,147,290,.507,25,89,.281,114,158,.722,95,207,302,49,48,20,92,103,483,11.3
979,Deon Jones\deon-jones-2,2013-14,Monmouth,G,32,31,973,150,336,.446,123,255,.482,27,81,.333,156,202,.772,69,152,221,43,39,21,88,77,483,10.9
980,Jermaine Marrow\jermaine-marrow-1,2016-17,Hampton,G,31,26,961,160,467,.343,118,315,.375,42,152,.276,121,159,.761,25,73,98,94,21,1,103,79,483,6.4
981,Jermaine Marshall\jermaine-marshall-1,2013-14,Arizona State,G,32,32,1013,162,360,.450,80,157,.510,82,203,.404,76,106,.717,11,88,99,45,24,15,48,76,482,9.5
982,Michael Frazier\michael-frazier-1,2013-14,Florida,G,39,34,1188,158,344,.459,40,79,.506,118,265,.445,48,57,.842,22,115,137,43,43,7,46,62,482,9.2
983,Jairus Lyles\jairus-lyles-1,2015-16,Maryland-Baltimore County,G,21,19,761,170,360,.472,132,249,.530,38,111,.342,104,149,.698,27,89,116,59,53,0,62,59,482,15.9
984,Ryan Woolridge\ryan-woolridge-1,2017-18,North Texas,G,38,37,1391,190,383,.496,173,329,.526,17,54,.315,85,168,.506,35,162,197,221,52,17,130,80,482,10.2
985,Askia Booker\askia-booker-1,2013-14,Colorado,G,35,35,1069,166,427,.389,129,291,.443,37,136,.272,112,137,.818,20,111,131,116,45,2,88,62,481,8.6
986,Devonte' Graham\devonte-graham-1,2016-17,Kansas,G,36,36,1269,157,367,.428,63,125,.504,94,242,.388,73,92,.793,17,95,112,149,55,7,64,56,481,11.0
987,Colton Weisbrod\colton-weisbrod-1,2017-18,Lamar,G,33,33,1124,171,371,.461,153,327,.468,18,44,.409,121,182,.665,95,171,266,61,37,6,66,81,481,11.2
988,Matt Carlino\matt-carlino-1,2013-14,Brigham Young,G,35,15,954,164,426,.385,104,249,.418,60,177,.339,93,135,.689,19,99,118,151,61,5,70,63,481,10.0
989,Xavier Moon\xavier-moon-1,2016-17,Morehead State,G,30,30,1051,164,378,.434,93,205,.454,71,173,.410,82,92,.891,12,94,106,139,35,9,59,58,481,12.4
990,Frank Eaves\frank-eaves-1,2014-15,Appalachian State,G,29,29,959,138,361,.382,76,184,.413,62,177,.350,143,176,.813,33,80,113,49,38,0,73,63,481,10.1
991,Makai Mason\makai-mason-1,2015-16,Yale,G,30,30,981,161,376,.428,106,222,.477,55,154,.357,104,128,.813,15,68,83,115,25,2,91,55,481,9.9
992,Tayler Persons\tayler-persons-1,2017-18,Ball State,G,32,32,953,187,406,.461,149,304,.490,38,102,.373,69,103,.670,17,90,107,137,26,5,94,78,481,9.3
993,Geno Crandall\geno-crandall-1,2016-17,North Dakota,G,31,31,1006,163,324,.503,125,217,.576,38,107,.355,117,156,.750,24,100,124,136,64,9,102,99,481,12.1
994,Chris Hansen\chris-hansen-1,2013-14,Idaho State,G,29,29,1001,150,352,.426,70,152,.461,80,200,.400,101,131,.771,16,97,113,54,31,5,53,60,481,11.0
995,Reginald Gee\reginald-gee-1,2017-18,Alabama State,G,31,29,931,152,349,.436,92,201,.458,60,148,.405,117,151,.775,39,105,144,30,20,14,48,63,481,10.3
996,D.J. Fenner\dj-fenner-1,2016-17,Nevada,G,35,22,1052,156,346,.451,92,199,.462,64,147,.435,105,126,.833,34,93,127,58,20,12,63,102,481,8.8
997,Jordan Woodard\jordan-woodard-1,2015-16,Oklahoma,G,37,37,1102,151,363,.416,71,187,.380,80,176,.455,99,123,.805,33,78,111,124,59,7,60,89,481,10.3
998,Kyle Guy\kyle-guy-1,2017-18,Virginia,G,34,33,1102,178,429,.415,95,217,.438,83,212,.392,42,51,.824,13,75,88,50,35,1,42,41,481,8.6
999,Dominic Artis\dominic-artis-1,2016-17,Texas-El Paso,G,32,32,1168,175,400,.438,138,274,.504,37,126,.294,93,146,.637,18,189,207,187,60,4,99,75,480,12.0
1000,Kevon Harris\kevon-harris-1,2017-18,Stephen F. Austin,G,33,31,863,159,331,.480,101,195,.518,58,136,.426,104,153,.680,70,112,182,43,34,7,60,54,480,11.0
1001,Jaysean Paige\jaysean-paige-1,2015-16,West Virginia,G,35,1,786,171,376,.455,128,243,.527,43,133,.323,95,121,.785,55,68,123,43,53,8,54,100,480,9.4
1002,Matthew Butler\matthew-butler-1,2016-17,Tennessee-Martin,G,35,33,1253,172,415,.414,90,196,.459,82,219,.374,54,76,.711,9,92,101,129,21,1,110,84,480,7.2
1003,Brett Comer\brett-comer-1,2013-14,Florida Gulf Coast,G,35,35,1084,177,389,.455,139,282,.493,38,107,.355,87,137,.635,23,79,102,187,41,7,108,84,479,9.5
1004,Khadeen Carrington\khadeen-carrington-1,2015-16,Seton Hall,G,34,31,1049,163,390,.418,107,223,.480,56,167,.335,97,129,.752,15,92,107,84,40,4,68,60,479,9.0
1005,Ken Williams\ken-williams-1,2015-16,South Alabama,G,31,31,963,153,418,.366,92,223,.413,61,195,.313,112,140,.800,18,86,104,106,26,6,82,36,479,9.1
1006,Braxton Ogbueze\braxton-ogbueze-1,2015-16,Charlotte,G,33,32,1131,160,383,.418,51,128,.398,109,255,.427,50,66,.758,18,58,76,87,16,2,38,51,479,9.6
1007,Trevor Cooney\trevor-cooney-1,2015-16,Syracuse,G,37,37,1347,150,431,.348,58,171,.339,92,260,.354,87,108,.806,22,73,95,82,61,5,56,49,479,8.4
1008,Phil Forte\phil-forte-1,2014-15,Oklahoma State,G,32,31,1078,139,328,.424,69,144,.479,70,184,.380,131,156,.840,3,64,67,55,60,2,60,44,479,10.6
1009,Caris LeVert\caris-levert-1,2013-14,Michigan,G,37,37,1258,163,371,.439,103,224,.460,60,147,.408,92,120,.767,19,141,160,109,44,10,62,63,478,9.9
1010,Quenton DeCosey\quenton-decosey-1,2013-14,Temple,G,31,30,1128,174,420,.414,116,247,.470,58,173,.335,72,109,.661,24,96,120,73,32,7,55,56,478,9.5
1011,Joe Jackson\joe-jackson-1,2013-14,Memphis,G,34,33,1129,154,348,.443,131,264,.496,23,84,.274,147,190,.774,36,86,122,154,52,2,73,68,478,11.5
1012,Milton Doyle\milton-doyle-1,2013-14,Loyola (IL),G,32,32,1050,154,363,.424,114,236,.483,40,127,.315,130,186,.699,29,104,133,115,38,23,108,88,478,9.6
1013,Shavon Shields\shavon-shields-1,2014-15,Nebraska,G,31,31,1095,161,366,.440,144,279,.516,17,87,.195,139,168,.827,45,141,186,67,33,5,84,73,478,10.3
1014,Damion Lee\damion-lee-1,2015-16,Louisville,G,30,30,1007,152,355,.428,91,176,.517,61,179,.341,113,134,.843,19,98,117,59,46,1,50,62,478,11.3
1015,Billy Garrett\billy-garrett-1,2016-17,DePaul,G,32,32,938,140,361,.388,99,248,.399,41,113,.363,157,178,.882,12,80,92,107,37,5,105,81,478,8.9
1016,Kurk Lee\kurk-lee-2,2016-17,Drexel,G,32,30,1053,171,412,.415,113,267,.423,58,145,.400,78,115,.678,24,100,124,160,51,0,94,86,478,10.1
1017,Aaseem Dixon\aaseem-dixon-1,2014-15,Northern Arizona,G,37,33,1293,158,435,.363,70,207,.338,88,228,.386,74,95,.779,28,98,126,85,27,1,55,63,478,7.7
1018,Quinndary Weatherspoon\quinndary-weatherspoon-1,2016-17,Mississippi State,G,29,29,926,173,369,.469,126,243,.519,47,126,.373,85,111,.766,40,108,148,53,50,9,64,68,478,11.8
1019,Zavier Turner\zavier-turner-1,2016-17,Manhattan,G,32,31,914,133,338,.393,75,196,.383,58,142,.408,154,175,.880,19,54,73,105,32,1,97,92,478,9.0
1020,Ty Cockfield\ty-cockfield-1,2017-18,Arkansas State,G,32,26,955,170,384,.443,116,235,.494,54,149,.362,83,106,.783,25,66,91,65,30,4,69,61,477,9.0
1021,Melvin Frazier\melvin-frazier-1,2017-18,Tulane,G,30,30,1032,179,322,.556,144,231,.623,35,91,.385,84,118,.712,35,133,168,86,65,22,77,60,477,13.8
1022,Evan Leonard\evan-leonard-1,2017-18,UC-Irvine,G,35,31,977,161,360,.447,94,191,.492,67,169,.396,88,111,.793,16,98,114,69,48,4,60,98,477,9.2
1023,James Woodard\james-woodard-1,2015-16,Tulsa,G,31,31,1056,145,349,.415,68,134,.507,77,215,.358,110,140,.786,20,143,163,74,31,12,56,49,477,11.3
1024,Johnathan Jordan\johnathan-jordan-1,2013-14,Texas A&M-Corpus Christi,G,33,33,1119,141,323,.437,133,288,.462,8,35,.229,187,271,.690,33,115,148,177,49,4,88,80,477,11.7
1025,Dez Wells\dezmine-wells-1,2013-14,Maryland,G,32,31,980,154,320,.481,137,264,.519,17,56,.304,152,186,.817,33,105,138,69,34,27,79,74,477,10.9
1026,Nijal Pearson\nijal-pearson-1,2016-17,Texas State,G,36,36,1182,167,382,.437,130,275,.473,37,107,.346,106,147,.721,68,138,206,88,49,14,79,84,477,9.9
1027,Trey Kell\trey-kell-1,2015-16,San Diego State,G,38,38,1084,158,390,.405,87,205,.424,71,185,.384,90,135,.667,29,113,142,54,30,7,67,51,477,7.6
1028,Landry Shamet\landry-shamet-1,2017-18,Wichita State,G,32,32,1015,154,315,.489,70,125,.560,84,190,.442,85,103,.825,14,89,103,166,23,6,67,61,477,12.5
1029,Darrell Davis\darrell-davis-2,2017-18,Dayton,G,31,31,1088,150,345,.435,78,156,.500,72,189,.381,105,120,.875,15,111,126,85,21,3,84,69,477,9.8
1030,Eric Fanning\eric-fanning-1,2016-17,Boston University,G,32,30,897,139,335,.415,103,233,.442,36,102,.353,163,208,.784,42,151,193,67,27,13,99,81,477,9.6
1031,Christen Cunningham\christian-cunningham-1,2015-16,Samford,G,33,33,1114,161,357,.451,142,287,.495,19,70,.271,135,163,.828,17,76,93,128,34,2,87,54,476,10.0
1032,Marcus LoVett\marcus-lovett-1,2016-17,St. John's (NY),G,30,25,948,166,358,.464,116,227,.511,50,131,.382,94,117,.803,18,70,88,113,40,1,79,61,476,11.1
1033,Prentiss Nixon\prentiss-nixon-1,2016-17,Colorado State,G,36,36,1153,152,400,.380,97,225,.431,55,175,.314,117,144,.813,11,91,102,72,30,4,60,94,476,7.4
1034,Eli Pemberton\eli-pemberton-1,2017-18,Hofstra,G,30,27,1046,145,321,.452,91,189,.481,54,132,.409,132,175,.754,48,96,144,67,20,5,61,75,476,11.1
1035,Travis Betran\travis-betran-1,2013-14,Austin Peay,G,30,30,998,147,375,.392,72,163,.442,75,212,.354,107,122,.877,4,39,43,68,22,3,75,34,476,8.8
1036,Brayden Carlson\brayden-carlson-1,2013-14,South Dakota State,G,32,32,1177,144,318,.453,92,174,.529,52,144,.361,136,174,.782,11,100,111,93,48,3,80,71,476,10.6
1037,Keenan Evans\keenan-evans-1,2016-17,Texas Tech,G,31,30,943,159,343,.464,108,225,.480,51,118,.432,107,126,.849,23,64,87,92,31,6,52,64,476,11.3
1038,Xavier Rathan-Mayes\xavier-rathan-mayes-1,2014-15,Florida State,G,32,30,1110,165,397,.416,117,226,.518,48,171,.281,98,142,.690,16,96,112,137,35,0,108,74,476,8.7
1039,Christian Vital\christian-vital-1,2017-18,Connecticut,G,32,23,1013,138,360,.383,70,146,.479,68,214,.318,132,156,.846,25,148,173,53,50,1,56,73,476,10.4
1040,Malcolm Brogdon\malcolm-brogdon-1,2014-15,Virginia,G,34,34,1105,158,374,.422,114,246,.463,44,128,.344,116,132,.879,16,118,134,81,24,14,58,65,476,9.5
1041,Mike Smith\mike-smith-9,2017-18,Columbia,G,27,26,918,157,403,.390,108,244,.443,49,159,.308,112,133,.842,12,58,70,124,31,1,59,49,475,11.6
1042,Malcolm Hill\malcolm-hill-1,2014-15,Illinois,G,33,32,1010,156,352,.443,114,244,.467,42,108,.389,121,155,.781,61,98,159,44,28,7,49,68,475,10.2
1043,Pat Connaughton\pat-connaughton-1,2014-15,Notre Dame,G,38,38,1351,166,356,.466,73,136,.537,93,220,.423,50,64,.781,41,241,282,57,27,36,44,75,475,10.7
1044,Liam O'Reilly\liam-oreilly-1,2017-18,Gardner-Webb,G,32,28,1091,166,403,.412,81,182,.445,85,221,.385,58,69,.841,11,139,150,120,33,2,95,58,475,9.5
1045,Kyle Collinsworth\kyle-collinsworth-1,2013-14,Brigham Young,G,34,33,1136,175,352,.497,167,330,.506,8,22,.364,117,203,.576,85,190,275,156,57,14,89,82,475,12.8
1046,Tucker Haymond\tucker-haymond-1,2016-17,Western Michigan,G,32,31,1003,155,340,.456,114,232,.491,41,108,.380,124,167,.743,47,115,162,80,23,3,79,69,475,10.1
1047,Fred VanVleet\fred-van-vleet-1,2014-15,Wichita State,G,35,35,1104,151,351,.430,111,239,.464,40,112,.357,133,167,.796,41,115,156,183,66,4,59,50,475,13.1
1048,Ethan Telfair\ethan-telfair-1,2016-17,Idaho State,G,28,28,1013,146,429,.340,104,296,.351,42,133,.316,141,183,.770,21,100,121,134,56,6,96,60,475,10.5
1049,Kori Babineaux\kori-babineaux-1,2014-15,Jacksonville,G,32,32,1080,193,396,.487,191,375,.509,2,21,.095,86,145,.593,18,108,126,127,51,4,106,81,474,9.4
1050,Shep Garner\shep-garner-1,2015-16,Penn State,G,32,32,1127,149,390,.382,74,185,.400,75,205,.366,101,129,.783,9,94,103,109,42,7,65,59,474,10.0
1051,Le'Bryan Nash\lebryan-nash-1,2013-14,Oklahoma State,G,34,34,1017,169,325,.520,169,319,.530,0,6,.000,136,184,.739,51,137,188,54,18,27,64,114,474,9.9
1052,Louis Dabney\louis-dabney-1,2015-16,Tulane,G,33,31,1088,153,413,.370,99,240,.413,54,173,.312,114,144,.792,26,74,100,73,35,4,68,86,474,7.9
1053,Tyler Larson\tyler-larson-1,2014-15,South Dakota,G,33,33,1141,156,362,.431,124,276,.449,32,86,.372,130,173,.751,74,185,259,95,26,8,70,85,474,11.1
1054,Aaron Brown\aaron-brown-1,2014-15,Boston College,G,32,32,1086,158,384,.411,98,194,.505,60,190,.316,98,143,.685,15,84,99,64,19,1,70,65,474,8.0
1055,Nick Masterson\nick-masterson-1,2017-18,Kennesaw State,G,30,30,1102,167,301,.555,94,166,.566,73,135,.541,67,76,.882,22,62,84,96,25,4,44,59,474,12.9
1056,Tevon Saddler\tevon-saddler-1,2017-18,Nicholls State,G,30,30,878,162,343,.472,143,272,.526,19,71,.268,131,171,.766,45,154,199,85,48,7,95,89,474,11.4
1057,Brock Stull\brock-stull-1,2016-17,Milwaukee,G,35,35,1167,173,390,.444,116,245,.473,57,145,.393,71,88,.807,37,195,232,100,27,1,76,65,474,9.8
1058,Jaylen Shaw\jaylen-shaw-1,2017-18,Coastal Carolina,G,32,29,989,157,374,.420,123,266,.462,34,108,.315,126,163,.773,10,92,102,172,51,1,112,71,474,10.2
1059,Micah Seaborn\micah-seaborn-1,2015-16,Monmouth,G,36,35,996,160,377,.424,92,201,.458,68,176,.386,86,102,.843,16,96,112,71,36,7,66,78,474,8.4
1060,Devareaux Manley\devareaux-manley-1,2014-15,Kent State,G,35,29,1139,144,361,.399,30,74,.405,114,287,.397,72,93,.774,15,84,99,29,20,6,37,64,474,8.2
1061,Steve Vasturia\steve-vasturia-1,2016-17,Notre Dame,G,36,36,1244,162,374,.433,104,212,.491,58,162,.358,91,100,.910,25,116,141,119,43,4,58,75,473,10.2
1062,Sterling Gibbs\sterling-gibbs-1,2014-15,Seton Hall,G,29,28,976,151,350,.431,76,178,.427,75,172,.436,96,137,.701,15,45,60,110,35,0,58,45,473,11.4
1063,Xavier Johnson\xavier-johnson-1,2016-17,Colorado,G,32,31,895,164,335,.490,125,233,.536,39,102,.382,106,157,.675,55,135,190,33,17,11,47,82,473,10.3
1064,Spencer Collins\spencer-collins-1,2015-16,Wofford,G,32,32,1006,152,385,.395,77,202,.381,75,183,.410,94,116,.810,29,78,107,69,27,4,60,75,473,9.0
1065,Teyvion Kirk\teyvion-kirk-1,2017-18,Ohio,G,31,31,993,160,365,.438,144,325,.443,16,40,.400,137,190,.721,34,154,188,95,42,5,105,78,473,9.9
1066,Deon Edwin\deon-edwin-1,2016-17,Kent State,G,36,30,1031,163,353,.462,126,246,.512,37,107,.346,110,153,.719,63,137,200,85,48,16,75,96,473,10.1
1067,Reed Timmer\reed-timmer-1,2016-17,Drake,G,31,31,918,146,349,.418,91,196,.464,55,153,.359,126,152,.829,17,81,98,56,31,1,56,53,473,9.9
1068,Jesse Reed\jesse-reed-1,2014-15,American,G,33,33,1269,158,336,.470,112,207,.541,46,129,.357,111,144,.771,23,141,164,44,33,19,62,75,473,10.0
1069,Wesley Myers\wesley-myers-1,2016-17,Maine,G,28,20,844,164,374,.439,130,275,.473,34,99,.343,110,142,.775,35,90,125,44,30,16,62,57,472,10.8
1070,Ryan Boatright\ryan-boatright-1,2013-14,Connecticut,G,39,38,1264,145,371,.391,101,254,.398,44,117,.376,138,173,.798,21,115,136,131,61,6,76,61,472,9.3
1071,Kevin Huerter\kevin-huerter-1,2017-18,Maryland,G,32,32,1101,162,322,.503,89,147,.605,73,175,.417,75,99,.758,31,130,161,108,20,21,80,76,472,11.3
1072,Matthew Fisher-Davis\matthew-fisher-davis-1,2016-17,Vanderbilt,G,34,21,947,145,359,.404,61,133,.459,84,226,.372,98,121,.810,11,98,109,35,21,8,52,70,472,8.2
1073,Malcolm Drumwright\malcolm-drumwright-1,2017-18,Jacksonville State,G,36,35,1231,162,405,.400,89,203,.438,73,202,.361,75,89,.843,16,74,90,130,25,2,47,72,472,9.0
1074,Ron Baker\ron-baker-1,2013-14,Wichita State,G,36,36,1075,146,320,.456,78,141,.553,68,179,.380,112,133,.842,27,110,137,112,51,23,61,66,472,11.3
1075,Ryan Betley\ryan-betley-1,2017-18,Pennsylvania,G,33,32,1106,150,355,.423,66,140,.471,84,215,.391,87,113,.770,21,144,165,40,27,14,48,67,471,9.7
1076,Noah Allen\noah-allen-1,2016-17,Hawaii,G,30,25,907,169,358,.472,127,229,.555,42,129,.326,91,117,.778,25,148,173,60,35,7,80,58,471,10.6
1077,Diante Baldwin\diante-baldwin-1,2016-17,North Carolina-Greensboro,G,35,34,1073,171,400,.428,128,285,.449,43,115,.374,86,118,.729,29,95,124,149,63,6,93,69,471,9.9
1078,Jordair Jett\jordair-jett-1,2013-14,Saint Louis,G,34,33,1073,169,345,.490,162,308,.526,7,37,.189,126,210,.600,32,105,137,164,51,18,97,63,471,11.0
1079,Zach Norvell Jr.\zach-norvelljr-1,2017-18,Gonzaga,G,37,29,999,161,353,.456,84,145,.579,77,208,.370,72,90,.800,39,104,143,85,42,3,58,79,471,9.6
1080,J-Mychal Reese\j-mychal-reese-1,2015-16,North Texas,G,32,32,1073,164,390,.421,126,266,.474,38,124,.306,105,138,.761,17,76,93,118,34,0,101,76,471,8.4
1081,Jaylen Bland\jaylen-bland-1,2014-15,UC-Riverside,G,31,29,1103,151,395,.382,56,150,.373,95,245,.388,74,92,.804,24,124,148,49,43,11,55,59,471,9.9
1082,JoJo Cooper\jojo-cooper-1,2017-18,Wagner,G,33,33,1202,158,376,.420,119,273,.436,39,103,.379,116,157,.739,38,135,173,201,48,1,109,72,471,11.3
1083,Jay Hook\jay-hook-1,2013-14,Tulane,G,34,33,1081,135,304,.444,52,128,.406,83,176,.472,118,142,.831,38,134,172,25,25,0,61,81,471,9.4
1084,Xavier Cooks\xavier-cooks-1,2015-16,Winthrop,G,32,32,883,172,332,.518,133,233,.571,39,99,.394,88,115,.765,47,179,226,57,26,54,83,84,471,11.6
1085,Malcolm Brogdon\malcolm-brogdon-1,2013-14,Virginia,G,37,37,1163,150,363,.413,106,244,.434,44,119,.370,126,144,.875,33,168,201,101,44,5,53,71,470,10.2
1086,Demetrius Jackson\demetrius-jackson-2,2014-15,Notre Dame,G,38,38,1318,167,329,.508,113,203,.557,54,126,.429,82,110,.745,44,93,137,116,59,12,57,71,470,11.0
1087,Quinton Pippen\quinton-pippen-1,2013-14,Chicago State,G,31,30,964,153,388,.394,63,145,.434,90,243,.370,74,91,.813,22,97,119,79,57,7,70,98,470,9.8
1088,TJ Haws\tj-haws-1,2016-17,Brigham Young,G,34,34,1040,147,347,.424,71,159,.447,76,188,.404,100,127,.787,9,88,97,110,34,4,86,77,470,9.0
1089,Ian Baker\ian-baker-1,2015-16,New Mexico State,G,34,34,1114,156,366,.426,87,186,.468,69,180,.383,89,109,.817,21,136,157,124,37,4,75,49,470,10.5
1090,Divine Myles\divine-myles-1,2015-16,Stetson,G,34,33,1103,175,342,.512,149,274,.544,26,68,.382,94,142,.662,22,132,154,143,46,4,57,76,470,11.7
1091,Lagerald Vick\lagerald-vick-1,2017-18,Kansas,G,39,35,1289,187,383,.488,128,225,.569,59,158,.373,37,55,.673,37,150,187,83,34,13,64,74,470,8.9
1092,Jacobi Boykins\jacobi-boykins-1,2016-17,Louisiana Tech,G,32,32,967,153,333,.459,64,115,.557,89,218,.408,75,94,.798,24,124,148,70,65,18,35,72,470,12.7
1093,Sterling Brown\sterling-brown-2,2016-17,Southern Methodist,G,35,34,1143,161,351,.459,100,215,.465,61,136,.449,87,110,.791,55,172,227,105,51,19,69,91,470,11.5
1094,Bryce Pressley\bryce-pressley-1,2015-16,Portland,G,32,32,1005,170,364,.467,107,200,.535,63,164,.384,67,89,.753,41,105,146,78,41,17,36,64,470,11.9
1095,Kyle Hittle\kyle-hittle-1,2015-16,Incarnate Word,G,29,29,970,158,328,.482,86,157,.548,72,171,.421,82,112,.732,33,138,171,67,34,3,44,73,470,12.6
1096,Koby McEwen\koby-mcewen-1,2016-17,Utah State,G,32,31,989,140,303,.462,81,162,.500,59,141,.418,131,181,.724,16,146,162,100,24,11,85,90,470,10.3
1097,Tyreek Duren\tyreek-duren-1,2013-14,La Salle,G,31,31,1121,147,353,.416,89,211,.422,58,142,.408,118,147,.803,18,87,105,108,51,9,58,61,470,11.6
1098,Corey Walden\corey-walden-2,2013-14,Eastern Kentucky,G,34,34,1072,151,304,.497,112,184,.609,39,120,.325,129,155,.832,25,115,140,100,76,1,69,121,470,11.4
1099,Austin Hollins\austin-hollins-1,2013-14,Minnesota,G,38,38,1258,161,362,.445,97,177,.548,64,185,.346,84,109,.771,61,128,189,91,75,19,59,69,470,11.0
1100,Justin Drummond\justin-drummond-2,2013-14,Toledo,G,33,32,909,146,288,.507,121,210,.576,25,78,.321,152,208,.731,49,121,170,87,34,13,58,88,469,11.7
1101,David Walker\david-walker-3,2014-15,Northeastern,G,35,35,1298,142,325,.437,73,149,.490,69,176,.392,116,134,.866,10,111,121,126,41,10,78,28,469,10.8
1102,Nolan Cressler\nolan-cressler-1,2013-14,Cornell,G,28,28,912,169,411,.411,101,224,.451,68,187,.364,63,81,.778,20,98,118,45,14,2,59,78,469,8.6
1103,Deville Smith\deville-smith-1,2014-15,Tennessee-Martin,G,34,33,1219,170,410,.415,109,220,.495,61,190,.321,68,103,.660,18,135,153,153,59,19,102,69,469,10.0
1104,Lucas Woodhouse\lucas-woodhouse-1,2016-17,Stony Brook,G,31,31,992,146,317,.461,80,173,.462,66,144,.458,111,127,.874,12,91,103,158,34,0,61,52,469,12.8
1105,Jalen Riley\jalen-riley-1,2013-14,East Tennessee State,G,35,3,735,125,343,.364,75,188,.399,50,155,.323,169,202,.837,21,67,88,64,31,6,53,76,469,8.5
1106,Evan Bradds\evan-bradds-1,2014-15,Belmont,G,33,32,928,185,269,.688,180,256,.703,5,13,.385,94,145,.648,65,171,236,44,21,7,83,74,469,11.4
1107,Laquincy Rideau\laquincy-rideau-1,2016-17,Gardner-Webb,G,33,30,950,157,334,.470,127,257,.494,30,77,.390,125,216,.579,45,144,189,171,100,10,112,99,469,12.5
1108,Dimencio Vaughn\dimencio-vaughn-1,2017-18,Rider,G,29,22,804,164,323,.508,137,246,.557,27,77,.351,113,148,.764,74,119,193,31,53,21,69,83,468,12.7
1109,T.J. Bray\tj-bray-1,2013-14,Princeton,G,26,24,920,152,283,.537,100,157,.637,52,126,.413,112,140,.800,13,111,124,133,34,5,46,51,468,16.4
1110,Brandon Anderson\brandon-anderson-2,2017-18,Brown,G,27,26,912,133,352,.378,100,238,.420,33,114,.289,169,196,.862,18,54,72,105,40,3,81,61,468,11.2
1111,Elijah Bryant\elijah-bryant-1,2014-15,Elon,G,33,13,840,147,385,.382,103,259,.398,44,126,.349,130,173,.751,45,93,138,89,42,13,115,87,468,8.0
1112,B.J. Tyson\bj-tyson-1,2015-16,East Carolina,G,32,30,1071,173,412,.420,129,262,.492,44,150,.293,78,106,.736,25,116,141,82,31,4,73,55,468,8.9
1113,Demetrious Floyd\demetrious-floyd-1,2015-16,Stephen F. Austin,G,34,31,832,173,375,.461,73,139,.525,100,236,.424,22,31,.710,9,43,52,50,40,3,32,45,468,9.3
1114,Desmond Cambridge\desmond-cambridge-2,2017-18,Brown,G,27,27,809,160,399,.401,92,196,.469,68,203,.335,80,104,.769,25,97,122,33,29,27,39,77,468,10.8
1115,Isaiah Cousins\isaiah-cousins-1,2015-16,Oklahoma,G,37,37,1232,169,416,.406,104,258,.403,65,158,.411,65,97,.670,23,142,165,168,51,10,88,63,468,9.5
1116,James McGee\james-mcgee-1,2016-17,Southern Utah,G,33,31,1116,138,344,.401,37,105,.352,101,239,.423,91,126,.722,16,72,88,84,27,4,59,83,468,9.0
1117,Roberto Gallinat\roberto-gallinat-1,2017-18,Pacific,G,32,32,1023,153,349,.438,102,190,.537,51,159,.321,111,144,.771,26,64,90,37,20,7,47,79,468,8.8
1118,Josh Cameron\josh-cameron-1,2013-14,Coastal Carolina,G,34,27,946,147,379,.388,81,205,.395,66,174,.379,108,143,.755,11,75,86,86,33,8,93,72,468,7.5
1119,Egor Koulechov\egor-koulechov-1,2017-18,Florida,G,34,34,1040,161,389,.414,91,213,.427,70,176,.398,76,88,.864,57,161,218,40,21,4,44,74,468,9.5
1120,Nigel Williams-Goss\nigel-williams-goss-1,2014-15,Washington,G,30,30,1104,186,421,.442,164,335,.490,22,86,.256,74,97,.763,20,121,141,177,33,5,85,56,468,11.4
1121,Yettra Specks\yettra-specks-1,2016-17,Jackson State,G,32,32,1175,143,377,.379,74,163,.454,69,214,.322,112,131,.855,23,80,103,85,37,4,59,78,467,9.4
1122,Remond Brown\remond-brown-1,2016-17,Grambling,G,33,30,1087,183,396,.462,148,291,.509,35,105,.333,66,100,.660,38,109,147,59,61,14,84,73,467,9.3
1123,Cameron Reynolds\cameron-reynolds-1,2017-18,Tulane,G,31,31,1117,171,419,.408,110,246,.447,61,173,.353,64,91,.703,36,160,196,68,24,18,47,77,467,10.0
1124,David Nichols\david-nichols-1,2017-18,Albany (NY),G,32,31,1082,166,421,.394,109,265,.411,57,156,.365,78,101,.772,16,120,136,111,37,7,80,84,467,8.8
1125,Omar Prewitt\omar-prewitt-1,2016-17,William & Mary,G,30,29,948,174,377,.462,130,244,.533,44,133,.331,75,116,.647,31,155,186,96,25,19,62,64,467,11.4
1126,Jarvis Threatt\jarvis-threatt-1,2013-14,Delaware,G,26,25,964,138,334,.413,128,288,.444,10,46,.217,181,262,.691,35,116,151,141,64,4,66,55,467,15.1
1127,Koby McEwen\koby-mcewen-1,2017-18,Utah State,G,30,30,970,150,375,.400,83,172,.483,67,203,.330,100,138,.725,13,150,163,97,23,1,89,78,467,9.2
1128,Braxton Huggins\braxton-huggins-1,2016-17,New Mexico State,G,34,29,940,140,319,.439,51,107,.477,89,212,.420,98,121,.810,15,75,90,45,11,8,52,63,467,8.7
1129,Jordan McLaughlin\jordan-mclaughlin-1,2016-17,Southern California,G,36,36,1228,162,353,.459,115,236,.487,47,117,.402,95,119,.798,29,99,128,197,53,4,80,35,466,11.8
1130,Ryan Taylor\ryan-taylor-2,2016-17,Evansville,G,33,32,1032,167,382,.437,113,238,.475,54,144,.375,78,92,.848,24,71,95,50,19,16,42,80,466,8.8
1131,Jarell Flora\jarell-flora-1,2014-15,Seattle,G,34,34,1097,166,383,.433,86,185,.465,80,198,.404,54,66,.818,19,125,144,51,29,9,73,50,466,8.5
1132,Alex Petrie\alex-petrie-1,2017-18,Lafayette,G,31,21,772,156,358,.436,88,190,.463,68,168,.405,86,95,.905,9,66,75,23,14,0,58,22,466,8.5
1133,Levi Bradley\levi-bradley-1,2017-18,Northern Illinois,G,32,32,947,162,379,.427,136,286,.476,26,93,.280,116,140,.829,41,135,176,24,28,8,42,88,466,9.3
1134,Brenton Scott\brenton-scott-1,2015-16,Indiana State,G,32,22,978,158,392,.403,82,194,.423,76,198,.384,74,96,.771,20,111,131,42,39,7,57,55,466,9.0
1135,Wade Baldwin\wade-baldwin-1,2015-16,Vanderbilt,G,33,30,1002,135,316,.427,94,215,.437,41,101,.406,155,194,.799,13,119,132,172,40,11,91,85,466,11.2
1136,Nic Moore\nic-moore-1,2015-16,Southern Methodist,G,29,29,996,153,364,.420,77,180,.428,76,184,.413,84,105,.800,9,61,70,152,39,3,66,64,466,11.9
1137,Raeford Worsham\raeford-worsham-1,2015-16,Jackson State,G,35,34,1109,173,336,.515,170,316,.538,3,20,.150,116,196,.592,104,165,269,75,61,28,77,98,465,11.6
1138,Gabe Vincent\gabe-vincent-1,2015-16,UC-Santa Barbara,G,33,32,1055,163,401,.406,83,193,.430,80,208,.385,59,73,.808,20,86,106,74,41,6,57,93,465,8.7
1139,Maurice Watson Jr.\mo-watsonjr-1,2013-14,Boston University,G,35,33,1090,189,382,.495,161,299,.538,28,83,.337,59,94,.628,20,106,126,248,74,0,101,87,465,11.9
1140,Connor Cashaw\connor-cashaw-1,2017-18,Rice,G,30,28,1010,158,397,.398,107,237,.451,51,160,.319,98,135,.726,42,172,214,96,40,2,65,60,465,11.2
1141,Aaron Cosby\aaron-cosby-1,2015-16,Western Kentucky,G,34,34,1073,136,389,.350,55,168,.327,81,221,.367,112,131,.855,16,108,124,67,15,5,67,47,465,7.7
1142,Codi Miller-McIntyre\codi-miller-mcintyre-1,2014-15,Wake Forest,G,32,32,1007,167,371,.450,148,304,.487,19,67,.284,112,174,.644,27,126,153,137,32,11,80,57,465,10.5
1143,Marcus Jackson\marcus-jackson-6,2014-15,Rice,G,32,31,1013,153,370,.414,68,156,.436,85,214,.397,74,89,.831,25,86,111,87,27,4,74,66,465,9.2
1144,Kassius Robertson\kassius-robertson-1,2015-16,Canisius,G,33,33,1121,153,350,.437,67,137,.489,86,213,.404,73,100,.730,34,59,93,59,36,2,77,73,465,8.6
1145,Montell Goodwin\montell-goodwin-1,2017-18,Eastern Illinois,G,31,31,1100,164,411,.399,91,208,.438,73,203,.360,64,83,.771,15,89,104,103,34,12,61,46,465,9.9
1146,Ashton Moore\ashton-moore-1,2013-14,Citadel,G,33,31,1070,150,386,.389,80,216,.370,70,170,.412,94,120,.783,16,95,111,120,33,3,82,64,464,8.9
1147,Andrew Andrews\andrew-andrews-1,2014-15,Washington,G,31,30,1047,140,347,.403,75,174,.431,65,173,.376,119,146,.815,32,100,132,67,44,1,61,81,464,10.2
1148,Chris Smith\chris-smith-6,2015-16,Utah State,G,31,31,960,161,326,.494,98,186,.527,63,140,.450,79,106,.745,43,120,163,64,25,12,50,66,464,11.5
1149,Daxter Miles\daxter-miles-1,2017-18,West Virginia,G,36,33,1030,160,358,.447,99,182,.544,61,176,.347,83,112,.741,44,57,101,110,47,0,51,110,464,9.5
1150,Grant Mullins\grant-mullins-1,2015-16,Columbia,G,35,35,1090,141,301,.468,72,144,.500,69,157,.439,113,136,.831,17,115,132,116,28,5,46,80,464,10.9
1151,Delano Spencer\delano-spencer-1,2017-18,Tennessee State,G,30,27,984,152,348,.437,67,147,.456,85,201,.423,75,90,.833,17,76,93,38,34,2,55,56,464,9.8
1152,T.J. Price\tj-price-1,2013-14,Western Kentucky,G,30,25,887,153,371,.412,81,170,.476,72,201,.358,86,111,.775,28,104,132,58,28,3,63,83,464,9.4
1153,Marlain Veal\marlain-veal-1,2016-17,Southeastern Louisiana,G,32,30,937,155,325,.477,109,210,.519,46,115,.400,107,142,.754,27,94,121,144,58,2,119,74,463,10.7
1154,Robert Brown\robert-brown-4,2015-16,Alabama-Birmingham,G,33,32,999,160,371,.431,93,202,.460,67,169,.396,76,98,.776,11,79,90,102,30,9,58,57,463,9.6
1155,Cane Broome\cane-broome-1,2014-15,Sacred Heart,G,32,30,1011,165,371,.445,120,238,.504,45,133,.338,88,117,.752,15,107,122,77,36,6,75,63,463,9.2
1156,Martez Harrison\martez-harrison-1,2015-16,Missouri-Kansas City,G,30,28,999,135,347,.389,96,221,.434,39,126,.310,154,201,.766,25,86,111,126,38,3,110,76,463,9.6
1157,Matt Lewis\matt-lewis-1,2017-18,James Madison,G,32,15,1017,136,362,.376,82,201,.408,54,161,.335,137,171,.801,24,95,119,72,31,5,40,62,463,9.9
1158,Josh Hagins\josh-hagins-1,2015-16,Little Rock,G,35,33,1073,162,358,.453,105,209,.502,57,149,.383,82,98,.837,28,119,147,165,52,6,59,75,463,11.7
1159,Jabarie Hinds\jabarie-hinds-1,2015-16,Massachusetts,G,32,21,947,175,382,.458,127,252,.504,48,130,.369,64,87,.736,14,61,75,96,47,7,54,67,462,10.1
1160,Eric Garcia\eric-garcia-2,2016-17,Wofford,G,33,33,1111,129,288,.448,53,120,.442,76,168,.452,128,139,.921,9,82,91,226,24,1,60,66,462,13.2
1161,Justin Robinson\justin-robinson-3,2017-18,Virginia Tech,G,33,33,1021,150,323,.464,99,195,.508,51,128,.398,111,142,.782,24,68,92,185,41,2,83,76,462,11.5
1162,Brian Parker\brian-parker-2,2015-16,Marist,G,29,27,913,163,317,.514,153,291,.526,10,26,.385,126,174,.724,46,104,150,84,20,1,90,63,462,10.8
1163,Dantrell Thomas\dantrell-thomas-1,2013-14,Nicholls State,G,29,29,838,150,286,.524,136,249,.546,14,37,.378,148,194,.763,49,109,158,78,44,11,55,92,462,13.3
1164,Cameron Jones\cameron-jones-2,2015-16,Radford,G,31,27,894,171,387,.442,96,192,.500,75,195,.385,45,59,.763,46,93,139,42,19,8,55,57,462,9.4
1165,Jaelan Sanford\jaelan-sanford-1,2016-17,Toledo,G,34,33,1219,157,345,.455,92,179,.514,65,166,.392,82,113,.726,14,59,73,107,23,17,63,61,461,9.4
1166,Ralston Turner\ralston-turner-1,2014-15,North Carolina State,G,36,36,1136,150,381,.394,56,125,.448,94,256,.367,67,80,.838,22,95,117,35,22,6,37,86,461,7.6
1167,Jalen Adams\jalen-adams-2,2016-17,Connecticut,G,32,32,1137,174,404,.431,138,301,.458,36,103,.350,77,93,.828,23,113,136,195,35,7,99,68,461,10.7
1168,R.J. Price\rj-price-1,2013-14,Radford,G,35,35,1033,151,382,.395,74,171,.433,77,211,.365,82,101,.812,14,73,87,100,49,4,48,49,461,9.5
1169,Jason McManamen\jason-mcmanamen-1,2015-16,Wyoming,G,32,32,1107,140,302,.464,44,87,.506,96,215,.447,85,112,.759,10,87,97,49,13,3,41,88,461,9.4
1170,Jalin Hart\jalin-hart-1,2016-17,Incarnate Word,G,29,28,958,163,315,.517,126,221,.570,37,94,.394,98,153,.641,16,86,102,135,40,8,77,78,461,12.2
1171,Cameron Ayers\cameron-ayers-1,2013-14,Bucknell,G,30,30,1022,154,374,.412,92,222,.414,62,152,.408,91,106,.858,25,109,134,41,27,2,39,40,461,10.2
1172,Rodney Purvis\rodney-purvis-1,2015-16,Connecticut,G,36,21,1038,163,376,.434,93,194,.479,70,182,.385,65,99,.657,16,91,107,74,32,4,55,71,461,8.1
1173,Bryce Canda\bryce-canda-1,2017-18,Portland State,G,33,33,1134,171,425,.402,96,193,.497,75,232,.323,44,67,.657,46,151,197,82,55,6,51,34,461,10.7
1174,ShawnDre' Jones\shawndre-jones-1,2015-16,Richmond,G,31,31,1073,154,354,.435,94,202,.465,60,152,.395,93,113,.823,17,53,70,114,23,2,50,82,461,10.2
1175,Tyus Jones\tyus-jones-1,2014-15,Duke,G,39,39,1322,135,324,.417,88,200,.440,47,124,.379,144,162,.889,19,118,137,217,59,3,76,46,461,11.5
1176,George King\george-king-1,2015-16,Colorado,G,34,27,862,152,341,.446,84,192,.438,68,149,.456,89,119,.748,55,104,159,23,13,8,63,60,461,8.5
1177,Rasheem Dunn\rasheem-dunn-1,2017-18,St. Francis (NY),G,30,29,928,157,403,.390,115,253,.455,42,150,.280,105,136,.772,21,151,172,70,42,1,62,60,461,9.8
1178,Jackson Kent\jackson-kent-1,2016-17,James Madison,G,33,32,1189,153,343,.446,99,190,.521,54,153,.353,101,119,.849,16,130,146,75,37,4,59,46,461,10.3
1179,Jordan McLaughlin\jordan-mclaughlin-1,2017-18,Southern California,G,36,36,1270,159,354,.449,105,218,.482,54,136,.397,88,118,.746,26,106,132,281,72,8,92,39,460,13.3
1180,Devin Morgan Jr.\devin-morganjr-1,2016-17,Delaware State,G,32,31,1148,149,404,.369,63,165,.382,86,239,.360,76,85,.894,16,82,98,103,35,0,57,42,460,9.4
1181,Mike Lewis II\mike-lewisii-1,2017-18,Duquesne,G,32,30,994,138,359,.384,49,117,.419,89,242,.368,95,115,.826,16,58,74,23,34,1,41,66,460,8.4
1182,Cedric Hankerson\cedric-hankerson-1,2014-15,Boston University,G,29,29,982,121,305,.397,49,124,.395,72,181,.398,146,217,.673,21,110,131,76,52,3,78,85,460,10.7
1183,Rich Williams\rich-williams-1,2015-16,Manhattan,G,31,7,879,166,367,.452,128,262,.489,38,105,.362,90,113,.796,45,140,185,41,33,15,74,82,460,9.7
1184,Dylan Garrity\dylan-garrity-1,2014-15,Sacramento State,G,33,33,1085,148,319,.464,67,121,.554,81,198,.409,83,100,.830,8,59,67,84,32,1,55,54,460,9.9
1185,Quinton Chievous\quinton-chievous-1,2015-16,Hampton,G,27,27,922,185,325,.569,167,266,.628,18,59,.305,72,149,.483,86,204,290,54,16,4,72,63,460,13.2
1186,Thomas Walkup\thomas-walkup-1,2013-14,Stephen F. Austin,G,35,34,994,175,308,.568,161,269,.599,14,39,.359,96,131,.733,81,105,186,75,38,9,55,111,460,11.0
1187,Dexter McClanahan\dexter-mcclanahan-1,2016-17,Savannah State,G,28,16,780,152,349,.436,79,142,.556,73,207,.353,83,120,.692,20,134,154,62,30,4,63,46,460,11.1
1188,Dylan Smith\dylan-smith-1,2015-16,North Carolina-Asheville,G,34,19,929,134,363,.369,53,131,.405,81,232,.349,111,135,.822,13,77,90,63,34,11,88,81,460,7.3
1189,Adrian Rodgers\adrian-rogers-2,2014-15,Southern,G,35,32,1010,164,420,.390,110,254,.433,54,166,.325,78,98,.796,24,122,146,40,26,5,64,67,460,7.0
1190,Ryan Allen\ryan-allen-3,2017-18,Delaware,G,30,24,1072,163,401,.406,77,180,.428,86,221,.389,47,65,.723,8,67,75,45,15,6,49,86,459,7.6
1191,Jaylen Barford\jaylen-barford-1,2016-17,Arkansas,G,36,30,913,174,397,.438,145,288,.503,29,109,.266,82,109,.752,39,98,137,71,44,6,70,81,459,8.1
1192,Bronson Koenig\bronson-koenig-1,2015-16,Wisconsin,G,35,35,1222,151,385,.392,68,172,.395,83,213,.390,74,97,.763,13,84,97,84,14,6,52,76,459,7.7
1193,Matt Scott\matt-scott-1,2015-16,Niagara,G,30,30,992,145,358,.405,111,240,.463,34,118,.288,135,176,.767,61,152,213,76,39,10,96,85,459,10.3
1194,Iverson Fleming\iverson-fleming-1,2016-17,Long Island University,G,32,32,1009,154,406,.379,104,265,.392,50,141,.355,101,131,.771,26,81,107,61,45,13,92,86,459,7.4
1195,Ron Curry\ron-curry-1,2014-15,James Madison,G,33,33,1175,141,349,.404,79,202,.391,62,147,.422,115,156,.737,19,108,127,143,36,7,75,60,459,10.4
1196,Grant Riller\grant-riller-1,2016-17,College of Charleston,G,35,27,944,159,327,.486,121,213,.568,38,114,.333,103,129,.798,13,59,72,43,33,7,47,60,459,8.8
1197,Jordan Price\jordan-price-1,2016-17,La Salle,G,30,28,985,155,358,.433,86,163,.528,69,195,.354,80,105,.762,17,112,129,77,19,8,71,59,459,9.7
1198,Corey Davis Jr.\corey-davisjr-1,2017-18,Houston,G,35,30,1057,148,334,.443,45,94,.479,103,240,.429,59,73,.808,23,84,107,84,31,1,50,69,458,9.5
1199,Charles Mann\charles-mann-1,2013-14,Georgia,G,33,31,979,121,295,.410,100,227,.441,21,68,.309,195,277,.704,23,115,138,97,35,2,113,82,458,8.4
1200,Kelsey Barlow\kelsey-barlow-1,2013-14,Illinois-Chicago,G,31,28,973,150,388,.387,102,238,.429,48,150,.320,110,144,.764,30,124,154,121,31,8,81,83,458,9.6
1201,Torin Dorn\torin-dorn-1,2017-18,North Carolina State,G,33,32,948,178,335,.531,155,261,.594,23,74,.311,79,108,.731,80,128,208,46,33,13,66,78,458,10.7
1202,Michael Bryson\michael-bryson-1,2014-15,UC-Santa Barbara,G,33,32,1060,160,360,.444,92,171,.538,68,189,.360,70,82,.854,33,125,158,56,27,22,51,82,458,9.8
1203,Siler Schneider\siler-schneider-1,2017-18,UC-Davis,G,33,32,995,176,397,.443,140,285,.491,36,112,.321,70,98,.714,16,86,102,71,37,8,82,85,458,7.7
1204,Eric Williams Jr.\eric-williamsjr-1,2017-18,Duquesne,G,32,31,1079,147,375,.392,80,191,.419,67,184,.364,97,131,.740,68,212,280,51,43,10,67,75,458,10.6
1205,Kendall Smith\kendall-smith-2,2017-18,Oklahoma State,G,35,30,943,166,414,.401,116,292,.397,50,122,.410,76,114,.667,20,88,108,100,35,1,75,61,458,7.6
1206,Olin Carter III\olin-carteriii-1,2016-17,San Diego,G,30,28,1063,151,366,.413,59,124,.476,92,242,.380,64,82,.780,5,70,75,61,19,1,43,75,458,9.0
1207,Jordan Mathews\jordan-mathews-1,2015-16,University of California,G,34,19,1011,143,338,.423,54,124,.435,89,214,.416,83,104,.798,25,89,114,42,16,0,45,73,458,8.4
1208,Charles Cooke\charles-cooke-1,2016-17,Dayton,G,29,27,915,151,332,.455,102,209,.488,49,123,.398,106,151,.702,29,120,149,82,32,28,61,56,457,12.0
1209,Tahjere McCall\tahjere-mccall-1,2015-16,Tennessee State,G,31,28,932,139,304,.457,119,232,.513,20,72,.278,159,211,.754,47,112,159,93,72,11,97,101,457,11.4
1210,Khallid Hart\khallid-hart-1,2013-14,Marist,G,31,31,1068,149,326,.457,104,208,.500,45,118,.381,114,144,.792,19,74,93,78,43,0,75,73,457,9.8
1211,Joe Rosga\joe-rosga-1,2016-17,Denver,G,30,30,1034,151,333,.453,78,167,.467,73,166,.440,82,96,.854,14,107,121,97,34,1,65,62,457,11.1
1212,Andre Walker\andre-walker-3,2017-18,Loyola (MD),G,29,28,929,168,438,.384,102,241,.423,66,197,.335,55,93,.591,28,85,113,80,47,0,84,83,457,8.0
1213,Sindarius Thornwell\sindarius-thornwell-1,2015-16,South Carolina,G,34,34,1125,144,377,.382,98,239,.410,46,138,.333,123,161,.764,39,125,164,130,50,16,78,66,457,10.2
1214,Martez Walker\martez-walker-1,2017-18,Oakland,G,26,24,965,138,299,.462,84,137,.613,54,162,.333,127,163,.779,28,78,106,42,23,15,45,50,457,12.7
1215,Chip Armelin\chip-armelin-1,2014-15,Southern Mississippi,G,29,29,1022,170,364,.467,109,195,.559,61,169,.361,56,88,.636,37,83,120,56,33,6,57,42,457,10.7
1216,Rickey McGill\rickey-mcgill-1,2017-18,Iona,G,34,33,1145,163,363,.449,112,230,.487,51,133,.383,80,114,.702,25,113,138,189,52,4,95,71,457,10.9
1217,E.C. Matthews\ec-matthews-1,2013-14,Rhode Island,G,32,25,1041,150,356,.421,103,221,.466,47,135,.348,110,149,.738,28,110,138,75,30,22,76,77,457,9.2
1218,Eric Lockett\eric-lockett-1,2017-18,Florida International,G,32,31,1185,181,388,.466,167,340,.491,14,48,.292,81,113,.717,41,168,209,98,39,12,66,76,457,10.7
1219,Quenton DeCosey\quenton-decosey-1,2014-15,Temple,G,37,35,1109,143,379,.377,92,237,.388,51,142,.359,119,177,.672,37,132,169,81,31,12,66,70,456,7.9
1220,Brandon Bos\brandon-bos-1,2014-15,South Dakota,G,33,33,1019,147,398,.369,99,260,.381,48,138,.348,114,138,.826,29,90,119,74,13,2,71,54,456,7.5
1221,Zak Irvin\zak-irvin-1,2014-15,Michigan,G,32,32,1160,163,405,.402,86,188,.457,77,217,.355,53,76,.697,31,122,153,49,33,3,47,42,456,9.1
1222,Ivan Gandia-Rosa\ivan-gandia-rosa-1,2017-18,North Florida,G,33,31,1080,149,357,.417,73,151,.483,76,206,.369,82,92,.891,12,77,89,205,18,0,103,36,456,10.2
1223,Rodney Purvis\rodney-purvis-1,2016-17,Connecticut,G,33,32,1217,151,406,.372,74,180,.411,77,226,.341,77,95,.811,13,126,139,84,34,8,59,71,456,8.6
1224,Nick Sherod\nick-sherod-1,2017-18,Richmond,G,32,32,1008,165,343,.481,104,187,.556,61,156,.391,65,81,.802,31,128,159,45,31,4,36,58,456,10.7
1225,Jordan Fouse\jordan-fouse-1,2015-16,Green Bay,G,36,35,1137,157,381,.412,116,248,.468,41,133,.308,101,138,.732,73,227,300,118,77,49,78,109,456,11.9
1226,Deandre Mathieu\deandre-mathieu-1,2013-14,Minnesota,G,38,38,1145,165,323,.511,143,278,.514,22,45,.489,104,138,.754,18,85,103,160,60,3,102,83,456,9.5
1227,Isaiah Wright\isaiah-wright-1,2017-18,San Diego,G,34,33,1173,147,326,.451,94,191,.492,53,135,.393,109,149,.732,11,157,168,181,44,4,105,93,456,10.5
1228,Andre Hollins\andre-hollins-1,2014-15,Minnesota,G,33,33,1007,153,366,.418,71,167,.425,82,199,.412,68,90,.756,27,105,132,89,35,6,61,72,456,9.5
1229,Jordan Howard\jordan-howard-2,2014-15,Central Arkansas,G,29,29,978,146,360,.406,69,162,.426,77,198,.389,87,111,.784,6,66,72,56,14,0,77,38,456,8.2
1230,Prince Okoroh\prince-okoroh-1,2013-14,Howard,G,33,33,1095,158,417,.379,144,366,.393,14,51,.275,126,183,.689,55,121,176,37,51,15,88,82,456,7.5
1231,Paris Collins\paris-collins-1,2015-16,Jackson State,G,35,25,1067,168,455,.369,113,261,.433,55,194,.284,65,105,.619,50,165,215,62,66,23,67,85,456,8.5
1232,Kyle Collinsworth\kyle-collinsworth-1,2014-15,Brigham Young,G,33,33,1019,158,335,.472,152,314,.484,6,21,.286,134,182,.736,81,205,286,197,59,11,96,73,456,14.0
1233,Keyshawn Evans\keyshawn-evans-1,2017-18,Illinois State,G,30,28,935,140,341,.411,49,124,.395,91,217,.419,85,112,.759,10,70,80,107,19,0,63,58,456,9.9
1234,Jordan Aaron\jordan-aaron-1,2013-14,Milwaukee,G,31,30,1021,138,369,.374,70,171,.409,68,198,.343,112,137,.818,12,84,96,77,34,4,65,78,456,8.7
1235,Malcolm Duvivier\malcolm-duvivier-1,2017-18,Akron,G,32,32,1041,159,408,.390,72,175,.411,87,233,.373,51,79,.646,10,71,81,99,27,6,95,94,456,6.8
1236,Jordan Williams\jordan-williams-2,2014-15,North Texas,G,31,31,1062,153,392,.390,112,243,.461,41,149,.275,109,149,.732,42,110,152,64,47,15,83,69,456,9.1
1237,Andrew Nicholas\andrew-nicholas-1,2013-14,Monmouth,G,32,32,969,165,421,.392,103,244,.422,62,177,.350,64,90,.711,29,77,106,35,29,14,61,88,456,7.1
1238,Josh Perkins\josh-perkins-1,2017-18,Gonzaga,G,37,37,1216,156,355,.439,73,144,.507,83,211,.393,61,81,.753,19,97,116,196,44,3,77,94,456,10.1
1239,Ky Bowman\ky-bowman-1,2016-17,Boston College,G,32,29,920,160,325,.492,98,187,.524,62,138,.449,74,104,.712,25,130,155,92,37,4,93,77,456,9.9
1240,Jordan McLaughlin\jordan-mclaughlin-1,2015-16,Southern California,G,34,34,1100,162,345,.470,106,213,.498,56,132,.424,76,103,.738,17,111,128,161,55,5,81,34,456,11.5
1241,B.J. Stith\bj-stith-1,2017-18,Old Dominion,G,32,30,1006,157,359,.437,101,220,.459,56,139,.403,85,101,.842,24,157,181,55,25,5,50,58,455,9.9
1242,Eric Washington\eric-washington-3,2014-15,Miami (OH),G,32,30,1029,137,304,.451,111,225,.493,26,79,.329,155,195,.795,26,76,102,176,45,1,108,71,455,11.1
1243,Ray Lee\ray-lee-2,2016-17,Eastern Michigan,G,29,21,755,144,356,.404,91,207,.440,53,149,.356,114,133,.857,13,36,49,72,45,2,80,64,455,9.2
1244,Holton Hunsaker\holton-hunsaker-1,2013-14,Utah Valley,G,32,32,1076,118,351,.336,51,152,.336,67,199,.337,152,176,.864,2,70,72,134,32,0,87,76,455,8.7
1245,Addison Spruill\addison-spruill-1,2014-15,North Carolina-Wilmington,G,32,30,981,165,371,.445,151,320,.472,14,51,.275,111,152,.730,57,152,209,52,30,16,73,81,455,9.5
1246,Paris Lee\paris-lee-1,2016-17,Illinois State,G,35,35,1080,149,354,.421,68,160,.425,81,194,.418,76,97,.784,11,117,128,176,65,4,86,50,455,11.0
1247,Jovan Mooring\jovan-mooring-1,2017-18,Nevada-Las Vegas,G,33,33,1077,135,362,.373,72,160,.450,63,202,.312,122,152,.803,9,91,100,110,38,2,62,75,455,9.1
1248,Andre Fox\andre-fox-1,2017-18,High Point,G,29,26,829,150,316,.475,95,187,.508,55,129,.426,100,133,.752,15,125,140,40,36,8,59,63,455,10.8
1249,Byron Ashe\byron-ashe-1,2015-16,Mount St. Mary's,G,33,20,1030,166,412,.403,113,242,.467,53,170,.312,70,97,.722,31,118,149,56,42,16,58,92,455,8.4
1250,Shake Milton\malik-milton-1,2016-17,Southern Methodist,G,35,35,1239,152,348,.437,70,154,.455,82,194,.423,69,91,.758,15,129,144,157,43,11,63,54,455,11.1
1251,Warren Gillis\warren-gillis-1,2014-15,Coastal Carolina,G,34,34,1064,160,366,.437,134,281,.477,26,85,.306,109,125,.872,22,84,106,108,48,3,88,76,455,9.0
1252,DaShaun Wiggins\dashaun-wiggins-1,2014-15,Portland State,G,29,24,823,133,322,.413,74,187,.396,59,135,.437,129,176,.733,17,93,110,47,44,2,59,79,454,10.0
1253,Austin Tillotson\austin-tillotson-1,2015-16,Colgate,G,30,30,1032,161,370,.435,105,206,.510,56,164,.341,76,95,.800,20,79,99,155,58,1,72,56,454,12.1
1254,Casey Jones\casey-jones-1,2014-15,Chattanooga,G,32,32,945,168,324,.519,165,312,.529,3,12,.250,115,162,.710,80,145,225,59,37,37,85,82,454,11.3
1255,Sherron Dorsey-Walker\sherron-dorsey-walker-1,2016-17,Oakland,G,34,34,1114,139,358,.388,69,167,.413,70,191,.366,106,140,.757,19,153,172,129,37,6,74,66,454,9.9
1256,Jay Harris\jay-harris-3,2014-15,Illinois-Chicago,G,30,26,974,122,318,.384,71,161,.441,51,157,.325,159,177,.898,19,71,90,110,39,3,84,57,454,10.6
1257,McKinley Wright IV\mckinley-wrightiv-1,2017-18,Colorado,G,32,31,1042,166,368,.451,138,276,.500,28,92,.304,94,122,.770,52,97,149,175,31,14,94,49,454,11.5
1258,Jamal Jones\jamal-jones-3,2013-14,Texas A&M,G,34,25,945,147,403,.365,65,179,.363,82,224,.366,78,104,.750,34,104,138,43,25,12,53,61,454,7.7
1259,Sindarius Thornwell\sindarius-thornwell-1,2013-14,South Carolina,G,34,34,1007,143,370,.386,106,270,.393,37,100,.370,131,178,.736,48,91,139,101,40,21,106,100,454,8.1
1260,Tra Holder\tra-holder-1,2015-16,Arizona State,G,32,32,1017,140,362,.387,91,228,.399,49,134,.366,125,172,.727,22,90,112,117,33,2,84,66,454,8.9
1261,Devin Sibley\devin-sibley-1,2017-18,Furman,G,32,24,850,172,373,.461,121,221,.548,51,152,.336,58,106,.547,14,143,157,63,25,10,87,63,453,8.1
1262,Terence Smith\terence-smith-1,2013-14,Tennessee-Martin,G,31,28,960,134,312,.429,74,175,.423,60,137,.438,125,152,.822,35,77,112,86,31,4,45,80,453,11.0
1263,Dakarai Henderson\dakarai-henderson-1,2015-16,Sam Houston State,G,32,32,953,150,396,.379,75,177,.424,75,219,.342,78,113,.690,26,65,91,47,19,2,42,48,453,7.9
1264,Madarious Gibbs\madarious-gibbs-1,2014-15,Texas Southern,G,32,32,1234,158,368,.429,135,277,.487,23,91,.253,114,169,.675,20,86,106,135,30,2,92,71,453,8.8
1265,Ian Miller\ian-miller-1,2013-14,Florida State,G,33,7,938,146,325,.449,81,162,.500,65,163,.399,96,110,.873,11,72,83,92,24,1,96,64,453,8.3
1266,Corey Henson\corey-henson-1,2015-16,Wagner,G,34,31,1025,155,362,.428,81,178,.455,74,184,.402,69,84,.821,21,82,103,98,39,1,61,77,453,9.2
1267,Evan Payne\evan-payne-1,2016-17,Cal State Long Beach,G,32,26,875,146,353,.414,90,197,.457,56,156,.359,105,122,.861,20,100,120,38,25,5,61,51,453,8.6
1268,Ahmad Caver\ahmad-caver-1,2017-18,Old Dominion,G,32,29,1189,155,380,.408,90,194,.464,65,186,.349,78,117,.667,19,94,113,197,73,5,65,52,453,12.6
1269,Kris Wilkes\kris-wilkes-1,2017-18,UCLA,G,33,32,983,160,363,.441,104,204,.510,56,159,.352,76,116,.655,43,119,162,56,25,18,44,83,452,9.4
1270,Kenny Carpenter\kenny-carpenter-1,2017-18,Cleveland State,G,34,33,1146,177,372,.476,120,211,.569,57,161,.354,41,58,.707,24,149,173,82,37,15,42,79,452,10.2
1271,Sir'Dominic Pointer\sirdominic-pointer-1,2014-15,St. John's (NY),G,33,32,1143,175,334,.524,173,309,.560,2,25,.080,100,138,.725,64,189,253,98,63,80,66,99,452,13.8
1272,Armon Fletcher\armon-fletcher-1,2017-18,Southern Illinois,G,32,31,1011,153,315,.486,113,200,.565,40,115,.348,106,145,.731,46,116,162,54,38,16,41,73,452,11.3
1273,Mike Lewis II\mike-lewisii-1,2016-17,Duquesne,G,32,31,1025,140,342,.409,77,167,.461,63,175,.360,109,131,.832,4,68,72,53,20,1,63,65,452,7.9
1274,Beau Beech\beau-beech-1,2014-15,North Florida,G,35,35,1065,149,351,.425,60,118,.508,89,233,.382,65,83,.783,36,164,200,50,43,10,64,92,452,9.1
1275,Christian Kessee\christian-kessee-1,2015-16,Coppin State,G,31,30,1007,150,385,.390,62,162,.383,88,223,.395,64,80,.800,15,62,77,58,20,0,63,74,452,7.5
1276,Jeremiah Bell\jeremiah-bell-1,2017-18,Milwaukee,G,32,22,975,157,371,.423,82,175,.469,75,196,.383,63,83,.759,10,92,102,57,38,3,44,74,452,9.0
1277,Jordan Hill\jordan-hill-2,2017-18,Seattle,G,33,33,1112,150,378,.397,76,174,.437,74,204,.363,78,101,.772,19,107,126,114,41,14,99,107,452,8.3
1278,Frank Mason\frank-mason-1,2014-15,Kansas,G,36,36,1207,150,340,.441,108,242,.446,42,98,.429,110,140,.786,22,119,141,142,50,4,74,65,452,10.1
1279,Tre' Coggins\tre-coggins-1,2015-16,Cal State Fullerton,G,29,26,865,145,368,.394,70,158,.443,75,210,.357,87,102,.853,14,98,112,52,20,4,71,61,452,8.6
1280,Elijah Wilson\elijah-wilson-1,2015-16,Coastal Carolina,G,33,33,1028,155,395,.392,79,184,.429,76,211,.360,65,93,.699,30,102,132,31,25,8,56,70,451,7.4
1281,Daniel Hamilton\daniel-hamilton-1,2015-16,Connecticut,G,36,36,1147,159,411,.387,112,269,.416,47,142,.331,86,100,.860,33,288,321,170,38,15,85,66,451,10.7
1282,Scottie Lindsey\scottie-lindsey-1,2016-17,Northwestern,G,32,32,975,163,384,.424,105,204,.515,58,180,.322,67,80,.838,17,105,122,73,32,8,45,73,451,9.4
1283,Deckie Johnson\deckie-johnson-1,2015-16,North Texas,G,31,31,1007,140,361,.388,67,141,.475,73,220,.332,98,124,.790,44,95,139,69,29,6,59,77,451,9.5
1284,Jordan Sibert\jordan-sibert-1,2013-14,Dayton,G,37,34,963,147,323,.455,64,128,.500,83,195,.426,74,104,.712,14,70,84,55,30,4,46,64,451,8.2
1285,Donovan Jackson\donovan-jackson-1,2017-18,Iowa State,G,30,30,1032,143,375,.381,48,138,.348,95,237,.401,70,80,.875,8,55,63,62,15,2,48,62,451,8.4
1286,Maurice Creek\maurice-creek-1,2013-14,George Washington,G,32,30,940,145,350,.414,65,150,.433,80,200,.400,81,109,.743,23,85,108,56,34,5,69,69,451,8.6
1287,Rodney Elliott\rodney-elliott-2,2013-14,Maryland-Baltimore County,G,30,30,941,141,312,.452,96,185,.519,45,127,.354,124,178,.697,19,99,118,108,40,1,108,101,451,9.3
1288,Trejon Jacob\trejon-jacob-1,2017-18,Florida International,G,31,28,1043,158,367,.431,86,175,.491,72,192,.375,63,98,.643,26,128,154,28,35,8,37,51,451,9.8
1289,Phil Forte\phil-forte-1,2013-14,Oklahoma State,G,34,11,976,129,302,.427,29,75,.387,100,227,.441,93,107,.869,12,50,62,46,29,1,22,46,451,9.7
1290,DeVaughn Akoon-Purcell\devaughn-akoon-purcell-1,2015-16,Illinois State,G,32,30,895,157,364,.431,138,291,.474,19,73,.260,118,165,.715,51,107,158,60,30,13,86,62,451,8.7
1291,Aaron Valdes\aaron-valdes-1,2014-15,Hawaii,G,33,33,934,161,338,.476,130,252,.516,31,86,.360,98,148,.662,62,114,176,40,56,12,56,78,451,10.4
1292,Jamel Waters\jamel-waters-1,2013-14,Alabama State,G,32,31,1114,146,377,.387,117,277,.422,29,100,.290,130,170,.765,25,79,104,194,58,1,76,70,451,11.3
1293,Kenneth Ogbe\kenneth-ogbe-1,2017-18,Utah Valley,G,33,33,999,150,311,.482,83,155,.535,67,156,.429,84,121,.694,19,85,104,49,26,7,57,60,451,9.1
1294,John Gillon\john-gillon-1,2015-16,Colorado State,G,34,25,1079,119,310,.384,59,131,.450,60,179,.335,152,173,.879,14,83,97,131,26,5,77,84,450,9.3
1295,Jordan Johnson\jordan-johnson-1,2017-18,Nevada-Las Vegas,G,33,33,1132,124,290,.428,75,164,.457,49,126,.389,153,182,.841,15,78,93,199,39,8,90,76,450,11.6
1296,Shaquille Johnson\shaquille-johnson-2,2014-15,Longwood,G,33,31,1065,166,419,.396,135,292,.462,31,127,.244,87,115,.757,61,124,185,94,49,18,114,92,450,8.1
1297,Javorn Farrell\javorn-farrell-1,2013-14,Texas-Rio Grande Valley,G,28,27,941,154,379,.406,127,270,.470,27,109,.248,115,155,.742,37,114,151,92,46,16,77,88,450,10.7
1298,Malcolm Hawkins\malcolm-hawkins-1,2013-14,Norfolk State,G,29,24,874,135,322,.419,76,180,.422,59,142,.415,121,155,.781,24,100,124,55,23,10,83,80,450,9.1
1299,Riley LaChance\riley-lachance-1,2017-18,Vanderbilt,G,32,31,1015,156,341,.457,75,147,.510,81,194,.418,57,73,.781,12,90,102,103,15,0,40,64,450,10.1
1300,Keon Lewis\keon-lewis-1,2014-15,Texas-San Antonio,G,29,29,974,129,324,.398,94,222,.423,35,102,.343,156,190,.821,19,59,78,89,47,0,62,57,449,10.9
1301,Brenton Scott\brenton-scott-1,2017-18,Indiana State,G,31,30,1018,156,390,.400,94,206,.456,62,184,.337,75,105,.714,14,163,177,73,53,6,78,78,449,9.2
1302,Daishon Knight\daishon-knight-1,2013-14,Illinois State,G,34,27,967,142,387,.367,94,223,.422,48,164,.293,117,150,.780,18,139,157,74,42,4,77,52,449,8.1
1303,Jared Harper\jared-harper-12,2017-18,Auburn,G,34,34,1039,111,308,.360,50,136,.368,61,172,.355,166,202,.822,14,68,82,185,40,1,72,63,449,10.8
1304,Josh Adams\josh-adams-1,2014-15,Wyoming,G,35,33,1176,146,334,.437,99,189,.524,47,145,.324,110,148,.743,21,93,114,126,48,8,90,74,449,9.2
1305,Ledarrius Brewer\ledarrius-brewer-1,2017-18,Southeast Missouri State,G,31,27,912,152,362,.420,81,166,.488,71,196,.362,74,100,.740,14,104,118,40,29,16,57,66,449,8.8
1306,Dante Holmes\dante-holmes-1,2015-16,North Carolina Central,G,29,27,975,151,374,.404,77,177,.435,74,197,.376,73,106,.689,28,113,141,52,29,2,60,98,449,8.8
1307,Zack Bryant\zack-bryant-1,2017-18,Alabama-Birmingham,G,33,32,1056,162,355,.456,132,261,.506,30,94,.319,94,125,.752,14,91,105,101,37,7,73,85,448,8.9
1308,Cody Wichmann\cody-wichmann-1,2016-17,Milwaukee,G,35,35,1149,149,367,.406,52,101,.515,97,266,.365,53,67,.791,13,124,137,54,28,2,34,80,448,8.4
1309,Chase Fischer\chase-fischer-1,2014-15,Brigham Young,G,34,33,914,147,351,.419,44,103,.427,103,248,.415,51,65,.785,10,64,74,67,25,2,49,50,448,8.4
1310,Lamonte Bearden\lamonte-bearden-1,2017-18,Western Kentucky,G,38,33,1053,151,317,.476,132,256,.516,19,61,.311,127,154,.825,21,67,88,131,65,6,92,82,448,9.1
1311,Colbey Ross\colbey-ross-1,2017-18,Pepperdine,G,32,32,1017,151,325,.465,110,229,.480,41,96,.427,105,128,.820,11,84,95,179,33,5,88,77,448,10.9
1312,Nick Garth\nick-garth-1,2017-18,Lamar,G,33,8,885,143,346,.413,64,137,.467,79,209,.378,83,99,.838,16,61,77,54,20,0,42,52,448,8.5
1313,Brett Olson\brett-olson-2,2013-14,Denver,G,31,31,1141,144,302,.477,76,147,.517,68,155,.439,92,102,.902,8,96,104,108,34,3,61,87,448,11.0
1314,Jordan Mathews\jordan-mathews-1,2014-15,University of California,G,33,32,1027,143,321,.445,73,163,.448,70,158,.443,92,117,.786,18,95,113,46,20,1,50,64,448,8.8
1315,B.J. Tyson\bj-tyson-1,2017-18,East Carolina,G,30,30,1093,162,394,.411,120,250,.480,42,144,.292,82,99,.828,25,105,130,81,24,7,58,60,448,9.4
1316,Ronnie Boyce III\ronnie-boyceiii-1,2016-17,San Francisco,G,33,7,624,168,371,.453,128,231,.554,40,140,.286,72,99,.727,28,102,130,47,28,8,68,37,448,8.4
1317,Mike Hughes\mike-hughes-1,2015-16,Georgia Southern,G,30,28,907,141,326,.433,74,152,.487,67,174,.385,99,136,.728,26,116,142,48,63,10,62,77,448,10.8
1318,Jordan Reed\jordan-reed-1,2013-14,Binghamton,G,29,25,961,134,324,.414,120,285,.421,14,39,.359,165,231,.714,72,186,258,36,45,23,78,87,447,11.3
1319,Dante Scott\dante-scott-1,2017-18,Mississippi Valley State,G,30,29,948,162,386,.420,118,267,.442,44,119,.370,79,102,.775,51,116,167,57,15,9,76,74,447,8.6
1320,Shaquille Harrison\shaquille-harrison-1,2014-15,Tulsa,G,34,34,1069,163,363,.449,150,308,.487,13,55,.236,108,171,.632,40,133,173,125,67,20,81,83,447,10.4
1321,Bryon Allen\bryon-allen-1,2013-14,George Mason,G,29,29,985,156,346,.451,113,236,.479,43,110,.391,92,110,.836,28,86,114,87,28,1,61,68,447,10.6
1322,Nico Clareth\nico-clareth-1,2015-16,Siena,G,34,8,905,174,379,.459,119,207,.575,55,172,.320,44,74,.595,33,76,109,75,54,20,77,86,447,8.7
1323,Scottie Wilbekin\scottie-wilbekin-1,2013-14,Florida,G,34,33,1150,140,348,.402,73,176,.415,67,172,.390,100,138,.725,6,77,83,123,56,0,58,59,447,9.8
1324,Sa'eed Nelson\saeed-nelson-1,2016-17,American,G,30,30,1136,164,372,.441,145,285,.509,19,87,.218,100,178,.562,20,113,133,82,72,4,86,82,447,9.4
1325,Musa Abdul-Aleem\musa-abdul-aleem-1,2014-15,Troy,G,28,20,811,151,341,.443,81,152,.533,70,189,.370,75,95,.789,25,109,134,20,33,1,53,60,447,10.1
1326,Jamaya Burr\jamaya-burr-1,2015-16,McNeese State,G,29,28,1048,127,309,.411,93,216,.431,34,93,.366,159,207,.768,23,85,108,104,44,1,98,64,447,10.3
1327,Sam Hunt\sam-hunt-1,2015-16,North Carolina A&T,G,29,25,967,134,345,.388,68,150,.453,66,195,.338,113,125,.904,8,51,59,61,20,1,69,82,447,8.2
1328,Clarke Rosenberg\clarke-rosenberg-1,2013-14,Chicago State,G,32,22,989,154,340,.453,129,266,.485,25,74,.338,114,152,.750,39,82,121,83,46,7,74,84,447,9.6
1329,Montrael Scott\montrael-scott-1,2014-15,Prairie View,G,29,29,993,163,385,.423,110,218,.505,53,167,.317,68,91,.747,28,96,124,51,41,1,65,61,447,9.3
1330,Nick Emery\nick-emery-1,2016-17,Brigham Young,G,34,33,1024,152,366,.415,77,164,.470,75,202,.371,68,82,.829,4,100,104,82,55,9,69,100,447,8.5
1331,Javier Duren\javier-duren-1,2014-15,Yale,G,32,32,1004,132,328,.402,80,185,.432,52,143,.364,131,167,.784,26,150,176,126,41,9,87,80,447,10.5
1332,Melvin Johnson\melvin-johnson-2,2014-15,Virginia Commonwealth,G,36,29,1003,155,385,.403,69,148,.466,86,237,.363,51,65,.785,17,53,70,65,37,3,36,56,447,8.0
1333,Lonnie McClanahan\lonnie-mcclanahan-1,2013-14,Texas-Arlington,G,32,23,856,149,335,.445,148,330,.448,1,5,.200,148,200,.740,36,95,131,113,29,1,105,86,447,8.6
1334,Kason Harrell\kason-harrell-1,2017-18,Purdue-Fort Wayne,G,33,32,1015,160,365,.438,71,123,.577,89,242,.368,38,46,.826,21,75,96,44,37,17,61,74,447,8.4
1335,Zaynah Robinson\zaynah-robinson-1,2016-17,Norfolk State,G,33,29,1176,148,390,.379,89,211,.422,59,179,.330,91,117,.778,12,101,113,148,53,4,55,69,446,10.2
1336,Dylon Cormier\dylon-cormier-1,2013-14,Loyola (MD),G,21,20,727,150,325,.462,130,255,.510,20,70,.286,126,191,.660,63,59,122,38,46,9,42,52,446,15.7
1337,Darrell Brown\darrell-brown-1,2017-18,Bradley,G,33,32,1051,141,400,.353,92,262,.351,49,138,.355,115,143,.804,7,70,77,142,25,0,95,69,446,7.2
1338,Victor Joseph\victor-joseph-1,2017-18,Cal Poly,G,31,31,913,147,365,.403,83,188,.441,64,177,.362,88,100,.880,18,61,79,59,26,5,59,64,446,8.4
1339,Christian Terrell\christian-terrell-1,2015-16,Florida Gulf Coast,G,35,24,1021,159,357,.445,112,226,.496,47,131,.359,81,113,.717,38,139,177,82,42,13,46,67,446,10.0
1340,DaVonte Lacy\davonte-lacy-1,2013-14,Washington State,G,23,23,787,132,308,.429,56,113,.496,76,195,.390,106,127,.835,22,75,97,33,28,3,47,57,446,12.9
1341,Frankie Ferrari\frankie-ferrari-1,2017-18,San Francisco,G,39,27,1119,157,382,.411,87,202,.431,70,180,.389,62,78,.795,8,89,97,179,38,0,69,72,446,8.5
1342,Geno Luzcando\geno-luzcando-1,2015-16,Idaho State,G,31,31,950,151,300,.503,114,197,.579,37,103,.359,107,150,.713,31,95,126,41,61,3,84,91,446,9.7
1343,Kobe Webster\kobe-webster-1,2017-18,Western Illinois,G,28,28,935,165,383,.431,106,222,.477,59,161,.366,57,73,.781,10,106,116,97,20,3,63,44,446,10.2
1344,Jake Odum\jake-odum-1,2013-14,Indiana State,G,34,34,1096,124,291,.426,102,221,.462,22,70,.314,176,229,.769,20,123,143,155,35,5,63,66,446,11.2
1345,Shep Garner\shep-garner-1,2017-18,Penn State,G,39,39,1279,146,329,.444,26,52,.500,120,277,.433,34,41,.829,8,72,80,52,35,4,47,83,446,7.5
1346,Edward Stephens\edward-stephens-1,2015-16,South Carolina State,G,34,33,1033,149,341,.437,59,118,.500,90,223,.404,58,69,.841,12,70,82,56,24,1,33,60,446,8.8
1347,Marshun Newell\marshun-newell-1,2014-15,Tennessee-Martin,G,34,34,1199,146,354,.412,77,184,.418,69,170,.406,85,112,.759,52,182,234,91,35,3,75,59,446,10.0
1348,Damyean Dotson\damyean-dotson-1,2015-16,Houston,G,32,32,991,164,324,.506,102,155,.658,62,169,.367,55,66,.833,62,155,217,40,22,6,33,61,445,11.4
1349,Brady Heslip\brady-heslip-1,2013-14,Baylor,G,38,19,1042,133,295,.451,15,41,.366,118,254,.465,61,76,.803,11,37,48,33,20,0,14,45,445,8.3
1350,Dakota Mathias\dakota-mathias-1,2017-18,Purdue,G,37,37,1158,151,320,.472,55,114,.482,96,206,.466,47,57,.825,5,145,150,146,46,9,54,64,445,10.8
1351,Jordan Bohannon\jordan-bohannon-1,2017-18,Iowa,G,33,33,1050,137,324,.423,41,101,.406,96,223,.430,75,83,.904,4,70,74,178,22,0,68,59,445,10.6
1352,Shizz Alston Jr.\shawn-alston-1,2016-17,Temple,G,32,32,1164,156,382,.408,89,188,.473,67,194,.345,66,76,.868,20,96,116,131,53,12,48,80,445,11.0
1353,Myles Stephens\myles-stephens-1,2017-18,Princeton,G,29,29,998,171,329,.520,131,232,.565,40,97,.412,63,92,.685,40,142,182,41,13,26,64,61,445,10.8
1354,Blake Hamilton\blake-hamilton-2,2015-16,Buffalo,G,34,24,901,152,334,.455,99,194,.510,53,140,.379,88,119,.739,45,195,240,85,47,12,97,96,445,9.7
1355,Omar Prewitt\omar-prewitt-1,2014-15,William & Mary,G,33,33,1089,152,331,.459,102,184,.554,50,147,.340,91,130,.700,16,128,144,84,40,27,63,77,445,10.1
1356,Mathieu Kamba\mathieu-kamba-1,2016-17,Central Arkansas,G,32,31,1001,167,314,.532,159,294,.541,8,20,.400,102,172,.593,90,124,214,56,25,16,71,92,444,10.3
1357,Christavious Gill\christavious-gill-1,2015-16,New Orleans,G,30,29,908,140,372,.376,76,187,.406,64,185,.346,100,120,.833,26,48,74,83,57,3,51,55,444,10.3
1358,Isaiah Taylor\isaiah-taylor-1,2013-14,Texas,G,35,35,1055,144,368,.391,139,349,.398,5,19,.263,151,202,.748,10,105,115,141,37,3,83,90,444,8.0
1359,Tomas Sanchez\tomas-sanchez-1,2013-14,Idaho State,G,29,29,1099,126,325,.388,67,165,.406,59,160,.369,133,160,.831,16,68,84,125,50,3,92,61,444,10.7
1360,Tre Bowman\tre-bowman-2,2013-14,Iona,G,32,27,1004,156,298,.523,88,128,.688,68,170,.400,64,81,.790,28,115,143,40,31,6,24,44,444,11.5
1361,Eric Atkins\eric-atkins-1,2013-14,Notre Dame,G,32,32,1211,159,375,.424,98,210,.467,61,165,.370,65,96,.677,28,60,88,156,39,5,61,73,444,10.4
1362,Derrick Bruce\derrick-bruce-1,2017-18,Texas Southern,G,32,28,1057,143,363,.394,59,150,.393,84,213,.394,74,90,.822,18,103,121,63,37,8,71,71,444,8.5
1363,Ken Williams\ken-williams-1,2016-17,South Alabama,G,32,26,941,141,392,.360,91,205,.444,50,187,.267,112,144,.778,19,74,93,106,27,7,61,52,444,8.5
1364,Damiyne Durham\damiyne-durham-1,2016-17,Cal State Bakersfield,G,35,0,742,163,422,.386,66,136,.485,97,286,.339,21,33,.636,28,79,107,27,44,13,51,34,444,7.4
1365,Keith Braxton\keith-braxton-1,2016-17,Saint Francis (PA),G,34,30,1136,164,308,.532,139,251,.554,25,57,.439,91,119,.765,69,224,293,107,49,13,85,69,444,12.3
1366,Justin Forrest\justin-forrest-1,2017-18,Appalachian State,G,33,27,924,147,399,.368,81,181,.448,66,218,.303,84,126,.667,10,85,95,67,42,2,95,86,444,6.1
1367,Jalen Jones\jalen-jones-2,2015-16,Texas-Arlington,G,35,34,877,155,337,.460,105,197,.533,50,140,.357,84,104,.808,67,115,182,43,29,1,29,75,444,9.8
1368,Fletcher Magee\fletcher-magee-1,2015-16,Wofford,G,32,22,921,133,282,.472,42,92,.457,91,190,.479,86,93,.925,12,85,97,47,12,3,47,49,443,9.7
1369,Anton Wilson\anton-wilson-1,2015-16,Detroit Mercy,G,31,30,1001,137,314,.436,51,113,.451,86,201,.428,83,93,.892,28,94,122,68,41,19,54,91,443,10.8
1370,Jeremy Hemsley\jeremy-hemsley-1,2015-16,San Diego State,G,37,25,1014,147,342,.430,105,224,.469,42,118,.356,107,141,.759,19,70,89,68,27,12,71,82,443,7.1
1371,Francis Alonso\francis-alonso-1,2015-16,North Carolina-Greensboro,G,34,26,965,139,313,.444,54,98,.551,85,215,.395,80,94,.851,8,52,60,61,18,5,66,67,443,7.8
1372,Joe Harris\joe-harris--1,2013-14,Virginia,G,37,37,1066,149,338,.441,77,158,.487,72,180,.400,73,114,.640,22,87,109,84,35,8,48,88,443,8.3
1373,Elijah Stewart\elijah-stewart-1,2016-17,Southern California,G,36,32,1073,154,357,.431,76,155,.490,78,202,.386,57,81,.704,45,96,141,43,29,42,37,94,443,8.9
1374,Anthony Brown\anthony-brown-5,2013-14,Stanford,G,36,35,1206,142,299,.475,89,182,.489,53,117,.453,106,135,.785,33,147,180,75,31,4,70,67,443,9.3
1375,LaVone Holland\lavone-holland-1,2017-18,Northern Kentucky,G,32,29,969,147,357,.412,90,193,.466,57,164,.348,91,108,.843,17,116,133,140,34,7,82,74,442,9.9
1376,D'Shon Taylor\dshon-taylor-1,2014-15,Norfolk State,G,34,33,1082,145,322,.450,95,181,.525,50,141,.355,102,151,.675,54,116,170,45,28,25,57,93,442,9.1
1377,Ray Bowles\ray-bowles-1,2016-17,Pacific,G,33,33,1107,141,397,.355,95,251,.378,46,146,.315,114,162,.704,35,88,123,89,26,10,72,88,442,7.3
1378,Jabari Peters\jabari-peters-1,2013-14,Sam Houston State,G,35,35,1113,115,300,.383,65,172,.378,50,128,.391,162,236,.686,29,130,159,147,44,13,81,59,442,10.3
1379,J.R. Lynch\jr-lynch-2,2017-18,Hartford,G,33,33,1190,154,361,.427,103,220,.468,51,141,.362,83,100,.830,11,132,143,126,48,2,80,89,442,9.5
1380,Mike Cunningham\mike-cunningham-2,2016-17,South Carolina Upstate,G,33,27,1041,145,360,.403,70,165,.424,75,195,.385,77,94,.819,15,66,81,103,44,1,49,39,442,9.8
1381,Lucky Jones\lucky-jones-1,2014-15,Robert Morris,G,31,19,924,135,346,.390,75,165,.455,60,181,.331,112,142,.789,43,141,184,43,42,12,73,82,442,9.3
1382,Darien Fernandez\darien-fernandez-1,2016-17,Jacksonville,G,33,32,975,134,334,.401,77,184,.418,57,150,.380,117,158,.741,35,110,145,123,79,2,81,116,442,10.4
1383,Paris Bass\paris-bass-1,2015-16,Detroit Mercy,G,24,19,714,159,342,.465,137,274,.500,22,68,.324,102,149,.685,50,141,191,50,33,33,81,84,442,12.6
1384,Keith Hornsby\keith-hornsby-1,2014-15,Louisiana State,G,33,33,1172,156,370,.422,84,187,.449,72,183,.393,58,74,.784,20,118,138,69,37,16,47,52,442,9.6
1385,Scoochie Smith\scoochie-smith-1,2016-17,Dayton,G,32,32,1000,145,310,.468,91,171,.532,54,139,.388,98,127,.772,11,87,98,144,51,3,70,76,442,11.2
1386,De'Sean Parsons\desean-parsons-1,2016-17,Portland State,G,31,30,905,167,346,.483,151,295,.512,16,51,.314,92,174,.529,56,137,193,83,41,22,89,66,442,10.1
1387,Pancake Thomas\cleveland-thomas-1,2016-17,Western Kentucky,G,32,32,1112,149,358,.416,73,167,.437,76,191,.398,68,87,.782,23,83,106,82,28,1,42,47,442,9.7
1388,Akeem Williams\akeem-williams-1,2013-14,Massachusetts-Lowell,G,28,28,896,145,379,.383,91,222,.410,54,157,.344,98,122,.803,26,88,114,95,36,2,90,67,442,9.2
1389,Dedrick Basile\dedrick-basile-1,2016-17,Cal State Bakersfield,G,35,35,1042,165,375,.440,100,208,.481,65,167,.389,47,68,.691,22,89,111,106,56,3,73,85,442,8.7
1390,Cassius Winston\cassius-winston-1,2017-18,Michigan State,G,35,34,985,143,282,.507,68,131,.519,75,151,.497,81,90,.900,7,111,118,241,23,2,87,69,442,11.9
1391,John Konchar\john-konchar-1,2015-16,Purdue-Fort Wayne,G,34,33,1211,163,279,.584,134,213,.629,29,66,.439,86,119,.723,91,221,312,92,71,9,51,81,441,14.3
1392,Trae Anderson\trae-anderson-1,2015-16,Eastern Illinois,G,30,27,711,171,357,.479,166,325,.511,5,32,.156,94,141,.667,46,110,156,53,31,22,85,91,441,8.9
1393,Kyan Anderson\kyan-anderson-1,2014-15,Texas Christian,G,33,32,1055,132,332,.398,75,164,.457,57,168,.339,120,138,.870,9,39,48,141,41,5,84,68,441,9.2
1394,Mike Brown\mike-brown-5,2014-15,Western Carolina,G,32,32,1117,162,354,.458,120,240,.500,42,114,.368,75,112,.670,67,133,200,51,29,18,70,95,441,9.4
1395,Bryant McIntosh\bryant-mcintosh-1,2015-16,Northwestern,G,32,32,1142,161,381,.423,112,247,.453,49,134,.366,70,85,.824,12,104,116,213,31,5,78,65,441,11.0
1396,Jared Terrell\jared-terrell-1,2016-17,Rhode Island,G,35,34,1074,142,340,.418,96,207,.464,46,133,.346,111,148,.750,34,66,100,71,36,6,54,90,441,8.2
1397,Alex Harris\alex-harris-2,2014-15,Cal State Fullerton,G,28,27,897,147,354,.415,112,231,.485,35,123,.285,112,167,.671,12,99,111,98,41,4,77,54,441,10.1
1398,Justin Robinson\justin-robinson-2,2014-15,Monmouth,G,33,33,1062,139,331,.420,87,190,.458,52,141,.369,111,140,.793,21,92,113,120,56,0,64,48,441,10.7
1399,Kyle Hittle\kyle-hittle-1,2013-14,Incarnate Word,G,27,26,915,154,290,.531,95,145,.655,59,145,.407,74,105,.705,30,123,153,48,21,8,47,48,441,12.6
1400,Jordan Capps\jordan-capps-1,2017-18,Southeastern Louisiana,G,33,20,692,178,329,.541,160,276,.580,18,53,.340,67,122,.549,37,105,142,17,15,31,63,79,441,8.2
1401,Ryan Andino\ryan-andino-1,2016-17,Maryland-Eastern Shore,G,34,24,1055,138,379,.364,17,61,.279,121,318,.381,44,52,.846,9,60,69,33,29,1,36,40,441,7.4
1402,Sterling Gibbs\sterling-gibbs-1,2015-16,Connecticut,G,36,36,1186,125,322,.388,46,118,.390,79,204,.387,112,131,.855,11,67,78,83,34,1,58,57,441,8.3
1403,Pat Connaughton\pat-connaughton-1,2013-14,Notre Dame,G,32,32,1190,155,343,.452,79,142,.556,76,201,.378,55,66,.833,38,189,227,95,33,18,35,57,441,12.4
1404,Josh Williams\josh-williams-4,2016-17,Lipscomb,G,33,33,850,142,321,.442,68,125,.544,74,196,.378,83,98,.847,34,80,114,57,27,8,74,82,441,8.5
1405,Aaron Holiday\aaron-holiday-1,2016-17,UCLA,G,36,0,952,150,309,.485,97,180,.539,53,129,.411,88,111,.793,12,91,103,158,39,6,87,81,441,9.6
1406,David Cohn\david-cohn-1,2017-18,William & Mary,G,31,31,1114,144,272,.529,95,157,.605,49,115,.426,103,113,.912,9,83,92,207,50,0,83,59,440,13.6
1407,Bernard Thompson\bernard-thompson-2,2014-15,Florida Gulf Coast,G,32,31,1031,151,383,.394,77,187,.412,74,196,.378,64,87,.736,46,114,160,56,55,4,50,66,440,9.7
1408,Chris Perez\chris-perez-1,2013-14,Canisius,G,34,34,1192,161,364,.442,135,293,.461,26,71,.366,92,131,.702,37,58,95,58,26,1,72,79,440,7.1
1409,Malcolm Drumwright\malcolm-drumwright-1,2016-17,Jacksonville State,G,35,34,1160,155,372,.417,92,196,.469,63,176,.358,67,84,.798,9,74,83,135,21,8,86,95,440,7.4
1410,Jeremy Hollimon\jeremy-hollimon-1,2016-17,Troy,G,37,2,807,145,305,.475,98,192,.510,47,113,.416,103,132,.780,29,65,94,58,20,6,56,68,440,8.0
1411,Terry Henderson\terry-henderson-1,2016-17,North Carolina State,G,32,32,988,136,314,.433,58,111,.523,78,203,.384,90,117,.769,22,77,99,51,22,18,51,76,440,9.1
1412,Tyler Ennis\tyler-ennis-1,2013-14,Syracuse,G,34,34,1215,148,360,.411,118,275,.429,30,85,.353,114,149,.765,27,88,115,187,71,6,58,69,440,11.7
1413,Andre Wolford\andre-wolford-1,2017-18,Saint Francis (PA),G,31,25,899,141,280,.504,44,84,.524,97,196,.495,61,72,.847,16,77,93,25,16,3,24,56,440,10.3
1414,Angel Rodriguez\angel-rodriguez-1,2015-16,Miami (FL),G,35,35,1055,144,326,.442,88,162,.543,56,164,.341,96,120,.800,23,66,89,158,58,6,89,90,440,9.8
1415,Kevin Pangos\kevin-pangos-1,2014-15,Gonzaga,G,38,38,1278,135,301,.449,54,113,.478,81,188,.431,89,108,.824,16,88,104,181,48,4,51,74,440,10.8
1416,Terence Davis\terence-davis-1,2017-18,Mississippi,G,32,24,873,157,386,.407,98,200,.490,59,186,.317,67,93,.720,47,151,198,66,29,28,72,94,440,8.9
1417,Bubba Parham\bubba-parham-1,2017-18,Virginia Military Institute,G,30,30,895,145,363,.399,87,188,.463,58,175,.331,91,114,.798,12,89,101,74,24,0,83,67,439,7.8
1418,Kevin Zabo\kevin-zabo-1,2017-18,Kent State,G,34,22,980,155,369,.420,111,232,.478,44,137,.321,85,108,.787,19,89,108,82,36,2,63,97,439,7.8
1419,Phil Forte\phil-forte-1,2016-17,Oklahoma State,G,33,32,1028,135,316,.427,50,112,.446,85,204,.417,84,88,.955,23,62,85,49,37,2,33,50,439,9.8
1420,Trae Bell-Haynes\trae-bell-haynes-1,2015-16,Vermont,G,36,34,995,135,286,.472,109,220,.495,26,66,.394,143,179,.799,16,80,96,126,41,2,98,87,439,8.7
1421,Ryan Kemrite\ryan-kemrite-1,2016-17,Liberty,G,33,33,1037,130,267,.487,49,75,.653,81,192,.422,98,116,.845,17,71,88,28,31,3,24,85,439,9.8
1422,Jherrod Stiggers\jherrod-stiggers-1,2014-15,Houston,G,31,28,1105,139,384,.362,43,104,.413,96,280,.343,65,85,.765,17,96,113,79,37,10,89,54,439,8.0
1423,Marcus Johnson Jr.\marcus-johnsonjr-1,2015-16,Little Rock,G,35,18,1072,140,296,.473,65,135,.481,75,161,.466,83,106,.783,21,87,108,54,27,0,47,39,438,9.2
1424,Evan Kelley\evan-kelley-1,2014-15,Sacred Heart,G,32,32,999,172,375,.459,161,326,.494,11,49,.224,83,136,.610,30,99,129,76,38,7,68,62,438,8.7
1425,Isaac Williams\isaac-williams-1,2016-17,Mississippi Valley State,G,32,23,916,157,395,.397,91,209,.435,66,186,.355,58,70,.829,40,75,115,29,28,4,23,65,438,8.5
1426,Darion Rackley\darion-rackley-1,2014-15,Jacksonville State,G,29,26,941,120,338,.355,80,195,.410,40,143,.280,158,211,.749,29,83,112,62,41,7,77,60,438,9.0
1427,Alex Robinson\alex-robinson-2,2016-17,Texas Christian,G,39,31,1283,164,391,.419,125,274,.456,39,117,.333,71,112,.634,18,104,122,228,59,20,107,73,438,9.1
1428,D'Shon Taylor\dshon-taylor-1,2015-16,Norfolk State,G,33,28,946,147,327,.450,103,203,.507,44,124,.355,100,130,.769,57,118,175,51,38,20,63,86,438,9.7
1429,LaVell Boyd\lavell-boyd-1,2015-16,Missouri-Kansas City,G,31,30,1014,149,345,.432,68,152,.447,81,193,.420,59,73,.808,13,92,105,70,24,4,45,78,438,9.3
1430,Giddy Potts\giddy-potts-1,2017-18,Middle Tennessee,G,33,32,1051,142,343,.414,57,133,.429,85,210,.405,69,80,.863,15,126,141,63,45,8,54,85,438,9.3
1431,Jordan Chatman\jordan-chatman-1,2017-18,Boston College,G,34,34,1250,140,337,.415,53,117,.453,87,220,.395,71,79,.899,16,84,100,54,22,1,28,58,438,8.8
1432,Rysheed Jordan\rysheed-jordan-1,2014-15,St. John's (NY),G,31,21,952,143,329,.435,100,211,.474,43,118,.364,109,166,.657,37,77,114,95,54,10,93,82,438,9.4
1433,Laurynas Motuzis\laurynas-motuzis-1,2017-18,American,G,30,30,1083,155,373,.416,92,183,.503,63,190,.332,65,102,.637,22,121,143,50,49,7,66,85,438,8.8
1434,Shizz Alston Jr.\shawn-alston-1,2017-18,Temple,G,33,33,1111,157,392,.401,86,213,.404,71,179,.397,53,59,.898,22,82,104,102,26,1,52,53,438,8.8
1435,Miye Oni\miye-oni-1,2017-18,Yale,G,29,26,952,156,385,.405,99,201,.493,57,184,.310,69,92,.750,26,147,173,105,27,20,81,82,438,9.8
1436,Robert Hubbs\robert-hubbs-1,2016-17,Tennessee,G,32,31,1011,170,364,.467,166,338,.491,4,26,.154,93,111,.838,40,107,147,53,23,7,47,56,437,9.3
1437,Ryan Martin\ryan-martin-3,2015-16,Tennessee Tech,G,31,30,895,133,255,.522,116,198,.586,17,57,.298,154,197,.782,74,179,253,36,18,21,61,108,437,11.4
1438,Clayton Custer\clayton-custer-1,2017-18,Loyola (IL),G,33,33,1086,160,303,.528,100,170,.588,60,133,.451,57,74,.770,8,63,71,135,50,2,71,57,437,10.9
1439,Tadric Jackson\tadric-jackson-1,2016-17,Georgia Tech,G,36,5,857,169,379,.446,129,256,.504,40,123,.325,59,104,.567,13,67,80,65,24,7,60,69,437,6.6
1440,Braian Angola-Rodas\braian-angola-rodas-1,2017-18,Florida State,G,35,31,963,135,324,.417,71,154,.461,64,170,.376,103,123,.837,32,106,138,105,46,9,72,86,437,9.4
1441,Jon Axel Gudmundsson\jonaxel-gudmundsson-1,2017-18,Davidson,G,33,33,1182,144,313,.460,81,158,.513,63,155,.406,86,108,.796,14,185,199,167,44,1,72,56,437,12.1
1442,Mike Talley\mike-talley-1,2014-15,Eastern Michigan,G,35,18,1027,131,302,.434,97,199,.487,34,103,.330,141,199,.709,19,61,80,147,56,0,64,72,437,10.1
1443,J.P. Macura\jp-macura-1,2017-18,Xavier,G,34,34,1010,146,305,.479,97,175,.554,49,130,.377,96,117,.821,45,107,152,99,49,13,68,76,437,10.8
1444,Isaiah Briscoe\isaiah-briscoe-1,2016-17,Kentucky,G,36,36,1095,163,347,.470,146,288,.507,17,59,.288,94,148,.635,53,142,195,152,30,7,89,92,437,9.2
1445,Craig Sword\craig-sword-1,2013-14,Mississippi State,G,32,32,900,157,324,.485,145,280,.518,12,44,.273,111,179,.620,35,85,120,88,60,15,96,93,437,9.2
1446,Quinton Campbell\quinton-campbell-1,2016-17,Southern Mississippi,G,31,31,1033,145,372,.390,89,193,.461,56,179,.313,91,117,.778,37,154,191,37,21,10,50,50,437,9.0
1447,Josh Okogie\josh-okogie-1,2017-18,Georgia Tech,G,24,24,873,133,320,.416,95,220,.432,38,100,.380,133,162,.821,54,96,150,59,42,23,61,70,437,13.8
1448,Tony Carr\tony-carr-1,2016-17,Penn State,G,33,33,1084,141,374,.377,108,271,.399,33,103,.320,121,157,.771,22,137,159,137,22,10,86,72,436,8.6
1449,Darnell Edge\darnell-edge-1,2017-18,Fairleigh Dickinson,G,30,30,1021,146,325,.449,86,159,.541,60,166,.361,84,89,.944,13,74,87,71,40,1,48,53,436,10.6
1450,Jared Terrell\jared-terrell-1,2015-16,Rhode Island,G,32,32,1137,148,373,.397,107,255,.420,41,118,.347,99,132,.750,14,95,109,82,38,8,62,80,436,8.3
1451,J.C. Hampton\jc-hampton-1,2013-14,Lipscomb,G,30,30,941,136,334,.407,54,122,.443,82,212,.387,82,109,.752,7,85,92,88,30,5,73,85,436,8.8
1452,Alante Fenner\alante-fenner-1,2017-18,Savannah State,G,31,24,820,141,354,.398,94,201,.468,47,153,.307,106,139,.763,35,109,144,73,46,0,66,45,435,9.7
1453,Braun Hartfield\braun-hartfield-1,2017-18,Youngstown State,G,32,27,1018,154,361,.427,106,224,.473,48,137,.350,79,127,.622,45,93,138,84,54,26,78,81,435,9.5
1454,Trey Kell\trey-kell-1,2016-17,San Diego State,G,33,32,1050,143,381,.375,105,239,.439,38,142,.268,111,145,.766,17,145,162,96,45,14,57,56,435,9.4
1455,Shawn Anderson\shawn-anderson-1,2015-16,Navy,G,33,33,1001,165,331,.498,141,255,.553,24,76,.316,81,124,.653,36,96,132,87,26,3,75,66,435,8.9
1456,Marlain Veal\marlain-veal-1,2017-18,Southeastern Louisiana,G,34,34,1146,140,314,.446,104,214,.486,36,100,.360,119,158,.753,31,147,178,207,66,4,116,77,435,11.4
1457,Robert Johnson\robert-johnson-5,2017-18,Indiana,G,31,31,1060,156,365,.427,90,188,.479,66,177,.373,57,81,.704,6,133,139,84,25,6,76,64,435,8.5
1458,Rashun Davis\rashun-davis-1,2015-16,Radford,G,31,30,975,156,353,.442,117,243,.481,39,110,.355,84,117,.718,11,80,91,149,60,2,90,77,435,10.1
1459,Kendrick Nunn\kendrick-nunn-1,2015-16,Illinois,G,28,25,982,155,362,.428,80,170,.471,75,192,.391,50,63,.794,10,129,139,48,41,5,45,63,435,10.4
1460,Ty Taylor II\ty-taylorii-1,2017-18,North Carolina-Wilmington,G,32,30,945,154,395,.390,103,241,.427,51,154,.331,76,97,.784,26,114,140,62,26,5,57,60,435,8.0
1461,Kentrell Barkley\kentrell-barkley-1,2016-17,East Carolina,G,33,31,1066,134,329,.407,95,215,.442,39,114,.342,128,188,.681,61,190,251,86,33,15,81,58,435,10.1
1462,Mike Laster\mike-laster-1,2017-18,Ohio,G,30,30,992,164,344,.477,110,206,.534,54,138,.391,53,75,.707,14,73,87,58,17,5,45,58,435,9.2
1463,Shaquille Boga\shaquille-boga-2,2013-14,Texas-Rio Grande Valley,G,31,31,1032,152,383,.397,109,261,.418,43,122,.352,88,124,.710,17,90,107,103,65,2,56,71,435,9.9
1464,Javontae Hawkins\javontae-hawkins-1,2016-17,Fordham,G,31,30,969,145,333,.435,114,245,.465,31,88,.352,113,134,.843,40,113,153,30,31,14,72,87,434,8.6
1465,Daniel Dion\daniel-dion-1,2016-17,New Hampshire,G,32,31,1132,132,309,.427,38,85,.447,94,224,.420,76,97,.784,8,83,91,78,21,0,53,45,434,9.3
1466,Prentiss Nixon\prentiss-nixon-1,2017-18,Colorado State,G,27,25,867,133,370,.359,67,170,.394,66,200,.330,102,121,.843,8,78,86,53,40,3,56,71,434,9.1
1467,Robert Johnson\robert-johnson-5,2016-17,Indiana,G,34,32,999,162,361,.449,92,172,.535,70,189,.370,40,53,.755,12,137,149,85,29,3,78,73,434,8.1
1468,Mark Alstork\mark-alstork-1,2015-16,Wright State,G,35,29,931,140,324,.432,86,181,.475,54,143,.378,100,144,.694,23,141,164,61,29,21,55,100,434,8.4
1469,Garret Covington\garret-covington-1,2014-15,Western Illinois,G,28,28,925,135,359,.376,72,182,.396,63,177,.356,101,122,.828,7,113,120,65,31,6,76,43,434,9.1
1470,Andrew Harrison\andrew-harrison-1,2013-14,Kentucky,G,40,39,1267,121,330,.367,88,236,.373,33,94,.351,159,208,.764,32,94,126,159,21,9,109,119,434,6.6
1471,Walter Wright\walter-wright-1,2015-16,Montana,G,33,33,1080,148,367,.403,101,238,.424,47,129,.364,91,115,.791,22,95,117,152,34,0,88,85,434,8.8
1472,Kenny Gaines\kenny-gaines-1,2015-16,Georgia,G,34,33,992,141,369,.382,56,147,.381,85,222,.383,67,90,.744,26,73,99,34,28,23,51,107,434,7.0
1473,Corey Allen\corey-allen-2,2016-17,Detroit Mercy,G,30,26,941,148,337,.439,70,163,.429,78,174,.448,60,93,.645,26,65,91,55,30,3,55,73,434,8.9
1474,Jaron Hopkins\jaron-hopkins-1,2016-17,Fresno State,G,33,27,981,181,376,.481,172,339,.507,9,37,.243,63,108,.583,44,139,183,119,69,8,101,92,434,9.6
1475,Roderick Bobbitt\roderick-bobbitt-1,2015-16,Hawaii,G,33,31,1125,125,326,.383,70,161,.435,55,165,.333,129,161,.801,35,108,143,180,68,6,92,86,434,11.3
1476,Tre' Coggins\tre-coggins-1,2013-14,Air Force,G,27,25,958,146,344,.424,74,158,.468,72,186,.387,69,88,.784,8,64,72,71,32,9,73,68,433,9.5
1477,Patricio Garino\patricio-garino-1,2014-15,George Washington,G,35,35,1107,153,288,.531,137,234,.585,16,54,.296,111,151,.735,75,110,185,52,59,28,89,81,433,10.2
1478,Justin Bibbins\justin-bibbins-1,2016-17,Cal State Long Beach,G,33,33,1083,137,344,.398,86,208,.413,51,136,.375,108,122,.885,21,85,106,152,44,1,94,95,433,9.1
1479,Damon Lynn\damon-lynn-1,2016-17,NJIT,G,21,20,718,128,341,.375,43,98,.439,85,243,.350,92,106,.868,9,37,46,72,39,3,50,31,433,13.6
1480,Seth Hinrichs\seth-hinrichs-1,2014-15,Lafayette,G,33,33,1027,154,315,.489,102,181,.564,52,134,.388,73,87,.839,54,135,189,84,28,22,69,60,433,10.8
1481,T.J. Sapp\tj-sapp-1,2014-15,Murray State,G,35,35,1070,144,313,.460,78,138,.565,66,175,.377,79,95,.832,15,99,114,102,34,3,68,78,433,9.0
1482,Anthony Mathis\anthony-mathis-1,2017-18,New Mexico,G,34,13,762,134,271,.494,36,64,.563,98,207,.473,67,78,.859,14,58,72,34,19,4,27,87,433,8.9
1483,Brandon Boyd\brandon-boyd-1,2017-18,Idaho State,G,29,12,858,148,316,.468,104,186,.559,44,130,.338,93,116,.802,15,108,123,71,39,2,56,48,433,11.0
1484,Darrion Allen\darrion-allen-1,2016-17,Longwood,G,30,30,1088,138,371,.372,84,196,.429,54,175,.309,103,123,.837,22,91,113,44,30,22,72,72,433,8.0
1485,JD Notae\jd-notae-1,2017-18,Jacksonville,G,28,28,878,159,388,.410,110,267,.412,49,121,.405,65,93,.699,28,103,131,54,49,14,72,60,432,9.4
1486,Jason Calliste\jason-calliste-1,2013-14,Oregon,G,34,1,901,115,218,.528,50,89,.562,65,129,.504,137,157,.873,17,54,71,57,36,2,50,73,432,10.1
1487,Justin Drummond\justin-drummond-2,2014-15,Toledo,G,33,33,969,145,303,.479,116,228,.509,29,75,.387,113,145,.779,35,117,152,62,24,16,67,89,432,9.1
1488,Ky Howard\ky-howard-1,2015-16,NJIT,G,34,34,1088,141,285,.495,116,219,.530,25,66,.379,125,164,.762,31,127,158,154,33,5,110,98,432,9.7
1489,Corey Allen\corey-allen-1,2014-15,South Florida,G,28,27,937,156,351,.444,116,237,.489,40,114,.351,80,101,.792,24,78,102,71,43,9,71,56,432,10.2
1490,Justin Coleman\justin-coleman-2,2017-18,Samford,G,32,27,1040,146,336,.435,89,182,.489,57,154,.370,83,103,.806,11,78,89,210,37,0,87,41,432,11.2
1491,Rashawn Rembert\rashawn-rembert-1,2014-15,East Tennessee State,G,30,29,979,138,336,.411,48,98,.490,90,238,.378,66,80,.825,9,69,78,36,27,3,42,52,432,8.8
1492,Trey Lewis\trey-lewis-1,2013-14,Cleveland State,G,33,26,1044,135,337,.401,77,180,.428,58,157,.369,104,139,.748,24,98,122,112,28,9,81,68,432,8.7
1493,Marcus Graves\marcus-graves-1,2016-17,Sacramento State,G,31,30,1088,163,372,.438,156,315,.495,7,57,.123,99,134,.739,15,100,115,165,28,10,81,70,432,9.8
1494,Erick Neal\erick-neal-1,2015-16,Texas-Arlington,G,34,33,1068,138,356,.388,72,156,.462,66,200,.330,89,122,.730,31,104,135,211,56,4,89,94,431,10.5
1495,Sterling Smith\sterling-smith-1,2014-15,Coppin State,G,31,27,933,147,314,.468,71,132,.538,76,182,.418,61,79,.772,42,110,152,51,44,15,45,46,431,11.4
1496,London Perrantes\london-perrantes-1,2016-17,Virginia,G,34,34,1093,146,353,.414,81,179,.453,65,174,.374,74,91,.813,11,91,102,128,25,2,58,33,431,9.3
1497,Mackey McKnight\mackey-mcknight-1,2013-14,Lehigh,G,32,31,1131,142,355,.400,102,230,.443,40,125,.320,107,144,.743,16,111,127,192,42,2,84,75,431,10.4
1498,Robert Champion\robert-champion-1,2016-17,Holy Cross,G,32,30,1021,149,363,.410,92,187,.492,57,176,.324,76,112,.679,11,102,113,43,51,11,60,89,431,7.9
1499,Jarvis Haywood\jarvis-haywood-1,2013-14,Jacksonville,G,26,26,784,149,293,.509,116,213,.545,33,80,.413,100,135,.741,37,80,117,68,33,4,80,73,431,11.4
1500,Zeek Woodley\zikiteran-woodley-1,2013-14,Northwestern State,G,31,24,746,174,282,.617,164,258,.636,10,24,.417,73,91,.802,55,87,142,21,12,25,38,73,431,10.9
1501,Jaden Jackson\jaden-jackson-1,2015-16,Utah Valley,G,30,30,1006,154,371,.415,94,211,.445,60,160,.375,63,77,.818,16,59,75,74,26,1,35,42,431,9.4
1502,Matt Frierson\matt-frierson-1,2017-18,Citadel,G,32,16,904,125,344,.363,11,30,.367,114,314,.363,67,75,.893,13,69,82,43,35,1,41,32,431,8.7
1503,Reggie Baker\reggie-baker-1,2016-17,Bethune-Cookman,G,32,25,994,157,413,.380,113,265,.426,44,148,.297,73,93,.785,35,113,148,54,27,2,50,67,431,7.6
1504,Kenneth Ortiz\kenneth-ortiz-2,2013-14,Wagner,G,31,31,997,137,333,.411,127,294,.432,10,39,.256,147,199,.739,35,104,139,130,57,6,91,72,431,10.3
1505,Parker Wentz\parker-wentz-1,2013-14,Abilene Christian,G,31,29,1040,136,277,.491,57,99,.576,79,178,.444,80,92,.870,5,64,69,86,50,1,60,70,431,10.7
1506,Victor Sanders\victor-sanders-1,2015-16,Idaho,G,27,25,772,122,295,.414,53,129,.411,69,166,.416,117,138,.848,19,79,98,51,33,16,54,78,430,10.9
1507,Jeremy Morgan\jeremy-morgan-1,2016-17,Northern Iowa,G,29,29,1009,136,339,.401,76,170,.447,60,169,.355,98,125,.784,14,155,169,79,51,33,63,61,430,11.5
1508,Phil Greene\phil-greene-1,2014-15,St. John's (NY),G,33,33,1150,164,385,.426,101,224,.451,63,161,.391,39,54,.722,16,90,106,53,30,1,36,31,430,8.4
1509,Corey Sanders\corey-sanders-2,2015-16,Rutgers,G,27,24,905,156,369,.423,115,239,.481,41,130,.315,77,108,.713,13,75,88,115,48,5,83,47,430,10.5
1510,Aaron Harrison\aaron-harrison-1,2014-15,Kentucky,G,39,38,1004,146,370,.395,87,183,.475,59,187,.316,79,101,.782,15,85,100,55,43,6,35,61,430,7.3
1511,Hunter Williams\hunter-williams-1,2013-14,Troy,G,31,31,1146,142,384,.370,44,134,.328,98,250,.392,48,73,.658,12,76,88,99,27,1,78,46,430,7.7
1512,Jordan Allen\jordan-allen-2,2017-18,Rider,G,32,30,909,142,371,.383,50,132,.379,92,239,.385,54,65,.831,26,87,113,22,26,12,43,57,430,7.8
1513,Jon Octeus\jonathan-octeus-1,2013-14,Colorado State,G,32,32,1075,130,320,.406,103,244,.422,27,76,.355,143,189,.757,33,117,150,73,28,5,39,85,430,9.6
1514,Matt Thomas\matt-thomas-2,2016-17,Iowa State,G,35,35,1083,146,306,.477,57,106,.538,89,200,.445,49,55,.891,22,115,137,58,32,4,40,50,430,9.6
1515,Michael Dison\michael-dison-1,2014-15,Montana State,G,30,29,869,150,366,.410,91,215,.423,59,151,.391,71,98,.724,42,79,121,40,31,1,63,62,430,8.3
1516,Devonte' Graham\devonte-graham-1,2015-16,Kansas,G,38,36,1238,144,313,.460,69,143,.483,75,170,.441,67,90,.744,13,114,127,140,55,5,64,81,430,9.5
1517,Javarez Willis\javarez-willis-1,2014-15,Ohio,G,29,28,963,152,363,.419,65,141,.461,87,222,.392,39,45,.867,7,84,91,93,25,0,81,47,430,8.8
1518,Brian Pegg\brian-pegg-1,2015-16,Stetson,G,34,33,975,185,321,.576,185,321,.576,0,0,,60,119,.504,114,218,332,37,31,35,79,109,430,10.6
1519,Evan Singletary\evan-singletary-1,2014-15,Albany (NY),G,33,33,1153,138,335,.412,77,183,.421,61,152,.401,93,115,.809,14,104,118,94,27,6,67,70,430,8.6
1520,Myles Mack\myles-mack-1,2014-15,Rutgers,G,32,32,1133,141,365,.386,81,180,.450,60,185,.324,88,104,.846,22,105,127,134,56,4,78,48,430,10.2
1521,Nat Dixon\nat-dixon-1,2017-18,Chattanooga,G,31,30,1130,140,320,.438,74,153,.484,66,167,.395,83,113,.735,37,106,143,59,31,10,63,54,429,9.7
1522,J.C. Show\jc-show-1,2017-18,Binghamton,G,31,30,1005,146,390,.374,70,164,.427,76,226,.336,61,70,.871,22,93,115,60,39,2,56,64,429,8.2
1523,Tra-Deon Hollins\tra-deon-hollins-1,2016-17,Omaha,G,32,30,1053,147,344,.427,109,222,.491,38,122,.311,97,123,.789,30,135,165,209,107,8,119,88,429,12.6
1524,Khyri Thomas\khyri-thomas-1,2016-17,Creighton,G,35,34,1093,162,324,.500,116,206,.563,46,118,.390,59,77,.766,53,149,202,116,51,15,69,55,429,11.2
1525,Terance Mann\terance-mann-1,2017-18,Florida State,G,34,31,994,171,301,.568,158,249,.635,13,52,.250,74,113,.655,65,120,185,87,31,9,60,57,429,10.8
1526,Riley LaChance\riley-lachance-1,2014-15,Vanderbilt,G,35,35,1166,147,337,.436,81,164,.494,66,173,.382,69,79,.873,10,100,110,102,25,1,47,46,429,9.0
1527,Justin Massey\justin-massey-1,2017-18,Florida Atlantic,G,31,15,791,130,362,.359,55,138,.399,75,224,.335,94,120,.783,14,54,68,45,15,0,34,57,429,7.5
1528,Adam Grant\adam-grant-1,2016-17,Bryant,G,32,30,1142,152,377,.403,93,202,.460,59,175,.337,66,85,.776,34,89,123,82,44,6,67,74,429,8.7
1529,Kyle Hittle\kyle-hittle-1,2014-15,Incarnate Word,G,28,28,1019,141,285,.495,81,140,.579,60,145,.414,86,117,.735,28,150,178,58,27,19,43,65,428,12.5
1530,Josh McFolley\josh-mcfolley-1,2016-17,Detroit Mercy,G,31,27,908,135,331,.408,64,137,.467,71,194,.366,87,107,.813,7,62,69,92,62,2,84,88,428,8.9
1531,Nigel Williams-Goss\nigel-williams-goss-1,2013-14,Washington,G,32,32,1063,168,362,.464,136,272,.500,32,90,.356,60,83,.723,27,114,141,140,36,5,92,75,428,9.4
1532,Brian Sullivan\brian-sullivan-1,2015-16,Davidson,G,30,30,1113,137,357,.384,37,113,.327,100,244,.410,54,65,.831,11,101,112,103,29,4,41,51,428,10.3
1533,Marcel Davis\marcel-davis-1,2015-16,Utah Valley,G,30,30,1001,146,329,.444,106,218,.486,40,111,.360,96,134,.716,27,140,167,153,33,5,82,65,428,11.2
1534,Troy Caupain\troy-caupain-1,2015-16,Cincinnati,G,33,33,1104,142,379,.375,87,209,.416,55,170,.324,89,113,.788,16,108,124,160,37,13,60,48,428,10.1
1535,Jason McManamen\jason-mcmanamen-1,2016-17,Wyoming,G,38,38,1207,129,364,.354,43,104,.413,86,260,.331,84,118,.712,14,99,113,91,23,1,47,92,428,6.7
1536,C.J. Jackson\cj-jackson-1,2017-18,Ohio State,G,34,31,1037,142,341,.416,78,172,.453,64,169,.379,80,101,.792,17,115,132,131,34,7,73,72,428,9.2
1537,Brendan Westendorf\brendan-westendorf-1,2016-17,Seattle,G,30,30,973,146,362,.403,85,174,.489,61,188,.324,75,90,.833,21,105,126,111,55,3,85,60,428,10.0
1538,Chris Thomas\chris-thomas-5,2014-15,Texas Southern,G,34,32,1055,156,343,.455,135,260,.519,21,83,.253,95,169,.562,65,103,168,56,40,19,86,81,428,8.0
1539,Charles Cooke\charles-cooke-1,2013-14,James Madison,G,30,28,1052,130,313,.415,102,219,.466,28,94,.298,140,195,.718,41,108,149,51,42,12,74,69,428,9.5
1540,Marcus Paige\marcus-paige-1,2015-16,North Carolina,G,34,34,1075,141,354,.398,67,146,.459,74,208,.356,72,93,.774,15,71,86,127,39,15,42,51,428,9.9
1541,Khalil Ahmad\khalil-ahmad-1,2015-16,Cal State Fullerton,G,30,20,818,139,324,.429,103,214,.481,36,110,.327,114,148,.770,23,109,132,48,24,6,55,67,428,9.1
1542,Michael Carey\michael-carey-1,2015-16,Wagner,G,34,25,991,151,300,.503,136,245,.555,15,55,.273,111,137,.810,109,202,311,52,25,27,56,85,428,11.6
1543,Juwan Staten\juwan-staten-1,2014-15,West Virginia,G,30,30,938,143,340,.421,122,282,.433,21,58,.362,120,171,.702,14,66,80,139,32,1,61,50,427,10.1
1544,Austin Price\austin-price-1,2016-17,Lehigh,G,32,31,1006,148,315,.470,74,136,.544,74,179,.413,57,76,.750,23,87,110,53,44,11,48,79,427,9.7
1545,David Crisp\david-crisp-1,2016-17,Washington,G,31,31,1021,151,367,.411,74,157,.471,77,210,.367,48,70,.686,25,73,98,97,17,4,76,73,427,7.9
1546,Duda Sanadze\duda-sanadze-1,2013-14,San Diego,G,33,25,879,139,343,.405,92,187,.492,47,156,.301,102,126,.810,26,95,121,29,21,8,68,81,427,6.9
1547,Tyrone Wallace\tyrone-wallace-1,2015-16,University of California,G,28,25,901,151,342,.442,126,258,.488,25,84,.298,100,154,.649,27,121,148,123,27,12,74,63,427,10.9
1548,Marcus Johnson Jr.\marcus-johnsonjr-1,2016-17,Little Rock,G,32,27,1103,137,359,.382,83,190,.437,54,169,.320,99,120,.825,14,89,103,91,29,0,66,47,427,8.3
1549,Derreck Brooks\derreck-brooks-1,2016-17,Central Arkansas,G,31,29,1011,156,371,.420,101,220,.459,55,151,.364,60,73,.822,48,175,223,94,24,31,70,81,427,10.3
1550,Demetrius McReynolds\demetrisu-mcreynolds-1,2016-17,Eastern Illinois,G,29,27,856,151,339,.445,94,182,.516,57,157,.363,68,83,.819,50,92,142,64,18,2,33,44,427,11.0
1551,Don Coleman\don-coleman-1,2017-18,University of California,G,30,21,943,127,387,.328,101,280,.361,26,107,.243,147,197,.746,32,56,88,57,42,1,60,68,427,7.4
1552,Jesse Reed\jesse-reed-1,2013-14,American,G,31,31,1095,150,298,.503,90,167,.539,60,131,.458,67,89,.753,15,122,137,52,36,16,57,80,427,10.0
1553,Ikenna Ndugba\ikenna-ndugba-1,2017-18,Bryant,G,31,29,1104,140,367,.381,89,214,.416,51,153,.333,96,129,.744,16,113,129,144,61,1,99,94,427,9.2
1554,Evan Singletary\evan-singletary-1,2015-16,Albany (NY),G,33,31,1098,139,340,.409,89,195,.456,50,145,.345,99,132,.750,16,103,119,97,39,7,72,77,427,8.6
1555,Kenny Chery\kenny-chery-1,2013-14,Baylor,G,37,34,1068,143,338,.423,104,218,.477,39,120,.325,102,116,.879,13,84,97,174,34,2,76,63,427,9.0
1556,Miles Reynolds\miles-reynolds-1,2017-18,Pacific,G,32,20,1003,123,298,.413,100,237,.422,23,61,.377,158,197,.802,11,72,83,89,33,2,62,78,427,8.9
1557,Steve McWhorter\steve-mcwhorter-1,2014-15,Milwaukee,G,30,30,1051,147,324,.454,107,206,.519,40,118,.339,92,123,.748,32,110,142,137,49,14,68,91,426,11.7
1558,Fred Sims Jr.\fred-simsjr-1,2017-18,Chicago State,G,30,29,922,146,453,.322,85,262,.324,61,191,.319,73,84,.869,24,88,112,34,23,2,44,43,426,6.4
1559,Marcus Jackson\marcus-jackson-6,2016-17,Rice,G,35,34,1049,138,317,.435,67,124,.540,71,193,.368,79,98,.806,14,72,86,82,32,5,61,44,426,8.5
1560,Andre Walker\andre-walker-3,2015-16,Loyola (MD),G,30,30,972,129,346,.373,83,227,.366,46,119,.387,122,152,.803,17,85,102,117,45,6,77,87,426,9.3
1561,Anthony McDonald\anthony-mcdonald-1,2014-15,North Carolina Central,G,33,33,1064,134,330,.406,29,53,.547,105,277,.379,53,68,.779,15,47,62,24,21,0,33,62,426,7.5
1562,Kris Yanku\kris-yanku-1,2015-16,Northern Arizona,G,29,22,909,119,337,.353,95,266,.357,24,71,.338,164,200,.820,23,135,158,139,51,3,95,75,426,10.5
1563,Mike Cunningham\mike-cunningham-2,2017-18,South Carolina Upstate,G,31,27,1039,149,387,.385,63,162,.389,86,225,.382,42,57,.737,21,66,87,93,26,3,43,51,426,8.8
1564,Jalen Jones\jalen-jones-1,2014-15,Texas A&M,G,31,31,892,148,329,.450,136,289,.471,12,40,.300,118,162,.728,59,147,206,25,30,17,45,79,426,9.9
1565,Brian Sullivan\brian-sullivan-1,2013-14,Davidson,G,33,30,1025,143,360,.397,53,123,.431,90,237,.380,50,60,.833,16,61,77,70,26,0,42,64,426,8.0
1566,Byron Ashe\byron-ashe-1,2017-18,Longwood,G,33,33,1130,153,426,.359,102,249,.410,51,177,.288,69,92,.750,31,137,168,77,43,9,96,62,426,6.8
1567,Eric Fanning\eric-fanning-1,2015-16,Boston University,G,28,19,737,132,266,.496,107,194,.552,25,72,.347,137,176,.778,35,115,150,44,15,12,76,73,426,10.2
1568,Maverick Rowan\maverick-rowan-1,2015-16,North Carolina State,G,33,31,1102,140,389,.360,59,148,.399,81,241,.336,65,85,.765,29,73,102,23,15,2,49,73,426,6.0
1569,Christian Thomas\christian-thomas-1,2013-14,Loyola (IL),G,32,32,1055,160,299,.535,144,257,.560,16,42,.381,89,139,.640,72,126,198,33,19,2,43,88,425,9.8
1570,Mike Rodriguez\mike-rodriguez-1,2016-17,Southern Illinois,G,33,33,1077,124,312,.397,97,224,.433,27,88,.307,150,201,.746,10,65,75,132,45,6,70,71,425,9.3
1571,Admon Gilder\admon-gilder-1,2016-17,Texas A&M,G,31,29,1073,146,340,.429,88,186,.473,58,154,.377,75,101,.743,32,88,120,120,60,9,83,69,425,10.4
1572,Wesley Saunders\wesley-saunders-1,2013-14,Harvard,G,30,29,1011,140,302,.464,130,268,.485,10,34,.294,135,177,.763,31,106,137,115,52,21,69,70,425,11.9
1573,Aaron Valdes\aaron-valdes-1,2015-16,Hawaii,G,30,29,921,147,312,.471,104,179,.581,43,133,.323,88,129,.682,44,121,165,72,35,18,44,63,425,11.5
1574,De'Riante Jenkins\deriante-jenkins-1,2017-18,Virginia Commonwealth,G,33,33,973,149,344,.433,70,155,.452,79,189,.418,48,64,.750,26,97,123,83,44,7,81,64,425,8.6
1575,Dylan Ennis\dylan-ennis-1,2016-17,Oregon,G,39,39,1237,144,336,.429,91,188,.484,53,148,.358,84,114,.737,28,144,172,119,43,17,71,65,425,8.7
1576,Rene Castro\rene-castro-1,2017-18,Duquesne,G,32,32,1022,153,337,.454,105,194,.541,48,143,.336,71,93,.763,21,69,90,108,28,3,56,59,425,9.5
1577,Anthony Barber\anthony-cat-barber-1,2014-15,North Carolina State,G,35,33,1108,144,328,.439,117,257,.455,27,71,.380,110,150,.733,30,86,116,130,28,0,73,68,425,8.6
1578,Freddie Jackson\freddie-jackson-1,2014-15,North Carolina-Wilmington,G,32,30,1161,160,367,.436,118,239,.494,42,128,.328,63,99,.636,47,131,178,66,51,13,66,49,425,9.7
1579,Chris Fowler\chris-fowler-1,2015-16,Central Michigan,G,26,26,944,142,310,.458,120,240,.500,22,70,.314,119,149,.799,16,87,103,153,33,4,68,77,425,12.9
1580,Anthony Holliday\anthony-holliday-1,2014-15,Lamar,G,29,28,828,135,278,.486,108,203,.532,27,75,.360,128,164,.780,12,43,55,100,31,6,82,65,425,9.9
1581,Luke Kennard\luke-kennard-1,2015-16,Duke,G,36,11,961,141,336,.420,86,163,.528,55,173,.318,88,99,.889,35,94,129,55,34,6,28,69,425,8.8
1582,Charles Cooper\charles-cooper-1,2016-17,Green Bay,G,31,12,814,138,328,.421,131,282,.465,7,46,.152,142,215,.660,38,122,160,54,36,9,72,62,425,8.6
1583,Angelo Warner\angelo-warner-1,2014-15,Morehead State,G,32,18,913,146,301,.485,93,168,.554,53,133,.398,79,102,.775,28,100,128,78,51,3,64,72,424,10.2
1584,Corey Henson\corey-henson-1,2016-17,Wagner,G,29,27,983,143,344,.416,78,160,.488,65,184,.353,73,89,.820,10,66,76,79,19,3,66,58,424,8.6
1585,Alex Anderson\alex-anderson-1,2014-15,Tennessee-Martin,G,34,33,1187,141,292,.483,47,96,.490,94,196,.480,48,54,.889,11,69,80,66,14,0,43,35,424,9.0
1586,Isaiah Blackmon\isaiah-blackmon-1,2016-17,Saint Francis (PA),G,31,21,845,151,316,.478,90,194,.464,61,122,.500,61,83,.735,35,101,136,43,32,3,47,67,424,9.7
1587,Stephen Thompson Jr.\stephen-thompsonjr-1,2016-17,Oregon State,G,26,26,940,148,373,.397,91,206,.442,57,167,.341,71,112,.634,30,81,111,79,37,4,73,58,424,9.6
1588,Brandon Boggs\brandon-boggs-1,2013-14,Western Carolina,G,34,31,912,160,352,.455,122,239,.510,38,113,.336,66,109,.606,41,89,130,40,34,26,57,73,424,8.1
1589,Nimrod Hilliard\nimrod-hilliard-1,2013-14,Lamar,G,30,29,1047,146,339,.431,103,216,.477,43,123,.350,89,119,.748,15,100,115,146,38,8,80,63,424,10.5
1590,Devin Sibley\devin-sibley-1,2015-16,Furman,G,35,23,960,145,322,.450,101,188,.537,44,134,.328,90,133,.677,23,77,100,58,19,6,79,85,424,6.6
1591,Jason Dunne\jason-dunne-1,2016-17,Hartford,G,31,26,1009,141,349,.404,68,149,.456,73,200,.365,69,88,.784,19,102,121,61,39,10,74,86,424,8.2
1592,Deon Jones\deon-jones-2,2014-15,Monmouth,G,33,33,931,139,301,.462,123,247,.498,16,54,.296,129,159,.811,49,110,159,41,29,15,54,74,423,9.3
1593,Geno Thorpe\geno-thorpe-1,2016-17,South Florida,G,28,26,925,140,355,.394,101,251,.402,39,104,.375,104,123,.846,21,61,82,129,44,2,84,75,423,9.9
1594,Quentin Snider\quentin-snider-1,2017-18,Louisville,G,36,36,1155,135,340,.397,66,174,.379,69,166,.416,84,97,.866,15,82,97,144,18,0,55,38,423,8.8
1595,Carlik Jones\carlik-jones-1,2017-18,Radford,G,36,26,1094,144,349,.413,108,231,.468,36,118,.305,99,129,.767,21,121,142,113,40,8,61,57,423,8.8
1596,Jalen Bradley\jalen-bradley-1,2016-17,Oral Roberts,G,30,29,1051,151,356,.424,106,232,.457,45,124,.363,76,90,.844,15,88,103,115,39,1,51,43,423,10.6
1597,Dez Wells\dezmine-wells-1,2014-15,Maryland,G,28,27,853,147,317,.464,122,268,.455,25,49,.510,104,129,.806,36,112,148,77,29,12,92,64,423,10.1
1598,Isaiah Williams\isaiah-williams-1,2015-16,Iona,G,33,33,1080,151,349,.433,66,107,.617,85,242,.351,36,52,.692,69,159,228,63,27,17,45,92,423,10.0
1599,Akeem Springs\akeem-springs-1,2015-16,Milwaukee,G,32,32,1022,154,314,.490,115,203,.567,39,111,.351,76,107,.710,34,137,171,54,27,2,46,65,423,9.7
1600,Micah Seaborn\micah-seaborn-1,2016-17,Monmouth,G,32,29,896,141,379,.372,77,185,.416,64,194,.330,77,93,.828,12,72,84,72,31,7,56,63,423,7.6
1601,Josh Cameron\josh-cameron-1,2014-15,Coastal Carolina,G,33,7,719,137,323,.424,73,151,.483,64,172,.372,85,113,.752,14,51,65,50,35,2,48,37,423,8.3
1602,R.J. Price\rj-price-1,2014-15,Radford,G,34,34,985,140,382,.366,60,141,.426,80,241,.332,63,92,.685,15,74,89,75,42,4,45,36,423,8.0
1603,Javier Duren\javier-duren-1,2013-14,Yale,G,31,31,932,115,309,.372,72,185,.389,43,124,.347,150,183,.820,29,91,120,96,46,5,84,92,423,9.1
1604,Marques Townes\marques-townes-1,2017-18,Loyola (IL),G,38,38,1067,160,311,.514,131,236,.555,29,75,.387,74,99,.747,22,129,151,92,36,7,77,56,423,8.4
1605,Corey Sanders\corey-sanders-2,2016-17,Rutgers,G,33,31,1003,163,427,.382,142,348,.408,21,79,.266,76,124,.613,17,90,107,107,44,16,90,63,423,6.8
1606,Alpha Diallo\alpha-diallo-1,2017-18,Providence,G,32,31,983,160,343,.466,145,273,.531,15,70,.214,88,120,.733,69,142,211,73,32,9,60,94,423,9.9
1607,Louis Dabney\louis-dabney-1,2014-15,Tulane,G,31,30,993,135,356,.379,74,192,.385,61,164,.372,92,118,.780,20,81,101,46,35,1,50,64,423,8.0
1608,Tre Burnette\tre-burnette-1,2015-16,South Dakota,G,32,23,752,172,389,.442,131,260,.504,41,129,.318,38,74,.514,47,164,211,48,25,32,51,90,423,8.8
1609,Harold McBride\harold-mcbride-1,2015-16,Gardner-Webb,G,33,33,954,135,360,.375,73,191,.382,62,169,.367,90,108,.833,20,76,96,133,47,3,72,57,422,9.1
1610,Stevie Browning\stevie-browning-1,2015-16,Marshall,G,33,32,1076,165,361,.457,119,225,.529,46,136,.338,46,62,.742,40,108,148,118,35,12,82,69,422,9.3
1611,Norman Powell\norman-powell-1,2013-14,UCLA,G,37,37,952,153,287,.533,133,219,.607,20,68,.294,96,123,.780,24,81,105,63,51,14,38,85,422,9.3
1612,Caleb White\caleb-white-1,2013-14,East Carolina,G,34,30,1080,147,301,.488,100,176,.568,47,125,.376,81,114,.711,30,81,111,48,14,7,49,102,422,7.8
1613,Que Johnson\que-johnson-1,2016-17,Western Kentucky,G,32,32,1031,139,355,.392,74,167,.443,65,188,.346,79,107,.738,20,132,152,55,27,11,58,65,422,8.1
1614,Bryce Dejean-Jones\bryce-jones-1,2013-14,Nevada-Las Vegas,G,31,26,848,146,342,.427,115,246,.467,31,96,.323,99,154,.643,28,86,114,92,22,9,52,64,422,9.0
1615,Kenny Williams\kenny-williams-3,2017-18,North Carolina,G,37,36,1149,156,321,.486,84,142,.592,72,179,.402,38,54,.704,39,97,136,88,38,18,40,69,422,9.6
1616,Garret Covington\garret-covington-1,2013-14,Western Illinois,G,29,27,954,130,315,.413,60,134,.448,70,181,.387,92,115,.800,23,114,137,54,28,3,55,41,422,10.0
1617,Marvin Smith\marvin-smith-2,2017-18,North Carolina-Greensboro,G,35,35,938,131,356,.368,56,123,.455,75,233,.322,84,111,.757,56,134,190,29,28,14,42,86,421,7.8
1618,Sterling Gibbs\sterling-gibbs-1,2013-14,Seton Hall,G,32,21,971,111,271,.410,80,181,.442,31,90,.344,168,232,.724,13,79,92,135,33,1,68,68,421,9.9
1619,Kalin Fisher\kalin-fisher-1,2017-18,Hampton,G,33,23,1007,159,360,.442,120,243,.494,39,117,.333,64,77,.831,23,132,155,70,20,4,53,57,421,8.5
1620,Geovonie McKnight\geovonie-mcknight-1,2015-16,Miami (OH),G,32,32,1029,156,364,.429,150,341,.440,6,23,.261,103,137,.752,39,88,127,72,34,7,77,72,421,7.9
1621,Jarekious Bradley\jarekious-bradley-1,2014-15,Southeast Missouri State,G,26,18,768,146,343,.426,100,202,.495,46,141,.326,83,94,.883,43,101,144,35,26,18,50,63,421,10.9
1622,Elijah Stewart\elijah-stewart-1,2017-18,Southern California,G,36,34,1066,143,316,.453,73,137,.533,70,179,.391,65,77,.844,32,77,109,45,24,21,30,69,421,8.6
1623,Robert Champion\robert-champion-1,2015-16,Holy Cross,G,35,13,964,145,327,.443,87,166,.524,58,161,.360,73,107,.682,24,144,168,52,36,6,57,93,421,8.0
1624,Kevin Hardy\kevin-hardy-1,2014-15,McNeese State,G,31,31,1154,171,356,.480,162,330,.491,9,26,.346,69,125,.552,79,129,208,125,85,32,53,77,420,13.6
1625,Ryan Richardson\ryan-richardson-1,2017-18,Weber State,G,31,31,1010,145,316,.459,54,103,.524,91,213,.427,39,52,.750,7,93,100,66,33,11,46,69,420,9.6
1626,Antwon Portley\antwon-portley-1,2015-16,Saint Peter's,G,30,30,1011,131,347,.378,64,150,.427,67,197,.340,91,109,.835,8,89,97,56,19,3,55,46,420,8.1
1627,Chris Thomas\chris-thomas-5,2013-14,Marshall,G,33,26,833,155,341,.455,132,256,.516,23,85,.271,87,146,.596,52,80,132,58,38,15,81,85,420,7.7
1628,Deandre Burnett\deandre-burnett-1,2017-18,Mississippi,G,31,18,877,116,308,.377,61,155,.394,55,153,.359,133,166,.801,10,53,63,121,19,0,66,31,420,9.2
1629,Perrin Buford\perrin-buford-1,2015-16,Middle Tennessee,G,35,30,1016,164,324,.506,148,286,.517,16,38,.421,76,111,.685,63,143,206,69,25,40,67,90,420,9.4
1630,Mike Scott\mike-scott-7,2014-15,Idaho,G,30,29,901,147,333,.441,94,191,.492,53,142,.373,73,95,.768,11,86,97,160,38,6,48,59,420,11.8
1631,Alex Harris\alex-harris-2,2013-14,Cal State Fullerton,G,27,26,894,126,322,.391,72,161,.447,54,161,.335,114,172,.663,20,69,89,66,34,2,55,57,420,9.6
1632,D.J. Irving\dj-irving-1,2013-14,Boston University,G,34,32,1057,133,335,.397,74,182,.407,59,153,.386,95,121,.785,18,98,116,78,42,3,68,71,420,8.0
1633,Olin Carter III\olin-carteriii-1,2017-18,San Diego,G,34,34,1184,142,364,.390,55,120,.458,87,244,.357,49,62,.790,9,94,103,56,33,19,38,84,420,7.8
1634,A.J. Jacobson\aj-jacobson-1,2015-16,North Dakota State,G,33,32,1133,138,316,.437,86,166,.518,52,150,.347,92,118,.780,17,113,130,49,18,14,41,87,420,8.4
1635,Matt Donlan\matt-donlan-1,2015-16,Youngstown State,G,32,32,1109,148,320,.463,66,143,.462,82,177,.463,42,50,.840,12,132,144,42,17,7,47,59,420,8.8
1636,Isaiah Walton\isaiah-walton-1,2017-18,Longwood,G,27,22,785,140,327,.428,84,178,.472,56,149,.376,84,100,.840,7,65,72,59,32,7,84,61,420,8.7
1637,Fuquan Edwin\edwin-fuquan-1,2013-14,Seton Hall,G,29,26,872,159,362,.439,114,227,.502,45,135,.333,57,73,.781,26,75,101,48,77,6,53,81,420,10.1
1638,Alex Anderson\alex-anderson-1,2015-16,Tennessee-Martin,G,35,33,1131,131,350,.374,37,89,.416,94,261,.360,64,74,.865,10,82,92,74,15,0,42,29,420,7.7
1639,Adam Grant\adam-grant-1,2017-18,Bryant,G,27,26,997,148,393,.377,83,203,.409,65,190,.342,59,84,.702,23,65,88,68,28,1,67,59,420,8.0
1640,Devin Martin\devin-martin-1,2014-15,Maryland-Eastern Shore,G,30,28,896,136,322,.422,77,174,.443,59,148,.399,89,111,.802,46,84,130,42,28,7,64,69,420,8.9
1641,Reed Tellinghuisen\reed-tellinghuisen-1,2017-18,South Dakota State,G,35,35,1079,141,302,.467,77,141,.546,64,161,.398,73,100,.730,31,137,168,54,18,21,26,77,419,9.4
1642,Jimond Ivey\jimond-ivey-1,2017-18,Akron,G,32,32,1059,142,355,.400,81,175,.463,61,180,.339,74,97,.763,39,144,183,113,35,13,76,86,419,9.4
1643,Rashad Madden\rashad-madden-1,2013-14,Arkansas,G,33,27,866,125,275,.455,75,150,.500,50,125,.400,119,145,.821,28,66,94,91,28,9,77,80,419,8.9
1644,C.J. Carter\cj-carter-1,2013-14,Omaha,G,31,30,946,139,329,.422,91,187,.487,48,142,.338,93,119,.782,21,59,80,105,39,7,65,45,419,9.7
1645,Desmond Washington\desmond-washington-1,2013-14,Saint Peter's,G,31,31,1019,130,345,.377,71,168,.423,59,177,.333,100,118,.847,6,90,96,31,36,2,56,58,419,7.5
1646,Dequon Miller\dequon-miller-1,2016-17,Missouri State,G,33,32,1174,138,351,.393,83,191,.435,55,160,.344,88,119,.739,21,77,98,124,36,0,73,50,419,8.6
1647,Donte Ingram\donte-ingram-1,2017-18,Loyola (IL),G,38,38,1161,147,332,.443,73,143,.510,74,189,.392,51,75,.680,20,223,243,59,34,14,55,60,419,8.5
1648,Christian Terrell\christian-terrell-1,2017-18,Florida Gulf Coast,G,35,22,1026,155,298,.520,100,164,.610,55,134,.410,54,66,.818,32,141,173,103,28,10,78,48,419,9.8
1649,Corey Allen\corey-allen-2,2017-18,Detroit Mercy,G,29,18,815,140,324,.432,80,167,.479,60,157,.382,79,100,.790,13,79,92,64,20,1,68,53,419,8.6
1650,Devin Mitchell\devin-mitchell-1,2017-18,Georgia State,G,35,35,993,144,323,.446,46,104,.442,98,219,.447,33,50,.660,10,76,86,65,24,6,49,85,419,7.5
1651,Matt Carlino\matt-carlino-1,2014-15,Marquette,G,28,27,924,129,320,.403,46,122,.377,83,198,.419,78,95,.821,16,88,104,88,40,2,64,55,419,10.5
1652,Isaiah Walton\isaiah-walton-1,2016-17,Longwood,G,30,26,944,148,312,.474,116,224,.518,32,88,.364,91,114,.798,18,100,118,95,53,11,130,85,419,8.5
1653,Treshawn Hagood\treshawn-hagood-1,2014-15,Prairie View,G,33,33,1154,157,386,.407,143,326,.439,14,60,.233,90,151,.596,47,123,170,160,78,3,112,72,418,9.3
1654,Frank Booker\frank-booker-1,2017-18,South Carolina,G,33,18,892,126,291,.433,41,83,.494,85,208,.409,81,105,.771,21,96,117,39,37,8,36,63,418,9.3
1655,Justin Edwards\justin-edwards-2,2015-16,Kansas State,G,33,29,1042,145,328,.442,107,211,.507,38,117,.325,90,130,.692,81,115,196,92,58,16,72,72,418,10.7
1656,Giddy Potts\giddy-potts-1,2015-16,Middle Tennessee,G,29,27,812,139,282,.493,60,126,.476,79,156,.506,61,80,.763,26,124,150,36,30,10,31,84,418,11.1
1657,Harald Frey\harald-frey-1,2017-18,Montana State,G,32,31,1035,133,311,.428,69,140,.493,64,171,.374,88,116,.759,11,89,100,103,26,1,55,54,418,9.3
1658,KeVaughn Allen\kevaughn-allen-1,2015-16,Florida,G,36,34,978,134,336,.399,83,174,.477,51,162,.315,99,117,.846,18,79,97,57,41,5,35,56,418,8.1
1659,Fred VanVleet\fred-van-vleet-1,2013-14,Wichita State,G,36,36,1141,134,277,.484,96,186,.516,38,91,.418,112,135,.830,26,113,139,193,69,4,48,68,418,12.6
1660,Brett Olson\brett-olson-2,2014-15,Denver,G,30,30,1061,139,288,.483,72,128,.563,67,160,.419,73,87,.839,12,89,101,90,24,4,52,83,418,10.2
1661,Zhaire Smith\zhaire-smith-1,2017-18,Texas Tech,G,37,21,1050,154,277,.556,136,237,.574,18,40,.450,91,127,.717,83,102,185,66,42,42,41,67,417,11.0
1662,Austin Price\austin-price-1,2015-16,Lehigh,G,32,32,1056,144,348,.414,75,169,.444,69,179,.385,60,85,.706,26,83,109,75,55,16,53,85,417,9.2
1663,Brian Bernardi\brian-bernardi-1,2015-16,Hofstra,G,34,34,1225,136,340,.400,49,116,.422,87,224,.388,58,67,.866,5,55,60,51,25,3,46,51,417,7.2
1664,Robert Gray Jr.\robert-grayjr-1,2015-16,Houston,G,26,9,690,150,345,.435,102,205,.498,48,140,.343,69,98,.704,11,46,57,38,30,5,36,54,417,9.5
1665,Brandon Brown\brandon-brown-4,2016-17,Loyola Marymount,G,30,30,930,140,346,.405,86,214,.402,54,132,.409,83,113,.735,30,65,95,122,41,0,70,51,417,9.8
1666,Deron Powers\deron-powers-1,2016-17,Hofstra,G,32,31,1062,130,311,.418,88,188,.468,42,123,.341,115,147,.782,11,64,75,166,20,0,84,72,417,9.0
1667,Chace Franklin\chace-franklin-1,2015-16,Jackson State,G,34,27,1022,137,376,.364,85,221,.385,52,155,.335,91,131,.695,37,141,178,90,46,13,69,78,417,8.2
1668,Takal Molson\takal-molson-1,2017-18,Canisius,G,33,32,966,137,310,.442,92,188,.489,45,122,.369,98,143,.685,60,104,164,86,39,14,70,87,417,9.5
1669,Eric Washington\eric-washington-3,2015-16,Miami (OH),G,30,30,995,125,285,.439,86,181,.475,39,104,.375,127,159,.799,16,94,110,138,47,0,82,53,416,11.1
1670,Wayne Blackshear\wayne-blackshear-1,2014-15,Louisville,G,36,36,1129,132,334,.395,72,153,.471,60,181,.331,92,118,.780,34,120,154,42,37,21,37,93,416,8.1
1671,Brian Darden\brian-darden-1,2015-16,Hampton,G,32,32,1012,127,369,.344,46,124,.371,81,245,.331,81,96,.844,8,58,66,59,25,1,54,75,416,6.5
1672,Seth Allen\seth-allen-1,2016-17,Virginia Tech,G,32,5,925,147,272,.540,95,155,.613,52,117,.444,70,96,.729,8,66,74,106,24,5,88,61,416,9.0
1673,Gary Payton\gary-payton-2,2014-15,Oregon State,G,31,30,1125,162,334,.485,135,242,.558,27,92,.293,65,98,.663,64,167,231,98,95,37,59,84,416,13.7
1674,George Marshall\george-marshall-1,2015-16,South Dakota State,G,28,27,956,136,338,.402,72,167,.431,64,171,.374,80,104,.769,2,94,96,77,22,2,37,59,416,9.7
1675,Jordan Ratinho\jordan-ratinho-1,2017-18,San Francisco,G,39,37,1206,142,322,.441,56,115,.487,86,207,.415,46,75,.613,32,98,130,47,28,15,32,82,416,7.5
1676,Charlie Moore\charlie-moore-1,2016-17,University of California,G,34,34,980,136,349,.390,91,221,.412,45,128,.352,99,131,.756,12,55,67,119,37,0,99,87,416,6.6
1677,Jared Wilson-Frame\jared-wilson-frame-1,2017-18,Pittsburgh,G,32,23,897,142,379,.375,68,148,.459,74,231,.320,58,70,.829,24,88,112,50,16,4,71,64,416,6.3
1678,Fred Miller\fred-miller-1,2014-15,South Carolina Upstate,G,34,33,1084,150,364,.412,104,221,.471,46,143,.322,70,90,.778,17,153,170,143,62,7,97,77,416,9.1
1679,Donte Clark\donte-clark-1,2016-17,Massachusetts,G,33,26,946,131,323,.406,91,190,.479,40,133,.301,114,150,.760,19,106,125,96,29,14,83,92,416,7.9
1680,Antonio Blakeney\antonio-blakeney-1,2015-16,Louisiana State,G,33,24,1016,137,322,.425,85,167,.509,52,155,.335,89,119,.748,26,88,114,31,22,5,25,48,415,8.5
1681,Willie Conner\willie-conner-1,2016-17,Buffalo,G,32,28,997,126,308,.409,59,127,.465,67,181,.370,96,127,.756,26,63,89,35,15,10,56,79,415,7.3
1682,Kimbal MacKenzie\kimbal-mackenzie-1,2016-17,Bucknell,G,35,33,1051,136,293,.464,72,137,.526,64,156,.410,79,95,.832,13,65,78,83,40,2,55,80,415,8.5
1683,Malik Morgan\malik-morgan-1,2015-16,Tulane,G,34,33,1075,154,365,.422,91,185,.492,63,180,.350,44,69,.638,37,137,174,80,47,14,84,82,415,8.1
1684,Montell Goodwin\montell-goodwin-1,2016-17,Eastern Illinois,G,29,25,898,143,380,.376,75,206,.364,68,174,.391,61,83,.735,12,71,83,91,34,7,64,46,415,8.5
1685,Kevin McKay\kevin-mckay-1,2017-18,Central Michigan,G,34,0,923,154,278,.554,140,241,.581,14,37,.378,93,108,.861,98,123,221,63,62,20,65,84,415,11.9
1686,Jordan Mathews\jordan-mathews-1,2016-17,Gonzaga,G,39,39,1090,132,326,.405,47,109,.431,85,217,.392,66,90,.733,26,102,128,57,34,5,32,53,415,7.8
1687,Jarrett Culver\jarrett-culver-1,2017-18,Texas Tech,G,37,20,978,145,319,.455,90,175,.514,55,144,.382,70,108,.648,39,138,177,67,41,27,57,77,415,8.7
1688,Kevin McClain\kevin-mcclain-1,2017-18,Belmont,G,33,32,1068,145,318,.456,88,157,.561,57,161,.354,68,95,.716,25,99,124,70,34,7,53,54,415,9.1
1689,Michael Carey\michael-carey-1,2016-17,Wagner,G,30,30,1024,167,353,.473,151,305,.495,16,48,.333,65,84,.774,94,177,271,51,20,6,67,72,415,10.3
1690,Matt Bohannon\matt-bohannon-1,2015-16,Northern Iowa,G,36,36,1265,135,305,.443,42,74,.568,93,231,.403,52,64,.813,1,148,149,33,28,3,25,69,415,8.2
1691,Kenny Gaines\kenny-gaines-1,2013-14,Georgia,G,32,31,907,139,313,.444,82,161,.509,57,152,.375,80,103,.777,22,57,79,31,22,23,40,76,415,8.3
1692,Spencer Butterfield\spencer-butterfield-1,2013-14,Utah State,G,32,32,977,141,304,.464,72,154,.468,69,150,.460,63,76,.829,54,144,198,81,19,10,56,77,414,10.3
1693,Sandro Carissimo\sandro-carissimo-1,2013-14,Vermont,G,33,33,1056,138,332,.416,84,206,.408,54,126,.429,84,105,.800,18,92,110,69,36,16,43,72,414,8.9
1694,Darin Johnson\darin-johnson-1,2016-17,Cal State Northridge,G,30,27,910,124,268,.463,92,181,.508,32,87,.368,134,165,.812,28,82,110,52,28,4,44,59,414,10.2
1695,Zach Lewis\zach-lewis-1,2014-15,Canisius,G,33,33,1062,135,404,.334,60,166,.361,75,238,.315,69,94,.734,17,82,99,83,52,7,62,71,414,7.2
1696,Anthony Drmic\anthony-drmic-1,2015-16,Boise State,G,31,24,906,134,308,.435,73,128,.570,61,180,.339,85,120,.708,30,106,136,44,28,0,49,93,414,8.5
1697,E.J. Crawford\ej-crawford-1,2017-18,Iona,G,33,29,884,146,317,.461,96,169,.568,50,148,.338,72,90,.800,17,96,113,36,19,9,32,59,414,8.5
1698,Tevon Saddler\tevon-saddler-1,2014-15,North Carolina-Greensboro,G,31,31,947,152,354,.429,140,300,.467,12,54,.222,98,148,.662,38,104,142,123,46,17,111,111,414,8.2
1699,Brock Stull\brock-stull-1,2017-18,Milwaukee,G,31,31,1114,139,367,.379,67,177,.379,72,190,.379,64,86,.744,17,133,150,97,20,3,68,47,414,8.4
1700,Julian Eleby\julian-eleby-1,2015-16,Virginia Military Institute,G,30,28,1002,132,306,.431,69,147,.469,63,159,.396,87,107,.813,17,121,138,78,32,6,77,48,414,9.6
1701,Jarron Cumberland\jarron-cumberland-1,2017-18,Cincinnati,G,36,36,1040,138,337,.409,78,160,.488,60,177,.339,78,115,.678,45,98,143,103,37,13,64,76,414,8.4
1702,Spencer Collins\spencer-collins-1,2013-14,Wofford,G,33,33,994,141,324,.435,114,232,.491,27,92,.293,105,136,.772,23,78,101,43,20,7,45,69,414,7.7
1703,Jordan Johnson\jordan-johnson-1,2015-16,Milwaukee,G,33,33,1161,116,268,.433,90,187,.481,26,81,.321,156,198,.788,19,99,118,267,30,1,91,64,414,12.1
1704,Armel Potter\armel-potter-1,2015-16,Charleston Southern,G,30,25,901,146,372,.392,99,237,.418,47,135,.348,75,109,.688,17,79,96,94,26,3,60,51,414,8.3
1705,Taishaun Johnson\taishaun-johnson-1,2014-15,South Alabama,G,33,25,1035,118,316,.373,78,179,.436,40,137,.292,138,177,.780,36,100,136,71,32,7,102,90,414,6.9
1706,Junior Robinson\lamont-robinson-1,2015-16,Mount St. Mary's,G,33,32,952,135,351,.385,85,205,.415,50,146,.342,94,112,.839,13,47,60,102,38,0,83,77,414,7.1
1707,George King\george-king-1,2017-18,Colorado,G,32,31,913,142,319,.445,80,162,.494,62,157,.395,68,87,.782,56,195,251,35,17,21,64,78,414,9.3
1708,Tanner Samson\tanner-samson-1,2014-15,Elon,G,33,33,979,121,346,.350,18,60,.300,103,286,.360,69,82,.841,10,129,139,44,43,8,44,84,414,8.0
1709,Ryan Jones\ryan-jones-4,2016-17,Massachusetts-Lowell,G,31,29,1051,147,309,.476,91,174,.523,56,135,.415,64,85,.753,26,91,117,93,22,6,92,71,414,8.5
1710,Trevor Cooney\trevor-cooney-1,2014-15,Syracuse,G,31,31,1156,135,376,.359,64,146,.438,71,230,.309,73,95,.768,17,71,88,68,56,1,46,48,414,8.7
1711,Kalob Ledoux\kalob-ledoux-1,2017-18,McNeese State,G,28,27,832,151,357,.423,90,190,.474,61,167,.365,51,63,.810,20,102,122,29,13,4,65,66,414,7.5
1712,Mandell Thomas\mandell-thomas-1,2014-15,Fordham,G,31,28,1065,140,346,.405,104,244,.426,36,102,.353,97,130,.746,38,86,124,112,73,13,67,83,413,10.5
1713,Tevonn Walker\tevonn-walker-1,2017-18,Valparaiso,G,28,27,864,134,346,.387,95,209,.455,39,137,.285,106,136,.779,32,103,135,48,48,2,48,67,413,9.8
1714,Willie Conner\willie-conner-1,2015-16,Buffalo,G,35,34,1014,133,291,.457,85,151,.563,48,140,.343,99,135,.733,25,56,81,40,30,11,48,77,413,7.7
1715,Jahad Thomas\jahad-thomas-1,2015-16,Massachusetts-Lowell,G,29,29,863,177,302,.586,176,298,.591,1,4,.250,58,115,.504,54,160,214,100,37,6,109,89,413,10.4
1716,Desmond Bane\desmond-bane-1,2017-18,Texas Christian,G,33,32,1005,145,269,.539,86,141,.610,59,128,.461,64,82,.780,15,119,134,82,31,8,58,76,413,9.9
1717,Peter Kiss\peter-kiss-1,2016-17,Quinnipiac,G,31,20,925,154,377,.408,118,247,.478,36,130,.277,69,93,.742,37,138,175,88,38,6,90,56,413,8.4
1718,Bryant Crawford\bryant-crawford-1,2015-16,Wake Forest,G,30,30,952,138,350,.394,82,189,.434,56,161,.348,81,121,.669,15,76,91,133,52,7,106,91,413,8.3
1719,B.J. Tyson\bj-tyson-1,2014-15,East Carolina,G,33,0,798,143,312,.458,124,249,.498,19,63,.302,108,150,.720,45,84,129,46,26,3,51,55,413,8.5
1720,Keyshawn Woods\keyshawn-woods-1,2016-17,Wake Forest,G,33,22,1007,151,305,.495,102,193,.528,49,112,.438,62,82,.756,23,116,139,116,18,0,57,87,413,9.4
1721,Jordan Gregory\jordan-gregory-1,2013-14,Montana,G,30,29,1030,127,287,.443,65,119,.546,62,168,.369,97,113,.858,20,72,92,59,17,1,40,48,413,9.7
1722,Canyon Barry\canyon-barry-1,2014-15,College of Charleston,G,33,33,1147,146,385,.379,82,211,.389,64,174,.368,57,79,.722,28,139,167,53,38,16,66,62,413,7.6
1723,Courtney Stockard\courtney-stockard-1,2017-18,St. Bonaventure,G,31,16,970,145,299,.485,126,243,.519,19,56,.339,104,137,.759,39,155,194,69,42,12,76,107,413,9.7
1724,Jeremy Hemsley\jeremy-hemsley-1,2016-17,San Diego State,G,32,31,917,146,352,.415,90,202,.446,56,150,.373,64,102,.627,15,62,77,66,20,9,64,67,412,6.9
1725,Wesley Person\wesley-person-2,2014-15,Troy,G,29,29,1010,133,325,.409,59,126,.468,74,199,.372,72,91,.791,22,59,81,29,13,2,49,55,412,7.8
1726,Lamonte Bearden\lamonte-bearden-1,2015-16,Buffalo,G,30,27,897,132,312,.423,116,248,.468,16,64,.250,132,172,.767,22,66,88,125,47,8,68,76,412,10.2
1727,Zak Irvin\zak-irvin-1,2015-16,Michigan,G,35,34,1147,157,386,.407,109,225,.484,48,161,.298,50,76,.658,17,140,157,107,27,1,65,40,412,7.7
1728,Miles Wilson\miles-wilson-1,2016-17,Mount St. Mary's,G,35,23,1009,144,317,.454,106,212,.500,38,105,.362,86,115,.748,24,113,137,25,29,18,71,86,412,6.9
1729,Luke Nelson\luke-nelson-1,2013-14,UC-Irvine,G,35,33,1014,139,337,.412,65,140,.464,74,197,.376,60,82,.732,13,75,88,100,38,10,77,72,412,7.5
1730,Spencer Collins\spencer-collins-1,2014-15,Wofford,G,35,35,965,140,303,.462,97,191,.508,43,112,.384,89,112,.795,21,75,96,50,23,2,47,60,412,7.8
1731,Corey Maynard\corey-maynard-1,2013-14,Bryant,G,31,31,1090,143,320,.447,107,192,.557,36,128,.281,90,109,.826,17,134,151,132,41,5,85,66,412,10.2
1732,Tyreek Jewell\tyreek-jewell-1,2015-16,St. Francis (NY),G,32,32,1051,141,366,.385,96,213,.451,45,153,.294,85,129,.659,63,115,178,67,33,8,63,63,412,8.5
1733,Avry Holmes\avry-holmes-1,2013-14,San Francisco,G,33,33,1046,126,288,.438,69,152,.454,57,136,.419,103,123,.837,5,70,75,102,34,2,65,67,412,8.9
1734,Shawn Anderson\shawn-anderson-1,2017-18,Navy,G,31,30,952,141,314,.449,121,252,.480,20,62,.323,110,148,.743,44,114,158,104,31,1,89,59,412,9.4
1735,Marcus Romain\marcus-romain-1,2016-17,Mississippi Valley State,G,22,16,670,132,282,.468,103,212,.486,29,70,.414,119,176,.676,28,84,112,54,21,6,100,61,412,10.4
1736,Zay Jackson\zay-jackson-1,2015-16,Southeastern Louisiana,G,33,30,1062,143,352,.406,96,216,.444,47,136,.346,79,106,.745,25,115,140,158,42,5,119,83,412,8.1
1737,Brett Comer\brett-comer-1,2014-15,Florida Gulf Coast,G,33,33,1052,143,343,.417,104,223,.466,39,120,.325,87,127,.685,20,95,115,236,42,5,80,71,412,10.8
1738,Kamau Stokes\kamau-stokes-1,2016-17,Kansas State,G,35,35,1165,120,337,.356,56,161,.348,64,176,.364,107,140,.764,15,75,90,145,38,0,100,77,411,7.2
1739,Peter Hooley\peter-hooley-1,2015-16,Albany (NY),G,33,31,1085,130,343,.379,90,179,.503,40,164,.244,111,146,.760,18,135,153,90,31,4,74,36,411,8.2
1740,Jordan Fox\jordan-fox-1,2017-18,Army,G,30,30,898,139,343,.405,61,146,.418,78,197,.396,55,68,.809,19,104,123,126,23,3,62,76,411,9.6
1741,Trevor Cooney\trevor-cooney-1,2013-14,Syracuse,G,34,34,1093,134,332,.404,44,92,.478,90,240,.375,53,63,.841,16,55,71,38,64,3,26,36,411,9.1
1742,Grant Benzinger\grant-benzinger-1,2016-17,Wright State,G,32,31,1047,133,311,.428,55,125,.440,78,186,.419,67,79,.848,47,138,185,51,23,5,46,87,411,9.3
1743,Deontae North\deontae-north-1,2016-17,Portland State,G,30,7,764,141,310,.455,97,176,.551,44,134,.328,85,124,.685,29,78,107,58,40,7,49,79,411,9.4
1744,Justin Bibbs\justin-bibbs-1,2015-16,Virginia Tech,G,35,34,1137,146,311,.469,70,142,.493,76,169,.450,43,59,.729,13,104,117,36,13,0,40,53,411,7.5
1745,Landry Shamet\landry-shamet-1,2016-17,Wichita State,G,36,35,961,135,286,.472,63,122,.516,72,164,.439,69,86,.802,21,80,101,117,26,7,39,77,411,9.4
1746,Deshon Taylor\deshon-taylor-1,2016-17,Fresno State,G,33,16,929,108,244,.443,58,120,.483,50,124,.403,145,165,.879,15,64,79,68,41,1,52,60,411,9.6
1747,Brendan Westendorf\brendan-westendorf-1,2015-16,Seattle,G,32,32,1032,144,358,.402,90,229,.393,54,129,.419,69,92,.750,38,131,169,136,56,4,105,67,411,9.3
1748,Trae Golden\trae-golden-1,2013-14,Georgia Tech,G,31,26,944,123,310,.397,77,168,.458,46,142,.324,119,152,.783,14,66,80,97,14,2,62,60,411,8.3
1749,Justin Bibbs\justin-bibbs-1,2017-18,Virginia Tech,G,31,30,1017,155,318,.487,89,152,.586,66,166,.398,35,47,.745,5,71,76,48,19,5,37,48,411,8.7
1750,Dennis Jones\dennis-jones-1,2017-18,Prairie View,G,33,21,1053,134,335,.400,102,223,.457,32,112,.286,111,180,.617,19,46,65,172,62,1,121,96,411,7.7
1751,TJ Haws\tj-haws-1,2017-18,Brigham Young,G,35,35,1179,139,339,.410,89,177,.503,50,162,.309,82,98,.837,12,84,96,146,43,10,66,69,410,9.0
1752,Christen Cunningham\christian-cunningham-1,2016-17,Samford,G,36,36,1250,140,332,.422,117,267,.438,23,65,.354,107,131,.817,18,81,99,225,31,0,78,55,410,9.7
1753,Joshua Langford\joshua-langford-1,2017-18,Michigan State,G,35,35,949,152,354,.429,108,245,.441,44,109,.404,62,73,.849,28,77,105,54,13,3,52,83,410,6.5
1754,Kethan Savage\kethan-savage-1,2014-15,George Washington,G,35,25,1055,126,314,.401,102,234,.436,24,80,.300,134,182,.736,35,133,168,80,34,15,77,83,410,7.9
1755,Robert Hatter\robert-hatter-1,2015-16,Cornell,G,24,20,676,144,347,.415,104,226,.460,40,121,.331,82,116,.707,20,57,77,85,28,3,83,58,410,9.4
1756,Rashad Vaughn\rashad-vaughn-1,2014-15,Nevada-Las Vegas,G,23,23,742,144,328,.439,90,187,.481,54,141,.383,68,98,.694,14,97,111,36,18,8,50,54,410,10.5
1757,Conner Toolson\conner-toolson-1,2017-18,Utah Valley,G,34,34,1059,142,313,.454,67,123,.545,75,190,.395,51,63,.810,19,107,126,53,53,12,45,65,410,9.3
1758,Carl Pierre\carl-pierre-1,2017-18,Massachusetts,G,33,22,1031,141,318,.443,49,123,.398,92,195,.472,36,44,.818,9,64,73,35,21,9,32,69,410,7.8
1759,Paris Bass\paris-bass-1,2014-15,Detroit Mercy,G,33,21,831,152,333,.456,129,269,.480,23,64,.359,83,130,.638,55,132,187,62,39,35,84,89,410,8.6
1760,Jahaad Proctor\jahaad-proctor-1,2017-18,High Point,G,25,23,798,143,331,.432,88,187,.471,55,144,.382,69,88,.784,17,74,91,74,25,7,60,35,410,10.8
1761,Johnathan Bell\johnathan-bell-1,2016-17,Nicholls State,G,31,30,1008,138,345,.400,112,254,.441,26,91,.286,108,143,.755,45,118,163,59,60,13,59,74,410,9.6
1762,Deven Simms\deven-simms-1,2017-18,Arkansas State,G,24,19,736,146,308,.474,116,228,.509,30,80,.375,88,120,.733,29,116,145,41,33,10,65,41,410,11.8
1763,Markus Howard\markus-howard-1,2016-17,Marquette,G,31,27,681,136,269,.506,54,119,.454,82,150,.547,56,63,.889,9,60,69,70,26,2,63,79,410,9.0
1764,Byron Hawkins\byron-hawkins-1,2015-16,Towson,G,31,30,929,127,323,.393,71,144,.493,56,179,.313,99,129,.767,12,65,77,67,24,7,36,59,409,8.6
1765,Steve Vasturia\steve-vasturia-1,2015-16,Notre Dame,G,36,36,1300,147,340,.432,102,209,.488,45,131,.344,70,82,.854,23,70,93,115,27,6,67,80,409,7.6
1766,Reed Tellinghuisen\reed-tellinghuisen-1,2016-17,South Dakota State,G,35,35,1150,138,345,.400,64,123,.520,74,222,.333,59,73,.808,34,130,164,61,27,27,61,88,409,7.8
1767,Trelun Banks\trelun-banks-1,2015-16,Southern,G,33,32,1132,136,370,.368,81,219,.370,55,151,.364,82,129,.636,22,69,91,71,34,0,78,76,409,6.0
1768,Shavon Shields\shavon-shields-1,2013-14,Nebraska,G,32,32,1041,131,296,.443,113,239,.473,18,57,.316,129,179,.721,44,140,184,51,29,9,51,89,409,9.1
1769,Davon Bell\davon-bell-1,2017-18,Presbyterian,G,32,31,1077,135,318,.425,108,237,.456,27,81,.333,112,139,.806,13,89,102,165,50,7,69,64,409,10.7
1770,Isaiah Cousins\isaiah-cousins-1,2014-15,Oklahoma,G,35,35,1079,150,354,.424,87,214,.407,63,140,.450,46,71,.648,33,128,161,77,43,13,72,65,409,8.0
1771,Markel Crawford\markel-crawford-1,2016-17,Memphis,G,32,29,1036,149,312,.478,107,186,.575,42,126,.333,69,91,.758,37,104,141,61,46,4,44,72,409,9.9
1772,Shawn Johnson\shawn-johnson-1,2016-17,Incarnate Word,G,29,28,941,128,279,.459,58,111,.523,70,168,.417,82,116,.707,36,168,204,47,36,46,53,76,408,11.8
1773,Dwayne Sutton\dwayne-sutton-1,2015-16,North Carolina-Asheville,G,34,34,1037,132,281,.470,110,211,.521,22,70,.314,122,193,.632,79,183,262,44,53,24,58,88,408,10.4
1774,Trent Mackey\trent-mackey-1,2015-16,North Florida,G,34,34,1175,126,279,.452,16,40,.400,110,239,.460,46,56,.821,13,69,82,60,20,2,37,68,408,8.5
1775,Rich Williams\rich-williams-1,2017-18,Manhattan,G,28,28,908,150,341,.440,95,212,.448,55,129,.426,53,68,.779,22,112,134,77,21,4,83,61,408,8.7
1776,Rashad Muhammad\rashad-muhammad-1,2013-14,San Jose State,G,31,3,873,121,332,.364,46,142,.324,75,190,.395,91,112,.813,20,71,91,24,14,1,52,53,408,6.7
1777,Joe Chealey\joe-chealey-1,2014-15,College of Charleston,G,33,32,1073,131,326,.402,98,218,.450,33,108,.306,113,149,.758,19,100,119,109,29,6,79,101,408,7.6
1778,Ray Lee\ray-lee-2,2015-16,Eastern Michigan,G,27,5,641,116,280,.414,68,148,.459,48,132,.364,128,156,.821,12,28,40,43,36,2,58,54,408,9.3
1779,Deshaunt Walker\deshaunt-walker-1,2013-14,Stephen F. Austin,G,35,0,761,146,360,.406,65,133,.489,81,227,.357,35,44,.795,17,43,60,42,22,1,28,50,408,6.8
1780,Jordan Wilson\jordan-wilson-1,2015-16,Northern Colorado,G,31,21,983,140,314,.446,75,154,.487,65,160,.406,63,82,.768,10,79,89,88,23,1,50,74,408,8.8
1781,JeQuan Lewis\jequan-lewis-1,2015-16,Virginia Commonwealth,G,36,34,1031,134,288,.465,90,182,.495,44,106,.415,96,112,.857,8,84,92,183,57,1,95,103,408,9.3
1782,Derrick Colter\derrick-colter-1,2014-15,Duquesne,G,31,31,988,134,302,.444,74,161,.460,60,141,.426,80,103,.777,22,67,89,113,29,2,56,65,408,9.8
1783,Kurk Lee\kurk-lee-2,2017-18,Drexel,G,33,32,1185,147,382,.385,96,233,.412,51,149,.342,63,83,.759,23,90,113,107,41,2,75,76,408,7.5
1784,Jordan Fox\jordan-fox-1,2016-17,Army,G,32,31,1026,143,330,.433,80,169,.473,63,161,.391,59,73,.808,9,68,77,146,27,1,70,75,408,8.9
1785,Barry Brown\barry-brown-1,2016-17,Kansas State,G,35,35,1146,146,354,.412,102,219,.466,44,135,.326,72,117,.615,17,95,112,84,82,4,61,68,408,8.5
1786,Andre Hatchett\andre-hatchett-1,2013-14,Idaho State,G,29,29,972,139,332,.419,133,302,.440,6,30,.200,124,199,.623,43,116,159,90,42,4,65,47,408,10.0
1787,Reco McCarter\reco-mccarter-1,2013-14,Campbell,G,32,31,903,144,318,.453,110,190,.579,34,128,.266,85,129,.659,64,100,164,76,37,24,97,64,407,8.9
1788,Terry Whisnant\terry-whisnant-1,2014-15,East Carolina,G,33,33,1041,131,327,.401,54,119,.454,77,208,.370,68,89,.764,25,62,87,60,31,3,40,61,407,8.1
1789,Tate Unruh\tate-unruh-1,2013-14,Northern Colorado,G,32,30,980,136,300,.453,60,117,.513,76,183,.415,59,62,.952,9,98,107,46,14,0,45,74,407,8.0
1790,Jamaal King\jamaal-king-1,2016-17,Saint Francis (PA),G,34,29,983,142,359,.396,91,192,.474,51,167,.305,72,97,.742,15,86,101,133,45,4,104,86,407,7.1
1791,Garrett Nevels\garrett-nevels-1,2013-14,Hawaii,G,31,30,985,156,333,.468,97,190,.511,59,143,.413,36,47,.766,13,87,100,54,25,16,28,76,407,9.1
1792,Kajon Mack\kajon-mack-1,2017-18,Tennessee Tech,G,32,32,1107,132,319,.414,94,199,.472,38,120,.317,105,136,.772,38,125,163,126,33,12,60,77,407,10.2
1793,Kourtlin Jackson\kourtlin-jackson-1,2015-16,Southern Mississippi,G,28,27,780,124,274,.453,68,145,.469,56,129,.434,103,134,.769,21,108,129,36,32,8,48,64,407,10.3
1794,Reggie Lewis\reggie-lewis-2,2013-14,Florida A&M,G,32,27,980,148,385,.384,77,193,.399,71,192,.370,40,48,.833,14,37,51,44,30,6,38,43,407,7.0
1795,Traevon Jackson\traevon-jackson-1,2013-14,Wisconsin,G,38,38,1170,122,299,.408,88,210,.419,34,89,.382,129,167,.772,20,124,144,151,26,4,82,88,407,7.9
1796,Malcolm Miller\macolm-miller-1,2013-14,Southern,G,32,28,903,142,321,.442,62,116,.534,80,205,.390,43,57,.754,40,127,167,40,32,38,41,60,407,10.0
1797,Keon Moore\keon-moore-1,2013-14,Winthrop,G,29,24,797,133,305,.436,69,142,.486,64,163,.393,77,94,.819,21,92,113,28,34,6,42,56,407,9.5
1798,Tavon Allen\tavon-allen-1,2015-16,Drexel,G,31,20,939,134,365,.367,62,170,.365,72,195,.369,67,81,.827,11,79,90,72,20,16,50,95,407,7.2
1799,Denzel Ingram\denzel-ingram-1,2015-16,North Carolina-Wilmington,G,32,24,1044,130,360,.361,55,158,.348,75,202,.371,71,87,.816,14,59,73,107,46,1,59,72,406,8.2
1800,Brian Sullivan\brian-sullivan-1,2014-15,Davidson,G,32,30,1066,134,342,.392,51,108,.472,83,234,.355,55,72,.764,6,89,95,124,22,1,45,66,406,8.8
1801,Ferron Flavors Jr.\ferron-flavorsjr-1,2017-18,Fairfield,G,33,24,1033,134,378,.354,39,95,.411,95,283,.336,43,58,.741,18,102,120,36,20,0,27,64,406,6.8
1802,Harald Frey\harald-frey-1,2016-17,Montana State,G,32,32,1058,132,292,.452,62,121,.512,70,171,.409,72,86,.837,14,65,79,110,25,0,62,88,406,8.8
1803,Emile Blackman\emile-blackman-1,2014-15,Niagara,G,30,29,956,153,333,.459,112,226,.496,41,107,.383,59,71,.831,45,73,118,43,25,10,58,74,406,8.6
1804,Monte Morris\monte-morris-1,2014-15,Iowa State,G,34,34,1153,155,306,.507,123,225,.547,32,81,.395,64,85,.753,24,93,117,176,64,15,38,45,406,12.7
1805,Tevin Hammond\tevin-hammond-1,2013-14,Arkansas-Pine Bluff,G,31,31,1101,112,309,.362,55,144,.382,57,165,.345,125,168,.744,25,66,91,146,83,3,118,90,406,9.3
1806,Stephan Jiggetts\stephan-jiggetts-1,2016-17,Fairleigh Dickinson,G,30,30,1059,123,314,.392,88,202,.436,35,112,.313,125,153,.817,15,68,83,125,18,3,94,94,406,7.7
1807,Dequon Miller\dequon-miller-1,2015-16,Missouri State,G,32,32,1110,132,369,.358,75,194,.387,57,175,.326,85,123,.691,17,82,99,96,18,0,82,63,406,6.2
1808,Kaheem Ransom\kaheem-ransom-1,2013-14,Sam Houston State,G,35,35,1078,115,305,.377,59,156,.378,56,149,.376,120,164,.732,32,112,144,126,51,5,84,90,406,8.6
1809,Kenyon McNeaill\kenyon-mcneaill-1,2013-14,Louisiana Tech,G,37,0,830,122,290,.421,34,72,.472,88,218,.404,74,91,.813,16,71,87,36,37,3,30,69,406,7.7
1810,John Papale\john-papale-1,2015-16,Boston University,G,34,34,1231,139,337,.412,44,100,.440,95,237,.401,33,40,.825,9,81,90,72,22,6,29,47,406,8.3
1811,Tevin Bellinger\tevin-bellinger-1,2016-17,Prairie View,G,32,17,887,145,360,.403,103,218,.472,42,142,.296,74,97,.763,25,91,116,83,46,3,66,60,406,8.2
1812,Isaac Williams\isaac-williams-1,2015-16,Mississippi Valley State,G,35,12,882,145,388,.374,79,177,.446,66,211,.313,50,63,.794,15,105,120,30,22,7,27,65,406,6.4
1813,Alec Wintering\alec-wintering-1,2014-15,Portland,G,33,33,1064,115,265,.434,82,193,.425,33,72,.458,143,180,.794,19,73,92,187,50,1,84,84,406,10.6
1814,Sam Hunt\sam-hunt-1,2016-17,North Carolina A&T,G,32,27,1100,129,337,.383,55,128,.430,74,209,.354,74,79,.937,6,47,53,56,19,0,73,56,406,6.3
1815,Edric Dennis\edric-dennis-1,2016-17,Jackson State,G,29,26,966,129,361,.357,71,184,.386,58,177,.328,90,138,.652,34,84,118,59,28,5,87,64,406,6.7
1816,Quinn Cook\quinn-cook-1,2013-14,Duke,G,35,22,1042,137,317,.432,72,142,.507,65,175,.371,67,81,.827,13,63,76,153,47,1,57,66,406,9.5
1817,Rasheed Sulaimon\rasheed-sulaimon-1,2015-16,Maryland,G,36,36,1184,137,295,.464,80,161,.497,57,134,.425,74,98,.755,9,117,126,125,42,3,65,52,405,9.2
1818,Antino Jackson\antino-jackson-1,2015-16,Akron,G,35,31,976,136,362,.376,69,172,.401,67,190,.353,66,81,.815,20,90,110,120,40,1,76,79,405,7.4
1819,Keon Johnson\keon-johnson-1,2013-14,Winthrop,G,33,32,838,124,297,.418,60,152,.395,64,145,.441,93,109,.853,8,55,63,47,19,0,39,51,405,7.7
1820,Trevis Wyche\trevis-wyche-1,2016-17,Saint Peter's,G,36,34,1101,128,294,.435,95,211,.450,33,83,.398,116,149,.779,7,91,98,137,55,6,53,84,405,9.4
1821,Brison White\brison-white-1,2013-14,Northwestern State,G,31,26,803,162,350,.463,141,259,.544,21,91,.231,60,87,.690,23,74,97,63,42,9,41,48,405,9.2
1822,Jamel Waters\jamel-waters-1,2014-15,Alabama State,G,29,28,939,147,340,.432,112,229,.489,35,111,.315,76,101,.752,23,86,109,152,58,5,71,69,405,11.3
1823,Jack Gibbs\jack-gibbs-1,2014-15,Davidson,G,25,22,750,125,261,.479,71,134,.530,54,127,.425,101,118,.856,20,73,93,120,38,0,62,49,405,13.7
1824,Kodi Justice\kodi-justice-1,2017-18,Arizona State,G,32,31,1036,143,312,.458,66,110,.600,77,202,.381,42,65,.646,8,77,85,65,38,6,47,62,405,8.7
1825,Jeremy Morgan\jeremy-morgan-1,2015-16,Northern Iowa,G,36,36,1160,128,264,.485,78,141,.553,50,123,.407,99,123,.805,42,147,189,83,70,32,50,85,405,11.2
1826,Charles Oliver\charles-oliver-2,2015-16,Norfolk State,G,34,19,824,114,289,.394,55,114,.482,59,175,.337,118,144,.819,19,55,74,34,10,2,45,80,405,6.6
1827,Josh Adams\josh-adams-1,2013-14,Wyoming,G,32,32,1036,143,296,.483,118,216,.546,25,80,.313,94,128,.734,11,88,99,92,25,8,78,84,405,8.1
1828,Ja Morant\temetrius-morant-1,2017-18,Murray State,G,32,32,1088,133,290,.459,106,202,.525,27,88,.307,112,139,.806,55,153,208,201,30,13,79,64,405,12.6
1829,Je'lon Hornbeak\jelon-hornbeak-1,2016-17,Monmouth,G,34,33,875,129,303,.426,49,123,.398,80,180,.444,67,88,.761,29,117,146,59,52,18,42,110,405,9.2
1830,Amir Coffey\amir-coffey-1,2016-17,Minnesota,G,33,33,1097,131,292,.449,99,197,.503,32,95,.337,110,146,.753,23,104,127,102,36,5,64,57,404,9.4
1831,Troy Harper\troy-harper-1,2015-16,Campbell,G,30,21,833,118,306,.386,79,173,.457,39,133,.293,129,168,.768,10,88,98,41,30,5,69,74,404,7.3
1832,Nick Garth\nick-garth-1,2016-17,Lamar,G,34,8,861,131,288,.455,38,70,.543,93,218,.427,49,66,.742,5,46,51,56,30,1,22,60,404,8.5
1833,Shelton Mitchell\shelton-mitchell-1,2017-18,Clemson,G,33,32,1099,123,308,.399,73,172,.424,50,136,.368,108,126,.857,14,86,100,119,25,1,67,47,404,8.8
1834,Steven Whitley\steven-whitley-1,2017-18,Norfolk State,G,33,29,946,144,323,.446,113,234,.483,31,89,.348,85,130,.654,44,145,189,154,53,4,101,92,404,9.6
1835,Caleb White\caleb-white-1,2014-15,East Carolina,G,33,32,1021,138,313,.441,71,149,.477,67,164,.409,61,77,.792,24,92,116,46,15,5,50,65,404,7.7
1836,Devin Watson\devin-watson-1,2017-18,San Diego State,G,33,33,1031,130,319,.408,81,193,.420,49,126,.389,95,126,.754,17,69,86,124,32,0,60,47,404,8.9
1837,Donte Wright\donte-wright-1,2017-18,South Carolina State,G,32,25,836,129,349,.370,36,91,.396,93,258,.360,53,65,.815,19,54,73,29,22,2,47,61,404,6.5
1838,Glynn Watson Jr.\glynn-watsonjr-1,2016-17,Nebraska,G,31,29,979,144,346,.416,96,224,.429,48,122,.393,68,84,.810,16,77,93,81,50,4,48,91,404,8.8
1839,Ja'Quan Newton\jaquan-newton-1,2016-17,Miami (FL),G,30,28,942,150,332,.452,139,292,.476,11,40,.275,93,133,.699,18,87,105,101,34,1,98,49,404,8.1
1840,Rawle Alkins\rawle-alkins-1,2016-17,Arizona,G,37,36,1037,143,309,.463,99,190,.521,44,119,.370,74,101,.733,57,126,183,76,33,17,67,81,404,8.4
1841,Ya Ya Anderson\ya-ya-anderson-1,2013-14,Radford,G,35,34,1059,143,307,.466,61,107,.570,82,200,.410,36,55,.655,22,81,103,79,24,3,43,58,404,8.4
1842,Tevin Svihovec\tevin-svihovec-1,2014-15,Northern Colorado,G,30,29,921,143,331,.432,122,271,.450,21,60,.350,97,128,.758,13,93,106,84,26,1,59,41,404,8.8
1843,Korey Billbury\korey-billbury-1,2014-15,Oral Roberts,G,28,28,929,141,356,.396,113,277,.408,28,79,.354,94,140,.671,57,149,206,80,40,6,69,71,404,10.0
1844,Devin Cannady\devin-cannady-1,2016-17,Princeton,G,30,24,944,123,296,.416,42,98,.429,81,198,.409,76,81,.938,9,98,107,54,33,8,35,56,403,9.9
1845,Tony Hicks\tony-hicks-1,2013-14,Pennsylvania,G,27,24,765,141,339,.416,104,223,.466,37,116,.319,84,110,.764,13,58,71,78,17,2,85,74,403,7.3
1846,Tim Derksen\tim-derksen-1,2014-15,San Francisco,G,32,31,935,133,281,.473,91,176,.517,42,105,.400,95,142,.669,36,108,144,74,32,3,45,66,403,9.8
1847,Jared Stutzman\jared-stutzman-1,2017-18,Idaho State,G,27,25,889,135,238,.567,69,111,.622,66,127,.520,67,93,.720,9,84,93,41,17,7,34,47,403,11.5
1848,Winfield Willis\winfield-willis-1,2014-15,NJIT,G,33,33,982,130,274,.474,71,139,.511,59,135,.437,84,99,.848,33,71,104,79,36,5,56,93,403,9.2
1849,Nick Griffin\nick-griffin-1,2017-18,Saint Peter's,G,32,31,1045,141,369,.382,68,168,.405,73,201,.363,48,65,.738,10,83,93,40,16,7,42,43,403,6.7
1850,Craig Sword\craig-sword-1,2015-16,Mississippi State,G,31,31,905,143,317,.451,120,218,.550,23,99,.232,94,139,.676,35,86,121,94,41,29,97,102,403,8.4
1851,Khalil Davis\khalil-davis-1,2015-16,Austin Peay,G,36,36,1129,133,312,.426,99,192,.516,34,120,.283,103,153,.673,50,94,144,97,43,12,94,99,403,7.4
1852,Jovan Mooring\jovan-mooring-1,2016-17,Nevada-Las Vegas,G,32,15,955,116,310,.374,58,154,.377,58,156,.372,113,145,.779,6,79,85,128,36,3,81,75,403,8.3
1853,Armani Moore\armani-moore-1,2015-16,Tennessee,G,33,33,1080,149,360,.414,131,303,.432,18,57,.316,87,154,.565,64,186,250,134,39,54,86,91,403,10.1
1854,Terry Larrier\terry-larrier-1,2017-18,Connecticut,G,29,28,987,148,372,.398,97,237,.409,51,135,.378,56,71,.789,38,100,138,25,20,7,69,49,403,7.1
1855,Matt Milon\matt-milon-1,2017-18,William & Mary,G,31,29,941,134,276,.486,57,96,.594,77,180,.428,58,63,.921,11,73,84,35,19,5,35,52,403,9.1
1856,David Efianayi\david-efianayi-1,2016-17,Gardner-Webb,G,32,15,816,135,265,.509,113,212,.533,22,53,.415,111,154,.721,15,64,79,61,31,8,76,49,403,8.4
1857,Jadon Cohee\jadon-cohee-1,2017-18,Southern Utah,G,32,31,1076,126,317,.397,80,194,.412,46,123,.374,105,132,.795,3,76,79,98,15,2,61,65,403,7.6
1858,Christian Thomas\christian-thomas-1,2014-15,Loyola (IL),G,36,36,998,160,284,.563,145,250,.580,15,34,.441,68,107,.636,58,104,162,34,17,9,56,87,403,7.8
1859,Casey Jones\casey-jones-1,2013-14,Chattanooga,G,33,33,959,154,288,.535,154,286,.538,0,2,.000,95,131,.725,97,108,205,61,40,33,73,95,403,10.4
1860,Ahmad Caver\ahmad-caver-1,2016-17,Old Dominion,G,31,29,1093,130,361,.360,63,179,.352,67,182,.368,76,121,.628,17,93,110,150,41,6,66,62,403,9.1
1861,Daniel Dingle\daniel-dingle-1,2016-17,Temple,G,32,30,1139,129,321,.402,72,173,.416,57,148,.385,88,123,.715,37,106,143,111,31,20,80,70,403,9.0
1862,Codi Miller-McIntyre\codi-miller-mcintyre-1,2013-14,Wake Forest,G,32,31,1031,149,344,.433,135,274,.493,14,70,.200,91,145,.628,22,75,97,134,24,1,64,55,403,8.5
1863,Wes Clark\wes-clark-2,2017-18,Buffalo,G,26,26,777,145,304,.477,95,179,.531,50,125,.400,62,81,.765,11,81,92,140,32,7,59,74,402,12.2
1864,Tarkus Ferguson\tarkus-ferguson-1,2016-17,Illinois-Chicago,G,36,36,1158,134,334,.401,83,183,.454,51,151,.338,83,106,.783,17,174,191,177,49,22,117,69,402,8.9
1865,Deven Simms\deven-simms-1,2016-17,Arkansas State,G,30,0,799,147,316,.465,135,276,.489,12,40,.300,96,135,.711,36,114,150,56,33,11,67,47,402,9.3
1866,Bakari Evelyn\bakari-evelyn-1,2017-18,Valparaiso,G,32,30,1003,140,312,.449,83,163,.509,57,149,.383,65,85,.765,8,90,98,93,44,3,88,71,402,8.1
1867,Fredrick Edmond\fredrick-edmond-1,2015-16,Western Kentucky,G,33,27,954,163,285,.572,155,264,.587,8,21,.381,68,125,.544,38,158,196,90,33,15,72,53,402,10.1
1868,Jeremy Smith\jeremy-smith-2,2013-14,Nicholls State,G,29,29,831,154,277,.556,136,230,.591,18,47,.383,76,111,.685,39,69,108,46,10,6,59,86,402,8.9
1869,DK Eldridge\dk-eldridge-1,2013-14,New Mexico State,G,36,36,995,144,308,.468,102,203,.502,42,105,.400,72,112,.643,55,107,162,72,20,14,59,79,402,8.0
1870,Darrell Brown\darrell-brown-1,2016-17,Bradley,G,32,30,980,123,321,.383,77,197,.391,46,124,.371,110,140,.786,7,65,72,87,21,2,94,67,402,6.3
1871,Malcolm Bernard\malcolm-bernard-1,2015-16,Florida A&M,G,28,26,912,126,299,.421,114,242,.471,12,57,.211,138,209,.660,39,158,197,119,63,19,98,83,402,11.4
1872,Jashaun Agosto\jashaun-agosto-1,2017-18,Long Island University,G,34,33,1234,138,342,.404,86,183,.470,52,159,.327,74,98,.755,14,128,142,142,24,2,81,85,402,7.8
1873,Manu Lecomte\manu-lecomte-1,2016-17,Baylor,G,33,32,992,129,303,.426,58,129,.450,71,174,.408,73,88,.830,7,54,61,125,28,2,65,63,402,8.6
1874,Donovan Fields\donovan-fields-1,2017-18,Cal Poly,G,31,30,999,145,355,.408,108,264,.409,37,91,.407,75,81,.926,9,93,102,126,36,4,73,78,402,8.6
1875,Byron Wesley\byron-wesley-1,2014-15,Gonzaga,G,38,38,1014,143,278,.514,133,246,.541,10,32,.313,106,158,.671,48,131,179,87,37,12,60,59,402,8.9
1876,Michael Dixon\michael-dixon-1,2013-14,Memphis,G,34,3,773,135,288,.469,84,156,.538,51,132,.386,81,96,.844,17,57,74,81,43,4,55,99,402,8.4
1877,Jesse Reed\jesse-reed-1,2015-16,American,G,31,30,1173,137,309,.443,83,173,.480,54,136,.397,73,99,.737,20,121,141,65,29,18,75,77,401,8.4
1878,Nick Masterson\nick-masterson-1,2016-17,Kennesaw State,G,31,31,953,143,287,.498,57,128,.445,86,159,.541,29,34,.853,26,47,73,96,26,3,37,59,401,10.4
1879,Tre Demps\tre-demps-1,2014-15,Northwestern,G,32,25,1043,149,354,.421,94,200,.470,55,154,.357,48,73,.658,13,84,97,84,9,1,47,49,401,7.5
1880,Burak Eslik\burak-eslik-1,2016-17,Southern Illinois-Edwardsville,G,30,29,980,107,296,.361,66,158,.418,41,138,.297,146,177,.825,6,81,87,52,16,0,59,46,401,7.6
1881,Korey Billbury\korey-billbury-1,2015-16,Virginia Commonwealth,G,36,27,1009,150,362,.414,108,255,.424,42,107,.393,59,90,.656,58,117,175,44,38,3,48,83,401,7.2
1882,Andre Stringer\andre-stringer-1,2013-14,Louisiana State,G,34,14,875,123,292,.421,49,108,.454,74,184,.402,81,100,.810,20,66,86,88,34,1,44,68,401,8.7
1883,Harrison Hawkins\harrison-hawkins-1,2014-15,Abilene Christian,G,31,18,741,142,324,.438,85,168,.506,57,156,.365,60,76,.789,10,26,36,46,25,3,72,80,401,6.3
1884,Kyron Cartwright\kyron-cartwright-1,2017-18,Providence,G,34,32,1061,138,323,.427,100,222,.450,38,101,.376,87,114,.763,11,86,97,196,44,1,92,64,401,9.3
1885,Carson Puriefoy\carson-puriefoy-1,2013-14,Stony Brook,G,31,12,891,122,285,.428,83,195,.426,39,90,.433,118,147,.803,14,61,75,86,46,4,74,69,401,8.8
1886,Lorenzo Bonam\lorenzo-bonam-1,2016-17,Utah,G,32,29,954,144,251,.574,114,164,.695,30,87,.345,83,104,.798,17,81,98,98,45,11,70,58,401,10.6
1887,Brent Arrington\brent-arrington-1,2013-14,Morehead State,G,34,28,949,128,305,.420,82,166,.494,46,139,.331,99,133,.744,25,83,108,79,66,14,73,124,401,8.1
1888,Nick Lindner\nick-lindner-1,2016-17,Lafayette,G,30,30,997,119,297,.401,42,93,.452,77,204,.377,86,110,.782,12,61,73,119,22,1,76,67,401,8.7
1889,DJ Evans\dj-evans-1,2013-14,Albany (NY),G,34,34,1149,131,329,.398,84,190,.442,47,139,.338,92,120,.767,15,101,116,93,47,1,65,74,401,8.0
1890,Jaleen Smith\jaleen-smith-1,2015-16,New Hampshire,G,30,29,1037,122,300,.407,82,191,.429,40,109,.367,117,130,.900,40,126,166,102,28,12,65,73,401,10.5
1891,Justin Simon\justin-simon-2,2017-18,St. John's (NY),G,33,33,1190,151,319,.473,136,283,.481,15,36,.417,84,127,.661,38,196,234,167,82,27,95,90,401,11.9
1892,Stephan Jiggetts\stephan-jiggetts-1,2017-18,South Florida,G,32,32,1089,133,359,.370,72,206,.350,61,153,.399,73,90,.811,11,81,92,104,21,3,75,73,400,6.8
1893,Teddy Okereafor\teddy-okereafor-1,2015-16,Rider,G,33,32,1168,121,303,.399,75,150,.500,46,153,.301,112,152,.737,13,126,139,150,37,7,98,47,400,9.0
1894,Sean O'Brien\sean-obrien-2,2016-17,Colgate,G,32,32,1159,136,294,.463,68,127,.535,68,167,.407,60,67,.896,15,62,77,132,34,0,71,90,400,9.2
1895,Jordan Ford\jordan-ford-1,2017-18,Saint Mary's (CA),G,36,36,988,150,295,.508,99,180,.550,51,115,.443,49,65,.754,17,80,97,58,31,2,31,50,400,8.5
1896,Tra-Deon Hollins\tra-deon-hollins-1,2015-16,Omaha,G,32,32,1036,135,292,.462,110,204,.539,25,88,.284,105,141,.745,40,113,153,196,127,13,95,85,400,13.8
1897,Demontrae Jefferson\demontrae-jefferson-1,2016-17,Texas Southern,G,28,22,898,128,340,.376,89,211,.422,39,129,.302,105,146,.719,13,44,57,88,30,0,86,48,400,7.3
1898,Deontae North\deontae-north-1,2017-18,Portland State,G,19,17,572,135,293,.461,93,171,.544,42,122,.344,88,123,.715,41,52,93,46,34,5,37,56,400,15.2
1899,Cleon Roberts\cleon-roberts-1,2015-16,La Salle,G,31,31,1137,127,328,.387,62,147,.422,65,181,.359,81,104,.779,44,67,111,38,60,12,55,86,400,8.7
1900,Cheddi Mosely\cheddi-mosley-1,2015-16,Boston University,G,30,18,894,125,313,.399,55,100,.550,70,213,.329,80,103,.777,11,77,88,31,33,3,63,59,400,7.4
1901,Jordan Strawberry\jordan-strawberry-1,2017-18,Mercer,G,34,33,1047,122,330,.370,72,173,.416,50,157,.318,106,121,.876,22,98,120,166,24,2,58,51,400,9.4
1902,Rayshawn Simmons\rayshawn-simmons-1,2015-16,Central Michigan,G,33,33,1093,145,338,.429,119,246,.484,26,92,.283,84,131,.641,44,98,142,165,19,1,74,88,400,8.8
1903,Dion Nesmith\dion-nesmith-1,2013-14,Hofstra,G,30,28,1039,133,341,.390,72,186,.387,61,155,.394,73,101,.723,17,60,77,126,24,1,90,100,400,7.2
1904,Nathan Moran\nathan-moran-1,2015-16,Lipscomb,G,33,21,898,118,310,.381,36,89,.404,82,221,.371,82,95,.863,10,90,100,151,42,1,73,77,400,9.2
1905,Tyree Appleby\tyree-appleby-1,2017-18,Cleveland State,G,34,25,874,129,292,.442,93,181,.514,36,111,.324,106,148,.716,17,65,82,135,44,8,115,68,400,7.8
1906,A'Torri Shine\atorri-shine-1,2013-14,Grambling,G,29,26,936,129,304,.424,101,210,.481,28,94,.298,113,150,.753,38,81,119,35,20,7,69,63,399,7.9
1907,Canyon Barry\canyon-barry-1,2016-17,Florida,G,35,1,747,122,289,.422,80,164,.488,42,125,.336,113,128,.883,29,69,98,22,18,12,31,41,399,7.9
1908,Jehvon Clarke\jehvon-clarke-1,2013-14,Bowling Green State,G,32,32,1166,152,420,.362,116,282,.411,36,138,.261,59,87,.678,30,82,112,149,61,2,117,63,399,7.0
1909,Ray Sanders\ray-sanders-1,2015-16,Albany (NY),G,33,31,907,134,304,.441,93,193,.482,41,111,.369,90,117,.769,32,109,141,77,52,3,58,90,399,9.0
1910,Paul Miller\paul-miller-2,2015-16,North Dakota State,G,26,25,880,133,324,.410,66,162,.407,67,162,.414,66,85,.776,11,114,125,46,22,7,54,51,399,9.4
1911,Dallas Moore\dallas-moore-1,2013-14,North Florida,G,32,32,921,138,322,.429,88,187,.471,50,135,.370,73,93,.785,12,54,66,83,18,3,74,50,399,7.2
1912,Emile Blackman\emile-blackman-1,2016-17,Duquesne,G,32,32,967,139,315,.441,98,211,.464,41,104,.394,80,106,.755,30,97,127,46,17,6,63,79,399,7.3
1913,Allonzo Trier\allonzo-trier-1,2015-16,Arizona,G,27,21,757,122,262,.466,82,152,.539,40,110,.364,115,145,.793,12,77,89,30,14,6,52,52,399,9.3
1914,Kris Davis\kris-davis-1,2014-15,Southern Illinois-Edwardsville,G,28,28,881,135,285,.474,85,171,.497,50,114,.439,79,113,.699,6,100,106,40,29,2,65,35,399,9.1
1915,Ricky Tarrant\ricky-tarrant-1,2015-16,Memphis,G,34,33,1006,104,291,.357,59,147,.401,45,144,.313,146,184,.793,13,78,91,110,46,1,51,84,399,8.6
1916,Trent Frazier\trent-fraizer-1,2017-18,Illinois,G,32,16,842,140,346,.405,79,170,.465,61,176,.347,58,90,.644,7,49,56,99,54,1,71,68,399,7.7
1917,DaShaun Wiggins\dashaun-wiggins-1,2013-14,Portland State,G,31,6,709,112,265,.423,81,171,.474,31,94,.330,144,189,.762,19,68,87,43,31,1,41,72,399,8.6
1918,Sean Lloyd\sean-lloyd-1,2017-18,Southern Illinois,G,33,33,1146,142,302,.470,113,225,.502,29,77,.377,85,116,.733,47,116,163,69,52,17,61,78,398,9.7
1919,Brad Davison\brad-davison-1,2017-18,Wisconsin,G,33,29,1028,124,306,.405,64,137,.467,60,169,.355,90,110,.818,10,66,76,83,40,1,59,109,398,7.5
1920,Dejuan Clayton\dejuan-clayton-1,2016-17,Coppin State,G,32,23,1037,120,292,.411,72,154,.468,48,138,.348,110,153,.719,19,49,68,99,31,5,64,65,398,8.3
1921,Austin Tillotson\austin-tillotson-1,2013-14,Colgate,G,30,30,1019,143,243,.588,107,168,.637,36,75,.480,76,104,.731,17,64,81,133,33,1,64,66,398,11.4
1922,Daniel Norl\daniel-norl-1,2017-18,Omaha,G,31,31,983,138,291,.474,94,167,.563,44,124,.355,78,95,.821,18,88,106,78,24,6,68,68,398,8.7
1923,Preston Medlin\preston-medlin-1,2013-14,Utah State,G,32,32,1060,132,316,.418,62,151,.411,70,165,.424,64,82,.780,6,81,87,132,11,2,45,46,398,9.1
1924,Keaton Wallace\keaton-wallace-1,2017-18,Texas-San Antonio,G,35,20,965,139,381,.365,65,158,.411,74,223,.332,46,62,.742,23,84,107,93,28,13,59,70,398,6.8
1925,Rodney Chatman\rodney-chatman-1,2017-18,Chattanooga,G,30,28,970,131,289,.453,88,162,.543,43,127,.339,93,119,.782,9,114,123,135,35,14,89,88,398,9.8
1926,David Nwaba\david-nwaba-1,2013-14,Cal Poly,G,34,30,809,140,266,.526,140,266,.526,0,0,,118,172,.686,64,99,163,40,28,21,43,63,398,9.5
1927,Rob Edwards\rob-edwards-1,2015-16,Cleveland State,G,32,29,994,130,331,.393,81,207,.391,49,124,.395,89,119,.748,21,104,125,46,37,1,109,71,398,5.8
1928,Devon Hall\devon-hall-1,2017-18,Virginia,G,34,34,1091,132,291,.454,75,159,.472,57,132,.432,76,85,.894,12,131,143,107,29,5,35,48,397,10.1
1929,Dimitri Batten\dimitri-batten-1,2013-14,Old Dominion,G,36,35,981,137,361,.380,94,211,.445,43,150,.287,80,128,.625,28,123,151,41,40,9,75,92,397,5.5
1930,Gabe Vincent\gabe-vincent-1,2017-18,UC-Santa Barbara,G,32,30,932,138,307,.450,83,161,.516,55,146,.377,66,82,.805,3,58,61,104,35,6,38,92,397,9.0
1931,John Schoof\john-schoof-1,2014-15,American,G,33,33,1239,145,310,.468,77,141,.546,68,169,.402,39,56,.696,21,83,104,53,28,9,54,78,397,7.8
1932,Eli Pemberton\eli-pemberton-1,2016-17,Hofstra,G,31,30,1001,118,267,.442,60,124,.484,58,143,.406,103,130,.792,38,66,104,62,24,4,40,87,397,9.3
1933,Tarin Smith\tarin-smith-1,2017-18,Duquesne,G,32,4,912,133,321,.414,94,204,.461,39,117,.333,92,140,.657,17,80,97,102,31,16,69,54,397,8.3
1934,Nisre Zouzoua\nisre-zouzoua-1,2015-16,Bryant,G,31,25,939,131,321,.408,71,159,.447,60,162,.370,75,89,.843,20,78,98,44,25,8,45,86,397,7.7
1935,Cameron Golden\cameron-golden-1,2014-15,Arkansas State,G,29,29,1016,133,366,.363,72,169,.426,61,197,.310,70,99,.707,15,76,91,78,49,5,63,56,397,8.2
1936,Bryce Jones\bryce-jones-2,2016-17,Murray State,G,33,30,1038,110,301,.365,56,141,.397,54,160,.338,123,138,.891,18,89,107,114,42,4,54,86,397,9.1
1937,Troyce Manassa\troyce-manassa-1,2015-16,Savannah State,G,32,32,948,128,310,.413,106,240,.442,22,70,.314,118,147,.803,22,141,163,76,33,16,75,75,396,8.4
1938,Micah Mason\micah-mason-1,2014-15,Duquesne,G,31,31,1011,135,287,.470,47,90,.522,88,197,.447,38,42,.905,13,110,123,89,35,1,41,45,396,10.6
1939,Xavier Johnson\xavier-johnson-1,2013-14,Colorado,G,33,33,994,136,293,.464,99,191,.518,37,102,.363,87,142,.613,57,137,194,27,25,10,58,67,396,8.2
1940,Dedrick Basile\dedrick-basile-1,2015-16,Cal State Bakersfield,G,33,33,966,152,324,.469,102,186,.548,50,138,.362,42,58,.724,22,88,110,122,59,7,59,80,396,9.8
1941,C.J. Massinburg\cj-massinburg-1,2015-16,Buffalo,G,35,7,885,123,275,.447,79,162,.488,44,113,.389,106,141,.752,43,101,144,60,40,15,49,68,396,9.0
1942,Willie Mangum\willie-mangum-1,2015-16,Eastern Michigan,G,33,28,810,139,361,.385,74,181,.409,65,180,.361,53,77,.688,10,59,69,54,40,2,68,76,396,5.9
1943,Brandon Better\brandon-better-1,2017-18,Southern Utah,G,31,6,748,123,324,.380,55,147,.374,68,177,.384,82,97,.845,13,61,74,40,29,1,67,66,396,6.6
1944,Lance Tejada\lance-tejada-1,2017-18,Lehigh,G,27,24,796,139,320,.434,62,150,.413,77,170,.453,41,54,.759,11,56,67,54,21,0,49,65,396,8.5
1945,Shep Garner\shep-garner-1,2016-17,Penn State,G,33,29,1058,133,350,.380,51,121,.421,82,229,.358,48,63,.762,13,81,94,78,40,3,61,62,396,7.3
1946,Jarvis Summers\jarvis-summers-1,2014-15,Mississippi,G,33,33,965,122,369,.331,93,251,.371,29,118,.246,123,164,.750,14,47,61,160,28,4,67,68,396,7.4
1947,Brian Bernardi\brian-bernardi-1,2014-15,Hofstra,G,34,34,1162,127,303,.419,32,68,.471,95,235,.404,47,55,.855,5,99,104,58,32,7,39,58,396,8.2
1948,Trae Anderson\trae-anderson-1,2014-15,Eastern Illinois,G,30,16,749,148,307,.482,132,265,.498,16,42,.381,84,129,.651,55,93,148,55,24,18,70,86,396,8.6
1949,Javan Felix\javan-felix-1,2013-14,Texas,G,34,20,892,139,388,.358,78,210,.371,61,178,.343,57,75,.760,13,47,60,94,30,0,46,70,396,6.4
1950,Rayvonte Rice\rayvonte-rice-1,2014-15,Illinois,G,24,19,721,130,276,.471,86,175,.491,44,101,.436,92,114,.807,32,123,155,44,43,7,31,64,396,13.6
1951,Edward Stephens\edward-stephens-1,2014-15,South Carolina State,G,33,28,887,134,329,.407,71,154,.461,63,175,.360,65,87,.747,24,69,93,58,38,0,51,53,396,7.7
1952,Shake Milton\malik-milton-1,2017-18,Southern Methodist,G,22,22,800,123,274,.449,67,145,.462,56,129,.434,94,111,.847,14,89,103,96,31,14,50,38,396,14.8
1953,Diante Baldwin\diante-baldwin-1,2015-16,North Carolina-Greensboro,G,34,34,1128,144,349,.413,122,279,.437,22,70,.314,86,130,.662,54,114,168,169,50,12,78,86,396,9.6
1954,Jalen Jones\jalen-jones-2,2016-17,Texas-Arlington,G,32,32,821,145,310,.468,94,170,.553,51,140,.364,55,72,.764,51,78,129,37,31,6,34,40,396,9.4
1955,Kahron Ross\kahron-ross-1,2017-18,Lehigh,G,30,30,983,147,293,.502,109,204,.534,38,89,.427,63,87,.724,16,74,90,127,42,5,55,63,395,10.9
1956,Tevin Foster\tevin-foster-1,2017-18,Abilene Christian,G,32,30,1037,122,291,.419,76,146,.521,46,145,.317,105,131,.802,20,79,99,112,47,4,84,74,395,8.8
1957,Eyassu Worku\eyassu-worku-1,2017-18,UC-Irvine,G,35,28,999,147,386,.381,114,280,.407,33,106,.311,68,90,.756,23,84,107,130,40,1,77,55,395,7.1
1958,T.J. Carpenter\tj-carpenter-1,2015-16,Nicholls State,G,33,33,961,125,350,.357,64,149,.430,61,201,.303,84,117,.718,31,145,176,83,32,7,93,102,395,6.5
1959,Tyrone Wallace\tyrone-wallace-1,2013-14,University of California,G,35,33,1090,141,328,.430,98,194,.505,43,134,.321,70,112,.625,35,110,145,95,44,16,55,95,395,8.3
1960,Deon Lyle\deon-lyle-1,2017-18,Texas-San Antonio,G,35,6,687,136,327,.416,40,89,.449,96,238,.403,27,43,.628,29,100,129,12,9,4,35,72,395,6.3
1961,Paris Austin\paris-austin-1,2016-17,Boise State,G,32,18,913,131,267,.491,124,234,.530,7,33,.212,126,165,.764,13,94,107,90,19,2,72,62,395,8.4
1962,Ike Iroegbu\ike-iroegbu-1,2015-16,Washington State,G,31,31,952,139,307,.453,106,212,.500,33,95,.347,84,109,.771,17,88,105,112,27,3,86,60,395,8.4
1963,T.J. McConnell\tj-mcconnell-1,2014-15,Arizona,G,38,38,1158,156,313,.498,131,235,.557,25,78,.321,58,70,.829,25,121,146,238,83,3,78,68,395,11.4
1964,Mustafaa Jones\mustafaa-jones-1,2014-15,Fairleigh Dickinson,G,29,29,933,125,325,.385,49,120,.408,76,205,.371,69,79,.873,7,50,57,55,42,2,63,59,395,7.9
1965,Bryce Jones\bryce-jones-2,2015-16,Murray State,G,31,28,989,118,303,.389,81,193,.420,37,110,.336,122,140,.871,19,104,123,131,38,14,86,96,395,9.1
1966,Kerwin Roach Jr.\kerwin-roachjr-1,2017-18,Texas,G,32,31,1070,140,320,.438,96,199,.482,44,121,.364,71,109,.651,26,93,119,115,47,8,79,81,395,8.7
1967,Justin Bibbins\justin-bibbins-1,2015-16,Cal State Long Beach,G,33,31,1026,115,262,.439,62,141,.440,53,121,.438,112,131,.855,13,91,104,164,36,0,65,89,395,10.2
1968,Dylan Garrity\dylan-garrity-1,2013-14,Sacramento State,G,30,30,1014,123,264,.466,48,105,.457,75,159,.472,74,89,.831,8,44,52,107,16,1,56,68,395,9.4
1969,Kellon Thomas\kellon-thomas-1,2015-16,Kent State,G,32,32,1007,122,327,.373,77,184,.418,45,143,.315,106,146,.726,10,58,68,82,20,1,47,76,395,7.0
1970,David Crisp\david-crisp-1,2017-18,Washington,G,34,33,1176,135,355,.380,81,166,.488,54,189,.286,71,107,.664,16,74,90,106,43,2,83,61,395,6.8
1971,Kerry Hammonds\kerry-hammonds-1,2013-14,Middle Tennessee,G,32,30,1013,114,284,.401,47,111,.423,67,173,.387,100,124,.806,12,101,113,85,26,20,52,63,395,9.2
1972,Greg Tucker\greg-tucker-3,2016-17,Jacksonville State,G,35,31,1064,115,324,.355,46,128,.359,69,196,.352,96,118,.814,13,56,69,82,19,2,63,67,395,6.3
1973,Souley Boum\souley-boum-1,2017-18,San Francisco,G,36,12,732,113,311,.363,66,181,.365,47,130,.362,121,146,.829,21,74,95,37,19,5,62,60,394,5.9
1974,Andre Fox\andre-fox-1,2016-17,High Point,G,31,28,914,122,310,.394,84,202,.416,38,108,.352,112,142,.789,31,99,130,67,26,19,68,63,394,8.3
1975,Nelson Kirksey\nelson-kirksey-1,2013-14,Missouri-Kansas City,G,30,28,881,132,286,.462,101,198,.510,31,88,.352,99,136,.728,39,112,151,67,40,2,85,104,394,8.5
1976,Calaen Robinson\calaen-robinson-1,2016-17,Portland State,G,31,30,1080,132,315,.419,66,123,.537,66,192,.344,64,82,.780,13,89,102,126,73,1,80,89,394,9.7
1977,Jon Severe\jon-severe-1,2016-17,Iona,G,35,27,927,135,300,.450,74,156,.474,61,144,.424,63,74,.851,25,105,130,76,24,3,67,73,394,7.6
1978,Frank Jackson\frank-jackson-2,2016-17,Duke,G,36,16,895,133,281,.473,82,152,.539,51,129,.395,77,102,.755,23,67,90,61,21,2,49,85,394,7.2
1979,Dominic Artis\dominic-artis-1,2015-16,Texas-El Paso,G,33,30,1064,138,342,.404,97,218,.445,41,124,.331,77,117,.658,27,141,168,170,40,8,69,72,394,9.8
1980,Rasheem Dunn\rasheem-dunn-1,2016-17,St. Francis (NY),G,30,10,897,129,333,.387,105,224,.469,24,109,.220,112,162,.691,44,109,153,49,43,3,52,63,394,8.6
1981,Armel Potter\armel-potter-1,2016-17,Charleston Southern,G,31,30,983,142,313,.454,114,222,.514,28,91,.308,82,139,.590,14,66,80,99,27,3,53,56,394,8.4
1982,Ian Chiles\ian-chiles-2,2013-14,IUPUI,G,25,22,827,149,356,.419,116,251,.462,33,105,.314,63,93,.677,14,67,81,44,24,11,47,45,394,8.8
1983,Jeremy Senglin\jeremy-senglin-1,2014-15,Weber State,G,24,22,845,115,276,.417,70,146,.479,45,130,.346,119,152,.783,13,65,78,84,27,1,63,53,394,11.0
1984,Antonius Cleveland\antonius-cleveland-1,2015-16,Southeast Missouri State,G,26,24,817,150,343,.437,142,297,.478,8,46,.174,86,141,.610,62,109,171,61,42,15,60,72,394,10.6
1985,Darion Rackley\darion-rackley-1,2013-14,Jacksonville State,G,30,18,835,108,272,.397,78,162,.481,30,110,.273,148,198,.747,26,58,84,61,36,10,62,68,394,8.6
1986,Marcus Shaver\marcus-shaver-1,2017-18,Portland,G,32,21,908,135,326,.414,102,202,.505,33,124,.266,91,106,.858,7,98,105,75,32,1,50,72,394,8.0
1987,Andrew Andrews\andrew-andrews-1,2013-14,Washington,G,32,32,966,125,328,.381,93,215,.433,32,113,.283,112,141,.794,29,95,124,83,37,2,52,78,394,8.3
1988,Conner Toolson\conner-toolson-1,2016-17,Utah Valley,G,33,25,886,134,323,.415,79,150,.527,55,173,.318,70,94,.745,23,106,129,52,35,10,58,90,393,7.4
1989,Chance Murray\chance-murray-1,2017-18,UC-Riverside,G,31,28,1056,131,381,.344,92,241,.382,39,140,.279,92,134,.687,24,142,166,119,55,7,79,58,393,8.5
1990,Sean Hoehn\sean-hoehn-1,2017-18,Sacred Heart,G,30,30,1003,132,333,.396,83,176,.472,49,157,.312,80,101,.792,20,89,109,126,42,4,78,74,393,9.0
1991,Antwan Scott\antwan-scott-2,2013-14,Grambling,G,25,22,839,123,282,.436,76,162,.469,47,120,.392,100,124,.806,23,89,112,92,32,1,91,59,393,10.4
1992,Zach Johnson\zach-johnson-2,2016-17,Florida Gulf Coast,G,33,32,967,136,356,.382,82,199,.412,54,157,.344,67,106,.632,18,75,93,102,45,12,88,77,393,6.8
1993,Billy Garrett\billy-garrett-1,2014-15,DePaul,G,32,32,961,100,252,.397,65,145,.448,35,107,.327,158,190,.832,4,74,78,126,22,8,74,90,393,8.6
1994,Trae Bell-Haynes\trae-bell-haynes-1,2016-17,Vermont,G,35,35,965,139,288,.483,120,233,.515,19,55,.345,96,132,.727,25,69,94,136,38,4,64,76,393,8.9
1995,Devonta White\devonta-white-1,2013-14,Georgia State,G,34,33,1120,127,283,.449,104,218,.477,23,65,.354,116,144,.806,10,83,93,147,38,0,58,72,393,9.4
1996,Jaire Grayer\jaire-grayer-1,2017-18,George Mason,G,32,31,983,143,360,.397,76,171,.444,67,189,.354,40,55,.727,57,175,232,41,41,26,49,68,393,9.3
1997,Joe Kilgore\joe-kilgore-1,2016-17,Texas A&M-Corpus Christi,G,36,34,1176,148,332,.446,123,248,.496,25,84,.298,71,88,.807,27,119,146,102,36,22,85,91,392,7.4
1998,Marcus Colbert\marcus-colbert-1,2014-15,Montana State,G,30,21,905,128,301,.425,78,183,.426,50,118,.424,86,113,.761,23,71,94,140,26,1,93,79,392,8.6
1999,Josh Freelove\josh-freelove-2,2013-14,Buffalo,G,29,29,868,143,314,.455,71,139,.511,72,175,.411,34,45,.756,15,47,62,32,17,9,33,56,392,8.3
2000,Devante Wallace\devante-wallace-1,2013-14,High Point,G,31,25,873,129,284,.454,51,125,.408,78,159,.491,56,63,.889,40,102,142,37,26,26,33,65,392,10.1
2001,Mike Williams\mike-williams-9,2015-16,Rutgers,G,32,28,867,128,337,.380,78,179,.436,50,158,.316,86,108,.796,32,80,112,36,33,14,49,71,392,7.4
2002,Chauncey Collins\chauncey-collins-1,2015-16,Texas Christian,G,32,24,992,105,271,.387,39,104,.375,66,167,.395,116,148,.784,17,79,96,63,25,3,65,85,392,7.5
2003,Deion Holmes\deion-holmes-1,2015-16,South Carolina Upstate,G,32,29,802,137,378,.362,83,210,.395,54,168,.321,64,80,.800,32,50,82,45,19,5,67,72,392,5.4
2004,Burak Eslik\burak-eslik-1,2015-16,Southern Illinois-Edwardsville,G,28,28,910,108,282,.383,63,149,.423,45,133,.338,131,155,.845,11,62,73,37,13,0,44,44,392,8.3
2005,Zack Denny\zack-denny-1,2016-17,Bowling Green State,G,31,26,853,138,336,.411,98,211,.464,40,125,.320,76,94,.809,30,124,154,34,61,11,41,59,392,9.4
2006,Aakim Saintil\aakim-saintil-1,2015-16,Long Island University,G,31,25,906,112,304,.368,78,174,.448,34,130,.262,134,166,.807,12,57,69,146,46,1,90,104,392,8.2
2007,Kevin Vannatta\kevin-vannatta-1,2015-16,North Carolina-Asheville,G,34,34,1157,125,247,.506,88,149,.591,37,98,.378,105,132,.795,23,119,142,91,42,4,59,60,392,9.9
2008,Donte Ingram\donte-ingram-1,2016-17,Loyola (IL),G,29,29,945,144,273,.527,90,155,.581,54,118,.458,50,74,.676,37,161,198,39,27,6,37,52,392,11.2
2009,Dmitri Thompson\dmitri-thompson-1,2017-18,Elon,G,32,30,1014,133,293,.454,84,165,.509,49,128,.383,77,102,.755,37,134,171,72,22,6,50,53,392,9.4
2010,Dorian Pickens\dorian-pickens-1,2016-17,Stanford,G,31,31,927,123,287,.429,56,118,.475,67,169,.396,79,107,.738,23,86,109,38,32,3,43,57,392,8.6
2011,Tayler Persons\tayler-persons-1,2014-15,Northern Kentucky,G,30,26,860,146,335,.436,136,281,.484,10,54,.185,90,118,.763,30,107,137,112,33,4,78,76,392,8.8
2012,Cameron Johnson\cameron-johnson-4,2016-17,Pittsburgh,G,33,33,1099,127,283,.449,49,96,.510,78,187,.417,60,74,.811,23,126,149,77,31,11,38,86,392,9.5
2013,Keith Appling\keith-appling-1,2013-14,Michigan State,G,35,32,1102,132,292,.452,98,198,.495,34,94,.362,93,141,.660,13,93,106,156,41,14,74,96,391,8.7
2014,Arlon Harper\arlon-harper-1,2014-15,Charleston Southern,G,30,30,928,139,349,.398,89,203,.438,50,146,.342,63,93,.677,20,103,123,65,53,12,46,65,391,9.0
2015,John Brisco\john-brisco-1,2013-14,Prairie View,G,32,25,809,133,346,.384,83,190,.437,50,156,.321,75,91,.824,26,52,78,50,44,1,47,90,391,7.1
2016,Khwan Fore\khwan-fore-1,2016-17,Richmond,G,35,35,1182,151,298,.507,137,256,.535,14,42,.333,75,122,.615,38,108,146,86,54,13,62,105,391,8.6
2017,JaQuan Lyle\jaquan-lyle-1,2015-16,Ohio State,G,35,31,1040,133,335,.397,102,212,.481,31,123,.252,94,132,.712,23,141,164,147,35,10,104,59,391,7.7
2018,Yunus Hopkinson\yunus-hopkinson-1,2015-16,St. Francis (NY),G,32,24,922,118,345,.342,43,139,.309,75,206,.364,80,95,.842,10,71,81,92,27,0,75,55,391,6.7
2019,Bruce Brown\bruce-brown-2,2016-17,Miami (FL),G,33,29,1053,134,292,.459,101,197,.513,33,95,.347,90,121,.744,48,138,186,106,49,18,67,83,391,10.3
2020,Haanif Cheatham\haanif-cheatham-1,2015-16,Marquette,G,33,33,974,131,268,.489,102,193,.528,29,75,.387,100,122,.820,13,98,111,73,35,1,89,67,391,7.8
2021,Chris Smith\chris-smith-6,2014-15,Utah State,G,31,30,996,128,267,.479,65,134,.485,63,133,.474,72,94,.766,12,107,119,79,21,6,46,66,391,9.5
2022,Rob Poole\rob-poole-1,2014-15,Siena,G,28,26,930,119,301,.395,64,148,.432,55,153,.359,98,117,.838,34,96,130,50,31,5,45,66,391,9.7
2023,Francisco Santiago\francisco-santiago-1,2016-17,Youngstown State,G,34,29,1131,155,331,.468,120,237,.506,35,94,.372,46,60,.767,33,145,178,158,49,13,73,74,391,10.2
2024,Mike Burwell\mike-burwell-1,2013-14,Towson,G,36,36,1080,135,325,.415,90,198,.455,45,127,.354,76,120,.633,36,117,153,85,23,16,75,113,391,6.5
2025,Delbert Love\delbert-love-1,2013-14,Kennesaw State,G,31,20,963,131,319,.411,66,165,.400,65,154,.422,64,92,.696,37,77,114,78,44,0,55,64,391,8.9
2026,Brandon Brown\brandon-brown-4,2015-16,Loyola Marymount,G,31,31,983,144,381,.378,122,303,.403,22,78,.282,81,107,.757,27,47,74,177,44,1,79,52,391,8.8
2027,Stevie Jordan\stevie-jordan-1,2017-18,Rider,G,31,28,1012,142,316,.449,119,233,.511,23,83,.277,84,127,.661,29,88,117,182,50,10,95,73,391,10.2
2028,Charlon Kloof\charlon-kloof-1,2013-14,St. Bonaventure,G,33,33,1103,122,284,.430,94,186,.505,28,98,.286,119,155,.768,16,104,120,164,40,14,75,112,391,9.5
2029,Austin Nehls\austin-nehls-1,2016-17,Central Connecticut State,G,29,29,1047,113,286,.395,45,102,.441,68,184,.370,96,119,.807,29,73,102,45,20,7,41,55,390,9.0
2030,Quinton Forrest\quinton-forrest-1,2016-17,Bethune-Cookman,G,32,27,988,166,311,.534,146,244,.598,20,67,.299,38,73,.521,74,97,171,48,46,4,52,75,390,9.6
2031,Xavier Rathan-Mayes\xavier-rathan-mayes-1,2015-16,Florida State,G,33,31,968,131,321,.408,92,184,.500,39,137,.285,89,115,.774,12,80,92,146,33,0,83,69,390,8.0
2032,Deyshonee Much\deyshonee-much-1,2015-16,Iona,G,30,27,867,128,270,.474,48,91,.527,80,179,.447,54,67,.806,21,84,105,54,34,6,49,67,390,9.6
2033,Nick Garth\nick-garth-1,2015-16,Lamar,G,29,5,734,123,323,.381,57,127,.449,66,196,.337,78,96,.813,22,59,81,75,26,1,53,58,390,8.3
2034,Ryan Bowie\ryan-bowie-1,2014-15,Texas-San Antonio,G,30,30,1013,140,317,.442,78,147,.531,62,170,.365,48,69,.696,59,115,174,57,35,10,43,68,390,10.1
2035,Ike Iroegbu\ike-iroegbu-1,2016-17,Washington State,G,31,30,1061,134,297,.451,101,209,.483,33,88,.375,89,131,.679,26,103,129,112,22,4,65,63,390,9.1
2036,James Sinclair\james-sinclair-1,2013-14,Western Carolina,G,33,33,905,133,335,.397,89,205,.434,44,130,.338,80,97,.825,42,113,155,62,55,9,65,74,390,8.3
2037,Jalan McCloud\jalan-mccloud-1,2017-18,East Tennessee State,G,33,27,869,144,297,.485,113,217,.521,31,80,.388,71,96,.740,15,80,95,114,37,7,79,67,390,8.5
2038,Clarke Rosenberg\clarke-rosenberg-1,2014-15,Chicago State,G,31,23,876,137,345,.397,99,222,.446,38,123,.309,78,116,.672,38,83,121,63,36,12,74,81,390,7.2
2039,Stephen Brown\stephen-brown-2,2016-17,Bucknell,G,35,35,1059,138,301,.458,87,174,.500,51,127,.402,63,93,.677,12,99,111,167,57,3,63,66,390,9.9
2040,Connor Burchfield\connor-burchfield-1,2017-18,William & Mary,G,31,28,945,133,248,.536,44,77,.571,89,171,.520,35,40,.875,7,94,101,58,25,4,47,55,390,9.7
2041,Lavon Long\lavon-long-1,2016-17,Siena,G,31,30,1013,140,268,.522,127,235,.540,13,33,.394,97,128,.758,68,127,195,80,31,24,78,101,390,10.2
2042,Randy Haynes\randy-haynes-1,2017-18,Old Dominion,G,32,31,957,145,375,.387,80,173,.462,65,202,.322,35,51,.686,31,88,119,78,43,8,46,82,390,7.9
2043,Tyrone Garland\tyrone-garland-1,2013-14,La Salle,G,31,24,916,126,380,.332,96,249,.386,30,131,.229,107,145,.738,8,64,72,81,21,6,52,47,389,6.3
2044,Joshua Braun\joshua-braun-1,2017-18,Grand Canyon,G,34,33,999,118,317,.372,54,129,.419,64,188,.340,89,120,.742,47,83,130,48,26,17,49,69,389,7.5
2045,Nick Weatherspoon\nick-weatherspoon-2,2017-18,Mississippi State,G,36,36,1022,149,311,.479,123,222,.554,26,89,.292,65,90,.722,10,95,105,75,33,5,38,63,389,7.8
2046,Darius Jones-Gibson\derius-jones-gibson-1,2014-15,Samford,G,32,32,856,128,264,.485,123,242,.508,5,22,.227,128,204,.627,29,69,98,69,42,3,58,77,389,8.4
2047,Sean O'Brien\sean-obrien-1,2016-17,Southern Illinois,G,33,33,1056,166,336,.494,159,297,.535,7,39,.179,50,92,.543,78,201,279,89,30,8,85,105,389,8.8
2048,Max Yon\max-yon-1,2013-14,Air Force,G,30,30,1038,125,288,.434,89,173,.514,36,115,.313,103,133,.774,26,80,106,75,25,4,73,57,389,8.4
2049,Jordan Dartis\jordan-dartis-1,2016-17,Ohio,G,31,31,1082,118,267,.442,32,72,.444,86,195,.441,67,76,.882,4,109,113,56,39,6,31,54,389,10.0
2050,Paul Watson\paul-watson-1,2013-14,Fresno State,G,39,39,1136,131,295,.444,76,150,.507,55,145,.379,72,98,.735,38,134,172,26,27,31,52,112,389,6.7
2051,Alex Young\alex-young-2,2015-16,UC-Irvine,G,37,37,1114,142,328,.433,100,222,.450,42,106,.396,63,89,.708,24,135,159,162,50,9,59,90,389,9.1
2052,Jaire Grayer\jaire-grayer-1,2016-17,George Mason,G,34,33,1006,142,337,.421,83,183,.454,59,154,.383,45,54,.833,56,127,183,20,25,33,51,80,388,7.7
2053,Paul Jesperson\paul-jesperson-1,2015-16,Northern Iowa,G,36,36,1091,130,305,.426,48,98,.490,82,207,.396,46,52,.885,19,125,144,32,14,9,40,71,388,6.9
2054,Matt Kennedy\matt-kennedy-1,2013-14,Charleston Southern,G,31,31,949,135,264,.511,86,166,.518,49,98,.500,69,76,.908,7,52,59,41,21,4,43,46,388,8.6
2055,Davon Reed\davon-reed-1,2015-16,Miami (FL),G,35,35,1007,129,275,.469,83,155,.535,46,120,.383,84,103,.816,21,122,143,42,27,15,44,72,388,8.1
2056,D'Marcus Simonds\dmarcus-simonds-1,2016-17,Georgia State,G,29,22,787,145,271,.535,129,226,.571,16,45,.356,82,114,.719,32,84,116,58,36,8,77,58,388,9.4
2057,Julian Eleby\julian-eleby-1,2016-17,Virginia Military Institute,G,30,28,960,123,325,.378,53,114,.465,70,211,.332,72,94,.766,24,130,154,66,31,7,64,45,388,8.6
2058,Casey Kasperbauer\casey-kasperbauer-1,2015-16,South Dakota,G,32,32,1065,124,302,.411,53,129,.411,71,173,.410,69,73,.945,6,74,80,67,32,0,31,35,388,8.9
2059,Katin Reinhardt\katin-reinhardt-1,2014-15,Southern California,G,31,22,887,137,361,.380,76,203,.374,61,158,.386,53,65,.815,16,59,75,54,30,5,61,37,388,6.8
2060,Montay Brandon\montay-brandon-1,2014-15,Florida State,G,33,33,1142,133,246,.541,128,225,.569,5,21,.238,117,174,.672,49,134,183,63,36,13,76,59,388,9.4
2061,Jarvis Garrett\jarvis-garrett-1,2015-16,Rhode Island,G,31,31,1063,135,323,.418,91,218,.417,44,105,.419,74,106,.698,29,87,116,146,34,4,75,59,388,9.4
2062,De'Edrick Petty\deedrick-petty-1,2016-17,Alabama A&M,G,29,24,854,104,296,.351,56,130,.431,48,166,.289,131,175,.749,18,70,88,37,10,5,55,57,387,6.9
2063,Neil Watson\neil-watson-1,2013-14,Southern Mississippi,G,36,35,1127,109,282,.387,41,100,.410,68,182,.374,101,110,.918,11,78,89,145,57,0,67,91,387,8.8
2064,Sean O'Brien\sean-obrien-1,2015-16,Southern Illinois,G,32,32,993,156,311,.502,148,271,.546,8,40,.200,67,112,.598,62,130,192,63,28,29,65,80,387,9.1
2065,Nick Lindner\nick-lindner-1,2014-15,Lafayette,G,31,31,994,125,255,.490,96,182,.527,29,73,.397,108,127,.850,13,52,65,162,20,2,62,59,387,10.5
2066,Zach Johnson\zach-johnson-2,2015-16,Florida Gulf Coast,G,35,20,941,141,298,.473,114,227,.502,27,71,.380,78,120,.650,11,78,89,115,31,19,82,83,387,7.4
2067,Duane Notice\duane-notice-1,2014-15,South Carolina,G,33,33,987,127,337,.377,66,169,.391,61,168,.363,72,91,.791,20,67,87,89,29,4,60,61,387,7.2
2068,Jabari Bird\jabari-bird-1,2016-17,University of California,G,27,25,863,140,319,.439,75,140,.536,65,179,.363,42,55,.764,26,101,127,28,18,6,50,52,387,8.7
2069,Tilman Dunbar\tilman-dunbar-1,2015-16,Navy,G,33,33,1033,120,292,.411,98,238,.412,22,54,.407,125,172,.727,16,76,92,127,33,1,82,73,387,7.8
2070,Davon Hayes\davon-hayes-1,2016-17,Southeastern Louisiana,G,32,29,823,131,332,.395,76,179,.425,55,153,.359,70,93,.753,27,94,121,55,27,7,74,62,387,6.8
2071,Ian Dubose\ian-dubose-1,2017-18,Houston Baptist,G,31,30,886,129,318,.406,94,218,.431,35,100,.350,93,150,.620,55,116,171,61,44,12,67,92,386,8.3
2072,Chris McNealy\chris-mcnealy-2,2013-14,UC-Irvine,G,35,35,997,138,315,.438,101,212,.476,37,103,.359,73,106,.689,33,116,149,75,28,9,50,63,386,7.9
2073,Anthony Jackson\anthony-jackson-4,2013-14,Stony Brook,G,31,22,929,134,324,.414,75,163,.460,59,161,.366,59,63,.937,20,56,76,67,21,1,69,72,386,6.9
2074,Katin Reinhardt\katin-reinhardt-1,2015-16,Southern California,G,34,18,913,145,328,.442,85,167,.509,60,161,.373,36,46,.783,22,73,95,48,35,5,48,34,386,7.6
2075,Tahjere McCall\tahjere-mccall-1,2016-17,Tennessee State,G,27,27,868,127,292,.435,118,255,.463,9,37,.243,123,193,.637,42,92,134,139,76,13,99,89,386,11.5
2076,Davell Roby\davell-roby-1,2016-17,Saint Louis,G,33,32,1068,120,298,.403,64,152,.421,56,146,.384,90,123,.732,17,88,105,114,25,6,75,92,386,7.5
2077,Tevon Saddler\tevon-saddler-1,2013-14,North Carolina-Greensboro,G,31,27,865,120,304,.395,119,293,.406,1,11,.091,145,216,.671,36,81,117,89,40,14,120,94,386,6.3
2078,Kasey Shepherd\kasey-shepherd-1,2015-16,Louisiana,G,34,9,778,120,298,.403,57,118,.483,63,180,.350,83,94,.883,17,60,77,60,44,2,51,50,386,7.9
2079,Brian Parker\brian-parker-2,2016-17,Marist,G,30,27,915,129,285,.453,117,248,.472,12,37,.324,116,177,.655,29,149,178,93,23,1,100,66,386,8.0
2080,Jon Davis\jon-davis-1,2015-16,Charlotte,G,33,30,1064,135,313,.431,105,229,.459,30,84,.357,86,117,.735,21,73,94,154,40,8,86,72,386,8.6
2081,Marquis Wright\marquis-wright-2,2014-15,Siena,G,31,31,1134,138,322,.429,125,277,.451,13,45,.289,97,142,.683,50,81,131,157,63,11,78,80,386,10.6
2082,T.J. Wallace\tj-wallace-1,2016-17,Pacific,G,30,30,946,130,326,.399,99,247,.401,31,79,.392,95,123,.772,19,93,112,91,24,4,70,86,386,7.5
2083,Christian Wilson\christian-wilson-1,2015-16,Texas-San Antonio,G,23,17,732,121,314,.385,107,246,.435,14,68,.206,130,178,.730,12,82,94,105,38,4,63,49,386,11.3
2084,Zay Jackson\zay-jackson-1,2014-15,Southeastern Louisiana,G,25,22,915,146,344,.424,107,208,.514,39,136,.287,55,76,.724,10,103,113,115,33,8,100,64,386,9.1
2085,Tyus Battle\tyus-battle-1,2016-17,Syracuse,G,34,25,1044,127,293,.433,67,129,.519,60,164,.366,71,89,.798,10,61,71,58,44,8,39,66,385,8.0
2086,Four McGlynn\four-mcglynn-1,2014-15,Towson,G,32,25,900,104,264,.394,49,117,.419,55,147,.374,122,133,.917,11,60,71,51,11,6,60,57,385,7.2
2087,Jordan Williams\jordan-williams-2,2013-14,North Texas,G,32,23,833,127,316,.402,94,207,.454,33,109,.303,98,128,.766,56,146,202,14,26,15,60,70,385,7.6
2088,Sedrick Barefield\sedrick-barefield-1,2017-18,Utah,G,32,24,934,122,304,.401,64,140,.457,58,164,.354,83,98,.847,8,61,69,80,27,3,56,43,385,7.8
2089,Andris Misters\andris-misters-1,2014-15,Jacksonville,G,32,31,906,122,290,.421,72,159,.453,50,131,.382,91,112,.813,21,97,118,52,34,3,57,52,385,8.2
2090,Elijah Wilson\elijah-wilson-1,2014-15,Coastal Carolina,G,34,27,915,129,328,.393,63,159,.396,66,169,.391,61,86,.709,31,87,118,22,22,6,40,52,385,6.6
2091,Latif Rivers\latif-rivers-1,2013-14,Wagner,G,29,24,807,123,299,.411,83,186,.446,40,113,.354,99,121,.818,18,64,82,57,27,9,53,65,385,8.3
2092,Scoochie Smith\scoochie-smith-1,2015-16,Dayton,G,33,33,1030,122,278,.439,75,155,.484,47,123,.382,94,141,.667,18,97,115,143,42,5,64,63,385,9.7
2093,Josh Hagins\josh-hagins-1,2013-14,Little Rock,G,31,12,876,143,356,.402,95,215,.442,48,141,.340,51,63,.810,19,119,138,114,37,23,71,88,385,8.5
2094,Lenzelle Smith\lenzelle-smith-jr-1,2013-14,Ohio State,G,35,35,1007,129,303,.426,79,152,.520,50,151,.331,77,102,.755,35,142,177,53,27,3,35,59,385,8.3
2095,Nick Lindner\nick-lindner-1,2015-16,Lafayette,G,29,29,941,127,336,.378,86,212,.406,41,124,.331,90,120,.750,12,46,58,115,24,1,60,63,385,8.0
2096,Eric McClellan\eric-mcclellan-1,2015-16,Gonzaga,G,36,36,969,134,282,.475,99,179,.553,35,103,.340,82,105,.781,24,92,116,71,31,9,61,80,385,7.5
2097,Sabri Thompson\sabri-thompson-1,2016-17,Northwestern State,G,29,27,874,128,308,.416,52,131,.397,76,177,.429,53,79,.671,36,90,126,41,26,4,52,41,385,8.7
2098,Quinton Hooker\quinton-hooker-1,2014-15,North Dakota,G,30,30,1025,133,296,.449,108,222,.486,25,74,.338,94,124,.758,24,104,128,127,44,8,67,67,385,10.4
2099,Dainan Swoope\dainan-swoope-1,2017-18,Elon,G,32,31,1065,116,338,.343,52,126,.413,64,212,.302,89,108,.824,9,90,99,126,32,8,70,72,385,7.7
2100,London Perrantes\london-perrantes-1,2015-16,Virginia,G,35,35,1162,123,280,.439,45,120,.375,78,160,.488,61,76,.803,14,91,105,153,37,3,64,45,385,9.5
2101,Lanerryl Johnson\lanerryl-johnson-1,2014-15,Cal State Fullerton,G,31,14,680,126,311,.405,68,176,.386,58,135,.430,75,89,.843,10,38,48,47,23,0,47,57,385,7.0
2102,Matt Bingaya\matt-bingaya-1,2014-15,Southern Mississippi,G,28,26,914,135,309,.437,110,217,.507,25,92,.272,90,132,.682,38,126,164,60,37,15,78,61,385,9.2
2103,Allerik Freeman\allerik-freeman-2,2015-16,Baylor,G,34,34,1021,124,295,.420,74,164,.451,50,131,.382,87,102,.853,23,91,114,57,26,1,45,49,385,7.9
2104,Derrick Walton\derrick-walton-1,2015-16,Michigan,G,33,33,1108,115,305,.377,52,142,.366,63,163,.387,91,112,.813,17,163,180,147,59,3,67,64,384,10.3
2105,Anders Broman\anders-broman-1,2017-18,Winthrop,G,31,31,970,118,278,.424,45,84,.536,73,194,.376,75,88,.852,10,76,86,58,35,4,27,67,384,9.2
2106,Louis Montes\louis-montes-1,2013-14,Sacred Heart,G,30,30,756,130,306,.425,95,202,.470,35,104,.337,89,126,.706,36,106,142,25,8,6,48,96,384,6.9
2107,Joshua Braun\joshua-braun-1,2016-17,Grand Canyon,G,22,21,740,109,245,.445,45,91,.495,64,154,.416,102,127,.803,27,74,101,31,12,8,32,39,384,12.7
2108,Cedrick Lindsay\cedrick-lindsay-1,2013-14,Richmond,G,21,21,727,120,275,.436,97,204,.475,23,71,.324,121,165,.733,16,38,54,85,38,1,46,50,384,13.2
2109,Jayrn Johnson\jayrn-johnson-1,2015-16,Prairie View,G,31,24,806,131,323,.406,76,174,.437,55,149,.369,67,91,.736,26,57,83,34,53,15,55,93,384,7.5
2110,Joe Sherburne\joe-sherburne-1,2017-18,Maryland-Baltimore County,G,36,29,1046,144,318,.453,67,131,.511,77,187,.412,19,29,.655,28,112,140,67,30,11,32,71,384,8.1
2111,Matt Thomas\matt-thomas-2,2015-16,Iowa State,G,35,27,1176,129,293,.440,40,87,.460,89,206,.432,37,41,.902,17,138,155,61,29,8,42,73,384,8.2
2112,Rodney Purvis\rodney-purvis-1,2014-15,Connecticut,G,33,24,947,144,336,.429,90,186,.484,54,150,.360,42,78,.538,10,68,78,40,27,5,62,60,384,5.8
2113,Kyle Anderson\kyle-anderson-2,2013-14,Delaware,G,35,35,1216,125,317,.394,40,91,.440,85,226,.376,49,63,.778,30,99,129,32,29,11,29,91,384,7.2
2114,Danuel House\danuel-house-1,2014-15,Texas A&M,G,26,23,845,125,300,.417,63,145,.434,62,155,.400,72,112,.643,22,76,98,55,17,16,50,42,384,9.5
2115,Kareem Canty\kareem-canty-1,2015-16,Auburn,G,21,21,721,126,314,.401,57,123,.463,69,191,.361,63,85,.741,5,57,62,111,16,0,62,40,384,11.5
2116,Rob Lewis\rob-lewis-2,2013-14,Houston Baptist,G,30,12,755,120,293,.410,88,199,.442,32,94,.340,112,154,.727,15,69,84,73,23,1,56,60,384,7.9
2117,Torin Dorn\torin-dorn-1,2014-15,Charlotte,G,32,16,880,147,291,.505,120,212,.566,27,79,.342,63,96,.656,25,92,117,40,20,4,59,37,384,7.8
2118,Duane Wilson\duane-wilson-1,2015-16,Marquette,G,33,15,939,131,307,.427,77,151,.510,54,156,.346,68,104,.654,10,75,85,84,43,6,67,76,384,7.4
2119,Billy Garrett\billy-garrett-1,2013-14,DePaul,G,31,25,911,107,292,.366,70,176,.398,37,116,.319,132,160,.825,12,62,74,93,29,3,68,93,383,7.4
2120,Erick Neal\erick-neal-1,2016-17,Texas-Arlington,G,36,33,1137,129,325,.397,61,134,.455,68,191,.356,57,82,.695,21,104,125,236,62,3,126,86,383,8.7
2121,Denzel Gregg\denzel-gregg-1,2016-17,St. Bonaventure,G,32,32,1018,156,315,.495,155,304,.510,1,11,.091,70,112,.625,93,153,246,34,14,55,63,101,383,9.1
2122,Terone Johnson\terone-johnson-1,2013-14,Purdue,G,32,31,961,139,344,.404,102,239,.427,37,105,.352,68,117,.581,39,79,118,77,22,4,47,62,383,7.4
2123,Steve Vasturia\steve-vasturia-1,2014-15,Notre Dame,G,38,38,1235,133,271,.491,73,125,.584,60,146,.411,57,66,.864,18,96,114,65,42,5,45,84,383,7.8
2124,Pat Birt\pat-birt-1,2015-16,Tulsa,G,32,18,848,120,321,.374,42,108,.389,78,213,.366,65,88,.739,18,88,106,25,20,4,32,70,383,6.8
2125,Blake Bozeman\blake-bozeman-1,2014-15,Morgan State,G,31,31,1065,125,356,.351,56,143,.392,69,213,.324,64,91,.703,13,62,75,52,18,0,54,59,383,5.7
2126,Andrew Bock\andrew-bock-1,2013-14,Pacific,G,34,34,957,93,241,.386,61,150,.407,32,91,.352,165,187,.882,17,58,75,96,14,1,51,67,383,8.1
2127,Khalen Cumberlander\khalen-cumberlander-1,2016-17,Central Connecticut State,G,29,29,980,151,326,.463,113,221,.511,38,105,.362,43,98,.439,25,95,120,58,36,5,83,81,383,7.0
2128,Myles Davis\myles-davis-1,2014-15,Xavier,G,36,12,967,109,277,.394,46,113,.407,63,164,.384,102,117,.872,11,77,88,77,32,0,49,67,383,7.4
2129,Michael Qualls\michael-qualls-1,2013-14,Arkansas,G,33,17,810,129,301,.429,87,181,.481,42,120,.350,83,122,.680,54,93,147,64,31,17,51,43,383,8.9
2130,Jalen Brunson\jalen-brunson-1,2015-16,Villanova,G,40,39,959,126,279,.452,77,151,.510,49,128,.383,82,106,.774,18,52,70,100,28,0,72,72,383,6.3
2131,Micheal Warren\michael-warren-1,2015-16,Cal State Northridge,G,30,28,887,120,268,.448,93,189,.492,27,79,.342,115,145,.793,34,88,122,65,40,8,55,91,382,9.3
2132,Tab Hamilton\tabarris-hamilton-1,2013-14,Appalachian State,G,30,29,958,139,382,.364,83,207,.401,56,175,.320,48,62,.774,32,46,78,36,36,3,48,56,382,6.5
2133,Hunter Ware\hunter-ware-1,2015-16,Bryant,G,30,29,977,141,341,.413,80,175,.457,61,166,.367,39,59,.661,19,78,97,44,38,5,63,77,382,6.9
2134,Gerdarius Troutman\gerdarius-troutman-1,2017-18,Florida Atlantic,G,31,15,841,122,292,.418,47,111,.423,75,181,.414,63,72,.875,14,64,78,35,27,4,23,25,382,8.8
2135,Sam Cassell\sam-cassell-2,2016-17,Iona,G,35,28,1056,125,329,.380,46,112,.411,79,217,.364,53,64,.828,11,99,110,105,30,2,49,49,382,7.7
2136,Daniel Fowler\daniel-fowler-1,2016-17,Furman,G,35,35,1051,127,296,.429,85,174,.489,42,122,.344,86,109,.789,51,100,151,129,36,6,68,78,382,9.0
2137,Angel Rodriguez\angel-rodriguez-1,2014-15,Miami (FL),G,32,29,906,110,326,.337,62,168,.369,48,158,.304,114,153,.745,14,61,75,126,59,9,74,89,382,7.9
2138,Dominique Matthews\dominique-matthews-1,2016-17,Illinois-Chicago,G,35,14,758,127,312,.407,66,143,.462,61,169,.361,67,89,.753,22,82,104,41,22,4,52,64,382,6.3
2139,DJ Miles\dj-miles-1,2016-17,Northern Colorado,G,29,14,792,118,298,.396,42,107,.393,76,191,.398,70,90,.778,10,61,71,35,13,1,53,64,382,6.8
2140,Michael Alvarado\michael-alvarado-1,2013-14,Manhattan,G,32,32,804,117,261,.448,103,216,.477,14,45,.311,134,203,.660,16,73,89,127,43,4,76,70,382,8.8
2141,Anthony McDonald\anthony-mcdonald-1,2013-14,Mississippi Valley State,G,32,31,906,118,304,.388,44,98,.449,74,206,.359,71,90,.789,14,51,65,45,24,1,59,49,381,6.6
2142,Jordan Dartis\jordan-dartis-1,2017-18,Ohio,G,29,29,886,124,288,.431,46,104,.442,78,184,.424,55,65,.846,12,91,103,62,34,4,40,58,381,9.6
2143,Otis Livingston II\otis-livingstonii-1,2015-16,George Mason,G,32,32,1097,124,318,.390,78,188,.415,46,130,.354,87,114,.763,10,72,82,114,23,0,69,56,381,7.4
2144,Lamonte Turner\lamonte-turner-1,2017-18,Tennessee,G,35,0,885,118,296,.399,48,119,.403,70,177,.395,75,85,.882,19,92,111,78,24,2,43,70,381,7.6
2145,Josh Richardson\josh-richardson-2,2013-14,Tennessee,G,37,36,1124,139,293,.474,105,193,.544,34,100,.340,69,87,.793,29,77,106,56,27,30,37,79,381,7.7
2146,Jon Elmore\jon-elmore-1,2015-16,Marshall,G,25,25,866,111,295,.376,50,118,.424,61,177,.345,98,122,.803,19,66,85,145,19,3,64,64,381,11.0
2147,Austin Loop\austin-loop-1,2016-17,Marshall,G,35,34,1092,119,265,.449,7,11,.636,112,254,.441,31,36,.861,13,55,68,41,25,10,18,54,381,8.2
2148,Marquan Botley\marquan-botley-1,2014-15,Florida Atlantic,G,29,29,949,127,348,.365,76,193,.394,51,155,.329,76,96,.792,13,51,64,112,13,1,59,46,381,7.6
2149,Jerry Evans\jerry-evans-1,2013-14,Nevada,G,31,30,995,131,309,.424,87,186,.468,44,123,.358,75,94,.798,56,137,193,19,26,17,37,76,381,8.8
2150,Isaac Hamilton\isaac-hamilton-1,2014-15,UCLA,G,36,36,1222,139,340,.409,80,188,.426,59,152,.388,44,64,.688,38,84,122,116,32,6,83,83,381,6.8
2151,Lamar Morgan\lamar-morgan-1,2017-18,Coppin State,G,31,31,964,118,308,.383,30,70,.429,88,238,.370,57,70,.814,13,145,158,13,23,6,52,85,381,6.8
2152,Austin Chatman\austin-chatman-1,2014-15,Creighton,G,33,33,1115,117,316,.370,72,171,.421,45,145,.310,102,126,.810,21,93,114,121,16,2,67,59,381,7.6
2153,Devin Booker\devin-booker-2,2014-15,Kentucky,G,38,0,816,135,287,.470,77,146,.527,58,141,.411,53,64,.828,17,59,76,42,17,2,37,58,381,6.5
2154,Duane Wilson\duane-wilson-1,2014-15,Marquette,G,32,29,899,121,307,.394,72,169,.426,49,138,.355,89,125,.712,13,64,77,68,38,8,59,79,380,7.1
2155,Mikey Thompson\mikey-thompson-1,2015-16,Boise State,G,32,29,1008,122,263,.464,97,194,.500,25,69,.362,111,135,.822,19,70,89,121,35,0,65,49,380,9.5
2156,Cameron Johnson\cameron-johnson-3,2015-16,College of Charleston,G,31,31,1026,136,317,.429,81,174,.466,55,143,.385,53,80,.663,23,86,109,73,36,14,64,93,380,7.7
2157,Cullen Neal\cullen-neal-1,2015-16,New Mexico,G,31,31,936,120,343,.350,67,181,.370,53,162,.327,87,117,.744,11,75,86,114,25,0,101,90,380,5.6
2158,Daniel Simmons\daniel-simmons-1,2017-18,Southeast Missouri State,G,31,13,776,131,284,.461,84,180,.467,47,104,.452,71,105,.676,14,101,115,61,32,3,57,68,380,8.2
2159,Dionte Ferguson\dionte-ferguson-1,2014-15,South Alabama,G,33,33,927,130,240,.542,130,239,.544,0,1,.000,120,162,.741,98,124,222,19,24,51,74,106,380,9.4
2160,Dalan Ancrum\dalan-ancrum-1,2017-18,Western Illinois,G,28,28,892,133,299,.445,85,171,.497,48,128,.375,66,78,.846,23,124,147,51,28,10,62,48,380,9.4
2161,Trevon Duval\trevon-duval-1,2017-18,Duke,G,37,34,1100,148,346,.428,117,239,.490,31,107,.290,53,89,.596,20,53,73,207,54,5,102,89,380,7.5
2162,Jalen Nesbitt\jalen-nesbitt-1,2014-15,North Florida,G,35,35,1136,107,226,.473,78,148,.527,29,78,.372,137,188,.729,55,144,199,118,58,25,84,71,380,10.6
2163,Ray Lee\ray-lee-2,2013-14,Eastern Michigan,G,36,29,780,128,320,.400,88,201,.438,40,119,.336,84,118,.712,11,40,51,56,32,3,74,48,380,5.4
2164,J.T. Escobar\jt-escobar-1,2017-18,North Florida,G,33,31,889,130,285,.456,39,71,.549,91,214,.425,29,33,.879,9,55,64,36,22,2,57,59,380,6.7
2165,E.C. Matthews\ec-matthews-1,2017-18,Rhode Island,G,28,26,804,138,322,.429,95,188,.505,43,134,.321,61,84,.726,23,93,116,25,22,14,45,44,380,8.3
2166,Daniel Hamilton\daniel-hamilton-1,2014-15,Connecticut,G,35,35,1100,139,366,.380,93,232,.401,46,134,.343,56,84,.667,37,230,267,128,33,13,81,86,380,8.0
2167,Jordan Jackson\jordan-jackson-1,2013-14,Northern Kentucky,G,28,26,792,117,248,.472,113,230,.491,4,18,.222,141,212,.665,34,107,141,82,41,14,65,71,379,10.5
2168,Tim Quarterman\tim-quarterman-1,2014-15,Louisiana State,G,33,14,1105,125,293,.427,85,165,.515,40,128,.313,89,124,.718,50,123,173,133,47,19,80,84,379,9.7
2169,Fred VanVleet\fred-van-vleet-1,2015-16,Wichita State,G,31,31,900,119,305,.390,76,192,.396,43,113,.381,98,120,.817,11,89,100,172,55,3,54,54,379,11.0
2170,Terry Tarpey\terry-tarpey-1,2014-15,William & Mary,G,32,32,1000,133,251,.530,109,181,.602,24,70,.343,89,108,.824,42,226,268,102,58,40,52,74,379,13.2
2171,A.J. Davis\aj-davis-2,2017-18,Central Florida,G,31,31,1023,119,273,.436,89,182,.489,30,91,.330,111,161,.689,60,175,235,67,29,12,65,65,379,9.8
2172,Joshua Braun\joshua-braun-1,2014-15,Grand Canyon,G,32,26,857,134,291,.460,78,144,.542,56,147,.381,55,71,.775,38,119,157,24,27,26,22,59,379,9.4
2173,Chris Martin\chris-martin-3,2015-16,Savannah State,G,32,30,872,119,323,.368,49,113,.434,70,210,.333,71,93,.763,4,84,88,58,21,2,47,57,379,6.7
2174,Ralston Turner\ralston-turner-1,2013-14,North Carolina State,G,36,22,941,126,310,.406,49,103,.476,77,207,.372,50,71,.704,18,73,91,33,21,4,34,93,379,6.0
2175,Joel Hernandez\joel-hernandez-1,2015-16,Long Island University,G,31,30,941,142,315,.451,121,239,.506,21,76,.276,74,117,.632,55,133,188,35,27,8,47,72,379,8.3
2176,Jaylen Fornes\jaylen-fornes-1,2017-18,North Carolina-Wilmington,G,32,30,902,127,289,.439,77,155,.497,50,134,.373,75,100,.750,48,80,128,64,16,6,64,77,379,7.7
2177,Gerry Blakes\gerry-blakes-1,2014-15,Arizona State,G,34,33,866,140,346,.405,101,217,.465,39,129,.302,60,73,.822,20,124,144,60,28,3,80,67,379,6.0
2178,Paris Roberts-Campbell\paris-roberts-campbell-1,2013-14,East Carolina,G,32,32,1095,113,297,.380,59,129,.457,54,168,.321,99,133,.744,25,111,136,89,49,22,61,99,379,8.7
2179,Erik Durham\erik-durham-1,2016-17,Jacksonville State,G,35,34,1172,130,251,.518,55,96,.573,75,155,.484,44,67,.657,47,124,171,67,25,4,43,50,379,9.4
2180,Ernie Duncan\ernie-duncan-1,2015-16,Vermont,G,33,32,926,121,276,.438,37,86,.430,84,190,.442,53,65,.815,13,83,96,85,27,1,65,64,379,7.9
2181,Hakeem Baxter\hakeem-baxter-1,2013-14,Maryland-Eastern Shore,G,27,27,809,110,243,.453,96,201,.478,14,42,.333,144,183,.787,33,68,101,41,19,9,56,66,378,9.3
2182,Jordan Strawberry\jordan-strawberry-1,2016-17,Mercer,G,31,29,909,122,270,.452,71,153,.464,51,117,.436,83,94,.883,16,87,103,132,20,1,58,49,378,9.9
2183,Kris Brewer\kris-brewer-1,2013-14,Kent State,G,32,26,964,123,323,.381,84,199,.422,39,124,.315,93,122,.762,10,88,98,91,31,3,53,74,378,7.4
2184,Marques Townes\marques-townes-1,2015-16,Fairleigh Dickinson,G,33,33,1011,141,295,.478,106,192,.552,35,103,.340,61,88,.693,31,99,130,88,43,3,59,54,378,8.9
2185,Tanner Samson\tanner-samson-1,2015-16,Elon,G,32,32,895,109,267,.408,27,44,.614,82,223,.368,78,100,.780,19,117,136,70,32,15,33,83,378,9.4
2186,Donivine Stewart\donivine-stewart-1,2013-14,Southern Illinois-Edwardsville,G,31,31,1006,132,299,.441,89,184,.484,43,115,.374,71,90,.789,27,65,92,139,50,1,62,52,378,10.2
2187,Marcus Barham\marcus-barham-1,2016-17,Florida A&M,G,30,29,928,125,325,.385,57,145,.393,68,180,.378,60,90,.667,23,85,108,59,33,14,58,68,378,7.6
2188,Kajon Mack\kajon-mack-1,2016-17,Tennessee Tech,G,32,30,967,127,286,.444,91,185,.492,36,101,.356,88,119,.739,46,113,159,90,43,15,60,80,378,9.6
2189,Tim Douglas\tim-douglas-1,2013-14,Portland State,G,32,32,1112,132,346,.382,87,210,.414,45,136,.331,69,88,.784,10,72,82,99,33,0,77,56,378,6.6
2190,George King\george-king-1,2016-17,Colorado,G,34,31,943,139,302,.460,92,177,.520,47,125,.376,53,79,.671,67,163,230,25,16,7,57,72,378,7.7
2191,Ahmed Hill\ahmed-hill-1,2016-17,Virginia Tech,G,33,28,979,124,277,.448,64,118,.542,60,159,.377,70,95,.737,10,97,107,40,8,6,37,74,378,7.1
2192,Davell Roby\davell-roby-1,2017-18,Saint Louis,G,33,33,1067,107,286,.374,51,128,.398,56,158,.354,108,150,.720,11,83,94,62,28,6,55,82,378,6.8
2193,Marcus Graves\marcus-graves-1,2015-16,Sacramento State,G,31,31,1067,127,305,.416,97,197,.492,30,108,.278,94,138,.681,13,107,120,136,49,1,65,95,378,9.1
2194,Curtis Cobb\curtis-cobb-1,2016-17,Fairfield,G,31,24,945,142,355,.400,85,190,.447,57,165,.345,37,61,.607,15,125,140,67,25,15,71,62,378,6.8
2195,Caleb White\caleb-white-1,2016-17,East Carolina,G,32,32,1020,126,328,.384,54,125,.432,72,203,.355,54,66,.818,11,63,74,47,17,10,36,66,378,6.7
2196,LaDarius White\ladarius-white-1,2014-15,Mississippi,G,34,8,807,126,304,.414,68,158,.430,58,146,.397,68,91,.747,13,95,108,45,26,6,52,51,378,6.9
2197,Billy Garrett\billy-garrett-1,2015-16,DePaul,G,30,30,839,116,294,.395,88,193,.456,28,101,.277,118,144,.819,8,80,88,106,20,8,74,80,378,7.7
2198,Mike Talley\mike-talley-1,2013-14,Eastern Michigan,G,37,35,1072,108,313,.345,80,217,.369,28,96,.292,134,186,.720,14,51,65,132,39,2,82,70,378,6.2
2199,Casey Walker\casey-walker-1,2013-14,Delaware State,G,30,19,902,124,327,.379,65,136,.478,59,191,.309,71,100,.710,24,91,115,31,18,10,26,57,378,7.6
2200,Brent Arrington\brent-arrington-1,2014-15,Morehead State,G,34,34,957,121,299,.405,89,200,.445,32,99,.323,104,136,.765,44,87,131,77,65,30,65,107,378,8.6
2201,Brent Arrington\brent-arrington-1,2015-16,Morehead State,G,37,37,1064,132,369,.358,100,249,.402,32,120,.267,82,109,.752,44,83,127,114,65,13,79,117,378,6.6
2202,Dwight Meikle\dwight-meikle-1,2014-15,Hampton,G,29,28,807,153,295,.519,145,268,.541,8,27,.296,63,93,.677,62,156,218,19,23,43,79,89,377,9.0
2203,Troy Caupain\troy-caupain-1,2016-17,Cincinnati,G,36,36,1162,130,328,.396,81,177,.458,49,151,.325,68,99,.687,23,146,169,157,43,12,48,52,377,9.4
2204,Paul Watson\paul-watson-1,2016-17,Fresno State,G,33,33,1064,128,309,.414,83,177,.469,45,132,.341,76,112,.679,36,134,170,44,29,22,75,105,377,6.7
2205,Andrew Jones\andrew-jones-3,2016-17,Texas,G,33,23,920,124,292,.425,81,161,.503,43,131,.328,86,111,.775,15,115,130,117,41,14,81,72,377,8.5
2206,Aaron Anderson\aaron-anderson-3,2013-14,North Dakota,G,34,30,1000,114,249,.458,75,150,.500,39,99,.394,110,137,.803,20,64,84,94,30,0,42,51,377,8.9
2207,Shaquille Boga\shaquille-boga-2,2014-15,Texas-Rio Grande Valley,G,30,28,1035,139,367,.379,96,222,.432,43,145,.297,56,75,.747,12,79,91,108,40,3,68,62,377,7.5
2208,T.J. Wallace\tj-wallace-1,2014-15,Pacific,G,29,28,894,125,313,.399,89,206,.432,36,107,.336,91,123,.740,43,120,163,75,21,2,80,100,377,7.5
2209,Josh Williams\josh-williams-4,2013-14,Lipscomb,G,29,12,769,136,273,.498,94,158,.595,42,115,.365,63,81,.778,41,108,149,39,34,12,43,71,377,10.1
2210,Shivaughn Wiggins\shivaughn-wiggins-1,2015-16,Coastal Carolina,G,30,26,976,106,241,.440,73,153,.477,33,88,.375,132,189,.698,18,72,90,108,45,3,48,53,377,10.5
2211,Cameron Wright\cameron-wright-1,2013-14,Pittsburgh,G,36,36,1111,152,333,.456,142,290,.490,10,43,.233,63,94,.670,26,91,117,92,66,6,52,74,377,8.1
2212,Daniel Fowler\daniel-fowler-1,2017-18,Furman,G,33,32,948,131,280,.468,76,146,.521,55,134,.410,60,72,.833,46,84,130,102,44,7,46,69,377,10.1
2213,Hakeem Rogers\hakeem-rogers-1,2016-17,Tennessee Tech,G,32,13,726,121,318,.381,55,117,.470,66,201,.328,69,93,.742,13,75,88,23,26,1,36,39,377,6.8
2214,DeShone McClure\deshone-mcclure-1,2013-14,Central Arkansas,G,29,25,848,142,313,.454,91,175,.520,51,138,.370,42,80,.525,22,37,59,64,41,18,52,56,377,8.6
2215,Duane Notice\duane-notice-1,2016-17,South Carolina,G,37,37,1210,122,311,.392,53,109,.486,69,202,.342,64,95,.674,31,63,94,86,37,7,52,53,377,7.2
2216,Reginald Gardner\reginald-gardner-1,2017-18,North Carolina Central,G,35,35,1027,122,357,.342,46,123,.374,76,234,.325,57,75,.760,17,45,62,57,13,6,38,60,377,5.4
2217,Bryce Aiken\bryce-aiken-1,2016-17,Harvard,G,26,9,724,117,296,.395,58,127,.457,59,169,.349,84,95,.884,11,47,58,74,21,0,64,62,377,8.4
2218,Daniel Bejarano\daniel-bejarano-1,2014-15,Colorado State,G,33,33,1014,127,359,.354,62,178,.348,65,181,.359,58,84,.690,50,186,236,94,13,20,52,78,377,8.1
2219,Ike Nwamu\ike-nwamu-1,2015-16,Nevada-Las Vegas,G,33,23,828,119,312,.381,57,133,.429,62,179,.346,77,113,.681,20,87,107,55,27,6,58,78,377,6.4
2220,Craig Ponder\craig-ponder-1,2015-16,North Carolina-Wilmington,G,33,23,891,133,300,.443,93,190,.489,40,110,.364,71,103,.689,14,89,103,76,35,6,51,98,377,7.5
2221,Chris Chiozza\chris-chiozza-1,2017-18,Florida,G,34,32,1088,131,314,.417,93,205,.454,38,109,.349,76,94,.809,18,129,147,208,65,4,61,73,376,11.1
2222,Joe Rahon\joe-rahon-1,2015-16,Saint Mary's (CA),G,35,34,1293,147,334,.440,102,211,.483,45,123,.366,37,68,.544,11,146,157,189,45,15,64,68,376,9.6
2223,Dupree McBrayer\dupree-mcbrayer-1,2016-17,Minnesota,G,34,21,947,128,286,.448,91,197,.462,37,89,.416,83,112,.741,9,59,68,93,29,10,51,51,376,7.9
2224,Xavier Moon\xavier-moon-1,2015-16,Morehead State,G,37,21,897,135,284,.475,88,170,.518,47,114,.412,59,78,.756,17,78,95,68,35,4,36,87,376,7.4
2225,Tyson Ward\tyson-ward-1,2017-18,North Dakota State,G,32,26,888,140,301,.465,105,193,.544,35,108,.324,61,80,.763,36,153,189,83,27,10,79,70,376,8.4
2226,Max Hooper\max-hooper-1,2015-16,Oakland,G,35,4,862,117,257,.455,0,0,,117,257,.455,25,26,.962,4,59,63,16,12,3,24,35,376,7.2
2227,Ahmad Thomas\ahmad-thomas-1,2015-16,North Carolina-Asheville,G,34,33,950,157,315,.498,148,285,.519,9,30,.300,53,81,.654,54,169,223,64,71,5,68,96,376,9.1
2228,Dion Nesmith\dion-nesmith-1,2014-15,Hofstra,G,34,7,961,132,294,.449,83,146,.568,49,148,.331,63,76,.829,29,79,108,87,46,1,45,89,376,8.5
2229,Daniel Dixon\daniel-dixon-1,2015-16,William & Mary,G,30,30,890,132,328,.402,62,131,.473,70,197,.355,42,58,.724,9,106,115,54,14,20,43,60,376,7.7
2230,Sama Taku\sama-taku-1,2013-14,Pacific,G,34,31,952,144,357,.403,130,294,.442,14,63,.222,74,98,.755,20,117,137,75,20,1,54,82,376,6.2
2231,John Schoof\john-schoof-1,2013-14,American,G,33,33,1208,124,298,.416,53,116,.457,71,182,.390,57,73,.781,17,82,99,69,16,4,57,62,376,7.0
2232,Kerry Carter\kerry-carter-1,2014-15,Saint Mary's (CA),G,31,31,1041,120,294,.408,46,107,.430,74,187,.396,61,92,.663,29,125,154,46,47,6,56,93,375,8.2
2233,Ben Millaud-Meunier\ben-millaud-meunier-1,2015-16,Saint Francis (PA),G,30,29,816,107,274,.391,27,75,.360,80,199,.402,81,89,.910,11,75,86,54,20,3,40,42,375,8.5
2234,Josh Hagins\josh-hagins-1,2014-15,Little Rock,G,31,8,785,131,313,.419,88,186,.473,43,127,.339,70,84,.833,32,91,123,93,52,5,50,77,375,9.4
2235,Raekwon Miller\raekwon-miller-1,2017-18,North Carolina-Asheville,G,34,19,989,114,238,.479,46,94,.489,68,144,.472,79,103,.767,22,132,154,112,40,4,89,87,375,8.7
2236,Gio McLean\gio-mclean-1,2015-16,Quinnipiac,G,29,29,893,122,342,.357,68,180,.378,54,162,.333,77,99,.778,29,107,136,95,21,1,86,70,375,7.0
2237,Jimmie Taylor\jimmie-taylor-2,2013-14,Rider,G,31,31,935,127,270,.470,82,174,.471,45,96,.469,76,110,.691,35,80,115,72,24,2,61,79,375,8.2
2238,David Nwaba\david-nwaba-1,2015-16,Cal Poly,G,30,27,840,132,286,.462,130,272,.478,2,14,.143,109,175,.623,65,125,190,105,37,14,62,61,375,10.6
2239,Andrien White\adrien-white-1,2017-18,Charlotte,G,25,22,682,118,276,.428,75,143,.524,43,133,.323,96,120,.800,26,95,121,31,42,6,47,73,375,10.3
2240,Deon Mitchell\deon-mitchell-1,2013-14,Northern Iowa,G,31,24,849,128,301,.425,95,204,.466,33,97,.340,86,130,.662,15,56,71,104,29,3,65,68,375,7.6
2241,Jay Bowie\jay-bowie-1,2013-14,Marist,G,31,31,1009,120,284,.423,54,132,.409,66,152,.434,69,85,.812,47,115,162,38,35,9,48,81,375,8.8
2242,Isaac Fleming\isaac-fleming-1,2017-18,East Carolina,G,30,28,962,144,324,.444,121,237,.511,23,87,.264,64,97,.660,39,74,113,144,37,3,107,81,375,8.1
2243,Reveal Chukwujekwu\reveal-chukwujekwu-1,2016-17,Houston Baptist,G,31,31,915,131,288,.455,125,264,.473,6,24,.250,107,130,.823,93,163,256,58,27,7,70,61,375,10.0
2244,Kyron Cartwright\kyron-cartwright-1,2016-17,Providence,G,33,33,1091,132,314,.420,101,234,.432,31,80,.388,80,112,.714,17,100,117,222,36,1,96,67,375,9.3
2245,Rashad Muhammad\rashad-muhammad-1,2014-15,San Jose State,G,27,22,871,119,312,.381,60,148,.405,59,164,.360,78,98,.796,17,71,88,31,18,3,38,48,375,7.9
2246,Sebastian Koch\sebastian-koch-1,2013-14,Elon,G,32,32,1036,130,281,.463,52,97,.536,78,184,.424,37,44,.841,32,126,158,90,18,7,58,57,375,9.2
2247,Aleksa Jugovic\aleksa-jugovic-1,2015-16,Tennessee Tech,G,31,31,982,120,268,.448,49,99,.495,71,169,.420,64,74,.865,3,69,72,89,26,1,48,53,375,8.8
2248,Dainan Swoope\dainan-swoope-1,2016-17,Elon,G,32,21,1014,109,272,.401,48,103,.466,61,169,.361,96,130,.738,20,93,113,89,37,4,54,69,375,8.7
2249,Myles Stephens\myles-stephens-1,2016-17,Princeton,G,30,21,830,146,285,.512,112,199,.563,34,86,.395,49,74,.662,41,97,138,34,20,22,47,45,375,9.2
2250,Nathan Hoover\nathan-hoover-1,2017-18,Wofford,G,34,17,922,125,294,.425,55,121,.455,70,173,.405,54,65,.831,16,73,89,46,22,2,37,40,374,7.3
2251,Devin Morgan Jr.\devin-morganjr-1,2015-16,Delaware State,G,31,25,950,121,331,.366,51,133,.383,70,198,.354,62,78,.795,22,75,97,83,29,0,59,45,374,7.5
2252,Antoine Myers\antoine-myers-1,2013-14,Troy,G,31,31,1056,121,238,.508,121,232,.522,0,6,.000,132,199,.663,45,123,168,80,25,1,64,62,374,9.4
2253,Cameron Michael\cameron-michael-1,2014-15,Northern Colorado,G,29,26,823,128,295,.434,62,127,.488,66,168,.393,52,69,.754,10,73,83,37,20,2,37,67,374,7.7
2254,Antoine Mason\antoine-mason-1,2014-15,Auburn,G,26,21,752,110,264,.417,65,152,.428,45,112,.402,109,150,.727,9,53,62,25,26,1,46,58,374,8.2
2255,Karonn Davis\karonn-davis-1,2017-18,Coppin State,G,32,30,1007,127,371,.342,85,216,.394,42,155,.271,78,100,.780,21,105,126,146,32,3,80,67,374,7.3
2256,Caleb White\caleb-white-1,2015-16,East Carolina,G,30,22,962,128,302,.424,58,118,.492,70,184,.380,48,60,.800,13,81,94,75,23,3,53,57,374,8.1
2257,Jeff Thomas\jeff-thomas-2,2017-18,Georgia State,G,35,30,1111,135,286,.472,73,128,.570,62,158,.392,42,50,.840,25,124,149,41,35,27,32,74,374,8.6
2258,Sam Finley\sam-finley-1,2013-14,UC-Riverside,G,30,8,669,114,283,.403,87,188,.463,27,95,.284,119,151,.788,8,55,63,23,18,6,49,44,374,6.8
2259,Jeffrey Simmons\jeffrey-simmons-1,2014-15,Mississippi Valley State,G,32,17,888,159,364,.437,149,318,.469,10,46,.217,46,73,.630,16,61,77,73,35,0,90,54,374,5.5
2260,John Davis\john-davis-5,2017-18,Furman,G,33,32,915,137,282,.486,93,168,.554,44,114,.386,56,74,.757,14,74,88,85,47,2,47,43,374,9.1
2261,Damiyne Durham\damiyne-durham-1,2015-16,Cal State Bakersfield,G,32,0,706,132,348,.379,43,98,.439,89,250,.356,21,34,.618,18,87,105,23,32,4,30,33,374,7.0
2262,KeVaughn Allen\kevaughn-allen-1,2017-18,Florida,G,34,29,1066,119,330,.361,60,150,.400,59,180,.328,77,85,.906,15,67,82,82,34,16,44,49,374,7.6
2263,Skylar Mays\skylar-mays-1,2017-18,Louisiana State,G,33,30,1026,125,282,.443,78,148,.527,47,134,.351,77,92,.837,17,115,132,97,52,8,56,54,374,9.5
2264,Dominic Magee\dominic-magee-1,2017-18,Southern Mississippi,G,32,26,840,127,285,.446,85,160,.531,42,125,.336,78,121,.645,26,186,212,47,28,5,41,60,374,8.8
2265,Mike Hughes\mike-hughes-1,2017-18,Georgia Southern,G,33,32,1009,105,306,.343,47,126,.373,58,180,.322,106,134,.791,21,129,150,57,34,13,49,78,374,7.5
2266,John Green\john-green-3,2014-15,UC-Santa Barbara,G,33,19,814,153,321,.477,125,245,.510,28,76,.368,40,60,.667,46,89,135,49,14,6,57,108,374,6.5
2267,Miye Oni\miye-oni-1,2016-17,Yale,G,29,28,906,127,287,.443,66,133,.496,61,154,.396,58,74,.784,26,158,184,79,21,32,66,85,373,9.7
2268,Tracy Abrams\tracy-abrams-1,2013-14,Illinois,G,35,35,1054,114,342,.333,84,231,.364,30,111,.270,115,149,.772,16,106,122,112,42,8,67,77,373,6.8
2269,Chris Jenkins\chris-jenkins-3,2015-16,Detroit Mercy,G,31,30,986,117,246,.476,66,128,.516,51,118,.432,88,114,.772,30,146,176,42,31,14,45,82,373,9.5
2270,K.J. Maura\kj-maura-1,2017-18,Maryland-Baltimore County,G,33,30,1159,123,262,.469,59,114,.518,64,148,.432,63,73,.863,20,54,74,166,65,0,64,49,373,11.0
2271,Nimrod Hilliard\nimrod-hilliard-1,2014-15,North Carolina Central,G,31,31,1097,127,263,.483,94,184,.511,33,79,.418,86,99,.869,15,76,91,196,35,15,89,60,373,10.9
2272,Nate Mason\nate-mason-1,2015-16,Minnesota,G,27,27,888,130,334,.389,91,205,.444,39,129,.302,74,93,.796,8,69,77,121,24,1,46,53,373,9.3
2273,Adam Weary\adam-weary-1,2015-16,High Point,G,30,29,835,138,269,.513,120,222,.541,18,47,.383,79,104,.760,28,75,103,94,37,7,50,77,373,10.0
2274,Marlon Stewart\marlon-stewart-1,2017-18,North Dakota,G,32,31,900,120,278,.432,87,169,.515,33,109,.303,100,131,.763,11,74,85,95,42,2,73,80,373,7.8
2275,Steve Santa Ana\steve-santaana-1,2016-17,Elon,G,32,27,939,124,327,.379,53,110,.482,71,217,.327,54,72,.750,20,103,123,72,37,4,42,71,373,7.9
2276,Travon Baker\travon-baker-1,2015-16,Northern Illinois,G,34,34,976,108,291,.371,41,110,.373,67,181,.370,90,118,.763,19,91,110,126,50,1,71,75,373,8.2
2277,Brian Bernardi\brian-bernardi-1,2016-17,Hofstra,G,31,31,1047,113,319,.354,39,111,.351,74,208,.356,73,83,.880,10,67,77,57,15,1,35,40,373,7.2
2278,Darius Gardner\darius-gardner-1,2013-14,American,G,33,33,1222,136,265,.513,109,195,.559,27,70,.386,74,101,.733,40,85,125,138,69,8,95,82,373,9.9
2279,Taariq Cephas\taariq-cephas-1,2014-15,Coppin State,G,31,31,980,132,322,.410,76,176,.432,56,146,.384,52,77,.675,27,81,108,151,46,1,69,67,372,9.3
2280,Brandon Taylor\brandon-taylor-1,2014-15,Utah,G,35,35,1056,121,272,.445,39,85,.459,82,187,.439,48,56,.857,7,83,90,117,45,0,58,54,372,8.7
2281,DeMarcus Gatlin\demarcus-gatlin-1,2014-15,Sam Houston State,G,35,28,818,123,259,.475,107,203,.527,16,56,.286,110,160,.688,61,111,172,69,34,22,46,86,372,8.9
2282,Ty Greene\ty-greene-1,2013-14,South Carolina Upstate,G,26,21,890,114,291,.392,64,139,.460,50,152,.329,94,110,.855,12,66,78,91,27,5,31,51,372,10.7
2283,Victor Joseph\victor-joseph-1,2016-17,Cal Poly,G,31,15,791,123,308,.399,73,168,.435,50,140,.357,76,93,.817,17,39,56,24,24,3,52,78,372,5.9
2284,Jordan Bohannon\jordan-bohannon-1,2016-17,Iowa,G,34,28,1005,118,304,.388,29,90,.322,89,214,.416,47,55,.855,9,67,76,175,29,2,76,55,372,8.4
2285,Duda Sanadze\duda-sanadze-1,2015-16,San Diego,G,29,20,735,133,348,.382,88,192,.458,45,156,.288,61,83,.735,23,92,115,32,25,5,51,66,372,6.6
2286,Lamarr Kimble\lamarr-kimble-1,2016-17,Saint Joseph's,G,24,24,897,127,351,.362,87,226,.385,40,125,.320,78,112,.696,15,82,97,107,20,3,79,39,372,8.4
2287,Michael Ertel\michael-ertel-1,2017-18,Louisiana-Monroe,G,32,26,965,137,315,.435,83,164,.506,54,151,.358,44,66,.667,13,85,98,75,24,1,37,57,372,7.8
2288,Dayon Griffin\dayon-griffin-1,2015-16,Louisiana Tech,G,33,29,959,139,290,.479,83,142,.585,56,148,.378,38,68,.559,20,119,139,57,45,8,45,60,372,8.6
2289,Brandon Boyd\brandon-boyd-1,2016-17,Idaho State,G,30,22,904,116,287,.404,62,150,.413,54,137,.394,86,100,.860,21,60,81,37,41,0,57,68,372,7.6
2290,Sam McDaniel\sam-mcdaniel-1,2016-17,Louisiana-Monroe,G,33,25,956,133,344,.387,98,220,.445,35,124,.282,70,97,.722,47,159,206,48,20,6,65,85,371,6.4
2291,Lovell Cabbil\lovell-cabbil-1,2017-18,Liberty,G,33,30,1070,118,306,.386,70,159,.440,48,147,.327,87,102,.853,14,137,151,123,43,14,69,64,371,8.9
2292,Siler Schneider\siler-schneider-1,2016-17,UC-Davis,G,36,2,836,125,314,.398,78,176,.443,47,138,.341,74,104,.712,20,97,117,72,18,2,84,83,371,5.1
2293,Shawn Williams\shawn-williams-4,2017-18,East Carolina,G,30,14,847,117,289,.405,45,93,.484,72,196,.367,65,74,.878,3,46,49,51,14,0,49,44,371,7.0
2294,Joe Sherburne\joe-sherburne-1,2016-17,Maryland-Baltimore County,G,34,33,931,132,272,.485,64,121,.529,68,151,.450,39,44,.886,32,105,137,53,22,7,38,75,371,8.3
2295,Tekele Cotton\tekele-cotton-1,2013-14,Wichita State,G,36,36,1085,128,283,.452,85,167,.509,43,116,.371,72,104,.692,48,97,145,88,50,11,39,72,371,9.0
2296,Quinton Chievous\quinton-chievous-1,2014-15,Hampton,G,35,23,891,126,288,.438,102,191,.534,24,97,.247,95,154,.617,55,174,229,32,16,3,70,70,371,6.6
2297,Clayton Custer\clayton-custer-1,2016-17,Loyola (IL),G,32,32,1011,129,278,.464,71,140,.507,58,138,.420,55,69,.797,13,64,77,96,33,3,56,75,371,8.3
2298,Kevin Bailey\kevin-bailey-1,2013-14,Portland,G,23,23,680,122,278,.439,93,209,.445,29,69,.420,98,132,.742,27,42,69,50,19,19,55,72,371,9.9
2299,Umar Shannon\umar-shannon-1,2013-14,Quinnipiac,G,26,26,858,111,321,.346,51,155,.329,60,166,.361,89,107,.832,15,37,52,59,15,1,44,57,371,7.5
2300,JaJuan Johnson\jajuan-johnson-2,2016-17,Marquette,G,31,24,806,137,288,.476,105,204,.515,32,84,.381,65,82,.793,20,106,126,83,59,14,71,50,371,9.6
2301,Nick Coppola\nick-coppola-1,2015-16,Louisiana-Monroe,G,34,33,1252,134,336,.399,81,184,.440,53,152,.349,50,79,.633,19,78,97,180,26,2,72,60,371,8.0
2302,John Caleb Sanders\john-caleb-sanders-1,2013-14,Liberty,G,32,31,982,118,292,.404,78,180,.433,40,112,.357,95,120,.792,29,66,95,140,10,0,79,76,371,7.6
2303,Keith Carter\keith-carter-2,2015-16,Valparaiso,G,36,36,1038,127,302,.421,64,142,.451,63,160,.394,54,89,.607,20,100,120,161,58,7,59,80,371,9.0
2304,Justinian Jessup\justinian-jessup-1,2017-18,Boise State,G,32,25,943,125,269,.465,35,72,.486,90,197,.457,31,39,.795,14,137,151,56,43,19,43,70,371,9.5
2305,Hamidou Diallo\hamidou-diallo-1,2017-18,Kentucky,G,37,37,918,134,313,.428,108,236,.458,26,77,.338,77,125,.616,32,102,134,46,28,13,51,96,371,5.9
2306,Jahlil Jenkins\jahlil-jenkins-1,2017-18,Fairleigh Dickinson,G,31,27,1049,134,307,.436,100,198,.505,34,109,.312,69,101,.683,10,73,83,136,38,1,72,47,371,8.7
2307,Demetre Rivers\demetre-rivers-1,2017-18,Mercer,G,34,33,969,125,245,.510,83,126,.659,42,119,.353,79,88,.898,33,77,110,32,18,7,46,61,371,7.9
2308,Ricky Johnson\ricky-johnson-1,2014-15,Bethune-Cookman,G,28,28,892,104,303,.343,67,173,.387,37,130,.285,126,151,.834,15,57,72,67,38,2,63,67,371,7.7
2309,Deion Hammond\deion-hammond-1,2017-18,Monmouth,G,31,23,783,123,299,.411,47,105,.448,76,194,.392,49,73,.671,17,57,74,27,24,6,39,68,371,6.8
2310,Kiefer Douse\kiefer-douse-1,2016-17,Canisius,G,34,33,952,133,265,.502,97,173,.561,36,92,.391,69,95,.726,41,109,150,92,31,4,64,89,371,8.5
2311,Andrew Rowsey\andrew-rowsey-1,2016-17,Marquette,G,32,9,667,106,230,.461,35,71,.493,71,159,.447,88,95,.926,6,52,58,73,21,1,42,66,371,8.6
2312,Joseph Edwards\joseph-edwards-1,2014-15,Purdue-Fort Wayne,G,31,31,987,138,276,.500,98,182,.538,40,94,.426,55,87,.632,30,62,92,69,32,8,56,51,371,8.7
2313,Quinndary Weatherspoon\quinndary-weatherspoon-1,2015-16,Mississippi State,G,31,17,836,133,297,.448,90,188,.479,43,109,.394,62,77,.805,47,99,146,43,42,16,45,75,371,9.1
2314,Teddy Okereafor\teddy-okereafor-1,2014-15,Rider,G,33,33,1121,114,298,.383,65,144,.451,49,154,.318,93,128,.727,26,127,153,133,59,4,84,40,370,9.2
2315,Wesley Alcegaire\wesley-alcegaire-1,2016-17,Bowling Green State,G,32,32,872,138,326,.423,92,189,.487,46,137,.336,48,79,.608,30,76,106,44,21,11,69,87,370,5.8
2316,Jontrell Walker\jontrell-walker-1,2014-15,Incarnate Word,G,27,24,807,119,278,.428,71,147,.483,48,131,.366,84,98,.857,13,46,59,49,25,1,63,45,370,8.1
2317,Jordan Burns\jordan-burns-1,2017-18,Colgate,G,31,19,847,135,313,.431,93,198,.470,42,115,.365,58,76,.763,14,68,82,93,25,3,79,43,370,7.2
2318,Dorian Pickens\dorian-pickens-1,2015-16,Stanford,G,30,19,880,117,280,.418,65,136,.478,52,144,.361,84,114,.737,41,68,109,56,31,4,33,65,370,9.1
2319,Aaric Armstead\aaric-armstead-1,2015-16,Northern Illinois,G,34,34,983,120,321,.374,79,189,.418,41,132,.311,89,133,.669,56,139,195,39,33,17,64,76,370,6.9
2320,Shawn Amiker\shawn-amiker-1,2014-15,Youngstown State,G,32,30,919,140,301,.465,132,276,.478,8,25,.320,82,121,.678,60,123,183,30,20,13,54,97,370,7.4
2321,Jherrod Stiggers\jherrod-stiggers-1,2013-14,Houston,G,33,9,782,123,317,.388,43,95,.453,80,222,.360,44,64,.688,28,56,84,35,11,5,33,57,370,6.3
2322,Four McGlynn\four-mcglynn-1,2015-16,Rhode Island,G,32,31,1074,104,293,.355,28,74,.378,76,219,.347,86,98,.878,7,72,79,45,20,4,46,76,370,6.4
2323,Xavier Bishop\xavier-bishop-1,2017-18,Missouri-Kansas City,G,32,27,952,122,317,.385,77,182,.423,45,135,.333,81,108,.750,16,76,92,105,23,1,61,86,370,6.9
2324,Pierria Henry\pierria-henry-1,2013-14,Charlotte,G,30,28,1013,124,303,.409,93,205,.454,31,98,.316,91,129,.705,41,112,153,175,64,22,99,87,370,10.8
2325,Devonte Brown\devonte-brown-1,2014-15,Indiana State,G,31,31,1020,113,246,.459,87,174,.500,26,72,.361,118,183,.645,13,124,137,101,28,4,103,70,370,7.5
2326,A'Torri Shine\atorri-shine-1,2014-15,Grambling,G,29,29,916,131,337,.389,82,190,.432,49,147,.333,59,80,.738,27,76,103,24,26,5,58,58,370,6.4
2327,Admon Gilder\admon-gilder-1,2017-18,Texas A&M,G,30,29,959,127,277,.458,80,158,.506,47,119,.395,69,84,.821,19,105,124,77,37,5,51,65,370,9.4
2328,Craig Ponder\craig-ponder-1,2014-15,North Carolina-Wilmington,G,32,32,1032,122,292,.418,76,190,.400,46,102,.451,80,117,.684,13,95,108,85,34,5,71,95,370,7.0
2329,Xavier Rathan-Mayes\xavier-rathan-mayes-1,2016-17,Florida State,G,35,35,969,134,296,.453,94,172,.547,40,124,.323,62,117,.530,22,90,112,168,33,4,65,70,370,8.5
2330,J.R. Harris\jr-harris-1,2015-16,Texas-San Antonio,G,31,19,873,118,337,.350,52,139,.374,66,198,.333,68,82,.829,12,65,77,49,27,4,58,79,370,5.7
2331,Ronshad Shabazz\ronshad-shabazz-1,2015-16,Appalachian State,G,31,30,786,127,320,.397,83,200,.415,44,120,.367,72,107,.673,32,80,112,47,20,2,65,48,370,6.4
2332,Glenn Sanabria\glenn-sanabria-1,2016-17,St. Francis (NY),G,30,28,998,119,362,.329,51,157,.325,68,205,.332,63,87,.724,24,39,63,74,37,6,43,70,369,6.8
2333,Anson Winder\anson-winder-1,2014-15,Brigham Young,G,29,8,739,124,260,.477,79,143,.552,45,117,.385,76,105,.724,16,84,100,52,39,6,31,57,369,9.9
2334,Tevonn Walker\tevonn-walker-1,2016-17,Valparaiso,G,31,30,889,120,282,.426,91,182,.500,29,100,.290,100,125,.800,45,130,175,40,41,1,41,91,369,8.8
2335,Manny Arop\mangisto-arop-1,2013-14,Indiana State,G,34,32,962,132,304,.434,85,169,.503,47,135,.348,58,70,.829,34,122,156,40,24,21,54,85,369,7.2
2336,Charles Mann\charles-mann-1,2015-16,Georgia,G,34,34,970,94,237,.397,72,182,.396,22,55,.400,159,228,.697,18,121,139,92,29,1,93,97,369,6.6
2337,Charles Mann\charles-mann-1,2014-15,Georgia,G,33,32,1009,104,260,.400,90,209,.431,14,51,.275,147,220,.668,23,140,163,119,21,4,106,99,369,6.6
2338,Matt Harris\matt-harris-1,2017-18,Massachusetts-Lowell,G,30,30,939,109,277,.394,36,80,.450,73,197,.371,78,90,.867,10,89,99,23,26,2,50,72,369,7.1
2339,Kris Martin\kris-martin-1,2016-17,Oral Roberts,G,27,22,845,117,284,.412,44,104,.423,73,180,.406,62,83,.747,8,91,99,58,34,14,57,64,369,9.0
2340,Rickey McGill\rickey-mcgill-1,2016-17,Iona,G,35,35,1122,132,278,.475,105,198,.530,27,80,.338,78,99,.788,28,106,134,180,62,15,70,88,369,10.4
2341,Shawn Lester\shawn-lester-1,2013-14,Charlotte,G,31,1,757,126,300,.420,77,142,.542,49,158,.310,68,90,.756,19,111,130,48,24,2,76,65,369,6.6
2342,Christavious Gill\christavious-gill-1,2016-17,New Orleans,G,32,31,1018,121,318,.381,61,126,.484,60,192,.313,67,92,.728,11,58,69,87,49,3,61,51,369,7.5
2343,Leron Fisher\leron-fisher-1,2014-15,Longwood,G,34,23,927,114,269,.424,68,155,.439,46,114,.404,94,123,.764,19,74,93,85,65,4,68,78,368,8.2
2344,Riley LaChance\riley-lachance-1,2016-17,Vanderbilt,G,35,34,1090,115,247,.466,45,103,.437,70,144,.486,68,78,.872,7,108,115,137,21,1,67,73,368,8.5
2345,James Miller\james-miller-2,2016-17,Howard,G,25,23,757,129,306,.422,104,209,.498,25,97,.258,85,128,.664,26,58,84,49,38,10,73,63,368,8.2
2346,Michael Perez\michael-perez-1,2013-14,Nevada,G,32,31,1122,128,334,.383,72,165,.436,56,169,.331,56,74,.757,9,112,121,98,16,5,53,63,368,7.1
2347,Tre Lynch\tre-lynch-1,2014-15,Southern,G,30,0,661,125,312,.401,74,160,.463,51,152,.336,67,80,.838,28,80,108,31,25,5,36,41,368,7.9
2348,Georgie Pacheco-Ortiz\georgie-pacheco-ortiz-1,2017-18,Liberty,G,37,37,1131,113,267,.423,69,155,.445,44,112,.393,98,109,.899,13,79,92,93,34,5,57,50,368,7.6
2349,Lonnie Walker\lonnie-walker-2,2017-18,Miami (FL),G,32,18,888,132,318,.415,76,156,.487,56,162,.346,48,65,.738,13,70,83,61,30,15,37,51,368,7.7
2350,Tim Quarterman\tim-quarterman-1,2015-16,Louisiana State,G,33,27,952,118,284,.415,70,144,.486,48,140,.343,84,133,.632,52,101,153,120,32,13,53,79,368,9.2
2351,Jahvaughn Powell\jahvaughn-powell-1,2016-17,Nicholls State,G,31,30,1011,116,285,.407,48,107,.449,68,178,.382,68,80,.850,8,91,99,156,62,3,115,97,368,8.5
2352,Naji Hibbert\naji-hibbert-1,2013-14,Gardner-Webb,G,32,32,962,133,341,.390,75,176,.426,58,165,.352,44,61,.721,15,77,92,72,39,6,36,62,368,7.6
2353,Mike Smith\mike-smith-9,2016-17,Columbia,G,27,27,849,130,324,.401,91,223,.408,39,101,.386,69,84,.821,10,46,56,93,29,0,48,44,368,8.8
2354,John Petty\john-petty-2,2017-18,Alabama,G,36,29,1026,123,313,.393,33,71,.465,90,242,.372,32,45,.711,14,78,92,65,17,9,74,36,368,5.7
2355,Eric Fanning\eric-fanning-1,2014-15,Boston University,G,30,4,640,106,218,.486,82,157,.522,24,61,.393,132,174,.759,21,87,108,44,13,4,55,72,368,8.2
2356,JaMichael Hawkins\jamichael-hawkins-1,2013-14,Southeastern Louisiana,G,30,9,816,117,305,.384,65,156,.417,52,149,.349,82,99,.828,14,64,78,31,21,6,52,39,368,6.8
2357,Christian James\christian-james-1,2017-18,Oklahoma,G,31,31,936,132,288,.458,74,129,.574,58,159,.365,46,60,.767,34,101,135,45,35,1,47,85,368,8.2
2358,De'Monte Buckingham\demonte-buckingham-1,2016-17,Richmond,G,35,23,1042,124,270,.459,78,141,.553,46,129,.357,73,97,.753,44,152,196,79,56,24,70,107,367,8.8
2359,Dennis Mavin\dennis-mavin-1,2013-14,Florida International,G,31,31,1017,111,290,.383,84,202,.416,27,88,.307,118,198,.596,28,94,122,58,51,1,82,70,367,6.7
2360,Jimond Ivey\jimond-ivey-1,2016-17,Akron,G,36,28,1051,127,244,.520,93,143,.650,34,101,.337,79,103,.767,50,158,208,71,41,10,50,90,367,9.2
2361,Tadric Jackson\tadric-jackson-1,2017-18,Georgia Tech,G,29,13,839,149,335,.445,121,237,.511,28,98,.286,41,67,.612,23,83,106,63,26,5,66,63,367,7.1
2362,Jaylen Shaw\jaylen-shaw-1,2015-16,Coastal Carolina,G,33,28,970,143,300,.477,98,187,.524,45,113,.398,36,55,.655,6,71,77,129,28,4,78,69,367,7.5
2363,Sindarius Thornwell\sindarius-thornwell-1,2014-15,South Carolina,G,33,33,1011,114,335,.340,76,193,.394,38,142,.268,101,141,.716,50,111,161,73,43,11,71,83,367,6.9
2364,Justin Mitchell\justin-mitchell-1,2016-17,Wright State,G,32,32,1001,140,262,.534,136,247,.551,4,15,.267,83,131,.634,67,200,267,127,30,17,103,82,367,10.1
2365,Rich Kelly\rich-kelly-1,2017-18,Quinnipiac,G,33,31,1128,122,313,.390,71,152,.467,51,161,.317,72,93,.774,10,65,75,155,23,4,97,64,367,6.9
2366,Carlos Morris\carlos-morris-2,2014-15,Minnesota,G,33,25,846,133,294,.452,101,206,.490,32,88,.364,69,95,.726,22,83,105,70,58,7,69,61,367,8.0
2367,Rhett Harrelson\rhett-harrelson-1,2014-15,Western Carolina,G,31,31,1056,114,297,.384,29,73,.397,85,224,.379,54,73,.740,17,46,63,73,45,2,75,64,367,7.1
2368,Rodney Cooper\rodney-cooper-1,2014-15,Alabama,G,33,33,1040,127,268,.474,78,137,.569,49,131,.374,64,80,.800,35,86,121,52,21,8,55,90,367,7.5
2369,Lucas Woodhouse\lucas-woodhouse-1,2013-14,Longwood,G,32,32,1057,126,305,.413,77,174,.443,49,131,.374,66,81,.815,7,75,82,213,39,5,86,75,367,9.4
2370,Jordan Barham\jordan-barham-1,2014-15,Davidson,G,31,14,671,148,251,.590,140,234,.598,8,17,.471,63,101,.624,66,122,188,34,12,12,33,76,367,9.6
2371,Nathan Moran\nathan-moran-1,2016-17,Lipscomb,G,33,33,851,105,248,.423,15,32,.469,90,216,.417,67,78,.859,9,65,74,138,32,2,72,73,367,8.7
2372,DeMarcus Robinson\demarcus-robinson-1,2013-14,Alabama State,G,32,26,899,123,336,.366,78,169,.462,45,167,.269,76,98,.776,21,45,66,53,24,3,39,38,367,6.5
2373,Nick Russell\nick-russell-1,2013-14,Southern Methodist,G,37,36,1203,118,292,.404,84,197,.426,34,95,.358,97,121,.802,9,118,127,119,38,9,90,89,367,6.6
2374,Sam Prescott\sam-prescott-1,2013-14,Mount St. Mary's,G,33,32,1026,133,319,.417,92,192,.479,41,127,.323,60,76,.789,44,121,165,57,37,8,54,88,367,7.6
2375,David Walker\david-walker-3,2013-14,Northeastern,G,32,32,1166,132,323,.409,84,175,.480,48,148,.324,55,74,.743,21,79,100,84,50,13,62,31,367,8.4
2376,Joe Rosga\joe-rosga-1,2015-16,Denver,G,29,29,964,115,240,.479,78,145,.538,37,95,.389,100,113,.885,17,54,71,65,41,1,50,53,367,9.8
2377,Jaylon Brown\jaylon-brown-1,2015-16,Evansville,G,34,34,1024,129,254,.508,113,202,.559,16,52,.308,92,127,.724,13,71,84,99,37,4,65,82,366,7.9
2378,Sammy Mojica\sammy-mojica-1,2017-18,Drexel,G,33,33,1174,128,339,.378,66,145,.455,62,194,.320,48,74,.649,44,88,132,48,48,11,47,69,366,7.3
2379,Kevin Bailey\kevin-bailey-1,2014-15,Portland,G,25,23,674,123,296,.416,93,210,.443,30,86,.349,90,111,.811,8,55,63,47,13,12,54,66,366,7.8
2380,Kaelon Wilson\kaelon-wilson-1,2017-18,Texas-Arlington,G,32,29,977,117,291,.402,75,195,.385,42,96,.438,90,138,.652,45,91,136,63,17,2,58,71,366,7.0
2381,Ghiavonni Robinson\ghiavonni-robinson-1,2015-16,Arkansas-Pine Bluff,G,33,31,1044,126,383,.329,64,154,.416,62,229,.271,52,83,.627,23,83,106,67,46,3,82,75,366,4.8
2382,Deron Powers\deron-powers-1,2013-14,Hampton,G,31,31,976,115,299,.385,87,203,.429,28,96,.292,108,129,.837,28,69,97,123,31,2,84,80,366,7.6
2383,Jacob Gilyard\jacob-gilyard-1,2017-18,Richmond,G,32,32,1166,126,279,.452,68,128,.531,58,151,.384,56,67,.836,15,54,69,130,89,1,54,56,366,10.9
2384,Lorenzo Bonam\lorenzo-bonam-1,2015-16,Utah,G,36,33,959,139,271,.513,117,216,.542,22,55,.400,66,81,.815,22,95,117,107,35,19,60,60,366,8.6
2385,Devon Agusi\devon-agusi-1,2013-14,Texas-San Antonio,G,30,26,830,108,248,.435,87,183,.475,21,65,.323,129,175,.737,30,62,92,70,34,1,90,84,366,7.2
2386,Josh Ritchart\josh-ritchart-1,2014-15,UC-Davis,G,31,30,745,135,273,.495,71,133,.534,64,140,.457,32,43,.744,32,96,128,24,12,13,36,72,366,8.0
2387,Will Tavares\will-tavares-1,2017-18,Fordham,G,27,27,893,140,321,.436,118,222,.532,22,99,.222,64,99,.646,33,111,144,32,31,8,63,55,366,7.9
2388,Rodney Simeon\rodney-simeon-1,2016-17,Alabama State,G,30,25,771,119,328,.363,46,106,.434,73,222,.329,55,77,.714,37,95,132,28,19,10,63,72,366,6.1
2389,Omega Harris\omega-harris-1,2017-18,Texas-El Paso,G,31,30,1013,127,285,.446,81,162,.500,46,123,.374,66,87,.759,5,111,116,63,30,5,48,68,366,8.0
2390,Michael Craig\michael-craig-1,2013-14,Southern Mississippi,G,33,24,805,142,237,.599,141,236,.597,1,1,1.000,81,130,.623,76,171,247,76,41,10,79,94,366,9.9
2391,Jacolby Mobley\jacolby-mobley-1,2015-16,Tennessee-Martin,G,34,6,855,122,297,.411,57,108,.528,65,189,.344,57,69,.826,18,66,84,54,25,5,51,72,366,6.5
2392,Khalil Small\khalil-small-1,2015-16,Green Bay,G,36,28,859,131,287,.456,90,186,.484,41,101,.406,63,89,.708,56,73,129,39,34,10,47,104,366,6.9
2393,De'Monte Buckingham\demonte-buckingham-1,2017-18,Richmond,G,30,30,951,120,274,.438,85,166,.512,35,108,.324,91,117,.778,49,161,210,103,31,11,80,72,366,9.9
2394,Duane Notice\duane-notice-1,2015-16,South Carolina,G,34,8,936,115,296,.389,47,125,.376,68,171,.398,68,91,.747,26,56,82,78,32,1,35,55,366,7.7
2395,Myles Davis\myles-davis-1,2015-16,Xavier,G,34,33,991,110,276,.399,46,108,.426,64,168,.381,82,96,.854,18,106,124,139,32,5,64,71,366,8.7
2396,Bryant McIntosh\bryant-mcintosh-1,2014-15,Northwestern,G,32,30,1066,134,318,.421,94,208,.452,40,110,.364,58,68,.853,10,69,79,150,8,6,79,34,366,7.7
2397,Josh Perkins\josh-perkins-1,2015-16,Gonzaga,G,36,36,1109,127,293,.433,79,166,.476,48,127,.378,63,90,.700,22,98,120,146,43,11,73,101,365,7.9
2398,Josh Hart\josh-hart-1,2014-15,Villanova,G,36,2,917,124,241,.515,72,129,.558,52,112,.464,65,97,.670,65,96,161,53,40,14,38,76,365,9.1
2399,Rapheal Davis\rapheal-davis-1,2014-15,Purdue,G,34,34,1065,122,268,.455,104,208,.500,18,60,.300,103,141,.730,39,109,148,88,28,8,65,78,365,7.9
2400,Shawn Anderson\shawn-anderson-1,2016-17,Navy,G,30,27,844,122,292,.418,107,222,.482,15,70,.214,106,161,.658,43,89,132,88,37,2,65,47,365,8.7
2401,Kendrick Nunn\kendrick-nunn-1,2014-15,Illinois,G,33,24,996,131,327,.401,77,177,.435,54,150,.360,49,60,.817,13,103,116,62,39,6,45,54,365,7.4
2402,Isaiah Moss\isaiah-moss-1,2017-18,Iowa,G,33,33,798,129,307,.420,80,180,.444,49,127,.386,58,66,.879,17,57,74,62,22,7,41,46,365,7.2
2403,Jared Harper\jared-harper-12,2016-17,Auburn,G,32,30,773,104,270,.385,50,113,.442,54,157,.344,103,146,.705,10,52,62,95,37,2,49,57,365,8.0
2404,Dylan Frye\dylan-frye-1,2017-18,Bowling Green State,G,31,30,918,124,329,.377,65,162,.401,59,167,.353,58,80,.725,12,86,98,73,23,5,49,65,365,6.8
2405,Anthony Johnson\anthony-johnson-8,2017-18,Northern Colorado,G,38,4,728,120,312,.385,60,130,.462,60,182,.330,65,80,.813,34,86,120,22,16,3,40,68,365,5.4
2406,Arlon Harper\arlon-harper-1,2013-14,Charleston Southern,G,29,21,773,118,269,.439,81,154,.526,37,115,.322,92,119,.773,24,80,104,65,47,7,45,76,365,9.5
2407,Lawrence Alexander\lawrence-alexander-1,2013-14,North Dakota State,G,33,32,1134,120,278,.432,79,175,.451,41,103,.398,84,97,.866,19,123,142,86,30,6,70,66,365,7.9
2408,Jordan Poydras\jordan-poydras-1,2016-17,Utah Valley,G,34,16,832,115,310,.371,52,114,.456,63,196,.321,71,93,.763,11,78,89,73,30,1,45,58,364,6.7
2409,Isaiah Cousins\isaiah-cousins-1,2013-14,Oklahoma,G,33,33,975,124,281,.441,86,187,.460,38,94,.404,78,97,.804,51,89,140,70,40,11,53,95,364,8.4
2410,Reggie Dillard\reggie-dillard-1,2013-14,Presbyterian,G,30,29,1044,129,315,.410,81,201,.403,48,114,.421,58,99,.586,21,90,111,118,28,7,91,68,364,7.3
2411,Omar Prewitt\omar-prewitt-1,2013-14,William & Mary,G,32,0,787,111,250,.444,60,112,.536,51,138,.370,91,120,.758,31,117,148,63,29,16,55,60,364,8.9
2412,Ryan Arcidiacono\ryan-arcidiacono-1,2014-15,Villanova,G,36,36,1095,109,277,.394,54,129,.419,55,148,.372,91,112,.813,10,52,62,129,40,2,48,64,364,7.9
2413,Rashun Davis\rashun-davis-1,2013-14,Radford,G,35,2,848,118,264,.447,102,202,.505,16,62,.258,112,147,.762,12,70,82,121,36,1,76,75,364,7.3
2414,Chris Kendrix\chris-kendrix-1,2015-16,Missouri State,G,30,22,837,100,247,.405,56,123,.455,44,124,.355,120,149,.805,32,113,145,33,30,17,61,74,364,8.3
2415,John Dewey III\john-deweyiii-1,2017-18,Sam Houston State,G,36,35,1063,106,302,.351,60,173,.347,46,129,.357,106,126,.841,26,88,114,158,36,0,107,87,364,6.6
2416,Tyler Kalinoski\tyler-kalinoski-1,2013-14,Davidson,G,33,30,1117,125,254,.492,64,120,.533,61,134,.455,53,70,.757,55,109,164,111,42,10,47,90,364,10.4
2417,Andrew Harrison\andrew-harrison-1,2014-15,Kentucky,G,39,39,994,101,267,.378,65,173,.376,36,94,.383,126,159,.792,13,74,87,139,40,8,64,70,364,7.3
2418,Tre Demps\tre-demps-1,2013-14,Northwestern,G,33,6,982,125,326,.383,77,186,.414,48,140,.343,66,97,.680,17,66,83,73,6,2,37,45,364,6.3
2419,Haboubacar Mutombo\haboubacar-mutombo-1,2016-17,Western Carolina,G,31,31,1000,150,319,.470,128,246,.520,22,73,.301,42,87,.483,56,109,165,67,29,6,59,60,364,8.1
2420,Eli Cain\eli-cain-1,2017-18,DePaul,G,31,30,1026,126,362,.348,90,247,.364,36,115,.313,76,115,.661,19,96,115,146,29,8,73,61,364,7.3
2421,Jeremy Major\jeremy-major-1,2016-17,Pepperdine,G,31,31,1021,134,366,.366,80,218,.367,54,148,.365,42,86,.488,29,68,97,120,25,5,64,54,364,6.8
2422,Darien Walker\darien-walker-1,2014-15,Valparaiso,G,34,29,924,129,333,.387,76,186,.409,53,147,.361,53,83,.639,31,124,155,60,26,10,56,52,364,6.7
2423,Austin Loop\austin-loop-1,2014-15,Marshall,G,32,32,1033,108,257,.420,24,43,.558,84,214,.393,63,71,.887,24,51,75,26,33,4,32,57,363,8.0
2424,Kenny Gaines\kenny-gaines-1,2014-15,Georgia,G,31,29,930,125,303,.413,69,151,.457,56,152,.368,57,80,.713,23,83,106,50,35,28,47,79,363,7.9
2425,Clemmye Owens\clemmye-owens-1,2013-14,Bethune-Cookman,G,32,21,956,135,322,.419,65,141,.461,70,181,.387,23,33,.697,21,35,56,33,37,5,44,48,363,6.7
2426,Jonah Antonio\jonah-antonio-1,2017-18,Mount St. Mary's,G,32,31,1071,122,333,.366,32,67,.478,90,266,.338,29,36,.806,14,107,121,21,41,18,19,42,363,7.8
2427,Dorian Pickens\dorian-pickens-1,2017-18,Stanford,G,24,24,842,114,272,.419,46,103,.447,68,169,.402,67,88,.761,12,79,91,51,19,3,45,33,363,10.0
2428,Michael Oguine\michael-oguine-1,2015-16,Montana,G,33,30,1011,117,290,.403,86,191,.450,31,99,.313,98,140,.700,21,125,146,61,34,13,62,97,363,6.9
2429,Nigel Johnson\nigel-johnson-2,2016-17,Rutgers,G,32,13,838,125,332,.377,82,209,.392,43,123,.350,70,100,.700,13,92,105,64,37,2,45,29,363,7.2
2430,Darius McNeill\darius-mcneill-1,2017-18,University of California,G,32,30,1051,128,336,.381,61,146,.418,67,190,.353,40,54,.741,10,84,94,70,39,6,70,76,363,6.2
2431,Devin Harris\devin-harris-2,2017-18,Jacksonville,G,29,26,974,121,268,.451,112,234,.479,9,34,.265,112,152,.737,33,188,221,158,49,5,97,51,363,11.5
2432,Matt Jones\matt-jones-3,2015-16,Duke,G,35,35,1113,124,304,.408,48,121,.397,76,183,.415,39,53,.736,36,52,88,79,36,7,39,92,363,7.3
2433,Isaiah Ross\isaiah-ross-1,2017-18,Missouri-Kansas City,G,32,17,805,120,300,.400,50,105,.476,70,195,.359,53,68,.779,21,77,98,32,17,0,47,65,363,6.2
2434,Justin Kier\justin-kier-1,2017-18,George Mason,G,33,32,1094,134,297,.451,126,251,.502,8,46,.174,87,111,.784,8,145,153,77,42,4,93,73,363,6.8
2435,Eric Nottage\eric-nottage-1,2016-17,Florida International,G,31,19,948,127,282,.450,82,157,.522,45,125,.360,64,80,.800,34,104,138,103,36,2,88,85,363,8.1
2436,Ron Curry\ron-curry-1,2013-14,James Madison,G,30,29,1062,119,297,.401,90,174,.517,29,123,.236,96,141,.681,28,81,109,101,34,7,53,70,363,8.6
2437,Dakarai Henderson\dakarai-henderson-1,2016-17,Sam Houston State,G,34,33,915,133,365,.364,73,159,.459,60,206,.291,37,63,.587,23,60,83,45,14,1,53,34,363,4.8
2438,Marlon Hunter\marlon-hunter-1,2017-18,Jacksonville State,G,35,18,870,152,303,.502,138,258,.535,14,45,.311,45,57,.789,60,63,123,39,35,3,41,64,363,7.6
2439,Kris Brewer\kris-brewer-1,2014-15,Kent State,G,34,10,994,111,301,.369,68,167,.407,43,134,.321,97,145,.669,13,59,72,96,19,4,66,58,362,6.0
2440,Quinton Marshall\quinton-marshall-1,2015-16,Citadel,G,32,31,826,137,305,.449,87,152,.572,50,153,.327,38,57,.667,30,94,124,52,41,6,67,83,362,7.1
2441,Marcus Foster\marcus-foster-1,2014-15,Kansas State,G,29,24,807,116,299,.388,57,129,.442,59,170,.347,71,101,.703,8,58,66,55,17,2,62,55,362,6.3
2442,Parker Wentz\parker-wentz-1,2014-15,Abilene Christian,G,31,31,894,110,262,.420,48,114,.421,62,148,.419,80,94,.851,8,55,63,44,48,3,45,64,362,8.0
2443,Alex Copeland\alex-copeland-1,2016-17,Yale,G,28,6,699,139,286,.486,117,212,.552,22,74,.297,62,78,.795,12,37,49,55,23,1,43,39,362,8.4
2444,Derek Jackson\derek-jackson-1,2014-15,Kent State,G,34,32,1181,122,291,.419,56,135,.415,66,156,.423,52,71,.732,22,88,110,114,58,7,50,56,362,9.2
2445,Marquan Botley\marquan-botley-1,2013-14,Florida Atlantic,G,32,28,955,110,293,.375,44,117,.376,66,176,.375,76,101,.752,11,75,86,84,26,2,37,58,362,7.7
2446,Ty Jerome\ty-jerome-1,2017-18,Virginia,G,34,34,1046,133,316,.421,75,163,.460,58,153,.379,38,42,.905,11,95,106,132,55,1,54,79,362,8.6
2447,Andrew Ryan\andrew-ryan-1,2014-15,Campbell,G,32,32,1071,123,271,.454,40,73,.548,83,198,.419,33,43,.767,36,120,156,61,25,2,26,70,362,9.2
2448,Julien Lewis\julien-lewis-1,2014-15,Fresno State,G,32,28,944,140,353,.397,119,254,.469,21,99,.212,61,77,.792,22,99,121,35,47,8,54,100,362,6.0
2449,Zavier Turner\zavier-turner-1,2013-14,Ball State,G,30,27,981,103,269,.383,42,120,.350,61,149,.409,95,108,.880,7,44,51,110,25,0,118,71,362,6.1
2450,Alex Mitola\alex-mitola-1,2014-15,Dartmouth,G,29,29,999,113,295,.383,42,101,.416,71,194,.366,64,75,.853,11,66,77,79,23,0,37,36,361,8.6
2451,Brandon Randolph\brandon-randolph-1,2017-18,Utah Valley,G,33,33,1065,127,289,.439,93,200,.465,34,89,.382,73,99,.737,20,109,129,152,35,3,86,62,361,8.4
2452,Hugh Greenwood\hugh-greenwood-1,2014-15,New Mexico,G,31,31,1094,121,345,.351,49,134,.366,72,211,.341,47,62,.758,18,147,165,101,47,21,58,60,361,8.7
2453,Julian Jacobs\julian-jacobs-1,2015-16,Southern California,G,31,31,960,129,274,.471,114,228,.500,15,46,.326,88,125,.704,31,120,151,168,38,13,83,78,361,10.1
2454,Lonnie McClanahan\lonnie-mcclanahan-1,2014-15,Texas-Arlington,G,31,20,762,118,261,.452,118,256,.461,0,5,.000,125,168,.744,27,81,108,92,32,1,87,73,361,7.5
2455,Garrison Mathews\garrison-matthews-1,2015-16,Lipscomb,G,33,12,687,118,293,.403,53,107,.495,65,186,.349,60,82,.732,34,77,111,51,28,8,48,74,361,7.1
2456,Andre Smith\andre-smith-3,2014-15,Winthrop,G,32,32,989,122,327,.373,58,139,.417,64,188,.340,53,63,.841,7,76,83,137,41,3,61,44,361,8.3
2457,Trevis Wyche\trevis-wyche-1,2015-16,Saint Peter's,G,29,18,930,134,262,.511,108,201,.537,26,61,.426,67,90,.744,14,75,89,130,33,2,63,62,361,10.1
2458,Zack Denny\zack-denny-1,2015-16,Bowling Green State,G,34,29,919,131,321,.408,79,179,.441,52,142,.366,47,70,.671,42,163,205,29,41,5,44,59,361,7.5
2459,Tyler White\tyler-white-1,2015-16,Northern Kentucky,G,30,29,918,127,354,.359,83,189,.439,44,165,.267,63,82,.768,11,71,82,105,27,5,75,78,361,6.1
2460,Trelun Banks\trelun-banks-1,2016-17,Southern,G,33,29,1135,112,346,.324,73,212,.344,39,134,.291,98,133,.737,14,91,105,162,40,1,105,60,361,6.4
2461,Bobby Word\bobby-word-1,2017-18,Cleveland State,G,35,34,956,119,300,.397,35,85,.412,84,215,.391,39,56,.696,10,93,103,23,23,7,47,71,361,5.6
2462,A.J. Davis\aj-davis-2,2015-16,Central Florida,G,30,30,943,107,280,.382,82,195,.421,25,85,.294,122,155,.787,36,144,180,88,28,15,85,73,361,8.3
2463,Kason Harrell\kason-harrell-1,2016-17,Purdue-Fort Wayne,G,33,29,952,122,258,.473,44,80,.550,78,178,.438,38,44,.864,23,86,109,56,32,22,42,66,360,8.7
2464,Carsen Edwards\carsen-edwards-1,2016-17,Purdue,G,35,21,813,128,335,.382,79,191,.414,49,144,.340,55,76,.724,14,77,91,62,37,3,64,68,360,5.5
2465,Kory Holden\kory-holden-1,2014-15,Delaware,G,29,28,990,117,296,.395,93,232,.401,24,64,.375,102,135,.756,16,74,90,144,16,4,95,58,360,7.6
2466,Jalen Sanders\jalen-sanders-2,2017-18,Northern Colorado,G,38,35,1088,138,237,.582,127,194,.655,11,43,.256,73,97,.753,55,165,220,46,31,53,47,102,360,9.0
2467,Phillip Leonard\phillip-leonard-1,2015-16,Mercer,G,34,34,933,119,255,.467,116,236,.492,3,19,.158,119,180,.661,35,119,154,162,15,1,64,79,360,8.8
2468,ShawnDre' Jones\shawndre-jones-1,2014-15,Richmond,G,35,7,999,123,292,.421,59,122,.484,64,170,.376,50,69,.725,9,31,40,90,34,2,39,64,360,7.0
2469,Christopher Anderson\christopher-anderson-1,2013-14,San Diego,G,35,35,1171,111,269,.413,68,172,.395,43,97,.443,95,144,.660,29,99,128,216,64,3,94,72,360,9.7
2470,Dazon Ingram\dazon-ingram-1,2016-17,Alabama,G,34,34,934,118,227,.520,97,178,.545,21,49,.429,103,156,.660,35,117,152,113,30,8,85,88,360,8.3
2471,Josh Reaves\josh-reaves-1,2017-18,Penn State,G,34,32,1048,133,273,.487,93,167,.557,40,106,.377,53,75,.707,59,114,173,107,74,17,48,105,359,10.5
2472,Sammy Mojica\sammy-mojica-1,2016-17,Drexel,G,32,31,1010,131,338,.388,72,149,.483,59,189,.312,38,52,.731,45,126,171,81,39,13,47,53,359,8.6
2473,Aaseem Dixon\aaseem-dixon-1,2013-14,Northern Arizona,G,32,27,1027,126,320,.394,69,161,.429,57,159,.358,50,65,.769,17,68,85,70,34,0,58,43,359,6.9
2474,Hameed Ali\hameed-ali-1,2015-16,Texas A&M-Corpus Christi,G,33,32,1004,114,338,.337,79,219,.361,35,119,.294,96,122,.787,18,71,89,174,88,4,67,80,359,9.2
2475,Jair Bolden\jair-bolden-1,2017-18,George Washington,G,32,24,1044,131,356,.368,76,183,.415,55,173,.318,42,62,.677,12,85,97,98,24,9,74,53,359,6.0
2476,Trelun Banks\trelun-banks-1,2014-15,Southern,G,35,35,1055,125,342,.365,91,233,.391,34,109,.312,75,119,.630,12,66,78,81,38,1,80,91,359,4.5
2477,Lavon Long\lavon-long-1,2013-14,Siena,G,38,36,1002,125,294,.425,122,286,.427,3,8,.375,106,147,.721,57,128,185,46,21,28,70,148,359,5.5
2478,Jake Toolson\jake-toolson-1,2017-18,Utah Valley,G,33,33,915,126,254,.496,96,170,.565,30,84,.357,77,91,.846,25,129,154,97,25,8,54,36,359,9.5
2479,Greg Brown\greg-brown-4,2015-16,Saint Francis (PA),G,28,28,960,129,323,.399,94,224,.420,35,99,.354,66,93,.710,15,75,90,92,24,7,71,72,359,7.2
2480,Ben Mockford\ben-mockford-1,2013-14,St. Francis (NY),G,30,26,884,121,286,.423,34,72,.472,87,214,.407,30,38,.789,6,42,48,27,7,1,24,29,359,7.1
2481,Ernie Duncan\ernie-duncan-1,2017-18,Vermont,G,33,32,958,116,257,.451,50,91,.549,66,166,.398,60,71,.845,6,73,79,74,17,3,39,55,358,7.8
2482,Rodney Elliott\rodney-elliott-2,2015-16,Maryland-Baltimore County,G,28,26,834,104,259,.402,68,138,.493,36,121,.298,114,140,.814,23,65,88,100,24,2,75,91,358,8.1
2483,Geo Baker\geo-baker-1,2017-18,Rutgers,G,33,29,1044,127,334,.380,74,187,.396,53,147,.361,51,65,.785,12,61,73,85,35,14,57,69,358,6.5
2484,Josh Hearlihy\josh-hearlihy-1,2017-18,Seattle,G,32,26,902,106,250,.424,67,153,.438,39,97,.402,107,132,.811,24,108,132,89,18,6,85,64,358,7.5
2485,Kahron Ross\kahron-ross-1,2015-16,Lehigh,G,32,32,1087,127,286,.444,98,210,.467,29,76,.382,75,108,.694,23,67,90,194,45,5,65,61,358,10.2
2486,Romone Saunders\romone-saunders--1,2017-18,Wagner,G,25,22,791,130,309,.421,82,169,.485,48,140,.343,50,71,.704,46,113,159,51,31,7,52,63,358,9.8
2487,Keenan Palmore\keenan-palmore-1,2013-14,Old Dominion,G,36,36,1009,141,284,.496,141,279,.505,0,5,.000,76,134,.567,43,96,139,96,47,8,86,88,358,6.9
2488,Aaron Brown\aaron-brown-1,2013-14,Southern Mississippi,G,36,30,973,103,240,.429,60,130,.462,43,110,.391,109,149,.732,54,101,155,48,25,2,53,81,358,7.2
2489,Bobby Hunter\bobby-hunter-1,2013-14,Illinois State,G,34,29,942,109,226,.482,76,131,.580,33,95,.347,107,139,.770,26,101,127,81,52,0,51,86,358,8.9
2490,John Gillon\john-gillon-1,2016-17,Syracuse,G,34,23,1015,105,257,.409,51,127,.402,54,130,.415,93,107,.869,13,49,62,184,49,1,72,52,357,9.5
2491,Torry Johnson\torry-johnson-1,2017-18,Northern Arizona,G,31,22,834,103,273,.377,75,186,.403,28,87,.322,123,159,.774,21,48,69,50,33,0,82,62,357,5.9
2492,DeVaughn Akoon-Purcell\devaughn-akoon-purcell-1,2014-15,Illinois State,G,28,18,734,118,278,.424,88,188,.468,30,90,.333,91,118,.771,50,108,158,37,28,5,54,52,357,8.9
2493,Jamel Outler\jamel-outler-1,2013-14,Texas-Arlington,G,32,19,883,110,264,.417,31,63,.492,79,201,.393,58,80,.725,12,71,83,19,21,2,32,73,357,6.6
2494,Isaiah Williams\isaiah-williams-2,2013-14,Samford,G,30,25,887,119,275,.433,73,157,.465,46,118,.390,73,95,.768,6,48,54,103,25,3,65,70,357,7.6
2495,Jalon Gates\jalon-gates-1,2017-18,Houston Baptist,G,31,9,573,111,294,.378,36,78,.462,75,216,.347,60,78,.769,12,30,42,15,8,0,18,23,357,6.4
2496,Brandon Sampson\brandon-sampson-1,2016-17,Louisiana State,G,31,26,853,120,254,.472,81,139,.583,39,115,.339,78,100,.780,18,78,96,42,19,14,63,55,357,7.3
2497,John Brisco\john-brisco-1,2014-15,Prairie View,G,32,26,839,129,288,.448,80,174,.460,49,114,.430,50,70,.714,19,59,78,35,53,1,51,71,357,7.2
2498,Demetre Rivers\demetre-rivers-1,2016-17,Mercer,G,32,32,959,131,276,.475,91,161,.565,40,115,.348,55,67,.821,25,70,95,41,12,8,68,64,357,6.3
2499,Nick Coppola\nick-coppola-1,2014-15,Louisiana-Monroe,G,38,38,1384,125,304,.411,67,155,.432,58,149,.389,49,68,.721,7,111,118,141,34,1,69,68,357,6.9
2500,Keon Johnson\keon-johnson-1,2014-15,Winthrop,G,31,22,878,109,271,.402,58,130,.446,51,141,.362,88,106,.830,9,66,75,59,21,0,37,65,357,7.4
2501,Paul Jorgensen\paul-jorgensen-1,2017-18,Butler,G,35,23,961,128,307,.417,68,135,.504,60,172,.349,41,49,.837,16,94,110,87,37,2,32,54,357,7.9
2502,Milton Doyle\milton-doyle-1,2015-16,Loyola (IL),G,32,17,906,122,296,.412,92,201,.458,30,95,.316,83,117,.709,23,96,119,96,27,16,103,96,357,6.1
2503,Mandell Thomas\mandell-thomas-1,2013-14,Fordham,G,30,26,990,123,341,.361,78,194,.402,45,147,.306,66,99,.667,46,81,127,60,45,22,45,56,357,8.2
2504,Khristian Smith\khristian-smith-1,2013-14,Indiana State,G,34,5,826,130,270,.481,105,194,.541,25,76,.329,72,110,.655,34,112,146,28,15,7,41,63,357,6.9
2505,Antwoine Anderson\antwoine-anderson-1,2016-17,Fordham,G,32,32,1074,131,320,.409,87,192,.453,44,128,.344,50,72,.694,21,43,64,103,55,6,74,86,356,7.1
2506,Ryan Kemrite\ryan-kemrite-1,2017-18,Liberty,G,35,34,1139,115,259,.444,31,73,.425,84,186,.452,42,47,.894,16,78,94,33,21,2,26,63,356,7.1
2507,Christavious Gill\christavious-gill-1,2014-15,New Orleans,G,29,25,915,117,290,.403,69,141,.489,48,149,.322,74,99,.747,13,45,58,51,39,1,42,45,356,7.9
2508,Shaq Calhoun\shaq-calhoun-1,2017-18,Tennessee Tech,G,33,17,805,122,284,.430,63,130,.485,59,154,.383,53,66,.803,13,82,95,41,38,14,41,97,356,7.0
2509,Ronrico White\ronrico-white-1,2014-15,Chattanooga,G,32,22,1006,108,282,.383,46,107,.430,62,175,.354,78,103,.757,13,69,82,104,23,3,48,55,356,7.8
2510,Alzee Williams\alzee-williams-1,2013-14,North Texas,G,32,28,908,124,269,.461,122,261,.467,2,8,.250,106,141,.752,35,42,77,45,23,2,31,33,356,7.9
2511,Will Darley\will-darley-1,2015-16,Maryland-Baltimore County,G,30,26,886,129,262,.492,80,149,.537,49,113,.434,49,58,.845,17,112,129,57,18,9,56,48,356,8.5
2512,Brandon Bos\brandon-bos-1,2013-14,South Dakota,G,30,25,847,107,279,.384,66,171,.386,41,108,.380,101,117,.863,20,76,96,73,16,4,60,42,356,7.6
2513,Holland Woods\holland-woods-1,2017-18,Portland State,G,34,25,1098,106,267,.397,79,175,.451,27,92,.293,117,148,.791,18,75,93,191,50,4,88,71,356,9.0
2514,Dylan Ennis\dylan-ennis-1,2014-15,Villanova,G,36,36,1013,123,295,.417,65,135,.481,58,160,.363,52,84,.619,33,99,132,126,35,16,64,78,356,7.7
2515,Garrett Sams\garrett-sams-1,2017-18,North Florida,G,28,26,777,112,270,.415,57,130,.438,55,140,.393,77,96,.802,18,101,119,38,19,6,70,59,356,7.3
2516,Reed Timmer\reed-timmer-1,2014-15,Drake,G,31,29,926,118,272,.434,92,199,.462,26,73,.356,93,108,.861,8,62,70,74,16,1,58,38,355,7.3
2517,Shawn Occeus\shawn-occeus-1,2017-18,Northeastern,G,33,28,953,118,258,.457,69,115,.600,49,143,.343,70,89,.787,12,70,82,59,64,18,58,60,355,8.5
2518,Richaud Gittens\richaud-gittens-1,2017-18,Seattle,G,33,30,1046,122,295,.414,77,158,.487,45,137,.328,66,90,.733,56,117,173,54,38,6,55,102,355,7.5
2519,Paris Lee\paris-lee-1,2015-16,Illinois State,G,32,30,972,114,289,.394,78,176,.443,36,113,.319,91,117,.778,9,77,86,117,54,3,61,65,355,8.4
2520,Chris Harrison-Docks\chris-harrison-docks-1,2014-15,Western Kentucky,G,32,30,1077,111,296,.375,37,87,.425,74,209,.354,59,78,.756,4,82,86,80,23,0,67,53,355,6.3
2521,B.J. Glasford\bj-glasford-1,2017-18,Stetson,G,32,32,845,138,331,.417,97,207,.469,41,124,.331,38,57,.667,28,97,125,56,44,9,51,75,355,7.1
2522,Paul Watson\paul-watson-1,2014-15,Fresno State,G,32,32,1066,121,307,.394,71,166,.428,50,141,.355,63,90,.700,25,131,156,24,29,23,41,87,355,6.9
2523,DeAndre Haywood\deandre-haywood-1,2016-17,Delaware State,G,32,30,905,125,279,.448,101,203,.498,24,76,.316,81,128,.633,25,60,85,72,48,3,71,73,355,7.1
2524,Dave Coley\dave-coley-1,2013-14,Stony Brook,G,34,34,1100,111,330,.336,66,193,.342,45,137,.328,88,112,.786,40,128,168,85,34,0,73,76,355,6.3
2525,Desonta Bradford\desonta-bradford-1,2016-17,East Tennessee State,G,34,33,1041,113,241,.469,85,159,.535,28,82,.341,101,129,.783,21,127,148,132,37,27,81,82,355,9.0
2526,Tamarcio Wilson\tamarcio-wilson-1,2015-16,Alcorn State,G,29,26,903,121,299,.405,83,170,.488,38,129,.295,75,104,.721,12,77,89,51,19,2,81,42,355,5.9
2527,Tucker Haymond\tucker-haymond-1,2014-15,Western Michigan,G,30,27,841,121,244,.496,86,147,.585,35,97,.361,77,103,.748,46,83,129,54,23,2,56,56,354,8.7
2528,Siyani Chambers\siyani-chambers-1,2013-14,Harvard,G,32,32,1099,104,272,.382,54,141,.383,50,131,.382,96,131,.733,15,62,77,143,41,1,74,33,354,8.6
2529,Vee Sanford\vee-sanford-1,2013-14,Dayton,G,37,2,800,134,299,.448,115,236,.487,19,63,.302,67,96,.698,16,83,99,66,27,11,52,59,354,6.2
2530,Jeremy Crutcher\jeremy-crutcher-1,2013-14,Alabama A&M,G,29,29,930,115,293,.392,63,150,.420,52,143,.364,72,109,.661,10,82,92,117,35,1,67,67,354,8.1
2531,Joey Ptasinski\joey-ptasinksi-1,2013-14,Lafayette,G,31,22,1025,123,256,.480,43,78,.551,80,178,.449,28,37,.757,10,69,79,58,27,4,37,47,354,8.5
2532,Andrien White\adrien-white-1,2015-16,Charlotte,G,33,31,863,117,283,.413,50,118,.424,67,165,.406,53,79,.671,18,93,111,35,53,6,42,98,354,7.1
2533,Marcel Mosley\marcel-mosley-1,2013-14,Arkansas-Pine Bluff,G,26,18,797,117,264,.443,70,143,.490,47,121,.388,73,95,.768,23,47,70,68,61,0,72,66,354,9.5
2534,Cole Murray\cole-murray-1,2016-17,Northern Kentucky,G,35,25,1011,118,277,.426,17,24,.708,101,253,.399,17,23,.739,7,106,113,39,18,14,25,69,354,7.0
2535,Sabri Thompson\sabri-thompson-1,2015-16,Northwestern State,G,28,21,766,118,273,.432,62,129,.481,56,144,.389,62,76,.816,29,62,91,62,18,8,54,58,354,8.3
2536,Josh McFolley\josh-mcfolley-1,2017-18,Detroit Mercy,G,32,19,804,118,289,.408,65,134,.485,53,155,.342,65,83,.783,16,55,71,48,49,2,42,84,354,7.1
2537,Sterling Taplin\sterling-taplin-1,2017-18,Tulsa,G,30,30,845,127,275,.462,89,170,.524,38,105,.362,62,85,.729,5,107,112,132,28,4,73,55,354,8.9
2538,Julian Batts\julian-batts-1,2017-18,Long Island University,G,35,33,1041,113,251,.450,47,90,.522,66,161,.410,62,84,.738,15,138,153,80,47,9,43,94,354,8.4
2539,Jarren Greenwood\jarren-greenwood-1,2017-18,McNeese State,G,28,27,955,112,263,.426,80,166,.482,32,97,.330,98,118,.831,10,97,107,90,22,3,65,50,354,8.7
2540,Pierre Bland\pierre-bland-1,2013-14,Purdue-Fort Wayne,G,36,36,1200,123,234,.526,101,184,.549,22,50,.440,86,120,.717,26,136,162,154,61,6,69,79,354,9.9
2541,Myles Powell\myles-powell-1,2016-17,Seton Hall,G,33,2,785,118,301,.392,50,96,.521,68,205,.332,49,60,.817,19,55,74,29,30,6,32,67,353,6.4
2542,Keron DeShields\keron-deshields-1,2013-14,Montana,G,30,28,934,128,257,.498,96,167,.575,32,90,.356,65,94,.691,7,74,81,76,36,3,43,88,353,8.4
2543,Sheldon Strickland\sheldon-strickland-1,2013-14,Charleston Southern,G,31,13,835,124,305,.407,60,147,.408,64,158,.405,41,54,.759,11,63,74,81,24,0,42,53,353,7.4
2544,Jake Bittle\jake-bittle-1,2014-15,South Dakota State,G,35,35,1019,119,223,.534,85,140,.607,34,83,.410,81,101,.802,47,105,152,96,41,9,60,97,353,9.0
2545,Joseph Chartouny\joseph-chartouny-1,2017-18,Fordham,G,29,28,1043,114,307,.371,74,166,.446,40,141,.284,85,122,.697,22,140,162,134,97,10,69,70,353,11.3
2546,Trey Dickerson\trey-dickerson-1,2016-17,South Dakota,G,34,34,759,115,285,.404,81,183,.443,34,102,.333,89,122,.730,7,68,75,95,21,2,60,70,353,6.3
2547,Xavier Pollard\xavier-pollard-1,2013-14,Maine,G,24,20,767,137,297,.461,121,234,.517,16,63,.254,63,90,.700,20,85,105,92,42,8,74,69,353,10.0
2548,Gerry Blakes\gerry-blakes-1,2015-16,Arizona State,G,32,29,962,128,332,.386,81,181,.448,47,151,.311,50,69,.725,34,136,170,76,34,5,66,94,353,6.7
2549,JaQuan Lyle\jaquan-lyle-1,2016-17,Ohio State,G,31,23,908,121,264,.458,88,183,.481,33,81,.407,78,108,.722,10,88,98,142,32,2,75,50,353,8.9
2550,Sean O'Brien\sean-obrien-2,2017-18,Colgate,G,33,33,1115,111,280,.396,53,109,.486,58,171,.339,73,85,.859,22,111,133,120,38,0,31,72,353,9.3
2551,James McGee\james-mcgee-1,2015-16,Southern Utah,G,29,14,788,109,254,.429,30,64,.469,79,190,.416,56,63,.889,7,48,55,48,28,3,40,55,353,8.2
2552,Kavon Stewart\kavon-stewart-1,2016-17,Robert Morris,G,32,31,933,94,263,.357,84,225,.373,10,38,.263,155,219,.708,19,89,108,118,56,1,120,88,353,6.4
2553,Jordan Walker\jordan-walker-2,2017-18,Morehead State,G,29,28,916,111,289,.384,68,159,.428,43,130,.331,88,119,.739,19,73,92,77,35,8,75,84,353,7.0
2554,Eric Cooper\eric-cooper-1,2015-16,Nevada,G,38,1,924,113,323,.350,57,144,.396,56,179,.313,71,87,.816,18,62,80,32,25,3,36,73,353,4.8
2555,Justin Cousin\justin-cousin-1,2016-17,Radford,G,32,30,927,119,315,.378,41,102,.402,78,213,.366,37,51,.725,11,69,80,64,19,1,57,44,353,6.0
2556,Stephan Jiggetts\stephan-jiggetts-1,2015-16,Fairleigh Dickinson,G,32,31,1002,103,280,.368,67,180,.372,36,100,.360,110,150,.733,17,55,72,98,38,0,82,91,352,6.2
2557,Nickeil Alexander-Walker\nickeil-alexander-walker-1,2017-18,Virginia Tech,G,33,33,840,124,276,.449,66,128,.516,58,148,.392,46,63,.730,23,104,127,49,28,18,52,49,352,7.6
2558,QJ Peterson\qj-peterson-1,2014-15,Virginia Military Institute,G,18,17,572,108,314,.344,64,155,.413,44,159,.277,92,112,.821,27,62,89,72,29,4,65,34,352,11.6
2559,Javan Felix\javan-felix-1,2015-16,Texas,G,33,31,888,126,294,.429,80,164,.488,46,130,.354,54,64,.844,15,43,58,72,27,0,36,66,352,7.0
2560,Austin Tillotson\austin-tillotson-1,2014-15,Colgate,G,33,33,1100,130,274,.474,86,168,.512,44,106,.415,48,70,.686,10,55,65,134,40,1,67,73,352,8.0
2561,Brenton Scott\brenton-scott-1,2014-15,Indiana State,G,31,26,889,113,264,.428,54,131,.412,59,133,.444,67,90,.744,18,93,111,51,31,1,69,55,352,7.1
2562,Darnell Foreman\darnell-foreman-1,2017-18,Pennsylvania,G,33,33,987,117,262,.447,92,174,.529,25,88,.284,93,127,.732,15,134,149,117,36,7,54,68,352,8.9
2563,Daejon Davis\daejon-davis-1,2017-18,Stanford,G,33,33,1013,117,249,.470,92,187,.492,25,62,.403,93,138,.674,24,120,144,160,40,6,132,82,352,7.6
2564,KJ Feagin\kj-feagin-1,2015-16,Santa Clara,G,31,30,958,127,289,.439,89,182,.489,38,107,.355,60,75,.800,6,72,78,117,18,3,71,63,352,7.3
2565,Jontrell Walker\jontrell-walker-1,2015-16,Incarnate Word,G,28,12,650,103,268,.384,55,125,.440,48,143,.336,98,105,.933,10,35,45,53,27,2,64,49,352,7.2
2566,Tim Marshall\tim-marshall-1,2014-15,Virginia Military Institute,G,30,16,666,118,331,.356,32,62,.516,86,269,.320,30,42,.714,23,59,82,32,28,1,33,78,352,6.1
2567,Ben Emelogu\ben-emelogu-1,2017-18,Southern Methodist,G,33,33,1047,123,266,.462,60,132,.455,63,134,.470,43,60,.717,49,131,180,56,43,5,51,86,352,8.5
2568,Aqeel Quinn\aqeel-quinn-1,2014-15,San Diego State,G,33,27,868,124,298,.416,70,150,.467,54,148,.365,50,71,.704,20,71,91,51,33,1,43,62,352,6.7
2569,Ryan Sypkens\ryan-sypkens-1,2013-14,UC-Davis,G,31,15,854,115,282,.408,20,53,.377,95,229,.415,27,31,.871,12,49,61,28,19,12,35,72,352,6.6
2570,Kyle Leufroy\kyle-leufroy-1,2016-17,Lehigh,G,31,31,880,123,265,.464,71,141,.504,52,124,.419,54,63,.857,12,90,102,67,43,5,65,52,352,8.2
2571,Nicholas Paulos\nicholas-paulos-1,2014-15,North Carolina-Greensboro,G,33,33,1178,120,264,.455,29,54,.537,91,210,.433,20,27,.741,14,112,126,54,25,11,52,61,351,7.5
2572,Tarik Phillip\tarik-phillip-1,2016-17,West Virginia,G,37,15,900,110,270,.407,74,175,.423,36,95,.379,95,129,.736,23,84,107,112,63,14,57,70,351,8.1
2573,Jacob Van\jacob-van-1,2016-17,Air Force,G,33,28,944,110,248,.444,76,161,.472,34,87,.391,97,116,.836,7,76,83,93,18,1,57,37,351,7.7
2574,Nick Hornsby\nick-hornsby-1,2016-17,Sacramento State,G,31,31,924,129,256,.504,110,206,.534,19,50,.380,74,104,.712,67,182,249,46,36,18,57,103,351,9.5
2575,Alec Wintering\alec-wintering-1,2016-17,Portland,G,18,18,668,122,278,.439,109,240,.454,13,38,.342,94,122,.770,19,64,83,101,35,0,83,44,351,12.9
2576,Glenn Sanabria\glenn-sanabria-1,2017-18,St. Francis (NY),G,29,29,872,123,279,.441,57,119,.479,66,160,.413,39,64,.609,29,64,93,89,29,9,31,62,351,9.5
2577,Perrion Callandret\perrion-callandret-1,2015-16,Idaho,G,25,23,788,102,260,.392,53,118,.449,49,142,.345,98,120,.817,15,86,101,51,22,7,59,62,351,8.6
2578,Joseph Chartouny\joseph-chartouny-1,2016-17,Fordham,G,29,26,960,118,284,.415,66,148,.446,52,136,.382,63,83,.759,12,107,119,144,94,4,83,71,351,11.0
2579,Matt Howard\matt-howard-2,2016-17,Pennsylvania,G,28,28,840,130,264,.492,89,153,.582,41,111,.369,50,83,.602,53,138,191,41,33,9,43,66,351,10.1
2580,Terell Gomez\terell-gomez-1,2017-18,Cal State Northridge,G,30,30,1022,121,277,.437,56,136,.412,65,141,.461,44,55,.800,12,60,72,109,19,0,62,50,351,8.0
2581,Josh Fortune\josh-fortune-1,2015-16,Colorado,G,34,17,781,121,300,.403,66,157,.420,55,143,.385,54,77,.701,22,113,135,75,26,6,76,61,351,6.2
2582,Deshawn Delaney\deshawn-delaney-1,2014-15,New Mexico,G,30,29,871,135,273,.495,119,230,.517,16,43,.372,65,98,.663,47,112,159,60,39,18,51,49,351,9.7
2583,Kenneth Ogbe\kenneth-ogbe-1,2016-17,Utah Valley,G,33,17,780,104,238,.437,46,96,.479,58,142,.408,85,122,.697,16,67,83,34,13,6,57,85,351,5.8
2584,Jalen Avery\jalen-avery-1,2017-18,Kent State,G,34,34,1142,119,276,.431,64,129,.496,55,147,.374,58,75,.773,20,73,93,121,21,1,24,31,351,9.0
2585,Joe De Ciman\joe-de-ciman-1,2015-16,Colorado State,G,34,34,1112,115,302,.381,48,130,.369,67,172,.390,54,80,.675,47,128,175,58,23,11,49,103,351,6.7
2586,Ahmed Hill\ahmed-hill-1,2017-18,Virginia Tech,G,33,22,831,128,261,.490,64,105,.610,64,156,.410,31,42,.738,18,80,98,30,12,2,27,46,351,7.3
2587,Sviatoslav Mykhailiuk\sviatoslav-mykhailiuk-1,2016-17,Kansas,G,36,25,984,124,280,.443,54,104,.519,70,176,.398,33,47,.702,29,80,109,46,31,9,40,71,351,6.8
2588,Braylon Rayson\braylon-rayson-1,2014-15,Central Michigan,G,32,32,754,118,285,.414,62,127,.488,56,158,.354,59,66,.894,27,68,95,34,30,1,37,61,351,7.1
2589,Damon Sherman-Newsome\damon-sherman-newsome-1,2013-14,Colgate,G,31,13,895,114,252,.452,62,125,.496,52,127,.409,70,85,.824,15,82,97,49,13,8,45,47,350,7.7
2590,Lavon Long\lavon-long-1,2015-16,Siena,G,33,29,981,112,232,.483,108,210,.514,4,22,.182,122,161,.758,64,117,181,109,33,21,104,104,350,8.3
2591,Trey Lewis\trey-lewis-1,2015-16,Louisville,G,31,27,859,121,291,.416,75,160,.469,46,131,.351,62,78,.795,22,84,106,71,32,3,52,55,350,7.7
2592,Donovan Fields\donovan-fields-1,2016-17,Cal Poly,G,31,17,819,123,277,.444,91,188,.484,32,89,.360,72,83,.867,11,55,66,59,35,3,56,74,350,7.0
2593,Bryce Scott\bryce-scott-1,2015-16,Lafayette,G,28,23,887,120,259,.463,47,92,.511,73,167,.437,37,50,.740,13,71,84,63,26,5,33,50,350,9.4
2594,Que Johnson\que-johnson-1,2015-16,Washington State,G,31,25,795,121,292,.414,79,188,.420,42,104,.404,66,86,.767,16,59,75,36,16,5,42,76,350,6.0
2595,Ike Smith\ike-smith-1,2015-16,Georgia Southern,G,30,28,764,115,306,.376,69,167,.413,46,139,.331,74,106,.698,37,107,144,34,26,11,53,61,350,6.9
2596,Brandon Taylor\brandon-taylor-1,2013-14,Utah,G,33,33,1035,116,273,.425,52,112,.464,64,161,.398,54,67,.806,10,59,69,114,31,3,72,48,350,7.5
2597,Kevin Scott\kevin-scott-2,2016-17,Texas Southern,G,35,25,973,129,292,.442,96,201,.478,33,91,.363,59,84,.702,60,112,172,59,46,5,64,79,350,7.4
2598,Jalen Coleman-Lands\jalen-coleman-lands-1,2015-16,Illinois,G,34,24,892,115,279,.412,28,73,.384,87,206,.422,33,44,.750,9,55,64,30,22,3,36,69,350,5.9
2599,Ash Yacoubou\achraf-yacoubou-1,2015-16,Saint Louis,G,32,30,963,139,322,.432,103,206,.500,36,116,.310,35,69,.507,36,147,183,56,23,10,63,86,349,6.5
2600,Colton Ray-St Cyr\colton-ray-st-cyr-1,2016-17,Coastal Carolina,G,37,37,997,125,296,.422,80,169,.473,45,127,.354,54,74,.730,50,186,236,88,37,14,67,99,349,7.5
2601,Tevonn Walker\tevonn-walker-1,2014-15,Valparaiso,G,34,33,920,119,268,.444,92,189,.487,27,79,.342,84,117,.718,37,78,115,57,37,3,52,62,349,7.3
2602,Zach Lofton\zach-lofton-1,2013-14,Illinois State,G,31,13,712,109,322,.339,59,151,.391,50,171,.292,81,106,.764,20,73,93,46,31,2,46,46,349,6.2
2603,Mikel Trapp\mikel-trapp-1,2013-14,Bethune-Cookman,G,31,31,989,115,286,.402,42,92,.457,73,194,.376,46,67,.687,23,61,84,35,16,6,50,87,349,5.8
2604,Kevin Ware\kevin-ware-1,2015-16,Georgia State,G,30,30,1065,115,273,.421,93,211,.441,22,62,.355,97,123,.789,11,101,112,92,37,14,78,70,349,7.9
2605,Toddrick Gotcher\toddrick-gotcher-1,2015-16,Texas Tech,G,32,31,926,110,260,.423,48,102,.471,62,158,.392,67,79,.848,31,81,112,71,33,11,26,69,349,9.0
2606,Marc Brown\marc-brown-1,2013-14,Illinois-Chicago,G,31,28,923,108,261,.414,82,186,.441,26,75,.347,107,142,.754,31,57,88,44,28,0,68,75,349,6.3
2607,Kasey Shepherd\kasey-shepherd-1,2014-15,Louisiana,G,36,11,713,119,271,.439,66,124,.532,53,147,.361,58,69,.841,20,74,94,82,63,6,68,46,349,7.7
2608,Sean Gardner\sean-gardner-1,2014-15,Arkansas State,G,29,26,897,129,310,.416,75,158,.475,54,152,.355,37,51,.725,32,64,96,35,33,8,43,64,349,7.4
2609,Brandon Taylor\brandon-taylor-1,2015-16,Utah,G,36,36,1184,115,291,.395,51,100,.510,64,191,.335,55,67,.821,8,76,84,140,61,1,79,51,349,7.6
2610,Kasey Hill\kasey-hill-1,2016-17,Florida,G,36,36,1041,126,312,.404,117,268,.437,9,44,.205,88,133,.662,15,88,103,161,60,5,110,83,349,6.5
2611,Ivan Canete\ivan-canete-1,2016-17,Stephen F. Austin,G,33,33,778,115,254,.453,68,133,.511,47,121,.388,72,91,.791,14,82,96,59,46,9,74,112,349,6.6
2612,Zach LaVine\zach-lavine-1,2013-14,UCLA,G,37,1,904,127,288,.441,79,160,.494,48,128,.375,47,68,.691,18,76,94,66,33,6,42,73,349,6.4
2613,Josh McSwiggan\josh-mcswiggan-1,2017-18,Portland,G,32,31,962,116,275,.422,46,114,.404,70,161,.435,46,54,.852,20,96,116,40,17,7,39,43,348,7.4
2614,Jashaun Agosto\jashaun-agosto-1,2016-17,Long Island University,G,31,30,1033,115,278,.414,88,204,.431,27,74,.365,91,123,.740,6,58,64,100,19,6,60,76,348,6.8
2615,Kaheem Ransom\kaheem-ransom-1,2014-15,Sam Houston State,G,35,35,1004,101,287,.352,38,95,.400,63,192,.328,83,100,.830,34,120,154,141,44,4,61,89,348,8.3
2616,Charlie Lee\charles-lee-2,2014-15,Cleveland State,G,27,26,959,110,232,.474,51,108,.472,59,124,.476,69,79,.873,17,64,81,108,26,1,58,61,348,10.2
2617,Marquise Pointer\marquise-pointer-1,2015-16,College of Charleston,G,31,18,932,116,328,.354,56,150,.373,60,178,.337,56,78,.718,28,45,73,86,37,0,66,61,348,6.3
2618,Bryce Dejean-Jones\bryce-jones-1,2014-15,Iowa State,G,33,21,760,119,250,.476,92,168,.548,27,82,.329,83,115,.722,39,116,155,70,35,10,49,57,348,8.8
2619,Tra'Vaughn White\travaughn-white-1,2015-16,Longwood,G,26,23,855,116,327,.355,74,189,.392,42,138,.304,74,87,.851,15,59,74,66,26,0,39,62,348,7.6
2620,Sterling Smith\sterling-smith-1,2013-14,Coppin State,G,32,28,948,116,274,.423,56,118,.475,60,156,.385,56,75,.747,39,95,134,50,39,12,38,34,348,8.8
2621,Bronson Koenig\bronson-koenig-1,2014-15,Wisconsin,G,40,24,1152,115,278,.414,53,125,.424,62,153,.405,56,69,.812,19,51,70,98,9,8,33,64,348,6.2
2622,Jimmie Taylor\jimmie-taylor-2,2014-15,Rider,G,33,33,980,119,297,.401,65,162,.401,54,135,.400,56,88,.636,43,100,143,36,31,6,48,88,348,6.4
2623,Wesley Alcegaire\wesley-alcegaire-1,2015-16,Bowling Green State,G,34,34,906,120,293,.410,68,146,.466,52,147,.354,56,75,.747,31,81,112,21,18,13,40,76,348,5.9
2624,Rod Hall\rod-hall-1,2013-14,Clemson,G,36,36,1194,110,254,.433,88,187,.471,22,67,.328,106,140,.757,14,77,91,143,16,5,72,37,348,7.4
2625,Joe McDonald\joe-mcdonald-2,2014-15,George Washington,G,35,35,1103,122,287,.425,81,177,.458,41,110,.373,63,115,.548,65,137,202,110,43,2,61,75,348,8.3
2626,Curran Scott\curran-scott-1,2015-16,Charlotte,G,33,18,815,100,221,.452,75,164,.457,25,57,.439,122,147,.830,11,65,76,44,17,1,55,72,347,6.5
2627,Matty McConnell\matty-mcconnell-1,2017-18,Robert Morris,G,32,30,1021,105,299,.351,50,115,.435,55,184,.299,82,103,.796,15,125,140,89,64,16,53,76,347,8.5
2628,Devaugntah Williams\devaugntah-williams-1,2015-16,Texas Tech,G,32,20,837,118,301,.392,83,188,.441,35,113,.310,76,97,.784,32,67,99,51,27,7,53,56,347,6.6
2629,Quentin Snider\quentin-snider-1,2016-17,Louisville,G,28,28,877,116,301,.385,60,151,.397,56,150,.373,59,82,.720,22,53,75,115,17,0,42,43,347,8.7
2630,Malique Trent\malique-trent-1,2015-16,Texas Christian,G,30,27,852,117,301,.389,84,170,.494,33,131,.252,80,128,.625,10,79,89,82,63,8,84,91,347,6.7
2631,Jeff Newberry\jeff-newberry-1,2015-16,Oklahoma State,G,32,32,969,113,294,.384,81,191,.424,32,103,.311,89,108,.824,36,115,151,48,49,16,38,70,347,8.3
2632,Arthur Johnson\arthur-johnson-3,2017-18,Alabama A&M,G,31,28,862,121,298,.406,73,162,.451,48,136,.353,57,78,.731,46,117,163,46,23,3,80,88,347,6.1
2633,Garrett Nevels\garrett-nevels-1,2014-15,Hawaii,G,32,31,984,131,320,.409,83,181,.459,48,139,.345,37,48,.771,37,105,142,43,24,12,37,62,347,7.2
2634,Artur Labinowicz\artur-labinowicz-1,2017-18,Coastal Carolina,G,32,17,873,97,265,.366,47,117,.402,50,148,.338,103,134,.769,31,110,141,36,22,18,62,55,347,6.8
2635,Malik Jackson\malik-jackson-1,2013-14,Bethune-Cookman,G,32,27,829,118,296,.399,67,156,.429,51,140,.364,60,77,.779,26,111,137,21,25,19,40,109,347,6.3
2636,Breein Tyree\breein-tyree-1,2017-18,Mississippi,G,32,23,807,122,310,.394,75,178,.421,47,132,.356,56,80,.700,11,59,70,90,22,9,58,64,347,6.3
2637,Ryan Funk\ryan-funk-1,2016-17,Marist,G,28,28,879,111,254,.437,30,54,.556,81,200,.405,44,53,.830,11,61,72,22,14,1,32,74,347,7.3
2638,C.J. Massinburg\cj-massinburg-1,2016-17,Buffalo,G,24,18,777,108,263,.411,61,121,.504,47,142,.331,84,112,.750,32,102,134,67,15,3,49,40,347,10.3
2639,Julian DeBose\julian-debose-1,2014-15,Florida Gulf Coast,G,30,25,932,128,296,.432,95,192,.495,33,104,.317,58,81,.716,36,82,118,41,28,23,41,69,347,7.9
2640,Ronnie Johnson\ronnie-johnson-1,2013-14,Purdue,G,32,31,901,123,294,.418,106,238,.445,17,56,.304,84,126,.667,27,64,91,117,16,0,70,76,347,6.5
2641,Jahmel Taylor\jahmel-taylor-1,2016-17,Fresno State,G,33,28,1101,105,246,.427,24,65,.369,81,181,.448,55,70,.786,14,99,113,59,40,6,36,74,346,8.2
2642,Trey Davis\trey-davis-1,2014-15,Massachusetts,G,32,32,982,110,288,.382,63,134,.470,47,154,.305,79,96,.823,20,69,89,121,32,3,64,65,346,7.7
2643,James Miller\james-miller-2,2014-15,Howard,G,30,30,770,125,248,.504,106,195,.544,19,53,.358,77,107,.720,23,59,82,27,31,7,64,68,346,6.9
2644,Ryan Funk\ryan-funk-1,2017-18,Marist,G,30,30,939,108,257,.420,31,68,.456,77,189,.407,53,70,.757,9,78,87,14,13,5,24,55,346,7.1
2645,Jimmy Whitt\jimmy-whitt-1,2017-18,Southern Methodist,G,33,33,1096,140,287,.488,134,266,.504,6,21,.286,60,101,.594,50,121,171,114,60,16,54,76,346,9.8
2646,Jay Hook\jay-hook-1,2014-15,Tulane,G,31,31,928,111,270,.411,40,88,.455,71,182,.390,53,66,.803,32,125,157,27,26,4,35,57,346,7.9
2647,Tavon Blackmon\tavon-blackmon-1,2015-16,Brown,G,26,26,894,114,250,.456,86,187,.460,28,63,.444,90,120,.750,10,50,60,144,30,0,83,62,346,9.6
2648,Matt Coleman\matt-coleman-3,2017-18,Texas,G,34,34,1157,124,302,.411,96,204,.471,28,98,.286,70,89,.787,24,61,85,139,40,1,74,103,346,6.9
2649,DeAndre Haywood\deandre-haywood-1,2015-16,Delaware State,G,30,19,773,127,271,.469,109,211,.517,18,60,.300,74,138,.536,25,75,100,72,39,3,63,68,346,7.4
2650,Timmy Knipp\timmy-knipp-1,2014-15,Eastern Kentucky,G,33,32,975,114,272,.419,41,81,.506,73,191,.382,45,54,.833,21,104,125,61,29,40,50,64,346,8.1
2651,Logan McIntosh\logan-mcintosh-1,2017-18,Maryland-Eastern Shore,G,29,26,1032,111,291,.381,84,199,.422,27,92,.293,97,129,.752,19,96,115,133,29,2,84,44,346,8.2
2652,Brandon Venturini\brandon-venturini-1,2013-14,Navy,G,30,30,841,132,335,.394,74,160,.463,58,175,.331,24,41,.585,9,83,92,86,44,3,72,60,346,6.6
2653,Ahmad Frost\ahmad-frost-1,2017-18,Maryland-Eastern Shore,G,32,28,1069,124,343,.362,64,153,.418,60,190,.316,38,57,.667,23,73,96,76,41,0,71,87,346,5.4
2654,Jaylen Fisher\jaylen-fisher-1,2016-17,Texas Christian,G,35,34,1032,117,300,.390,63,158,.399,54,142,.380,58,77,.753,13,55,68,140,36,5,94,72,346,6.2
2655,Bryce Scott\bryce-scott-1,2013-14,Lafayette,G,30,29,953,116,265,.438,71,141,.504,45,124,.363,69,80,.863,21,71,92,71,20,6,35,57,346,8.5
2656,Rashad Madden\rashad-madden-1,2014-15,Arkansas,G,36,32,980,100,236,.424,54,114,.474,46,122,.377,100,116,.862,31,101,132,164,29,5,84,80,346,8.3
2657,Glynn Watson Jr.\glynn-watsonjr-1,2017-18,Nebraska,G,33,32,981,120,346,.347,86,229,.376,34,117,.291,71,91,.780,24,86,110,106,47,7,48,78,345,7.0
2658,Lawrence Cooks\lawrence-cooks-1,2016-17,Hampton,G,30,19,888,105,270,.389,35,91,.385,70,179,.391,65,80,.813,17,102,119,77,26,1,49,73,345,7.9
2659,Nazareth Mitrou-Long\nazareth-mitrou-long-1,2014-15,Iowa State,G,34,33,934,114,254,.449,37,57,.649,77,197,.391,40,53,.755,6,94,100,68,27,3,47,72,345,7.1
2660,Jeremiah Samarrippas\jeremiah-samarrippas-1,2013-14,Tennessee Tech,G,33,32,991,112,282,.397,52,116,.448,60,166,.361,61,69,.884,13,69,82,158,46,0,100,71,345,7.5
2661,Jarred Jones\jarred-jones-1,2015-16,Loyola (MD),G,26,25,722,125,250,.500,125,244,.512,0,6,.000,95,121,.785,54,132,186,31,27,29,65,85,345,9.9
2662,Darius Gardner\darius-gardner-1,2014-15,American,G,33,33,1272,120,262,.458,84,179,.469,36,83,.434,69,93,.742,26,76,102,130,67,5,85,76,345,8.7
2663,Yunus Hopkinson\yunus-hopkinson-1,2016-17,St. Francis (NY),G,31,29,898,107,369,.290,43,138,.312,64,231,.277,67,92,.728,19,60,79,67,31,1,68,69,345,4.3
2664,George Marshall\george-marshall-1,2014-15,South Dakota State,G,26,26,896,114,289,.394,50,137,.365,64,152,.421,53,73,.726,4,93,97,59,19,2,54,53,345,7.6
2665,Jalen Jordan\jalen-jordan-1,2017-18,St. Francis (NY),G,31,30,855,108,260,.415,44,103,.427,64,157,.408,65,77,.844,16,73,89,30,18,4,35,57,345,7.0
2666,Dirk Williams\dirk-williams-2,2016-17,Alabama-Birmingham,G,33,30,948,121,297,.407,60,120,.500,61,177,.345,42,53,.792,16,96,112,53,14,9,47,53,345,6.4
2667,Patrick Cole\patrick-cole-1,2015-16,North Carolina Central,G,24,6,728,103,269,.383,76,183,.415,27,86,.314,112,151,.742,20,87,107,77,20,2,67,72,345,8.4
2668,Deron Powers\deron-powers-1,2014-15,Hampton,G,34,32,1111,107,277,.386,67,156,.429,40,121,.331,91,108,.843,27,79,106,128,41,2,55,77,345,8.1
2669,Kyle Vinales\kyle-vinales-1,2013-14,Central Connecticut State,G,20,10,648,110,287,.383,54,146,.370,56,141,.397,69,88,.784,3,30,33,78,29,0,60,47,345,9.8
2670,Kamar Baldwin\kamar-baldwin-1,2016-17,Butler,G,34,23,916,138,279,.495,103,185,.557,35,94,.372,34,45,.756,15,111,126,50,59,18,51,76,345,7.9
2671,Bobby Word\bobby-word-1,2016-17,Cleveland State,G,31,30,958,113,321,.352,47,115,.409,66,206,.320,53,74,.716,27,65,92,33,26,11,36,74,345,6.0
2672,Rhett Harrelson\rhett-harrelson-1,2015-16,Western Carolina,G,30,20,883,101,253,.399,20,60,.333,81,193,.420,62,73,.849,11,44,55,58,23,0,42,53,345,7.5
2673,Jay Harris\jay-harris-2,2014-15,Tennessee State,G,31,23,884,117,297,.394,57,151,.377,60,146,.411,51,73,.699,23,73,96,69,36,1,75,75,345,6.2
2674,Joe Cremo\joe-cremo-1,2015-16,Albany (NY),G,33,1,684,108,210,.514,89,162,.549,19,48,.396,110,128,.859,30,94,124,46,23,6,44,43,345,8.5
2675,Desmond Washington\desmond-washington-1,2014-15,Saint Peter's,G,25,25,827,98,261,.375,65,148,.439,33,113,.292,115,136,.846,11,85,96,34,31,1,42,41,344,8.9
2676,Devin Cherry\devin-cherry-1,2013-14,Cornell,G,28,28,907,120,285,.421,103,217,.475,17,68,.250,87,126,.690,25,94,119,98,21,6,84,77,344,7.2
2677,Tony Hicks\tony-hicks-1,2014-15,Pennsylvania,G,26,25,715,114,283,.403,71,167,.425,43,116,.371,73,94,.777,12,79,91,65,22,0,83,77,344,6.5
2678,Muhammad-Ali Abdur-Rahkman\muhammad-ali-abdur-rahkman-1,2016-17,Michigan,G,38,37,1164,120,259,.463,78,148,.527,42,111,.378,62,81,.765,27,78,105,74,35,4,40,82,344,6.9
2679,Sekou Wiggs\sekou-wiggs-1,2014-15,Idaho,G,30,29,790,115,253,.455,107,225,.476,8,28,.286,106,143,.741,26,85,111,81,17,7,61,70,344,7.7
2680,Darrion Allen\darrion-allen-1,2015-16,Longwood,G,33,33,1058,116,261,.444,62,144,.431,54,117,.462,58,66,.879,32,94,126,46,48,21,53,86,344,8.0
2681,Marvin Jean-Pierre\marvin-jean-pierre-1,2017-18,Louisiana-Monroe,G,32,28,937,134,282,.475,104,187,.556,30,95,.316,46,66,.697,61,106,167,74,39,8,55,85,344,8.6
2682,Broderick Robinson\broderick-robinson-1,2017-18,Missouri-Kansas City,G,31,31,979,113,289,.391,50,113,.442,63,176,.358,55,79,.696,32,129,161,58,44,4,48,63,344,8.1
2683,Melvin Frazier\melvin-frazier-1,2016-17,Tulane,G,30,28,907,117,267,.438,89,161,.553,28,106,.264,82,123,.667,39,99,138,46,56,14,72,80,344,8.0
2684,Cortez Mitchell\cortez-mitchell-1,2016-17,Charleston Southern,G,31,19,749,127,279,.455,101,205,.493,26,74,.351,64,108,.593,16,73,89,60,27,4,40,66,344,7.1
2685,Antino Jackson\antino-jackson-1,2017-18,New Mexico,G,33,23,775,112,275,.407,43,97,.443,69,178,.388,51,67,.761,11,57,68,151,47,0,80,80,344,7.7
2686,Seth Hinrichs\seth-hinrichs-1,2013-14,Lafayette,G,21,20,638,118,241,.490,78,145,.538,40,96,.417,68,78,.872,37,89,126,34,24,5,58,35,344,11.9
2687,Mo Evans\mo-evans-1,2013-14,Purdue-Fort Wayne,G,36,0,783,113,237,.477,49,95,.516,64,142,.451,54,68,.794,16,81,97,67,45,5,53,67,344,7.5
2688,Steve Glowiak\steve-glowiak-1,2013-14,Sacred Heart,G,31,6,835,111,286,.388,27,67,.403,84,219,.384,38,47,.809,24,58,82,29,27,1,19,54,344,7.3
2689,Jordan Parks\jordan-parks-1,2013-14,North Carolina Central,G,34,0,645,137,208,.659,130,196,.663,7,12,.583,63,98,.643,82,107,189,21,26,38,36,110,344,9.3
2690,Greg Pryor\greg-pryor-1,2015-16,Chattanooga,G,35,33,1027,91,242,.376,50,113,.442,41,129,.318,121,153,.791,17,62,79,121,50,2,72,95,344,7.3
2691,Tai Webster\tai-webster-1,2015-16,Nebraska,G,34,18,941,126,266,.474,105,206,.510,21,60,.350,71,96,.740,27,113,140,66,46,12,72,74,344,7.4
2692,Jabari Peters\jabari-peters-1,2014-15,Sam Houston State,G,35,35,1017,107,260,.412,55,104,.529,52,156,.333,78,110,.709,40,122,162,81,48,11,64,50,344,8.1
2693,Nate Engesser\nate-engesser-1,2015-16,Denver,G,31,3,656,117,226,.518,63,100,.630,54,126,.429,56,67,.836,9,62,71,37,16,4,33,41,344,8.0
2694,Divine Myles\divine-myles-1,2014-15,Stetson,G,31,30,939,128,319,.401,107,253,.423,21,66,.318,67,99,.677,20,94,114,106,36,7,52,62,344,7.7
2695,Jalen Lindsey\jalen-lindsey-1,2016-17,Providence,G,32,32,1026,106,232,.457,32,71,.451,74,161,.460,57,77,.740,38,100,138,22,28,8,23,69,343,8.4
2696,Aaron Bacote\aaron-bacote-1,2014-15,Old Dominion,G,35,35,955,101,267,.378,63,147,.429,38,120,.317,103,122,.844,23,84,107,95,24,1,47,58,343,7.2
2697,Emmett Naar\emmett-naar-1,2017-18,Saint Mary's (CA),G,36,36,1274,126,267,.472,101,204,.495,25,63,.397,66,78,.846,11,76,87,284,29,5,102,44,343,9.6
2698,Federico Mussini\federico-mussini-1,2015-16,St. John's (NY),G,32,24,938,103,305,.338,47,121,.388,56,184,.304,81,94,.862,14,64,78,70,38,2,73,41,343,6.0
2699,Cazmon Hayes\cazmon-hayes-1,2014-15,Delaware,G,30,30,838,111,281,.395,61,128,.477,50,153,.327,71,103,.689,17,80,97,29,27,3,37,56,343,6.8
2700,Silas Melson\silas-melson-1,2017-18,Gonzaga,G,37,37,1137,118,289,.408,57,125,.456,61,164,.372,46,55,.836,16,98,114,83,39,5,36,88,343,6.9
2701,Damiyne Durham\damiyne-durham-1,2017-18,Cal State Bakersfield,G,28,12,751,124,331,.375,55,108,.509,69,223,.309,26,38,.684,21,59,80,38,31,10,39,31,343,7.2
2702,Matt Howard\matt-howard-2,2015-16,Pennsylvania,G,28,28,859,125,271,.461,92,155,.594,33,116,.284,60,89,.674,48,111,159,32,25,10,43,70,343,8.6
2703,Josh Davis\josh-davis-7,2017-18,Western Michigan,G,32,29,881,125,263,.475,83,147,.565,42,116,.362,51,75,.680,63,140,203,39,27,21,47,76,343,8.7
2704,Eddie Reese\eddie-reese-1,2017-18,Southern,G,31,22,905,107,266,.402,46,98,.469,61,168,.363,68,97,.701,18,80,98,104,35,14,72,61,343,7.9
2705,Derek Jackson\derek-jackson-1,2013-14,Kent State,G,32,30,1019,117,270,.433,71,146,.486,46,124,.371,63,85,.741,24,93,117,64,59,4,54,33,343,8.6
2706,A.J. Lawson\aj-lawson-1,2016-17,North Texas,G,30,19,694,131,294,.446,115,235,.489,16,59,.271,65,109,.596,44,88,132,31,31,5,49,72,343,6.9
2707,Matt Smith\matt-smith-8,2016-17,Cal State Bakersfield,G,34,34,842,129,250,.516,129,250,.516,0,0,,84,136,.618,89,106,195,19,29,28,62,124,342,7.1
2708,Garrett Sams\garrett-sams-1,2016-17,North Florida,G,33,24,821,96,238,.403,47,122,.385,49,116,.422,101,131,.771,36,101,137,49,32,10,68,69,342,7.1
2709,Cortez Edwards\cortez-edwards-1,2016-17,Southern Mississippi,G,31,21,1018,134,294,.456,115,231,.498,19,63,.302,55,82,.671,28,133,161,113,45,16,63,47,342,9.4
2710,Jaleen Smith\jaleen-smith-1,2014-15,New Hampshire,G,32,32,1014,110,264,.417,79,170,.465,31,94,.330,91,113,.805,26,140,166,90,43,11,72,85,342,8.1
2711,Marshawn Wilson\marshawn-wilson-1,2015-16,Northern Illinois,G,31,9,588,109,249,.438,52,111,.468,57,138,.413,67,90,.744,21,64,85,31,20,2,32,55,342,7.3
2712,Jabari Bird\jabari-bird-1,2015-16,University of California,G,33,22,883,125,270,.463,64,121,.529,61,149,.409,31,46,.674,25,85,110,31,17,11,27,56,342,7.2
2713,Melvin Johnson\melvin-johnson-2,2013-14,Virginia Commonwealth,G,33,7,739,123,305,.403,57,138,.413,66,167,.395,30,41,.732,15,56,71,40,30,2,47,52,342,5.8
2714,Aaron Craft\aaron-craft-1,2013-14,Ohio State,G,35,35,1204,113,239,.473,97,186,.522,16,53,.302,100,135,.741,11,116,127,164,89,3,90,85,342,9.4
2715,J.C. Fuller\jc-fuller-1,2015-16,Western Illinois,G,27,24,783,123,310,.397,86,205,.420,37,105,.352,59,67,.881,24,97,121,51,17,9,51,50,342,7.6
2716,Dante Holmes\dante-holmes-1,2014-15,North Carolina Central,G,33,33,934,123,302,.407,75,164,.457,48,138,.348,48,83,.578,34,120,154,78,44,1,60,113,342,6.7
2717,Jehvon Clarke\jehvon-clarke-1,2014-15,Bowling Green State,G,32,8,771,121,280,.432,79,165,.479,42,115,.365,58,72,.806,27,70,97,50,27,1,47,41,342,7.1
2718,James Walker\james-walker-3,2013-14,Saint Mary's (CA),G,35,35,1061,104,280,.371,53,141,.376,51,139,.367,83,114,.728,26,88,114,46,49,5,50,77,342,6.4
2719,Bryant McIntosh\bryant-mcintosh-1,2017-18,Northwestern,G,29,29,908,127,327,.388,88,210,.419,39,117,.333,49,58,.845,13,56,69,149,13,3,74,46,342,7.4
2720,Daniel Kinchen\daniel-kinchen-1,2017-18,Southern Illinois-Edwardsville,G,30,8,743,103,302,.341,42,105,.400,61,197,.310,75,83,.904,8,42,50,68,18,1,63,47,342,5.7
2721,Brian Darden\brian-darden-1,2014-15,Hampton,G,35,20,833,93,261,.356,24,68,.353,69,193,.358,87,103,.845,7,52,59,34,19,1,44,77,342,5.1
2722,Will Sullivan\will-sullivan-1,2014-15,Miami (OH),G,32,31,1034,109,225,.484,41,72,.569,68,153,.444,56,69,.812,28,127,155,47,28,1,43,51,342,8.7
2723,Schadrac Casimir\schadrac-casimir-1,2017-18,Iona,G,33,22,899,99,224,.442,34,82,.415,65,142,.458,79,96,.823,14,49,63,65,26,0,38,65,342,7.6
2724,Dazon Ingram\dazon-ingram-1,2017-18,Alabama,G,35,33,1007,100,235,.426,81,168,.482,19,67,.284,122,177,.689,33,167,200,92,30,12,79,93,341,7.3
2725,Ty Toney\ty-toney-1,2015-16,Eastern Michigan,G,31,31,935,113,286,.395,98,220,.445,15,66,.227,100,138,.725,15,83,98,89,49,9,79,77,341,6.9
2726,Jackson Kent\jackson-kent-1,2014-15,James Madison,G,33,33,1050,108,259,.417,48,116,.414,60,143,.420,65,82,.793,14,106,120,55,28,0,49,38,341,7.3
2727,Diamante Lewis\diamante-lewis-1,2016-17,Bethune-Cookman,G,31,21,944,127,333,.381,106,260,.408,21,73,.288,66,99,.667,51,105,156,142,44,3,85,79,341,7.8
2728,Michael Calder\michael-calder-1,2015-16,Purdue-Fort Wayne,G,34,16,882,112,292,.384,61,152,.401,51,140,.364,66,96,.688,19,110,129,83,18,4,81,74,341,5.4
2729,Avry Holmes\avry-holmes-1,2016-17,Clemson,G,33,33,886,103,248,.415,34,92,.370,69,156,.442,66,81,.815,16,63,79,44,34,1,27,40,341,7.7
2730,Arkel Lamar\arkel-lamar-1,2017-18,Maryland-Baltimore County,G,33,30,901,116,292,.397,50,137,.365,66,155,.426,43,79,.544,38,157,195,37,38,17,39,80,341,7.5
2731,Edmond Sumner\edmond-sumner-1,2015-16,Xavier,G,31,29,802,102,257,.397,77,174,.443,25,83,.301,112,154,.727,17,89,106,112,39,6,65,72,341,8.1
2732,Devon Turk\devon-turk-1,2015-16,Loyola (IL),G,31,23,784,127,282,.450,72,132,.545,55,150,.367,32,41,.780,10,82,92,22,15,4,29,65,341,6.5
2733,Jordan Woodard\jordan-woodard-1,2013-14,Oklahoma,G,33,33,925,84,235,.357,57,162,.352,27,73,.370,146,188,.777,13,59,72,152,34,4,70,65,341,8.1
2734,Shivaughn Wiggins\shivaughn-wiggins-1,2014-15,Coastal Carolina,G,34,34,1059,105,231,.455,88,182,.484,17,49,.347,114,161,.708,12,82,94,111,41,3,42,59,341,8.6
2735,Austin Price\austin-price-1,2014-15,Lehigh,G,30,28,847,119,275,.433,74,158,.468,45,117,.385,58,73,.795,22,68,90,59,46,11,58,65,341,7.9
2736,Kevin Hardy\kevin-hardy-1,2013-14,McNeese State,G,31,31,1099,126,273,.462,113,236,.479,13,37,.351,75,118,.636,64,145,209,134,62,28,80,92,340,10.6
2737,De'Antae McMurray\deantae-mcmurray-1,2017-18,Drake,G,34,33,1031,119,316,.377,75,177,.424,44,139,.317,58,79,.734,13,125,138,87,39,2,69,68,340,6.2
2738,Brandon Randolph\brandon-randolph-1,2016-17,Utah Valley,G,34,25,932,115,292,.394,89,196,.454,26,96,.271,84,112,.750,21,153,174,133,35,4,110,72,340,6.6
2739,Devante Wallace\devante-wallace-1,2014-15,High Point,G,33,31,913,116,267,.434,52,105,.495,64,162,.395,44,59,.746,45,139,184,46,31,18,44,65,340,8.3
2740,Shawn Johnson\shawn-johnson-1,2017-18,Incarnate Word,G,28,27,898,106,261,.406,48,100,.480,58,161,.360,70,99,.707,30,159,189,52,41,44,41,67,340,10.6
2741,Mark Hughes\mark-hughes-1,2017-18,Wright State,G,35,33,1101,109,268,.407,46,85,.541,63,183,.344,59,71,.831,9,100,109,105,41,9,57,83,340,7.4
2742,Keon Lewis\keon-lewis-1,2013-14,Texas-San Antonio,G,27,18,762,87,242,.360,62,164,.378,25,78,.321,141,168,.839,17,45,62,70,18,0,71,69,340,7.0
2743,Wayne Selden\wayne-selden-1,2013-14,Kansas,G,35,35,1023,121,277,.437,79,149,.530,42,128,.328,56,89,.629,32,60,92,87,25,11,66,71,340,6.3
2744,Todd Mayo\todd-mayo-1,2013-14,Marquette,G,30,0,715,105,228,.461,80,153,.523,25,75,.333,105,129,.814,11,69,80,61,26,6,61,55,340,7.7
2745,Stephen Thompson Jr.\stephen-thompsonjr-1,2015-16,Oregon State,G,32,5,694,118,291,.405,70,163,.429,48,128,.375,56,81,.691,26,35,61,26,37,11,27,55,340,6.8
2746,C.J. Anderson\cj-anderson-3,2017-18,Massachusetts,G,32,28,1126,115,278,.414,83,198,.419,32,80,.400,78,96,.813,29,132,161,165,22,5,76,77,340,8.7
2747,Dayton Gumm\dayton-gumm-1,2017-18,Austin Peay,G,33,28,860,123,294,.418,82,174,.471,41,120,.342,53,89,.596,28,68,96,60,38,0,56,63,340,6.3
2748,Anthony Cowan\anthony-cowan-1,2016-17,Maryland,G,33,33,957,97,229,.424,71,148,.480,26,81,.321,120,156,.769,29,100,129,123,40,5,76,67,340,8.5
2749,Taylor Barnette\taylor-barnette-1,2016-17,Belmont,G,30,30,995,102,297,.343,39,76,.513,63,221,.285,73,81,.901,11,70,81,55,11,4,43,62,340,6.1
2750,James Milliken\james-milliken-1,2015-16,Creighton,G,35,11,921,109,264,.413,59,122,.484,50,142,.352,72,102,.706,10,63,73,62,14,2,29,47,340,6.4
2751,Jordan Davis\jordan-davis-2,2015-16,Northern Colorado,G,31,29,825,117,237,.494,106,202,.525,11,35,.314,95,136,.699,18,95,113,66,40,12,67,98,340,7.5
2752,Gabe York\gabe-york-1,2014-15,Arizona,G,37,13,856,107,243,.440,41,78,.526,66,165,.400,60,74,.811,6,71,77,45,22,13,37,45,340,6.5
2753,Kyle Fuller\kyle-fuller-1,2013-14,Vanderbilt,G,31,22,983,103,281,.367,80,190,.421,23,91,.253,111,152,.730,12,104,116,130,22,2,93,45,340,6.8
2754,Dakota Mathias\dakota-mathias-1,2016-17,Purdue,G,35,35,1111,118,251,.470,46,92,.500,72,159,.453,32,39,.821,11,126,137,133,30,4,52,75,340,8.5
2755,Ryan Jones\ryan-jones-4,2017-18,Massachusetts-Lowell,G,30,30,947,114,254,.449,71,141,.504,43,113,.381,69,99,.697,22,117,139,91,19,5,68,48,340,8.2
2756,Lionheart Leslie\lionheart-leslie-1,2016-17,Cal State Fullerton,G,32,29,836,114,245,.465,100,182,.549,14,63,.222,98,132,.742,38,95,133,76,57,4,59,100,340,8.4
2757,Luke Doyle\luke-doyle-1,2016-17,Stetson,G,32,32,944,123,304,.405,47,100,.470,76,204,.373,18,30,.600,12,106,118,40,21,3,31,62,340,6.5
2758,Justin Robinson\justin-robinson-3,2016-17,Virginia Tech,G,33,33,1040,99,241,.411,61,133,.459,38,108,.352,103,134,.769,16,84,100,160,23,6,81,81,339,7.9
2759,Gary Winston\gary-winston-1,2014-15,Portland State,G,28,28,884,116,282,.411,63,158,.399,53,124,.427,54,66,.818,5,58,63,104,16,1,63,53,339,7.5
2760,Justin Roberson\justin-roberson-1,2014-15,Louisiana-Monroe,G,38,28,1059,132,333,.396,124,290,.428,8,43,.186,67,91,.736,36,116,152,105,45,8,72,103,339,5.8
2761,Taylor Barnette\taylor-barnette-1,2014-15,Belmont,G,32,31,951,121,277,.437,37,62,.597,84,215,.391,13,30,.433,5,78,83,42,26,1,26,53,339,7.0
2762,Jamaya Burr\jamaya-burr-1,2016-17,McNeese State,G,29,24,842,110,256,.430,74,172,.430,36,84,.429,83,124,.669,18,62,80,102,32,1,70,41,339,8.1
2763,Cullen Neal\cullen-neal-1,2016-17,Mississippi,G,36,13,846,99,241,.411,36,87,.414,63,154,.409,78,89,.876,10,51,61,77,16,1,54,72,339,6.0
2764,Ricky Johnson\ricky-johnson-1,2015-16,Bethune-Cookman,G,32,30,1030,102,295,.346,53,126,.421,49,169,.290,86,110,.782,19,69,88,57,26,0,53,66,339,5.8
2765,John Dewey III\john-deweyiii-1,2016-17,Sam Houston State,G,34,31,972,112,262,.427,82,177,.463,30,85,.353,85,115,.739,23,96,119,168,47,1,110,87,339,7.5
2766,Derreck Brooks\derreck-brooks-1,2015-16,Central Arkansas,G,28,28,869,124,297,.418,87,197,.442,37,100,.370,54,69,.783,54,122,176,73,34,26,53,85,339,9.5
2767,Wayne Selden\wayne-selden-1,2014-15,Kansas,G,36,36,1060,112,293,.382,66,167,.395,46,126,.365,69,105,.657,34,67,101,95,22,19,74,75,339,5.7
2768,Taylor Barnette\taylor-barnette-1,2015-16,Belmont,G,32,32,936,113,272,.415,39,70,.557,74,202,.366,39,49,.796,6,65,71,65,14,5,17,48,339,7.5
2769,Fred Sims Jr.\fred-simsjr-1,2015-16,Chicago State,G,31,14,643,126,362,.348,86,234,.368,40,128,.313,47,57,.825,26,54,80,27,22,5,33,42,339,5.2
2770,Greg Pryor\greg-pryor-1,2014-15,Chattanooga,G,30,30,823,105,231,.455,61,115,.530,44,116,.379,85,114,.746,14,63,77,76,41,4,60,78,339,8.1
2771,Ray Bowles\ray-bowles-1,2017-18,Fresno State,G,32,32,1020,123,284,.433,89,180,.494,34,104,.327,58,95,.611,20,88,108,65,31,4,46,78,338,6.8
2772,Devin Sibley\devin-sibley-1,2014-15,Furman,G,33,21,826,103,237,.435,67,140,.479,36,97,.371,96,128,.750,21,77,98,40,24,10,72,71,338,6.0
2773,Cam Ward\cam-ward-1,2015-16,Vermont,G,37,3,885,112,263,.426,61,118,.517,51,145,.352,63,83,.759,10,80,90,88,23,1,46,69,338,6.3
2774,Duke Mondy\duke-mondy-1,2013-14,Oakland,G,29,28,956,114,287,.397,86,201,.428,28,86,.326,82,120,.683,34,110,144,121,90,10,71,94,338,10.3
2775,Saben Lee\saben-lee-1,2017-18,Vanderbilt,G,32,29,857,115,249,.462,92,174,.529,23,75,.307,85,117,.726,22,73,95,99,39,5,71,78,338,7.6
2776,A.J. Hess\aj-hess-1,2014-15,Southern Utah,G,29,28,743,106,241,.440,49,103,.476,57,138,.413,69,82,.841,13,95,108,28,15,17,39,78,338,7.6
2777,Nigel Ribeiro\nigel-ribeiro-1,2015-16,Grambling,G,31,15,917,125,302,.414,85,171,.497,40,131,.305,48,75,.640,11,75,86,67,46,2,64,75,338,6.3
2778,Glen Burns\glen-burns-1,2017-18,Chicago State,G,32,32,1000,105,223,.471,94,188,.500,11,35,.314,117,154,.760,32,101,133,110,41,3,96,95,338,7.7
2779,Jaron Johnson\jaron-johnson-1,2013-14,Louisiana Tech,G,37,18,794,115,226,.509,84,128,.656,31,98,.316,77,108,.713,63,68,131,27,23,12,31,74,338,7.2
2780,Mike Crawford\mike-crawford-1,2016-17,Saint Louis,G,33,31,1030,123,324,.380,92,204,.451,31,120,.258,61,92,.663,16,104,120,70,25,9,56,73,338,5.6
2781,Jeremy Senglin\jeremy-senglin-1,2013-14,Weber State,G,31,31,920,107,241,.444,45,88,.511,62,153,.405,62,81,.765,7,61,68,68,22,6,48,67,338,7.3
2782,Adedeji Ibitayo\adedeji-ibitayo-1,2014-15,Akron,G,34,3,660,105,233,.451,67,132,.508,38,101,.376,90,121,.744,38,68,106,33,29,14,39,74,338,7.2
2783,Deishuan Booker\deishuan-booker-1,2017-18,Cal State Long Beach,G,32,28,960,110,220,.500,83,149,.557,27,71,.380,91,106,.858,16,97,113,148,47,7,94,76,338,9.2
2784,Austin Nehls\austin-nehls-1,2015-16,Central Connecticut State,G,29,28,1023,102,273,.374,31,87,.356,71,186,.382,63,81,.778,34,76,110,47,16,6,51,63,338,7.0
2785,Royce Woolridge\royce-woolridge-1,2014-15,Grand Canyon,G,32,30,810,110,241,.456,90,179,.503,20,62,.323,98,132,.742,9,79,88,72,29,3,71,76,338,6.6
2786,Aaron Parks\aaron-parks-1,2014-15,Cal State Northridge,G,32,11,926,93,261,.356,81,213,.380,12,48,.250,140,181,.773,15,81,96,58,23,10,73,85,338,5.5
2787,Louis Munks\louis-munks-1,2013-14,Prairie View,G,34,13,789,104,281,.370,65,158,.411,39,123,.317,91,118,.771,25,88,113,23,23,2,52,70,338,5.2
2788,Zach Stahl\zach-stahl-1,2015-16,Northeastern,G,32,29,949,134,257,.521,133,253,.526,1,4,.250,69,97,.711,50,145,195,72,27,18,92,89,338,7.5
2789,Shakir Brown\shakir-brown-1,2015-16,James Madison,G,31,23,762,111,272,.408,55,125,.440,56,147,.381,60,74,.811,48,129,177,39,21,9,42,80,338,7.7
2790,Tyler Lamb\tyler-lamb-1,2013-14,Cal State Long Beach,G,22,18,622,112,270,.415,68,151,.450,44,119,.370,70,92,.761,18,61,79,48,30,8,52,48,338,9.7
2791,Stevie Jordan\stevie-jordan-1,2016-17,Rider,G,29,27,907,116,261,.444,94,189,.497,22,72,.306,84,133,.632,27,88,115,161,39,9,103,82,338,8.6
2792,Sam Logwood\sam-logwood-1,2017-18,New Mexico,G,26,14,669,121,246,.492,117,235,.498,4,11,.364,92,115,.800,48,88,136,40,14,0,59,67,338,8.5
2793,Dikymbe Martin\dikymbe-martin-1,2017-18,UC-Riverside,G,25,20,788,115,274,.420,84,198,.424,31,76,.408,76,89,.854,14,75,89,71,30,0,68,56,337,8.3
2794,Luwane Pipkins\luwane-pipkins-1,2016-17,Massachusetts,G,33,27,908,110,324,.340,39,101,.386,71,223,.318,46,71,.648,18,59,77,77,63,1,51,68,337,6.5
2795,Ahmad Walker\ahmad-walker-1,2015-16,Stony Brook,G,33,33,962,112,259,.432,97,194,.500,15,65,.231,98,142,.690,54,169,223,139,33,8,102,94,337,8.1
2796,Ryan Arcidiacono\ryan-arcidiacono-1,2013-14,Villanova,G,34,33,1059,107,271,.395,48,100,.480,59,171,.345,64,91,.703,11,71,82,118,37,1,48,73,337,7.4
2797,Geovonie McKnight\geovonie-mcknight-1,2014-15,Miami (OH),G,32,31,964,130,304,.428,125,273,.458,5,31,.161,72,103,.699,19,90,109,43,46,6,62,68,337,6.1
2798,Reece Chamberlain\reece-chamberlain-1,2013-14,Belmont,G,31,31,1004,104,220,.473,82,155,.529,22,65,.338,107,142,.754,43,72,115,170,44,5,82,83,337,10.1
2799,Christian Terrell\christian-terrell-1,2016-17,Florida Gulf Coast,G,33,31,937,120,284,.423,67,133,.504,53,151,.351,44,61,.721,26,79,105,80,26,8,39,57,337,7.5
2800,Alex Copeland\alex-copeland-1,2017-18,Yale,G,30,24,799,124,276,.449,100,209,.478,24,67,.358,65,75,.867,13,61,74,82,32,1,62,39,337,7.6
2801,Jesse Berry\jesse-berry-1,2013-14,Ball State,G,30,16,854,101,292,.346,35,77,.455,66,215,.307,69,85,.812,8,32,40,39,19,2,60,54,337,4.9
2802,T.J. Williams\tj-williams-4,2014-15,Northeastern,G,35,35,1158,119,261,.456,91,180,.506,28,81,.346,71,118,.602,23,102,125,111,28,9,78,56,337,6.9
2803,Kameron McGusty\kameron-mcgusty-1,2016-17,Oklahoma,G,31,17,771,125,291,.430,87,183,.475,38,108,.352,49,63,.778,12,55,67,27,24,8,48,41,337,6.0
2804,Joe Thomasson\joe-thomasson-1,2015-16,Wright State,G,35,34,1044,105,246,.427,73,155,.471,32,91,.352,95,116,.819,18,167,185,117,29,16,74,96,337,7.7
2805,Malcolm Drumwright\malcolm-drumwright-1,2015-16,Jacksonville State,G,24,24,777,117,283,.413,86,192,.448,31,91,.341,72,93,.774,13,50,63,92,20,9,56,70,337,8.7
2806,Gerrell Martin\gerrell-martin-1,2014-15,Long Island University,G,30,29,795,111,281,.395,58,146,.397,53,135,.393,62,75,.827,32,79,111,20,18,2,37,34,337,6.9
2807,Javaris Jenkins\javaris-jenkins-1,2017-18,Savannah State,G,32,11,689,118,300,.393,61,104,.587,57,196,.291,44,50,.880,42,82,124,36,32,15,31,62,337,7.4
2808,Luke Eddy\luke-eddy-1,2015-16,Elon,G,32,32,849,114,287,.397,89,191,.466,25,96,.260,84,123,.683,20,73,93,144,33,1,93,50,337,7.0
2809,Devin Cannady\devin-cannady-1,2015-16,Princeton,G,29,0,638,100,205,.488,43,81,.531,57,124,.460,80,90,.889,19,53,72,36,31,5,33,57,337,9.1
2810,Rasheed Sulaimon\rasheed-sulaimon-1,2013-14,Duke,G,34,17,871,99,246,.402,56,141,.397,43,105,.410,96,125,.768,17,66,83,81,27,1,37,74,337,7.1
2811,James Robinson\james-robinson-2,2015-16,Pittsburgh,G,33,33,1055,113,303,.373,74,183,.404,39,120,.325,72,95,.758,14,91,105,166,38,8,42,67,337,8.8
2812,Greg Pryor\greg-pryor-1,2016-17,Chattanooga,G,28,27,833,103,225,.458,54,98,.551,49,127,.386,82,107,.766,14,55,69,79,46,4,63,64,337,9.0
2813,Kyle Leufroy\kyle-leufroy-1,2015-16,Lehigh,G,32,23,908,117,261,.448,72,159,.453,45,102,.441,58,72,.806,13,115,128,52,31,7,72,74,337,6.6
2814,Allen Huddleston\allen-huddleston-1,2013-14,Fresno State,G,38,5,848,101,249,.406,57,112,.509,44,137,.321,90,143,.629,13,67,80,56,46,2,34,61,336,6.3
2815,Dawon Cummings\dawon-cummings-1,2013-14,Indiana State,G,34,30,881,110,264,.417,59,112,.527,51,152,.336,65,86,.756,11,80,91,78,52,18,44,70,336,7.8
2816,Robert Hatter\robert-hatter-1,2016-17,Cornell,G,28,24,761,124,289,.429,94,164,.573,30,125,.240,58,80,.725,5,101,106,55,23,5,60,59,336,6.8
2817,Jarrey Foster\jarrey-foster-1,2016-17,Southern Methodist,G,34,32,1005,130,242,.537,98,170,.576,32,72,.444,44,76,.579,80,96,176,73,21,28,43,81,336,9.0
2818,Greg Mortimer\greg-mortimer-1,2016-17,South Carolina State,G,31,26,811,122,277,.440,95,195,.487,27,82,.329,65,92,.707,23,52,75,69,19,7,52,44,336,6.9
2819,Khy Kabellis\khy-kabellis-1,2016-17,North Dakota State,G,30,29,997,109,272,.401,60,141,.426,49,131,.374,69,102,.676,7,73,80,80,34,4,71,62,336,6.7
2820,Cedric Jenkins\cedric-jenkins-1,2014-15,Southeastern Louisiana,G,30,18,770,120,307,.391,85,169,.503,35,138,.254,61,81,.753,31,62,93,54,35,7,67,48,336,6.4
2821,Joe Sherburne\joe-sherburne-1,2015-16,Maryland-Baltimore County,G,32,32,1026,120,283,.424,59,108,.546,61,175,.349,35,44,.795,31,113,144,34,37,5,33,74,336,7.5
2822,Jaquori McLaughlin\jaquori-mclaughlin-1,2016-17,Oregon State,G,32,30,1082,113,295,.383,55,137,.401,58,158,.367,52,70,.743,6,63,69,104,26,9,69,90,336,6.0
2823,Ridge Shipley\ridge-shipley-1,2016-17,Cal Poly,G,31,29,955,118,293,.403,77,166,.464,41,127,.323,59,91,.648,13,62,75,106,32,0,58,68,336,6.9
2824,Jaylen Franklin\jaylen-franklin-1,2017-18,Abilene Christian,G,32,32,1027,142,255,.557,138,234,.590,4,21,.190,48,89,.539,35,90,125,143,59,6,86,77,336,9.2
2825,Garrius Adams\garrius-adams-1,2013-14,Miami (FL),G,33,33,1103,106,290,.366,78,180,.433,28,110,.255,96,143,.671,25,132,157,95,42,6,62,63,336,7.2
2826,Jonathan Williams\jonathan-williams-2,2014-15,Toledo,G,33,33,983,114,270,.422,62,126,.492,52,144,.361,56,77,.727,22,91,113,56,19,2,72,61,336,5.8
2827,Coron Williams\coron-williams-1,2013-14,Wake Forest,G,33,13,833,117,251,.466,46,75,.613,71,176,.403,31,37,.838,14,57,71,38,22,3,10,53,336,7.6
2828,Jalen Ross\jalen-ross-1,2015-16,Hartford,G,33,12,830,104,254,.409,62,142,.437,42,112,.375,86,111,.775,16,88,104,67,29,1,45,61,336,7.1
2829,Graham Woodward\graham-woodward-1,2015-16,Drake,G,31,27,927,113,285,.396,53,142,.373,60,143,.420,50,73,.685,4,37,41,89,23,0,78,64,336,5.4
2830,Niels Giffey\niels-giffey-1,2013-14,Connecticut,G,40,16,987,115,213,.540,57,93,.613,58,120,.483,48,66,.727,46,107,153,32,28,19,36,92,336,7.0
2831,Nick Lindner\nick-lindner-1,2013-14,Lafayette,G,31,28,946,100,224,.446,81,172,.471,19,52,.365,117,147,.796,13,45,58,124,25,1,74,64,336,7.8
2832,Keelan Garrett\keelan-garrett-1,2014-15,McNeese State,G,31,30,892,123,324,.380,54,121,.446,69,203,.340,21,32,.656,12,59,71,45,22,1,39,31,336,5.9
2833,Caleb Wood\caleb-wood-2,2017-18,Pennsylvania,G,33,1,648,115,247,.466,51,78,.654,64,169,.379,42,55,.764,13,53,66,32,11,3,23,51,336,6.7
2834,Rob Brandenberg\rob-brandenberg-1,2013-14,Virginia Commonwealth,G,35,35,931,117,294,.398,59,137,.431,58,157,.369,44,55,.800,23,51,74,54,43,11,30,59,336,6.8
2835,Deyshonee Much\deyshonee-much-1,2017-18,Iona,G,32,24,903,116,286,.406,49,117,.419,67,169,.396,36,44,.818,23,100,123,73,39,7,47,52,335,7.9
2836,Devaugntah Williams\devaugntah-williams-1,2014-15,Texas Tech,G,32,23,785,108,272,.397,54,134,.403,54,138,.391,65,85,.765,26,67,93,52,29,3,58,53,335,6.5
2837,Kevin Olekaibe\kevin-olekaibe-1,2013-14,Nevada-Las Vegas,G,33,32,1009,113,295,.383,43,99,.434,70,196,.357,39,53,.736,10,67,77,68,24,2,31,41,335,6.7
2838,Ike Smith\ike-smith-1,2017-18,Georgia Southern,G,28,21,708,126,319,.395,84,175,.480,42,144,.292,41,74,.554,18,101,119,25,13,19,63,64,335,5.3
2839,Kanayo Obi-Rapu\kanayo-obi-rapu-1,2015-16,Longwood,G,28,27,892,115,276,.417,52,112,.464,63,164,.384,42,57,.737,18,71,89,49,22,3,56,79,335,6.7
2840,Makale Foreman\makale-foreman-1,2017-18,Chattanooga,G,33,33,1161,110,276,.399,34,77,.442,76,199,.382,39,46,.848,13,54,67,60,25,0,48,54,335,6.2
2841,Anthony Hubbard\anthony-hubbard-1,2013-14,Morgan State,G,31,26,884,118,266,.444,102,192,.531,16,74,.216,83,135,.615,77,135,212,65,22,7,56,71,335,8.3
2842,Jeremiah Ingram\jeremiah-ingram-1,2015-16,North Carolina Central,G,32,32,875,122,264,.462,104,218,.477,18,46,.391,73,124,.589,60,138,198,32,17,15,81,119,335,5.7
2843,J.C. Fuller\jc-fuller-1,2014-15,Western Illinois,G,28,13,763,124,301,.412,94,208,.452,30,93,.323,57,74,.770,8,85,93,63,11,9,57,38,335,6.7
2844,Austin Ramljak\austin-ramljak-1,2013-14,Rice,G,29,29,878,101,256,.395,12,31,.387,89,225,.396,44,64,.688,9,62,71,36,19,1,34,62,335,6.9
2845,Kyree Jones\kyree-jones-1,2013-14,Maryland-Eastern Shore,G,25,23,814,94,299,.314,37,123,.301,57,176,.324,90,102,.882,16,46,62,55,24,1,47,39,335,7.4
2846,Malik Benlevi\malik-benlevi-1,2017-18,Georgia State,G,35,35,1225,117,266,.440,47,96,.490,70,170,.412,31,44,.705,51,176,227,59,51,31,24,78,335,9.6
2847,Elijah Mayes\elijah-mayes-1,2017-18,Florida A&M,G,30,30,885,130,270,.481,100,203,.493,30,67,.448,44,51,.863,8,55,63,85,27,0,53,78,334,7.3
2848,Greg Alexander\greg-alexander-1,2017-18,Mount St. Mary's,G,32,1,889,115,246,.467,42,64,.656,73,182,.401,31,40,.775,7,77,84,26,22,11,22,54,334,7.4
2849,Trey Zeigler\trey-zeigler-1,2014-15,Texas Christian,G,33,32,901,126,271,.465,126,261,.483,0,10,.000,82,132,.621,63,74,137,70,26,11,65,88,334,6.8
2850,Byron Ashe\byron-ashe-1,2014-15,Mount St. Mary's,G,28,4,717,116,276,.420,62,126,.492,54,150,.360,48,65,.738,17,56,73,35,31,10,40,47,334,7.6
2851,Terrence Phillips\terrence-phillips-1,2016-17,Missouri,G,32,23,907,100,274,.365,47,125,.376,53,149,.356,81,102,.794,7,110,117,142,44,4,79,114,334,7.3
2852,Pe'Shon Howard\peshon-howard-1,2013-14,Southern California,G,31,30,942,107,295,.363,61,145,.421,46,150,.307,74,96,.771,14,78,92,121,45,3,90,55,334,6.9
2853,Geno Crandall\geno-crandall-1,2015-16,North Dakota,G,31,27,936,113,272,.415,86,186,.462,27,86,.314,81,112,.723,19,111,130,129,59,8,92,104,334,7.9
2854,Mike McCall\mike-mccall-1,2013-14,Saint Louis,G,34,34,1022,115,286,.402,73,155,.471,42,131,.321,62,82,.756,35,95,130,80,47,3,43,53,334,7.8
2855,Zach Jackson\zach-jackson-1,2016-17,Omaha,G,31,29,852,101,219,.461,60,128,.469,41,91,.451,91,114,.798,44,91,135,29,25,3,40,63,334,8.1
2856,Michael Bryson\michael-bryson-1,2013-14,UC-Santa Barbara,G,29,29,845,116,246,.472,61,114,.535,55,132,.417,47,62,.758,24,101,125,46,20,20,57,86,334,7.7
2857,David Blanks\david-blanks-1,2015-16,Texas Southern,G,33,32,1080,109,280,.389,84,189,.444,25,91,.275,91,140,.650,33,117,150,148,32,4,96,71,334,7.1
2858,Andre Smith\andre-smith-3,2013-14,Winthrop,G,33,28,875,108,257,.420,37,87,.425,71,170,.418,47,58,.810,6,82,88,81,34,2,47,62,334,7.3
2859,B.J. Taylor\bj-taylor-1,2014-15,Central Florida,G,26,26,855,107,286,.374,62,157,.395,45,129,.349,75,106,.708,10,67,77,65,24,2,32,38,334,8.3
2860,Isaac White\isaac-white-1,2015-16,Massachusetts-Lowell,G,29,25,912,99,227,.436,29,63,.460,70,164,.427,66,83,.795,7,75,82,70,27,3,63,61,334,7.8
2861,A.J. Merriweather\aj-merriweather-1,2013-14,East Tennessee State,G,35,32,928,119,247,.482,106,217,.488,13,30,.433,82,122,.672,72,149,221,41,50,8,68,90,333,7.6
2862,Miles Wright\miles-wright-1,2017-18,Dartmouth,G,27,27,873,113,274,.412,63,127,.496,50,147,.340,57,69,.826,17,100,117,30,41,17,41,68,333,8.5
2863,C.J. Bryce\cj-bryce-1,2015-16,North Carolina-Wilmington,G,33,30,765,124,231,.537,111,201,.552,13,30,.433,72,114,.632,41,96,137,25,31,2,57,88,333,6.6
2864,Armon Fletcher\armon-fletcher-1,2016-17,Southern Illinois,G,30,28,904,116,274,.423,69,131,.527,47,143,.329,54,72,.750,43,100,143,31,40,18,33,85,333,8.3
2865,D'Marques Tyson\dmarques-tyson-1,2015-16,Portland,G,32,9,640,109,259,.421,23,50,.460,86,209,.411,29,38,.763,18,64,82,24,15,7,30,57,333,6.5
2866,A.J. Lawson\aj-lawson-1,2017-18,North Texas,G,37,30,935,128,311,.412,117,258,.453,11,53,.208,66,119,.555,47,133,180,78,29,12,74,115,333,5.1
2867,Josh Gasser\josh-gasser-1,2013-14,Wisconsin,G,38,38,1270,84,194,.433,37,85,.435,47,109,.431,118,136,.868,21,131,152,72,25,6,32,97,333,7.5
2868,Nate Darling\nate-darling-1,2017-18,Alabama-Birmingham,G,33,31,924,114,239,.477,53,90,.589,61,149,.409,44,53,.830,14,85,99,91,14,10,67,47,333,7.3
2869,Riley Grabau\riley-grabau-1,2013-14,Wyoming,G,33,33,1164,91,216,.421,23,54,.426,68,162,.420,83,93,.892,6,75,81,71,14,0,44,94,333,6.8
2870,Kelly Oubre\kelly-oubre-1,2014-15,Kansas,G,36,27,756,110,248,.444,76,153,.497,34,95,.358,79,110,.718,41,138,179,28,41,13,43,71,333,7.2
2871,Braylon Rayson\braylon-rayson-1,2013-14,Central Michigan,G,31,17,712,117,284,.412,76,143,.531,41,141,.291,58,88,.659,16,59,75,42,33,1,54,62,333,5.9
2872,Kalob Ledoux\kalob-ledoux-1,2016-17,McNeese State,G,28,14,689,118,259,.456,68,134,.507,50,125,.400,47,61,.770,14,63,77,30,12,1,65,54,333,6.0
2873,Brian Oliver\brian-oliver-2,2013-14,Seton Hall,G,32,20,855,108,270,.400,23,65,.354,85,205,.415,32,40,.800,16,95,111,31,28,9,32,74,333,6.8
2874,David Robertson\david-robertson-1,2014-15,North Carolina-Asheville,G,31,30,964,109,273,.399,55,116,.474,54,157,.344,61,83,.735,11,57,68,83,35,1,65,71,333,6.5
2875,A.J. Mosby\aj-mosby-1,2016-17,Alcorn State,G,32,30,995,112,280,.400,53,128,.414,59,152,.388,50,63,.794,24,126,150,87,43,3,49,55,333,8.3
2876,Trency Jackson\trency-jackson-2,2014-15,Western Kentucky,G,32,32,970,107,263,.407,55,134,.410,52,129,.403,67,96,.698,23,78,101,85,32,1,55,77,333,7.1
2877,Farad Cobb\farad-cobb-1,2015-16,Cincinnati,G,31,31,831,119,295,.403,45,107,.421,74,188,.394,21,25,.840,14,42,56,48,42,1,28,34,333,7.4
2878,Jake Pemberton\jake-pemberton-1,2017-18,Denver,G,30,30,977,119,252,.472,63,128,.492,56,124,.452,39,48,.813,7,91,98,85,38,4,55,75,333,8.3
2879,Christopher Hyder\christopher-hyder-1,2015-16,Southern,G,35,35,1255,116,238,.487,107,196,.546,9,42,.214,92,119,.773,12,115,127,174,85,2,60,83,333,10.3
2880,Marcus Lewis\marcus-lewis-2,2013-14,Eastern Kentucky,G,34,34,917,127,247,.514,103,172,.599,24,75,.320,55,93,.591,16,53,69,46,55,11,43,84,333,7.1
2881,Keyshawn Woods\keyshawn-woods-1,2017-18,Wake Forest,G,28,5,719,118,269,.439,81,170,.476,37,99,.374,60,71,.845,15,55,70,53,22,0,45,52,333,7.4
2882,Jevon Carter\jevon-carter-1,2015-16,West Virginia,G,35,35,970,111,290,.383,67,146,.459,44,144,.306,67,90,.744,25,75,100,114,59,9,58,85,333,7.4
2883,Kadeem Allen\kadeem-allen-1,2016-17,Arizona,G,34,33,1020,107,236,.453,75,161,.466,32,75,.427,86,116,.741,12,125,137,101,53,21,65,83,332,8.3
2884,Steven Haney\steven-haney-1,2015-16,Loyola Marymount,G,31,26,860,111,302,.368,38,94,.404,73,208,.351,37,47,.787,16,71,87,34,20,1,31,58,332,5.9
2885,Cortez Seales\cortez-seales-1,2017-18,North Dakota,G,31,31,1022,139,289,.481,135,272,.496,4,17,.235,50,79,.633,25,89,114,67,32,20,37,35,332,8.4
2886,Justin Bibbs\justin-bibbs-1,2014-15,Virginia Tech,G,29,20,863,119,279,.427,74,170,.435,45,109,.413,49,75,.653,10,77,87,52,11,1,56,61,332,5.9
2887,Keith McDougald\keith-mcdougle-1,2013-14,Jacksonville,G,26,23,728,108,275,.393,78,161,.484,30,114,.263,86,106,.811,18,63,81,66,30,1,62,62,332,7.6
2888,Omari Grier\omari-grier-1,2013-14,Bradley,G,32,27,845,98,289,.339,41,112,.366,57,177,.322,79,95,.832,15,63,78,29,17,0,31,54,332,5.5
2889,Austin Tilghman\austin-tilghman-1,2017-18,Monmouth,G,30,28,1002,107,231,.463,99,193,.513,8,38,.211,110,151,.728,19,158,177,165,43,2,88,55,332,10.2
2890,Dewayne Russell\dewayne-russell-1,2015-16,Grand Canyon,G,34,32,1054,117,282,.415,102,246,.415,15,36,.417,83,121,.686,18,85,103,182,47,3,75,66,332,8.2
2891,Raijon Kelly\raijon-kelly-1,2013-14,Samford,G,33,12,769,126,269,.468,96,177,.542,30,92,.326,50,61,.820,9,75,84,84,27,3,55,75,332,6.7
2892,Elijah Stewart\elijah-stewart-1,2015-16,Southern California,G,34,18,897,114,260,.438,54,120,.450,60,140,.429,44,60,.733,26,98,124,38,21,25,29,88,332,7.0
2893,Luke Doyle\luke-doyle-1,2015-16,Stetson,G,34,1,832,113,251,.450,41,72,.569,72,179,.402,34,42,.810,8,86,94,56,26,5,27,54,332,7.3
2894,Buay Tuach\buay-tuach-1,2016-17,Loyola Marymount,G,29,29,814,121,238,.508,78,131,.595,43,107,.402,47,81,.580,34,78,112,65,39,8,63,73,332,8.5
2895,Dee Davis\dee-davis-1,2014-15,Xavier,G,37,37,1214,111,275,.404,76,166,.458,35,109,.321,75,104,.721,12,78,90,221,48,1,89,88,332,7.7
2896,Kyle Anderson\kyle-anderson-2,2014-15,Delaware,G,23,23,788,116,313,.371,62,143,.434,54,170,.318,46,56,.821,12,80,92,46,17,8,45,51,332,7.7
2897,Corey Baldwin\corey-baldwin-1,2016-17,North Dakota,G,32,31,919,112,255,.439,38,80,.475,74,175,.423,34,58,.586,14,109,123,41,38,5,45,76,332,7.1
2898,Tekele Cotton\tekele-cotton-1,2014-15,Wichita State,G,34,34,1080,122,296,.412,89,182,.489,33,114,.289,55,78,.705,24,110,134,98,47,11,45,53,332,8.0
2899,Bryn Forbes\bryn-forbes-1,2014-15,Michigan State,G,39,24,1022,110,246,.447,40,82,.488,70,164,.427,42,52,.808,8,48,56,38,23,5,31,61,332,5.6
2900,Julian Edmonson\julian-edmonson-1,2013-14,Abilene Christian,G,30,5,568,101,252,.401,60,146,.411,41,106,.387,89,120,.742,14,41,55,29,22,2,54,63,332,5.7
2901,Kevin Little\kevin-little-1,2015-16,Maine,G,23,20,635,117,312,.375,56,135,.415,61,177,.345,37,46,.804,8,43,51,60,28,1,49,54,332,7.6
2902,Anthony Odunsi\anthony-odunsi-1,2014-15,Houston Baptist,G,27,26,724,92,192,.479,85,175,.486,7,17,.412,140,182,.769,14,68,82,69,25,2,82,39,331,8.3
2903,Anton Beard\anton-beard-1,2017-18,Arkansas,G,35,35,1051,110,286,.385,72,170,.424,38,116,.328,73,99,.737,20,70,90,105,32,2,45,89,331,6.4
2904,Antoine Allen\antoine-allen-2,2013-14,South Alabama,G,31,29,870,109,311,.350,43,115,.374,66,196,.337,47,59,.797,13,85,98,41,24,4,54,73,331,5.1
2905,Darian Anderson\darin-anderson-1,2014-15,Fairleigh Dickinson,G,29,29,846,121,312,.388,85,210,.405,36,102,.353,53,77,.688,30,72,102,86,51,5,75,82,331,6.9
2906,Torrance Rowe\torrance-rowe-1,2014-15,Tennessee Tech,G,29,27,842,107,281,.381,55,127,.433,52,154,.338,65,82,.793,14,53,67,79,26,0,59,38,331,7.0
2907,Rashad Lindsey\rashad-lindsey-1,2016-17,Arkansas State,G,32,31,1086,112,253,.443,72,150,.480,40,103,.388,67,93,.720,10,81,91,81,20,0,60,50,331,6.8
2908,Demetre Rivers\demetre-rivers-1,2015-16,Mercer,G,34,33,823,112,260,.431,69,145,.476,43,115,.374,64,74,.865,52,57,109,29,12,9,55,52,331,6.1
2909,Andre Armstrong\andre-armstrong-1,2013-14,Coppin State,G,28,13,643,85,265,.321,27,77,.351,58,188,.309,103,124,.831,16,25,41,19,15,1,29,70,331,5.8
2910,Gary Bell\gary-bell-1,2013-14,Gonzaga,G,30,27,839,110,231,.476,54,100,.540,56,131,.427,55,70,.786,17,71,88,50,29,1,31,67,331,8.2
2911,Adonis Filer\adonis-filer-1,2015-16,Florida Atlantic,G,32,32,901,107,269,.398,81,179,.453,26,90,.289,91,120,.758,26,127,153,67,31,2,66,80,331,6.6
2912,Phil Booth\phil-booth-1,2017-18,Villanova,G,33,31,903,108,245,.441,53,100,.530,55,145,.379,60,75,.800,12,92,104,95,27,6,45,56,331,8.0
2913,Four McGlynn\four-mcglynn-1,2013-14,Towson,G,36,20,908,83,205,.405,12,31,.387,71,174,.408,94,103,.913,5,50,55,28,16,0,23,61,331,6.2
2914,Alex Mitola\alex-mitola-1,2013-14,Dartmouth,G,28,28,885,103,251,.410,37,93,.398,66,158,.418,59,68,.868,12,59,71,75,18,0,44,49,331,8.1
2915,Aaron Wheeler\aaron-wheeler-1,2015-16,Charleston Southern,G,30,28,787,130,260,.500,117,210,.557,13,50,.260,58,109,.532,49,127,176,55,26,24,50,69,331,8.6
2916,Malcolm Duvivier\malcolm-duvivier-1,2014-15,Oregon State,G,31,30,1080,110,297,.370,80,200,.400,30,97,.309,81,110,.736,20,72,92,107,38,3,84,84,331,6.1
2917,Maurice Howard\maurice-howard-1,2017-18,Alcorn State,G,32,8,891,114,308,.370,40,101,.396,74,207,.357,29,41,.707,17,62,79,64,26,0,53,56,331,5.7
2918,Kareem South\kareem-south-1,2017-18,Texas A&M-Corpus Christi,G,29,29,893,118,277,.426,78,169,.462,40,108,.370,55,64,.859,33,92,125,34,29,3,50,63,331,7.3
2919,Aaron Holiday\aaron-holiday-1,2015-16,UCLA,G,32,32,1013,114,289,.394,75,196,.383,39,93,.419,64,88,.727,19,77,96,127,45,8,92,103,331,6.5
2920,Terrell Lewis\terrell-lewis-1,2015-16,Eastern Illinois,G,30,30,1131,103,278,.371,39,108,.361,64,170,.376,61,94,.649,23,64,87,171,36,1,58,60,331,9.1
2921,Beau Beech\beau-beech-1,2013-14,North Florida,G,32,32,908,96,250,.384,28,79,.354,68,171,.398,70,85,.824,29,104,133,28,27,10,58,92,330,6.2
2922,Deuce Bello\deuce-bello-1,2015-16,East Tennessee State,G,36,11,787,110,240,.458,80,146,.548,30,94,.319,80,122,.656,33,90,123,37,41,16,68,101,330,5.8
2923,Deriece Parks\deriece-parks-1,2017-18,Western Carolina,G,31,26,947,114,299,.381,48,99,.485,66,200,.330,36,45,.800,27,91,118,83,44,9,63,33,330,7.8
2924,Armani Moore\armani-moore-1,2014-15,Tennessee,G,32,32,989,125,281,.445,119,248,.480,6,33,.182,74,120,.617,91,125,216,69,46,39,74,91,330,8.7
2925,Anthony Mosley\anthony-mosley-1,2017-18,Delaware,G,32,30,1035,112,232,.483,112,226,.496,0,6,.000,106,151,.702,29,107,136,93,40,11,63,74,330,8.3
2926,Scoochie Smith\scoochie-smith-1,2014-15,Dayton,G,36,35,1181,106,256,.414,65,148,.439,41,108,.380,77,102,.755,12,98,110,138,52,4,72,81,330,7.4
2927,Carrington Love\carrington-love-1,2014-15,Green Bay,G,33,32,1031,108,284,.380,70,158,.443,38,126,.302,76,110,.691,24,82,106,101,52,7,64,64,330,7.3
2928,Tyson Carter\tyson-carter-1,2017-18,Mississippi State,G,37,17,845,113,273,.414,55,103,.534,58,170,.341,46,55,.836,6,62,68,46,28,1,36,32,330,5.8
2929,Zach Sellers\zach-sellers-2,2017-18,Savannah State,G,32,27,848,117,264,.443,76,132,.576,41,132,.311,55,72,.764,24,77,101,123,40,5,68,58,330,8.2
2930,Kevin Vannatta\kevin-vannatta-1,2017-18,North Carolina-Asheville,G,34,32,1195,110,251,.438,78,158,.494,32,93,.344,78,99,.788,32,147,179,105,23,5,58,60,330,8.1
2931,Corban Collins\corban-collins-1,2015-16,Morehead State,G,30,28,862,107,272,.393,50,138,.362,57,134,.425,59,82,.720,11,64,75,90,36,2,36,67,330,7.9
2932,Anthony Lindauer\anthony-lindauer-1,2016-17,High Point,G,31,13,797,108,273,.396,44,125,.352,64,148,.432,50,58,.862,3,76,79,77,33,10,67,59,330,6.7
2933,Aaron Parks\aaron-parks-1,2016-17,Cal State Northridge,G,29,27,844,111,274,.405,105,247,.425,6,27,.222,102,138,.739,26,109,135,71,48,4,56,92,330,7.8
2934,Marquis Wright\marquis-wright-2,2013-14,Siena,G,38,37,1318,120,284,.423,113,246,.459,7,38,.184,83,119,.697,48,100,148,199,64,12,116,95,330,7.5
2935,Mike Crawford\mike-crawford-1,2015-16,Saint Louis,G,32,28,861,110,257,.428,67,130,.515,43,127,.339,67,84,.798,17,96,113,31,23,1,38,59,330,6.6
2936,Reese Morgan\reese-morgan-1,2015-16,Cal Poly,G,30,18,755,85,223,.381,11,47,.234,74,176,.420,86,102,.843,17,74,91,52,29,4,21,75,330,8.4
2937,Casey Benson\casey-benson-1,2017-18,Grand Canyon,G,34,33,994,97,258,.376,57,141,.404,40,117,.342,96,126,.762,27,115,142,152,25,4,63,68,330,8.0
2938,Andrien White\adrien-white-1,2016-17,Charlotte,G,29,20,692,102,247,.413,43,99,.434,59,148,.399,66,88,.750,22,95,117,30,42,11,48,66,329,7.9
2939,Charles Minlend\charles-minlend-2,2016-17,San Francisco,G,33,16,678,119,285,.418,68,147,.463,51,138,.370,40,70,.571,19,51,70,37,22,8,41,37,329,5.8
2940,Peter Hooley\peter-hooley-1,2014-15,Albany (NY),G,24,16,781,108,252,.429,63,120,.525,45,132,.341,68,90,.756,12,60,72,56,13,0,44,26,329,8.8
2941,Tarius Johnson\tarius-johnson-1,2013-14,Eastern Kentucky,G,34,33,865,104,216,.481,66,127,.520,38,89,.427,83,116,.716,41,82,123,41,30,3,35,100,329,7.2
2942,Briante Weber\briante-weber-1,2013-14,Virginia Commonwealth,G,35,35,1010,114,254,.449,104,213,.488,10,41,.244,91,116,.784,34,108,142,136,121,5,65,88,329,10.4
2943,Walter Wright\walter-wright-1,2016-17,Montana,G,31,9,678,110,280,.393,85,185,.459,25,95,.263,84,97,.866,8,47,55,90,12,2,65,59,329,5.8
2944,Kaelon Wilson\kaelon-wilson-1,2015-16,Texas-Arlington,G,33,12,719,112,247,.453,92,171,.538,20,76,.263,85,123,.691,58,107,165,34,35,4,37,61,329,7.8
2945,Conner Frankamp\conner-frankamp-1,2017-18,Wichita State,G,31,24,742,119,278,.428,63,124,.508,56,154,.364,35,35,1.000,4,52,56,70,23,5,12,39,329,8.0
2946,Trey Landers\trey-landers-1,2017-18,Dayton,G,29,29,837,126,216,.583,107,162,.660,19,54,.352,58,80,.725,65,97,162,52,31,11,57,77,329,9.7
2947,Anthony Mosley\anthony-mosley-1,2016-17,Delaware,G,33,28,979,112,234,.479,108,216,.500,4,18,.222,101,130,.777,21,88,109,83,55,15,80,84,329,7.6
2948,Christen Cunningham\christian-cunningham-1,2014-15,Samford,G,32,32,962,106,246,.431,95,205,.463,11,41,.268,106,134,.791,16,61,77,125,38,4,73,51,329,7.9
2949,Jonathan Stark\jonathan-stark-1,2014-15,Tulane,G,31,31,985,119,320,.372,89,213,.418,30,107,.280,61,84,.726,17,60,77,137,39,7,76,60,329,6.9
2950,E.J. Crawford\ej-crawford-1,2016-17,Iona,G,35,30,874,110,243,.453,54,118,.458,56,125,.448,53,68,.779,19,88,107,39,13,7,31,74,329,6.3
2951,Malik Newman\malik-newman-1,2015-16,Mississippi State,G,29,22,803,111,284,.391,50,123,.407,61,161,.379,46,67,.687,8,73,81,63,11,2,54,45,329,6.1
2952,Drew Brandon\drew-brandon-1,2014-15,Eastern Washington,G,34,34,1139,113,273,.414,91,184,.495,22,89,.247,81,100,.810,67,169,236,160,61,10,62,79,329,10.6
2953,JC Younger\jc-younger-1,2017-18,Presbyterian,G,32,22,949,112,284,.394,45,110,.409,67,174,.385,38,45,.844,22,100,122,36,12,1,46,38,329,6.1
2954,Marcus DeBerry\marcus-deberry-1,2016-17,Northern Arizona,G,32,32,1040,110,338,.325,48,127,.378,62,211,.294,47,63,.746,9,120,129,93,20,3,51,39,329,6.0
2955,Drew Charles\drew-charles-1,2015-16,Texas-Arlington,G,35,35,862,104,275,.378,35,93,.376,69,182,.379,52,66,.788,42,65,107,55,32,3,40,92,329,6.2
2956,Roland Nyama\roland-nyama-1,2016-17,Stony Brook,G,32,29,886,117,282,.415,87,173,.503,30,109,.275,65,95,.684,40,102,142,46,25,18,51,105,329,6.3
2957,Gee McGhee\gee-mcghee-1,2013-14,Chattanooga,G,33,32,978,105,263,.399,88,191,.461,17,72,.236,102,159,.642,35,125,160,90,40,5,67,70,329,7.2
2958,Gary Winston\gary-winston-1,2013-14,Portland State,G,29,19,863,113,255,.443,67,146,.459,46,109,.422,57,71,.803,8,56,64,79,14,1,52,38,329,7.4
2959,C.J. Cooper\cj-cooper-1,2013-14,Texas-El Paso,G,34,30,1075,94,263,.357,36,89,.404,58,174,.333,82,94,.872,10,54,64,102,26,0,69,63,328,6.0
2960,Grant Mullins\grant-mullins-1,2016-17,University of California,G,32,25,1000,106,252,.421,35,87,.402,71,165,.430,45,56,.804,7,96,103,64,30,3,38,57,328,7.5
2961,Jamal Williams\jamal-williams-3,2015-16,Sam Houston State,G,34,34,1020,124,253,.490,112,219,.511,12,34,.353,68,95,.716,51,135,186,148,38,5,79,69,328,9.0
2962,Deshaun Morman\deshaun-morman-1,2016-17,Towson,G,33,31,856,109,262,.416,95,208,.457,14,54,.259,96,128,.750,35,68,103,65,49,12,57,68,328,7.2
2963,Darrian Ringo\darrian-ringo-1,2017-18,Miami (OH),G,34,28,1047,114,250,.456,85,157,.541,29,93,.312,71,98,.724,25,94,119,236,91,4,110,91,328,10.2
2964,Davauhnte Turner\davauhnte-turner-1,2017-18,Saint Peter's,G,31,11,846,122,281,.434,83,168,.494,39,113,.345,45,59,.763,27,69,96,61,29,9,53,67,328,6.8
2965,Jeremiah Martin\jeremiah-martin-1,2016-17,Memphis,G,32,32,1114,114,253,.451,90,168,.536,24,85,.282,76,113,.673,26,72,98,142,58,23,63,80,328,9.4
2966,Pookie Powell\rashawn-powell-1,2016-17,La Salle,G,24,18,749,106,244,.434,65,131,.496,41,113,.363,75,89,.843,8,99,107,75,31,1,35,46,328,10.8
2967,Prince Williams\prince-williams-1,2015-16,East Carolina,G,32,30,903,113,265,.426,74,169,.438,39,96,.406,63,84,.750,20,80,100,123,37,7,67,53,328,8.0
2968,Zavier Turner\zavier-turner-1,2017-18,Manhattan,G,31,23,898,90,213,.423,53,125,.424,37,88,.420,111,136,.816,14,55,69,132,26,0,79,75,328,7.8
2969,Dexter Fields\dexter-fields-1,2013-14,Murray State,G,34,31,1029,109,253,.431,33,72,.458,76,181,.420,34,48,.708,23,81,104,52,31,8,39,70,328,6.9
2970,Kevin Punter\kevin-punter-1,2014-15,Tennessee,G,32,31,992,111,265,.419,68,143,.476,43,122,.352,63,92,.685,10,57,67,60,51,6,56,90,328,6.4
2971,Aaron Bright\aaron-bright-1,2014-15,Saint Mary's (CA),G,30,27,951,102,286,.357,58,141,.411,44,145,.303,80,91,.879,9,54,63,113,15,0,68,82,328,6.0
2972,Tavon Allen\tavon-allen-1,2013-14,Drexel,G,28,10,826,128,323,.396,107,248,.431,21,75,.280,51,78,.654,12,72,84,53,19,8,44,59,328,5.9
2973,Eric Garcia\eric-garcia-2,2015-16,Wofford,G,32,32,981,90,214,.421,33,79,.418,57,135,.422,91,116,.784,10,73,83,153,17,0,47,66,328,8.9
2974,Cazmon Hayes\cazmon-hayes-1,2015-16,Delaware,G,29,27,1020,112,307,.365,59,123,.480,53,184,.288,51,83,.614,22,129,151,39,29,9,33,52,328,7.2
2975,Tevin Svihovec\tevin-svihovec-1,2013-14,Northern Colorado,G,32,23,895,105,254,.413,85,198,.429,20,56,.357,98,126,.778,10,71,81,85,25,3,52,71,328,6.7
2976,Brandon Pye\brandon-pye-1,2015-16,Texas A&M-Corpus Christi,G,33,33,1016,111,289,.384,37,99,.374,74,190,.389,31,37,.838,10,39,49,40,29,0,25,41,327,6.1
2977,Jeff Dowtin\jeff-dowtin-1,2017-18,Rhode Island,G,34,33,1117,121,271,.446,97,209,.464,24,62,.387,61,86,.709,24,80,104,189,32,16,43,56,327,9.6
2978,Terry Henderson\terry-henderson-1,2013-14,West Virginia,G,28,17,756,112,255,.439,65,130,.500,47,125,.376,56,66,.848,32,49,81,31,21,16,30,39,327,8.4
2979,Pierria Henry\pierria-henry-1,2014-15,Charlotte,G,32,30,1003,107,266,.402,86,190,.453,21,76,.276,92,116,.793,43,123,166,173,76,22,79,81,327,10.7
2980,Kenny Chery\kenny-chery-1,2014-15,Baylor,G,29,28,940,107,281,.381,55,143,.385,52,138,.377,61,74,.824,14,77,91,119,40,0,76,47,327,7.9
2981,Kerry Carter\kerry-carter-1,2013-14,Saint Mary's (CA),G,35,19,929,102,247,.413,34,75,.453,68,172,.395,55,73,.753,7,110,117,30,27,5,45,96,327,5.5
2982,Micheal Warren\michael-warren-1,2017-18,Cal State Northridge,G,27,27,846,108,245,.441,69,143,.483,39,102,.382,72,85,.847,18,146,164,52,33,11,52,92,327,8.8
2983,Stuckey Mosley\stuckey-mosley-1,2015-16,Toledo,G,32,31,975,112,265,.423,78,171,.456,34,94,.362,69,88,.784,14,139,153,126,37,5,65,80,327,8.2
2984,Makuach Maluach\makuach-maluach-1,2017-18,New Mexico,G,34,15,670,117,211,.555,88,148,.595,29,63,.460,64,79,.810,37,48,85,33,19,8,43,82,327,6.8
2985,DeAngelo Priar\deangelo-priar-1,2013-14,Mississippi Valley State,G,31,28,800,109,282,.387,78,174,.448,31,108,.287,78,122,.639,43,61,104,47,37,3,53,65,327,6.4
2986,Danuel House\danuel-house-1,2013-14,Houston,G,24,18,684,110,257,.428,75,152,.493,35,105,.333,72,103,.699,40,88,128,45,18,18,52,50,327,9.3
2987,Jason Brickman\jason-brickman-1,2013-14,Long Island University,G,29,29,1073,100,234,.427,49,107,.458,51,127,.402,76,88,.864,19,78,97,289,32,0,102,17,327,12.4
2988,Rashaun Madison\rashaun-madison-1,2016-17,North Carolina Central,G,34,32,998,110,304,.362,20,35,.571,90,269,.335,17,31,.548,9,66,75,26,41,0,26,69,327,5.4
2989,Khristian Smith\khristian-smith-1,2014-15,Indiana State,G,31,30,940,109,271,.402,88,191,.461,21,80,.263,88,112,.786,25,114,139,52,29,12,47,77,327,7.1
2990,Dwaun Anderson\dwaun-anderson-1,2015-16,Wagner,G,33,29,936,127,291,.436,115,231,.498,12,60,.200,61,89,.685,39,114,153,53,41,30,57,72,327,7.2
2991,Carlton Brundidge\carlton-brundidge-1,2015-16,Detroit Mercy,G,31,10,632,118,238,.496,108,202,.535,10,36,.278,81,110,.736,48,78,126,70,20,3,41,60,327,8.4
2992,Jerrold Brooks\jerrold-brooks-1,2013-14,Southern Mississippi,G,34,32,943,104,290,.359,42,103,.408,62,187,.332,57,76,.750,12,56,68,87,37,0,59,71,327,5.7
2993,Luke Roh\luke-roh-1,2014-15,Colgate,G,33,33,1085,129,215,.600,129,215,.600,0,0,,69,101,.683,53,150,203,85,27,8,62,80,327,9.0
2994,Troy Caupain\troy-caupain-1,2014-15,Cincinnati,G,34,33,1065,107,241,.444,76,165,.461,31,76,.408,82,104,.788,17,105,122,121,41,6,72,49,327,8.1
2995,Tyreek Jewell\tyreek-jewell-1,2014-15,St. Francis (NY),G,35,34,1023,123,358,.344,94,213,.441,29,145,.200,52,83,.627,44,84,128,39,25,7,47,59,327,4.5
2996,Eric Laster\eric-laster-1,2014-15,Loyola (MD),G,30,26,891,123,318,.387,90,229,.393,33,89,.371,48,86,.558,46,67,113,48,20,14,58,81,327,5.5
2997,James White\james-white-2,2013-14,Little Rock,G,28,28,658,138,254,.543,137,248,.552,1,6,.167,49,80,.613,58,112,170,15,11,26,55,82,326,7.8
2998,Jordan Woodard\jordan-woodard-1,2014-15,Oklahoma,G,35,35,1118,90,249,.361,73,182,.401,17,67,.254,129,154,.838,15,108,123,134,55,4,81,61,326,7.6
2999,Dewayne Russell\dewayne-russell-1,2014-15,Grand Canyon,G,23,23,769,103,250,.412,89,208,.428,14,42,.333,106,140,.757,9,59,68,90,32,2,49,62,326,9.8
3000,Terrence Williams\terrence-williams-2,2013-14,Charlotte,G,31,31,937,108,288,.375,92,231,.398,16,57,.281,94,130,.723,29,124,153,72,31,6,73,76,326,6.2
3001,Casey Kasperbauer\casey-kasperbauer-1,2014-15,South Dakota,G,33,28,985,105,242,.434,27,62,.435,78,180,.433,38,41,.927,6,73,79,26,24,2,30,35,326,6.8
3002,Adonis Filer\adonis-filer-1,2016-17,Florida Atlantic,G,30,6,677,102,268,.381,72,168,.429,30,100,.300,92,114,.807,22,66,88,63,29,0,54,55,326,6.8
3003,Demetrius McReynolds\demetrisu-mcreynolds-1,2015-16,Eastern Illinois,G,27,20,674,115,248,.464,64,112,.571,51,136,.375,45,55,.818,33,104,137,36,22,2,24,52,326,9.4
3004,Patrick Steeves\patrick-steeves-1,2017-18,George Washington,G,33,32,944,142,272,.522,138,259,.533,4,13,.308,38,52,.731,59,116,175,66,20,13,69,57,326,7.5
3005,Geno Luzcando\geno-luzcando-1,2017-18,Idaho State,G,30,29,952,108,219,.493,94,173,.543,14,46,.304,96,140,.686,27,115,142,87,59,8,87,109,326,8.2
3006,Corey Henderson\corey-henderson-1,2017-18,Tulsa,G,31,23,874,99,268,.369,26,72,.361,73,196,.372,55,70,.786,10,57,67,38,18,0,21,40,326,6.6
3007,Kasey Hill\kasey-hill-1,2015-16,Florida,G,36,17,859,118,303,.389,99,239,.414,19,64,.297,71,132,.538,12,74,86,120,53,11,72,87,326,5.7
3008,Lamar Peters\lamar-peters-1,2017-18,Mississippi State,G,34,21,943,118,320,.369,69,143,.483,49,177,.277,41,63,.651,11,65,76,152,50,9,88,66,326,6.4
3009,JaJuan Johnson\jajuan-johnson-2,2015-16,Marquette,G,32,16,757,123,241,.510,98,176,.557,25,65,.385,55,69,.797,24,79,103,63,51,8,49,48,326,8.6
3010,Darius Banks\darius-banks-1,2017-18,James Madison,G,32,30,941,115,282,.408,88,186,.473,27,96,.281,69,84,.821,29,104,133,59,48,13,61,84,326,7.0
3011,Deven Williams\deven-williams-1,2013-14,Savannah State,G,32,14,578,119,288,.413,68,146,.466,51,142,.359,37,48,.771,8,23,31,33,12,1,51,45,326,4.6
3012,Marcquise Reed\marcquise-reed-1,2016-17,Clemson,G,33,0,711,99,236,.419,67,155,.432,32,81,.395,96,106,.906,16,60,76,64,46,1,40,56,326,7.7
3013,Wade Baldwin\wade-baldwin-1,2014-15,Vanderbilt,G,35,24,1009,99,227,.436,56,129,.434,43,98,.439,85,106,.802,17,128,145,155,50,4,67,86,326,8.8
3014,John Papale\john-papale-1,2013-14,Boston University,G,35,33,1063,113,257,.440,43,88,.489,70,169,.414,30,34,.882,16,42,58,42,23,5,16,34,326,6.9
3015,Isaiah Briscoe\isaiah-briscoe-1,2015-16,Kentucky,G,34,33,1094,132,301,.439,127,264,.481,5,37,.135,57,124,.460,49,132,181,107,35,5,66,96,326,6.6
3016,Eron Harris\eron-harris-1,2015-16,Michigan State,G,35,22,732,108,249,.434,65,151,.430,43,98,.439,67,84,.798,26,66,92,72,9,3,53,77,326,5.8
3017,Kareem South\kareem-south-1,2016-17,Texas A&M-Corpus Christi,G,36,28,1043,109,261,.418,67,145,.462,42,116,.362,65,83,.783,55,79,134,67,32,2,52,90,325,6.5
3018,Tarik Phillip\tarik-phillip-1,2015-16,West Virginia,G,35,0,779,93,223,.417,57,135,.422,36,88,.409,103,146,.705,24,63,87,98,53,9,71,87,325,7.0
3019,Yondarius Johnson\yondarius-johnson-2,2013-14,Southern,G,31,22,798,121,245,.494,88,151,.583,33,94,.351,50,87,.575,19,70,89,35,22,6,38,62,325,6.8
3020,Jacoby Ross\jacoby-ross-1,2017-18,Alabama State,G,26,8,644,106,253,.419,59,129,.457,47,124,.379,66,83,.795,11,36,47,59,18,0,48,43,325,7.5
3021,Kyle Allman\kyle-allman-1,2016-17,Cal State Fullerton,G,32,26,912,105,253,.415,92,205,.449,13,48,.271,102,141,.723,12,63,75,67,21,10,76,59,325,5.5
3022,Aaron Cook\aaron-cook-2,2017-18,Southern Illinois,G,33,32,989,108,246,.439,70,147,.476,38,99,.384,71,102,.696,7,69,76,90,47,9,74,61,325,6.9
3023,Shaquille Harrison\shaquille-harrison-1,2013-14,Tulsa,G,34,34,1026,104,233,.446,96,203,.473,8,30,.267,109,160,.681,25,106,131,110,61,8,78,76,325,7.9
3024,Tavon Allen\tavon-allen-1,2014-15,Drexel,G,29,27,951,109,346,.315,66,194,.340,43,152,.283,64,80,.800,15,73,88,68,24,18,60,74,325,5.1
3025,Aaron Calixte\aaron-calixte-1,2015-16,Maine,G,30,26,813,116,265,.438,82,176,.466,34,89,.382,59,67,.881,25,39,64,80,21,2,85,61,325,6.0
3026,David Knudsen\david-knudsen-1,2017-18,Marist,G,30,30,937,108,248,.435,49,88,.557,59,160,.369,50,60,.833,15,74,89,63,28,7,59,53,325,7.3
3027,Kobi Simmons\kobi-simmons-1,2016-17,Arizona,G,37,19,871,112,282,.397,80,184,.435,32,98,.327,69,89,.775,13,47,60,73,24,3,46,70,325,5.2
3028,Sam Kearns\sam-kearns-1,2017-18,Oral Roberts,G,32,31,1058,106,289,.367,36,90,.400,70,199,.352,43,52,.827,13,64,77,131,18,1,69,83,325,6.2
3029,Brian Williams\brian-williams-8,2013-14,Jacksonville State,G,29,23,952,113,301,.375,90,206,.437,23,95,.242,76,125,.608,16,80,96,101,28,9,47,36,325,7.5
3030,Armoni Brooks\armoni-brooks-1,2017-18,Houston,G,35,1,704,110,259,.425,27,61,.443,83,198,.419,22,27,.815,29,99,128,17,26,12,14,47,325,7.1
3031,Tom Droney\tom-droney-1,2013-14,Davidson,G,32,31,984,107,226,.473,77,146,.527,30,80,.375,81,109,.743,20,99,119,104,21,3,70,75,325,7.4
3032,A.J. Jacobson\aj-jacobson-1,2014-15,North Dakota State,G,28,28,919,99,240,.413,45,106,.425,54,134,.403,73,89,.820,14,103,117,49,12,7,42,79,325,7.4
3033,Devon Baulkman\devon-baulkman-1,2015-16,Tennessee,G,34,32,933,109,292,.373,47,106,.443,62,186,.333,44,54,.815,50,67,117,60,35,13,45,56,324,6.9
3034,Guilien Smith\guilien-smith-1,2016-17,Dartmouth,G,27,27,778,107,248,.431,73,156,.468,34,92,.370,76,101,.752,11,84,95,48,20,1,63,67,324,6.7
3035,Ako Adams\ako-adams-1,2017-18,Rice,G,31,29,921,98,271,.362,44,111,.396,54,160,.338,74,92,.804,9,72,81,100,24,1,82,66,324,5.8
3036,Evan Hymes\evan-hymes-1,2013-14,Siena,G,38,1,753,101,276,.366,66,170,.388,35,106,.330,87,105,.829,22,43,65,85,18,1,68,84,324,4.4
3037,Cody Demps\cody-demps-1,2014-15,Sacramento State,G,33,33,1104,109,217,.502,103,192,.536,6,25,.240,100,125,.800,44,125,169,108,33,12,62,83,324,9.0
3038,Brandon Venturini\brandon-venturini-1,2014-15,Navy,G,27,27,836,114,293,.389,49,105,.467,65,188,.346,31,37,.838,6,97,103,82,39,2,71,59,324,7.4
3039,Tyler Hubbard\tyler-hubbard-1,2014-15,Loyola (MD),G,30,25,917,99,270,.367,35,97,.361,64,173,.370,62,80,.775,14,44,58,24,17,1,31,61,324,5.7
3040,Marshun Newell\marshun-newell-1,2013-14,Tennessee-Martin,G,31,24,834,108,292,.370,82,198,.414,26,94,.277,82,121,.678,33,70,103,107,42,6,78,79,324,6.5
3041,Yolonzo Moore\yolonzo-moore-1,2013-14,Hartford,G,33,33,1081,99,221,.448,71,137,.518,28,84,.333,98,135,.726,12,80,92,94,42,5,90,68,324,6.7
3042,Devin Peterson\devin-peterson-1,2016-17,Western Carolina,G,31,26,968,119,339,.351,107,274,.391,12,65,.185,74,98,.755,7,70,77,113,37,6,84,78,324,5.0
3043,Miles Jackson-Cartwright\miles-cartwright-1,2013-14,Pennsylvania,G,28,27,873,98,234,.419,53,114,.465,45,120,.375,83,102,.814,10,65,75,94,30,4,67,67,324,8.0
3044,Matt Harris\matt-harris-1,2016-17,Massachusetts-Lowell,G,31,20,817,96,237,.405,33,70,.471,63,167,.377,69,76,.908,21,64,85,52,22,4,50,78,324,6.7
3045,Jahmal McMurray\jahmal-mcmurray-1,2017-18,Southern Methodist,G,22,14,690,116,271,.428,54,119,.454,62,152,.408,30,36,.833,17,42,59,34,15,1,38,37,324,8.6
3046,Princeton Onwas\princeton-onwas-1,2015-16,San Jose State,G,31,15,792,110,242,.455,97,179,.542,13,63,.206,91,149,.611,24,71,95,73,24,6,80,97,324,5.6
3047,Khalil Small\khalil-small-1,2016-17,Green Bay,G,32,32,895,115,269,.428,96,187,.513,19,82,.232,75,93,.806,59,103,162,60,29,7,58,103,324,7.0
3048,Ja'Quan Newton\jaquan-newton-1,2015-16,Miami (FL),G,31,1,703,105,228,.461,96,202,.475,9,26,.346,105,143,.734,16,55,71,76,27,5,66,48,324,7.0
3049,Malcolm McMillan\malcolm-mcmillan-1,2013-14,Central Connecticut State,G,30,27,902,106,231,.459,79,152,.520,27,79,.342,85,116,.733,17,88,105,97,26,11,62,62,324,8.2
3050,T.J. Henderson\tj-henderson-1,2017-18,IUPUI,G,30,5,721,102,245,.416,62,133,.466,40,112,.357,80,96,.833,17,62,79,63,30,6,73,56,324,6.7
3051,Jalen Poyser\jalen-poyser-1,2016-17,Nevada-Las Vegas,G,31,20,840,98,278,.353,60,146,.411,38,132,.288,89,111,.802,18,67,85,81,23,1,60,51,323,6.2
3052,Orlando Williams\orlando-williams-1,2013-14,Eastern Kentucky,G,34,0,677,109,226,.482,59,107,.551,50,119,.420,55,72,.764,8,59,67,42,23,4,39,72,323,6.2
3053,Denzel Keyes\denzel-keyes-1,2017-18,North Carolina A&T,G,35,10,787,125,247,.506,107,182,.588,18,65,.277,55,89,.618,72,120,192,26,22,15,31,76,323,7.5
3054,Deon Jones\deon-jones-2,2015-16,Monmouth,G,31,30,731,119,261,.456,103,218,.472,16,43,.372,69,95,.726,39,157,196,35,20,25,41,79,323,7.8
3055,Reggie Jones\reggie-jones-2,2017-18,Western Michigan,G,32,6,756,113,296,.382,75,167,.449,38,129,.295,59,73,.808,27,97,124,67,30,9,65,58,323,6.2
3056,Bryce Dulin\bryce-dulin-1,2017-18,Navy,G,32,32,927,113,282,.401,74,153,.484,39,129,.302,58,91,.637,27,73,100,55,22,5,52,64,323,5.8
3057,Thomas Funk\thomas-funk-1,2017-18,Army,G,30,30,904,119,279,.427,85,189,.450,34,90,.378,51,73,.699,18,75,93,172,23,1,66,57,323,8.6
3058,Lafayette Rutledge\lafayette-rutledge-1,2017-18,Nicholls State,G,32,6,668,99,247,.401,2,7,.286,97,240,.404,28,37,.757,7,37,44,14,20,0,12,42,323,6.3
3059,Adonys Henriquez\adonys-henriquez-1,2014-15,Central Florida,G,30,30,1050,107,250,.428,42,85,.494,65,165,.394,44,56,.786,21,78,99,64,19,6,46,29,323,7.8
3060,Cameron Johnson\cameron-johnson-4,2017-18,North Carolina,G,26,20,761,113,265,.426,66,127,.520,47,138,.341,50,59,.847,44,78,122,60,18,5,27,45,323,9.7
3061,Nate Mason\nate-mason-1,2014-15,Minnesota,G,33,9,862,115,281,.409,73,173,.422,42,108,.389,51,83,.614,17,77,94,92,59,3,36,58,323,7.9
3062,Devin Patterson\devin-patterson-1,2013-14,Omaha,G,32,31,840,94,232,.405,62,141,.440,32,91,.352,103,127,.811,13,72,85,106,57,0,79,62,323,7.7
3063,Alfonzo Houston\alfonzo-houston-1,2013-14,North Carolina Central,G,34,33,892,107,247,.433,103,222,.464,4,25,.160,105,137,.766,22,73,95,43,22,3,40,43,323,6.3
3064,Chris McNeal\chris-mcneal-1,2017-18,New Mexico,G,34,18,829,102,274,.372,46,96,.479,56,178,.315,63,83,.759,6,56,62,93,26,0,64,56,323,5.6
3065,Earl Peterson\earl-peterson-1,2014-15,Loyola (IL),G,37,17,935,109,218,.500,88,161,.547,21,57,.368,84,107,.785,8,62,70,75,31,4,68,56,323,6.1
3066,Tyler Hooker\tyler-hooker-1,2017-18,Kennesaw State,G,30,16,782,113,275,.411,97,203,.478,16,72,.222,81,114,.711,10,70,80,79,38,4,72,65,323,6.3
3067,Blake Simmons\blake-simmons-1,2017-18,Evansville,G,31,30,1108,117,267,.438,69,149,.463,48,118,.407,41,53,.774,18,127,145,65,28,9,61,61,323,7.2
3068,Antonius Cleveland\antonius-cleveland-1,2014-15,Southeast Missouri State,G,30,30,871,120,254,.472,108,197,.548,12,57,.211,71,125,.568,41,102,143,55,38,15,39,73,323,8.3
3069,Jesse Morgan\jesse-morgan-1,2014-15,Temple,G,27,27,786,107,307,.349,39,115,.339,68,192,.354,40,49,.816,31,60,91,36,32,7,20,35,322,7.9
3070,Cedric Hankerson\cedric-hankerson-1,2017-18,Boston University,G,25,24,677,110,269,.409,61,124,.492,49,145,.338,53,90,.589,22,62,84,40,37,6,43,57,322,8.0
3071,Nathan Sobey\nathan-sobey-1,2013-14,Wyoming,G,33,33,995,112,262,.427,90,177,.508,22,85,.259,76,110,.691,20,92,112,64,18,8,42,72,322,6.3
3072,Jordan Tolbert\jordan-tolbert-2,2017-18,Sacramento State,G,32,8,781,116,285,.407,67,163,.411,49,122,.402,41,50,.820,14,73,87,73,37,0,61,69,322,6.1
3073,Quinton Rose\quinton-rose-1,2016-17,Temple,G,32,5,793,115,265,.434,94,194,.485,21,71,.296,71,103,.689,27,103,130,61,49,14,61,67,322,7.3
3074,Chris Hass\chris-hass-1,2013-14,Bucknell,G,29,23,754,109,255,.427,62,138,.449,47,117,.402,57,68,.838,27,90,117,17,17,13,30,45,322,7.5
3075,Jacob Rigoni\jacob-rigoni-1,2017-18,Quinnipiac,G,33,15,857,107,233,.459,32,68,.471,75,165,.455,33,42,.786,22,104,126,35,19,9,43,55,322,7.0
3076,Anthony Henderson\anthony-henderson-1,2013-14,Bowling Green State,G,31,31,1047,114,284,.401,66,156,.423,48,128,.375,46,77,.597,34,88,122,53,66,5,41,87,322,7.7
3077,Travis Hammonds\travis-hammonds-1,2015-16,Cal State Long Beach,G,32,5,755,106,246,.431,54,115,.470,52,131,.397,58,75,.773,40,117,157,39,26,20,48,94,322,7.2
3078,Tim Bond\tim-bond-1,2017-18,Eastern Michigan,G,35,26,1085,124,268,.463,94,182,.516,30,86,.349,44,65,.677,29,142,171,121,85,40,63,74,322,9.8
3079,Jestin Lewis\jestin-lewis-1,2015-16,Mercer,G,23,23,624,116,258,.450,69,128,.539,47,130,.362,43,56,.768,9,73,82,42,35,1,36,35,322,9.8
3080,Monty Boykins\monty-boykins-1,2015-16,Lafayette,G,30,25,703,108,281,.384,54,130,.415,54,151,.358,52,84,.619,7,68,75,56,19,3,58,38,322,5.6
3081,Mike Martin\michael-martin-2,2014-15,Central Arkansas,G,28,28,927,112,266,.421,71,156,.455,41,110,.373,56,70,.800,12,94,106,120,53,3,97,86,321,7.8
3082,DeAngelo Priar\deangelo-priar-1,2014-15,Mississippi Valley State,G,32,30,962,109,300,.363,71,177,.401,38,123,.309,65,114,.570,42,115,157,64,37,7,76,67,321,5.7
3083,Mandell Thomas\mandell-thomas-1,2015-16,Fordham,G,26,20,719,114,272,.419,62,142,.437,52,130,.400,41,64,.641,11,82,93,50,54,5,37,50,321,9.0
3084,Brian Darden\brian-darden-1,2013-14,Hampton,G,31,29,739,90,257,.350,27,64,.422,63,193,.326,78,98,.796,17,52,69,36,32,1,46,80,321,5.7
3085,Lamar Peters\lamar-peters-1,2016-17,Mississippi State,G,30,17,738,103,266,.387,44,105,.419,59,161,.366,56,75,.747,12,56,68,101,34,5,68,81,321,6.7
3086,Kendall Smith\kendall-smith-2,2015-16,Cal State Northridge,G,21,20,721,103,267,.386,81,186,.435,22,81,.272,93,137,.679,12,50,62,64,24,1,49,43,321,8.8
3087,T.J. McConnell\tj-mcconnell-1,2013-14,Arizona,G,38,38,1226,127,280,.454,91,180,.506,36,100,.360,31,50,.620,19,117,136,202,64,8,67,83,321,8.6
3088,Conner Frankamp\conner-frankamp-1,2016-17,Wichita State,G,36,24,861,111,249,.446,38,83,.458,73,166,.440,26,34,.765,6,50,56,96,27,8,24,28,321,7.5
3089,James Bolden\james-bolden-1,2017-18,West Virginia,G,37,3,635,108,252,.429,39,84,.464,69,168,.411,36,43,.837,25,45,70,39,34,8,36,76,321,5.9
3090,Khristian Smith\khristian-smith-1,2015-16,Indiana State,G,32,32,934,111,300,.370,87,205,.424,24,95,.253,75,105,.714,33,134,167,61,37,7,52,102,321,6.2
3091,Cam Griffin\cam-griffin-1,2014-15,Denver,G,28,26,930,109,201,.542,104,179,.581,5,22,.227,97,128,.758,51,121,172,66,48,8,62,70,320,10.4
3092,J.P. Macura\jp-macura-1,2015-16,Xavier,G,34,4,773,108,230,.470,71,126,.563,37,104,.356,67,83,.807,48,41,89,69,37,1,35,81,320,7.7
3093,A.J. Hicks\adrian-hicks-1,2017-18,Morehead State,G,29,22,885,98,231,.424,73,151,.483,25,80,.313,99,155,.639,24,63,87,122,51,8,84,62,320,8.4
3094,Theo Johnson\theo-johnson-1,2014-15,Liberty,G,32,22,814,95,220,.432,85,182,.467,10,38,.263,120,163,.736,41,105,146,53,18,9,66,53,320,6.9
3095,Zach Kocur\zach-kocur-1,2016-17,Air Force,G,33,32,837,111,248,.448,50,85,.588,61,163,.374,37,56,.661,31,111,142,67,27,0,49,78,320,7.0
3096,Jordan Bowden\jordan-bowden-1,2017-18,Tennessee,G,35,35,978,98,249,.394,47,120,.392,51,129,.395,73,99,.737,32,93,125,66,39,11,39,86,320,7.0
3097,Ray Sanders\ray-sanders-1,2014-15,Albany (NY),G,33,33,979,100,230,.435,68,143,.476,32,87,.368,88,114,.772,44,108,152,74,45,2,58,77,320,7.9
3098,Eli Cain\eli-cain-1,2015-16,DePaul,G,31,29,877,111,256,.434,80,183,.437,31,73,.425,67,102,.657,17,76,93,55,23,12,62,83,320,5.8
3099,Marcus Carr\marcus-carr-2,2017-18,Pittsburgh,G,32,27,916,106,268,.396,70,160,.438,36,108,.333,72,88,.818,8,82,90,129,20,4,88,70,320,6.1
3100,Jeremie Tyler\jeremie-tyler-1,2015-16,Ball State,G,35,18,796,115,294,.391,56,130,.431,59,164,.360,31,41,.756,6,51,57,34,24,12,26,58,320,5.2
3101,Jeremy Hollimon\jeremy-hollimon-1,2015-16,Troy,G,31,21,836,102,304,.336,66,176,.375,36,128,.281,80,117,.684,23,74,97,51,32,3,64,72,320,4.8
3102,Taylor Johnson\taylor-johnson-2,2017-18,Dartmouth,G,27,24,776,119,230,.517,90,147,.612,29,83,.349,53,71,.746,15,84,99,80,28,2,75,57,320,8.2
3103,Anthony Stitt\anthony-stitt-1,2013-14,College of Charleston,G,32,32,1106,113,319,.354,58,158,.367,55,161,.342,39,70,.557,16,76,92,98,32,3,54,61,320,5.9
3104,Rickey Holden\rickey-holden-1,2017-18,Cal State Bakersfield,G,30,20,920,111,269,.413,77,153,.503,34,116,.293,64,77,.831,20,63,83,85,38,0,63,62,320,7.1
3105,Evan Kelley\evan-kelley-1,2013-14,Sacred Heart,G,25,17,746,120,279,.430,106,213,.498,14,66,.212,66,101,.653,19,69,88,46,25,1,62,59,320,6.6
3106,Antwain Johnson\antwain-johnson-1,2017-18,Middle Tennessee,G,31,17,704,111,251,.442,70,146,.479,41,105,.390,56,65,.862,14,46,60,56,22,4,32,60,319,7.0
3107,Jordon Bronner\jordon-bronner-1,2013-14,New Hampshire,G,30,30,1002,104,270,.385,56,138,.406,48,132,.364,63,83,.759,8,65,73,66,21,1,38,55,319,6.6
3108,Paul Baxter\paul-baxter-1,2013-14,Sam Houston State,G,35,35,988,113,227,.498,67,118,.568,46,109,.422,47,77,.610,11,75,86,129,47,18,55,114,319,7.8
3109,Matt Hauser\matt-hauser-1,2016-17,Santa Clara,G,31,30,1099,113,273,.414,72,159,.453,41,114,.360,52,70,.743,7,55,62,162,26,1,51,53,319,8.2
3110,Luke Doyle\luke-doyle-1,2017-18,Stetson,G,32,32,876,115,287,.401,56,110,.509,59,177,.333,30,38,.789,17,75,92,49,28,7,41,49,319,6.3
3111,Warren Sledge\warren-sledge-1,2015-16,Citadel,G,31,28,879,104,253,.411,39,82,.476,65,171,.380,46,61,.754,21,49,70,73,28,5,47,65,319,7.0
3112,Tevin King\tevin-king-1,2017-18,South Dakota State,G,35,32,944,120,230,.522,102,173,.590,18,57,.316,61,85,.718,50,146,196,104,59,8,60,109,319,8.8
3113,Jay Wright\jay-wright-2,2014-15,Louisiana,G,35,34,921,103,268,.384,73,194,.376,30,74,.405,83,138,.601,17,92,109,127,31,8,78,73,319,6.0
3114,Marcus Harris\marcus-harris-1,2017-18,Sam Houston State,G,34,30,850,93,252,.369,55,127,.433,38,125,.304,95,122,.779,15,78,93,34,31,2,38,77,319,5.6
3115,Braxton Bonds\braxton-bonds-1,2017-18,Houston Baptist,G,31,30,1020,123,314,.392,116,270,.430,7,44,.159,66,108,.611,53,109,162,158,59,3,74,63,319,8.8
3116,T.J. Sapp\tj-sapp-1,2013-14,Murray State,G,24,1,643,94,228,.412,49,115,.426,45,113,.398,86,107,.804,13,79,92,41,28,7,50,65,319,8.6
3117,Khwan Fore\khwan-fore-1,2017-18,Richmond,G,29,26,931,117,244,.480,106,204,.520,11,40,.275,74,113,.655,23,69,92,77,27,4,44,64,319,7.9
3118,Emmett Naar\emmett-naar-1,2016-17,Saint Mary's (CA),G,34,34,1116,109,243,.449,73,158,.462,36,85,.424,65,76,.855,7,76,83,191,24,3,83,26,319,8.3
3119,Isaiah Hart\isaiah-hart-1,2017-18,Loyola (MD),G,31,27,838,125,257,.486,116,228,.509,9,29,.310,60,92,.652,7,53,60,90,32,5,82,71,319,6.0
3120,Jordan Capps\jordan-capps-1,2015-16,Southeastern Louisiana,G,32,14,661,128,244,.525,121,226,.535,7,18,.389,56,121,.463,66,134,200,12,8,26,50,77,319,6.7
3121,Nick Griffin\nick-griffin-1,2016-17,Saint Peter's,G,36,24,834,110,247,.445,35,67,.522,75,180,.417,23,24,.958,12,54,66,19,15,7,27,38,318,5.7
3122,Donte Williams\donte-williams-2,2014-15,Utah Valley,G,30,28,809,91,253,.360,49,112,.438,42,141,.298,94,116,.810,1,79,80,47,13,8,50,55,318,5.7
3123,TJ Starks\tj-starks-1,2017-18,Texas A&M,G,32,15,680,118,304,.388,83,196,.423,35,108,.324,47,74,.635,8,55,63,72,12,2,85,54,318,3.8
3124,Robert Hubbs\robert-hubbs-1,2015-16,Tennessee,G,30,16,801,128,283,.452,117,237,.494,11,46,.239,51,69,.739,47,70,117,38,13,1,22,47,318,7.2
3125,Jeremiah Paige\jeremiah-paige-1,2016-17,Colorado State,G,36,36,1171,101,272,.371,56,143,.392,45,129,.349,71,90,.789,10,80,90,91,32,23,66,77,318,5.7
3126,Marquise Moore\marquise-moore-1,2015-16,George Mason,G,28,27,910,111,279,.398,110,263,.418,1,16,.063,95,140,.679,26,144,170,86,18,26,58,64,318,8.0
3127,Aaron Hawley\aaron-hawley-1,2013-14,Drake,G,31,25,841,113,255,.443,52,124,.419,61,131,.466,31,44,.705,24,94,118,20,18,0,39,61,318,6.2
3128,Donte DiVincenzo\donte-divincenzo-1,2016-17,Villanova,G,36,1,919,109,234,.466,67,119,.563,42,115,.365,58,83,.699,37,100,137,61,33,10,51,58,318,7.0
3129,Jerome Seagears\jerome-seagears-1,2015-16,Nevada-Las Vegas,G,31,31,915,102,248,.411,57,117,.487,45,131,.344,69,86,.802,16,74,90,126,39,3,59,76,318,8.1
3130,Candon Rusin\candon-rusin-1,2013-14,Vermont,G,33,30,840,110,243,.453,56,114,.491,54,129,.419,44,60,.733,11,39,50,23,18,3,39,69,318,5.3
3131,Geno Luzcando\geno-luzcando-1,2016-17,Idaho State,G,30,30,912,119,241,.494,97,170,.571,22,71,.310,58,87,.667,43,109,152,29,61,7,74,94,318,7.4
3132,Andrew Ryan\andrew-ryan-1,2013-14,Campbell,G,32,32,928,113,253,.447,51,103,.495,62,150,.413,30,45,.667,36,93,129,69,41,11,46,63,318,8.1
3133,Nate Hickman\nate-hickman-1,2016-17,Columbia,G,27,27,747,102,255,.400,63,146,.432,39,109,.358,75,101,.743,14,60,74,52,25,4,56,56,318,6.8
3134,Marvin Smith\marvin-smith-2,2015-16,North Carolina-Greensboro,G,34,33,908,108,300,.360,53,129,.411,55,171,.322,47,70,.671,40,147,187,20,41,15,39,106,318,5.8
3135,Jon Octeus\jonathan-octeus-1,2014-15,Purdue,G,34,34,978,102,208,.490,86,160,.538,16,48,.333,97,134,.724,54,114,168,89,35,7,50,95,317,8.3
3136,Ervin Mitchell\ervin-mitchell-2,2015-16,Grambling,G,27,18,656,108,245,.441,82,159,.516,26,86,.302,75,112,.670,19,88,107,32,23,8,33,58,317,7.7
3137,Devin Patterson\devin-patterson-1,2014-15,Omaha,G,27,27,823,104,241,.432,77,168,.458,27,73,.370,82,101,.812,19,57,76,104,59,0,83,63,317,8.8
3138,Mo Evans\mo-evans-1,2014-15,Purdue-Fort Wayne,G,31,31,970,107,265,.404,53,102,.520,54,163,.331,49,60,.817,14,95,109,103,30,5,58,80,317,7.2
3139,Khufu Najee\khufu-najee-1,2013-14,IUPUI,G,32,30,1049,120,277,.433,104,222,.468,16,55,.291,61,75,.813,12,74,86,62,29,6,60,57,317,5.9
3140,Mike Hughes\mike-hughes-1,2016-17,Georgia Southern,G,30,30,917,100,277,.361,42,102,.412,58,175,.331,59,80,.738,12,104,116,48,35,5,58,77,317,5.9
3141,Kaelon Wilson\kaelon-wilson-1,2016-17,Texas-Arlington,G,36,7,717,117,224,.522,103,161,.640,14,63,.222,69,106,.651,33,68,101,43,30,5,49,66,317,6.2
3142,Craig Sword\craig-sword-1,2014-15,Mississippi State,G,28,22,695,97,215,.451,70,140,.500,27,75,.360,96,137,.701,12,67,79,48,29,11,71,70,317,6.7
3143,Isaiah Zierden\isaiah-zierden-1,2015-16,Creighton,G,31,31,984,95,236,.403,25,54,.463,70,182,.385,57,68,.838,8,94,102,69,44,0,29,42,317,8.6
3144,Ivan Canete\ivan-canete-1,2017-18,Stephen F. Austin,G,33,33,781,104,234,.444,55,116,.474,49,118,.415,60,77,.779,23,73,96,97,53,7,64,105,317,7.4
3145,Gerrell Martin\gerrell-martin-1,2013-14,Long Island University,G,26,26,817,107,242,.442,48,108,.444,59,134,.440,44,51,.863,30,61,91,23,20,0,33,49,317,8.1
3146,Justin Anderson\justin-anderson-1,2014-15,Virginia,G,26,23,724,103,221,.466,56,117,.479,47,104,.452,64,82,.780,17,88,105,45,17,14,31,30,317,9.6
3147,Dedric Boyd\dedric-boyd-1,2017-18,Eastern Kentucky,G,24,20,651,104,294,.354,70,173,.405,34,121,.281,75,90,.833,14,65,79,48,22,2,60,48,317,6.4
3148,Nick Coppola\nick-coppola-1,2016-17,Louisiana-Monroe,G,33,33,1233,106,273,.388,54,125,.432,52,148,.351,53,77,.688,8,92,100,146,16,0,51,63,317,7.1
3149,Laurent Rivard\laurent-rivard-1,2013-14,Harvard,G,32,31,1079,93,210,.443,13,24,.542,80,186,.430,51,63,.810,25,71,96,24,29,3,22,65,317,7.5
3150,Jahvaughn Powell\jahvaughn-powell-1,2017-18,Nicholls State,G,32,28,894,112,271,.413,42,84,.500,70,187,.374,23,30,.767,10,80,90,86,74,0,62,89,317,7.4
3151,Dmitri Thompson\dmitri-thompson-1,2015-16,Elon,G,32,30,800,125,252,.496,111,201,.552,14,51,.275,52,81,.642,42,110,152,38,26,3,57,60,316,6.7
3152,Brandon Spearman\brandon-spearman-1,2013-14,Hawaii,G,28,28,830,119,259,.459,78,137,.569,41,122,.336,37,62,.597,61,66,127,35,23,4,36,65,316,8.0
3153,Jaron Martin\jaron-martin-1,2015-16,UC-Irvine,G,38,0,756,105,271,.387,44,116,.379,61,155,.394,45,60,.750,13,42,55,54,23,0,37,48,316,5.0
3154,Ria'n Holland\rian-holland-1,2017-18,Mercer,G,18,15,539,105,217,.484,55,108,.509,50,109,.459,56,67,.836,12,41,53,44,28,1,27,37,316,13.3
3155,Joe O'Shea\joe-oshea-1,2014-15,Bryant,G,30,30,1017,95,204,.466,62,118,.525,33,86,.384,93,120,.775,52,118,170,67,25,9,41,102,316,9.0
3156,Chaz Glotta\chaz-glotta-1,2016-17,Northern Colorado,G,28,23,764,108,290,.372,31,68,.456,77,222,.347,23,35,.657,2,58,60,43,17,5,41,64,316,5.5
3157,Matt Donlan\matt-donlan-1,2016-17,Youngstown State,G,34,26,891,102,274,.372,35,98,.357,67,176,.381,45,52,.865,19,117,136,54,13,8,39,66,316,5.9
3158,Bjorn Broman\bjorn-broman-1,2017-18,Winthrop,G,31,29,938,94,215,.437,22,40,.550,72,175,.411,56,69,.812,8,60,68,95,38,2,34,57,316,8.7
3159,Ian Baker\ian-baker-1,2014-15,New Mexico State,G,34,33,989,98,213,.460,40,86,.465,58,127,.457,62,81,.765,9,74,83,93,50,1,74,53,316,7.3
3160,Dre Wills\dre-willis-1,2014-15,Vermont,G,34,34,927,120,210,.571,117,196,.597,3,14,.214,73,119,.613,37,127,164,80,63,33,65,91,316,8.9
3161,Amir Bell\amir-bell-2,2017-18,Princeton,G,29,29,1001,112,252,.444,80,165,.485,32,87,.368,60,92,.652,24,132,156,107,40,19,43,91,316,9.5
3162,Joe McDonald\joe-mcdonald-2,2015-16,George Washington,G,36,36,1072,102,250,.408,85,187,.455,17,63,.270,95,134,.709,53,144,197,110,42,5,53,78,316,7.9
3163,Kerwin Roach Jr.\kerwin-roachjr-1,2016-17,Texas,G,32,31,959,105,263,.399,84,189,.444,21,74,.284,85,135,.630,21,101,122,117,50,6,83,102,316,6.6
3164,Ethan Thompson\ethan-thompson-1,2017-18,Oregon State,G,32,32,1030,97,253,.383,62,148,.419,35,105,.333,87,119,.731,40,90,130,111,23,12,63,87,316,7.2
3165,J-Mychal Reese\j-mychal-reese-1,2016-17,North Texas,G,29,27,815,106,244,.434,76,178,.427,30,66,.455,74,102,.725,10,78,88,92,17,0,68,67,316,6.7
3166,JT Gibson\jt-gibson-1,2017-18,Omaha,G,31,11,871,113,258,.438,56,110,.509,57,148,.385,33,38,.868,9,63,72,81,27,4,52,63,316,6.9
3167,Shirmane Thomas\shirmane-thomas-1,2017-18,Grambling,G,30,26,845,105,260,.404,68,159,.428,37,101,.366,69,92,.750,30,108,138,49,29,12,62,72,316,6.7
3168,Marcus Ottey\marcus-ottey-1,2016-17,Illinois-Chicago,G,30,9,747,114,255,.447,96,208,.462,18,47,.383,69,95,.726,20,67,87,53,21,2,72,68,315,5.5
3169,Jamaal Robateau\jamaal-robateau-1,2016-17,Gardner-Webb,G,33,31,840,109,252,.433,49,96,.510,60,156,.385,37,47,.787,11,88,99,47,39,10,42,48,315,7.0
3170,Dwayne Lautier-Ogunleye\dwayne-lautier-ogunleye-1,2015-16,Bradley,G,32,24,1035,93,247,.377,65,161,.404,28,86,.326,101,169,.598,7,121,128,94,22,9,108,87,315,4.5
3171,Bryce Canda\bryce-canda-1,2016-17,Portland State,G,31,24,934,110,243,.453,53,96,.552,57,147,.388,38,48,.792,27,101,128,66,35,4,41,30,315,8.6
3172,Quade Green\quade-green-1,2017-18,Kentucky,G,34,13,869,116,257,.451,75,148,.507,41,109,.376,42,52,.808,13,47,60,91,11,0,55,55,315,5.8
3173,Jordan Dartis\jordan-dartis-1,2015-16,Ohio,G,32,26,1015,97,198,.490,30,58,.517,67,140,.479,54,61,.885,4,61,65,40,24,2,32,58,315,7.2
3174,Jordan Sims\jordan-sims-1,2013-14,Texas-San Antonio,G,30,30,970,101,260,.388,22,45,.489,79,215,.367,34,58,.586,44,80,124,29,37,3,26,83,315,7.3
3175,Tyrone Johnson\ty-johnson-1,2014-15,South Carolina,G,33,33,981,97,268,.362,69,172,.401,28,96,.292,93,112,.830,16,73,89,114,40,9,63,69,315,6.9
3176,Patricio Garino\patricio-garino-1,2013-14,George Washington,G,26,14,747,115,205,.561,103,170,.606,12,35,.343,73,123,.593,45,69,114,51,41,22,51,64,315,10.2
3177,Tyler Strange\tyler-strange-1,2013-14,Gardner-Webb,G,33,32,1068,106,253,.419,42,83,.506,64,170,.376,39,58,.672,10,73,83,163,57,0,59,57,315,8.8
3178,Isaiah Williams\isaiah-williams-1,2013-14,Iona,G,28,24,786,118,221,.534,57,78,.731,61,143,.427,18,20,.900,39,72,111,47,35,26,25,75,315,10.2
3179,Shake Milton\malik-milton-1,2015-16,Southern Methodist,G,30,23,980,113,237,.477,61,115,.530,52,122,.426,37,51,.725,9,80,89,82,24,8,46,43,315,8.1
3180,Edmond Sumner\edmond-sumner-1,2016-17,Xavier,G,22,19,697,101,211,.479,89,167,.533,12,44,.273,101,137,.737,11,81,92,105,27,16,58,51,315,11.8
3181,Jonah Mathews\jonah-matthews-1,2017-18,Southern California,G,34,23,921,115,251,.458,57,114,.500,58,137,.423,27,45,.600,20,68,88,32,19,5,28,59,315,6.1
3182,Robert Hatter\robert-hatter-1,2014-15,Cornell,G,28,27,743,97,266,.365,51,114,.447,46,152,.303,75,90,.833,16,60,76,19,34,7,40,65,315,6.3
3183,Calaen Robinson\calaen-robinson-1,2015-16,Portland State,G,31,20,884,107,273,.392,49,103,.476,58,170,.341,43,54,.796,10,85,95,101,55,1,59,69,315,7.6
3184,Devon Turk\devon-turk-1,2014-15,Loyola (IL),G,37,36,884,106,246,.431,28,62,.452,78,184,.424,25,30,.833,12,88,100,29,28,5,35,79,315,5.5
3185,Samir Doughty\samir-doughty-1,2016-17,Virginia Commonwealth,G,35,15,811,103,252,.409,80,171,.468,23,81,.284,85,111,.766,29,98,127,75,33,2,66,76,314,6.0
3186,Shelton Mitchell\shelton-mitchell-1,2016-17,Clemson,G,29,27,783,105,229,.459,76,165,.461,29,64,.453,75,94,.798,11,57,68,103,19,2,59,48,314,7.8
3187,Max Guercy\max-guercy-1,2014-15,Rice,G,32,32,1056,101,265,.381,65,136,.478,36,129,.279,76,88,.864,17,69,86,145,49,0,82,73,314,7.4
3188,Jermaine Jackson Jr.\jermaine-jacksonjr-1,2017-18,Detroit Mercy,G,30,24,893,102,301,.339,49,122,.402,53,179,.296,57,67,.851,15,76,91,80,34,3,54,54,314,6.3
3189,Tevin Bellinger\tevin-bellinger-1,2015-16,Prairie View,G,31,20,842,109,308,.354,80,188,.426,29,120,.242,67,79,.848,19,63,82,48,37,0,85,58,314,4.3
3190,Jeremy Major\jeremy-major-1,2015-16,Pepperdine,G,32,32,925,108,236,.458,64,131,.489,44,105,.419,54,97,.557,11,84,95,121,38,10,48,82,314,8.0
3191,Jeff White\jeff-white-1,2013-14,Loyola (IL),G,32,31,1032,109,234,.466,86,179,.480,23,55,.418,73,88,.830,12,91,103,97,32,4,78,77,314,6.8
3192,Terel Hall\terel-hall-1,2014-15,Savannah State,G,30,30,850,109,227,.480,106,208,.510,3,19,.158,93,130,.715,23,42,65,88,55,6,73,67,314,7.8
3193,Dakarai Henderson\dakarai-henderson-1,2014-15,Sam Houston State,G,35,0,738,101,292,.346,39,114,.342,62,178,.348,50,67,.746,23,56,79,21,18,3,29,41,314,4.7
3194,Anthony Hickey\anthony-hickey-1,2014-15,Oklahoma State,G,32,31,954,121,283,.428,61,133,.459,60,150,.400,12,29,.414,18,116,134,109,64,6,50,75,314,8.4
3195,Michael Frazier\michael-frazier-1,2014-15,Florida,G,26,19,759,98,235,.417,41,85,.482,57,150,.380,61,70,.871,23,84,107,37,31,2,46,44,314,8.5
3196,Isaiah Taylor\isaiah-taylor-1,2014-15,Texas,G,24,24,757,109,272,.401,98,233,.421,11,39,.282,85,101,.842,9,67,76,110,23,2,63,50,314,8.6
3197,Jahad Thomas\jahad-thomas-1,2014-15,Massachusetts-Lowell,G,22,21,706,123,235,.523,118,221,.534,5,14,.357,63,100,.630,28,114,142,34,29,3,70,59,314,9.0
3198,Travon Langston\travon-langston-1,2015-16,Southern Utah,G,28,17,699,108,222,.486,95,172,.552,13,50,.260,85,119,.714,14,128,142,54,27,4,64,73,314,7.5
3199,Kay Felder\kahlil-felder-1,2013-14,Oakland,G,33,33,1068,102,254,.402,82,192,.427,20,62,.323,90,119,.756,16,113,129,212,29,4,93,100,314,7.8
3200,Miles Wright\miles-wright-1,2015-16,Dartmouth,G,28,28,774,111,274,.405,74,168,.440,37,106,.349,54,78,.692,44,80,124,23,32,11,45,68,313,6.9
3201,Malik Morgan\malik-morgan-1,2016-17,Tulane,G,31,28,993,103,263,.392,71,159,.447,32,104,.308,75,100,.750,55,126,181,136,32,15,87,93,313,8.1
3202,Jarkell Joiner\jarkell-joiner-1,2017-18,Cal State Bakersfield,G,30,27,840,106,280,.379,74,168,.440,32,112,.286,69,76,.908,28,75,103,22,15,1,28,54,313,6.0
3203,Kentrell Barkley\kentrell-barkley-1,2015-16,East Carolina,G,31,11,872,98,211,.464,74,143,.517,24,68,.353,93,137,.679,53,142,195,93,38,11,48,50,313,10.0
3204,Davon Marshall\davon-marshall-1,2013-14,Liberty,G,31,26,939,99,300,.330,33,106,.311,66,194,.340,49,62,.790,9,46,55,72,28,0,47,32,313,5.7
3205,Lovell Cabbil\lovell-cabbil-1,2015-16,Liberty,G,32,31,982,100,264,.379,49,119,.412,51,145,.352,62,73,.849,11,93,104,80,45,10,75,84,313,6.2
3206,Shep Garner\shep-garner-1,2014-15,Penn State,G,34,32,979,104,286,.364,45,111,.405,59,175,.337,46,58,.793,17,75,92,77,33,2,48,69,313,5.8
3207,Justin Jaworski\justin-jaworski-1,2017-18,Lafayette,G,29,13,832,103,234,.440,42,92,.457,61,142,.430,46,54,.852,6,58,64,50,14,2,36,52,313,7.0
3208,Austin Vereen\austin-vereen-1,2017-18,Virginia Military Institute,G,30,17,814,95,264,.360,35,89,.393,60,175,.343,63,79,.797,32,109,141,31,32,12,39,56,313,7.2
3209,Katin Reinhardt\katin-reinhardt-1,2016-17,Marquette,G,29,4,749,104,258,.403,47,106,.443,57,152,.375,48,54,.889,21,58,79,61,18,3,39,41,313,7.3
3210,Prince Williams\prince-williams-1,2013-14,East Carolina,G,34,10,901,99,213,.465,92,185,.497,7,28,.250,108,151,.715,21,100,121,121,33,9,83,81,313,7.0
3211,Devon Bookert\devon-bookert-1,2015-16,Florida State,G,33,2,867,107,252,.425,48,101,.475,59,151,.391,40,53,.755,30,60,90,91,55,2,48,63,313,7.9
3212,Chris Jenkins\chris-jenkins-3,2016-17,Detroit Mercy,G,27,27,841,101,246,.411,76,168,.452,25,78,.321,86,104,.827,31,151,182,38,17,7,58,68,313,7.6
3213,Andell Cumberbatch\andell-cumberbatch-1,2014-15,St. Bonaventure,G,31,31,995,114,284,.401,76,179,.425,38,105,.362,47,67,.701,34,119,153,60,36,10,55,78,313,6.8
3214,Terry Tarpey\terry-tarpey-1,2015-16,William & Mary,G,30,30,905,113,232,.487,97,170,.571,16,62,.258,71,90,.789,42,191,233,75,62,39,55,57,313,11.3
3215,Bryce Moore\bryce-moore-1,2017-18,Western Michigan,G,32,32,982,100,247,.405,36,83,.434,64,164,.390,49,72,.681,8,76,84,49,39,2,30,73,313,6.7
3216,Justin Foreman\justin-foreman-1,2015-16,Central Arkansas,G,28,28,841,103,244,.422,68,151,.450,35,93,.376,72,125,.576,31,106,137,40,21,2,60,93,313,6.0
3217,Mike Cunningham\mike-cunningham-2,2015-16,South Carolina Upstate,G,32,27,926,99,269,.368,45,113,.398,54,156,.346,61,80,.763,6,77,83,85,25,0,57,55,313,5.9
3218,Remy Abell\remy-abell-1,2014-15,Xavier,G,37,34,1020,108,221,.489,69,126,.548,39,95,.411,57,80,.713,12,63,75,46,22,3,33,45,312,6.1
3219,JoJo Anderson\jojo-anderson-1,2017-18,Northern Arizona,G,28,10,708,72,208,.346,34,91,.374,38,117,.325,130,160,.813,7,42,49,62,15,2,65,46,312,6.3
3220,Drew Brandon\drew-brandon-1,2013-14,Eastern Washington,G,30,29,1002,102,273,.374,71,177,.401,31,96,.323,77,100,.770,57,136,193,152,29,5,74,83,312,8.8
3221,Jamall Robinson\jamall-robinson-1,2013-14,Hofstra,G,33,33,1103,106,274,.387,75,171,.439,31,103,.301,69,102,.676,44,95,139,52,20,9,46,88,312,5.8
3222,Isaac Williams\isaac-williams-1,2014-15,Mississippi Valley State,G,32,19,731,107,299,.358,64,171,.374,43,128,.336,55,64,.859,37,100,137,29,19,4,51,51,312,5.3
3223,Gary Bell\gary-bell-1,2014-15,Gonzaga,G,38,38,1058,101,250,.404,45,95,.474,56,155,.361,54,72,.750,9,84,93,76,32,5,35,90,312,5.8
3224,Tre' Thomas\tre-thomas-1,2016-17,Coppin State,G,32,25,829,105,292,.360,41,111,.369,64,181,.354,38,53,.717,14,58,72,26,4,1,34,54,312,4.3
3225,Kenny Cooper\kenny-cooper-2,2017-18,Lipscomb,G,31,30,845,110,264,.417,96,205,.468,14,59,.237,78,117,.667,16,62,78,121,63,9,94,85,312,6.8
3226,Kahron Ross\kahron-ross-1,2014-15,Lehigh,G,30,29,948,97,243,.399,74,172,.430,23,71,.324,95,119,.798,25,59,84,175,37,3,70,69,312,9.0
3227,Miguel Dicent\miguel-dicent-1,2016-17,Morehead State,G,30,29,955,111,283,.392,60,135,.444,51,148,.345,39,53,.736,14,75,89,122,26,12,60,72,312,7.2
3228,Julian Eleby\julian-eleby-1,2014-15,Virginia Military Institute,G,28,8,700,89,242,.368,54,127,.425,35,115,.304,99,127,.780,19,107,126,78,29,3,66,55,312,7.5
3229,B.J. Stith\bj-stith-1,2016-17,Old Dominion,G,30,25,721,109,292,.373,89,218,.408,20,74,.270,74,95,.779,18,111,129,30,15,6,39,45,312,5.7
3230,Arthur Edwards\arthur-edwards-1,2015-16,Alabama,G,33,33,945,107,259,.413,36,79,.456,71,180,.394,27,41,.659,18,106,124,47,26,15,62,83,312,5.7
3231,Justin Bibbs\justin-bibbs-1,2016-17,Virginia Tech,G,33,33,1032,107,262,.408,40,105,.381,67,157,.427,31,41,.756,11,82,93,54,12,3,35,71,312,5.7
3232,Derrick Gordon\derrick-gordon-1,2014-15,Massachusetts,G,32,32,910,108,268,.403,107,256,.418,1,12,.083,95,129,.736,36,120,156,85,49,14,79,42,312,7.4
3233,Curtis Cobb\curtis-cobb-1,2015-16,Fairfield,G,30,26,757,116,271,.428,72,148,.486,44,123,.358,36,53,.679,20,79,99,52,39,12,47,65,312,7.0
3234,Trevor Stumpe\trevor-stumpe-1,2017-18,Wofford,G,29,24,775,104,226,.460,57,116,.491,47,110,.427,57,66,.864,37,84,121,62,25,3,42,79,312,8.3
3235,A.J. Harris\aj-harris-2,2017-18,New Mexico State,G,33,33,914,121,300,.403,84,173,.486,37,127,.291,32,58,.552,14,50,64,97,30,10,53,69,311,5.7
3236,Devon Walker\devon-walker-2,2014-15,Maryland-Eastern Shore,G,33,33,916,107,248,.431,35,65,.538,72,183,.393,25,31,.806,15,84,99,32,21,8,27,72,311,6.3
3237,Austin Loop\austin-loop-1,2015-16,Marshall,G,33,33,955,97,238,.408,11,22,.500,86,216,.398,31,36,.861,19,37,56,34,24,8,14,55,311,6.8
3238,Sean Gardner\sean-gardner-1,2015-16,Arkansas State,G,30,27,972,106,305,.348,68,175,.389,38,130,.292,61,73,.836,42,65,107,51,27,7,52,66,311,5.8
3239,Kyle Boswell\kyle-boswell-1,2013-14,UC-Santa Barbara,G,30,5,832,90,213,.423,17,43,.395,73,170,.429,58,81,.716,1,51,52,77,12,0,38,41,311,7.2
3240,Roderick Bobbitt\roderick-bobbitt-1,2014-15,Hawaii,G,35,35,1155,94,245,.384,67,138,.486,27,107,.252,96,131,.733,32,88,120,187,100,7,96,102,311,8.9
3241,DaQuan Bracey\daquan-bracey-1,2017-18,Louisiana Tech,G,25,16,622,113,241,.469,87,177,.492,26,64,.406,59,92,.641,16,31,47,103,22,2,61,42,311,8.5
3242,Damyean Dotson\damyean-dotson-1,2013-14,Oregon,G,33,33,786,116,265,.438,90,182,.495,26,83,.313,53,66,.803,23,83,106,40,16,5,38,58,311,5.9
3243,Evan Roquemore\evan-roguemore-1,2013-14,Santa Clara,G,29,16,879,97,271,.358,55,150,.367,42,121,.347,75,96,.781,16,74,90,85,23,11,71,68,311,6.1
3244,Daniel Dixon\daniel-dixon-1,2014-15,William & Mary,G,28,27,812,102,232,.440,29,70,.414,73,162,.451,34,42,.810,6,72,78,32,23,9,31,70,311,7.3
3245,Malik Harmon\malik-harmon-1,2014-15,Saint Francis (PA),G,32,29,1002,101,255,.396,58,124,.468,43,131,.328,66,101,.653,3,66,69,85,37,3,56,76,311,6.0
3246,Avry Holmes\avry-holmes-1,2015-16,Clemson,G,31,31,959,91,243,.374,41,93,.441,50,150,.333,79,109,.725,17,69,86,80,36,0,41,55,311,7.3
3247,Muhammad-Ali Abdur-Rahkman\muhammad-ali-abdur-rahkman-1,2015-16,Michigan,G,36,25,1001,116,253,.458,85,168,.506,31,85,.365,48,68,.706,22,76,98,61,22,9,27,59,311,6.4
3248,Yosef Yacob\yosef-yacob-1,2013-14,Binghamton,G,27,22,876,90,268,.336,44,128,.344,46,140,.329,85,115,.739,10,39,49,70,26,1,88,57,311,4.9
3249,Madarious Gibbs\madarious-gibbs-1,2013-14,Texas Southern,G,34,29,1175,109,216,.505,91,165,.552,18,51,.353,75,114,.658,23,82,105,178,32,4,99,92,311,7.4
3250,Zach Green\zach-green-2,2016-17,Montana State,G,32,32,722,101,227,.445,80,151,.530,21,76,.276,88,116,.759,43,116,159,38,21,6,37,108,311,6.8
3251,Keljin Blevins\keljin-blevins-1,2017-18,Montana State,G,32,31,784,108,255,.424,99,217,.456,9,38,.237,86,126,.683,66,120,186,30,19,13,68,71,311,6.1
3252,Terrence Williams\terrence-williams-2,2014-15,Charlotte,G,32,27,826,104,246,.423,79,183,.432,25,63,.397,78,109,.716,33,105,138,70,28,3,72,85,311,6.1
3253,Aaric Armstead\aaric-armstead-1,2014-15,Northern Illinois,G,28,27,807,100,244,.410,79,183,.432,21,61,.344,90,128,.703,39,92,131,18,40,10,47,51,311,7.6
3254,Parker Kelly\parker-kelly-1,2013-14,Eastern Washington,G,31,27,1069,94,228,.412,39,77,.506,55,151,.364,68,76,.895,8,87,95,42,21,6,35,86,311,6.5
3255,Lovell Cabbil\lovell-cabbil-1,2016-17,Liberty,G,32,27,925,106,240,.442,65,121,.537,41,119,.345,58,72,.806,8,97,105,60,45,7,42,85,311,7.2
3256,Ty Charles\ty-charles-1,2015-16,Stephen F. Austin,G,33,31,832,114,257,.444,92,184,.500,22,73,.301,61,82,.744,56,101,157,76,45,10,60,90,311,7.5
3257,Mike Williams\mike-williams-9,2016-17,Rutgers,G,33,12,865,109,278,.392,66,143,.462,43,135,.319,49,67,.731,70,98,168,37,30,9,33,76,310,6.9
3258,Ronnie Boyce III\ronnie-boyceiii-1,2015-16,San Francisco,G,28,14,582,113,287,.394,75,170,.441,38,117,.325,46,63,.730,20,75,95,42,25,11,34,54,310,6.8
3259,Sheriff Drammeh\sheriff-drammeh-1,2017-18,Hawaii,G,29,22,881,93,238,.391,52,124,.419,41,114,.360,83,108,.769,13,85,98,55,33,6,48,88,310,6.8
3260,Max Yon\max-yon-1,2014-15,Air Force,G,25,17,706,112,242,.463,70,129,.543,42,113,.372,44,68,.647,8,51,59,56,13,4,51,36,310,7.5
3261,Mario Kegler\mario-kegler-1,2016-17,Mississippi State,G,32,31,901,106,252,.421,66,136,.485,40,116,.345,58,88,.659,37,138,175,37,22,8,60,78,310,6.1
3262,James Reid\james-reid-1,2016-17,Boise State,G,31,15,721,94,219,.429,30,54,.556,64,165,.388,58,70,.829,5,68,73,50,18,4,48,83,310,6.1
3263,Matthew Fisher-Davis\matthew-fisher-davis-1,2015-16,Vanderbilt,G,32,28,877,102,236,.432,23,59,.390,79,177,.446,27,36,.750,12,103,115,36,15,9,27,50,310,6.9
3264,Alex Young\alex-young-2,2013-14,UC-Irvine,G,35,35,1004,109,276,.395,78,181,.431,31,95,.326,61,86,.709,26,91,117,161,35,6,70,77,310,7.1
3265,Dylan Poston\dylan-poston-1,2015-16,Gardner-Webb,G,33,33,819,103,291,.354,38,93,.409,65,198,.328,39,56,.696,11,79,90,34,34,6,30,47,310,5.6
3266,Ray Bowles\ray-bowles-1,2015-16,Pacific,G,28,28,769,103,224,.460,77,147,.524,26,77,.338,78,106,.736,34,76,110,64,18,2,56,69,310,7.5
3267,Tavon Blackmon\tavon-blackmon-1,2016-17,Brown,G,28,28,810,97,254,.382,58,157,.369,39,97,.402,77,100,.770,7,37,44,109,32,0,61,59,310,7.2
3268,Marvin Smith\marvin-smith-2,2016-17,North Carolina-Greensboro,G,34,34,887,107,287,.373,52,112,.464,55,175,.314,41,57,.719,47,93,140,36,30,21,46,96,310,5.6
3269,Michael Oguine\michael-oguine-1,2016-17,Montana,G,26,23,738,99,206,.481,80,155,.516,19,51,.373,93,123,.756,52,104,156,43,37,8,32,91,310,10.2
3270,Deville Smith\deville-smith-1,2013-14,Nevada-Las Vegas,G,32,18,810,110,258,.426,65,125,.520,45,133,.338,45,66,.682,15,40,55,87,32,5,63,57,310,6.2
3271,Allonzo Trier\allonzo-trier-1,2016-17,Arizona,G,18,13,575,91,198,.460,57,111,.514,34,87,.391,94,116,.810,5,91,96,48,7,2,31,32,310,12.7
3272,Mack Smith\mack-smith-3,2017-18,Eastern Illinois,G,25,20,682,106,231,.459,52,92,.565,54,139,.388,44,59,.746,5,91,96,35,17,5,41,55,310,7.9
3273,Marcus Allen\marcus-allen-2,2015-16,Stanford,G,28,24,848,101,246,.411,83,171,.485,18,75,.240,90,124,.726,35,73,108,52,39,1,45,70,310,7.6
3274,Chris Wilson\chris-wilson-1,2013-14,Saint Joseph's,G,34,34,1152,103,260,.396,55,124,.444,48,136,.353,56,86,.651,14,110,124,92,25,6,63,44,310,6.3
3275,Edward Townsel\edward-townsel-1,2013-14,Arkansas State,G,32,26,898,102,253,.403,59,127,.465,43,126,.341,63,75,.840,35,83,118,71,39,2,44,72,310,7.4
3276,Austin Nehls\austin-nehls-1,2017-18,Central Connecticut State,G,32,32,1101,100,260,.385,33,65,.508,67,195,.344,43,67,.642,29,96,125,40,19,6,27,35,310,6.8
3277,Reggie Johnson\reggie-johnson-3,2014-15,Hampton,G,26,17,722,104,281,.370,65,168,.387,39,113,.345,63,106,.594,33,53,86,43,36,7,39,54,310,7.2
3278,Kris Yanku\kris-yanku-1,2013-14,Northern Arizona,G,32,7,799,87,226,.385,76,197,.386,11,29,.379,124,150,.827,9,78,87,91,47,2,72,79,309,6.7
3279,Malcolm Brooks\malcolm-brooks-1,2013-14,Pepperdine,G,30,28,842,106,231,.459,62,120,.517,44,111,.396,53,65,.815,18,60,78,49,12,3,32,70,309,6.8
3280,Eric James\eric-james-2,2015-16,Duquesne,G,34,22,872,117,247,.474,98,171,.573,19,76,.250,56,86,.651,54,122,176,48,37,10,68,77,309,6.6
3281,Quincy McKnight\quincy-mcknight-1,2015-16,Sacred Heart,G,27,27,867,119,275,.433,109,235,.464,10,40,.250,61,108,.565,28,114,142,68,42,11,75,84,309,7.0
3282,Devareaux Manley\devareaux-manley-1,2013-14,Kent State,G,32,15,744,94,243,.387,21,56,.375,73,187,.390,48,59,.814,7,52,59,15,14,1,27,59,309,5.2
3283,Riley Grabau\riley-grabau-1,2014-15,Wyoming,G,34,33,1154,78,207,.377,17,41,.415,61,166,.367,92,98,.939,5,70,75,73,8,3,48,53,309,6.2
3284,Steve Santa Ana\steve-santaana-1,2017-18,Elon,G,32,29,906,108,251,.430,55,104,.529,53,147,.361,40,62,.645,24,117,141,62,25,8,58,67,309,6.5
3285,Steven Haney\steven-haney-1,2017-18,Loyola Marymount,G,24,22,730,96,250,.384,30,90,.333,66,160,.413,51,66,.773,6,51,57,35,19,1,29,47,309,7.6
3286,Marcus Burton\marcus-burton-1,2013-14,Wagner,G,28,0,626,98,234,.419,51,108,.472,47,126,.373,66,76,.868,7,50,57,45,18,3,41,57,309,6.7
3287,DeMarcus Robinson\demarcus-robinson-1,2014-15,Alabama State,G,29,28,870,110,254,.433,59,133,.444,51,121,.421,38,51,.745,21,57,78,61,34,2,36,44,309,7.8
3288,Kareem Brewton Jr.\kareem-brewtonjr-1,2017-18,Memphis,G,34,14,832,115,272,.423,96,189,.508,19,83,.229,60,92,.652,32,59,91,80,30,2,71,70,309,5.3
3289,Derrick Gordon\derrick-gordon-1,2013-14,Massachusetts,G,33,33,942,131,274,.478,131,270,.485,0,4,.000,47,89,.528,36,81,117,67,48,10,55,65,309,6.8
3290,A.J. Merriweather\aj-merriweather-1,2014-15,East Tennessee State,G,30,28,816,112,232,.483,92,183,.503,20,49,.408,65,90,.722,57,127,184,41,39,10,58,79,309,8.2
3291,Qiydar Davis\qiydar-davis-1,2017-18,Indiana State,G,29,20,768,111,236,.470,83,156,.532,28,80,.350,59,76,.776,37,101,138,30,47,18,47,87,309,8.2
3292,Quinton Adlesh\quinton-adlesh-1,2017-18,Columbia,G,27,25,796,112,241,.465,40,78,.513,72,163,.442,13,19,.684,14,79,93,63,29,1,41,44,309,8.6
3293,Antino Jackson\antino-jackson-1,2016-17,Akron,G,35,26,820,102,250,.408,53,106,.500,49,144,.340,56,78,.718,13,63,76,80,33,2,59,68,309,5.7
3294,Ron Patterson\ron-patterson-1,2017-18,IUPUI,G,30,27,837,111,275,.404,49,105,.467,62,170,.365,25,38,.658,16,79,95,54,33,20,49,66,309,6.7
3295,Martynas Bareika\martynas-bareika-1,2013-14,Chattanooga,G,33,17,642,97,245,.396,40,84,.476,57,161,.354,58,83,.699,32,60,92,21,16,4,42,59,309,5.3
3296,James Harvey\james-harvey-3,2015-16,McNeese State,G,29,13,701,95,267,.356,35,87,.402,60,180,.333,59,76,.776,11,30,41,24,17,2,27,49,309,5.5
3297,Jarvis Davis\jarvis-davis-1,2014-15,Gardner-Webb,G,35,35,842,99,235,.421,43,82,.524,56,153,.366,54,62,.871,17,103,120,31,39,2,39,68,308,6.2
3298,Agunwa Okolie\agunwa-okolie-1,2015-16,Harvard,G,30,30,930,120,224,.536,115,211,.545,5,13,.385,63,100,.630,67,112,179,60,34,21,55,73,308,9.0
3299,Devontavius Payne\devontavius-payne-1,2017-18,East Tennessee State,G,33,5,775,107,262,.408,37,83,.446,70,179,.391,24,30,.800,16,88,104,36,30,16,31,62,308,6.5
3300,Dirk Williams\dirk-williams-2,2015-16,Alabama-Birmingham,G,33,1,625,108,224,.482,60,99,.606,48,125,.384,44,49,.898,36,92,128,44,14,17,36,49,308,7.5
3301,Brandon Reed\brandon-reed-1,2013-14,Arkansas State,G,32,19,796,98,249,.394,54,124,.435,44,125,.352,68,93,.731,13,64,77,65,21,1,31,49,308,6.5
3302,Xavian Rimmer\xavian-rimmer-2,2013-14,Louisiana,G,35,24,947,89,205,.434,32,73,.438,57,132,.432,73,89,.820,16,66,82,60,26,1,40,84,308,6.3
3303,Sekou Wiggs\sekou-wiggs-1,2013-14,Idaho,G,31,0,724,90,192,.469,85,179,.475,5,13,.385,123,187,.658,34,88,122,41,16,0,49,56,308,6.7
3304,Remy Martin\remy-martin-2,2017-18,Arizona State,G,32,1,737,107,236,.453,84,174,.483,23,62,.371,71,94,.755,22,73,95,94,36,2,43,48,308,8.0
3305,Josh Perkins\josh-perkins-1,2016-17,Gonzaga,G,38,35,1106,97,232,.418,34,74,.459,63,158,.399,51,70,.729,9,78,87,119,33,6,75,85,308,5.7
3306,Phlandrous Fleming Jr.\phlandrous-flemingjr-1,2017-18,Charleston Southern,G,29,26,812,106,254,.417,63,136,.463,43,118,.364,52,72,.722,39,75,114,47,36,12,42,50,307,7.9
3307,Kevin Huerter\kevin-huerter-1,2016-17,Maryland,G,33,33,971,111,264,.420,46,89,.517,65,175,.371,20,28,.714,22,141,163,88,32,23,46,60,307,7.9
3308,Trent Mackey\trent-mackey-1,2014-15,North Florida,G,35,1,903,93,210,.443,12,24,.500,81,186,.435,40,46,.870,10,47,57,50,17,2,30,74,307,6.0
3309,Matt Bohannon\matt-bohannon-1,2013-14,Northern Iowa,G,31,31,907,98,244,.402,21,38,.553,77,206,.374,34,47,.723,4,92,96,41,23,0,12,66,307,6.9
3310,Rashaan Surles\rashaan-surles-1,2016-17,Mississippi Valley State,G,31,23,810,114,263,.433,97,201,.483,17,62,.274,62,80,.775,21,71,92,74,43,18,66,64,307,6.9
3311,Tyler Nelson\tyler-nelson-1,2014-15,Fairfield,G,30,27,815,97,229,.424,33,78,.423,64,151,.424,49,57,.860,14,44,58,41,21,0,40,39,307,6.6
3312,Brandon Goodwin\brandon-goodwin-1,2014-15,Central Florida,G,30,30,1013,108,247,.437,91,182,.500,17,65,.262,74,122,.607,36,81,117,127,37,4,88,59,307,7.5
3313,Graham Woodward\graham-woodward-1,2017-18,Drake,G,34,6,797,99,250,.396,37,91,.407,62,159,.390,47,62,.758,11,54,65,53,22,0,45,65,307,5.2
3314,Avery Woodson\avery-woodson-1,2015-16,Memphis,G,32,15,840,101,238,.424,24,59,.407,77,179,.430,28,40,.700,10,72,82,46,26,9,22,80,307,6.7
3315,Chris Lykes\chris-lykes-1,2017-18,Miami (FL),G,32,10,690,100,249,.402,52,110,.473,48,139,.345,59,82,.720,3,36,39,75,25,1,58,70,307,5.3
3316,Jordan Cornish\jordan-cornish-1,2017-18,Tulane,G,31,31,937,103,275,.375,62,150,.413,41,125,.328,60,86,.698,12,88,100,101,11,10,74,46,307,5.7
3317,Reed Tellinghuisen\reed-tellinghuisen-1,2015-16,South Dakota State,G,34,34,1018,103,259,.398,43,96,.448,60,163,.368,41,67,.612,47,117,164,40,11,14,53,84,307,5.5
3318,Kyle Williams\kyle-williams-4,2017-18,Norfolk State,G,32,25,871,101,242,.417,36,79,.456,65,163,.399,40,58,.690,23,91,114,44,22,8,51,53,307,6.3
3319,Evan Bradds\evan-bradds-1,2013-14,Belmont,G,35,5,773,112,172,.651,112,164,.683,0,8,.000,83,119,.697,46,98,144,32,15,6,39,103,307,6.9
3320,Ty Toney\ty-toney-1,2016-17,Eastern Michigan,G,30,29,810,113,267,.423,99,220,.450,14,47,.298,67,106,.632,11,51,62,81,48,7,40,50,307,7.4
3321,Steven Spieth\steven-spieth-1,2014-15,Brown,G,31,30,1000,89,230,.387,72,158,.456,17,72,.236,112,138,.812,35,111,146,65,32,17,69,78,307,7.0
3322,Josh Newkirk\josh-newkirk-1,2016-17,Indiana,G,34,32,955,114,260,.438,79,168,.470,35,92,.380,44,63,.698,23,82,105,107,19,7,76,99,307,5.5
3323,Bobby Conley\bobby-conley-1,2016-17,Texas State,G,36,34,1077,104,252,.413,59,117,.504,45,135,.333,54,84,.643,14,121,135,71,35,8,35,66,307,6.5
3324,Donte Clark\donte-clark-1,2014-15,Massachusetts,G,32,18,742,91,233,.391,62,145,.428,29,88,.330,96,126,.762,21,58,79,63,22,7,42,66,307,6.3
3325,Ahmad Abdullah\ahmad-abdullah-1,2015-16,North Carolina A&T,G,32,29,1122,100,263,.380,62,166,.373,38,97,.392,69,87,.793,19,84,103,109,18,1,59,63,307,6.4
3326,Zak Showalter\zak-showalter-1,2016-17,Wisconsin,G,37,37,1088,107,214,.500,58,91,.637,49,123,.398,44,53,.830,29,79,108,65,56,11,41,99,307,7.3
3327,A.J. Jacobson\aj-jacobson-1,2016-17,North Dakota State,G,29,28,924,95,218,.436,45,101,.446,50,117,.427,67,87,.770,14,145,159,65,16,23,40,67,307,8.6
3328,Patrick McCaw\patrick-mccaw-1,2014-15,Nevada-Las Vegas,G,32,16,947,105,261,.402,48,106,.453,57,155,.368,40,56,.714,23,81,104,86,48,10,57,49,307,7.5
3329,Jerry Johnson Jr.\jerry-johnsonjr-1,2016-17,Fairfield,G,27,13,775,101,263,.384,39,79,.494,62,184,.337,43,58,.741,8,83,91,39,19,2,28,54,307,6.9
3330,Alex Caruso\alex-caruso-1,2013-14,Texas A&M,G,34,33,1013,103,224,.460,79,152,.520,24,72,.333,76,111,.685,15,107,122,170,69,28,84,91,306,9.0
3331,Shane Southwell\shane-southwell-1,2013-14,Kansas State,G,31,23,835,108,281,.384,70,157,.446,38,124,.306,52,76,.684,34,98,132,84,25,33,49,69,306,7.3
3332,Zach Kocur\zach-kocur-1,2015-16,Air Force,G,32,32,967,103,265,.389,46,107,.430,57,158,.361,43,60,.717,17,154,171,64,37,0,65,74,306,6.3
3333,Anthony White\anthony-white-1,2013-14,Mercer,G,36,36,772,104,218,.477,57,108,.528,47,110,.427,51,64,.797,23,65,88,39,19,1,20,54,306,6.4
3334,JerShon Cobb\jershon-cobb-1,2013-14,Northwestern,G,25,24,839,104,253,.411,66,145,.455,38,108,.352,60,77,.779,6,113,119,57,22,8,48,75,306,7.7
3335,Andre Walker\andre-walker-3,2014-15,Loyola (MD),G,30,14,838,97,305,.318,77,219,.352,20,86,.233,92,117,.786,33,91,124,68,52,4,71,90,306,5.6
3336,Jaren Sina\jaren-sina-1,2016-17,George Washington,G,34,34,1094,88,265,.332,28,100,.280,60,165,.364,70,83,.843,13,78,91,110,28,0,50,34,306,6.6
3337,Justin Simmons\justin-simmons-1,2013-14,Omaha,G,30,17,632,109,295,.369,82,186,.441,27,109,.248,61,75,.813,15,57,72,46,32,8,53,24,306,5.7
3338,Jaylen Hands\jaylen-hands-1,2017-18,UCLA,G,31,15,781,102,252,.405,59,137,.431,43,115,.374,59,80,.738,18,105,123,81,30,5,57,49,306,7.1
3339,Isaiah Williams\isaiah-williams-1,2014-15,Iona,G,23,21,798,107,213,.502,38,57,.667,69,156,.442,23,31,.742,42,98,140,51,33,32,24,67,306,12.9
3340,Deverell Biggs\deverell-biggs-1,2014-15,Texas Southern,G,26,26,753,112,240,.467,84,168,.500,28,72,.389,54,70,.771,13,73,86,50,43,6,69,64,306,7.5
3341,Braxton Ogbueze\braxton-ogbueze-1,2014-15,Charlotte,G,32,32,899,97,245,.396,48,124,.387,49,121,.405,63,76,.829,19,54,73,54,30,1,37,55,306,6.5
3342,Brynton Lemar\brynton-lemar-1,2015-16,UC-Davis,G,30,26,929,108,269,.401,59,149,.396,49,120,.408,41,59,.695,14,93,107,47,24,1,50,76,306,5.6
3343,Thatch Unruh\thatch-unruh-1,2017-18,Central Arkansas,G,35,25,821,101,243,.416,54,95,.568,47,148,.318,57,73,.781,19,102,121,85,30,3,61,77,306,6.1
3344,Jamal Williams\jamal-williams-3,2017-18,Sam Houston State,G,36,16,903,118,230,.513,108,206,.524,10,24,.417,60,92,.652,77,120,197,63,39,4,51,58,306,7.8
3345,Malique Trent\malique-trent-1,2017-18,Hampton,G,23,10,588,104,206,.505,81,140,.579,23,66,.348,75,92,.815,14,79,93,79,40,6,55,62,306,10.9
3346,Levi Randolph\levi-randolph-1,2013-14,Alabama,G,32,19,958,103,245,.420,70,150,.467,33,95,.347,67,95,.705,38,85,123,45,27,5,51,61,306,6.4
3347,Jorge Rosa\jorge-rosa-1,2014-15,Florida A&M,G,27,24,809,96,276,.348,41,108,.380,55,168,.327,59,83,.711,17,56,73,18,19,3,42,41,306,5.4
3348,Greg Tucker\greg-tucker-3,2015-16,Jacksonville State,G,31,20,763,80,239,.335,33,89,.371,47,150,.313,99,122,.811,14,55,69,41,21,1,55,71,306,5.0
3349,Anthony Barber\anthony-cat-barber-1,2013-14,North Carolina State,G,36,18,870,108,269,.401,96,223,.430,12,46,.261,78,112,.696,14,58,72,126,21,1,62,59,306,5.5
3350,Devon Bookert\devon-bookert-1,2013-14,Florida State,G,36,27,987,100,240,.417,56,138,.406,44,102,.431,61,78,.782,19,96,115,102,38,2,72,67,305,6.2
3351,Derric Jean\derric-jean-1,2017-18,Louisiana Tech,G,32,19,847,97,234,.415,47,120,.392,50,114,.439,61,82,.744,20,79,99,61,35,5,54,76,305,6.4
3352,Tyler White\tyler-white-1,2014-15,Northern Kentucky,G,30,24,833,109,274,.398,43,99,.434,66,175,.377,21,34,.618,10,48,58,35,16,5,27,66,305,5.5
3353,Jared Terrell\jared-terrell-1,2014-15,Rhode Island,G,33,31,893,105,283,.371,75,189,.397,30,94,.319,65,91,.714,15,65,80,49,46,5,58,105,305,4.6
3354,Daniel Harris\daniel-harris-1,2015-16,Quinnipiac,G,30,28,802,104,253,.411,34,81,.420,70,172,.407,27,40,.675,33,97,130,60,34,10,48,51,305,7.7
3355,Luke Nelson\luke-nelson-1,2016-17,UC-Irvine,G,18,18,468,101,221,.457,47,96,.490,54,125,.432,49,71,.690,4,55,59,54,30,4,47,42,305,11.6
3356,Terrell Lewis\terrell-lewis-1,2016-17,Eastern Illinois,G,29,28,924,95,252,.377,23,66,.348,72,186,.387,43,56,.768,12,27,39,136,34,0,50,56,305,8.1
3357,Torin Dorn\torin-dorn-1,2016-17,North Carolina State,G,32,18,768,114,228,.500,90,162,.556,24,66,.364,53,78,.679,29,119,148,27,13,4,43,42,305,6.6
3358,Brian Brown\brian-brown-5,2014-15,Virginia Military Institute,G,28,25,754,106,264,.402,31,71,.437,75,193,.389,18,21,.857,10,43,53,51,32,2,52,39,305,6.5
3359,Jamari Bradshaw\jamari-bradshaw-1,2013-14,Florida A&M,G,32,22,565,113,259,.436,84,174,.483,29,85,.341,50,92,.543,35,79,114,31,38,3,43,65,305,6.0
3360,Riley Norris\riley-norris-1,2016-17,Alabama,G,34,27,929,105,258,.407,58,117,.496,47,141,.333,48,65,.738,41,88,129,25,23,4,38,76,305,5.6
3361,Saah Nimley\saah-nimley-1,2013-14,Charleston Southern,G,23,18,648,84,234,.359,45,122,.369,39,112,.348,98,127,.772,12,41,53,114,23,2,52,47,305,9.4
3362,Markus Golder\markus-golder-1,2017-18,Valparaiso,G,32,5,728,109,221,.493,76,144,.528,33,77,.429,54,65,.831,27,111,138,42,26,16,50,74,305,7.1
3363,Malcolm Brooks\malcolm-brooks-1,2015-16,Cal State Fullerton,G,26,18,585,103,243,.424,62,132,.470,41,111,.369,58,75,.773,8,25,33,28,10,1,31,40,305,6.4
3364,Steven Spieth\steven-spieth-1,2015-16,Brown,G,28,28,866,93,215,.433,67,135,.496,26,80,.325,93,112,.830,44,157,201,104,26,10,58,90,305,9.8
3365,Rasean Simpson\rasean-simpson-1,2015-16,Morgan State,G,25,21,807,104,219,.475,101,213,.474,3,6,.500,94,133,.707,64,105,169,17,36,8,39,73,305,9.6
3366,Kellon Thomas\kellon-thomas-1,2016-17,IUPUI,G,32,32,892,92,265,.347,61,175,.349,31,90,.344,90,100,.900,13,54,67,85,27,1,46,69,305,6.0
3367,Zack Denny\zack-denny-1,2014-15,Bowling Green State,G,33,20,896,105,252,.417,55,125,.440,50,127,.394,45,53,.849,42,131,173,31,53,5,38,60,305,7.6
3368,Zjori Bosha\zjori-bosha-1,2017-18,Lamar,G,33,33,1035,104,245,.424,64,124,.516,40,121,.331,57,99,.576,57,113,170,38,56,12,39,86,305,7.6
3369,Alex Barlow\alex-barlow-1,2014-15,Butler,G,34,34,1154,98,243,.403,41,90,.456,57,153,.373,51,61,.836,16,120,136,88,74,2,64,103,304,7.3
3370,Brandon Kamga\brandon-kamga-1,2017-18,High Point,G,28,27,757,108,260,.415,91,216,.421,17,44,.386,71,91,.780,26,70,96,52,26,7,53,83,304,6.3
3371,Giovanni De Nicolao\giovanni-denicolao-1,2017-18,Texas-San Antonio,G,35,33,976,109,270,.404,73,166,.440,36,104,.346,50,74,.676,14,101,115,123,50,3,70,96,304,6.3
3372,Devin Coleman\devin-coleman-1,2015-16,Temple,G,33,14,850,106,289,.367,42,126,.333,64,163,.393,28,39,.718,32,66,98,33,14,4,27,46,304,5.3
3373,Blake Simmons\blake-simmons-1,2013-14,Evansville,G,33,33,1060,99,245,.404,60,136,.441,39,109,.358,67,91,.736,16,83,99,77,29,10,51,74,304,6.3
3374,Tre Lynch\tre-lynch-1,2013-14,Southern,G,32,2,598,101,233,.433,58,106,.547,43,127,.339,59,83,.711,17,56,73,26,27,2,33,57,304,6.0
3375,Charles Jackson\charles-jackson-4,2017-18,Arkansas-Pine Bluff,G,35,33,1036,98,286,.343,42,92,.457,56,194,.289,52,78,.667,24,81,105,78,38,12,75,85,304,4.7
3376,Braxton Ogbueze\braxton-ogbueze-1,2016-17,Charlotte,G,30,27,927,103,265,.389,36,96,.375,67,169,.396,31,39,.795,14,54,68,32,16,3,25,34,304,6.1
3377,Marial Shayok\marial-shayok-1,2016-17,Virginia,G,34,14,702,121,272,.445,102,214,.477,19,58,.328,43,54,.796,12,70,82,33,30,10,36,46,304,5.7
3378,Jamall Gregory\jamall-gregory-1,2017-18,Jacksonville State,G,36,32,830,113,251,.450,88,169,.521,25,82,.305,53,81,.654,19,101,120,106,53,34,85,73,304,6.7
3379,Calvin Newell\calvin-newell--1,2013-14,Central Florida,G,30,29,839,104,275,.378,73,161,.453,31,114,.272,65,101,.644,21,49,70,86,51,2,72,52,304,6.3
3380,Martin Hermannsson\martin-hermannsson-1,2014-15,Long Island University,G,30,30,937,90,230,.391,68,150,.453,22,80,.275,102,118,.864,18,97,115,100,27,5,73,83,304,7.0
3381,LaDarrien Williams\ladarrien-williams-1,2014-15,Abilene Christian,G,31,14,747,110,276,.399,78,183,.426,32,93,.344,52,62,.839,30,105,135,62,28,3,64,71,304,5.9
3382,Mo Evans\mo-evans-1,2015-16,Purdue-Fort Wayne,G,18,18,558,103,214,.481,55,101,.545,48,113,.425,50,59,.847,2,64,66,91,20,3,42,49,304,13.1
3383,Lexus Williams\lexus-williams-1,2017-18,Boise State,G,32,32,835,100,232,.431,52,113,.460,48,119,.403,56,64,.875,11,62,73,75,30,2,53,69,304,6.5
3384,Nate Kennell\nate-kennell-1,2017-18,Bradley,G,33,16,849,99,262,.378,30,82,.366,69,180,.383,37,48,.771,12,78,90,61,22,5,49,81,304,5.3
3385,J.J. Frazier\jj-frazier-1,2014-15,Georgia,G,32,16,943,84,212,.396,34,85,.400,50,127,.394,86,104,.827,23,100,123,104,37,5,48,72,304,8.3
3386,Akeem Springs\akeem-springs-1,2016-17,Minnesota,G,32,15,768,102,268,.381,35,93,.376,67,175,.383,32,47,.681,17,79,96,43,18,6,30,36,303,6.1
3387,Terrell Allen\terrell-allen-2,2015-16,Drexel,G,31,28,1007,94,234,.402,77,179,.430,17,55,.309,98,117,.838,16,74,90,100,49,3,58,88,303,7.4
3388,Martino Brock\martino-brock-1,2013-14,South Florida,G,32,13,762,119,240,.496,116,219,.530,3,21,.143,62,108,.574,46,51,97,45,42,5,42,33,303,7.3
3389,A.J. Jacobson\aj-jacobson-1,2017-18,North Dakota State,G,32,32,826,97,202,.480,42,79,.532,55,123,.447,54,60,.900,10,120,130,51,13,11,27,61,303,7.7
3390,Quentin Goodin\quentin-goodin-1,2017-18,Xavier,G,35,35,1039,106,238,.445,87,175,.497,19,63,.302,72,91,.791,9,94,103,171,32,7,80,73,303,7.2
3391,Lindy Waters\lindy-waters-1,2017-18,Oklahoma State,G,35,31,948,105,237,.443,55,103,.534,50,134,.373,43,56,.768,28,102,130,70,31,14,43,88,303,6.7
3392,Jose Alvarado\jose-alvarado-1,2017-18,Georgia Tech,G,25,25,874,99,221,.448,59,113,.522,40,108,.370,65,81,.802,15,78,93,77,43,2,59,60,303,9.2
3393,Tyler White\tyler-white-1,2013-14,Northern Kentucky,G,28,25,862,105,289,.363,56,146,.384,49,143,.343,44,59,.746,20,56,76,55,22,4,47,64,303,5.7
3394,Everett Clemons\everett-clemons-1,2016-17,Indiana State,G,31,30,1006,112,223,.502,107,206,.519,5,17,.294,74,102,.725,43,150,193,140,51,2,64,56,303,10.3
3395,Gary Ricks\gary-ricks-1,2014-15,Drake,G,28,27,838,106,251,.422,42,97,.433,64,154,.416,27,35,.771,6,80,86,57,22,2,28,52,303,7.5
3396,Dejon Jarreau\dejon-jarreau-1,2016-17,Massachusetts,G,31,24,755,107,242,.442,85,152,.559,22,90,.244,67,104,.644,12,100,112,140,30,23,101,71,303,6.9
3397,Austin Luke\austin-luke-1,2017-18,Belmont,G,33,32,1084,103,237,.435,31,63,.492,72,174,.414,25,31,.806,7,88,95,246,32,2,104,53,303,8.7
3398,Ethan Montalvo\ethan-montalvo-1,2015-16,Texas State,G,29,28,849,95,258,.368,35,86,.407,60,172,.349,53,65,.815,4,53,57,33,28,0,33,30,303,6.2
3399,Allerik Freeman\allerik-freeman-2,2016-17,Baylor,G,32,22,743,93,216,.431,48,102,.471,45,114,.395,72,87,.828,19,58,77,37,14,0,47,41,303,5.9
3400,De'Andre Hunter\deandre-hunter-1,2017-18,Virginia,G,33,0,657,104,213,.488,83,158,.525,21,55,.382,74,98,.755,38,79,117,36,19,13,31,60,303,7.1
3401,Kahron Ross\kahron-ross-1,2016-17,Lehigh,G,31,31,1025,102,224,.455,74,152,.487,28,72,.389,71,88,.807,15,80,95,164,37,7,75,57,303,8.8
3402,Denzel Valentine\denzel-valentine-1,2013-14,Michigan State,G,38,32,1116,108,265,.408,65,151,.430,43,114,.377,44,65,.677,47,181,228,144,37,12,69,98,303,7.3
3403,Balint Mocsan\balint-mocsan-1,2017-18,Idaho State,G,30,24,844,108,240,.450,46,92,.500,62,148,.419,25,39,.641,10,95,105,31,20,8,47,62,303,6.1
3404,Jimmie Taylor\jimmie-taylor-2,2015-16,Rider,G,33,30,981,101,257,.393,52,125,.416,49,132,.371,52,73,.712,26,118,144,32,23,4,41,83,303,5.5
3405,Jarren Greenwood\jarren-greenwood-1,2015-16,McNeese State,G,28,24,859,102,263,.388,60,140,.429,42,123,.341,57,84,.679,10,51,61,48,32,1,34,51,303,6.5
3406,Jaire Grayer\jaire-grayer-1,2015-16,George Mason,G,32,31,945,115,303,.380,72,158,.456,43,145,.297,30,54,.556,32,88,120,27,11,12,46,89,303,4.2
3407,Lester Medford\lester-medford-1,2015-16,Baylor,G,34,34,1103,97,247,.393,55,132,.417,42,115,.365,67,89,.753,11,66,77,222,54,3,78,87,303,8.4
3408,Justin Edmonds\justin-edmonds-1,2014-15,Marshall,G,31,24,713,98,253,.387,44,100,.440,54,153,.353,53,87,.609,19,63,82,41,24,3,56,50,303,5.2
3409,Brandon Barnes\brandon-barnes-1,2013-14,Cal State Bakersfield,G,32,20,835,115,256,.449,97,193,.503,18,63,.286,55,95,.579,41,96,137,43,29,6,57,87,303,5.7
3410,Desmond Lee\desmond-lee-1,2013-14,North Carolina State,G,36,19,872,91,233,.391,70,158,.443,21,75,.280,100,138,.725,24,81,105,57,26,1,61,65,303,5.1
3411,Nate Frye\nate-frye-1,2015-16,New Orleans,G,30,28,844,87,220,.395,66,163,.405,21,57,.368,108,146,.740,39,64,103,104,39,3,67,75,303,7.7
3412,Zach Lewis\zach-lewis-1,2013-14,Canisius,G,32,19,912,101,253,.399,38,91,.418,63,162,.389,38,51,.745,20,50,70,52,44,11,26,56,303,7.2
3413,Tavon Blackmon\tavon-blackmon-1,2014-15,Brown,G,29,28,939,97,252,.385,79,190,.416,18,62,.290,91,111,.820,17,45,62,114,18,2,94,69,303,5.5
3414,Trey Davis\trey-davis-1,2013-14,Massachusetts,G,33,0,769,94,238,.395,48,116,.414,46,122,.377,69,90,.767,11,74,85,83,31,0,38,64,303,6.7
3415,Nehemias Morillo\nehemias-morillo-1,2014-15,South Florida,G,30,23,838,117,278,.421,80,162,.494,37,116,.319,32,43,.744,31,99,130,38,20,7,64,69,303,5.4
3416,Robert Johnson\robert-johnson-5,2014-15,Indiana,G,34,33,917,111,259,.429,59,125,.472,52,134,.388,28,43,.651,14,85,99,79,29,1,71,65,302,5.4
3417,John Davis\john-davis-5,2016-17,Furman,G,34,34,985,104,250,.416,56,126,.444,48,124,.387,46,67,.687,12,100,112,96,40,0,46,57,302,7.0
3418,Cole Murray\cole-murray-1,2015-16,Northern Kentucky,G,30,29,827,108,220,.491,30,48,.625,78,172,.453,8,10,.800,9,98,107,23,9,7,30,69,302,6.6
3419,Joey Ptasinski\joey-ptasinksi-1,2014-15,Lafayette,G,32,28,967,104,218,.477,32,57,.561,72,161,.447,22,24,.917,9,78,87,58,39,4,26,57,302,7.9
3420,Mike Green\mike-green-5,2016-17,Northern Arizona,G,29,10,714,106,277,.383,52,127,.409,54,150,.360,36,48,.750,5,65,70,72,20,0,84,31,302,4.9
3421,Malachi Flynn\malachi-flynn-1,2016-17,Washington State,G,31,30,1027,104,263,.395,46,113,.407,58,150,.387,36,49,.735,8,83,91,91,21,1,65,59,302,5.9
3422,James Harvey\james-harvey-3,2017-18,McNeese State,G,29,28,889,100,251,.398,33,72,.458,67,179,.374,35,47,.745,12,46,58,43,14,4,49,37,302,5.8
3423,Quinton Everett\quinton-everett-1,2016-17,Montana State,G,31,12,718,107,271,.395,69,164,.421,38,107,.355,50,84,.595,33,88,121,37,32,8,43,87,302,5.7
3424,Dru Smith\dru-smith-1,2017-18,Evansville,G,22,22,665,100,173,.578,73,117,.624,27,56,.482,75,87,.862,10,67,77,101,45,10,70,60,302,12.4
3425,Gian Clavell\gian-clavell-1,2014-15,Colorado State,G,33,3,813,90,241,.373,46,95,.484,44,146,.301,78,116,.672,10,112,122,41,33,14,37,72,302,6.1
3426,Daxter Miles\daxter-miles-1,2015-16,West Virginia,G,32,30,797,106,248,.427,66,116,.569,40,132,.303,50,83,.602,24,44,68,43,46,2,43,85,302,5.9
3427,Kodi Justice\kodi-justice-1,2016-17,Arizona State,G,33,26,1025,99,235,.421,36,84,.429,63,151,.417,41,55,.745,13,81,94,80,44,19,53,106,302,6.8
3428,Jonah Radebaugh\jonah-radebaugh-1,2017-18,Northern Colorado,G,38,36,1350,99,211,.469,36,67,.537,63,144,.438,41,61,.672,44,183,227,50,39,12,33,88,302,7.5
3429,Rawle Alkins\rawle-alkins-1,2017-18,Arizona,G,23,21,723,99,229,.432,66,137,.482,33,92,.359,71,98,.724,43,67,110,58,29,17,59,50,302,9.7
3430,Anthony Thompson\anthony-thompson-2,2013-14,Holy Cross,G,32,21,885,72,181,.398,31,82,.378,41,99,.414,117,149,.785,10,60,70,80,30,1,36,82,302,7.3
3431,Isiah Jones\isiah-jones-1,2015-16,Southeast Missouri State,G,29,29,865,101,280,.361,46,110,.418,55,170,.324,45,65,.692,10,79,89,86,49,2,69,81,302,6.1
3432,Dylan Cox\dylan-cox-1,2014-15,Army,G,30,27,834,111,203,.547,106,173,.613,5,30,.167,75,113,.664,44,96,140,144,33,7,75,80,302,9.3
3433,Marvin Jordan\marvin-jordan-1,2013-14,Niagara,G,31,29,920,101,271,.373,42,88,.477,59,183,.322,41,53,.774,16,53,69,65,34,1,43,81,302,5.8
3434,Bryce Brown\bryce-brown-1,2015-16,Auburn,G,30,11,742,93,274,.339,15,63,.238,78,211,.370,38,46,.826,15,40,55,20,11,0,31,73,302,4.4
3435,Charles Callison\charles-callison-1,2016-17,Washington State,G,31,25,844,114,250,.456,72,151,.477,42,99,.424,32,38,.842,5,48,53,67,39,11,49,73,302,6.6
3436,Geron Johnson\geron-johnson-1,2013-14,Memphis,G,34,32,948,112,274,.409,88,181,.486,24,93,.258,54,89,.607,53,113,166,120,45,15,81,91,302,6.9
3437,Marcus Tyus\marcus-tyus-1,2013-14,Omaha,G,32,16,593,108,237,.456,73,141,.518,35,96,.365,51,64,.797,19,48,67,36,31,5,45,64,302,6.0
3438,Rashard Odomes\rashard-odomes-1,2016-17,Oklahoma,G,30,30,804,110,226,.487,109,217,.502,1,9,.111,81,130,.623,44,88,132,55,31,4,47,60,302,7.6
3439,Sterling Brown\sterling-brown-2,2015-16,Southern Methodist,G,30,29,816,109,181,.602,79,125,.632,30,56,.536,54,63,.857,39,93,132,79,33,13,67,90,302,8.8
3440,Jamail Jones\jamail-jones-1,2013-14,Florida Gulf Coast,G,35,32,1028,110,276,.399,87,188,.463,23,88,.261,59,96,.615,44,153,197,40,23,3,66,80,302,4.9
3441,Godwin Boahen\godwin-boahen-1,2017-18,Illinois-Chicago,G,34,11,790,101,235,.430,45,104,.433,56,131,.427,44,56,.786,12,86,98,72,36,5,56,89,302,6.0
3442,Nico Clareth\nico-clareth-1,2016-17,Siena,G,22,5,553,107,284,.377,54,118,.458,53,166,.319,35,50,.700,23,57,80,30,24,9,49,63,302,6.8
3443,Damon Collins\damon-collins-1,2015-16,Howard,G,30,29,994,106,283,.375,95,233,.408,11,50,.220,79,107,.738,26,110,136,62,34,5,74,60,302,5.6
3444,Francis Kiapway\francis-kiapway-1,2015-16,Ball State,G,35,32,942,96,222,.432,22,46,.478,74,176,.420,36,51,.706,2,45,47,52,20,3,45,53,302,5.3
3445,Eric Robertson\eric-robertson-1,2015-16,Chattanooga,G,35,34,965,98,243,.403,18,41,.439,80,202,.396,26,36,.722,11,38,49,58,29,13,32,68,302,5.9
3446,Braxton Bonds\braxton-bonds-1,2016-17,Houston Baptist,G,31,29,968,108,233,.464,101,211,.479,7,22,.318,79,119,.664,55,101,156,103,58,4,55,67,302,9.2
3447,Zavier Simpson\zavier-simpson-1,2017-18,Michigan,G,41,29,1085,115,246,.467,91,162,.562,24,84,.286,47,91,.516,18,115,133,150,53,2,60,55,301,6.9
3448,Terry Nolan Jr.\terry-nolanjr-1,2017-18,George Washington,G,33,31,971,96,236,.407,58,117,.496,38,119,.319,71,99,.717,24,82,106,82,52,12,66,93,301,6.6
3449,Josh Brown\josh-brown-3,2017-18,Temple,G,33,33,1094,111,266,.417,80,187,.428,31,79,.392,48,66,.727,23,104,127,111,28,11,56,71,301,6.9
3450,Avery Woodson\avery-woodson-1,2016-17,Butler,G,34,20,762,103,238,.433,28,60,.467,75,178,.421,20,26,.769,8,79,87,23,10,9,11,59,301,5.9
3451,Alex Caruso\alex-caruso-1,2014-15,Texas A&M,G,33,33,1038,106,229,.463,80,158,.506,26,71,.366,63,92,.685,24,126,150,182,69,2,100,67,301,9.0
3452,Terrell Lewis\terrell-lewis-1,2014-15,Eastern Illinois,G,33,33,1144,95,222,.428,40,116,.345,55,106,.519,56,65,.862,13,50,63,156,25,0,85,51,301,7.1
3453,Dante Thorpe\dante-thorpe-1,2017-18,Northern Illinois,G,28,27,782,124,234,.530,108,193,.560,16,41,.390,37,53,.698,30,61,91,49,24,8,52,62,301,7.4
3454,Drew Charles\drew-charles-1,2016-17,Texas-Arlington,G,36,36,831,100,242,.413,28,54,.519,72,188,.383,29,40,.725,25,61,86,47,23,1,25,80,301,5.6
3455,Reed Tellinghuisen\reed-tellinghuisen-1,2014-15,South Dakota State,G,35,23,823,102,225,.453,44,87,.506,58,138,.420,39,57,.684,25,92,117,34,20,19,41,81,301,5.9
3456,Broderick Newbill\broderick-newbill-1,2016-17,Missouri-Kansas City,G,34,21,740,112,220,.509,93,168,.554,19,52,.365,58,84,.690,35,70,105,20,26,13,50,78,301,5.7
3457,Johnathan Stove\johnathan-stove-1,2015-16,Louisiana,G,34,32,877,102,228,.447,87,186,.468,15,42,.357,82,110,.745,44,73,117,57,8,7,43,96,301,5.7
3458,Mustafaa Jones\mustafaa-jones-1,2013-14,Fairleigh Dickinson,G,31,31,955,97,259,.375,23,72,.319,74,187,.396,33,36,.917,7,79,86,38,38,3,36,67,301,6.1
3459,Alex Caruso\alex-caruso-1,2015-16,Texas A&M,G,37,37,1067,111,221,.502,83,145,.572,28,76,.368,51,65,.785,40,94,134,185,77,14,87,92,301,9.0
3460,Je'lon Hornbeak\jelon-hornbeak-1,2015-16,Monmouth,G,34,15,730,89,226,.394,39,102,.382,50,124,.403,73,93,.785,26,84,110,62,46,8,63,113,301,5.9
3461,Tracy Abrams\tracy-abrams-1,2016-17,Illinois,G,35,30,846,104,244,.426,53,117,.453,51,127,.402,42,59,.712,8,93,101,81,36,6,44,70,301,6.4
3462,Nick Faust\nick-faust-1,2013-14,Maryland,G,32,13,876,96,250,.384,55,114,.482,41,136,.301,68,93,.731,29,88,117,64,37,19,57,66,301,6.7
3463,James Robinson\james-robinson-2,2014-15,Pittsburgh,G,34,34,1152,94,256,.367,66,162,.407,28,94,.298,85,102,.833,16,106,122,174,36,8,56,81,301,8.0
3464,Iziahiah Sweeney\iziahiah-sweeney-1,2017-18,Northwestern State,G,27,21,683,116,289,.401,95,205,.463,21,84,.250,48,70,.686,33,64,97,37,26,9,59,70,301,5.5
3465,Tim Bond\tim-bond-1,2016-17,Eastern Michigan,G,33,25,985,113,267,.423,87,185,.470,26,82,.317,49,65,.754,31,91,122,132,69,25,62,84,301,8.6
3466,Reggie Jones\reggie-jones-2,2016-17,Western Michigan,G,32,14,737,111,247,.449,75,158,.475,36,89,.404,43,59,.729,12,99,111,73,37,10,58,62,301,6.8
3467,James Currington\james-currington-1,2013-14,Mississippi Valley State,G,29,23,701,115,212,.542,115,211,.545,0,1,.000,71,112,.634,75,121,196,7,43,21,50,95,301,8.5
3468,Louis Adams\louis-adams-1,2017-18,Wyoming,G,31,3,586,90,188,.479,67,134,.500,23,54,.426,98,139,.705,19,62,81,45,20,8,58,90,301,5.9
3469,Taariq Cephas\taariq-cephas-1,2013-14,Coppin State,G,32,27,868,91,236,.386,57,140,.407,34,96,.354,85,107,.794,19,78,97,131,34,1,89,55,301,6.7
3470,Prince Ali\prince-ali-1,2017-18,UCLA,G,33,22,757,103,234,.440,67,134,.500,36,100,.360,59,92,.641,24,78,102,46,25,6,46,58,301,6.0
3471,Marcus Tyus\marcus-tyus-1,2014-15,Omaha,G,23,23,641,104,213,.488,71,138,.514,33,75,.440,59,84,.702,27,59,86,47,23,2,44,68,300,8.9
3472,Jesus Cruz\jesus-cruz-1,2017-18,Fairfield,G,33,24,893,119,276,.431,92,180,.511,27,96,.281,35,63,.556,30,115,145,45,53,6,48,94,300,6.1
3473,Jordan Goodwin\jordan-goodwin-1,2017-18,Saint Louis,G,26,26,868,108,290,.372,89,209,.426,19,81,.235,65,94,.691,68,127,195,103,52,16,56,70,300,10.2
3474,Kevin Baker\kevin-baker-2,2016-17,Troy,G,37,33,895,90,268,.336,18,51,.353,72,217,.332,48,68,.706,11,82,93,112,42,0,62,73,300,5.5
3475,Tanner Samson\tanner-samson-1,2013-14,Elon,G,32,22,841,86,199,.432,7,17,.412,79,182,.434,49,58,.845,15,100,115,51,28,7,21,67,300,7.9
3476,Jalen Pendleton\jalen-pendleton-1,2013-14,Southern Illinois,G,33,5,685,108,236,.458,104,215,.484,4,21,.190,80,147,.544,46,69,115,40,25,2,44,73,300,5.6
3477,Bosko Kostur\bosco-kostur-1,2017-18,Bryant,G,29,15,729,102,212,.481,54,106,.509,48,106,.453,48,58,.828,29,81,110,21,17,5,49,94,300,6.3
3478,Darius Graham\darius-graham-1,2015-16,UC-Davis,G,30,30,1000,96,241,.398,48,113,.425,48,128,.375,60,85,.706,11,57,68,82,24,3,88,56,300,5.3
3479,Trey Phills\trey-phills-1,2017-18,Yale,G,31,25,825,104,200,.520,84,133,.632,20,67,.299,72,101,.713,44,89,133,58,33,22,46,57,300,8.6
3480,LaVone Holland\lavone-holland-1,2015-16,Northern Kentucky,G,28,24,810,109,274,.398,77,188,.410,32,86,.372,50,85,.588,13,118,131,113,29,1,85,57,300,6.5
3481,Joey McLean\joey-mclean-1,2016-17,James Madison,G,32,30,976,101,245,.412,50,111,.450,51,134,.381,47,62,.758,12,65,77,84,39,4,60,92,300,6.1
3482,Devin Cherry\devin-cherry-1,2014-15,Cornell,G,30,30,1001,96,257,.374,67,158,.424,29,99,.293,79,109,.725,10,110,120,103,25,1,98,56,300,5.5
3483,De'Anthony Melton\deanthony-melton-1,2016-17,Southern California,G,36,25,972,101,231,.437,80,157,.510,21,74,.284,77,109,.706,50,120,170,125,69,37,64,81,300,9.0
3484,Trae Berhow\trae-berhow-1,2017-18,Pepperdine,G,30,28,916,107,235,.455,59,115,.513,48,120,.400,38,51,.745,44,126,170,26,17,3,34,78,300,7.1
3485,Tavarius Shine\tavarius-shine-1,2017-18,Oklahoma State,G,31,18,798,100,247,.405,59,120,.492,41,127,.323,59,77,.766,39,68,107,52,30,22,34,70,300,7.3
3486,Chuck Champion\chuck-champion-1,2017-18,Loyola (MD),G,26,17,798,118,298,.396,92,217,.424,26,81,.321,38,54,.704,19,54,73,42,25,1,50,46,300,5.7
3487,Manu Lecomte\manu-lecomte-1,2014-15,Miami (FL),G,38,23,853,92,214,.430,40,100,.400,52,114,.456,64,73,.877,11,41,52,67,18,0,43,56,300,5.3
3488,Alex Robinson\alex-robinson-2,2017-18,Texas Christian,G,31,21,992,112,254,.441,89,184,.484,23,70,.329,53,92,.576,13,79,92,190,36,8,101,70,300,7.4
3489,Jarred Dixon\jarred-dixon-1,2017-18,Missouri State,G,33,18,951,113,266,.425,81,185,.438,32,81,.395,42,56,.750,22,69,91,72,23,11,44,62,300,6.1
3490,A.J. Merriweather\aj-merriweather-1,2016-17,East Tennessee State,G,35,34,826,102,199,.513,74,139,.532,28,60,.467,68,90,.756,36,90,126,53,56,2,65,86,300,6.9
3491,Kyle Leufroy\kyle-leufroy-1,2017-18,Lehigh,G,30,18,778,96,264,.364,60,149,.403,36,115,.313,72,85,.847,8,138,146,76,28,3,67,54,300,6.3
3492,Zach Thomas\zach-thomas-1,2015-16,Bucknell,G,29,12,606,102,219,.466,70,133,.526,32,86,.372,64,92,.696,32,133,165,42,20,13,47,66,300,7.7
3493,Jaylon Hall\jaylon-hall-1,2017-18,Wright State,G,33,2,764,100,260,.385,67,157,.427,33,103,.320,67,101,.663,17,67,84,47,18,2,58,55,300,4.5
3494,Georgie Pacheco-Ortiz\georgie-pacheco-ortiz-1,2016-17,Liberty,G,35,32,1086,95,228,.417,55,128,.430,40,100,.400,70,86,.814,13,97,110,90,27,1,39,45,300,7.0
3495,DaQuan Bracey\daquan-bracey-1,2016-17,Louisiana Tech,G,33,27,924,113,259,.436,90,189,.476,23,70,.329,51,78,.654,22,67,89,193,32,1,55,70,300,8.3
3496,Kevin Vannatta\kevin-vannatta-1,2016-17,North Carolina-Asheville,G,33,32,1061,106,242,.438,74,139,.532,32,103,.311,56,80,.700,16,134,150,110,42,3,57,77,300,7.5
3497,Kam Williams\kam-williams-1,2016-17,Ohio State,G,32,29,981,108,276,.391,58,143,.406,50,133,.376,34,37,.919,9,58,67,31,24,4,34,48,300,5.2
3498,Maverick Rowan\maverick-rowan-1,2016-17,North Carolina State,G,25,17,748,106,247,.429,53,100,.530,53,147,.361,34,40,.850,21,71,92,22,16,4,30,44,299,7.5
3499,Nate Frye\nate-frye-1,2014-15,New Orleans,G,29,28,780,91,227,.401,69,171,.404,22,56,.393,95,113,.841,23,48,71,76,44,6,74,76,299,6.8
3500,Grant Lozoya\grant-lozoya-1,2014-15,Stetson,G,31,20,720,105,250,.420,52,104,.500,53,146,.363,36,52,.692,6,96,102,34,19,0,41,81,299,5.2
3501,Skyler Halford\skyler-halford-1,2014-15,Brigham Young,G,34,4,624,94,194,.485,42,86,.488,52,108,.481,59,67,.881,10,51,61,78,24,0,51,65,299,6.5
3502,John Dawson\john-dawson-1,2016-17,Liberty,G,35,34,1003,99,256,.387,49,111,.441,50,145,.345,51,69,.739,11,138,149,93,36,11,69,105,299,5.7
3503,Eddy Polanco\eddy-polanco-1,2016-17,Southeastern Louisiana,G,32,6,619,92,230,.400,48,112,.429,44,118,.373,71,93,.763,31,90,121,47,14,3,53,49,299,6.0
3504,Donnell Gresham Jr.\donnell-greshamjr-1,2017-18,Northeastern,G,33,26,915,91,223,.408,25,70,.357,66,153,.431,51,65,.785,14,133,147,63,25,5,28,47,299,7.6
3505,Trae Bell-Haynes\trae-bell-haynes-1,2014-15,Vermont,G,34,29,895,84,167,.503,71,143,.497,13,24,.542,118,149,.792,17,73,90,118,31,4,105,71,299,6.5
3506,Addison Spruill\addison-spruill-1,2013-14,North Carolina-Wilmington,G,32,19,702,110,308,.357,93,227,.410,17,81,.210,62,92,.674,33,80,113,32,17,7,38,63,299,4.5
3507,Jabril Trawick\jabril-trawick-1,2014-15,Georgetown,G,33,33,921,98,199,.492,65,118,.551,33,81,.407,70,103,.680,25,94,119,78,32,13,61,94,299,6.9
3508,Shannon Scott\shannon-scott-1,2014-15,Ohio State,G,35,34,1068,115,279,.412,92,198,.465,23,81,.284,46,62,.742,36,90,126,207,59,4,83,55,299,8.5
3509,James Towns\james-towns-1,2017-18,Niagara,G,33,0,596,93,195,.477,69,129,.535,24,66,.364,89,113,.788,9,46,55,68,19,0,53,33,299,6.4
3510,Xavier Johnson\xavier-johnson-1,2014-15,Colorado,G,29,15,706,105,236,.445,76,157,.484,29,79,.367,60,93,.645,46,116,162,19,17,9,52,62,299,6.5
3511,Aaren Edmead\aaren-edmead-1,2017-18,North Carolina A&T,G,31,16,779,92,249,.369,54,132,.409,38,117,.325,77,93,.828,11,50,61,91,22,0,64,64,299,5.6
3512,Corban Wroe\corban-wroe-1,2014-15,Hartford,G,30,29,1036,108,234,.462,59,97,.608,49,137,.358,33,44,.750,21,101,122,73,41,3,57,89,298,7.3
3513,Triston Simpson\triston-simpson-1,2017-18,South Dakota,G,35,35,1070,108,242,.446,78,153,.510,30,89,.337,52,79,.658,15,60,75,109,28,1,61,64,298,5.9
3514,Dre' Winston\dre-winston--1,2013-14,Portland State,G,31,29,855,96,181,.530,88,141,.624,8,40,.200,98,127,.772,24,79,103,70,32,4,48,60,298,8.1
3515,Cedric Hankerson\cedric-hankerson-1,2016-17,Boston University,G,31,28,896,93,261,.356,21,46,.457,72,215,.335,40,69,.580,15,56,71,34,61,3,26,87,298,6.3
3516,Jahmel Taylor\jahmel-taylor-1,2017-18,Fresno State,G,32,9,884,97,232,.418,25,63,.397,72,169,.426,32,44,.727,14,98,112,76,26,4,31,69,298,7.3
3517,Darrell Bowie\darrell-bowie-1,2013-14,Northern Illinois,G,31,29,858,95,250,.380,92,240,.383,3,10,.300,105,191,.550,64,138,202,34,32,18,90,68,298,5.3
3518,Jared Savage\jared-savag-1,2016-17,Austin Peay,G,29,26,919,104,252,.413,47,93,.505,57,159,.358,33,39,.846,34,93,127,35,36,12,36,70,298,7.5
3519,David Cohn\david-cohn-1,2015-16,William & Mary,G,31,31,923,92,213,.432,64,138,.464,28,75,.373,86,103,.835,18,80,98,144,26,3,50,42,298,9.0
3520,Hasan Abdullah\hasan-abdullah-1,2017-18,Navy,G,30,28,874,106,264,.402,57,126,.452,49,138,.355,37,59,.627,8,83,91,101,65,1,88,82,298,6.4
3521,Christian Kessee\christian-kessee-1,2014-15,Coppin State,G,31,26,723,97,241,.402,46,113,.407,51,128,.398,53,68,.779,15,47,62,50,19,2,58,80,298,4.9
3522,Richaud Gittens\richaud-gittens-1,2014-15,Weber State,G,30,29,989,93,229,.406,54,137,.394,39,92,.424,73,94,.777,11,79,90,85,32,3,57,68,298,6.9
3523,Johnnie Shuler\johnnie-shuler-1,2015-16,La Salle,G,31,30,1104,93,279,.333,30,88,.341,63,191,.330,49,62,.790,19,97,116,92,40,0,68,75,298,5.9
3524,Julien Lewis\julien-lewis-1,2015-16,Fresno State,G,34,10,789,113,264,.428,84,196,.429,29,68,.426,42,59,.712,14,74,88,56,42,5,40,89,297,5.6
3525,Vince Martin\vince-martin-1,2013-14,Jacksonville,G,30,30,976,88,229,.384,48,121,.397,40,108,.370,81,107,.757,24,93,117,141,55,6,54,49,297,9.7
3526,Jerrick Harding\jerrick-harding-1,2016-17,Weber State,G,32,7,562,94,189,.497,64,115,.557,30,74,.405,79,92,.859,11,48,59,25,19,6,28,42,297,6.7
3527,Juwan Parker\juwan-parker-1,2016-17,Georgia,G,32,31,857,106,277,.383,98,226,.434,8,51,.157,77,90,.856,35,136,171,56,19,2,54,70,297,5.7
3528,Dylan Cox\dylan-cox-1,2013-14,Army,G,31,30,712,112,200,.560,98,167,.587,14,33,.424,59,104,.567,52,79,131,88,17,13,56,61,297,8.1
3529,JeQuan Lewis\jequan-lewis-1,2014-15,Virginia Commonwealth,G,35,16,761,91,245,.371,53,139,.381,38,106,.358,77,96,.802,11,47,58,95,49,0,77,88,297,5.1
3530,Hakeem Rogers\hakeem-rogers-1,2015-16,Tennessee Tech,G,30,1,548,92,225,.409,33,78,.423,59,147,.401,54,64,.844,6,57,63,30,22,3,42,53,297,5.9
3531,Malik Thomas\malik-thomas-1,2014-15,Norfolk State,G,32,22,851,107,255,.420,68,135,.504,39,120,.325,44,69,.638,39,102,141,61,16,29,34,90,297,6.8
3532,Joseph Bertrand\joseph-bertrand-1,2013-14,Illinois,G,35,23,877,113,235,.481,93,183,.508,20,52,.385,51,75,.680,50,84,134,27,23,0,61,64,297,5.2
3533,Bosko Kostur\bosco-kostur-1,2016-17,Bryant,G,31,17,646,91,193,.472,58,114,.509,33,79,.418,82,99,.828,31,85,116,33,16,5,35,94,297,6.7
3534,Chris Crawford\chris-crawford-3,2013-14,Memphis,G,34,31,1012,101,274,.369,25,70,.357,76,204,.373,19,29,.655,13,122,135,101,51,10,53,69,297,6.9
3535,Jovaughn Love\jovaughn-love-1,2015-16,Arkansas-Pine Bluff,G,33,31,900,105,307,.342,80,212,.377,25,95,.263,62,95,.653,28,114,142,35,20,13,52,67,297,4.2
3536,Namon Wright\namon-wright-1,2015-16,Missouri,G,31,25,820,86,242,.355,47,118,.398,39,124,.315,86,113,.761,22,138,160,40,14,7,57,62,297,5.6
3537,Ron Patterson\ron-patterson-1,2016-17,IUPUI,G,32,10,757,107,242,.442,45,86,.523,62,156,.397,21,30,.700,15,64,79,64,44,13,40,70,297,7.1
3538,Miles Dixon\miles-dixon-2,2013-14,Wright State,G,35,24,849,93,237,.392,78,176,.443,15,61,.246,96,119,.807,19,63,82,72,16,8,48,43,297,5.7
3539,Trey Kennedy\trey-kennedy-1,2015-16,Southern Utah,G,26,20,709,102,257,.397,70,160,.438,32,97,.330,61,80,.763,10,60,70,65,25,9,51,54,297,6.9
3540,Jordan Washington\jordan-washington-2,2014-15,Mississippi Valley State,G,23,16,634,98,249,.394,60,147,.408,38,102,.373,63,84,.750,20,34,54,47,30,0,58,44,297,7.2
3541,James Milliken\james-milliken-1,2014-15,Creighton,G,31,12,811,95,234,.406,50,117,.427,45,117,.385,62,79,.785,9,73,82,56,13,0,30,51,297,6.3
3542,Jaylin Airington\jaylin-airington-1,2015-16,Cal State Bakersfield,G,29,25,827,96,223,.430,75,157,.478,21,66,.318,84,109,.771,35,85,120,62,27,12,47,87,297,7.5
3543,Nate Engesser\nate-engesser-1,2014-15,Denver,G,29,21,795,108,209,.517,56,89,.629,52,120,.433,29,35,.829,8,60,68,69,21,4,35,51,297,8.0
3544,Chris Golden\chris-golden-1,2014-15,Weber State,G,30,26,797,95,262,.363,32,80,.400,63,182,.346,44,58,.759,7,52,59,38,28,3,42,66,297,5.2
3545,Estan Tyler\estan-tyler-2,2014-15,North Dakota,G,27,22,812,91,223,.408,53,119,.445,38,104,.365,77,94,.819,10,57,67,61,28,3,63,63,297,6.6
3546,Leyton Hammonds\leyton-hammonds-1,2015-16,Oklahoma State,G,28,24,798,108,253,.427,69,139,.496,39,114,.342,41,52,.788,40,103,143,24,19,8,41,91,296,6.5
3547,Isaac Fleming\isaac-fleming-1,2014-15,Hawaii,G,31,2,715,115,244,.471,90,147,.612,25,97,.258,41,64,.641,31,65,96,66,33,4,64,70,296,6.2
3548,Robert Turner\robert-turner-2,2013-14,Texas Tech,G,32,32,905,106,262,.405,84,187,.449,22,75,.293,62,100,.620,27,56,83,84,42,8,56,62,296,6.3
3549,Ernie Duncan\ernie-duncan-1,2016-17,Vermont,G,34,33,954,96,242,.397,21,54,.389,75,188,.399,29,35,.829,11,69,80,74,22,3,27,30,296,6.7
3550,Jordan Mathews\jordan-mathews-1,2013-14,University of California,G,35,12,671,95,240,.396,53,130,.408,42,110,.382,64,84,.762,22,52,74,25,12,2,18,50,296,5.2
3551,Omega Harris\omega-harris-1,2015-16,Texas-El Paso,G,24,19,746,102,215,.474,54,106,.509,48,109,.440,44,59,.746,13,47,60,55,28,0,44,63,296,8.4
3552,Geno Thorpe\geno-thorpe-1,2014-15,Penn State,G,34,16,826,91,229,.397,71,164,.433,20,65,.308,94,112,.839,26,62,88,43,38,4,53,103,296,5.2
3553,Cameron Johnson\cameron-johnson-3,2017-18,College of Charleston,G,34,34,1114,107,233,.459,62,117,.530,45,116,.388,37,61,.607,26,89,115,60,27,12,44,77,296,6.3
3554,Josh Robinson\josh-robinson-3,2014-15,Austin Peay,G,30,6,645,95,261,.364,51,142,.359,44,119,.370,62,81,.765,15,36,51,21,21,1,35,24,296,5.2
3555,Jonathan Williams\jonathan-williams-3,2017-18,Virginia Commonwealth,G,32,32,935,90,226,.398,72,169,.426,18,57,.316,98,125,.784,9,71,80,182,43,4,69,41,296,8.7
3556,Kendall Stephens\kendall-stephens-1,2014-15,Purdue,G,34,16,760,93,265,.351,20,75,.267,73,190,.384,37,50,.740,13,64,77,56,14,11,41,54,296,5.0
3557,Jalan McCloud\jalan-mccloud-1,2016-17,Texas Southern,G,35,17,742,93,222,.419,66,131,.504,27,91,.297,83,98,.847,22,65,87,40,32,9,28,52,296,6.4
3558,Troy Thompson\troy-thompson-2,2016-17,Prairie View,G,28,17,595,96,213,.451,36,70,.514,60,143,.420,44,60,.733,21,35,56,19,18,8,40,48,296,6.5
3559,Que Johnson\que-johnson-1,2013-14,Washington State,G,31,14,737,103,262,.393,52,117,.444,51,145,.352,39,55,.709,17,57,74,20,14,2,30,55,296,5.0
3560,A.J. Riley\aj-riley-1,2015-16,Eastern Illinois,G,30,11,629,93,224,.415,73,160,.456,20,64,.313,90,128,.703,39,62,101,60,23,4,64,68,296,6.1
3561,Siyani Chambers\siyani-chambers-1,2014-15,Harvard,G,30,28,1036,93,260,.358,53,143,.371,40,117,.342,70,86,.814,10,58,68,129,45,1,70,57,296,7.1
3562,Reggie Dillard\reggie-dillard-1,2016-17,Presbyterian,G,30,30,920,105,247,.425,76,156,.487,29,91,.319,56,75,.747,15,68,83,106,18,4,83,65,295,5.8
3563,Wayne Blackshear\wayne-blackshear-1,2013-14,Louisville,G,36,18,707,93,215,.433,48,101,.475,45,114,.395,64,86,.744,20,91,111,26,32,19,21,84,295,6.2
3564,Sterling Taplin\sterling-taplin-1,2016-17,Tulsa,G,32,28,935,92,233,.395,63,161,.391,29,72,.403,82,97,.845,13,88,101,122,35,2,84,90,295,6.3
3565,Anthony Clemmons\anthony-clemmons-1,2015-16,Iowa,G,33,33,976,108,248,.435,81,161,.503,27,87,.310,52,86,.605,14,73,87,121,32,6,50,71,295,6.8
3566,Paul Baxter\paul-baxter-1,2014-15,Sam Houston State,G,35,34,951,98,247,.397,65,153,.425,33,94,.351,66,97,.680,15,78,93,92,32,5,71,101,295,4.9
3567,Marlon Beck\marlon-beck-1,2015-16,Binghamton,G,30,27,984,92,263,.350,19,59,.322,73,204,.358,38,56,.679,9,72,81,62,34,1,44,66,295,5.9
3568,Marcellus Barksdale\marcellus-barksdale-1,2014-15,IUPUI,G,31,31,991,99,253,.391,86,202,.426,13,51,.255,84,115,.730,28,117,145,74,52,7,68,71,295,6.8
3569,Tim Derksen\tim-derksen-1,2013-14,San Francisco,G,33,10,760,103,194,.531,78,123,.634,25,71,.352,64,97,.660,15,91,106,44,22,5,41,59,295,6.6
3570,Mike Scott\mike-scott-7,2013-14,Idaho,G,34,16,762,117,272,.430,92,188,.489,25,84,.298,36,51,.706,17,65,82,75,26,3,39,45,295,5.9
3571,Brandon Gfeller\brandon-gfeller-1,2014-15,Montana,G,33,25,834,92,216,.426,9,19,.474,83,197,.421,28,36,.778,18,74,92,36,30,6,26,80,295,6.5
3572,Bryce Alford\bryce-alford-1,2013-14,UCLA,G,37,1,855,83,216,.384,36,94,.383,47,122,.385,82,102,.804,4,61,65,102,30,4,48,45,295,6.2
3573,Jalen Harris\jalen-harris-2,2016-17,Louisiana Tech,G,27,2,618,106,237,.447,76,143,.531,30,94,.319,53,60,.883,20,63,83,42,22,7,42,40,295,7.4
3574,Austin Butler\austin-butler-1,2017-18,Holy Cross,G,30,21,739,106,251,.422,67,132,.508,39,119,.328,44,63,.698,29,81,110,34,23,4,27,69,295,6.5
3575,Wes Cole\wes-cole-1,2013-14,Hartford,G,33,14,797,99,225,.440,21,43,.488,78,182,.429,19,22,.864,11,36,47,25,19,1,28,33,295,5.8
3576,Charlie Lee\charles-lee-2,2013-14,Cleveland State,G,30,27,955,84,213,.394,42,116,.362,42,97,.433,85,94,.904,10,62,72,123,44,0,56,77,295,8.2
3577,T.J. Carpenter\tj-carpenter-1,2014-15,Nicholls State,G,27,27,748,99,256,.387,68,141,.482,31,115,.270,66,97,.680,30,85,115,58,20,3,73,71,295,5.6
3578,Diandre Wilson\diandre-wilson-1,2017-18,NJIT,G,29,28,732,101,243,.416,60,139,.432,41,104,.394,52,76,.684,10,55,65,39,33,12,53,61,295,5.9
3579,Kyle Toth\kyle-toth-1,2016-17,Cal Poly,G,31,24,824,106,246,.431,37,89,.416,69,157,.439,14,19,.737,14,69,83,25,15,2,12,35,295,6.5
3580,Eric Laster\eric-laster-1,2015-16,Loyola (MD),G,30,18,838,107,281,.381,72,159,.453,35,122,.287,46,70,.657,50,78,128,36,14,12,39,84,295,5.5
3581,Markel Crawford\markel-crawford-1,2017-18,Mississippi,G,32,25,989,97,248,.391,67,141,.475,30,107,.280,71,93,.763,18,110,128,68,38,7,36,63,295,7.1
3582,Isaiah Ivey\isaiah-ivey-1,2015-16,Gardner-Webb,G,33,23,783,95,236,.403,51,129,.395,44,107,.411,61,71,.859,39,92,131,36,20,9,34,53,295,6.5
3583,Xavier McDaniel Jr.\xavier-mcdanieljr-1,2017-18,Texas-Rio Grande Valley,G,32,27,628,102,266,.383,76,175,.434,26,91,.286,65,87,.747,42,96,138,28,19,26,46,88,295,5.5
3584,Gabe Vincent\gabe-vincent-1,2016-17,UC-Santa Barbara,G,20,18,639,98,276,.355,47,121,.388,51,155,.329,48,63,.762,18,56,74,47,16,2,31,56,295,8.1
3585,Cameron Hunter\cameron-hunter-1,2017-18,North Dakota State,G,32,21,883,89,202,.441,48,104,.462,41,98,.418,76,99,.768,3,94,97,76,28,0,65,75,295,6.1
3586,James Richardson\james-richardson-1,2017-18,South Carolina State,G,29,14,690,111,289,.384,74,180,.411,37,109,.339,36,54,.667,20,35,55,30,34,14,37,38,295,5.8
3587,Joshua Filmore\joshua-filmore-1,2015-16,Southeastern Louisiana,G,33,30,992,103,265,.389,35,80,.438,68,185,.368,20,36,.556,8,70,78,84,22,1,34,46,294,6.0
3588,Darius Perkins\darius-perkins-1,2014-15,Utah State,G,31,31,911,98,243,.403,36,97,.371,62,146,.425,36,56,.643,9,66,75,101,18,1,65,48,294,6.0
3589,Braxton Beverly\braxton-beverly-1,2017-18,North Carolina State,G,31,26,1003,97,248,.391,37,92,.402,60,156,.385,40,49,.816,18,57,75,121,30,0,37,83,294,7.4
3590,Damarcus Croaker\damarcus-croaker-1,2016-17,Murray State,G,28,25,836,114,254,.449,97,192,.505,17,62,.274,49,69,.710,45,85,130,40,28,6,44,47,294,7.4
3591,Mike Liabo\mike-liabo-1,2013-14,Tennessee-Martin,G,24,6,555,104,271,.384,52,123,.423,52,148,.351,34,42,.810,7,49,56,50,10,3,43,26,294,6.5
3592,Ronnel Jordan\ronnel-jordan-1,2015-16,New Hampshire,G,33,29,855,114,271,.421,76,153,.497,38,118,.322,28,52,.538,26,96,122,41,14,8,40,54,294,5.3
3593,Josh Fortune\josh-fortune-1,2013-14,Providence,G,35,35,1154,101,244,.414,45,84,.536,56,160,.350,36,47,.766,15,91,106,72,33,9,66,81,294,5.4
3594,Paris Collins\paris-collins-1,2016-17,Jackson State,G,24,20,772,107,300,.357,65,155,.419,42,145,.290,38,72,.528,40,86,126,68,48,13,46,60,294,8.4
3595,Jay Wright\jay-wright-2,2015-16,Louisiana,G,33,32,939,99,263,.376,64,160,.400,35,103,.340,61,100,.610,18,75,93,116,36,8,75,71,294,5.7
3596,Trey Kell\trey-kell-1,2017-18,San Diego State,G,28,27,797,98,255,.384,72,165,.436,26,90,.289,72,97,.742,17,99,116,114,31,6,44,36,294,8.7
3597,K.J. Maura\kj-maura-1,2016-17,Maryland-Baltimore County,G,33,32,1072,94,218,.431,54,118,.458,40,100,.400,66,74,.892,21,72,93,141,60,1,58,63,294,8.7
3598,Devonte Hall\devonte-hall-1,2015-16,Northwestern State,G,27,25,786,100,242,.413,83,191,.435,17,51,.333,77,109,.706,16,76,92,171,44,2,80,74,294,8.9
3599,Terance Mann\terance-mann-1,2016-17,Florida State,G,35,34,876,114,198,.576,107,175,.611,7,23,.304,59,89,.663,65,94,159,58,35,6,42,82,294,7.6
3600,Josh Sharkey\josh-sharkey-1,2016-17,Samford,G,36,2,811,83,201,.413,73,155,.471,10,46,.217,118,164,.720,15,54,69,150,72,2,96,97,294,6.6
3601,DJ Cole\dj-cole-1,2014-15,Youngstown State,G,32,31,1037,98,229,.428,68,144,.472,30,85,.353,68,102,.667,10,72,82,150,51,1,87,69,294,7.2
3602,Patrick Holloway\patrick-holloway-1,2014-15,George Mason,G,27,8,712,108,277,.390,68,156,.436,40,121,.331,38,46,.826,4,29,33,20,18,0,50,54,294,4.1
3603,Ray Ona Embo\rayona-embo-1,2017-18,Tulane,G,29,28,960,101,234,.432,55,108,.509,46,126,.365,46,64,.719,14,79,93,95,23,5,47,73,294,7.4
3604,Derrick Walton\derrick-walton-1,2013-14,Michigan,G,37,36,989,91,212,.429,48,107,.449,43,105,.410,69,87,.793,14,98,112,106,21,1,56,63,294,6.2
3605,Khalil Davis\khalil-davis-1,2014-15,Austin Peay,G,30,30,905,86,245,.351,62,164,.378,24,81,.296,98,156,.628,61,86,147,77,27,8,68,74,294,6.4
3606,Jalen Hudson\jalen-hudson-1,2015-16,Virginia Tech,G,35,24,700,99,247,.401,71,166,.428,28,81,.346,67,100,.670,20,59,79,21,21,5,49,67,293,4.0
3607,D.J. Davis\dj-davis-1,2015-16,South Dakota,G,32,31,944,114,207,.551,96,159,.604,18,48,.375,47,61,.770,26,88,114,83,41,10,66,86,293,7.5
3608,Joseph Edwards\joseph-edwards-1,2013-14,Purdue-Fort Wayne,G,36,23,914,107,213,.502,86,152,.566,21,61,.344,58,96,.604,32,63,95,81,19,11,62,46,293,6.0
3609,Morgan Means\morgan-means-1,2017-18,Seattle,G,34,9,939,103,260,.396,74,157,.471,29,103,.282,58,73,.795,22,101,123,95,28,3,80,81,293,5.2
3610,Joseph Chartouny\joseph-chartouny-1,2015-16,Fordham,G,26,26,852,84,227,.370,50,119,.420,34,108,.315,91,119,.765,14,125,139,161,56,4,75,60,293,10.6
3611,Mathieu Kamba\mathieu-kamba-1,2015-16,Central Arkansas,G,28,17,717,118,202,.584,116,194,.598,2,8,.250,55,105,.524,61,90,151,36,16,20,63,68,293,7.6
3612,Javonte Maynor\javonte-maynor-1,2014-15,Cal State Bakersfield,G,33,23,968,92,259,.355,22,59,.373,70,200,.350,39,57,.684,9,34,43,33,28,2,36,78,293,4.3
3613,Kemy Osse\kemy-osse-1,2016-17,Little Rock,G,32,23,818,97,233,.416,40,76,.526,57,157,.363,42,51,.824,20,85,105,31,19,6,29,65,293,6.1
3614,Justin Ravenel\justin-ravenal-1,2016-17,Florida A&M,G,30,20,815,100,221,.452,45,84,.536,55,137,.401,38,44,.864,13,58,71,45,21,2,23,40,293,7.2
3615,Justin Ravenel\justin-ravenel-1,2017-18,Florida A&M,G,34,17,875,99,240,.413,36,80,.450,63,160,.394,32,40,.800,11,61,72,33,20,2,14,59,293,5.7
3616,Ray Salnave\ray-salnave-1,2017-18,Monmouth,G,30,16,659,82,200,.410,62,138,.449,20,62,.323,109,145,.752,17,88,105,49,39,4,71,87,293,6.0
3617,Luke Nelson\luke-nelson-1,2014-15,UC-Irvine,G,28,25,820,97,272,.357,50,117,.427,47,155,.303,52,72,.722,10,72,82,111,29,3,73,55,293,6.3
3618,Thomas Funk\thomas-funk-1,2016-17,Army,G,32,32,951,101,285,.354,72,188,.383,29,97,.299,61,95,.642,15,81,96,155,24,2,88,67,292,5.4
3619,Nate Duhon\nate-duhon-1,2013-14,Chicago State,G,31,10,762,108,247,.437,97,205,.473,11,42,.262,65,91,.714,24,76,100,39,40,2,54,86,292,5.5
3620,Leroy Buchanan\leroy-buchanan-1,2017-18,Murray State,G,32,30,878,117,231,.506,97,166,.584,20,65,.308,38,54,.704,33,92,125,35,50,12,42,67,292,7.4
3621,Trevor Lyons\trevor-lyons-1,2017-18,Air Force,G,31,30,1012,95,242,.393,62,153,.405,33,89,.371,69,94,.734,18,128,146,102,43,2,64,67,292,7.3
3622,J.J. Thompson\jj-thompson-1,2015-16,Texas-Rio Grande Valley,G,28,28,899,97,248,.391,68,159,.428,29,89,.326,69,106,.651,15,55,70,137,27,2,68,64,292,7.1
3623,Anthony Mosley\anthony-mosley-1,2015-16,Delaware,G,30,26,940,90,196,.459,76,167,.455,14,29,.483,98,140,.700,14,119,133,67,21,5,63,87,292,6.4
3624,Franklin Porter\franklin-porter-1,2017-18,Portland,G,32,19,825,107,248,.431,77,171,.450,30,77,.390,48,64,.750,12,93,105,60,15,9,58,73,292,5.2
3625,Glynn Watson Jr.\glynn-watsonjr-1,2015-16,Nebraska,G,34,16,826,115,296,.389,95,221,.430,20,75,.267,42,53,.792,8,55,63,83,40,3,35,73,292,5.4
3626,Tilman Dunbar\tilman-dunbar-1,2014-15,Navy,G,32,30,953,106,247,.429,102,232,.440,4,15,.267,76,117,.650,10,54,64,105,34,0,66,77,292,5.6
3627,Ash Yacoubou\achraf-yacoubou-1,2014-15,Saint Louis,G,32,31,833,105,267,.393,90,202,.446,15,65,.231,67,107,.626,44,109,153,44,28,6,65,79,292,5.0
3628,Jordan Woodard\jordan-woodard-1,2016-17,Oklahoma,G,20,19,588,94,244,.385,56,139,.403,38,105,.362,66,77,.857,14,77,91,61,38,2,50,41,292,10.2
3629,Tywhon Pickford\tywhon-pickford-1,2017-18,Northern Iowa,G,32,32,951,102,274,.372,72,151,.477,30,123,.244,58,75,.773,60,188,248,40,20,11,35,34,292,7.5
3630,Jarron Cumberland\jarron-cumberland-1,2016-17,Cincinnati,G,35,0,669,99,201,.493,61,94,.649,38,107,.355,56,86,.651,36,48,84,49,34,10,35,62,292,6.7
3631,Isaiah Miller\isaiah-miller-1,2017-18,North Carolina-Greensboro,G,35,0,570,129,237,.544,128,228,.561,1,9,.111,33,53,.623,48,62,110,51,48,2,46,78,292,6.6
3632,Johnathan Stove\johnathan-stove-1,2017-18,Louisiana,G,29,6,557,93,173,.538,79,135,.585,14,38,.368,92,112,.821,38,50,88,47,14,14,41,66,292,8.0
3633,Raemond Robinson\raemond-robinson-1,2015-16,Charleston Southern,G,30,22,749,98,241,.407,16,46,.348,82,195,.421,14,20,.700,11,84,95,40,23,1,46,68,292,5.7
3634,Tim Bond\tim-bond-1,2015-16,Eastern Michigan,G,33,26,1018,110,249,.442,93,186,.500,17,63,.270,55,71,.775,37,101,138,94,66,23,63,94,292,7.8
3635,Edward Stephens\edward-stephens-1,2016-17,South Carolina State,G,31,22,844,100,265,.377,33,79,.418,67,186,.360,25,33,.758,13,54,67,52,22,4,27,41,292,6.0
3636,Tyler Strange\tyler-strange-1,2014-15,Gardner-Webb,G,35,35,1201,99,257,.385,42,102,.412,57,155,.368,37,56,.661,12,86,98,260,59,5,85,65,292,8.9
3637,Devonte Boykins\devonte-boykins-1,2017-18,North Carolina A&T,G,32,30,995,96,242,.397,40,76,.526,56,166,.337,43,58,.741,15,83,98,74,25,3,46,69,291,6.1
3638,Jake Wright\jake-wright-1,2016-17,Miami (OH),G,32,15,851,97,256,.379,26,54,.481,71,202,.351,26,28,.929,7,44,51,13,13,0,19,33,291,4.9
3639,Chad White\chad-white-1,2013-14,South Dakota State,G,30,30,970,89,226,.394,29,53,.547,60,173,.347,53,67,.791,21,86,107,66,19,17,47,59,291,7.0
3640,Paris Burns\paris-burns-1,2014-15,Illinois-Chicago,G,28,13,617,101,238,.424,81,176,.460,20,62,.323,69,89,.775,12,59,71,68,20,2,48,70,291,6.3
3641,Joe O'Shea\joe-oshea-1,2013-14,Bryant,G,32,31,1030,100,216,.463,65,116,.560,35,100,.350,56,77,.727,43,96,139,51,36,16,35,100,291,7.4
3642,Anthony Johnson\anthony-johnson-6,2014-15,Northern Illinois,G,27,25,616,105,242,.434,71,151,.470,34,91,.374,47,67,.701,19,39,58,26,11,0,28,37,291,6.2
3643,T.J. Wallace\tj-wallace-1,2015-16,Pacific,G,27,27,793,100,265,.377,69,157,.439,31,108,.287,60,89,.674,26,116,142,62,32,11,47,71,291,7.2
3644,Anthony Henderson\anthony-henderson-1,2014-15,Bowling Green State,G,33,32,861,105,217,.484,60,106,.566,45,111,.405,36,56,.643,38,63,101,42,30,8,23,50,291,7.3
3645,Denzel Dulin\denzel-dulin-1,2016-17,Alcorn State,G,31,28,904,99,234,.423,82,172,.477,17,62,.274,76,109,.697,29,70,99,44,24,10,53,81,291,5.5
3646,Noah Robotham\noah-robotham-1,2016-17,Akron,G,33,32,981,85,212,.401,37,89,.416,48,123,.390,73,92,.793,10,59,69,99,27,0,43,60,291,6.8
3647,Namon Wright\namon-wright-1,2017-18,Colorado,G,30,13,688,103,237,.435,74,150,.493,29,87,.333,56,76,.737,19,85,104,34,15,8,57,48,291,5.5
3648,JaMichael Hawkins\jamichael-hawkins-1,2015-16,Southeastern Louisiana,G,33,14,787,94,233,.403,22,55,.400,72,178,.404,31,37,.838,5,47,52,36,24,2,44,48,291,5.1
3649,Logan McIntosh\logan-mcintosh-1,2016-17,Maryland-Eastern Shore,G,34,27,1020,103,247,.417,88,200,.440,15,47,.319,70,110,.636,21,93,114,148,30,3,77,79,291,6.3
3650,Parker Stewart\parker-stewart-1,2017-18,Pittsburgh,G,32,20,839,90,235,.383,19,51,.373,71,184,.386,40,50,.800,16,89,105,29,14,5,19,51,291,6.1
3651,Geovonie McKnight\geovonie-mcknight-1,2013-14,Miami (OH),G,31,28,930,110,272,.404,102,236,.432,8,36,.222,63,90,.700,27,86,113,71,46,4,77,92,291,5.3
3652,Jalen Lindsey\jalen-lindsey-1,2017-18,Providence,G,33,29,1082,92,224,.411,19,39,.487,73,185,.395,34,45,.756,37,81,118,28,31,21,22,66,291,7.1
3653,Marcus Colbert\marcus-colbert-1,2013-14,Montana State,G,31,25,840,97,223,.435,54,107,.505,43,116,.371,54,68,.794,7,57,64,94,24,1,58,68,291,6.3
3654,Antwon Lillard\antwon-lillard-1,2015-16,Bowling Green State,G,34,3,717,107,209,.512,91,150,.607,16,59,.271,61,97,.629,38,76,114,21,25,9,44,73,291,5.7
3655,Ronnie Johnson\ronnie-johnson-1,2015-16,Houston,G,31,13,691,97,240,.404,72,170,.424,25,70,.357,72,90,.800,19,63,82,89,22,1,51,51,291,6.5
3656,Donte Thomas\donte-thomas-2,2015-16,Arkansas State,G,26,25,828,88,192,.458,83,168,.494,5,24,.208,110,164,.671,22,129,151,146,31,7,76,71,291,9.9
3657,Quentin Snider\quentin-snider-1,2015-16,Louisville,G,31,24,861,103,256,.402,63,157,.401,40,99,.404,45,60,.750,23,47,70,109,25,0,40,60,291,6.9
3658,Ike Nwamu\ike-nwamu-1,2013-14,Mercer,G,35,0,658,94,194,.485,74,148,.500,20,46,.435,83,111,.748,26,77,103,34,22,9,59,61,291,5.5
3659,Ty Charles\ty-charles-1,2014-15,Stephen F. Austin,G,34,21,747,96,199,.482,65,122,.533,31,77,.403,68,85,.800,60,111,171,59,29,5,41,80,291,7.6
3660,A.J. Spencer\aj-spencer-2,2013-14,Cal State Long Beach,G,32,28,912,115,248,.464,103,189,.545,12,59,.203,48,64,.750,43,60,103,54,17,4,35,69,290,6.2
3661,Siler Schneider\siler-schneider-1,2015-16,UC-Davis,G,30,20,892,106,267,.397,69,170,.406,37,97,.381,41,62,.661,11,82,93,70,24,2,85,98,290,4.0
3662,Sam Merrill\sam-merrill-1,2016-17,Utah State,G,31,18,813,103,225,.458,56,122,.459,47,103,.456,37,42,.881,12,83,95,97,30,5,31,80,290,7.9
3663,Eron Harris\eron-harris-1,2016-17,Michigan State,G,27,24,618,101,234,.432,58,123,.472,43,111,.387,45,59,.763,14,67,81,46,11,5,47,40,290,6.5
3664,Stanford Robinson\stanford-robinson-1,2017-18,Rhode Island,G,33,31,915,111,245,.453,88,170,.518,23,75,.307,45,75,.600,56,131,187,61,69,16,54,89,290,8.0
3665,Rayshawn Simmons\rayshawn-simmons-1,2014-15,Central Michigan,G,32,32,887,99,227,.436,83,173,.480,16,54,.296,76,100,.760,30,89,119,130,35,3,60,75,290,7.7
3666,C.J. Burks\cj-burks-1,2015-16,Marshall,G,33,4,742,111,232,.478,77,127,.606,34,105,.324,34,48,.708,16,50,66,61,32,2,37,52,290,6.4
3667,Jeremiah Jefferson\jeremiah-jefferson-1,2017-18,Jackson State,G,30,24,790,102,295,.346,39,111,.351,63,184,.342,23,29,.793,11,40,51,36,12,3,25,45,290,4.6
3668,Johnathan Stove\johnathan-stove-1,2016-17,Louisiana,G,32,19,831,97,234,.415,83,189,.439,14,45,.311,82,112,.732,46,85,131,51,10,7,56,101,290,5.2
3669,Zach Lewis\zach-lewis-1,2016-17,Massachusetts,G,33,8,759,93,270,.344,50,121,.413,43,149,.289,61,72,.847,7,46,53,43,33,4,30,68,290,4.9
3670,Antonius Cleveland\antonius-cleveland-1,2013-14,Southeast Missouri State,G,32,21,714,107,204,.525,93,165,.564,14,39,.359,62,104,.596,39,50,89,53,32,16,60,85,290,6.3
3671,Kam Williams\kam-williams-1,2015-16,Ohio State,G,35,2,766,108,244,.443,56,125,.448,52,119,.437,22,26,.846,14,49,63,28,24,5,17,38,290,5.7
3672,Justin Burrell\justin-burrell-2,2014-15,Holy Cross,G,30,29,820,93,251,.371,60,148,.405,33,103,.320,71,86,.826,8,46,54,123,38,0,53,45,290,7.3
3673,Damon Collins\damon-collins-1,2016-17,Howard,G,30,27,981,92,222,.414,83,192,.432,9,30,.300,97,132,.735,33,115,148,82,24,7,107,72,290,5.5
3674,Marcus Roper\marcus-roper-1,2014-15,Tennessee State,G,29,11,675,96,268,.358,35,78,.449,61,190,.321,37,54,.685,19,63,82,18,23,8,43,44,290,5.1
3675,Francisco Santiago\francisco-santiago-1,2015-16,Youngstown State,G,32,32,1006,105,278,.378,83,192,.432,22,86,.256,58,78,.744,20,110,130,139,44,8,74,54,290,7.1
3676,Cleon Roberts\cleon-roberts-1,2014-15,La Salle,G,33,22,941,90,253,.356,43,112,.384,47,141,.333,63,83,.759,23,74,97,35,39,12,41,100,290,5.2
3677,Payton Pritchard\payton-pritchard-1,2016-17,Oregon,G,39,35,1105,97,245,.396,47,102,.461,50,143,.350,46,63,.730,23,108,131,140,45,3,56,87,290,6.5
3678,Justin Anderson\justin-anderson-1,2013-14,Virginia,G,37,5,799,96,236,.407,66,134,.493,30,102,.294,68,95,.716,26,94,120,54,13,28,51,58,290,5.3
3679,Daxter Miles\daxter-miles-1,2016-17,West Virginia,G,33,26,694,105,236,.445,66,119,.555,39,117,.333,41,69,.594,41,40,81,54,46,3,27,70,290,6.9
3680,Dainan Swoope\dainan-swoope-1,2015-16,Elon,G,32,0,715,94,248,.379,34,85,.400,60,163,.368,42,62,.677,19,61,80,60,20,1,38,48,290,5.7
3681,Alec Kobre\alec-kobre-1,2015-16,Pacific,G,22,21,601,95,188,.505,35,52,.673,60,136,.441,40,44,.909,3,29,32,19,6,0,21,60,290,8.2
3682,Mario Dunn\mario-dunn-1,2014-15,Montana,G,33,33,1046,104,213,.488,78,142,.549,26,71,.366,56,79,.709,16,111,127,126,59,11,83,84,290,7.8
3683,Zach Stahl\zach-stahl-1,2014-15,Northeastern,G,35,34,969,119,209,.569,119,209,.569,0,0,,52,79,.658,66,139,205,69,22,12,79,87,290,6.7
3684,Cullen Hamilton\cullen-hamilton-1,2015-16,Holy Cross,G,35,35,964,105,268,.392,77,177,.435,28,91,.308,52,67,.776,16,63,79,59,23,1,39,56,290,4.9
3685,Djimon Henson\djimon-henson-1,2017-18,Morehead State,G,29,23,790,101,255,.396,49,116,.422,52,139,.374,36,49,.735,20,62,82,22,9,4,43,55,290,4.9
3686,Farad Cobb\farad-cobb-1,2014-15,Cincinnati,G,34,9,821,99,259,.382,46,100,.460,53,159,.333,38,48,.792,18,67,85,49,33,4,37,36,289,5.7
3687,Bo Hodges\bo-hodges-1,2017-18,East Tennessee State,G,32,4,679,109,213,.512,103,188,.548,6,25,.240,65,98,.663,36,75,111,29,26,22,32,59,289,7.0
3688,Fred Thomas\fred-thomas-1,2013-14,Mississippi State,G,31,23,926,99,259,.382,53,115,.461,46,144,.319,45,72,.625,10,81,91,44,31,23,40,56,289,5.9
3689,Dejan Vasiljevic\dejan-vasiljevic-1,2017-18,Miami (FL),G,32,20,731,104,231,.450,37,68,.544,67,163,.411,14,16,.875,15,65,80,14,13,2,16,49,289,5.8
3690,Adam Pickett\adam-pickett-1,2017-18,Winthrop,G,31,18,649,105,192,.547,82,132,.621,23,60,.383,56,78,.718,16,76,92,57,27,12,67,75,289,6.5
3691,Ojai Black\ojai-black-1,2016-17,Texas State,G,36,35,998,90,201,.448,77,156,.494,13,45,.289,96,128,.750,19,62,81,144,37,11,66,89,289,6.9
3692,Akeem Springs\akeem-springs-1,2014-15,Milwaukee,G,28,22,868,100,246,.407,76,162,.469,24,84,.286,65,92,.707,36,100,136,48,17,3,53,43,289,6.6
3693,Mychal Ammons\mychal-ammons-1,2013-14,South Alabama,G,31,29,865,98,223,.439,72,153,.471,26,70,.371,67,104,.644,76,147,223,44,13,35,57,103,289,7.2
3694,Jarvis Ray\jarvis-ray-1,2013-14,Texas Christian,G,31,31,842,116,261,.444,111,228,.487,5,33,.152,52,77,.675,43,91,134,40,40,13,55,94,289,6.0
3695,Antonio Green\antonio-green-2,2015-16,Texas-Rio Grande Valley,G,25,22,838,103,261,.395,44,106,.415,59,155,.381,24,36,.667,11,94,105,75,15,2,48,47,289,7.2
3696,DelFincko Bogan\delfincko-bogan-1,2017-18,Tennessee-Martin,G,31,15,845,110,227,.485,69,125,.552,41,102,.402,28,35,.800,12,73,85,93,58,4,61,71,289,7.7
3697,Jacobi Boykins\jacobi-boykins-1,2015-16,Louisiana Tech,G,31,29,889,101,244,.414,51,104,.490,50,140,.357,37,55,.673,20,81,101,28,25,16,30,73,289,6.0
3698,Keith Shamburger\keith-shamburger-1,2013-14,Hawaii,G,31,30,1001,75,215,.349,35,85,.412,40,130,.308,99,119,.832,15,79,94,166,33,2,62,59,289,8.4
3699,Chris Czerapowicz\chris-czerapowicz-1,2013-14,Davidson,G,33,30,834,108,260,.415,78,156,.500,30,104,.288,43,61,.705,41,101,142,23,15,11,31,97,289,5.2
3700,Donald Carey\donald-carey-1,2017-18,Mount St. Mary's,G,32,32,1006,98,240,.408,59,133,.444,39,107,.364,54,66,.818,11,74,85,109,32,3,86,60,289,5.8
3701,Bryce Dulin\bryce-dulin-1,2016-17,Navy,G,31,25,845,98,213,.460,65,133,.489,33,80,.413,60,88,.682,38,88,126,56,26,12,60,54,289,6.9
3702,Chris Jones\chris-jones-5,2014-15,Pittsburgh,G,34,21,933,109,253,.431,68,138,.493,41,115,.357,30,55,.545,37,68,105,68,15,11,34,83,289,5.7
3703,Shavar Newkirk\shavar-newkirk-1,2015-16,Saint Joseph's,G,36,36,848,90,237,.380,67,161,.416,23,76,.303,86,118,.729,14,73,87,95,29,5,54,34,289,5.8
3704,Kyle Castlin\kyle-castlin-1,2014-15,Columbia,G,28,28,747,101,220,.459,77,156,.494,24,64,.375,63,78,.808,53,65,118,27,22,8,35,48,289,7.8
3705,DeVon Walker\devon-walker-1,2016-17,Troy,G,37,36,1011,102,214,.477,96,193,.497,6,21,.286,79,116,.681,81,154,235,62,31,23,51,82,289,7.4
3706,Corey Allen\corey-allen-1,2013-14,South Florida,G,32,28,986,93,236,.394,71,165,.430,22,71,.310,81,103,.786,19,87,106,88,43,6,67,72,289,6.4
3707,Ya Ya Anderson\ya-ya-anderson-1,2014-15,Radford,G,31,18,872,102,238,.429,43,71,.606,59,167,.353,26,40,.650,13,45,58,55,24,0,21,39,289,6.6
3708,Braun Hartfield\braun-hartfield-1,2016-17,Youngstown State,G,34,14,768,106,232,.457,89,176,.506,17,56,.304,60,89,.674,46,117,163,34,24,16,32,59,289,6.7
3709,Jamel Outler\jamel-outler-1,2014-15,Texas-Arlington,G,31,24,733,89,249,.357,33,71,.465,56,178,.315,55,88,.625,8,34,42,28,25,0,45,63,289,4.1
3710,Donald Hicks\donald-hicks-1,2017-18,Radford,G,36,35,967,99,267,.371,34,107,.318,65,160,.406,26,30,.867,43,76,119,48,20,1,39,84,289,4.9
3711,Cameron Jones\cameron-jones-2,2014-15,Radford,G,34,0,610,109,222,.491,64,119,.538,45,103,.437,25,39,.641,34,61,95,20,12,11,34,58,288,5.6
3712,Naadir Tharpe\naadir-tharpe-1,2013-14,Kansas,G,34,31,1001,95,218,.436,52,104,.500,43,114,.377,55,67,.821,4,68,72,170,24,0,70,72,288,6.9
3713,Carlos Anderson\carlos-anderson-1,2015-16,Southern Illinois-Edwardsville,G,28,28,883,103,267,.386,71,163,.436,32,104,.308,50,68,.735,32,100,132,66,31,2,56,73,288,6.5
3714,Galal Cancer\galal-cancer-1,2014-15,Cornell,G,30,30,896,91,232,.392,67,169,.396,24,63,.381,82,101,.812,37,66,103,91,29,8,61,86,288,6.8
3715,Julian DeBose\julian-debose-1,2015-16,Florida Gulf Coast,G,33,33,914,114,268,.425,82,172,.477,32,96,.333,28,48,.583,29,73,102,40,35,17,43,65,288,5.6
3716,Darien Walker\darien-walker-1,2015-16,Valparaiso,G,36,18,725,103,264,.390,62,142,.437,41,122,.336,41,54,.759,30,99,129,37,20,3,39,57,288,4.9
3717,Denzel Gregg\denzel-gregg-1,2015-16,St. Bonaventure,G,31,2,729,97,203,.478,82,158,.519,15,45,.333,79,117,.675,55,109,164,23,14,43,39,91,288,7.3
3718,Ahmed Hill\ahmed-hill-1,2014-15,Virginia Tech,G,33,30,978,99,248,.399,67,165,.406,32,83,.386,58,84,.690,35,87,122,51,15,4,51,74,288,5.1
3719,Quayson Williams\quayson-williams-1,2015-16,Citadel,G,31,6,585,98,268,.366,32,85,.376,66,183,.361,26,35,.743,16,44,60,29,28,2,41,74,288,4.5
3720,Marcus Burk\marcus-burk-1,2016-17,Campbell,G,36,12,754,96,224,.429,29,57,.509,67,167,.401,29,37,.784,9,78,87,28,17,3,25,51,288,5.3
3721,Jalyn Hinton\jalyn-hinton-1,2017-18,Jacksonville,G,32,13,755,119,180,.661,119,180,.661,0,0,,50,89,.562,58,112,170,16,22,35,23,66,288,8.6
3722,Jalil Abdul-Bassit\jalil-abdul-bassit-1,2014-15,Oregon,G,35,19,699,99,227,.436,40,91,.440,59,136,.434,31,38,.816,19,42,61,25,21,12,35,80,288,4.9
3723,Shaq Calhoun\shaq-calhoun-1,2015-16,South Alabama,G,33,2,631,95,235,.404,46,97,.474,49,138,.355,49,66,.742,17,60,77,16,43,7,52,76,288,4.9
3724,Ambrose Mosley\ambrose-mosley-1,2016-17,North Carolina-Wilmington,G,35,31,862,99,222,.446,25,45,.556,74,177,.418,16,22,.727,34,66,100,43,24,3,22,80,288,6.2
3725,Isaiah Still\isaiah-still-1,2015-16,Robert Morris,G,29,23,880,84,238,.353,53,131,.405,31,107,.290,88,128,.688,18,91,109,47,17,7,50,66,287,5.4
3726,Andrew Kostecka\andrew-kostecka-1,2017-18,Loyola (MD),G,26,18,751,98,217,.452,77,152,.507,21,65,.323,70,94,.745,17,78,95,48,54,29,39,70,287,9.3
3727,Langston Morris-Walker\langston-morris-walker-1,2014-15,Oregon State,G,31,30,946,97,269,.361,59,148,.399,38,121,.314,55,78,.705,33,109,142,44,30,2,40,60,287,5.9
3728,Joe Rahon\joe-rahon-1,2013-14,Boston College,G,32,32,1067,98,245,.400,53,118,.449,45,127,.354,46,62,.742,22,88,110,103,24,4,58,65,287,6.4
3729,Jaquan Lynch\jaquan-lynch-1,2016-17,Arkansas-Pine Bluff,G,32,19,798,96,251,.382,54,137,.394,42,114,.368,53,64,.828,17,52,69,67,43,4,47,58,287,6.1
3730,Nehemias Morillo\nehemias-morillo-1,2015-16,South Florida,G,33,21,906,98,281,.349,64,166,.386,34,115,.296,57,74,.770,14,59,73,68,25,9,68,64,287,4.1
3731,Adam Weary\adam-weary-1,2014-15,High Point,G,31,8,712,98,210,.467,81,161,.503,17,49,.347,74,99,.747,14,60,74,85,20,4,60,60,287,6.3
3732,Sayeed Pridgett\sayeed-pridgett-1,2017-18,Montana,G,34,0,770,122,264,.462,119,248,.480,3,16,.188,40,61,.656,35,111,146,44,41,14,65,102,287,5.2
3733,Johnathan Burroughs-Cook\johnathan-burroughs-cook-1,2016-17,Chattanooga,G,31,30,753,96,226,.425,72,149,.483,24,77,.312,71,104,.683,27,49,76,36,27,3,39,61,287,5.8
3734,Johnathan Bell\johnathan-bell-1,2015-16,Nicholls State,G,34,24,824,100,264,.379,69,166,.416,31,98,.316,56,79,.709,24,97,121,33,31,12,43,57,287,5.2
3735,Detrick Mostella\detrick-mostella-1,2015-16,Tennessee,G,34,4,667,95,262,.363,48,107,.449,47,155,.303,50,68,.735,14,60,74,40,9,6,46,66,287,3.9
3736,Kinnon LaRose\kinnon-larose-1,2017-18,Sacred Heart,G,31,28,861,104,245,.424,45,75,.600,59,170,.347,20,27,.741,37,80,117,26,12,10,30,69,287,5.9
3737,Godwin Boahen\godwin-boahen-1,2016-17,Illinois-Chicago,G,31,21,796,93,200,.465,43,87,.494,50,113,.442,51,73,.699,22,89,111,102,29,2,75,88,287,6.7
3738,Joey Frenchwood\joseph-frenchwood-1,2016-17,Lamar,G,34,34,868,102,253,.403,61,122,.500,41,131,.313,42,64,.656,8,56,64,143,54,7,80,78,287,6.2
3739,Kaelon Harris\kaelon-harris-1,2017-18,Citadel,G,29,23,661,87,211,.412,57,122,.467,30,89,.337,83,118,.703,52,100,152,53,29,13,50,68,287,7.7
3740,Shane Rector\shane-rector-1,2015-16,Utah State,G,31,12,731,101,233,.433,81,173,.468,20,60,.333,65,86,.756,12,66,78,101,38,5,73,67,287,6.3
3741,Jaycee Hillsman\jaycee-hillsman-1,2017-18,San Jose State,G,30,13,748,89,215,.414,62,136,.456,27,79,.342,82,101,.812,31,96,127,71,17,8,77,75,287,6.0
3742,Devon Daniels\devon-daniels-1,2016-17,Utah,G,29,26,779,113,198,.571,99,163,.607,14,35,.400,46,65,.708,25,108,133,78,25,13,57,63,286,8.3
3743,Austin Hamilton\austin-hamilton-1,2014-15,Elon,G,32,31,789,103,245,.420,72,152,.474,31,93,.333,49,75,.653,22,56,78,100,29,1,58,55,286,6.2
3744,Devin Wilson\devin-wilson-2,2013-14,Virginia Tech,G,31,31,1081,75,201,.373,61,156,.391,14,45,.311,122,185,.659,15,85,100,148,25,5,90,77,286,6.4
3745,Nick Norton\nick-norton-1,2015-16,Alabama-Birmingham,G,32,31,878,89,215,.414,30,54,.556,59,161,.366,49,57,.860,9,75,84,161,52,1,54,53,286,9.0
3746,Kavon Stewart\kavon-stewart-1,2015-16,Robert Morris,G,31,29,960,93,267,.348,81,215,.377,12,52,.231,88,149,.591,16,54,70,145,55,1,99,85,286,5.3
3747,Brevin Pritzl\brevin-pritzl-1,2017-18,Wisconsin,G,32,21,938,93,234,.397,40,85,.471,53,149,.356,47,55,.855,30,92,122,33,26,7,17,56,286,6.9
3748,Matt Miller\matt-miller-2,2014-15,New Hampshire,G,29,16,662,100,212,.472,37,81,.457,63,131,.481,23,31,.742,13,74,87,34,11,1,21,44,286,7.0
3749,Alante Fenner\alante-fenner-1,2014-15,Savannah State,G,31,8,743,106,261,.406,90,198,.455,16,63,.254,57,89,.640,33,92,125,45,43,4,67,67,285,5.4
3750,Tarkus Ferguson\tarkus-ferguson-1,2017-18,Illinois-Chicago,G,27,27,792,91,240,.379,53,127,.417,38,113,.336,65,81,.802,21,127,148,136,30,24,71,60,285,9.1
3751,Cazmon Hayes\cazmon-hayes-1,2016-17,Delaware,G,33,21,884,98,276,.355,69,164,.421,29,112,.259,60,87,.690,25,85,110,58,17,23,52,50,285,5.0
3752,Josh Delaney\josh-delaney-1,2017-18,Sam Houston State,G,35,7,800,85,214,.397,17,46,.370,68,168,.405,47,62,.758,8,60,68,76,25,3,32,54,285,6.1
3753,Dmitri Thompson\dmitri-thompson-1,2016-17,Elon,G,32,27,839,106,219,.484,88,153,.575,18,66,.273,55,83,.663,39,122,161,39,20,10,52,74,285,6.2
3754,Mitchell Badillo\mitchell-badillo-1,2015-16,Incarnate Word,G,29,28,916,99,207,.478,65,128,.508,34,79,.430,53,71,.746,25,80,105,138,51,0,67,70,285,9.2
3755,Anthony Masinton-Bonner\anthony-masinton-bonner-1,2017-18,Colorado State,G,32,21,866,99,221,.448,58,126,.460,41,95,.432,46,56,.821,8,78,86,43,20,2,45,69,285,5.4
3756,Demetrius Pollard\demetrius-pollard-1,2013-14,Northeastern,G,32,29,915,90,256,.352,35,89,.393,55,167,.329,50,74,.676,11,48,59,67,23,3,45,72,285,4.8
3757,Daniel Dion\daniel-dion-1,2014-15,New Hampshire,G,31,15,795,95,253,.375,39,104,.375,56,149,.376,39,53,.736,7,47,54,46,31,0,49,50,285,5.0
3758,Anthony Hickey\anthony-hickey-1,2013-14,Louisiana State,G,34,31,1066,100,271,.369,38,92,.413,62,179,.346,23,40,.575,19,75,94,126,62,5,45,78,285,7.1
3759,Sam Burmeister\sam-burmeister-1,2013-14,Incarnate Word,G,26,26,828,92,217,.424,40,90,.444,52,127,.409,49,70,.700,11,58,69,48,18,1,46,71,285,6.3
3760,Stephen Brown\stephen-brown-2,2015-16,Bucknell,G,31,31,891,93,189,.492,79,146,.541,14,43,.326,85,102,.833,22,79,101,165,40,2,61,65,285,9.4
3761,John Emezie\john-emezie-1,2016-17,Army,G,32,7,707,93,221,.421,64,136,.471,29,85,.341,70,91,.769,20,67,87,48,31,13,66,69,285,5.4
3762,Caleb Tanner\caleb-tanner-1,2016-17,Radford,G,32,0,694,92,246,.374,21,64,.328,71,182,.390,30,35,.857,4,25,29,33,8,0,34,25,285,4.5
3763,Austin Ruder\austin-ruder-1,2013-14,Missouri State,G,33,32,981,91,231,.394,19,51,.373,72,180,.400,31,39,.795,5,49,54,40,9,0,21,44,285,5.2
3764,Zach Lewis\zach-lewis-1,2017-18,Iona,G,31,20,867,97,241,.402,50,103,.485,47,138,.341,44,59,.746,4,86,90,95,46,9,43,65,285,7.3
3765,Aaron Walker\aaron-walker-1,2016-17,Manhattan,G,32,9,577,101,245,.412,84,178,.472,17,67,.254,66,109,.606,23,53,76,53,28,6,65,77,285,4.4
3766,Trayvon Palmer\trayvon-palmer-1,2015-16,Chicago State,G,30,28,905,101,239,.423,83,177,.469,18,62,.290,65,89,.730,90,143,233,42,39,30,69,87,285,8.0
3767,Reco McCarter\reco-mccarter-1,2014-15,Campbell,G,28,27,776,100,226,.442,73,134,.545,27,92,.293,58,104,.558,39,80,119,57,43,19,67,63,285,7.3
3768,Jevon Carter\jevon-carter-1,2014-15,West Virginia,G,35,4,832,95,264,.360,47,111,.423,48,153,.314,47,61,.770,39,43,82,62,67,3,41,67,285,6.2
3769,Barry Brown\barry-brown-1,2015-16,Kansas State,G,33,11,852,100,287,.348,55,153,.359,45,134,.336,40,64,.625,23,69,92,50,40,3,50,65,285,4.6
3770,Kadeem Allen\kadeem-allen-1,2015-16,Arizona,G,34,28,848,100,215,.465,82,165,.497,18,50,.360,67,95,.705,8,98,106,121,35,27,68,82,285,6.9
3771,Jarred Dixon\jarred-dixon-1,2016-17,Missouri State,G,33,10,758,105,260,.404,90,207,.435,15,53,.283,60,71,.845,23,60,83,67,26,7,42,62,285,5.6
3772,Tyron Criswell\tyron-criswell-1,2014-15,Nevada,G,31,14,734,101,236,.428,81,177,.458,20,59,.339,63,92,.685,60,66,126,51,24,2,58,81,285,5.8
3773,Marc Brown\marc-brown-1,2014-15,Illinois-Chicago,G,34,22,849,80,247,.324,52,164,.317,28,83,.337,97,119,.815,33,80,113,37,19,3,42,58,285,4.8
3774,Tyler Hubbard\tyler-hubbard-1,2015-16,Loyola (MD),G,30,23,885,88,267,.330,26,75,.347,62,192,.323,46,64,.719,8,41,49,35,9,0,29,58,284,4.1
3775,Aleksa Jugovic\aleksa-jugovic-1,2017-18,Tennessee Tech,G,23,20,685,95,208,.457,49,97,.505,46,111,.414,48,56,.857,4,40,44,71,22,3,48,25,284,8.9
3776,Gabe Vincent\gabe-vincent-1,2014-15,UC-Santa Barbara,G,28,21,733,97,229,.424,40,92,.435,57,137,.416,33,50,.660,15,45,60,60,24,4,28,64,284,7.0
3777,Jovaughn Love\jovaughn-love-1,2014-15,Arkansas-Pine Bluff,G,26,24,703,100,263,.380,81,199,.407,19,64,.297,65,98,.663,42,87,129,25,16,28,48,59,284,6.3
3778,Dylan Frye\dylan-frye-1,2016-17,Bowling Green State,G,32,15,760,106,240,.442,65,138,.471,41,102,.402,31,44,.705,14,57,71,38,16,0,38,69,284,4.9
3779,Milton Doyle\milton-doyle-1,2014-15,Loyola (IL),G,25,17,677,94,194,.485,65,125,.520,29,69,.420,67,102,.657,12,69,81,106,31,15,77,56,284,8.7
3780,Dre Evans\dre-evans-2,2013-14,Southeastern Louisiana,G,30,30,839,95,232,.409,44,117,.376,51,115,.443,43,56,.768,5,44,49,85,15,1,41,79,284,5.8
3781,Anthlon Bell\anthlon-bell-1,2014-15,Arkansas,G,36,16,660,95,257,.370,30,72,.417,65,185,.351,29,41,.707,12,30,42,50,21,4,32,62,284,4.4
3782,Jalen Crutcher\jalen-crutcher-1,2017-18,Dayton,G,31,22,967,100,243,.412,48,89,.539,52,154,.338,32,47,.681,9,87,96,135,32,4,64,72,284,7.0
3783,Jarell Flora\jarell-flora-1,2013-14,Seattle,G,30,25,851,99,256,.387,44,106,.415,55,150,.367,31,44,.705,30,65,95,26,22,2,36,41,284,5.6
3784,Jaron Hopkins\jaron-hopkins-1,2017-18,Fresno State,G,25,25,716,116,229,.507,109,210,.519,7,19,.368,45,78,.577,22,120,142,77,35,9,59,57,284,8.9
3785,Retin Obasohan\retin-obasohan-1,2013-14,Alabama,G,30,19,862,83,218,.381,69,161,.429,14,57,.246,104,156,.667,13,77,90,48,54,29,56,85,284,6.5
3786,JaQuail Townser\jaquail-townser-1,2015-16,Jacksonville State,G,30,29,878,95,242,.393,49,128,.383,46,114,.404,48,65,.738,19,95,114,107,35,3,54,71,284,7.2
3787,Tahj Shamsid-Deen\tahj-shamsid-deen-1,2013-14,Auburn,G,30,30,880,97,238,.408,54,108,.500,43,130,.331,47,62,.758,8,36,44,86,25,2,39,79,284,6.1
3788,Jeff Mullahey\jeff-mullahey-1,2013-14,Troy,G,31,28,928,81,238,.340,35,104,.337,46,134,.343,76,97,.784,58,85,143,62,42,5,32,84,284,7.4
3789,Devon Hall\devon-hall-1,2016-17,Virginia,G,34,34,931,100,245,.408,68,159,.428,32,86,.372,52,67,.776,22,127,149,65,18,4,35,65,284,6.0
3790,Jake Allsmiller\jake-allsmiller-1,2017-18,Georgia Southern,G,33,31,847,92,251,.367,9,19,.474,83,232,.358,17,23,.739,10,42,52,21,9,6,14,87,284,4.3
3791,Deandre Mathieu\deandre-mathieu-1,2014-15,Minnesota,G,33,25,936,110,240,.458,97,198,.490,13,42,.310,51,71,.718,23,67,90,143,64,1,54,75,284,8.2
3792,Rod Hall\rod-hall-1,2014-15,Clemson,G,31,31,1061,92,227,.405,73,167,.437,19,60,.317,81,107,.757,9,63,72,106,27,6,64,55,284,6.3
3793,Gerdarius Troutman\gerdarius-troutman-1,2016-17,Florida Atlantic,G,30,12,535,92,220,.418,20,51,.392,72,169,.426,27,36,.750,9,32,41,28,10,3,10,26,283,6.3
3794,A.J. Spencer\aj-spencer-2,2015-16,Cal State Long Beach,G,35,32,884,114,261,.437,82,177,.463,32,84,.381,23,36,.639,17,85,102,51,13,2,33,81,283,4.7
3795,Steven Haney\steven-haney-1,2016-17,Loyola Marymount,G,30,25,760,100,248,.403,38,76,.500,62,172,.360,21,25,.840,9,84,93,30,15,1,27,50,283,5.6
3796,Chris Evans\chris-evans-2,2013-14,Sacred Heart,G,25,23,708,81,223,.363,67,177,.379,14,46,.304,107,143,.748,23,61,84,45,18,6,44,58,283,6.6
3797,Alex Young\alex-young-2,2014-15,UC-Irvine,G,30,29,891,102,248,.411,75,168,.446,27,80,.338,52,69,.754,17,88,105,109,40,9,49,55,283,7.8
3798,Ken Williams\ken-williams-1,2013-14,South Alabama,G,31,31,856,94,259,.363,39,98,.398,55,161,.342,40,51,.784,15,91,106,51,13,6,50,63,283,4.9
3799,Jawun Evans\jawun-evans-1,2015-16,Oklahoma State,G,22,20,635,97,206,.471,78,166,.470,19,40,.475,70,84,.833,10,86,96,108,25,4,56,54,283,10.5
3800,De'Antae McMurray\deantae-mcmurray-1,2016-17,Drake,G,31,22,819,93,269,.346,39,118,.331,54,151,.358,43,54,.796,3,75,78,94,35,2,51,59,283,5.8
3801,Eric Robertson\eric-robertson-1,2014-15,Chattanooga,G,32,3,671,94,196,.480,29,57,.509,65,139,.468,30,42,.714,21,38,59,37,14,10,30,46,283,6.4
3802,Travis Weatherington\travis-weatherington-1,2017-18,Hartford,G,33,24,877,103,214,.481,44,74,.595,59,140,.421,18,20,.900,17,71,88,37,30,2,48,52,283,5.9
3803,Evan Gilyard\evan-gilyard-1,2017-18,Texas-El Paso,G,31,13,626,88,231,.381,62,142,.437,26,89,.292,81,96,.844,8,51,59,51,26,1,69,70,283,4.4
3804,Corey Johnson\corey-johnson-4,2015-16,Harvard,G,29,26,831,96,249,.386,22,63,.349,74,186,.398,17,25,.680,13,54,67,43,13,8,39,57,283,5.4
3805,Mikey Thompson\mikey-thompson-1,2013-14,Boise State,G,33,12,855,92,203,.453,80,160,.500,12,43,.279,87,117,.744,8,42,50,81,19,1,46,53,283,5.9
3806,Cezar Guerrero\cezar-guerrero-1,2015-16,Fresno State,G,35,35,889,91,234,.389,42,100,.420,49,134,.366,52,68,.765,19,89,108,83,31,0,46,94,283,5.6
3807,Rashad Lindsey\rashad-lindsey-1,2017-18,Arkansas State,G,32,24,947,103,251,.410,73,162,.451,30,89,.337,47,56,.839,20,49,69,78,29,2,47,51,283,6.0
3808,Josh Adeyeye\josh-adeyeye-1,2015-16,Jacksonville,G,31,13,635,94,217,.433,36,73,.493,58,144,.403,37,50,.740,18,104,122,21,9,3,28,36,283,6.2
3809,Wesley Myers\wesley-myers-1,2014-15,Niagara,G,30,16,882,94,220,.427,60,139,.432,34,81,.420,61,86,.709,21,76,97,45,30,10,54,60,283,6.2
3810,Ehab Amin\ehab-amin-1,2015-16,Texas A&M-Corpus Christi,G,33,0,596,100,210,.476,75,142,.528,25,68,.368,58,81,.716,39,90,129,49,59,5,54,68,283,7.2
3811,Devonte Hall\devonte-hall-1,2016-17,Northwestern State,G,29,28,770,86,208,.413,74,164,.451,12,44,.273,99,128,.773,9,60,69,133,38,2,74,93,283,7.1
3812,Armani Cotton\armani-cotton-1,2013-14,Yale,G,33,30,854,79,221,.357,47,118,.398,32,103,.311,92,121,.760,44,135,179,32,30,2,43,62,282,6.2
3813,Joe Rahon\joe-rahon-1,2016-17,Saint Mary's (CA),G,34,34,1237,104,245,.424,68,145,.469,36,100,.360,38,52,.731,15,111,126,192,36,11,58,64,282,8.4
3814,Matt Harris\matt-harris-1,2015-16,Massachusetts-Lowell,G,28,12,612,93,206,.451,42,85,.494,51,121,.421,45,51,.882,11,53,64,35,20,1,39,59,282,6.4
3815,Dominique Matthews\dominique-matthews-1,2017-18,Illinois-Chicago,G,36,12,674,94,264,.356,42,110,.382,52,154,.338,42,59,.712,18,43,61,26,18,9,40,46,282,3.8
3816,Christian Vital\christian-vital-1,2016-17,Connecticut,G,31,10,882,92,235,.391,40,93,.430,52,142,.366,46,65,.708,18,92,110,56,35,5,41,80,282,6.2
3817,Phillip Leonard\phillip-leonard-1,2014-15,Mercer,G,35,34,945,92,198,.465,91,182,.500,1,16,.063,97,155,.626,26,96,122,158,31,1,64,92,282,7.0
3818,Derrik Jamerson Jr.\derrik-jamersonjr-1,2017-18,Norfolk State,G,33,22,842,102,240,.425,27,52,.519,75,188,.399,3,5,.600,44,59,103,14,30,10,27,68,282,5.9
3819,Kari Jonsson\kari-jonsson-1,2016-17,Drexel,G,28,22,797,94,201,.468,29,52,.558,65,149,.436,29,35,.829,11,53,64,55,28,3,39,58,282,7.4
3820,Isaiah Williams\isaiah-williams-2,2015-16,Georgia State,G,30,22,747,89,232,.384,49,124,.395,40,108,.370,64,83,.771,14,49,63,80,26,1,47,41,282,6.4
3821,Devon Bookert\devon-bookert-1,2014-15,Florida State,G,28,28,983,85,227,.374,32,92,.348,53,135,.393,59,73,.808,13,88,101,74,27,3,69,56,282,6.3
3822,Austin Chatman\austin-chatman-1,2013-14,Creighton,G,35,35,1059,90,212,.425,55,122,.451,35,90,.389,67,89,.753,22,98,120,155,18,1,60,78,282,6.9
3823,Jordan Lauf\jordan-lauf-1,2016-17,Toledo,G,34,32,1142,98,166,.590,74,105,.705,24,61,.393,62,90,.689,75,135,210,63,34,2,29,93,282,8.8
3824,John Dawson\john-dawson-1,2015-16,Liberty,G,21,21,671,102,224,.455,60,110,.545,42,114,.368,36,47,.766,6,105,111,71,22,1,69,55,282,8.5
3825,Antwon Portley\antwon-portley-1,2016-17,Saint Peter's,G,36,12,967,95,270,.352,42,114,.368,53,156,.340,39,50,.780,3,80,83,76,32,3,57,58,282,4.4
3826,Ja'Quan Newton\jaquan-newton-1,2017-18,Miami (FL),G,32,26,849,109,245,.445,102,218,.468,7,27,.259,57,92,.620,15,61,76,84,30,5,61,49,282,5.6
3827,Dee Oldham\dee-oldham-1,2013-14,Tennessee-Martin,G,31,14,792,97,250,.388,56,126,.444,41,124,.331,47,54,.870,30,73,103,57,37,6,29,55,282,7.0
3828,Anton Wilson\anton-wilson-1,2014-15,Detroit Mercy,G,33,16,800,95,204,.466,39,70,.557,56,134,.418,36,42,.857,24,84,108,57,27,7,43,69,282,6.6
3829,Jonathan Williams\jonathan-williams-3,2016-17,Virginia Commonwealth,G,34,18,819,110,245,.449,109,228,.478,1,17,.059,61,84,.726,5,71,76,105,21,6,48,48,282,5.9
3830,Tyler Singleton\tyler-singleton-1,2016-17,Incarnate Word,G,29,16,794,97,224,.433,83,186,.446,14,38,.368,74,120,.617,17,69,86,70,22,1,64,44,282,5.8
3831,Fred Thomas\fred-thomas-1,2014-15,Mississippi State,G,31,17,757,84,223,.377,37,86,.430,47,137,.343,67,85,.788,16,95,111,25,23,15,47,58,282,5.6
3832,Grant Benzinger\grant-benzinger-1,2014-15,Wright State,G,31,14,722,99,214,.463,40,77,.519,59,137,.431,25,37,.676,18,72,90,22,10,5,21,75,282,5.8
3833,Andre Jones\andre-jones-3,2017-18,Little Rock,G,23,22,666,115,292,.394,103,218,.472,12,74,.162,40,60,.667,25,81,106,55,11,4,52,42,282,6.1
3834,Jaylen Franklin\jaylen-franklin-1,2016-17,Abilene Christian,G,26,25,896,115,249,.462,110,220,.500,5,29,.172,47,108,.435,12,86,98,115,48,8,65,62,282,8.0
3835,Preston Bungei\preston-bungei-1,2017-18,Norfolk State,G,33,17,926,100,235,.426,91,201,.453,9,34,.265,73,102,.716,52,149,201,71,29,23,77,93,282,6.3
3836,Dulani Robinson\dulani-robinson-1,2014-15,Pacific,G,31,5,777,87,257,.339,38,114,.333,49,143,.343,59,73,.808,19,67,86,79,26,2,47,57,282,5.7
3837,Perrin Buford\perrin-buford-1,2014-15,Middle Tennessee,G,35,13,623,103,206,.500,94,187,.503,9,19,.474,67,95,.705,55,69,124,20,13,22,45,61,282,5.7
3838,Jalen Love\jalen-love-1,2013-14,Denver,G,31,31,992,100,250,.400,54,123,.439,46,127,.362,35,51,.686,18,55,73,54,33,3,37,112,281,5.2
3839,Pat Birt\pat-birt-1,2016-17,Tulsa,G,32,23,960,87,281,.310,35,114,.307,52,167,.311,55,74,.743,14,70,84,49,36,6,44,71,281,4.5
3840,Rex Pflueger\rex-pfleuger-1,2017-18,Notre Dame,G,35,35,1153,93,260,.358,53,134,.396,40,126,.317,55,71,.775,44,107,151,112,36,8,52,69,281,6.7
3841,Marqueze Coleman\marqueze-coleman-1,2014-15,Nevada,G,30,24,778,91,238,.382,78,194,.402,13,44,.295,86,114,.754,5,78,83,70,33,3,60,70,281,5.4
3842,James Sylvester\james-sylvester-1,2015-16,Coppin State,G,28,4,610,81,215,.377,53,150,.353,28,65,.431,91,133,.684,51,50,101,45,25,5,40,55,281,7.0
3843,Jeremy Major\jeremy-major-1,2013-14,Pepperdine,G,31,31,934,94,227,.414,67,153,.438,27,74,.365,66,100,.660,20,78,98,138,40,10,69,57,281,7.6
3844,Harold McBride\harold-mcbride-1,2014-15,Gardner-Webb,G,35,0,830,91,228,.399,49,108,.454,42,120,.350,57,78,.731,15,63,78,79,40,2,49,68,281,5.7
3845,Everson Davis\everson-davis-1,2015-16,Binghamton,G,30,28,862,95,271,.351,85,212,.401,10,59,.169,81,112,.723,21,104,125,75,25,8,92,85,281,4.0
3846,Nick Daniels\nick-daniels-2,2017-18,Oakland,G,33,17,830,82,225,.364,22,64,.344,60,161,.373,57,79,.722,11,79,90,129,33,2,71,68,281,6.2
3847,Austin Dassent\austin-dassent-1,2017-18,Savannah State,G,32,25,705,89,235,.379,28,59,.475,61,176,.347,42,73,.575,30,80,110,55,35,3,38,62,281,6.2
3848,Triston Chambers\triston-chambers-1,2017-18,Samford,G,32,22,721,91,207,.440,25,61,.410,66,146,.452,33,42,.786,16,46,62,15,21,2,37,66,281,5.1
3849,Warren Jones\warren-jones-1,2016-17,Green Bay,G,29,1,560,78,186,.419,40,80,.500,38,106,.358,87,108,.806,9,52,61,63,32,4,40,57,281,7.3
3850,Isiah Jones\isiah-jones-1,2014-15,Southeast Missouri State,G,29,18,724,96,238,.403,33,79,.418,63,159,.396,26,37,.703,21,70,91,56,19,2,55,59,281,5.7
3851,Raheem Appleby\raheem-appleby-1,2013-14,Louisiana Tech,G,25,13,505,103,231,.446,80,160,.500,23,71,.324,52,63,.825,9,37,46,36,20,3,28,22,281,7.4
3852,Paris Collins\paris-collins-1,2017-18,Jackson State,G,25,19,728,106,299,.355,71,175,.406,35,124,.282,34,56,.607,53,99,152,63,73,13,44,64,281,9.1
3853,Adam Weary\adam-weary-1,2013-14,High Point,G,24,17,616,101,204,.495,84,154,.545,17,50,.340,62,90,.689,15,33,48,48,16,7,51,81,281,6.6
3854,Sam Hauser\sam-hauser-1,2016-17,Marquette,G,32,28,847,97,205,.473,34,66,.515,63,139,.453,24,29,.828,29,130,159,42,25,19,22,80,281,7.7
3855,Phil Booth\phil-booth-1,2015-16,Villanova,G,40,3,875,89,242,.368,50,119,.420,39,123,.317,64,73,.877,18,66,84,85,30,5,57,75,281,4.6
3856,Hasan Abdullah\hasan-abdullah-1,2016-17,Navy,G,32,31,910,95,272,.349,47,132,.356,48,140,.343,43,66,.652,21,70,91,105,60,4,86,81,281,5.4
3857,Jordon Talley\jordon-talley-1,2014-15,North Carolina-Wilmington,G,32,21,849,85,221,.385,71,174,.408,14,47,.298,97,123,.789,13,50,63,98,49,3,63,115,281,5.8
3858,Brandon Pye\brandon-pye-1,2014-15,Texas A&M-Corpus Christi,G,31,29,951,98,231,.424,51,113,.451,47,118,.398,38,46,.826,5,37,42,21,25,0,30,39,281,5.3
3859,D'Marques Tyson\dmarques-tyson-1,2016-17,Portland,G,33,13,874,95,238,.399,24,65,.369,71,173,.410,20,23,.870,13,87,100,24,14,2,28,80,281,4.8
3860,Grant Mullins\grant-mullins-1,2013-14,Columbia,G,24,24,743,81,196,.413,43,87,.494,38,109,.349,80,89,.899,10,59,69,57,17,4,43,42,280,8.2
3861,Lance Crawford\lance-crawford-1,2014-15,Massachusetts-Lowell,G,29,13,830,83,205,.405,56,126,.444,27,79,.342,87,113,.770,16,67,83,66,18,1,58,64,280,5.9
3862,Bishop Daniels\bishop-daniels-1,2015-16,Rutgers,G,32,17,869,111,280,.396,99,238,.416,12,42,.286,46,67,.687,19,102,121,96,34,14,87,58,280,5.1
3863,Jalen Coleman-Lands\jalen-coleman-lands-1,2016-17,Illinois,G,35,15,850,94,257,.366,23,70,.329,71,187,.380,21,25,.840,7,75,82,34,24,4,35,73,280,4.3
3864,Joe Thomasson\joe-thomasson-1,2014-15,Wright State,G,28,23,872,94,191,.492,76,132,.576,18,59,.305,74,95,.779,30,123,153,90,24,25,53,84,280,9.0
3865,Eric Parrish\eric-parrish-1,2017-18,Akron,G,32,21,864,108,209,.517,85,138,.616,23,71,.324,41,66,.621,51,100,151,44,39,7,45,73,280,7.3
3866,Marvin Jean-Pierre\marvin-jean-pierre-1,2016-17,Louisiana-Monroe,G,31,13,722,107,222,.482,89,164,.543,18,58,.310,48,71,.676,42,63,105,41,24,12,53,67,280,6.1
3867,Hyjii Thomas\hyjii-thomas-1,2013-14,Texas-San Antonio,G,30,8,716,84,200,.420,70,152,.461,14,48,.292,98,140,.700,28,58,86,50,25,5,74,46,280,5.5
3868,Rysheed Jordan\rysheed-jordan-1,2013-14,St. John's (NY),G,29,22,761,100,240,.417,83,179,.464,17,61,.279,63,95,.663,31,60,91,88,36,1,65,86,280,6.1
3869,Kendal Williams\kendal-williams-1,2014-15,Delaware State,G,33,27,814,96,256,.375,57,146,.390,39,110,.355,49,63,.778,24,61,85,93,14,1,48,63,280,5.3
3870,Kory Brown\kory-brown-1,2015-16,North Dakota State,G,27,26,786,104,213,.488,90,167,.539,14,46,.304,58,77,.753,40,135,175,67,36,26,54,82,280,9.2
3871,Levi Bradley\levi-bradley-1,2016-17,Northern Illinois,G,32,9,721,104,253,.411,89,193,.461,15,60,.250,57,74,.770,32,102,134,25,13,5,33,80,280,5.0
3872,Noah Robotham\noah-robotham-1,2015-16,Akron,G,29,27,922,91,219,.416,35,79,.443,56,140,.400,42,56,.750,13,67,80,108,34,3,41,52,280,8.2
3873,Keith Shamburger\keith-shamburger-1,2014-15,Missouri,G,32,31,1092,80,211,.379,37,80,.463,43,131,.328,77,86,.895,17,89,106,124,37,4,60,68,280,7.5
3874,Khalen Cumberlander\khalen-cumberlander-1,2015-16,Central Connecticut State,G,26,21,787,99,261,.379,75,162,.463,24,99,.242,58,101,.574,16,80,96,72,27,2,74,61,280,5.2
3875,Khallid Hart\khallid-hart-1,2014-15,Marist,G,19,18,627,85,219,.388,51,110,.464,34,109,.312,76,89,.854,7,44,51,31,17,2,37,50,280,8.2
3876,Lavon Long\lavon-long-1,2014-15,Siena,G,27,24,733,102,222,.459,95,204,.466,7,18,.389,69,97,.711,42,89,131,46,25,17,61,113,280,6.4
3877,Jovante' Spivey\jovante-spivey-1,2015-16,Sam Houston State,G,34,23,837,77,218,.353,48,119,.403,29,99,.293,97,138,.703,22,59,81,85,25,2,47,71,280,5.5
3878,Byron Frohnen\byron-frohnen-1,2016-17,Texas-San Antonio,G,33,33,995,111,235,.472,109,212,.514,2,23,.087,56,99,.566,82,139,221,49,30,9,43,75,280,7.3
3879,Jarrod West\jarrod-west-2,2017-18,Marshall,G,36,35,1165,93,216,.431,30,63,.476,63,153,.412,31,47,.660,13,81,94,106,57,2,52,75,280,6.8
3880,Javonte Maynor\javonte-maynor-1,2013-14,Cal State Bakersfield,G,32,24,904,92,233,.395,17,40,.425,75,193,.389,21,31,.677,19,34,53,22,33,3,23,79,280,5.3
3881,Damarcus Harrison\damarcus-harrison-1,2013-14,Clemson,G,36,22,786,91,234,.389,55,131,.420,36,103,.350,61,73,.836,21,77,98,46,22,7,32,51,279,5.3
3882,Will Sullivan\will-sullivan-1,2013-14,Miami (OH),G,31,25,956,97,196,.495,55,93,.591,42,103,.408,43,52,.827,14,73,87,49,39,2,29,52,279,7.5
3883,Devon Turk\devon-turk-1,2013-14,Loyola (IL),G,32,0,684,90,220,.409,26,54,.481,64,166,.386,35,41,.854,8,61,69,22,12,5,43,59,279,4.6
3884,Anthony Gaston\anthony-gaston-1,2017-18,Grambling,G,30,21,773,102,259,.394,78,169,.462,24,90,.267,51,71,.718,29,59,88,43,45,5,52,80,279,5.4
3885,Trevor Lyons\trevor-lyons-1,2015-16,Air Force,G,22,22,707,83,211,.393,63,153,.412,20,58,.345,93,144,.646,9,69,78,61,31,0,42,42,279,8.5
3886,Duane Notice\duane-notice-1,2013-14,South Carolina,G,34,22,856,90,237,.380,69,179,.385,21,58,.362,78,116,.672,35,64,99,99,20,4,89,72,279,4.5
3887,CJ Walker\cj-walker-2,2017-18,Florida State,G,35,34,804,94,228,.412,55,118,.466,39,110,.355,52,71,.732,8,81,89,85,35,5,61,84,279,5.2
3888,Malik Benlevi\malik-benlevi-1,2016-17,Georgia State,G,33,26,866,97,192,.505,63,113,.558,34,79,.430,51,75,.680,42,97,139,32,36,29,35,89,279,7.3
3889,Antonio Barton\antonio-barton-1,2013-14,Tennessee,G,37,28,929,93,249,.373,42,99,.424,51,150,.340,42,61,.689,16,65,81,76,22,4,36,66,279,4.9
3890,Kevon Harris\kevon-harris-1,2016-17,Stephen F. Austin,G,33,13,734,85,189,.450,64,126,.508,21,63,.333,88,125,.704,49,69,118,34,22,16,57,53,279,6.1
3891,Connor Cashaw\connor-cashaw-1,2016-17,Rice,G,35,34,913,103,232,.444,66,133,.496,37,99,.374,36,54,.667,38,149,187,63,27,6,40,55,279,6.7
3892,Jamaya Burr\jamaya-burr-1,2014-15,McNeese State,G,31,30,929,85,231,.368,78,193,.404,7,38,.184,102,143,.713,21,46,67,126,36,0,73,34,279,6.5
3893,Marcus Washington\marcus-washington-1,2016-17,Louisiana-Monroe,G,33,21,738,107,244,.439,94,192,.490,13,52,.250,52,69,.754,40,89,129,64,28,13,61,75,279,5.8
3894,Viont'e Daniels\vionte-daniels-1,2017-18,Washington State,G,31,31,1015,92,199,.462,21,43,.488,71,156,.455,24,31,.774,16,55,71,62,15,3,29,51,279,6.9
3895,Chris Thomas\chris-thomas-6,2016-17,Southern,G,33,12,764,96,232,.414,82,177,.463,14,55,.255,73,117,.624,62,93,155,27,19,16,44,88,279,5.4
3896,Alex Hobbs\alex-hobbs-1,2017-18,Boise State,G,32,8,817,113,231,.489,96,176,.545,17,55,.309,36,41,.878,12,72,84,82,13,1,72,45,279,5.4
3897,Max Guercy\max-guercy-1,2013-14,Rice,G,30,30,930,82,236,.347,45,114,.395,37,122,.303,78,97,.804,25,74,99,97,22,0,54,46,279,6.5
3898,DK Eldridge\dk-eldridge-1,2014-15,New Mexico State,G,34,25,880,102,262,.389,65,136,.478,37,126,.294,38,60,.633,26,64,90,74,37,2,63,61,279,4.9
3899,Gee McGhee\gee-mcghee-1,2015-16,Murray State,G,31,26,927,83,197,.421,54,118,.458,29,79,.367,84,123,.683,47,99,146,72,31,8,44,79,279,7.5
3900,Jaleel Wheeler\jaleel-wheeler-1,2016-17,Tulsa,G,30,28,876,91,204,.446,73,143,.510,18,61,.295,79,109,.725,10,118,128,59,16,9,68,55,279,5.9
3901,Austin Richie\austin-richie-1,2014-15,Western Michigan,G,28,26,907,81,207,.391,29,78,.372,52,129,.403,65,83,.783,10,40,50,63,27,2,34,62,279,6.9
3902,DeAngelo Stewart\deangelo-stewart-1,2015-16,Purdue-Fort Wayne,G,34,1,714,94,214,.439,33,72,.458,61,142,.430,30,43,.698,20,99,119,26,11,14,27,55,279,5.7
3903,Eugene German\eugene-german-1,2016-17,Northern Illinois,G,31,7,530,109,231,.472,93,174,.534,16,57,.281,45,73,.616,8,34,42,27,10,3,45,41,279,4.4
3904,Silas Melson\silas-melson-1,2016-17,Gonzaga,G,39,4,929,97,216,.449,54,106,.509,43,110,.391,42,50,.840,18,77,95,58,26,7,31,78,279,5.3
3905,Speedy Smith\kenneth-smith-1,2013-14,Louisiana Tech,G,36,35,1093,93,220,.423,55,116,.474,38,104,.365,55,84,.655,25,110,135,278,90,3,86,79,279,10.3
3906,Keenan Evans\keenan-evans-1,2015-16,Texas Tech,G,32,31,802,82,199,.412,64,151,.424,18,48,.375,96,127,.756,17,77,94,92,32,10,58,77,278,6.5
3907,Hayes Garrity\hayes-garrity-1,2013-14,Utah Valley,G,32,0,695,98,247,.397,68,154,.442,30,93,.323,52,65,.800,20,65,85,51,16,1,38,32,278,5.4
3908,Reece Chamberlain\reece-chamberlain-1,2014-15,Belmont,G,33,32,1031,90,207,.435,68,142,.479,22,65,.338,76,119,.639,57,121,178,198,55,5,84,70,278,9.5
3909,Aaric Armstead\aaric-armstead-1,2016-17,Northern Illinois,G,32,31,974,93,279,.333,65,185,.351,28,94,.298,64,96,.667,62,123,185,51,49,20,51,63,278,6.6
3910,Max Landis\max-landis-1,2014-15,Purdue-Fort Wayne,G,30,17,911,84,182,.462,44,70,.629,40,112,.357,70,81,.864,6,60,66,72,22,0,30,52,278,7.5
3911,KJ Feagin\kj-feagin-1,2016-17,Santa Clara,G,19,18,661,99,214,.463,48,110,.436,51,104,.490,29,33,.879,7,65,72,84,19,3,40,42,278,11.2
3912,Haanif Cheatham\haanif-cheatham-1,2016-17,Marquette,G,32,25,814,93,203,.458,80,163,.491,13,40,.325,79,103,.767,21,101,122,71,23,4,51,49,278,6.7
3913,Tanner Krebs\tanner-krebs-1,2017-18,Saint Mary's (CA),G,36,29,992,92,217,.424,33,68,.485,59,149,.396,35,42,.833,31,157,188,36,19,13,21,69,278,6.5
3914,Trelun Banks\trelun-banks-1,2013-14,Southern,G,32,24,851,93,267,.348,66,176,.375,27,91,.297,65,103,.631,12,69,81,107,28,6,84,69,278,4.3
3915,Kam Williams\kam-williams-1,2017-18,Ohio State,G,31,21,733,106,215,.493,64,121,.529,42,94,.447,24,29,.828,7,57,64,25,17,5,19,33,278,6.3
3916,Khalen Cumberlander\khalen-cumberlander-1,2014-15,Central Connecticut State,G,28,24,899,103,254,.406,65,137,.474,38,117,.325,34,53,.642,16,63,79,62,23,2,64,51,278,5.3
3917,Khari Price\khari-price-1,2015-16,Southern Mississippi,G,29,29,859,89,219,.406,49,104,.471,40,115,.348,60,72,.833,17,74,91,131,33,5,61,75,278,7.8
3918,Craig Bowman\craig-bowman-1,2015-16,Florida A&M,G,29,20,767,85,255,.333,53,146,.363,32,109,.294,76,114,.667,15,71,86,53,38,2,66,66,278,4.6
3919,Glen Dean\glen-dean-2,2013-14,Idaho,G,31,19,788,77,214,.360,32,91,.352,45,123,.366,79,96,.823,8,58,66,73,11,0,42,86,278,5.2
3920,Damarcus Croaker\damarcus-croaker-1,2015-16,Murray State,G,29,20,825,113,242,.467,89,168,.530,24,74,.324,28,54,.519,36,95,131,46,18,7,59,59,278,5.8
3921,Isaiah Washington\isaiah-washington-12,2017-18,Minnesota,G,32,4,641,102,279,.366,81,192,.422,21,87,.241,52,68,.765,19,65,84,75,18,2,48,38,277,4.9
3922,John Papale\john-papale-1,2014-15,Boston University,G,30,30,1111,95,234,.406,38,83,.458,57,151,.377,30,42,.714,14,68,82,102,19,7,40,56,277,7.0
3923,Javares Brent\javeres-brent-1,2013-14,Jackson State,G,31,25,886,91,276,.330,21,75,.280,70,201,.348,25,33,.758,12,91,103,18,31,4,45,59,277,4.2
3924,Jeremy Major\jeremy-major-1,2014-15,Pepperdine,G,32,29,929,93,245,.380,59,141,.418,34,104,.327,57,90,.633,20,88,108,115,50,7,67,88,277,6.3
3925,Michael Mayhew\michael-mayhew-1,2017-18,Portland State,G,34,20,683,89,226,.394,23,55,.418,66,171,.386,33,41,.805,29,55,84,51,40,0,47,70,277,5.6
3926,I.J. Ready\ij-ready-1,2015-16,Mississippi State,G,30,22,886,103,247,.417,77,156,.494,26,91,.286,45,56,.804,12,67,79,134,39,1,48,56,277,7.8
3927,William Jackson II\william-jacksonii-1,2017-18,Georgia,G,33,33,976,92,264,.348,40,98,.408,52,166,.313,41,54,.759,9,63,72,115,23,5,61,67,277,5.1
3928,Malik Marquetti\malik-marquetti-1,2017-18,Louisiana,G,34,29,923,91,222,.410,39,96,.406,52,126,.413,43,51,.843,35,85,120,63,28,6,43,58,277,6.3
3929,Desmond Bane\desmond-bane-1,2016-17,Texas Christian,G,39,13,807,102,198,.515,72,119,.605,30,79,.380,43,56,.768,27,86,113,38,12,9,39,74,277,5.0
3930,Zach Gengler\zach-gengler-1,2016-17,Portland State,G,31,30,836,106,212,.500,77,139,.554,29,73,.397,36,42,.857,17,51,68,75,52,5,35,89,277,7.5
3931,Joshua Filmore\joshua-filmore-1,2017-18,Southeastern Louisiana,G,30,26,927,93,241,.386,21,49,.429,72,192,.375,19,33,.576,8,58,66,62,25,0,31,31,277,6.3
3932,Lawrence White\lawrence-white-1,2016-17,UC-Davis,G,36,35,983,98,226,.434,74,152,.487,24,74,.324,57,92,.620,23,106,129,55,36,26,55,92,277,5.4
3933,Reveal Chukwujekwu\reveal-chukwujekwu-1,2015-16,Houston Baptist,G,34,22,791,95,189,.503,84,159,.528,11,30,.367,76,105,.724,54,117,171,52,19,4,67,52,277,6.3
3934,Shaun Lawton\shaun-lawton-1,2014-15,Maine,G,29,26,917,89,219,.406,66,139,.475,23,80,.288,76,100,.760,14,111,125,81,54,2,76,79,277,6.8
3935,Justin Burrell\justin-burrell-2,2013-14,Holy Cross,G,31,31,913,95,240,.396,52,119,.437,43,121,.355,44,53,.830,5,51,56,75,23,0,53,47,277,5.4
3936,Ike Iroegbu\ike-iroegbu-1,2014-15,Washington State,G,31,30,836,90,207,.435,64,134,.478,26,73,.356,71,95,.747,10,78,88,106,17,4,60,67,277,6.3
3937,Corey Henderson\corey-henderson-1,2016-17,Tulsa,G,32,4,718,89,243,.366,38,92,.413,51,151,.338,48,58,.828,4,30,34,38,17,2,41,41,277,4.3
3938,King McClure\king-mcclure-1,2017-18,Baylor,G,34,21,814,93,237,.392,51,117,.436,42,120,.350,49,64,.766,16,68,84,57,31,1,53,79,277,4.7
3939,Darryl Morsell\darryl-morsell-1,2017-18,Maryland,G,32,21,922,101,238,.424,98,213,.460,3,25,.120,72,99,.727,52,89,141,65,19,15,70,64,277,5.7
3940,Dayon Griffin\dayon-griffin-1,2017-18,Central Florida,G,32,4,877,95,271,.351,39,97,.402,56,174,.322,31,53,.585,22,108,130,38,26,9,42,44,277,5.1
3941,Greg Mortimer\greg-mortimer-1,2014-15,South Carolina State,G,31,24,783,92,221,.416,78,172,.453,14,49,.286,79,108,.731,30,46,76,48,15,4,62,39,277,5.0
3942,Sammy Mojica\sammy-mojica-1,2015-16,Drexel,G,31,20,880,98,279,.351,50,137,.365,48,142,.338,33,53,.623,34,74,108,63,25,19,51,86,277,5.0
3943,Denzel Johnson\denzel-johnson-1,2014-15,Santa Clara,G,32,32,1017,102,263,.388,68,172,.395,34,91,.374,39,51,.765,20,71,91,59,37,3,38,62,277,5.7
3944,Khy Kabellis\khy-kabellis-1,2015-16,North Dakota State,G,32,20,972,92,225,.409,56,115,.487,36,110,.327,57,81,.704,13,86,99,72,22,5,49,49,277,5.9
3945,Jake Pemberton\jake-pemberton-1,2016-17,Denver,G,30,28,963,93,215,.433,48,94,.511,45,121,.372,46,56,.821,4,79,83,131,43,5,72,75,277,7.4
3946,Solomon Poole\solomon-poole-1,2014-15,Florida Atlantic,G,22,21,635,100,296,.338,52,155,.335,48,141,.340,28,44,.636,13,54,67,49,18,4,73,58,276,3.9
3947,Marcellus Barksdale\marcellus-barksdale-1,2013-14,IUPUI,G,32,32,1074,83,198,.419,76,159,.478,7,39,.179,103,143,.720,42,174,216,117,35,24,70,82,276,8.3
3948,Andrew Brown\andrew-brown-3,2017-18,Furman,G,32,30,786,93,196,.474,32,55,.582,61,141,.433,29,38,.763,28,75,103,66,37,4,32,63,276,7.6
3949,Jordan Strawberry\jordan-strawberry-1,2015-16,Mercer,G,34,5,863,96,254,.378,62,159,.390,34,95,.358,50,60,.833,21,61,82,126,33,1,61,47,276,6.1
3950,Max Hazzard\max-hazzard-1,2017-18,UC-Irvine,G,33,7,750,93,257,.362,41,114,.360,52,143,.364,38,49,.776,10,56,66,64,17,0,55,49,276,4.2
3951,Montay Brandon\montay-brandon-1,2013-14,Florida State,G,36,36,1060,92,221,.416,83,185,.449,9,36,.250,83,135,.615,54,121,175,54,33,1,50,65,276,5.7
3952,Bobby Word\bobby-word-1,2014-15,Oral Roberts,G,33,9,761,86,219,.393,30,76,.395,56,143,.392,48,63,.762,19,60,79,28,11,5,17,49,276,5.5
3953,Niem Stevenson\niem-stevenson-1,2017-18,Texas Tech,G,37,19,760,93,236,.394,60,153,.392,33,83,.398,57,83,.687,27,84,111,65,18,7,39,53,276,5.1
3954,Shawn Olden\shawn-olden-1,2014-15,Pepperdine,G,30,28,855,81,217,.373,46,101,.455,35,116,.302,79,107,.738,23,50,73,55,30,8,54,62,276,5.7
3955,Wayne Sparrow\wayne-sparrow-1,2014-15,Maryland-Baltimore County,G,20,20,646,95,263,.361,63,170,.371,32,93,.344,54,84,.643,21,72,93,44,32,15,66,63,276,6.8
3956,Jeremy Sheppard\jeremy-sheppard-1,2016-17,East Carolina,G,30,13,797,93,255,.365,43,107,.402,50,148,.338,40,61,.656,12,52,64,104,32,1,79,59,276,5.1
3957,Quincy Smith\quincy-smith-1,2015-16,Hawaii,G,34,34,906,103,226,.456,86,168,.512,17,58,.293,53,113,.469,29,80,109,85,57,4,51,72,276,6.4
3958,Kentrell Barkley\kentrell-barkley-1,2017-18,East Carolina,G,23,21,741,103,224,.460,82,151,.543,21,73,.288,49,76,.645,42,125,167,51,30,15,51,50,276,9.6
3959,P.J. Thompson\pj-thompson-1,2017-18,Purdue,G,37,37,1032,81,176,.460,21,40,.525,60,136,.441,54,64,.844,17,49,66,66,43,2,32,69,276,6.5
3960,Trey Kennedy\trey-kennedy-1,2013-14,Southern Utah,G,29,21,779,85,215,.395,72,160,.450,13,55,.236,93,120,.775,6,42,48,65,14,5,75,50,276,4.6
3961,Kelvin Amayo\kelvin-amayo-1,2014-15,Iona,G,35,24,860,105,211,.498,101,190,.532,4,21,.190,62,123,.504,62,113,175,96,35,14,73,100,276,6.3
3962,Lew Stallworth\lew-stallworth-1,2016-17,Texas-Rio Grande Valley,G,32,26,821,92,212,.434,67,134,.500,25,78,.321,66,94,.702,18,59,77,116,33,4,69,64,275,6.4
3963,Donte Thomas\donte-thomas-2,2016-17,Arkansas State,G,32,31,903,84,233,.361,73,191,.382,11,42,.262,96,156,.615,22,121,143,177,28,7,89,80,275,6.5
3964,Jaqawn Raymond\jaqawn-raymond-1,2014-15,Middle Tennessee,G,36,29,1088,83,226,.367,41,104,.394,42,122,.344,67,81,.827,12,99,111,75,36,8,74,74,275,4.8
3965,Marquan Botley\marquan-botley-1,2015-16,Florida Atlantic,G,31,0,648,82,227,.361,33,102,.324,49,125,.392,62,73,.849,11,44,55,76,21,0,35,34,275,6.2
3966,A.J. Hess\aj-hess-1,2016-17,South Dakota State,G,29,20,747,84,215,.391,18,37,.486,66,178,.371,41,48,.854,14,86,100,17,15,9,24,41,275,6.3
3967,Marquis Wright\marquis-wright-2,2015-16,Siena,G,19,17,672,95,222,.428,69,163,.423,26,59,.441,59,72,.819,22,61,83,93,35,7,67,55,275,10.6
3968,Shawn Johnson\shawn-johnson-1,2015-16,Incarnate Word,G,29,24,784,93,211,.441,51,106,.481,42,105,.400,47,71,.662,30,160,190,26,27,34,28,54,275,8.4
3969,Desonta Bradford\desonta-bradford-1,2015-16,East Tennessee State,G,36,0,718,95,188,.505,74,141,.525,21,47,.447,64,79,.810,29,76,105,72,34,15,37,71,275,6.9
3970,Romello Walker\romello-walker-1,2014-15,Binghamton,G,32,31,986,100,281,.356,78,197,.396,22,84,.262,53,94,.564,38,109,147,31,30,7,63,64,275,4.0
3971,James Robinson\james-robinson-2,2013-14,Pittsburgh,G,36,36,1118,83,207,.401,59,137,.431,24,70,.343,85,107,.794,17,94,111,148,53,11,36,96,275,7.9
3972,Dylan Windler\dylan-windler-1,2016-17,Belmont,G,30,30,904,97,182,.533,60,89,.674,37,93,.398,44,60,.733,47,142,189,48,27,29,30,81,275,9.1
3973,Marquise Moore\marquise-moore-1,2014-15,George Mason,G,29,28,879,91,201,.453,85,181,.470,6,20,.300,87,110,.791,14,79,93,89,27,9,66,66,275,6.8
3974,Kris Davis\kris-davis-1,2013-14,Southern Illinois-Edwardsville,G,29,19,806,94,214,.439,59,125,.472,35,89,.393,52,79,.658,12,79,91,69,16,2,59,44,275,6.0
3975,Bryce Scott\bryce-scott-1,2014-15,Lafayette,G,33,29,954,93,220,.423,42,91,.462,51,129,.395,38,49,.776,21,87,108,79,32,0,36,58,275,6.7
3976,Caleb Green\caleb-green-2,2017-18,Holy Cross,G,31,31,1030,104,254,.409,70,144,.486,34,110,.309,33,45,.733,13,62,75,90,25,0,58,51,275,5.5
3977,Austin Dassent\austin-dassent-1,2016-17,Savannah State,G,28,12,575,92,223,.413,54,103,.524,38,120,.317,53,80,.663,28,80,108,73,26,2,65,69,275,6.2
3978,Jarryn Skeete\jarryn-skeete-1,2015-16,Buffalo,G,35,34,974,87,275,.316,26,90,.289,61,185,.330,40,57,.702,21,90,111,78,31,2,46,76,275,4.7
3979,Javante McCoy\javante-mccoy-1,2017-18,Boston University,G,31,27,793,100,225,.444,60,133,.451,40,92,.435,35,54,.648,12,68,80,52,29,5,56,55,275,5.5
3980,Josh Brown\josh-brown-3,2015-16,Temple,G,33,32,1195,99,240,.413,72,162,.444,27,78,.346,50,68,.735,13,146,159,162,41,15,46,67,275,8.6
3981,Christian Hairston\christian-hairston-1,2015-16,Elon,G,32,17,689,116,191,.607,116,191,.607,0,0,,43,79,.544,52,135,187,36,19,15,41,82,275,7.2
3982,Tarin Smith\tarin-smith-1,2016-17,Duquesne,G,32,32,915,97,253,.383,86,201,.428,11,52,.212,69,106,.651,15,96,111,99,34,11,66,38,274,5.9
3983,Dimitry Akanda-Coronel\dimitry-akanda-coronel-1,2013-14,Maine,G,26,21,586,98,255,.384,69,161,.429,29,94,.309,49,82,.598,15,60,75,39,23,6,48,58,274,5.1
3984,Cordarius Johnson\cordarius-johnson-1,2013-14,Louisiana Tech,G,37,9,768,93,249,.373,54,113,.478,39,136,.287,49,76,.645,45,104,149,33,45,10,39,55,274,5.5
3985,Kevin Aronis\kevin-aronis-1,2013-14,New Mexico State,G,36,8,702,89,205,.434,9,22,.409,80,183,.437,16,22,.727,3,51,54,13,11,4,17,51,274,4.6
3986,Jibri Bryan\jibri-bryan-1,2014-15,Mercer,G,35,33,1040,89,244,.365,45,90,.500,44,154,.286,52,67,.776,29,128,157,44,49,7,45,91,274,5.6
3987,Jordan Chatman\jordan-chatman-1,2016-17,Boston College,G,32,7,794,87,208,.418,29,69,.420,58,139,.417,42,46,.913,12,57,69,34,20,7,36,54,274,5.6
3988,Francis Kiapway\francis-kiapway-1,2016-17,Ball State,G,34,21,841,84,238,.353,24,65,.369,60,173,.347,46,59,.780,6,50,56,37,14,3,35,57,274,4.1
3989,Juwan Parker\juwan-parker-1,2017-18,Georgia,G,33,22,806,87,222,.392,60,148,.405,27,74,.365,73,85,.859,18,103,121,38,13,5,42,54,274,5.2
3990,Steve McWhorter\steve-mcwhorter-1,2013-14,Milwaukee,G,35,35,1195,92,243,.379,64,153,.418,28,90,.311,62,93,.667,28,116,144,140,51,16,76,107,274,6.4
3991,Zach Glotta\zach-glotta-1,2017-18,Austin Peay,G,34,5,749,86,229,.376,29,65,.446,57,164,.348,45,55,.818,13,44,57,80,29,0,31,69,274,5.7
3992,Ceasar DeJesus\ceasar-dejesus-1,2017-18,Central Florida,G,32,32,877,94,226,.416,77,181,.425,17,45,.378,69,93,.742,14,59,73,58,24,0,61,50,274,4.8
3993,James Harrison\james-harrison-1,2017-18,Lamar,G,32,19,585,99,247,.401,40,82,.488,59,165,.358,17,21,.810,19,54,73,22,19,4,28,67,274,4.7
3994,Tevonn Walker\tevonn-walker-1,2015-16,Valparaiso,G,31,26,701,97,245,.396,69,153,.451,28,92,.304,52,80,.650,28,76,104,50,24,3,41,75,274,5.2
3995,Jeremy Miller\jeremy-miller-2,2015-16,Northeastern,G,33,25,679,96,188,.511,65,105,.619,31,83,.373,51,67,.761,45,85,130,14,12,27,32,103,274,6.0
3996,Kain Harris\kain-harris-1,2016-17,Tulane,G,30,0,551,92,242,.380,50,120,.417,42,122,.344,48,59,.814,13,37,50,10,9,4,40,53,274,3.8
3997,Joe De Ciman\joe-de-ciman-1,2013-14,Colorado State,G,32,22,815,94,213,.441,60,115,.522,34,98,.347,52,76,.684,10,71,81,39,15,15,28,86,274,5.4
3998,David Nwaba\david-nwaba-1,2014-15,Cal Poly,G,24,20,642,101,236,.428,99,226,.438,2,10,.200,70,110,.636,35,78,113,35,31,14,36,50,274,7.9
3999,Caleb Homesley\caleb-homesley-1,2017-18,Liberty,G,35,4,688,98,196,.500,67,109,.615,31,87,.356,47,65,.723,16,143,159,67,26,11,52,63,274,6.5
4000,Chris Clarke\chris-clarke-2,2016-17,Virginia Tech,G,24,19,694,97,165,.588,94,152,.618,3,13,.231,77,114,.675,35,140,175,79,30,7,49,48,274,11.3
4001,Parker Jackson-Cartwright\parker-jackson-cartwright-1,2017-18,Arizona,G,35,35,1120,90,206,.437,40,86,.465,50,120,.417,44,59,.746,8,75,83,156,50,4,65,78,274,7.2
4002,Dontae Caldwell\dontae-caldwell-1,2016-17,Maryland-Eastern Shore,G,32,28,813,107,247,.433,75,142,.528,32,105,.305,27,49,.551,44,126,170,44,24,11,48,89,273,5.7
4003,Corey Henson\corey-henson-1,2014-15,Wagner,G,30,22,812,101,256,.395,60,129,.465,41,127,.323,30,40,.750,21,45,66,47,26,2,54,75,273,4.5
4004,Isaiah Ross\isaiah-ross-1,2016-17,Missouri-Kansas City,G,34,10,584,87,221,.394,23,51,.451,64,170,.376,35,42,.833,12,53,65,19,16,1,29,64,273,4.4
4005,Marcus Marshall\marcus-marshall-1,2014-15,Missouri State,G,14,13,456,85,185,.459,44,95,.463,41,90,.456,62,69,.899,3,42,45,23,10,2,19,22,273,13.5
4006,Isaiah Washington\isaiah-washington-1,2017-18,Quinnipiac,G,33,31,1094,86,263,.327,38,106,.358,48,157,.306,53,78,.679,27,86,113,65,30,10,61,89,273,4.4
4007,Hakeem Baxter\hakeem-baxter-1,2014-15,Alabama-Birmingham,G,36,31,941,81,215,.377,66,150,.440,15,65,.231,96,121,.793,14,95,109,55,29,10,56,72,273,4.8
4008,Marcellus Barksdale\marcellus-barksdale-1,2015-16,IUPUI,G,32,31,928,97,218,.445,88,185,.476,9,33,.273,70,95,.737,42,120,162,51,50,30,57,78,273,7.3
4009,Shamiel Stevenson\shamiel-stevenson-1,2017-18,Pittsburgh,G,32,13,761,95,188,.505,80,148,.541,15,40,.375,68,112,.607,27,114,141,33,16,8,72,50,273,5.2
4010,Jordon Talley\jordon-talley-1,2015-16,North Carolina-Wilmington,G,32,15,788,87,227,.383,73,163,.448,14,64,.219,85,114,.746,29,77,106,126,32,0,45,95,273,6.8
4011,Jordan Roper\jordan-roper-1,2015-16,Clemson,G,31,31,1029,96,259,.371,57,144,.396,39,115,.339,42,57,.737,16,68,84,118,40,4,39,39,273,7.3
4012,Dakarai Allen\dakarai-allen-1,2016-17,San Diego State,G,33,33,932,102,194,.526,89,147,.605,13,47,.277,56,86,.651,42,96,138,47,44,28,52,97,273,7.0
4013,Shaqquan Aaron\shaqquan-aaron-1,2016-17,Southern California,G,36,20,748,91,232,.392,54,122,.443,37,110,.336,54,75,.720,31,81,112,41,14,6,37,48,273,4.9
4014,Brandon Gfeller\brandon-gfeller-1,2015-16,Montana,G,33,27,783,81,208,.389,9,23,.391,72,185,.389,39,50,.780,13,59,72,35,21,5,27,93,273,5.1
4015,Jordan Lyons\jordan-lyons-1,2017-18,Furman,G,33,8,596,87,236,.369,29,57,.509,58,179,.324,41,52,.788,3,48,51,25,18,1,47,32,273,4.0
4016,Bobby Brown\bobby-brown-2,2015-16,Alabama State,G,31,18,792,105,298,.352,74,181,.409,31,117,.265,32,47,.681,48,131,179,18,18,14,42,54,273,4.8
4017,Lamonte Bearden\lamonte-bearden-1,2014-15,Buffalo,G,33,31,974,83,216,.384,71,170,.418,12,46,.261,95,129,.736,26,68,94,144,45,9,74,91,273,6.7
4018,Hameed Ali\hameed-ali-1,2013-14,Texas A&M-Corpus Christi,G,34,30,872,96,233,.412,65,152,.428,31,81,.383,50,68,.735,11,57,68,82,39,9,35,75,273,6.0
4019,Nick Rutherford\nick-rutherford-1,2016-17,Florida Atlantic,G,30,30,803,84,238,.353,75,204,.368,9,34,.265,96,138,.696,24,94,118,129,39,12,72,52,273,7.1
4020,Andre Yates\andre-yates-1,2015-16,Cleveland State,G,30,28,850,102,281,.363,70,179,.391,32,102,.314,37,60,.617,24,43,67,63,23,3,56,97,273,3.7
4021,Brandon Childress\brandon-childress-1,2017-18,Wake Forest,G,30,5,786,86,227,.379,47,124,.379,39,103,.379,62,74,.838,13,67,80,109,29,1,61,63,273,6.4
4022,Jalen Adaway\jalen-adaway-1,2017-18,Miami (OH),G,32,28,918,105,215,.488,87,146,.596,18,69,.261,45,64,.703,43,116,159,30,19,5,42,48,273,6.4
4023,Khadeen Carrington\khadeen-carrington-1,2014-15,Seton Hall,G,31,10,776,90,235,.383,73,175,.417,17,60,.283,76,101,.752,27,62,89,57,24,6,50,75,273,5.2
4024,Ronnie Suggs\ronnie-suggs-1,2015-16,Bradley,G,32,19,965,91,271,.336,61,156,.391,30,115,.261,61,87,.701,20,109,129,42,20,6,57,82,273,3.7
4025,Georgios Angelou\georgios-angelou-1,2016-17,Saint Francis (PA),G,34,13,764,87,218,.399,19,42,.452,68,176,.386,30,36,.833,4,42,46,73,18,1,57,40,272,4.8
4026,Avery Moore\avery-moore-1,2014-15,Jacksonville State,G,30,16,800,88,253,.348,23,54,.426,65,199,.327,31,37,.838,10,54,64,52,22,3,28,51,272,5.4
4027,Isiah Osborne\isiah-osborne-1,2017-18,Texas-El Paso,G,29,19,781,92,244,.377,51,119,.429,41,125,.328,47,75,.627,15,91,106,30,19,3,25,39,272,5.7
4028,Tramique Sutherland\tramique-sutherland-1,2014-15,Bradley,G,24,24,864,93,260,.358,79,215,.367,14,45,.311,72,96,.750,36,57,93,73,25,0,57,48,272,6.7
4029,Jamar Sandfer\jamar-sandfer-1,2017-18,Southern,G,33,28,739,95,229,.415,65,150,.433,30,79,.380,52,65,.800,43,79,122,46,25,17,46,94,272,5.6
4030,Eliel Gonzalez\eliel-gonzalez-1,2016-17,North Carolina A&T,G,27,14,711,92,219,.420,64,145,.441,28,74,.378,60,82,.732,31,66,97,77,16,2,71,59,272,6.1
4031,Bryan Alberts\bryan-alberts-1,2017-18,Cal State Long Beach,G,24,19,684,98,254,.386,39,96,.406,59,158,.373,17,24,.708,9,33,42,24,17,7,21,43,272,6.1
4032,Nolan Cressler\nolan-cressler-1,2016-17,Vanderbilt,G,35,22,828,107,208,.514,72,127,.567,35,81,.432,23,33,.697,28,118,146,61,19,1,45,61,272,6.1
4033,Obi Okolie\obi-okolie-1,2016-17,Brown,G,30,29,845,96,221,.434,74,153,.484,22,68,.324,58,86,.674,27,92,119,36,16,1,56,59,272,5.1
4034,Derrick Colter\derrick-colter-1,2013-14,Duquesne,G,30,30,773,87,240,.363,38,98,.388,49,142,.345,49,70,.700,14,61,75,101,20,2,54,64,272,5.7
4035,Daniel Mullings\daniel-mullings-1,2014-15,New Mexico State,G,22,18,637,83,192,.432,70,156,.449,13,36,.361,93,132,.705,42,66,108,59,47,9,51,58,272,10.2
4036,Giovanni De Nicolao\giovanni-denicolao-1,2016-17,Texas-San Antonio,G,33,33,899,100,310,.323,77,222,.347,23,88,.261,49,73,.671,8,79,87,108,57,2,80,111,272,3.8
4037,Derrick Gordon\derrick-gordon-1,2015-16,Seton Hall,G,34,4,802,98,242,.405,83,188,.441,15,54,.278,61,104,.587,38,73,111,56,35,8,63,67,272,4.8
4038,Martez Walker\martez-walker-1,2015-16,Oakland,G,26,13,602,75,161,.466,42,81,.519,33,80,.413,89,109,.817,37,57,94,25,11,9,25,45,272,8.3
4039,Nicholas Paulos\nicholas-paulos-1,2013-14,North Carolina-Greensboro,G,32,32,948,93,222,.419,24,33,.727,69,189,.365,16,18,.889,16,98,114,32,14,12,32,73,271,5.5
4040,George Willborn III\george-willborniii-1,2017-18,Texas-San Antonio,G,35,17,591,94,203,.463,80,163,.491,14,40,.350,69,121,.570,57,90,147,42,23,7,43,78,271,5.6
4041,Matt Halvorsen\matt-halvorsen-1,2017-18,Western Carolina,G,32,15,713,72,209,.344,13,34,.382,59,175,.337,68,80,.850,5,31,36,32,15,0,33,31,271,4.8
4042,DeAndre Harris\deandre-harris-1,2016-17,Nicholls State,G,16,6,326,81,189,.429,58,122,.475,23,67,.343,86,113,.761,13,32,45,33,22,2,49,44,271,9.9
4043,Darell Combs\darell-combs-1,2013-14,Eastern Michigan,G,36,5,542,84,249,.337,48,139,.345,36,110,.327,67,88,.761,9,38,47,50,16,1,56,66,271,3.0
4044,Jahvon Blair\jahvon-blair-1,2017-18,Georgetown,G,30,2,645,81,244,.332,32,92,.348,49,152,.322,60,70,.857,26,39,65,52,12,0,44,32,271,5.0
4045,T.J. Carpenter\tj-carpenter-1,2013-14,Nicholls State,G,29,22,775,90,261,.345,32,74,.432,58,187,.310,33,56,.589,26,76,102,35,17,4,34,83,271,4.6
4046,Earl Peterson\earl-peterson-1,2015-16,Loyola (IL),G,31,27,848,93,212,.439,74,169,.438,19,43,.442,66,88,.750,9,68,77,67,26,7,52,43,271,6.0
4047,Ron Mvouika\ron-mvouika-1,2015-16,St. John's (NY),G,32,30,855,88,221,.398,40,96,.417,48,125,.384,47,71,.662,20,109,129,57,22,7,56,96,271,5.0
4048,Dikymbe Martin\dikymbe-martin-1,2016-17,UC-Riverside,G,29,17,781,109,244,.447,81,171,.474,28,73,.384,25,30,.833,14,53,67,75,44,3,51,57,271,6.6
4049,Lyrik Shreiner\lyrik-shreiner-1,2017-18,Cal State Northridge,G,30,29,875,99,218,.454,83,163,.509,16,55,.291,57,74,.770,35,107,142,60,24,8,73,67,271,6.0
4050,Amar Stukes\amar-stukes-1,2017-18,La Salle,G,32,32,1132,93,206,.451,70,151,.464,23,55,.418,62,69,.899,22,57,79,99,37,4,49,82,271,6.9
4051,Evan Hymes\evan-hymes-1,2014-15,Siena,G,30,15,611,88,213,.413,63,135,.467,25,78,.321,70,94,.745,15,20,35,47,25,0,46,54,271,5.1
4052,Raymone Andrews\raymone-andrews-1,2013-14,Stetson,G,30,27,889,80,229,.349,46,119,.387,34,110,.309,77,105,.733,5,66,71,116,29,8,66,95,271,5.6
4053,Demetrius Troy\demetrius-troy-1,2017-18,North Carolina-Greensboro,G,35,33,898,99,238,.416,46,101,.455,53,137,.387,20,32,.625,5,75,80,132,46,1,78,40,271,6.0
4054,Isaiah McCray\isaiah-mccray-1,2014-15,Purdue-Fort Wayne,G,31,31,894,90,218,.413,50,108,.463,40,110,.364,51,105,.486,22,151,173,72,40,31,49,88,271,7.1
4055,A.J. Hess\aj-hess-1,2013-14,Southern Utah,G,29,25,783,87,221,.394,39,95,.411,48,126,.381,49,56,.875,13,103,116,34,9,4,33,65,271,5.7
4056,Derric Jean\derric-jean-1,2016-17,Louisiana Tech,G,33,33,941,85,234,.363,51,130,.392,34,104,.327,67,90,.744,31,58,89,109,37,13,63,77,271,6.1
4057,Malik Harmon\malik-harmon-1,2013-14,Saint Francis (PA),G,31,31,931,75,224,.335,30,95,.316,45,129,.349,76,110,.691,13,73,86,90,24,2,52,58,271,5.6
4058,Brian Holmes\brian-holmes-2,2013-14,Georgia Southern,G,30,29,900,83,210,.395,36,84,.429,47,126,.373,58,77,.753,4,70,74,73,27,4,46,58,271,6.2
4059,Patrick Holloway\patrick-holloway-1,2013-14,George Mason,G,31,3,648,98,245,.400,47,121,.388,51,124,.411,24,34,.706,16,31,47,21,13,0,19,60,271,4.5
4060,Jackson Trapp\jackson-trapp-1,2013-14,Florida Atlantic,G,31,27,884,92,266,.346,42,109,.385,50,157,.318,37,51,.725,32,64,96,50,21,11,42,57,271,5.0
4061,Thomas Bropleh\thomas-bropleh-1,2013-14,Boise State,G,34,6,666,91,195,.467,42,80,.525,49,115,.426,40,50,.800,25,71,96,41,18,6,24,77,271,5.9
4062,Tyler Peterson\tyler-peterson-2,2017-18,South Dakota,G,35,18,851,100,213,.469,79,141,.560,21,72,.292,50,66,.758,28,86,114,65,32,4,45,86,271,5.8
4063,Javan Felix\javan-felix-1,2014-15,Texas,G,31,4,723,96,231,.416,45,101,.446,51,130,.392,27,36,.750,13,54,67,61,11,3,49,36,270,5.2
4064,Keyshawn Woods\keyshawn-woods-1,2014-15,Charlotte,G,32,3,813,103,211,.488,62,123,.504,41,88,.466,23,34,.676,14,61,75,39,17,3,39,58,270,5.4
4065,Patrick Heckmann\patrick-heckmann-1,2014-15,Boston College,G,32,32,938,93,198,.470,68,111,.613,25,87,.287,59,75,.787,37,103,140,87,40,12,61,90,270,7.2
4066,Jared Hamilton\jared-hamilton-1,2015-16,Jacksonville State,G,30,29,886,109,246,.443,104,224,.464,5,22,.227,47,73,.644,59,89,148,42,23,8,29,49,270,6.9
4067,Jeremiah Williams\jeremiah-williams-2,2014-15,Canisius,G,33,8,718,89,226,.394,46,109,.422,43,117,.368,49,59,.831,13,52,65,59,34,5,53,54,270,5.2
4068,Greg Alexander\greg-alexander-1,2016-17,Mount St. Mary's,G,35,13,907,92,237,.388,20,36,.556,72,201,.358,14,23,.609,12,71,83,10,17,11,20,54,270,4.5
4069,Rozell Nunn\rozell-nunn-1,2013-14,Southern Illinois-Edwardsville,G,31,29,740,106,221,.480,80,154,.519,26,67,.388,32,43,.744,34,94,128,33,24,0,44,73,270,5.8
4070,James McGee\james-mcgee-1,2017-18,Southern Utah,G,31,29,928,78,199,.392,27,66,.409,51,133,.383,63,83,.759,7,57,64,75,26,8,32,66,270,6.5
4071,Mikel Trapp\mikel-trapp-1,2014-15,Bethune-Cookman,G,31,19,943,92,243,.379,31,62,.500,61,181,.337,25,35,.714,14,74,88,37,14,0,42,60,270,4.5
4072,Jamail Jones\jamail-jones-1,2014-15,Florida Gulf Coast,G,23,23,675,101,234,.432,70,147,.476,31,87,.356,37,54,.685,29,95,124,24,9,3,35,39,270,7.2
4073,Bryce Pressley\bryce-pressley-1,2013-14,Portland,G,31,30,916,98,213,.460,61,132,.462,37,81,.457,37,50,.740,26,82,108,104,27,14,46,73,270,7.5
4074,Jordan Cohen\jordan-cohen-1,2017-18,Lehigh,G,29,8,729,100,207,.483,78,140,.557,22,67,.328,48,53,.906,28,75,103,71,27,8,37,54,270,7.9
4075,Larry Wideman\larry-wideman-1,2013-14,Furman,G,30,28,896,92,256,.359,45,117,.385,47,139,.338,39,56,.696,11,68,79,32,9,3,44,58,270,3.8
4076,John Green\john-green-3,2015-16,UC-Santa Barbara,G,25,8,580,91,232,.392,65,158,.411,26,74,.351,62,90,.689,28,99,127,37,24,4,41,69,270,6.6
4077,Torry Johnson\torry-johnson-1,2015-16,Northern Arizona,G,29,26,843,92,203,.453,77,160,.481,15,43,.349,71,108,.657,22,54,76,46,18,2,47,81,270,5.3
4078,Carlin Dupree\carlin-dupree-1,2016-17,North Dakota State,G,30,29,884,99,236,.419,88,189,.466,11,47,.234,61,88,.693,18,82,100,62,30,4,57,53,270,5.6
4079,Dusty Baker\dusty-baker-1,2016-17,Weber State,G,34,0,642,77,146,.527,30,57,.526,47,89,.528,69,83,.831,15,59,74,53,17,1,32,49,270,6.6
4080,Eric Green\eric-green-1,2013-14,Holy Cross,G,34,27,1021,108,234,.462,101,201,.502,7,33,.212,47,70,.671,49,86,135,72,58,15,54,54,270,7.2
4081,Kamau Stokes\kamau-stokes-1,2017-18,Kansas State,G,30,20,809,85,231,.368,44,101,.436,41,130,.315,59,77,.766,12,64,76,103,35,1,56,39,270,6.6
4082,Julian Jacobs\julian-jacobs-1,2014-15,Southern California,G,32,22,866,106,211,.502,97,179,.542,9,32,.281,49,73,.671,34,103,137,113,36,13,84,72,270,6.9
4083,Isaiah Jackson\isaiah-jackson-2,2014-15,George Mason,G,31,23,811,81,233,.348,50,146,.342,31,87,.356,77,109,.706,32,88,120,41,25,1,63,63,270,4.6
4084,Zeek Woodley\zikiteran-woodley-1,2016-17,Northwestern State,G,14,11,412,91,179,.508,64,117,.547,27,62,.435,60,69,.870,22,27,49,10,11,2,14,30,269,13.8
4085,Jabari Sandifer\jabari-sandifer-1,2013-14,Western Illinois,G,30,20,867,87,222,.392,65,150,.433,22,72,.306,73,101,.723,10,65,75,92,35,1,83,78,269,5.0
4086,Evan Conti\evan-conti-1,2014-15,Quinnipiac,G,30,13,810,86,236,.364,38,97,.392,48,139,.345,49,63,.778,40,105,145,77,13,3,56,60,269,6.0
4087,Darnell Edge\darnell-edge-1,2016-17,Fairleigh Dickinson,G,30,16,843,96,191,.503,66,109,.606,30,82,.366,47,52,.904,18,73,91,40,26,1,36,59,269,6.7
4088,Trent Forrest\trent-forrest-1,2017-18,Florida State,G,34,2,871,87,177,.492,84,163,.515,3,14,.214,92,132,.697,44,123,167,138,53,12,59,60,269,9.0
4089,Elijah Bryant\elijah-bryant-1,2016-17,Brigham Young,G,23,9,567,83,195,.426,58,105,.552,25,90,.278,78,98,.796,14,68,82,51,21,8,36,51,269,8.4
4090,Josh James\josh-james-2,2013-14,Monmouth,G,32,7,797,99,230,.430,90,191,.471,9,39,.231,62,120,.517,19,68,87,101,32,3,68,68,269,5.2
4091,Caris LeVert\caris-levert-1,2014-15,Michigan,G,18,18,645,93,221,.421,61,142,.430,32,79,.405,51,63,.810,5,83,88,67,32,7,39,31,269,11.5
4092,Joe De Ciman\joe-de-ciman-1,2014-15,Colorado State,G,34,34,943,85,213,.399,40,95,.421,45,118,.381,54,63,.857,16,97,113,56,16,20,33,90,269,5.6
4093,Reese Morgan\reese-morgan-1,2014-15,Cal Poly,G,27,0,583,66,181,.365,27,57,.474,39,124,.315,98,114,.860,30,55,85,31,19,3,27,66,269,7.0
4094,Chris Clarke\chris-clarke-2,2017-18,Virginia Tech,G,33,0,814,101,176,.574,87,143,.608,14,33,.424,53,82,.646,34,175,209,98,31,4,75,55,269,7.8
4095,Ja'Mill Powell\jamill-powell-1,2014-15,Eastern Kentucky,G,33,22,730,84,218,.385,43,97,.443,41,121,.339,60,82,.732,21,43,64,37,24,9,48,75,269,4.5
4096,Shakir Brown\shakir-brown-1,2016-17,James Madison,G,30,12,683,93,267,.348,50,116,.431,43,151,.285,40,55,.727,32,77,109,33,33,3,45,72,269,4.8
4097,Connor Cashaw\connor-cashaw-1,2015-16,Rice,G,32,17,956,94,222,.423,50,107,.467,44,115,.383,37,62,.597,33,106,139,38,30,2,41,67,269,5.8
4098,Parker Wentz\parker-wentz-1,2015-16,Abilene Christian,G,31,28,918,87,202,.431,18,48,.375,69,154,.448,26,31,.839,5,51,56,27,37,3,27,65,269,5.9
4099,David Collins\david-collins-3,2017-18,South Florida,G,27,12,668,84,169,.497,64,121,.529,20,48,.417,81,113,.717,13,53,66,65,28,3,70,82,269,6.3
4100,KJ Robinson\kj-robinson-1,2017-18,Omaha,G,28,27,816,100,262,.382,59,148,.399,41,114,.360,28,34,.824,5,57,62,74,23,3,68,39,269,4.9
4101,Chad Holley\chad-holley-2,2013-14,Massachusetts-Lowell,G,26,25,864,74,215,.344,45,120,.375,29,95,.305,91,115,.791,3,61,64,89,29,1,63,62,268,6.2
4102,Khailil Richard\khailil-richard-1,2017-18,Siena,G,29,9,673,98,225,.436,66,152,.434,32,73,.438,40,50,.800,14,50,64,41,13,1,48,50,268,5.0
4103,Cane Broome\cane-broome-1,2017-18,Cincinnati,G,34,3,698,95,205,.463,63,123,.512,32,82,.390,46,65,.708,16,36,52,95,31,2,51,44,268,6.1
4104,Marlon Beck\marlon-beck-1,2013-14,Binghamton,G,29,20,951,86,262,.328,45,113,.398,41,149,.275,55,90,.611,11,51,62,83,33,0,62,58,268,4.6
4105,Patrick Wallace\patrick-wallace-1,2015-16,Charleston Southern,G,30,11,753,87,238,.366,15,38,.395,72,200,.360,22,25,.880,6,43,49,45,12,0,27,56,268,4.9
4106,Liam O'Reilly\liam-oreilly-1,2016-17,Gardner-Webb,G,33,17,929,93,234,.397,34,73,.466,59,161,.366,23,34,.676,9,87,96,49,24,9,40,51,268,5.3
4107,Eddy Polanco\eddy-polanco-1,2017-18,Southeastern Louisiana,G,33,7,634,71,196,.362,35,84,.417,36,112,.321,90,113,.796,32,77,109,54,21,5,45,46,268,5.9
4108,Travon Baker\travon-baker-1,2013-14,Northern Illinois,G,32,30,894,78,244,.320,46,117,.393,32,127,.252,80,109,.734,14,61,75,78,48,6,66,72,268,4.9
4109,Adama Adams\adama-louie-adams-1,2013-14,South Carolina State,G,30,18,736,82,225,.364,54,128,.422,28,97,.289,76,99,.768,8,66,74,83,17,0,85,76,268,4.0
4110,JoJo McGlaston\jojo-mcglaston-1,2016-17,Bradley,G,33,14,720,92,223,.413,60,131,.458,32,92,.348,52,78,.667,30,94,124,25,25,19,52,59,268,5.1
4111,John Gillon\john-gillon-1,2014-15,Colorado State,G,34,1,708,61,168,.363,27,82,.329,34,86,.395,112,141,.794,5,51,56,110,12,2,41,49,268,6.2
4112,Seth Allen\seth-allen-1,2013-14,Maryland,G,20,15,594,89,219,.406,40,90,.444,49,129,.380,41,55,.745,10,29,39,59,18,5,34,45,268,8.6
4113,Daniel Dion\daniel-dion-1,2015-16,New Hampshire,G,29,7,752,80,236,.339,32,82,.390,48,154,.312,60,67,.896,12,58,70,48,14,4,27,59,268,5.4
4114,David Stockton\david-stockton-1,2013-14,Gonzaga,G,36,36,1002,92,212,.434,76,143,.531,16,69,.232,68,90,.756,9,77,86,152,55,6,73,81,268,6.6
4115,Austin Price\austin-price-1,2013-14,Lehigh,G,32,23,836,88,235,.374,36,98,.367,52,137,.380,40,54,.741,14,48,62,27,33,14,28,72,268,5.1
4116,Taylor Dyson\taylor-dyson-1,2013-14,Hartford,G,33,15,620,83,224,.371,31,81,.383,52,143,.364,49,64,.766,12,67,79,15,18,3,37,52,267,4.2
4117,Rasheed Brooks\rasheed-brooks-1,2015-16,Mississippi,G,32,22,880,101,272,.371,57,124,.460,44,148,.297,21,38,.553,19,86,105,52,42,10,30,65,267,5.6
4118,Negus Webster-Chan\negus-webster-chan-1,2014-15,Hawaii,G,32,25,833,92,244,.377,28,88,.318,64,156,.410,19,31,.613,40,96,136,48,28,6,53,45,267,5.6
4119,Jack Montague\jack-montague-1,2014-15,Yale,G,32,32,949,90,227,.396,23,73,.315,67,154,.435,20,30,.667,10,51,61,65,31,0,56,49,267,5.1
4120,Martez Cameron\martez-cameron-1,2017-18,Morgan State,G,31,26,1010,99,267,.371,89,239,.372,10,28,.357,59,85,.694,27,62,89,137,46,2,91,60,267,5.6
4121,C.J. Cooper\cj-cooper-1,2014-15,Texas-El Paso,G,33,27,1018,82,214,.383,34,78,.436,48,136,.353,55,74,.743,5,54,59,106,21,1,43,45,267,6.0
4122,Reginald Gee\reginald-gee-1,2016-17,Alabama State,G,31,16,702,86,231,.372,45,117,.385,41,114,.360,54,82,.659,28,81,109,17,14,3,44,46,267,4.5
4123,Christian Ellis\christian-ellis-1,2017-18,Southern Illinois-Edwardsville,G,30,29,815,97,206,.471,90,183,.492,7,23,.304,66,108,.611,32,103,135,101,23,0,81,109,267,5.6
4124,Austin Reaves\austin-reaves-1,2017-18,Wichita State,G,33,11,708,85,189,.450,31,62,.500,54,127,.425,43,52,.827,13,90,103,67,16,8,38,53,267,6.4
4125,Leyton Hammonds\leyton-hammonds-1,2016-17,Oklahoma State,G,33,33,739,95,218,.436,58,110,.527,37,108,.343,40,47,.851,45,117,162,23,21,14,34,118,267,5.5
4126,Casey Jones\casey-jones-1,2016-17,Chattanooga,G,28,24,646,107,205,.522,93,163,.571,14,42,.333,39,50,.780,43,72,115,40,20,11,53,59,267,6.9
4127,Garrett Covington\garrett-covington-1,2017-18,Youngstown State,G,32,22,788,95,212,.448,71,142,.500,24,70,.343,53,76,.697,47,67,114,26,34,4,43,66,267,5.8
4128,Ryan Richardson\ryan-richardson-1,2016-17,Weber State,G,33,26,914,89,212,.420,26,57,.456,63,155,.406,26,36,.722,7,60,67,60,30,6,52,66,267,5.2
4129,Chris Porter-Bunton\chris-porter-bunton-1,2017-18,Austin Peay,G,34,34,833,91,215,.423,65,138,.471,26,77,.338,59,84,.702,40,109,149,68,42,3,65,117,267,5.4
4130,Zac Seljaas\zac-seljaas-1,2015-16,Brigham Young,G,35,1,699,88,178,.494,20,42,.476,68,136,.500,23,33,.697,19,81,100,41,21,16,21,63,267,6.5
4131,Sheriff Drammeh\sheriff-drammeh-1,2016-17,Hawaii,G,29,25,879,84,236,.356,49,129,.380,35,107,.327,64,84,.762,12,65,77,81,22,2,59,78,267,5.0
4132,Mike Gesell\mike-gesell-1,2015-16,Iowa,G,33,33,987,91,232,.392,75,186,.403,16,46,.348,69,93,.742,16,88,104,205,44,5,65,69,267,8.1
4133,Siyani Chambers\siyani-chambers-1,2016-17,Harvard,G,27,27,870,84,226,.372,57,141,.404,27,85,.318,71,84,.845,12,58,70,158,33,0,53,39,266,8.8
4134,Matt MacDonald\matt-macdonald-1,2013-14,Fairleigh Dickinson,G,31,31,940,83,230,.361,30,72,.417,53,158,.335,47,62,.758,30,79,109,24,26,1,35,63,266,5.2
4135,Wes Washpun\wes-washpun-1,2014-15,Northern Iowa,G,35,0,767,86,177,.486,71,139,.511,15,38,.395,79,116,.681,8,79,87,91,34,17,65,62,266,6.0
4136,Byron Frohnen\byron-frohnen-1,2017-18,Texas-San Antonio,G,35,35,956,109,204,.534,109,193,.565,0,11,.000,48,73,.658,65,188,253,74,32,14,43,67,266,8.1
4137,Isaiah White\isaiah-white-1,2017-18,Maine,G,24,22,662,98,226,.434,63,128,.492,35,98,.357,35,50,.700,28,83,111,21,29,30,36,52,266,8.1
4138,Elvar Fridriksson\elvar-frioriksson-1,2014-15,Long Island University,G,30,30,888,79,218,.362,40,98,.408,39,120,.325,69,97,.711,11,67,78,114,34,0,77,60,266,5.8
4139,Jordan McLaughlin\jordan-mclaughlin-1,2014-15,Southern California,G,22,21,696,89,253,.352,61,150,.407,28,103,.272,60,92,.652,11,55,66,100,33,5,50,26,266,8.3
4140,Lagerald Vick\lagerald-vick-1,2016-17,Kansas,G,36,6,878,97,219,.443,63,127,.496,34,92,.370,38,46,.826,36,91,127,34,21,15,40,58,266,5.4
4141,Corey Schaefer\corey-schaefer-1,2013-14,Lehigh,G,32,32,1041,100,224,.446,69,143,.483,31,81,.383,35,42,.833,6,78,84,80,23,3,41,47,266,6.1
4142,Robert Williams\robert-williams-2,2013-14,Alabama-Birmingham,G,31,14,793,89,220,.405,67,140,.479,22,80,.275,66,103,.641,98,99,197,44,23,6,46,59,266,7.1
4143,Kyle Foreman\kyle-foreman-1,2015-16,Boston University,G,29,26,848,89,208,.428,61,122,.500,28,86,.326,60,80,.750,6,72,78,112,33,3,76,63,266,6.4
4144,Rodrick Caldwell\rodrick-caldwell-1,2017-18,Bowling Green State,G,31,21,770,77,212,.363,41,102,.402,36,110,.327,76,103,.738,6,49,55,82,20,1,44,47,266,5.5
4145,Deion Holmes\deion-holmes-1,2016-17,South Carolina Upstate,G,30,14,657,88,220,.400,51,105,.486,37,115,.322,53,64,.828,19,44,63,35,9,0,53,61,266,4.2
4146,Kevin Blake\kevin-blake-1,2014-15,Elon,G,33,33,790,91,196,.464,68,135,.504,23,61,.377,61,100,.610,47,67,114,36,22,3,44,78,266,5.4
4147,Bobby Brown\bobby-brown-2,2013-14,Alabama State,G,28,2,653,91,218,.417,55,111,.495,36,107,.336,48,73,.658,33,105,138,26,15,13,24,32,266,7.1
4148,Sidy N'Dir\sidy-ndir-2,2017-18,New Mexico State,G,34,34,884,86,207,.415,54,109,.495,32,98,.327,62,82,.756,31,70,101,49,21,16,45,67,266,5.4
4149,Josiah Moore\josiah-moore-1,2014-15,Tennessee Tech,G,30,8,675,93,221,.421,63,135,.467,30,86,.349,50,74,.676,56,90,146,41,17,4,41,74,266,6.1
4150,Ben Richardson\ben-richardson-1,2016-17,Loyola (IL),G,32,32,1018,93,210,.443,41,87,.471,52,123,.423,27,41,.659,11,82,93,94,40,10,39,86,265,6.9
4151,Josh Hart\josh-hart-1,2013-14,Villanova,G,34,1,728,87,174,.500,61,91,.670,26,83,.313,65,96,.677,62,89,151,30,19,9,19,83,265,6.8
4152,Josh Kozinski\josh-kozinski-1,2015-16,Central Michigan,G,33,0,738,89,244,.365,5,10,.500,84,234,.359,3,4,.750,12,55,67,15,19,8,5,72,265,4.7
4153,Nick Sherod\nick-sherod-1,2016-17,Richmond,G,35,16,754,102,223,.457,63,106,.594,39,117,.333,22,26,.846,12,71,83,31,19,1,16,58,265,5.1
4154,Brendan Barry\brendan-barry-1,2017-18,Dartmouth,G,27,26,944,87,204,.426,34,84,.405,53,120,.442,38,44,.864,7,62,69,105,19,3,41,48,265,7.9
4155,Joe McDonald\joe-mcdonald-2,2013-14,George Washington,G,32,32,948,76,196,.388,51,132,.386,25,64,.391,88,125,.704,48,98,146,131,50,3,70,72,265,7.9
4156,Brocke Stepteau\brocke-stepteau-1,2017-18,Hawaii,G,28,17,799,87,170,.512,51,89,.573,36,81,.444,55,68,.809,12,45,57,75,14,0,46,55,265,7.0
4157,Mislav Brzoja\mislav-brzoja-1,2015-16,Evansville,G,34,0,818,83,190,.437,54,115,.470,29,75,.387,70,94,.745,32,88,120,106,30,5,62,79,265,6.4
4158,Cory Gensler\cory-gensler-1,2016-17,Campbell,G,37,30,1130,95,210,.452,46,88,.523,49,122,.402,26,36,.722,27,125,152,40,41,16,22,72,265,6.4
4159,Amir Bell\amir-bell-2,2014-15,Princeton,G,30,30,867,89,180,.494,76,135,.563,13,45,.289,74,117,.632,9,81,90,77,16,13,48,102,265,5.9
4160,Micah Mason\micah-mason-1,2013-14,Duquesne,G,25,22,711,90,159,.566,25,43,.581,65,116,.560,20,24,.833,9,62,71,74,21,1,13,46,265,10.2
4161,Anthony Lindauer\anthony-lindauer-1,2015-16,High Point,G,32,24,829,89,218,.408,44,102,.431,45,116,.388,42,47,.894,7,90,97,64,34,8,42,60,265,6.1
4162,Jarryn Skeete\jarryn-skeete-1,2014-15,Buffalo,G,29,28,861,86,224,.384,25,66,.379,61,158,.386,32,41,.780,20,72,92,44,33,2,21,61,265,6.7
4163,Isaiah Whitehead\isaiah-whitehead-1,2014-15,Seton Hall,G,22,19,612,91,248,.367,55,144,.382,36,104,.346,47,63,.746,22,63,85,78,30,14,73,53,265,7.1
4164,Kevin Ware\kevin-ware-1,2014-15,Georgia State,G,35,16,1001,99,226,.438,85,178,.478,14,48,.292,53,75,.707,21,87,108,85,58,12,48,67,265,6.6
4165,Charlie Jones\charlie-jones-2,2014-15,American,G,33,31,1087,88,178,.494,64,114,.561,24,64,.375,65,84,.774,19,104,123,61,28,16,35,64,265,7.1
4166,Mike Rodriguez\mike-rodriguez-1,2015-16,Southern Illinois,G,32,32,916,85,204,.417,66,142,.465,19,62,.306,76,121,.628,11,54,65,94,40,2,50,72,265,6.0
4167,Robert Turner\robert-turner-2,2014-15,Texas Tech,G,32,29,781,92,254,.362,61,146,.418,31,108,.287,50,69,.725,27,66,93,59,26,2,50,42,265,4.9
4168,Isiah Deas\isiah-deas-1,2017-18,La Salle,G,28,10,687,90,248,.363,56,131,.427,34,117,.291,51,73,.699,19,105,124,38,27,8,47,49,265,5.6
4169,Herb McGee\herb-mcgee-1,2017-18,South Alabama,G,32,27,845,84,208,.404,36,72,.500,48,136,.353,49,68,.721,11,75,86,95,16,3,80,79,265,4.6
4170,D.D. Scarver\dd-scarver-1,2013-14,Texas Southern,G,21,20,667,90,259,.347,48,112,.429,42,147,.286,43,58,.741,7,66,73,29,14,2,27,38,265,6.3
4171,Chivarsky Corbett\chivarsky-corbett-1,2014-15,Delaware,G,30,1,725,87,212,.410,41,94,.436,46,118,.390,45,55,.818,27,98,125,24,21,17,30,49,265,6.5
4172,Ghiavonni Robinson\ghiavonni-robinson-1,2014-15,Arkansas-Pine Bluff,G,32,27,814,94,245,.384,39,90,.433,55,155,.355,22,36,.611,14,64,78,32,31,5,45,59,265,4.5
4173,Josh Gasser\josh-gasser-1,2014-15,Wisconsin,G,40,40,1320,77,174,.443,28,48,.583,49,126,.389,62,75,.827,29,110,139,70,30,8,21,90,265,6.2
4174,Jordan Wilson\jordan-wilson-1,2014-15,Northern Colorado,G,30,10,777,89,212,.420,42,95,.442,47,117,.402,39,46,.848,13,43,56,69,29,0,26,50,264,6.7
4175,Corban Collins\corban-collins-1,2014-15,Morehead State,G,30,19,822,85,219,.388,44,100,.440,41,119,.345,53,67,.791,22,93,115,65,30,4,55,72,264,5.9
4176,D.J. Fenner\dj-fenner-1,2014-15,Nevada,G,30,19,756,90,260,.346,77,199,.387,13,61,.213,71,90,.789,22,58,80,33,33,10,52,60,264,4.3
4177,JR Hobbie\norman-hobbie-1,2014-15,Brown,G,31,14,826,78,199,.392,5,20,.250,73,179,.408,35,39,.897,3,41,44,14,11,0,28,63,264,4.4
4178,Ahsante Shivers\ahsante-shivers-1,2017-18,Siena,G,32,21,796,88,233,.378,65,158,.411,23,75,.307,65,90,.722,37,88,125,42,18,6,64,65,264,4.4
4179,Shaq Calhoun\shaq-calhoun-1,2016-17,South Alabama,G,32,20,717,86,267,.322,46,114,.404,40,153,.261,52,69,.754,15,60,75,31,45,4,39,99,264,3.9
4180,Amir Bell\amir-bell-2,2015-16,Princeton,G,29,28,792,92,203,.453,62,120,.517,30,83,.361,50,75,.667,13,60,73,68,30,11,49,83,264,6.2
4181,Jake Kocher\jake-kocher-1,2016-17,Texas A&M-Corpus Christi,G,34,17,962,105,208,.505,84,130,.646,21,78,.269,33,53,.623,32,61,93,54,59,4,39,86,264,6.5
4182,Gavin Block\gavin-block-1,2017-18,Ohio,G,31,25,943,89,243,.366,40,93,.430,49,150,.327,37,62,.597,18,111,129,106,23,10,50,74,264,6.1
4183,Everett Winchester\everett-winchester-1,2017-18,Wright State,G,33,1,699,91,195,.467,91,189,.481,0,6,.000,82,117,.701,44,80,124,37,13,9,55,70,264,5.1
4184,Tevin Hammond\tevin-hammond-1,2014-15,Arkansas-Pine Bluff,G,32,30,994,80,243,.329,44,121,.364,36,122,.295,68,98,.694,20,59,79,92,78,1,95,98,264,4.8
4185,Ryan Kemrite\ryan-kemrite-1,2015-16,Liberty,G,32,28,915,90,203,.443,33,63,.524,57,140,.407,27,42,.643,31,96,127,30,21,3,28,96,264,5.6
4186,Charles Glover\charles-glover-1,2017-18,Longwood,G,29,29,799,90,208,.433,41,90,.456,49,118,.415,35,52,.673,7,91,98,56,24,2,81,60,264,4.8
4187,Marreon Jackson\marreon-jackson-1,2017-18,Toledo,G,33,32,979,83,205,.405,21,58,.362,62,147,.422,36,48,.750,17,78,95,90,25,4,51,59,264,6.1
4188,Dallas Anglin\dallas-anglin-1,2015-16,Northern Colorado,G,20,11,555,81,180,.450,61,116,.526,20,64,.313,82,103,.796,5,52,57,44,20,1,53,50,264,8.0
4189,Shy McClelland\shy-mcclelland-1,2015-16,South Dakota,G,23,21,663,100,203,.493,88,171,.515,12,32,.375,52,102,.510,17,75,92,82,34,3,42,81,264,8.5
4190,Rinardo Perry\rinardo-perry-1,2017-18,Massachusetts-Lowell,G,29,29,727,101,224,.451,74,132,.561,27,92,.293,35,61,.574,22,51,73,44,30,9,36,54,264,6.1
4191,Adam Wing\adam-wing-1,2015-16,Evansville,G,34,34,1001,94,183,.514,73,143,.510,21,40,.525,55,66,.833,25,99,124,90,24,10,47,77,264,6.8
4192,Brandon Clarke\brandon-clarke-1,2015-16,San Jose State,G,31,3,728,104,163,.638,103,157,.656,1,6,.167,55,98,.561,65,109,174,46,22,38,34,54,264,9.0
4193,Jalen Adams\jalen-adams-2,2015-16,Connecticut,G,36,11,839,104,245,.424,92,201,.458,12,44,.273,44,51,.863,28,64,92,87,39,15,60,64,264,5.4
4194,Chris Clover\chris-clover-1,2017-18,Saint Joseph's,G,32,27,871,100,258,.388,74,167,.443,26,91,.286,37,61,.607,23,81,104,36,18,3,29,60,263,4.5
4195,Akim Mitchell\akim-mitchell-1,2017-18,Hampton,G,33,33,886,94,188,.500,80,156,.513,14,32,.438,61,75,.813,57,90,147,48,22,2,33,79,263,6.7
4196,Greg Brown\greg-brown-4,2014-15,Saint Francis (PA),G,32,31,882,93,184,.505,71,127,.559,22,57,.386,55,73,.753,10,74,84,76,20,4,40,71,263,6.3
4197,Ja'Michael Brown\jamichael-brown-1,2015-16,North Texas,G,32,18,868,93,230,.404,38,90,.422,55,140,.393,22,45,.489,17,65,82,79,37,1,58,71,263,5.3
4198,Travis Trice\travis-trice-1,2013-14,Michigan State,G,36,8,801,87,207,.420,34,85,.400,53,122,.434,36,44,.818,8,50,58,84,32,6,37,58,263,5.7
4199,Cody Demps\cody-demps-1,2015-16,Sacramento State,G,22,22,673,94,219,.429,77,166,.464,17,53,.321,58,90,.644,31,69,100,103,17,7,64,61,263,8.3
4200,Kyle Davis\kyle-davis-3,2015-16,Dayton,G,33,33,858,91,183,.497,70,121,.579,21,62,.339,60,87,.690,15,102,117,70,41,8,43,79,263,6.7
4201,Cody John\cody-john-1,2016-17,Weber State,G,34,27,903,98,213,.460,81,152,.533,17,61,.279,50,69,.725,6,103,109,74,18,5,55,69,263,5.0
4202,Marlon Beck\marlon-beck-1,2014-15,Binghamton,G,32,20,968,83,225,.369,33,85,.388,50,140,.357,47,68,.691,11,72,83,84,33,2,56,56,263,5.5
4203,Jackson Trapp\jackson-trapp-1,2014-15,Florida Atlantic,G,26,26,879,88,188,.468,41,76,.539,47,112,.420,40,48,.833,7,76,83,24,25,11,36,49,263,7.1
4204,Dallas Cameron\dallas-cameron-1,2016-17,Stephen F. Austin,G,33,33,1004,79,208,.380,38,84,.452,41,124,.331,64,84,.762,9,47,56,95,25,4,53,62,263,5.4
4205,Kevin Little\kevin-little-1,2014-15,Maine,G,21,9,620,96,257,.374,52,144,.361,44,113,.389,27,35,.771,11,42,53,55,23,0,49,36,263,6.5
4206,Austin Ruder\austin-ruder-1,2014-15,Missouri State,G,31,25,967,85,257,.331,29,86,.337,56,171,.327,37,43,.860,4,62,66,40,22,1,32,44,263,4.4
4207,Chris Caird\chris-caird-1,2013-14,Drake,G,31,24,767,85,201,.423,32,65,.492,53,136,.390,40,47,.851,16,86,102,40,8,2,40,53,263,5.4
4208,Matt Glover\matt-glover-1,2013-14,San Francisco,G,33,33,930,83,219,.379,70,172,.407,13,47,.277,84,144,.583,58,132,190,108,41,6,66,104,263,6.4
4209,Anthony Dallier\anthony-dallier-1,2016-17,Yale,G,28,28,905,79,197,.401,40,94,.426,39,103,.379,66,90,.733,14,91,105,113,29,5,71,64,263,7.1
4210,Josh Williams\josh-williams-5,2016-17,Akron,G,35,9,765,88,227,.388,19,38,.500,69,189,.365,18,28,.643,20,46,66,26,17,1,40,55,263,3.9
4211,Parker Kelly\parker-kelly-1,2014-15,Eastern Washington,G,34,34,1059,78,202,.386,13,53,.245,65,149,.436,42,53,.792,11,77,88,36,11,10,14,62,263,5.4
4212,Carlton Hurst\carlton-hurst-1,2016-17,South Dakota,G,34,34,971,81,167,.485,60,123,.488,21,44,.477,80,101,.792,60,113,173,33,27,19,29,72,263,7.4
4213,Lamonte Turner\lamonte-turner-1,2016-17,Tennessee,G,32,6,662,76,214,.355,35,89,.393,41,125,.328,70,91,.769,10,71,81,86,19,7,55,67,263,5.2
4214,Anders Broman\anders-broman-1,2016-17,Winthrop,G,33,7,734,86,199,.432,24,52,.462,62,147,.422,29,35,.829,4,41,45,42,25,4,30,50,263,5.4
4215,Jalen Bradley\jalen-bradley-1,2015-16,Oral Roberts,G,31,20,781,95,222,.428,56,123,.455,39,99,.394,33,43,.767,22,58,80,61,28,1,34,39,262,6.3
4216,Zach Green\zach-green-2,2015-16,Montana State,G,31,31,776,98,209,.469,85,161,.528,13,48,.271,53,90,.589,70,102,172,45,15,2,38,79,262,6.4
4217,Adonys Henriquez\adonys-henriquez-1,2015-16,Central Florida,G,26,26,824,86,219,.393,37,82,.451,49,137,.358,41,60,.683,20,60,80,51,15,3,28,24,262,7.0
4218,Andre Dawkins\andre-dawkins-1,2013-14,Duke,G,33,4,453,84,189,.444,20,37,.541,64,152,.421,30,37,.811,6,37,43,12,15,5,18,43,262,5.1
4219,Joy Williamson\joy-williamson-1,2013-14,Texas A&M-Corpus Christi,G,33,6,834,88,160,.550,80,129,.620,8,31,.258,78,102,.765,39,90,129,35,28,2,46,60,262,6.5
4220,Jordan Ratinho\jordan-ratinho-1,2016-17,San Francisco,G,32,23,787,95,213,.446,40,83,.482,55,130,.423,17,25,.680,12,73,85,33,25,4,29,69,262,5.4
4221,Keith Hornsby\keith-hornsby-1,2015-16,Louisiana State,G,20,19,608,89,182,.489,50,88,.568,39,94,.415,45,55,.818,6,51,57,32,25,2,24,34,262,9.8
4222,Zach Hunsaker\zach-hunsaker-1,2017-18,Brown,G,27,26,836,87,229,.380,41,97,.423,46,132,.348,42,45,.933,10,80,90,45,28,3,53,78,262,5.3
4223,Zak Showalter\zak-showalter-1,2015-16,Wisconsin,G,35,35,1099,90,198,.455,53,91,.582,37,107,.346,45,56,.804,26,108,134,76,36,6,48,102,262,6.0
4224,Reggie Dillard\reggie-dillard-1,2015-16,Presbyterian,G,31,31,931,91,248,.367,47,109,.431,44,139,.317,36,55,.655,14,119,133,64,27,8,66,70,262,4.7
4225,Cam Griffin\cam-griffin-1,2013-14,Denver,G,31,29,893,93,189,.492,86,163,.528,7,26,.269,69,102,.676,60,119,179,61,43,10,50,95,262,7.6
4226,Jaelan Sanford\jaelan-sanford-1,2015-16,Toledo,G,32,32,879,83,194,.428,35,58,.603,48,136,.353,48,59,.814,14,51,65,59,22,7,33,58,262,6.0
4227,Grantham Gillard\grantham-gillard-1,2017-18,Arkansas State,G,30,10,653,85,217,.392,37,65,.569,48,152,.316,44,62,.710,27,80,107,23,26,3,25,60,262,5.8
4228,Greg Mortimer\greg-mortimer-1,2015-16,South Carolina State,G,34,13,813,84,223,.377,59,146,.404,25,77,.325,69,85,.812,19,74,93,81,23,3,67,60,262,4.7
4229,Zach Kocur\zach-kocur-1,2014-15,Air Force,G,30,15,689,90,179,.503,33,59,.559,57,120,.475,25,40,.625,17,51,68,62,13,2,35,68,262,6.3
4230,Bobby Sharp\bobby-sharp-1,2013-14,Portland,G,31,6,644,84,219,.384,18,55,.327,66,164,.402,27,37,.730,5,33,38,36,13,1,20,49,261,4.8
4231,Blake Simmons\blake-simmons-1,2014-15,Evansville,G,36,36,1079,92,199,.462,63,112,.563,29,87,.333,48,58,.828,13,52,65,84,24,9,44,55,261,5.6
4232,Shannon Scott\shannon-scott-1,2013-14,Ohio State,G,35,21,940,96,222,.432,70,136,.515,26,86,.302,43,63,.683,24,94,118,119,71,5,65,78,261,6.9
4233,Collin Stewart\collin-stewart-1,2015-16,Monmouth,G,36,2,594,80,239,.335,32,87,.368,48,152,.316,53,60,.883,23,63,86,22,17,14,31,43,261,4.2
4234,Quayson Williams\quayson-williams-1,2016-17,Citadel,G,33,17,571,83,225,.369,28,73,.384,55,152,.362,40,51,.784,23,70,93,40,35,1,35,69,261,5.2
4235,Ambrose Mosley\ambrose-mosley-1,2013-14,Old Dominion,G,36,1,716,86,238,.361,28,69,.406,58,169,.343,31,43,.721,18,85,103,32,24,1,26,73,261,4.3
4236,Niem Stevenson\niem-stevenson-1,2016-17,Texas Tech,G,30,8,650,91,203,.448,64,131,.489,27,72,.375,52,85,.612,22,93,115,46,18,4,28,44,261,6.4
4237,Darreon Reddick\darreon-reddick-1,2016-17,Tennessee State,G,29,25,848,86,237,.363,41,107,.383,45,130,.346,44,59,.746,2,61,63,35,11,1,36,51,261,4.2
4238,Hallice Cooke\hallice-cooke-1,2013-14,Oregon State,G,32,18,843,89,194,.459,48,104,.462,41,90,.456,42,57,.737,6,77,83,80,27,2,50,57,261,6.1
4239,Kalin Fisher\kalin-fisher-1,2016-17,Hampton,G,28,18,656,98,255,.384,78,179,.436,20,76,.263,45,65,.692,24,48,72,42,17,5,46,49,261,4.6
4240,Deante Strickland\deante-strickland-1,2017-18,Portland State,G,34,10,696,91,213,.427,37,85,.435,54,128,.422,25,40,.625,20,52,72,88,34,1,42,57,261,6.0
4241,Deon Mitchell\deon-mitchell-1,2014-15,Northern Iowa,G,35,35,722,86,209,.411,57,143,.399,29,66,.439,60,85,.706,8,62,70,86,35,2,61,29,261,5.4
4242,Jarren Greenwood\jarren-greenwood-1,2016-17,McNeese State,G,28,20,790,81,230,.352,64,163,.393,17,67,.254,82,112,.732,7,50,57,73,26,2,44,57,261,5.4
4243,Devin Watson\devin-watson-1,2014-15,San Francisco,G,31,17,732,82,214,.383,66,150,.440,16,64,.250,81,111,.730,13,39,52,78,31,0,59,58,261,5.0
4244,Matt MacDonald\matt-macdonald-1,2014-15,Fairleigh Dickinson,G,29,28,856,82,195,.421,41,75,.547,41,120,.342,56,67,.836,37,80,117,31,27,2,32,83,261,6.5
4245,Malik Smith\malik-smith-1,2013-14,Minnesota,G,36,2,685,77,222,.347,20,48,.417,57,174,.328,50,64,.781,1,57,58,38,22,3,25,47,261,4.3
4246,Triston Chambers\triston-chambers-1,2016-17,Samford,G,36,34,815,88,206,.427,15,29,.517,73,177,.412,12,17,.706,9,56,65,37,21,2,29,73,261,4.5
4247,Bolden Brace\bolden-brace-1,2017-18,Northeastern,G,33,6,812,82,178,.461,27,39,.692,55,139,.396,42,51,.824,24,132,156,72,21,14,42,68,261,7.1
4248,Karl Harris\karl-harris-1,2017-18,Northern Arizona,G,32,10,584,90,235,.383,77,177,.435,13,58,.224,68,83,.819,15,56,71,21,17,3,43,74,261,3.6
4249,Cartier Diarra\cartier-diarra-1,2017-18,Kansas State,G,37,22,879,90,192,.469,56,108,.519,34,84,.405,47,65,.723,22,71,93,73,28,3,69,89,261,4.6
4250,Rob Ukawuba\rob-ukawuba-1,2015-16,NJIT,G,33,2,702,88,199,.442,65,129,.504,23,70,.329,62,89,.697,28,81,109,57,20,7,34,71,261,5.8
4251,Ghiavonni Robinson\ghiavonni-robinson-1,2016-17,Arkansas-Pine Bluff,G,29,23,827,85,237,.359,49,116,.422,36,121,.298,55,76,.724,20,82,102,43,35,2,62,50,261,5.0
4252,Darius Graham\darius-graham-1,2016-17,UC-Davis,G,36,36,1040,87,218,.399,44,103,.427,43,115,.374,44,57,.772,11,54,65,113,19,1,67,68,261,4.6
4253,Keith Shivers\keith-shivers-1,2016-17,Coppin State,G,32,32,859,100,268,.373,73,168,.435,27,100,.270,33,66,.500,28,85,113,65,39,8,54,91,260,4.5
4254,Shon Briggs\shon-briggs-1,2016-17,Cal State Bakersfield,G,35,6,740,96,194,.495,95,188,.505,1,6,.167,67,118,.568,49,121,170,39,23,8,52,70,260,5.4
4255,UC Iroegbu\uc-iroegbu-1,2017-18,Stony Brook,G,32,13,799,82,216,.380,34,88,.386,48,128,.375,48,67,.716,24,54,78,49,38,6,33,62,260,5.8
4256,Jordan Roper\jordan-roper-1,2013-14,Clemson,G,35,13,674,89,219,.406,56,116,.483,33,103,.320,49,60,.817,10,48,58,47,19,1,38,41,260,4.5
4257,Leo Vincent\leo-vincent-1,2015-16,Southern Illinois,G,32,0,683,82,197,.416,46,88,.523,36,109,.330,60,71,.845,13,52,65,34,25,1,48,48,260,4.9
4258,Kameron Langley\kameron-langley-1,2017-18,North Carolina A&T,G,35,33,1068,88,171,.515,73,129,.566,15,42,.357,69,97,.711,26,88,114,177,59,4,77,72,260,8.3
4259,Anton Beard\anton-beard-1,2016-17,Arkansas,G,36,11,756,86,213,.404,54,123,.439,32,90,.356,56,75,.747,29,46,75,68,39,1,38,69,260,5.4
4260,Chris Chiozza\chris-chiozza-1,2015-16,Florida,G,36,22,857,86,249,.345,45,121,.372,41,128,.320,47,59,.797,10,94,104,156,39,2,65,82,260,5.6
4261,Leslie McDonald\leslie-mcdonald-1,2013-14,North Carolina,G,25,18,677,88,228,.386,45,90,.500,43,138,.312,41,66,.621,10,39,49,37,11,2,28,73,260,5.0
4262,Janai Raynor Powell\janai-raynorpowell-1,2017-18,South Carolina State,G,32,25,855,86,192,.448,71,149,.477,15,43,.349,73,91,.802,22,95,117,106,32,5,72,61,260,6.6
4263,Austin Richie\austin-richie-1,2013-14,Western Michigan,G,33,33,1098,70,168,.417,27,64,.422,43,104,.413,77,106,.726,7,67,74,77,30,4,43,81,260,5.9
4264,Markus Terry\markus-terry-1,2013-14,Presbyterian,G,31,17,792,90,210,.429,75,154,.487,15,56,.268,65,86,.756,16,62,78,42,13,4,52,45,260,4.7
4265,Josh Adeyeye\josh-adeyeye-1,2014-15,Jacksonville,G,32,20,623,86,227,.379,26,72,.361,60,155,.387,28,35,.800,9,72,81,15,13,4,34,59,260,4.0
4266,Darryl Gaynor\darryl-gaynor-1,2014-15,San Jose State,G,29,21,705,88,280,.314,56,167,.335,32,113,.283,52,67,.776,14,27,41,58,19,2,82,63,260,2.2
4267,Chris Burgess\chris-burgess-3,2014-15,Appalachian State,G,29,29,864,89,229,.389,42,108,.389,47,121,.388,35,45,.778,16,55,71,84,12,0,47,53,260,5.6
4268,Admon Gilder\admon-gilder-1,2015-16,Texas A&M,G,37,0,755,87,202,.431,52,101,.515,35,101,.347,51,67,.761,16,70,86,49,34,5,27,57,260,5.4
4269,Jack Isenbarger\jack-isenbarger-1,2013-14,Elon,G,29,11,724,76,213,.357,27,71,.380,49,142,.345,59,75,.787,17,54,71,66,16,1,36,36,260,6.1
4270,Jo'Vontae Millner\jovontae-millner-1,2016-17,Presbyterian,G,24,24,642,100,207,.483,77,136,.566,23,71,.324,36,60,.600,46,88,134,23,11,3,63,49,259,6.2
4271,Chris Chiozza\chris-chiozza-1,2016-17,Florida,G,36,0,797,83,201,.413,53,106,.500,30,95,.316,63,80,.788,15,104,119,135,48,0,56,79,259,6.7
4272,Justin Coleman\justin-coleman-2,2015-16,Alabama,G,33,7,866,73,243,.300,33,96,.344,40,147,.272,73,82,.890,8,57,65,110,23,0,65,47,259,4.6
4273,Tanner Rubio\tanner-rubio-1,2016-17,Jacksonville,G,29,4,523,82,171,.480,18,40,.450,64,131,.489,31,41,.756,10,33,43,62,23,0,60,38,259,6.1
4274,Eyassu Worku\eyassu-worku-1,2016-17,UC-Irvine,G,36,1,731,93,233,.399,70,164,.427,23,69,.333,50,70,.714,26,86,112,67,25,3,74,44,259,4.2
4275,Malik Johnson\malik-johnson-2,2017-18,Canisius,G,33,32,1093,90,205,.439,56,104,.538,34,101,.337,45,61,.738,4,105,109,152,49,4,56,78,259,7.6
4276,Grant Benzinger\grant-benzinger-1,2015-16,Wright State,G,34,26,896,89,218,.408,27,59,.458,62,159,.390,19,23,.826,9,54,63,18,16,2,20,89,259,4.0
4277,Lester Medford\lester-medford-1,2014-15,Baylor,G,34,34,1005,88,224,.393,41,102,.402,47,122,.385,36,58,.621,11,37,48,106,51,3,57,83,259,5.4
4278,Chad Holley\chad-holley-2,2014-15,Massachusetts-Lowell,G,29,28,963,75,210,.357,32,86,.372,43,124,.347,66,88,.750,7,67,74,72,21,1,45,68,259,5.5
4279,Mike Anderson\mike-anderson-2,2014-15,Washington,G,31,31,992,84,186,.452,46,95,.484,38,91,.418,53,77,.688,58,133,191,78,27,16,65,75,259,7.5
4280,Perrion Callandret\perrion-callandret-1,2017-18,Idaho,G,27,21,720,92,209,.440,55,118,.466,37,91,.407,38,57,.667,12,79,91,82,23,9,63,43,259,6.7
4281,Matt Jones\matt-jones-3,2016-17,Duke,G,37,33,1216,95,239,.397,45,93,.484,50,146,.342,19,26,.731,37,67,104,72,62,6,41,86,259,5.8
4282,Terry Rozier\terry-rozier-1,2013-14,Louisville,G,37,10,699,93,232,.401,57,135,.422,36,97,.371,37,52,.712,28,86,114,67,38,2,22,54,259,5.8
4283,Yolonzo Moore\yolonzo-moore-1,2014-15,Hartford,G,30,30,990,88,220,.400,54,104,.519,34,116,.293,49,69,.710,15,100,115,80,32,1,55,60,259,6.1
4284,Stevie Taylor\stevie-taylor-1,2013-14,Ohio,G,36,24,802,97,237,.409,65,129,.504,32,108,.296,32,51,.627,13,53,66,87,37,1,47,60,258,4.9
4285,Ronrico White\ronrico-white-1,2013-14,Chattanooga,G,24,1,584,64,178,.360,26,79,.329,38,99,.384,92,111,.829,4,47,51,57,17,1,28,41,258,7.6
4286,Wesley Myers\wesley-myers-1,2017-18,South Carolina,G,33,12,725,81,213,.380,51,137,.372,30,76,.395,66,99,.667,21,61,82,56,21,4,47,77,258,4.4
4287,Sean O'Brien\sean-obrien-2,2015-16,Colgate,G,30,25,841,89,195,.456,43,87,.494,46,108,.426,34,44,.773,18,43,61,72,34,2,19,61,258,7.4
4288,Louis Adams\louis-adams-1,2016-17,Wyoming,G,34,16,504,76,175,.434,63,127,.496,13,48,.271,93,123,.756,11,77,88,34,15,8,45,56,258,4.8
4289,Miles Wright\miles-wright-1,2016-17,Dartmouth,G,27,27,779,94,253,.372,52,130,.400,42,123,.341,28,37,.757,39,86,125,24,21,4,53,49,258,5.0
4290,Dai-Jon Parker\dai-jon-parker-1,2013-14,Vanderbilt,G,31,26,1066,90,221,.407,44,101,.436,46,120,.383,32,45,.711,20,115,135,98,26,10,70,68,258,6.0
4291,P.J. Thompson\pj-thompson-1,2016-17,Purdue,G,35,35,1000,87,191,.455,34,59,.576,53,132,.402,31,44,.705,24,49,73,102,36,1,26,69,258,6.9
4292,Corey Baldwin\corey-baldwin-1,2015-16,North Dakota,G,33,29,700,86,214,.402,34,72,.472,52,142,.366,34,53,.642,23,89,112,37,32,5,33,61,258,5.5
4293,Isaiah Jackson\isaiah-jackson-2,2017-18,Providence,G,35,10,709,76,205,.371,49,130,.377,27,75,.360,79,101,.782,33,115,148,38,25,6,39,64,258,5.3
4294,Chad Sherwood\chad-sherwood-1,2015-16,Idaho,G,34,13,762,83,207,.401,15,46,.326,68,161,.422,24,29,.828,10,44,54,59,14,1,47,62,258,4.4
4295,Ben Millaud-Meunier\ben-millaud-meunier-1,2013-14,Saint Francis (PA),G,31,4,607,76,218,.349,20,57,.351,56,161,.348,50,63,.794,7,47,54,21,19,0,30,31,258,4.5
4296,Frank Williams\frank-williams-2,2013-14,Missouri-Kansas City,G,28,25,881,96,261,.368,50,104,.481,46,157,.293,20,27,.741,7,54,61,44,16,6,35,28,258,4.9
4297,O'Showen Williams\oshowen-williams-1,2017-18,Appalachian State,G,33,0,813,82,201,.408,38,86,.442,44,115,.383,50,74,.676,24,51,75,77,36,3,43,51,258,6.1
4298,Tyler Lamb\tyler-lamb-1,2014-15,Cal State Long Beach,G,31,23,716,87,248,.351,54,148,.365,33,100,.330,51,59,.864,26,91,117,36,24,4,51,59,258,4.5
4299,Brandon Ellis\brandon-ellis-1,2013-14,Alabama A&M,G,30,30,699,89,227,.392,54,121,.446,35,106,.330,45,66,.682,21,50,71,40,22,6,51,50,258,4.6
4300,Jarred Jones\jarred-jones-1,2013-14,Loyola (MD),G,30,3,709,93,197,.472,90,183,.492,3,14,.214,69,96,.719,42,93,135,25,44,41,42,91,258,7.2
4301,Rapheal Davis\rapheal-davis-1,2015-16,Purdue,G,31,31,922,84,220,.382,51,127,.402,33,93,.355,57,78,.731,22,98,120,71,13,13,42,59,258,5.8
4302,Torloft Thomas\torlorf-thomas-1,2016-17,Alabama State,G,31,29,937,76,241,.315,29,98,.296,47,143,.329,59,77,.766,16,65,81,76,15,4,70,64,258,3.8
4303,Skylar Mays\skylar-mays-1,2016-17,Louisiana State,G,31,25,711,84,203,.414,63,139,.453,21,64,.328,69,85,.812,16,53,69,113,40,2,69,55,258,6.4
4304,Jared Johnson\jared-johnson-2,2014-15,Stephen F. Austin,G,31,20,418,87,186,.468,41,74,.554,46,112,.411,38,46,.826,8,38,46,39,18,5,40,55,258,5.3
4305,Wes Washpun\wes-washpun-1,2013-14,Northern Iowa,G,31,29,911,81,182,.445,69,147,.469,12,35,.343,84,122,.689,14,96,110,118,30,23,75,69,258,6.9
4306,Jabarie Hinds\jabarie-hinds-1,2014-15,Massachusetts,G,32,6,691,98,239,.410,68,150,.453,30,89,.337,32,47,.681,4,35,39,70,32,1,59,56,258,4.3
4307,Mike Gesell\mike-gesell-1,2013-14,Iowa,G,33,33,783,90,240,.375,61,148,.412,29,92,.315,49,73,.671,9,58,67,128,43,4,42,64,258,6.3
4308,Manroop Clair\manroop-clair-1,2015-16,Seattle,G,31,0,666,82,218,.376,13,34,.382,69,184,.375,24,28,.857,3,44,47,17,12,0,28,36,257,4.3
4309,Kory Brown\kory-brown-1,2014-15,North Dakota State,G,31,31,807,96,197,.487,84,162,.519,12,35,.343,53,92,.576,39,114,153,51,25,22,71,90,257,5.6
4310,Jordan Bone\jordan-bone-1,2017-18,Tennessee,G,35,33,808,92,235,.391,65,164,.396,27,71,.380,46,56,.821,8,64,72,124,26,2,44,40,257,5.8
4311,J.R. Lynch\jr-lynch-2,2016-17,Hartford,G,32,29,1022,86,209,.411,43,106,.406,43,103,.417,42,51,.824,11,68,79,88,34,0,44,73,257,6.0
4312,Jabari Bird\jabari-bird-1,2013-14,University of California,G,31,12,619,93,219,.425,63,126,.500,30,93,.323,41,51,.804,17,44,61,33,12,8,32,38,257,5.0
4313,Jake Allsmiller\jake-allsmiller-1,2016-17,Georgia Southern,G,33,21,772,82,195,.421,5,15,.333,77,180,.428,16,18,.889,7,46,53,23,19,10,31,79,257,4.6
4314,Bryson Robinson\bryson-robinson-1,2017-18,New Orleans,G,27,16,673,81,205,.395,31,67,.463,50,138,.362,45,55,.818,14,45,59,75,22,0,44,40,257,6.7
4315,D'Marques Tyson\dmarques-tyson-1,2017-18,Portland,G,30,2,565,85,184,.462,22,50,.440,63,134,.470,24,28,.857,6,58,64,16,10,1,24,39,257,5.5
4316,Frankie Johnson\frankie-johnson-1,2016-17,Citadel,G,33,31,809,78,213,.366,51,115,.443,27,98,.276,74,97,.763,42,48,90,121,49,3,62,93,257,6.4
4317,Tre Burnette\tre-burnette-1,2014-15,South Dakota,G,33,33,670,110,260,.423,91,193,.472,19,67,.284,18,41,.439,65,131,196,26,44,17,46,93,257,5.6
4318,Dee Oldham\dee-oldham-1,2015-16,Chattanooga,G,35,1,681,80,185,.432,53,111,.477,27,74,.365,70,88,.795,42,127,169,40,30,3,42,49,257,6.2
4319,Noah Robotham\noah-robotham-1,2014-15,Akron,G,26,25,796,86,222,.387,46,111,.414,40,111,.360,45,60,.750,13,56,69,87,33,1,59,38,257,6.8
4320,A.J. Davis\aj-davis-2,2016-17,Central Florida,G,31,29,1012,77,213,.362,60,149,.403,17,64,.266,86,125,.688,43,175,218,74,27,10,73,84,257,6.0
4321,Eric Childress\eric-childress-1,2016-17,UC-Santa Barbara,G,28,27,905,91,246,.370,46,115,.400,45,131,.344,30,39,.769,22,70,92,101,61,3,69,53,257,7.1
4322,Leo Vincent\leo-vincent-1,2016-17,Southern Illinois,G,32,16,743,90,241,.373,41,95,.432,49,146,.336,28,39,.718,14,47,61,35,16,2,43,40,257,4.0
4323,Devin Brooks\devin-brooks-1,2014-15,Creighton,G,33,16,758,83,237,.350,66,167,.395,17,70,.243,74,101,.733,46,118,164,101,32,3,76,46,257,5.8
4324,Trevis Wyche\trevis-wyche-1,2013-14,Saint Peter's,G,31,31,913,71,204,.348,59,155,.381,12,49,.245,103,150,.687,15,63,78,120,38,3,65,71,257,5.9
4325,Kyre' Hamer\kyre-hamer-1,2015-16,Campbell,G,27,22,790,86,167,.515,65,106,.613,21,61,.344,64,85,.753,11,95,106,53,32,6,49,66,257,7.4
4326,Jake Wright\jake-wright-1,2014-15,Citadel,G,29,9,746,84,211,.398,12,40,.300,72,171,.421,17,22,.773,4,41,45,16,5,0,17,36,257,4.9
4327,Steve Glowiak\steve-glowiak-1,2014-15,Sacred Heart,G,32,2,807,85,238,.357,22,47,.468,63,191,.330,23,33,.697,12,87,99,40,26,2,23,43,256,5.3
4328,Izayah Mauriohooho-Le'afa\izayah-mauriohooho-leafa-1,2017-18,Sacramento State,G,30,26,931,91,226,.403,43,108,.398,48,118,.407,26,36,.722,7,94,101,107,34,4,54,58,256,6.6
4329,Jourdan Grant\jourdan-grant-1,2014-15,Maryland-Baltimore County,G,30,30,1048,89,238,.374,76,180,.422,13,58,.224,65,116,.560,18,120,138,121,49,6,99,72,256,5.4
4330,Dashawn King\dashawn-king-1,2015-16,Missouri-Kansas City,G,31,13,601,91,211,.431,77,158,.487,14,53,.264,60,85,.706,33,53,86,52,30,3,57,63,256,5.2
4331,Dominique Collier\dominique-collier-1,2015-16,Colorado,G,34,33,764,80,208,.385,40,118,.339,40,90,.444,56,74,.757,9,64,73,91,38,4,69,100,256,4.6
4332,Deyshonee Much\deyshonee-much-1,2016-17,Iona,G,27,9,664,92,241,.382,35,93,.376,57,148,.385,15,19,.789,23,73,96,50,39,4,41,49,256,6.5
4333,Fard Muhammad\fard-muhammad-1,2017-18,Binghamton,G,31,4,628,88,203,.433,24,48,.500,64,155,.413,16,25,.640,12,65,77,33,18,3,25,41,256,5.7
4334,Joshua Filmore\joshua-filmore-1,2014-15,Southeastern Louisiana,G,21,20,722,91,220,.414,41,81,.506,50,139,.360,24,37,.649,7,50,57,46,17,0,36,38,256,7.2
4335,Sean Hoehn\sean-hoehn-1,2016-17,Sacred Heart,G,32,24,912,86,233,.369,36,91,.396,50,142,.352,34,41,.829,14,75,89,99,40,1,72,76,256,5.1
4336,Raeford Worsham\raeford-worsham-1,2014-15,Jackson State,G,19,19,618,88,220,.400,78,177,.441,10,43,.233,70,116,.603,64,86,150,41,27,5,44,37,256,10.0
4337,Justin Robinson\justin-robinson-3,2015-16,Virginia Tech,G,35,19,811,76,181,.420,56,124,.452,20,57,.351,84,115,.730,11,53,64,97,22,4,57,68,256,5.1
4338,Xavier Pollard\xavier-pollard-1,2015-16,Kent State,G,22,8,535,91,194,.469,71,142,.500,20,52,.385,54,85,.635,18,51,69,62,22,1,40,56,256,8.0
4339,Kameron McGusty\kameron-mcgusty-1,2017-18,Oklahoma,G,32,8,592,90,213,.423,56,111,.505,34,102,.333,42,56,.750,12,50,62,11,11,1,26,34,256,4.4
4340,Kyle Guy\kyle-guy-1,2016-17,Virginia,G,34,7,634,90,205,.439,39,102,.382,51,103,.495,25,35,.714,5,52,57,45,13,1,21,37,256,5.1
4341,Nigel Ribeiro\nigel-ribeiro-1,2016-17,Grambling,G,30,17,849,95,245,.388,69,153,.451,26,92,.283,40,63,.635,11,97,108,72,49,4,48,60,256,6.0
4342,Rashad Ray\rashad-ray-1,2014-15,Tulsa,G,34,7,913,71,212,.335,31,100,.310,40,112,.357,74,92,.804,9,87,96,98,34,1,40,59,256,5.9
4343,Nathan Hoover\nathan-hoover-1,2016-17,Wofford,G,33,15,821,86,224,.384,33,74,.446,53,150,.353,31,37,.838,21,55,76,35,6,2,32,44,256,4.4
4344,Josh McFolley\josh-mcfolley-1,2015-16,Detroit Mercy,G,30,23,657,83,219,.379,40,92,.435,43,127,.339,47,71,.662,10,35,45,68,35,2,46,72,256,5.1
4345,Daniel Fowler\daniel-fowler-1,2014-15,Furman,G,33,33,980,94,204,.461,72,136,.529,22,68,.324,46,74,.622,29,104,133,83,38,11,79,73,256,5.7
4346,Zach Cooks\zach-cooks-1,2017-18,NJIT,G,30,1,663,87,191,.455,46,96,.479,41,95,.432,41,56,.732,11,54,65,64,48,5,50,34,256,6.9
4347,Gabe York\gabe-york-1,2013-14,Arizona,G,38,12,828,82,221,.371,25,73,.342,57,148,.385,35,52,.673,15,70,85,61,18,4,21,56,256,4.7
4348,Roland Nyama\roland-nyama-1,2014-15,Stony Brook,G,35,35,856,85,211,.403,44,106,.415,41,105,.390,45,65,.692,40,86,126,53,28,20,49,68,256,5.5
4349,Kendall Stephens\kendall-stephens-1,2013-14,Purdue,G,32,16,657,80,225,.356,16,52,.308,64,173,.370,32,37,.865,7,50,57,25,14,12,23,60,256,4.4
4350,Jourdan Grant\jourdan-grant-1,2017-18,Maryland-Baltimore County,G,34,10,820,85,210,.405,47,108,.435,38,102,.373,48,71,.676,16,66,82,87,23,9,62,63,256,4.9
4351,DJ Cole\dj-cole-1,2013-14,Youngstown State,G,31,31,915,75,173,.434,52,112,.464,23,61,.377,83,109,.761,13,82,95,143,39,4,59,62,256,7.9
4352,Canyon Barry\canyon-barry-1,2015-16,College of Charleston,G,13,13,415,84,209,.402,56,125,.448,28,84,.333,60,71,.845,6,38,44,17,10,7,31,20,256,10.9
4353,Terrel de Rouen\terrel-de-rouen-1,2014-15,North Dakota,G,29,28,727,92,245,.376,61,138,.442,31,107,.290,41,62,.661,11,51,62,65,34,4,63,87,256,4.2
4354,Carter Skaggs\carter-skaggs-1,2017-18,Washington State,G,31,11,634,85,200,.425,16,29,.552,69,171,.404,16,18,.889,16,65,81,17,5,0,28,45,255,4.8
4355,Romone Saunders\romone-saunders--1,2015-16,Wagner,G,27,13,631,85,206,.413,40,92,.435,45,114,.395,40,53,.755,31,82,113,54,26,6,40,59,255,7.0
4356,Derryck Thornton\derryck-thornton-1,2015-16,Duke,G,36,20,935,94,241,.390,67,159,.421,27,82,.329,40,58,.690,10,56,66,90,27,8,58,76,255,4.1
4357,David Robertson\david-robertson-1,2016-17,North Carolina-Asheville,G,33,25,660,82,178,.461,21,44,.477,61,134,.455,30,39,.769,6,32,38,38,22,1,20,50,255,5.5
4358,Kyle Davis\kyle-davis-3,2014-15,Dayton,G,36,35,1050,78,171,.456,61,94,.649,17,77,.221,82,116,.707,4,96,100,88,53,17,48,94,255,6.3
4359,Brian Pegg\brian-pegg-1,2014-15,Stetson,G,26,13,662,97,191,.508,97,191,.508,0,0,,61,98,.622,50,91,141,20,19,3,36,49,255,7.2
4360,Daxter Miles\daxter-miles-1,2014-15,West Virginia,G,35,35,718,93,228,.408,52,113,.460,41,115,.357,28,53,.528,40,40,80,34,38,2,25,89,255,4.7
4361,Cortez Mitchell\cortez-mitchell-1,2017-18,Charleston Southern,G,28,12,635,94,208,.452,82,161,.509,12,47,.255,55,73,.753,9,86,95,56,23,3,43,37,255,6.4
4362,Jordan Gathers\jordan-gathers-1,2013-14,St. Bonaventure,G,31,10,809,84,215,.391,48,115,.417,36,100,.360,51,64,.797,13,54,67,64,40,3,52,88,255,5.1
4363,Diante Baldwin\diante-baldwin-1,2014-15,North Carolina-Greensboro,G,25,21,800,91,220,.414,78,177,.441,13,43,.302,60,93,.645,25,84,109,88,42,9,59,74,255,7.5
4364,J.T. Miller\jt-miller-1,2017-18,Missouri State,G,32,15,658,106,224,.473,95,187,.508,11,37,.297,32,49,.653,23,87,110,40,16,7,52,60,255,4.7
4365,Rayjon Tucker\rayjon-tucker-1,2016-17,Florida Gulf Coast,G,33,6,622,81,159,.509,52,95,.547,29,64,.453,64,85,.753,23,72,95,32,13,9,32,61,255,5.8
4366,Ryan Frazier\ryan-frazier-1,2015-16,Bucknell,G,31,31,834,73,190,.384,42,105,.400,31,85,.365,78,97,.804,10,41,51,55,20,0,33,67,255,5.2
4367,Ahmad Starks\ahmad-starks-1,2014-15,Illinois,G,33,20,794,91,265,.343,43,118,.364,48,147,.327,25,30,.833,8,45,53,73,22,4,37,51,255,4.3
4368,Alexander Aka Gorski\alexander-aka-gorski-1,2016-17,Wyoming,G,33,16,711,85,212,.401,29,50,.580,56,162,.346,28,36,.778,10,66,76,49,16,1,29,64,254,4.8
4369,Cortez Seales\cortez-seales-1,2016-17,North Dakota,G,30,1,772,94,213,.441,84,189,.444,10,24,.417,56,87,.644,30,71,101,50,28,13,26,48,254,6.6
4370,Nic Thomas\nic-thomas-1,2017-18,Norfolk State,G,30,7,608,72,223,.323,35,108,.324,37,115,.322,73,92,.793,25,61,86,45,10,0,55,54,254,4.0
4371,Kyle Odister\kyle-odister-1,2013-14,Cal Poly,G,28,24,697,89,247,.360,27,74,.365,62,173,.358,14,20,.700,11,50,61,40,25,1,18,53,254,5.4
4372,Darryl Smith\darryl-smith-1,2015-16,Cornell,G,28,27,708,98,151,.649,76,114,.667,22,37,.595,36,50,.720,16,80,96,34,33,12,28,45,254,8.4
4373,Jure Span\jure-span-1,2017-18,South Carolina Upstate,G,32,26,901,92,232,.397,44,90,.489,48,142,.338,22,35,.629,16,69,85,132,35,6,55,79,254,6.3
4374,Antonio Woods\antonio-woods-1,2017-18,Pennsylvania,G,33,32,930,88,204,.431,57,115,.496,31,89,.348,47,81,.580,21,99,120,70,20,4,40,64,254,5.6
4375,T.J. Dunans\tj-dunans-1,2016-17,Auburn,G,31,11,754,105,271,.387,90,199,.452,15,72,.208,29,53,.547,15,93,108,76,31,22,72,65,254,4.4
4376,Dinero Mercurius\dinero-mercurius-1,2017-18,Florida Gulf Coast,G,32,15,700,80,188,.426,22,48,.458,58,140,.414,36,39,.923,18,38,56,22,21,3,30,61,254,5.0
4377,Nate Frye\nate-frye-1,2016-17,New Orleans,G,24,1,603,80,177,.452,60,120,.500,20,57,.351,74,96,.771,33,47,80,61,30,3,44,57,254,8.3
4378,Will Spradling\will-spradling-1,2013-14,Kansas State,G,33,33,991,77,202,.381,28,56,.500,49,146,.336,51,70,.729,18,82,100,95,45,1,34,96,254,6.4
4379,B.J. Taylor\bj-taylor-1,2017-18,Central Florida,G,16,14,495,80,201,.398,54,134,.403,26,67,.388,68,101,.673,3,29,32,51,8,0,28,20,254,9.4
4380,Markus Terry\markus-terry-1,2014-15,Presbyterian,G,31,19,823,91,211,.431,65,140,.464,26,71,.366,46,63,.730,12,59,71,42,16,2,38,44,254,4.9
4381,Jordan Ashton\jordan-ashton-1,2016-17,Northern Iowa,G,30,21,991,82,201,.408,33,87,.379,49,114,.430,41,53,.774,16,89,105,35,28,7,33,53,254,6.1
4382,Avery Woodson\avery-woodson-1,2014-15,Memphis,G,32,30,872,85,227,.374,24,65,.369,61,162,.377,23,28,.821,8,68,76,36,32,8,34,95,254,4.5
4383,Matt Vest\matt-vest-1,2013-14,Wright State,G,34,34,923,91,165,.552,60,95,.632,31,70,.443,41,64,.641,20,90,110,74,38,10,30,52,254,7.4
4384,Maurice Wiltz\maurice-wiltz-1,2013-14,Southern Illinois-Edwardsville,G,30,18,581,76,176,.432,28,70,.400,48,106,.453,54,76,.711,10,44,54,25,16,0,37,70,254,4.7
4385,Nazareth Mitrou-Long\nazareth-mitrou-long-1,2013-14,Iowa State,G,36,7,731,86,199,.432,22,39,.564,64,160,.400,18,28,.643,13,44,57,41,6,3,16,66,254,4.5
4386,Javarez Willis\javarez-willis-1,2013-14,Ohio,G,37,12,758,86,212,.406,34,75,.453,52,137,.380,30,34,.882,4,58,62,96,26,0,79,49,254,4.1
4387,Tyler Williams\tyler-williams-3,2017-18,San Diego,G,29,23,921,77,173,.445,33,61,.541,44,112,.393,56,66,.848,30,82,112,51,19,5,41,66,254,6.8
4388,Brandon Stewart\brandon-stewart-1,2014-15,Bethune-Cookman,G,18,18,573,68,199,.342,45,119,.378,23,80,.288,95,123,.772,38,57,95,23,17,3,51,48,254,7.7
4389,Bryce Pressley\bryce-pressley-1,2014-15,Portland,G,31,30,914,83,206,.403,35,97,.361,48,109,.440,40,55,.727,37,77,114,91,26,10,50,63,254,6.7
4390,Ian Boyd\ian-boyd-2,2017-18,George Mason,G,33,13,820,97,245,.396,71,155,.458,26,90,.289,34,44,.773,46,97,143,41,20,2,42,68,254,4.8
4391,Jon Axel Gudmundsson\jonaxel-gudmundsson-1,2016-17,Davidson,G,31,29,985,81,197,.411,44,84,.524,37,113,.327,55,75,.733,26,99,125,107,35,2,53,80,254,6.9
4392,Jabril Trawick\jabril-trawick-1,2013-14,Georgetown,G,28,21,735,83,160,.519,68,112,.607,15,48,.313,73,105,.695,24,62,86,47,19,9,44,90,254,6.3
4393,Randall Gaskins Jr.\randall-gaskinsjr-1,2016-17,Saint Francis (PA),G,32,30,928,102,215,.474,86,175,.491,16,40,.400,34,59,.576,29,48,77,49,42,6,42,62,254,5.7
4394,Tanner Rubio\tanner-rubio-1,2017-18,Jacksonville,G,33,14,838,86,260,.331,29,73,.397,57,187,.305,25,41,.610,11,35,46,54,19,1,59,56,254,2.9
4395,Kamar McKnight\kamar-mcknight-1,2017-18,Tennessee State,G,30,6,657,90,214,.421,60,123,.488,30,91,.330,44,62,.710,8,63,71,47,23,0,46,52,254,4.9
4396,Jake Thomas\jake-thomas-1,2013-14,Marquette,G,32,30,957,76,207,.367,9,35,.257,67,172,.390,35,46,.761,10,78,88,43,17,6,34,84,254,4.7
4397,Jackson Donahue\jackson-donahue-1,2015-16,Pennsylvania,G,26,16,659,82,207,.396,20,43,.465,62,164,.378,27,44,.614,15,37,52,32,15,1,23,43,253,5.9
4398,Kodi Justice\kodi-justice-1,2015-16,Arizona State,G,32,3,792,84,213,.394,24,63,.381,60,150,.400,25,33,.758,12,57,69,76,30,5,53,78,253,5.1
4399,Nick Norton\nick-norton-1,2014-15,Alabama-Birmingham,G,35,33,946,69,178,.388,10,27,.370,59,151,.391,56,66,.848,8,65,73,132,48,1,62,50,253,6.7
4400,Josh Gantz\josh-gantz-1,2017-18,Massachusetts-Lowell,G,30,30,906,95,195,.487,64,104,.615,31,91,.341,32,43,.744,34,92,126,69,39,32,49,104,253,7.4
4401,Troy Harper\troy-harper-1,2017-18,Drexel,G,25,10,597,72,188,.383,65,144,.451,7,44,.159,102,125,.816,10,46,56,36,13,2,44,61,253,5.3
4402,Tyler Smithpeters\tyler-smithpeters-1,2017-18,Southern Illinois,G,33,5,836,80,199,.402,31,62,.500,49,137,.358,44,63,.698,20,123,143,77,37,5,47,80,253,6.2
4403,Dupree McBrayer\dupree-mcbrayer-1,2017-18,Minnesota,G,27,27,773,82,230,.357,46,125,.368,36,105,.343,53,78,.679,4,52,56,66,26,9,33,48,253,5.9
4404,Jaylin Airington\jaylin-airington-1,2014-15,Cal State Bakersfield,G,33,26,922,81,201,.403,61,140,.436,20,61,.328,71,92,.772,46,74,120,59,22,7,40,99,253,5.4
4405,Artur Labinowicz\artur-labinowicz-1,2016-17,Coastal Carolina,G,39,7,858,78,196,.398,38,95,.400,40,101,.396,57,83,.687,42,110,152,39,25,8,61,62,253,4.4
4406,Warren Sledge\warren-sledge-1,2016-17,Citadel,G,33,33,955,75,208,.361,38,88,.432,37,120,.308,66,78,.846,19,69,88,113,32,6,42,74,253,6.4
4407,Andell Cumberbatch\andell-cumberbatch-1,2013-14,St. Bonaventure,G,31,25,710,91,212,.429,69,142,.486,22,70,.314,49,77,.636,42,82,124,46,32,6,47,67,253,5.8
4408,Tevin Broyles\tevin-broyles-1,2014-15,New Orleans,G,29,5,687,88,193,.456,82,167,.491,6,26,.231,71,110,.645,24,75,99,43,28,8,65,67,253,5.1
4409,Manu Lecomte\manu-lecomte-1,2013-14,Miami (FL),G,33,17,924,85,200,.425,58,132,.439,27,68,.397,56,73,.767,23,47,70,77,21,1,58,63,253,4.9
4410,Galen Robinson Jr.\galen-robinsonjr-1,2015-16,Houston,G,32,22,777,97,212,.458,79,153,.516,18,59,.305,41,59,.695,9,68,77,110,32,3,50,65,253,6.2
4411,Mike Gesell\mike-gesell-1,2014-15,Iowa,G,34,34,866,97,238,.408,81,178,.455,16,60,.267,42,61,.689,12,54,66,135,33,5,61,58,252,5.5
4412,Deonte Burton\deonte-burton-2,2015-16,Iowa State,G,26,7,488,97,182,.533,79,144,.549,18,38,.474,40,63,.635,35,66,101,27,24,16,31,63,252,7.6
4413,Deonte Hearns\deonte-hearns-1,2015-16,Grambling,G,22,19,653,89,189,.471,89,184,.484,0,5,.000,74,120,.617,52,99,151,18,21,5,62,78,252,6.7
4414,Aaron Jordan\aaron-jordan-1,2017-18,Illinois,G,32,6,644,77,165,.467,33,70,.471,44,95,.463,54,64,.844,42,57,99,23,27,7,30,63,252,6.3
4415,Matthew Grant\matthew-grant-1,2013-14,Detroit Mercy,G,32,12,731,75,213,.352,39,96,.406,36,117,.308,66,82,.805,14,62,76,41,30,8,32,84,252,4.8
4416,Jordan Andrews\jordan-andrews-1,2015-16,Youngstown State,G,32,19,666,77,219,.352,27,83,.325,50,136,.368,48,65,.738,21,69,90,30,28,3,45,81,252,4.1
4417,Michael Neal\michael-neal-3,2013-14,Appalachian State,G,26,19,735,83,238,.349,52,142,.366,31,96,.323,55,85,.647,15,36,51,85,26,7,56,52,252,5.4
4418,Kevin Booze\kevin-booze-1,2015-16,Lamar,G,27,18,606,86,204,.422,59,125,.472,27,79,.342,53,75,.707,12,53,65,114,36,1,67,71,252,6.7
4419,Marcel Davis\marcel-davis-1,2014-15,Utah Valley,G,30,29,917,87,211,.412,71,165,.430,16,46,.348,62,97,.639,15,92,107,123,28,3,75,66,252,5.9
4420,Justin Ravenel\justin-ravenal-1,2015-16,Florida A&M,G,29,18,820,81,234,.346,20,61,.328,61,173,.353,29,42,.690,15,63,78,15,12,0,28,48,252,4.1
4421,Jalen Nesbitt\jalen-nesbitt-1,2013-14,North Florida,G,31,1,754,76,171,.444,53,104,.510,23,67,.343,77,99,.778,41,90,131,76,25,10,62,50,252,6.9
4422,Amir Coffey\amir-coffey-1,2017-18,Minnesota,G,18,18,569,87,183,.475,66,126,.524,21,57,.368,57,83,.687,17,56,73,60,13,5,35,36,252,10.3
4423,Devon Begley\devon-begley-1,2016-17,Northeastern,G,26,20,860,82,202,.406,36,79,.456,46,123,.374,42,57,.737,10,85,95,87,48,7,60,70,252,7.5
4424,Devante Wilson\devante-wilson-1,2013-14,San Jose State,G,30,24,731,76,238,.319,21,67,.313,55,171,.322,44,56,.786,35,49,84,20,20,10,37,59,251,4.3
4425,Dwayne Lautier-Ogunleye\dwayne-lautier-ogunleye-1,2017-18,Bradley,G,33,33,865,77,174,.443,58,110,.527,19,64,.297,78,112,.696,45,109,154,88,17,2,44,81,251,6.5
4426,Tevin Broyles\tevin-broyles-1,2016-17,New Orleans,G,32,31,834,82,192,.427,69,142,.486,13,50,.260,74,106,.698,23,70,93,80,27,1,75,75,251,4.8
4427,Jeremiah Bell\jeremiah-bell-1,2016-17,Milwaukee,G,35,0,734,90,240,.375,61,141,.433,29,99,.293,42,69,.609,10,64,74,57,17,2,37,60,251,3.8
4428,Elliott Cole\elliot-cole-1,2015-16,Chicago State,G,28,13,527,87,233,.373,34,76,.447,53,157,.338,24,27,.889,11,37,48,48,25,0,52,44,251,4.6
4429,Jarrey Foster\jarrey-foster-1,2017-18,Southern Methodist,G,19,19,616,97,208,.466,77,146,.527,20,62,.323,37,53,.698,53,60,113,51,14,23,28,36,251,11.4
4430,Kristinn Palsson\kristinn-palsson-1,2015-16,Marist,G,30,28,950,84,222,.378,17,33,.515,67,189,.354,16,28,.571,11,118,129,35,21,7,33,86,251,5.0
4431,Ayodeji Egbeyemi\ayodeji-egbeyemi-1,2014-15,Loyola Marymount,G,26,26,708,86,215,.400,72,177,.407,14,38,.368,65,82,.793,23,66,89,38,17,10,49,44,251,5.7
4432,Austin Ajukwa\austin-ajukwa-1,2017-18,Charlotte,G,29,21,799,82,211,.389,55,132,.417,27,79,.342,60,69,.870,16,82,98,24,32,10,69,85,251,4.2
4433,Jordan Barham\jordan-barham-1,2015-16,Davidson,G,30,10,425,99,187,.529,97,181,.536,2,6,.333,51,85,.600,29,81,110,23,6,5,18,43,251,6.0
4434,Walter Whyte\walter-whyte-1,2017-18,Boston University,G,27,23,664,88,183,.481,71,137,.518,17,46,.370,58,86,.674,39,96,135,30,23,14,46,46,251,7.1
4435,Travis Souza\travis-souza-1,2014-15,UC-Irvine,G,34,33,879,78,169,.462,11,24,.458,67,145,.462,28,33,.848,14,87,101,50,28,5,33,32,251,6.4
4436,David Robertson\david-robertson-1,2013-14,North Carolina-Asheville,G,32,26,925,79,212,.373,35,87,.402,44,125,.352,49,75,.653,26,54,80,73,27,1,45,71,251,5.1
4437,Javares Brent\javeres-brent-1,2014-15,Jackson State,G,31,14,799,81,254,.319,10,35,.286,71,219,.324,18,23,.783,14,88,102,23,19,7,29,36,251,4.4
4438,Ky Howard\ky-howard-1,2014-15,NJIT,G,23,17,730,80,159,.503,69,126,.548,11,33,.333,80,108,.741,34,98,132,90,11,3,68,59,251,8.6
4439,Isaiah Williams\isaiah-williams-2,2017-18,Georgia State,G,34,3,681,82,195,.421,39,84,.464,43,111,.387,44,50,.880,7,39,46,52,15,1,31,29,251,5.0
4440,Sayeed Pridgett\sayeed-pridgett-1,2016-17,Montana,G,31,12,605,99,188,.527,98,178,.551,1,10,.100,52,66,.788,33,88,121,44,11,16,45,79,251,5.8
4441,Devin Harris\devin-harris-2,2016-17,Jacksonville,G,23,21,686,98,192,.510,93,174,.534,5,18,.278,50,73,.685,31,93,124,62,29,8,42,51,251,9.2
4442,Jordon Harris\jordon-harris-1,2017-18,Louisiana-Monroe,G,32,14,862,95,264,.360,54,128,.422,41,136,.301,20,27,.741,20,51,71,104,36,1,60,46,251,5.1
4443,Troy Holston\troy-holston-1,2016-17,South Florida,G,26,19,759,91,268,.340,37,97,.381,54,171,.316,15,32,.469,4,56,60,33,15,4,48,52,251,3.3
4444,Dachon Burke\dachon-burke-1,2016-17,Robert Morris,G,33,16,755,95,226,.420,81,182,.445,14,44,.318,47,64,.734,49,79,128,24,51,11,58,74,251,5.1
4445,JR Hobbie\norman-hobbie-1,2015-16,Brown,G,28,14,704,78,189,.413,6,17,.353,72,172,.419,23,27,.852,3,29,32,16,8,0,16,46,251,5.1
4446,Dylan Cox\dylan-cox-1,2015-16,Army,G,31,29,862,92,182,.505,87,164,.530,5,18,.278,61,89,.685,37,101,138,147,23,16,78,74,250,7.5
4447,Jerome Garrison\jerome-garrison-1,2014-15,Grand Canyon,G,32,32,849,87,182,.478,68,117,.581,19,65,.292,57,90,.633,36,71,107,40,13,10,32,83,250,5.4
4448,Bobby Moorehead\bobby-moorehead-1,2017-18,Montana,G,34,34,1085,82,215,.381,31,70,.443,51,145,.352,35,49,.714,27,147,174,41,41,18,39,75,250,6.0
4449,Ronnie Johnson\ronnie-johnson-1,2016-17,Auburn,G,32,2,525,91,210,.433,66,144,.458,25,66,.379,43,60,.717,16,41,57,74,22,0,37,32,250,5.6
4450,Spencer Dinwiddie\spencer-dinwiddie-1,2013-14,Colorado,G,17,17,529,61,131,.466,35,68,.515,26,63,.413,102,119,.857,8,44,52,64,26,4,30,32,250,13.3
4451,Zedric Sadler\zedric-sadler-1,2014-15,Rider,G,33,7,801,88,213,.413,57,126,.452,31,87,.356,43,64,.672,21,75,96,63,42,7,38,59,250,5.9
4452,Tyreke Key\tyreke-key-1,2017-18,Indiana State,G,30,13,843,82,228,.360,59,157,.376,23,71,.324,63,88,.716,25,102,127,45,29,8,43,61,250,5.3
4453,Anthony Myers\anthony-myers-1,2013-14,Robert Morris,G,36,36,993,80,204,.392,59,138,.428,21,66,.318,69,92,.750,25,63,88,134,38,1,60,58,250,6.0
4454,JoJo Walker\jojo-walker-1,2017-18,Portland,G,32,26,811,74,191,.387,41,102,.402,33,89,.371,69,98,.704,6,60,66,78,30,0,63,61,250,4.8
4455,K.C. Ross-Miller\kc-ross-miller-1,2014-15,Auburn,G,35,27,879,72,199,.362,51,129,.395,21,70,.300,85,111,.766,11,64,75,83,54,1,81,87,250,4.4
4456,Deshon Taylor\deshon-taylor-1,2014-15,Missouri-Kansas City,G,33,10,765,80,196,.408,39,92,.424,41,104,.394,49,61,.803,18,49,67,44,29,2,40,64,250,4.9
4457,Cheddi Mosely\cheddi-mosley-1,2014-15,Boston University,G,29,25,694,90,209,.431,37,76,.487,53,133,.398,17,26,.654,5,39,44,30,24,3,32,37,250,5.2
4458,Fred Miller\fred-miller-1,2013-14,South Carolina Upstate,G,34,13,822,84,211,.398,56,136,.412,28,75,.373,54,72,.750,20,63,83,113,46,3,63,61,250,5.9
4459,Jordan Coleman\jordan-coleman-1,2013-14,Valparaiso,G,31,10,648,72,173,.416,59,119,.496,13,54,.241,93,118,.788,34,75,109,33,12,14,37,59,250,5.8
4460,Eric Cooper\eric-cooper-1,2017-18,Pepperdine,G,19,17,536,84,195,.431,44,83,.530,40,112,.357,42,49,.857,4,30,34,24,9,0,18,29,250,8.0
4461,Jordan Davis\jordan-davis-23,2017-18,Dayton,G,31,22,891,88,208,.423,32,66,.485,56,142,.394,17,23,.739,6,51,57,57,32,4,23,29,249,6.3
4462,Ambrose Mosley\ambrose-mosley-1,2014-15,Old Dominion,G,35,0,786,81,229,.354,18,43,.419,63,186,.339,24,33,.727,13,57,70,29,16,1,24,52,249,3.9
4463,Vasa Pusica\vasa-pusica-1,2015-16,San Diego,G,30,15,789,86,195,.441,61,130,.469,25,65,.385,52,69,.754,17,102,119,74,21,4,59,60,249,5.8
4464,Warren Jones\warren-jones-1,2014-15,Bradley,G,21,5,553,72,212,.340,38,97,.392,34,115,.296,71,109,.651,6,48,54,35,33,5,30,32,249,7.2
4465,Troy Green\troy-green-2,2017-18,New Orleans,G,33,16,652,80,175,.457,76,157,.484,4,18,.222,85,121,.702,24,60,84,67,16,3,56,82,249,4.7
4466,Jordan Fouse\jordan-fouse-1,2014-15,Green Bay,G,33,33,1060,101,203,.498,91,160,.569,10,43,.233,37,72,.514,74,160,234,121,64,37,56,93,249,9.5
4467,Justin Bassey\justin-bassey-1,2017-18,Harvard,G,31,26,1021,75,164,.457,38,77,.494,37,87,.425,62,76,.816,37,147,184,79,40,3,83,69,249,6.9
4468,Ryan Badowski\ryan-badowski-1,2014-15,Longwood,G,34,17,752,78,202,.386,17,43,.395,61,159,.384,32,44,.727,15,68,83,17,22,3,26,73,249,4.3
4469,Breein Tyree\breein-tyree-1,2016-17,Mississippi,G,34,22,651,85,228,.373,58,141,.411,27,87,.310,52,74,.703,9,55,64,65,22,0,71,53,249,3.3
4470,B.J. Miller\bj-miller-2,2017-18,Troy,G,33,20,935,92,185,.497,77,137,.562,15,48,.313,50,64,.781,24,76,100,104,41,11,56,81,249,6.8
4471,Torloft Thomas\torlorf-thomas-1,2015-16,Alabama State,G,31,22,838,70,187,.374,33,82,.402,37,105,.352,72,96,.750,20,56,76,58,21,3,64,69,249,4.5
4472,Malcolm Bernard\malcolm-bernard-1,2016-17,Xavier,G,38,34,1065,84,201,.418,38,84,.452,46,117,.393,35,60,.583,47,107,154,58,37,12,56,104,249,4.9
4473,Winston Grays\winston-grays-1,2014-15,James Madison,G,32,18,884,89,214,.416,53,110,.482,36,104,.346,35,52,.673,31,77,108,58,37,7,47,41,249,6.0
4474,De'Edrick Petty\deedrick-petty-1,2017-18,Alabama A&M,G,29,10,704,75,221,.339,55,125,.440,20,96,.208,79,102,.775,6,55,61,49,18,3,77,51,249,3.2
4475,Josiah Moore\josiah-moore-1,2013-14,Tennessee Tech,G,33,0,574,78,178,.438,53,107,.495,25,71,.352,67,102,.657,22,79,101,28,12,7,55,65,248,4.1
4476,Kendal Manuel\kendal-manuel-1,2016-17,Oregon State,G,32,25,923,86,229,.376,34,94,.362,52,135,.385,24,34,.706,13,64,77,52,29,2,57,66,248,4.1
4477,Xavier Cooks\xavier-cooks-1,2014-15,Winthrop,G,32,28,825,97,181,.536,94,165,.570,3,16,.188,51,83,.614,59,135,194,49,24,47,57,80,248,7.2
4478,Eric Laster\eric-laster-1,2013-14,Loyola (MD),G,30,28,833,90,215,.419,53,121,.438,37,94,.394,31,54,.574,40,65,105,31,12,12,30,64,248,5.3
4479,Kerwin Roach Jr.\kerwin-roachjr-1,2015-16,Texas,G,33,0,595,78,172,.453,59,114,.518,19,58,.328,73,116,.629,18,78,96,40,29,9,51,85,248,4.7
4480,Austin McBroom\austin-mcbroom-1,2013-14,Saint Louis,G,34,1,730,74,210,.352,30,84,.357,44,126,.349,56,62,.903,16,49,65,56,23,1,45,54,248,4.4
4481,Donald Hicks\donald-hicks-1,2016-17,Radford,G,32,28,850,85,239,.356,50,135,.370,35,104,.337,43,58,.741,33,84,117,43,20,2,55,79,248,3.8
4482,Frank Williams\frank-williams-2,2014-15,Missouri-Kansas City,G,33,25,884,91,242,.376,42,99,.424,49,143,.343,17,24,.708,10,75,85,44,23,11,28,27,248,5.0
4483,Nick Weiler-Babb\nick-weiler-babb-1,2017-18,Iowa State,G,22,20,791,84,188,.447,64,126,.508,20,62,.323,60,79,.759,15,138,153,149,28,8,55,37,248,11.9
4484,K.C. Ross-Miller\kc-ross-miller-1,2013-14,New Mexico State,G,30,29,818,62,142,.437,38,81,.469,24,61,.393,100,122,.820,10,55,65,104,23,0,58,72,248,6.6
4485,Brian Pegg\brian-pegg-1,2013-14,Stetson,G,30,21,867,97,222,.437,92,199,.462,5,23,.217,49,96,.510,69,120,189,40,24,11,59,50,248,5.9
4486,Julion Pearre\julion-pearre-1,2015-16,Utah State,G,31,9,716,91,214,.425,50,94,.532,41,120,.342,25,40,.625,7,46,53,45,18,6,34,68,248,4.5
4487,Chris Wilson\chris-wilson-1,2014-15,Saint Joseph's,G,31,31,1023,88,237,.371,47,101,.465,41,136,.301,31,54,.574,20,113,133,84,35,3,49,43,248,6.0
4488,Ryan Oliver\ryan-oliver-1,2015-16,Siena,G,34,21,826,89,217,.410,38,91,.418,51,126,.405,19,33,.576,21,79,100,45,15,0,40,68,248,4.2
4489,Zavion Williams\zavion-williams-1,2013-14,Austin Peay,G,30,8,601,83,192,.432,64,131,.489,19,61,.311,63,87,.724,10,54,64,75,35,5,71,66,248,5.1
4490,Andre Horne Jr.\andre-hornejr-1,2015-16,Morgan State,G,26,19,583,83,213,.390,50,115,.435,33,98,.337,49,63,.778,27,37,64,34,21,5,38,81,248,5.2
4491,Tre'Larenz Nottingham\trelarenz-nottingham-1,2017-18,Texas State,G,33,17,816,75,231,.325,29,90,.322,46,141,.326,52,70,.743,5,72,77,88,25,5,63,61,248,4.1
4492,A.C. Reid\ac-reid-1,2015-16,Liberty,G,32,12,745,85,236,.360,25,59,.424,60,177,.339,18,25,.720,7,84,91,47,20,4,49,71,248,3.8
4493,Keawe Enos\kaewe-enos-1,2013-14,Utah Valley,G,32,32,949,77,172,.448,21,47,.447,56,125,.448,38,42,.905,5,75,80,60,19,1,36,80,248,5.5
4494,L.J. Rose\lj-rose-2,2013-14,Houston,G,28,25,795,76,190,.400,50,127,.394,26,63,.413,70,90,.778,10,61,71,154,19,2,65,37,248,7.5
4495,Ricky Tarrant\ricky-tarrant-1,2014-15,Alabama,G,19,13,491,69,167,.413,40,70,.571,29,97,.299,81,101,.802,5,36,41,38,27,0,34,43,248,8.8
4496,Zedric Sadler\zedric-sadler-1,2013-14,Rider,G,30,24,853,85,203,.419,55,128,.430,30,75,.400,48,73,.658,22,96,118,89,27,10,59,50,248,6.4
4497,Bishop Mency\bishop-mency-1,2014-15,Rice,G,32,23,934,81,230,.352,22,57,.386,59,173,.341,27,42,.643,27,77,104,36,17,8,54,84,248,3.6
4498,Anell Alexis\anell-alexis-1,2013-14,Norfolk State,G,34,15,689,87,190,.458,67,133,.504,20,57,.351,53,68,.779,42,72,114,20,19,11,37,68,247,5.0
4499,Shannon Evans\shannon-evans-1,2013-14,Buffalo,G,29,0,766,73,209,.349,41,101,.406,32,108,.296,69,87,.793,11,61,72,95,40,11,60,56,247,6.2
4500,Jackson Trapp\jackson-trapp-1,2015-16,Florida Atlantic,G,33,32,926,83,209,.397,32,73,.438,51,136,.375,30,39,.769,7,83,90,32,14,12,26,51,247,4.8
4501,Micah Seaborn\micah-seaborn-1,2017-18,Monmouth,G,17,13,465,79,181,.436,37,86,.430,42,95,.442,47,53,.887,4,63,67,34,15,3,48,31,247,8.9
4502,Jarod Oldham\jarod-oldham-1,2013-14,Buffalo,G,29,29,906,77,192,.401,67,145,.462,10,47,.213,83,113,.735,16,66,82,153,50,11,83,85,247,7.2
4503,Cameron Johnson\cameron-johnson-3,2016-17,College of Charleston,G,35,33,1095,86,235,.366,52,125,.416,34,110,.309,41,60,.683,23,86,109,62,28,13,41,75,247,4.6
4504,Clemmye Owens\clemmye-owens-1,2016-17,Chicago State,G,28,11,722,91,221,.412,49,106,.462,42,115,.365,23,33,.697,18,51,69,55,21,2,33,54,247,5.7
4505,Anthony Thompson\anthony-thompson-2,2015-16,Holy Cross,G,35,33,1135,69,253,.273,26,85,.306,43,168,.256,66,83,.795,14,74,88,88,37,0,36,71,247,4.5
4506,David McFarland\david-mcfarland-1,2017-18,Southern Illinois-Edwardsville,G,29,23,685,84,227,.370,46,93,.495,38,134,.284,41,53,.774,19,78,97,44,32,4,36,76,247,5.3
4507,Taylor Dyson\taylor-dyson-1,2014-15,Hartford,G,30,23,676,73,213,.343,13,49,.265,60,164,.366,41,47,.872,12,71,83,18,8,0,21,54,247,4.4
4508,Davon Reed\davon-reed-1,2014-15,Miami (FL),G,30,21,824,77,164,.470,40,83,.482,37,81,.457,56,77,.727,25,96,121,57,27,13,32,68,247,7.3
4509,Cory Gensler\cory-gensler-1,2017-18,Campbell,G,34,32,1032,92,218,.422,44,91,.484,48,127,.378,15,23,.652,22,127,149,53,31,10,26,84,247,5.8
4510,Brian Starr\brian-starr-1,2017-18,Towson,G,30,30,919,75,187,.401,42,105,.400,33,82,.402,64,78,.821,10,69,79,78,33,5,60,53,247,5.9
4511,Jarod Williams\jarod-williams-1,2013-14,Detroit Mercy,G,32,29,756,83,205,.405,71,156,.455,12,49,.245,69,92,.750,20,70,90,63,33,8,54,59,247,5.2
4512,Justin Seymour\justin-seymour-1,2014-15,Murray State,G,35,0,709,79,192,.411,32,84,.381,47,108,.435,42,64,.656,15,62,77,41,22,9,42,75,247,4.3
4513,Dusty Hannahs\dusty-hannahs-1,2013-14,Texas Tech,G,32,10,706,73,193,.378,32,82,.390,41,111,.369,60,65,.923,14,30,44,40,14,1,26,53,247,4.8
4514,Marcus Johnson\marcus-johnson-8,2015-16,Samford,G,33,1,787,86,225,.382,49,98,.500,37,127,.291,38,55,.691,20,55,75,67,34,1,47,57,247,4.8
4515,Marquel Curtis\marquel-curtis-1,2014-15,Tulsa,G,34,27,931,92,204,.451,73,138,.529,19,66,.288,44,63,.698,32,81,113,52,20,3,61,53,247,4.6
4516,Angel Rivera\angel-rivera-2,2017-18,Stetson,G,32,32,938,74,174,.425,42,92,.457,32,82,.390,67,96,.698,21,91,112,150,27,2,50,83,247,7.4
4517,Rashun Davis\rashun-davis-1,2014-15,Radford,G,32,16,739,86,218,.394,74,157,.471,12,61,.197,63,86,.733,10,61,71,112,37,0,77,55,247,5.0
4518,Caris LeVert\caris-levert-1,2015-16,Michigan,G,15,14,464,82,162,.506,53,97,.546,29,65,.446,54,68,.794,9,71,80,74,15,3,25,18,247,15.0
4519,Zak Irvin\zak-irvin-1,2013-14,Michigan,G,37,0,568,85,196,.434,23,50,.460,62,146,.425,15,21,.714,14,35,49,13,9,3,16,35,247,4.1
4520,Chrishawn Hopkins\chrishawn-hopkins-1,2014-15,Wright State,G,29,22,817,82,198,.414,63,143,.441,19,55,.345,64,88,.727,12,74,86,81,18,3,60,42,247,5.6
4521,Daiquan Walker\daiquan-walker-1,2015-16,Central Florida,G,30,23,833,81,213,.380,48,124,.387,33,89,.371,52,64,.813,17,85,102,115,33,4,62,44,247,6.7
4522,Reggie Arceneaux\reggie-arceneaux-1,2013-14,Wright State,G,35,18,829,83,192,.432,36,91,.396,47,101,.465,34,36,.944,9,49,58,76,27,0,55,39,247,5.0
4523,Jeffrey Carroll\jeffrey-carroll-2,2015-16,Oklahoma State,G,30,20,738,87,212,.410,47,92,.511,40,120,.333,33,47,.702,18,101,119,19,17,8,35,42,247,5.2
4524,Eli Carter\eli-carter-1,2014-15,Florida,G,28,16,686,85,235,.362,42,94,.447,43,141,.305,34,42,.810,7,48,55,55,24,0,44,46,247,4.7
4525,Junior Robinson\lamont-robinson-1,2014-15,Mount St. Mary's,G,30,29,734,80,221,.362,48,125,.384,32,96,.333,55,73,.753,9,33,42,98,27,3,60,63,247,4.9
4526,Demarcus Holland\demarcus-holland-1,2013-14,Texas,G,35,35,1036,92,222,.414,78,174,.448,14,48,.292,49,86,.570,52,113,165,84,42,4,66,67,247,5.6
4527,Shaquille Johnson\shaquille-johnson-2,2015-16,Longwood,G,21,15,693,98,191,.513,84,134,.627,14,57,.246,37,66,.561,28,125,153,95,30,6,97,57,247,8.5
4528,Isaiah Williams\isaiah-williams-2,2016-17,Georgia State,G,32,23,656,82,191,.429,53,106,.500,29,85,.341,54,65,.831,8,44,52,60,22,5,34,39,247,5.6
4529,Lawrence Johnson-Danner\lawrence-johnson-danner-1,2013-14,Texas Southern,G,34,23,916,70,175,.400,11,33,.333,59,142,.415,48,55,.873,15,75,90,36,13,3,24,48,247,5.3
4530,Brandon Britt\brandon-britt-1,2013-14,William & Mary,G,23,9,538,80,164,.488,49,102,.480,31,62,.500,55,76,.724,6,38,44,32,15,0,21,26,246,7.7
4531,Matthew Fisher-Davis\matthew-fisher-davis-1,2014-15,Vanderbilt,G,34,11,777,80,228,.351,9,51,.176,71,177,.401,15,21,.714,16,63,79,46,13,16,31,55,246,4.4
4532,Montaque Gill-Caesar\montaque-gill-caesar-1,2014-15,Missouri,G,27,13,647,84,231,.364,55,137,.401,29,94,.309,49,66,.742,20,60,80,14,19,2,52,55,246,3.7
4533,Jamal Shabazz\jamal-shabazz-1,2015-16,Samford,G,33,33,758,76,192,.396,42,84,.500,34,108,.315,60,73,.822,37,77,114,18,17,16,32,91,246,4.8
4534,Jalen Perry\jalen-perry-1,2017-18,Alabama-Birmingham,G,33,2,759,80,196,.408,49,104,.471,31,92,.337,55,76,.724,25,90,115,60,21,1,45,50,246,5.3
4535,Ky Howard\ky-howard-1,2013-14,NJIT,G,27,26,704,79,178,.444,75,171,.439,4,7,.571,84,125,.672,23,90,113,105,19,4,77,75,246,6.2
4536,Riley Norris\riley-norris-1,2015-16,Alabama,G,33,19,930,77,208,.370,32,88,.364,45,120,.375,47,72,.653,54,122,176,23,26,8,39,64,246,5.4
4537,Damarcus Harrison\damarcus-harrison-1,2014-15,Clemson,G,31,21,753,83,222,.374,43,107,.402,40,115,.348,40,58,.690,13,78,91,38,19,6,47,65,246,4.1
4538,Trevor Lyons\trevor-lyons-1,2014-15,Air Force,G,31,26,864,84,186,.452,59,129,.457,25,57,.439,53,77,.688,12,65,77,68,41,0,30,57,246,6.6
4539,Jamal Webb\jamal-webb-2,2013-14,North Dakota,G,34,22,848,92,203,.453,73,151,.483,19,52,.365,43,68,.632,38,79,117,105,57,19,68,85,246,6.6
4540,C.J. Burks\cj-burks-1,2016-17,Marshall,G,25,1,641,88,195,.451,60,122,.492,28,73,.384,42,54,.778,13,52,65,57,19,7,54,50,246,6.2
4541,M.J. Walker\mj-walker-1,2017-18,Florida State,G,35,1,668,81,214,.379,40,95,.421,41,119,.345,43,57,.754,7,52,59,38,22,5,40,78,246,3.6
4542,Jahenns Manigat\jahenns-manigat-1,2013-14,Creighton,G,35,35,993,84,192,.438,24,44,.545,60,148,.405,18,20,.900,14,85,99,100,36,0,25,79,246,6.5
4543,Skyler Halford\skyler-halford-1,2013-14,Brigham Young,G,35,13,528,84,195,.431,55,102,.539,29,93,.312,49,58,.845,6,44,50,35,15,1,29,49,246,4.2
4544,Erik Durham\erik-durham-1,2015-16,Jacksonville State,G,21,14,611,87,208,.418,37,79,.468,50,129,.388,22,33,.667,25,58,83,18,16,5,14,49,246,7.8
4545,Carrington Love\carrington-love-1,2013-14,Green Bay,G,31,14,832,77,194,.397,43,86,.500,34,108,.315,58,82,.707,13,70,83,77,38,5,41,58,246,6.2
4546,P.J. Boutte\pj-boutte-1,2015-16,Citadel,G,31,27,786,87,208,.418,69,135,.511,18,73,.247,54,82,.659,45,84,129,176,51,1,81,75,246,7.9
4547,William Gates\william-gates-2,2013-14,Furman,G,30,3,801,97,212,.458,71,150,.473,26,62,.419,26,51,.510,10,58,68,20,19,3,56,44,246,3.7
4548,James Harvey\james-harvey-3,2016-17,McNeese State,G,29,20,712,80,242,.331,24,61,.393,56,181,.309,30,38,.789,9,38,47,19,19,3,36,37,246,3.7
4549,Keith Shivers\keith-shivers-1,2015-16,Coppin State,G,27,26,805,96,236,.407,81,171,.474,15,65,.231,38,60,.633,41,59,100,47,31,3,45,62,245,5.6
4550,Aaron Wheeler\aaron-wheeler-1,2014-15,Charleston Southern,G,31,21,961,103,214,.481,103,202,.510,0,12,.000,39,75,.520,77,83,160,74,34,18,51,63,245,7.2
4551,Dakarai Allen\dakarai-allen-1,2015-16,San Diego State,G,38,17,842,78,202,.386,52,104,.500,26,98,.265,63,93,.677,21,83,104,44,39,20,41,79,245,4.6
4552,Kendal Williams\kendal-williams-1,2013-14,Delaware State,G,30,20,820,92,221,.416,63,152,.414,29,69,.420,32,45,.711,15,53,68,84,21,0,47,47,245,5.4
4553,David Crisp\david-crisp-1,2015-16,Washington,G,34,0,728,82,253,.324,31,84,.369,51,169,.302,30,45,.667,23,59,82,56,28,4,41,62,245,3.9
4554,Wes Clark\wes-clark-2,2015-16,Missouri,G,25,25,662,80,216,.370,50,136,.368,30,80,.375,55,66,.833,14,61,75,73,23,4,53,63,245,5.9
4555,Earl Potts\earl-potts-1,2016-17,Fairleigh Dickinson,G,20,15,662,85,205,.415,42,82,.512,43,123,.350,32,44,.727,15,76,91,15,21,3,20,64,245,7.6
4556,Travis Wilkins\travis-wilkins-1,2013-14,Ohio,G,37,14,890,82,186,.441,27,58,.466,55,128,.430,26,32,.813,14,60,74,55,19,3,27,56,245,5.0
4557,Trency Jackson\trency-jackson-2,2013-14,Western Kentucky,G,24,14,597,80,199,.402,60,137,.438,20,62,.323,65,104,.625,19,38,57,43,23,2,44,51,245,5.7
4558,Federico Mussini\federico-mussini-1,2016-17,St. John's (NY),G,30,2,576,77,188,.410,21,57,.368,56,131,.427,35,41,.854,6,46,52,26,17,0,29,37,245,5.0
4559,Brandon Anderson\brandon-anderson-2,2016-17,Brown,G,30,28,688,74,184,.402,55,112,.491,19,72,.264,78,105,.743,6,42,48,55,38,1,62,74,245,4.6
4560,Dee Davis\dee-davis-1,2013-14,Xavier,G,32,29,997,78,196,.398,39,91,.429,39,105,.371,50,59,.847,8,50,58,149,38,1,62,85,245,6.3
4561,Stephan Holm\stephan-holm-1,2014-15,Montana State,G,25,1,600,82,212,.387,32,66,.485,50,146,.342,31,35,.886,8,46,54,11,7,1,36,30,245,4.6
4562,Sean Lloyd\sean-lloyd-1,2016-17,Southern Illinois,G,32,19,854,82,206,.398,59,140,.421,23,66,.348,58,84,.690,13,78,91,30,33,6,40,75,245,4.5
4563,Maurice Watson Jr.\mo-watsonjr-1,2016-17,Creighton,G,19,19,568,97,191,.508,82,159,.516,15,32,.469,36,52,.692,6,44,50,162,28,0,71,36,245,11.4
4564,Chance Murray\chance-murray-1,2016-17,UC-Riverside,G,24,20,739,87,231,.377,66,151,.437,21,80,.263,50,83,.602,9,112,121,65,30,4,48,47,245,6.5
4565,Eric Garcia\eric-garcia-2,2014-15,Wofford,G,32,30,860,68,158,.430,36,69,.522,32,89,.360,77,102,.755,7,56,63,80,20,1,41,43,245,6.0
4566,Corbin Miller\corbin-miller-1,2014-15,Harvard,G,30,2,756,79,214,.369,16,36,.444,63,178,.354,24,30,.800,6,41,47,19,15,1,16,26,245,4.8
4567,James Richardson\james-richardson-1,2016-17,South Carolina State,G,30,3,552,95,243,.391,64,141,.454,31,102,.304,24,39,.615,18,35,53,38,21,8,53,54,245,3.6
4568,Trevon Seymore\trevon-seymore-1,2015-16,Coppin State,G,24,21,748,79,230,.343,58,149,.389,21,81,.259,66,91,.725,22,92,114,95,32,7,58,62,245,7.1
4569,Mastadi Pitt\mastadi-pitt-1,2017-18,Norfolk State,G,29,9,590,81,213,.380,49,124,.395,32,89,.360,51,69,.739,7,48,55,67,12,0,41,55,245,4.7
4570,Maurice Taylor\maurice-taylor-3,2013-14,Bethune-Cookman,G,32,10,659,68,167,.407,56,136,.412,12,31,.387,97,131,.740,33,88,121,18,13,8,44,69,245,4.7
4571,Eric Davis Jr.\eric-davisjr-1,2015-16,Texas,G,33,2,673,80,214,.374,38,104,.365,42,110,.382,43,54,.796,12,68,80,21,13,0,26,40,245,4.2
4572,Jordan Pickett\jordan-pickett-1,2015-16,IUPUI,G,26,8,672,81,211,.384,58,139,.417,23,72,.319,59,72,.819,9,37,46,45,20,3,38,41,244,5.4
4573,Christian James\christian-james-1,2016-17,Oklahoma,G,31,14,682,81,223,.363,49,130,.377,32,93,.344,50,71,.704,26,88,114,35,21,2,61,73,244,3.7
4574,Derric Jean\derric-jean-1,2015-16,Louisiana Tech,G,33,0,709,87,193,.451,60,123,.488,27,70,.386,43,62,.694,31,69,100,72,33,8,48,77,244,5.7
4575,Iziahiah Sweeney\iziahiah-sweeney-1,2016-17,Northwestern State,G,29,20,749,87,224,.388,70,168,.417,17,56,.304,53,77,.688,43,66,109,32,35,14,44,52,244,5.7
4576,Wesley Davis\wesley-davis-1,2013-14,Texas State,G,29,27,820,94,206,.456,71,130,.546,23,76,.303,33,53,.623,12,58,70,47,36,3,37,77,244,5.5
4577,Marcus Hall\marcus-hall-3,2013-14,Portland State,G,32,31,952,79,187,.422,28,58,.483,51,129,.395,35,53,.660,27,85,112,49,25,9,34,115,244,5.2
4578,Thomas Wilder\thomas-wilder-1,2014-15,Western Michigan,G,34,8,693,81,180,.450,68,136,.500,13,44,.295,69,93,.742,3,81,84,56,34,2,57,53,244,4.8
4579,Tommy McCarthy\tommy-mccarthy-1,2015-16,Harvard,G,28,25,694,74,220,.336,33,105,.314,41,115,.357,55,65,.846,7,38,45,101,24,1,81,81,244,4.1
4580,James Reid\james-reid-1,2014-15,Little Rock,G,31,18,725,76,194,.392,24,44,.545,52,150,.347,40,52,.769,7,67,74,43,16,1,23,66,244,5.0
4581,Brandon McKissic\brandon-mckissic-1,2017-18,Missouri-Kansas City,G,31,20,713,86,187,.460,61,127,.480,25,60,.417,47,75,.627,18,68,86,48,24,3,40,94,244,4.9
4582,Ollie Jackson\ollie-jackson-1,2014-15,Saint Francis (PA),G,32,31,780,84,200,.420,33,69,.478,51,131,.389,25,39,.641,14,74,88,40,27,12,44,63,244,4.9
4583,Jordan Reed\jordan-reed-1,2016-17,Tennessee State,G,30,22,741,82,191,.429,73,160,.456,9,31,.290,71,101,.703,80,116,196,27,16,13,45,76,244,6.4
4584,Jonah Mathews\jonah-matthews-1,2016-17,Southern California,G,35,3,715,83,223,.372,41,96,.427,42,127,.331,36,52,.692,14,50,64,40,31,2,22,47,244,4.5
4585,Jacob Davison\jacob-davison-1,2017-18,Eastern Washington,G,34,7,544,78,161,.484,51,96,.531,27,65,.415,61,73,.836,21,73,94,19,26,11,33,57,244,5.5
4586,Chris Bilbo\chris-bilbo-1,2014-15,Troy,G,29,24,1006,83,221,.376,62,141,.440,21,80,.263,57,89,.640,15,89,104,85,28,7,62,60,244,5.3
4587,Sean O'Brien\sean-obrien-1,2014-15,Southern Illinois,G,33,33,908,91,206,.442,80,171,.468,11,35,.314,51,77,.662,38,124,162,54,31,23,63,80,244,5.4
4588,Cameron Golden\cameron-golden-1,2013-14,Arkansas State,G,32,11,768,81,226,.358,38,90,.422,43,136,.316,39,59,.661,11,68,79,81,36,3,50,52,244,5.1
4589,Cullen Neal\cullen-neal-1,2013-14,New Mexico,G,34,3,677,75,201,.373,33,84,.393,42,117,.359,51,71,.718,9,49,58,65,12,0,65,80,243,3.1
4590,Zach Gengler\zach-gengler-1,2015-16,Portland State,G,31,23,684,87,190,.458,57,96,.594,30,94,.319,39,46,.848,10,58,68,77,37,5,31,78,243,6.4
4591,Delano Spencer\delano-spencer-1,2016-17,Tennessee State,G,29,8,641,79,194,.407,21,47,.447,58,147,.395,27,31,.871,9,48,57,21,16,0,29,58,243,4.7
4592,Markus Terry\markus-terry-1,2015-16,Presbyterian,G,31,17,730,84,210,.400,59,128,.461,25,82,.305,50,78,.641,12,57,69,40,17,2,31,35,243,4.7
4593,Darian Bryant\darian-bryant-1,2016-17,Delaware,G,32,19,880,93,212,.439,72,151,.477,21,61,.344,36,54,.667,15,75,90,57,13,7,59,62,243,4.1
4594,Jadon Cohee\jadon-cohee-1,2015-16,Seattle,G,31,18,644,80,208,.385,51,130,.392,29,78,.372,54,64,.844,6,55,61,31,12,0,45,40,243,3.8
4595,Christian Bradford\christian-bradford-1,2016-17,Radford,G,32,27,946,89,250,.356,62,157,.395,27,93,.290,38,51,.745,9,84,93,112,15,1,63,52,243,4.4
4596,Drew Buggs\drew-buggs-1,2017-18,Hawaii,G,30,26,850,85,212,.401,65,150,.433,20,62,.323,53,81,.654,26,85,111,108,46,4,64,77,243,6.4
4597,Bishop Mency\bishop-mency-1,2017-18,Rice,G,31,29,973,77,214,.360,24,40,.600,53,174,.305,36,56,.643,49,105,154,26,16,7,32,57,243,5.4
4598,Malik Ellison\malik-ellison-1,2016-17,St. John's (NY),G,33,26,818,83,198,.419,53,110,.482,30,88,.341,47,79,.595,22,86,108,84,31,8,59,95,243,5.0
4599,Austin Howard\austin-howard-2,2016-17,Maine,G,32,19,683,90,236,.381,52,135,.385,38,101,.376,25,37,.676,12,59,71,28,14,1,35,30,243,3.8
4600,Mason Faulkner\mason-faulkner-1,2016-17,Northern Kentucky,G,33,0,603,79,196,.403,55,99,.556,24,97,.247,61,80,.763,13,67,80,68,27,2,44,67,243,5.0
4601,Jordan Washington\jordan-washington-2,2013-14,Mississippi Valley State,G,31,7,571,78,185,.422,49,103,.476,29,82,.354,58,76,.763,14,45,59,59,29,1,42,65,243,5.3
4602,Terrence Phillips\terrence-phillips-1,2015-16,Missouri,G,31,31,812,81,212,.382,52,122,.426,29,90,.322,52,72,.722,20,110,130,107,40,3,71,107,243,5.5
4603,Shavar Newkirk\shavar-newkirk-1,2016-17,Saint Joseph's,G,12,12,404,76,163,.466,57,115,.496,19,48,.396,72,85,.847,20,37,57,42,15,2,26,20,243,15.9
4604,Monte Morris\monte-morris-1,2013-14,Iowa State,G,36,17,1013,77,179,.430,49,110,.445,28,69,.406,61,72,.847,18,74,92,134,46,7,28,61,243,7.5
4605,Ore Arogundade\ore-arogundade-1,2016-17,Drake,G,31,14,657,88,214,.411,44,104,.423,44,110,.400,23,32,.719,30,75,105,34,31,4,33,56,243,5.5
4606,Ross Cummings\ross-cummings-1,2017-18,Mercer,G,28,12,489,77,179,.430,20,47,.426,57,132,.432,32,42,.762,5,40,45,14,8,1,16,37,243,5.3
4607,Barrington Stevens\barrington-stevens-1,2014-15,South Alabama,G,33,33,1109,89,241,.369,47,121,.388,42,120,.350,23,32,.719,16,77,93,104,17,2,52,70,243,4.6
4608,Trevor Lyons\trevor-lyons-1,2016-17,Air Force,G,33,17,849,79,204,.387,59,142,.415,20,62,.323,65,94,.691,15,92,107,78,47,1,40,56,243,6.0
4609,Aaron Bodager\aaron-bodager-1,2016-17,North Florida,G,34,34,998,83,229,.362,17,32,.531,66,197,.335,11,14,.786,35,99,134,47,31,0,61,70,243,4.2
4610,Curtis Diamond\curtis-diamond-1,2014-15,Georgia Southern,G,31,7,769,83,239,.347,47,101,.465,36,138,.261,41,74,.554,21,75,96,31,19,5,39,62,243,3.7
4611,Lasan Kromah\lasan-kromah-2,2013-14,Connecticut,G,40,17,897,90,208,.433,69,146,.473,21,62,.339,42,61,.689,22,85,107,46,45,14,51,55,243,4.5
4612,Matt Williams\matt-williams-4,2015-16,Central Florida,G,30,18,778,81,222,.365,26,55,.473,55,167,.329,25,34,.735,12,67,79,26,13,1,25,46,242,4.4
4613,Jourdan Stickler\jourdan-stickler-1,2015-16,Houston Baptist,G,31,29,709,84,214,.393,30,92,.326,54,122,.443,20,24,.833,20,42,62,32,14,1,35,45,242,4.4
4614,Cameron Wright\cameron-wright-1,2014-15,Pittsburgh,G,26,25,721,102,221,.462,98,202,.485,4,19,.211,34,67,.507,11,66,77,75,36,12,43,60,242,6.6
4615,Marlain Veal\marlain-veal-1,2015-16,Southeastern Louisiana,G,33,23,716,79,176,.449,60,123,.488,19,53,.358,65,92,.707,23,54,77,98,40,3,82,80,242,5.1
4616,Amin Torres\amin-torres-1,2014-15,Nicholls State,G,24,3,459,77,189,.407,39,86,.453,38,103,.369,50,62,.806,4,28,32,34,29,3,49,49,242,5.6
4617,Tyler Russell\tyler-russell-1,2013-14,Houston Baptist,G,29,13,662,92,223,.413,69,158,.437,23,65,.354,35,46,.761,16,56,72,35,16,1,50,52,242,4.0
4618,Josh Kozinski\josh-kozinski-1,2017-18,Central Michigan,G,36,34,869,73,204,.358,3,9,.333,70,195,.359,26,30,.867,9,67,76,18,18,2,8,54,242,4.3
4619,Pat Benzan\pat-benzan-1,2016-17,Holy Cross,G,32,9,929,93,181,.514,85,157,.541,8,24,.333,48,72,.667,23,57,80,76,45,0,42,51,242,6.6
4620,John Marshall\john-marshall-1,2016-17,Southern Utah,G,32,25,961,64,187,.342,44,128,.344,20,59,.339,94,121,.777,33,107,140,94,42,5,55,84,242,6.4
4621,Amar Stukes\amar-stukes-1,2016-17,La Salle,G,30,27,942,84,165,.509,76,138,.551,8,27,.296,66,80,.825,25,61,86,129,38,1,53,84,242,7.8
4622,Chad Jackson\chad-jackson-2,2014-15,Northern Kentucky,G,30,27,783,88,179,.492,88,176,.500,0,3,.000,66,110,.600,63,101,164,63,26,4,44,78,242,6.9
4623,Joshua Langford\joshua-langford-1,2016-17,Michigan State,G,35,27,735,94,189,.497,57,100,.570,37,89,.416,17,26,.654,25,56,81,38,14,3,38,70,242,4.4
4624,Kethan Savage\kethan-savage-1,2013-14,George Washington,G,19,17,486,85,164,.518,79,140,.564,6,24,.250,66,99,.667,28,54,82,49,36,12,42,44,242,10.7
4625,Lionheart Leslie\lionheart-leslie-1,2015-16,Cal State Fullerton,G,29,18,718,78,179,.436,59,114,.518,19,65,.292,67,94,.713,20,70,90,52,27,1,41,77,242,5.7
4626,Rob Ukawuba\rob-ukawuba-1,2016-17,NJIT,G,31,25,763,87,191,.455,76,145,.524,11,46,.239,57,93,.613,42,92,134,54,14,5,55,73,242,5.1
4627,Jackson Kent\jackson-kent-1,2015-16,James Madison,G,32,31,872,79,230,.343,36,100,.360,43,130,.331,41,56,.732,21,101,122,61,15,4,36,29,242,5.1
4628,Josh Hall\josh-hall-2,2017-18,Nevada,G,35,8,829,92,183,.503,77,133,.579,15,50,.300,43,60,.717,43,93,136,48,21,13,42,60,242,5.7
4629,Jordan Geist\jordan-geist-1,2017-18,Missouri,G,33,11,860,73,167,.437,40,77,.519,33,90,.367,63,90,.700,19,109,128,95,27,0,57,62,242,6.1
4630,Kyle Davis\kyle-davis-3,2016-17,Dayton,G,30,20,832,83,148,.561,59,88,.670,24,60,.400,52,78,.667,15,100,115,79,49,10,27,68,242,8.6
4631,Robert Johnson\robert-johnson-5,2015-16,Indiana,G,30,22,747,84,187,.449,33,73,.452,51,114,.447,23,36,.639,12,88,100,94,19,5,51,53,242,6.3
4632,Wes VanBeck\wes-vanbeck-1,2016-17,Houston,G,32,5,708,70,157,.446,24,62,.387,46,95,.484,55,63,.873,20,63,83,51,17,2,29,93,241,5.5
4633,Trey Norris\trey-norris-1,2015-16,South Dakota,G,32,11,949,87,190,.458,68,139,.489,19,51,.373,48,60,.800,18,55,73,139,38,3,68,82,241,6.4
4634,Mitchell Ballock\mitchell-ballock-1,2017-18,Creighton,G,33,5,707,88,209,.421,44,74,.595,44,135,.326,21,26,.808,9,86,95,63,24,7,38,51,241,5.3
4635,Quinn Taylor\quinn-taylor-2,2017-18,Saint Peter's,G,32,31,848,79,162,.488,68,125,.544,11,37,.297,72,95,.758,54,129,183,53,33,9,65,94,241,6.3
4636,Osborn Blount\osborn-blount-1,2017-18,North Florida,G,33,0,710,81,214,.379,41,103,.398,40,111,.360,39,48,.813,6,52,58,41,37,0,52,53,241,4.0
4637,Demarcus Holland\demarcus-holland-1,2014-15,Texas,G,34,27,976,85,173,.491,59,117,.504,26,56,.464,45,65,.692,46,63,109,82,13,5,65,58,241,5.4
4638,Travon Baker\travon-baker-1,2014-15,Northern Illinois,G,30,18,768,73,221,.330,37,98,.378,36,123,.293,59,85,.694,8,44,52,94,45,1,59,68,241,5.0
4639,Jarrel Marshall\jarrel-marshall-1,2015-16,Portland,G,31,0,581,86,236,.364,64,165,.388,22,71,.310,47,61,.770,26,82,108,38,12,22,34,56,241,4.7
4640,Donivine Stewart\donivine-stewart-1,2014-15,Southern Illinois-Edwardsville,G,28,27,899,82,218,.376,54,129,.419,28,89,.315,49,86,.570,27,94,121,114,38,1,47,33,241,7.6
4641,Kris Clyburn\kris-clyburn-1,2017-18,Nevada-Las Vegas,G,33,20,748,84,205,.410,50,101,.495,34,104,.327,39,69,.565,40,65,105,48,17,9,43,43,241,4.9
4642,B.J. Tyson\bj-tyson-1,2016-17,East Carolina,G,25,18,627,91,237,.384,75,178,.421,16,59,.271,43,63,.683,7,65,72,59,26,4,49,29,241,5.5
4643,Victor Bailey Jr.\victor-baileyjr-1,2017-18,Oregon,G,36,0,597,81,194,.418,49,106,.462,32,88,.364,47,54,.870,21,41,62,31,15,4,29,42,241,4.3
4644,Matty McConnell\matty-mcconnell-1,2016-17,Robert Morris,G,33,26,854,81,242,.335,30,81,.370,51,161,.317,28,39,.718,22,122,144,49,54,10,40,75,241,5.4
4645,Shane Rector\shane-rector-1,2016-17,Utah State,G,29,16,652,79,180,.439,56,112,.500,23,68,.338,60,87,.690,7,54,61,68,30,10,51,54,241,5.8
4646,Jake Allsmiller\jake-allsmiller-1,2015-16,Georgia Southern,G,31,23,833,74,221,.335,9,24,.375,65,197,.330,28,30,.933,9,45,54,38,20,7,26,73,241,4.2
4647,Jabari Bird\jabari-bird-1,2014-15,University of California,G,23,21,648,92,210,.438,61,126,.484,31,84,.369,26,34,.765,22,54,76,40,11,10,28,51,241,6.8
4648,Paul Baxter\paul-baxter-1,2016-17,Sam Houston State,G,33,32,821,79,193,.409,66,131,.504,13,62,.210,70,106,.660,20,76,96,63,40,7,38,101,241,5.2
4649,Lawrence Cooks\lawrence-cooks-1,2015-16,Hampton,G,31,21,856,74,185,.400,39,77,.506,35,108,.324,58,67,.866,15,100,115,47,19,3,42,77,241,5.1
4650,Carlton Brundidge\carlton-brundidge-1,2013-14,Detroit Mercy,G,32,20,697,80,205,.390,62,142,.437,18,63,.286,63,95,.663,22,55,77,48,27,5,52,62,241,4.2
4651,Jarred Dixon\jarred-dixon-1,2015-16,Missouri State,G,30,17,725,91,222,.410,80,181,.442,11,41,.268,47,64,.734,22,46,68,45,40,4,30,60,240,5.5
4652,Angel Rivera\angel-rivera-2,2016-17,Stetson,G,30,28,931,80,195,.410,57,116,.491,23,79,.291,57,78,.731,7,87,94,162,26,0,52,63,240,7.3
4653,Greg Malinowski\greg-malinowski-1,2016-17,William & Mary,G,31,24,673,86,207,.415,34,77,.442,52,130,.400,16,20,.800,17,92,109,45,15,2,41,54,240,4.9
4654,Paul Watson\paul-watson-1,2015-16,Fresno State,G,31,24,748,85,210,.405,54,128,.422,31,82,.378,39,54,.722,26,72,98,21,21,16,34,69,240,4.7
4655,Cody Demps\cody-demps-1,2013-14,Sacramento State,G,30,30,879,86,191,.450,76,146,.521,10,45,.222,58,83,.699,29,96,125,57,31,3,54,85,240,5.5
4656,Chris Bowling\chris-bowling-1,2017-18,Northern Arizona,G,31,24,737,86,248,.347,41,109,.376,45,139,.324,23,32,.719,11,71,82,35,22,12,54,61,240,3.3
4657,Tre'Shaun Fletcher\treshaun-fletcher-1,2015-16,Colorado,G,34,14,666,75,189,.397,40,88,.455,35,101,.347,55,66,.833,25,56,81,38,13,6,44,68,240,4.1
4658,Shane McLaughlin\shane-mclaughlin-1,2015-16,Bryant,G,31,31,1134,86,215,.400,61,143,.427,25,72,.347,43,73,.589,9,97,106,165,29,1,95,65,240,5.5
4659,Dominique Collier\dominique-collier-1,2017-18,Colorado,G,32,10,632,71,184,.386,29,76,.382,42,108,.389,56,77,.727,8,41,49,46,18,0,42,82,240,3.9
4660,J.D. Paige\jd-paige-1,2017-18,Colorado State,G,23,22,721,85,241,.353,51,127,.402,34,114,.298,36,46,.783,17,52,69,58,27,6,57,51,240,5.4
4661,Rick Kreklow\ricky-kreklow-1,2014-15,Creighton,G,32,19,783,76,177,.429,33,64,.516,43,113,.381,45,63,.714,34,66,100,48,24,6,44,77,240,5.3
4662,Mislav Brzoja\mislav-brzoja-1,2014-15,Evansville,G,32,7,789,83,200,.415,61,125,.488,22,75,.293,52,69,.754,36,107,143,84,28,8,71,68,240,5.6
4663,Jermaine Bishop\jermaine-bishop-2,2015-16,Saint Louis,G,27,16,562,80,197,.406,51,108,.472,29,89,.326,51,59,.864,7,46,53,62,10,2,45,33,240,5.4
4664,Isaiah Reese\isaiah-reese-1,2016-17,Canisius,G,34,1,704,91,215,.423,70,135,.519,21,80,.263,37,51,.725,25,101,126,98,46,7,58,75,240,5.9
4665,Nick Norton\nick-norton-1,2017-18,Alabama-Birmingham,G,32,32,940,80,213,.376,29,63,.460,51,150,.340,29,36,.806,9,82,91,156,39,1,52,44,240,7.2
4666,Chazz Patterson\chazz-patterson-1,2015-16,Saint Peter's,G,30,30,955,78,223,.350,37,89,.416,41,134,.306,43,62,.694,9,129,138,51,43,21,58,54,240,5.5
4667,Xavian Stapleton\xavian-stapleton-1,2014-15,Louisiana Tech,G,36,1,558,85,206,.413,52,91,.571,33,115,.287,37,53,.698,29,45,74,12,26,23,24,67,240,4.4
4668,Greg Malinowski\greg-malinowski-1,2015-16,William & Mary,G,31,2,582,83,193,.430,48,88,.545,35,105,.333,38,53,.717,27,92,119,24,18,8,22,52,239,5.7
4669,Rodney Cooper\rodney-cooper-1,2013-14,Alabama,G,32,22,939,82,235,.349,53,125,.424,29,110,.264,46,62,.742,45,111,156,60,17,15,42,86,239,5.0
4670,Hakeem Baxter\hakeem-baxter-1,2016-17,Alabama-Birmingham,G,32,31,800,68,180,.378,46,116,.397,22,64,.344,81,111,.730,21,76,97,60,19,1,48,58,239,4.9
4671,Peter Jok\peter-jok-1,2014-15,Iowa,G,34,21,676,83,232,.358,47,127,.370,36,105,.343,37,41,.902,25,63,88,44,19,4,43,63,239,3.8
4672,Elijah Pughsley\elijah-pughsley-1,2015-16,Western Carolina,G,26,4,535,70,206,.340,16,58,.276,54,148,.365,45,62,.726,9,35,44,36,25,1,54,44,239,4.3
4673,Austin Ajukwa\austin-ajukwa-1,2016-17,Charlotte,G,21,17,567,84,189,.444,60,131,.458,24,58,.414,47,59,.797,14,86,100,14,17,13,29,47,239,7.6
4674,Jeff Elorriaga\jeff-elorriaga-1,2013-14,Boise State,G,31,27,875,78,175,.446,8,19,.421,70,156,.449,13,18,.722,4,61,65,36,21,0,17,64,239,5.5
4675,Charles Bennett\charles-bennett-1,2014-15,Indiana State,G,30,6,688,74,190,.389,33,72,.458,41,118,.347,50,64,.781,12,62,74,90,24,1,56,54,239,5.6
4676,Austin Luke\austin-luke-1,2016-17,Belmont,G,30,30,923,79,199,.397,33,58,.569,46,141,.326,35,50,.700,8,77,85,214,35,0,92,51,239,7.5
4677,Bo Zeigler\bo-zeigler-1,2017-18,George Washington,G,33,6,617,107,171,.626,107,171,.626,0,0,,25,43,.581,45,50,95,21,18,36,43,79,239,5.6
4678,Johnathan Loyd\johnathan-loyd-1,2013-14,Oregon,G,34,28,867,73,159,.459,55,107,.514,18,52,.346,75,91,.824,8,53,61,161,36,4,60,78,239,6.8
4679,Jack Perry\jack-perry-1,2017-18,Eastern Washington,G,35,27,957,83,184,.451,27,54,.500,56,130,.431,17,21,.810,8,61,69,84,13,0,52,46,239,4.8
4680,I.J. Ready\ij-ready-1,2014-15,Mississippi State,G,29,21,744,87,218,.399,59,123,.480,28,95,.295,37,42,.881,6,51,57,71,37,0,41,46,239,5.7
4681,K.J. Rose\kj-rose-1,2013-14,Fairfield,G,30,29,936,88,203,.433,74,150,.493,14,53,.264,49,93,.527,29,73,102,112,25,0,94,99,239,4.2
4682,Maurice Aniefiok\maurice-aniefiok-1,2014-15,North Texas,G,28,26,839,84,205,.410,37,84,.440,47,121,.388,24,38,.632,9,88,97,40,26,1,47,65,239,4.9
4683,Tyson Carter\tyson-carter-1,2016-17,Mississippi State,G,32,12,645,84,211,.398,40,89,.449,44,122,.361,27,33,.818,5,50,55,22,23,4,14,45,239,4.7
4684,Nick Rutherford\nick-rutherford-1,2015-16,Florida Atlantic,G,33,32,866,74,202,.366,63,164,.384,11,38,.289,80,114,.702,17,79,96,117,49,9,90,72,239,5.1
4685,Nick Robinson\nick-robinson-2,2017-18,Saint Joseph's,G,31,11,804,81,175,.463,65,129,.504,16,46,.348,61,76,.803,34,127,161,77,30,12,46,92,239,6.9
4686,Austin Ruder\austin-ruder-1,2017-18,Oral Roberts,G,22,14,698,80,220,.364,17,48,.354,63,172,.366,16,20,.800,5,61,66,50,17,0,21,39,239,6.9
4687,Kethan Savage\kethan-savage-1,2016-17,Butler,G,30,11,613,77,174,.443,63,126,.500,14,48,.292,71,95,.747,5,75,80,46,27,6,34,59,239,5.7
4688,Terry Larrier\terry-larrier-1,2014-15,Virginia Commonwealth,G,36,6,666,73,213,.343,41,91,.451,32,122,.262,61,86,.709,33,75,108,21,17,5,38,49,239,3.7
4689,Donte Ingram\donte-ingram-1,2015-16,Loyola (IL),G,32,26,828,85,216,.394,60,127,.472,25,89,.281,43,51,.843,35,96,131,26,12,8,35,57,238,4.7
4690,Chris Harrison-Docks\chris-harrison-docks-1,2013-14,Western Kentucky,G,24,14,632,70,195,.359,24,68,.353,46,127,.362,52,60,.867,4,42,46,52,8,0,55,39,238,4.8
4691,Shon Briggs\shon-briggs-1,2017-18,Cal State Bakersfield,G,23,23,579,78,213,.366,74,194,.381,4,19,.211,78,110,.709,40,86,126,43,17,7,46,55,238,6.3
4692,Darreon Reddick\darreon-reddick-1,2014-15,Tennessee State,G,31,26,842,82,205,.400,60,156,.385,22,49,.449,52,75,.693,19,93,112,42,22,2,61,83,238,3.8
4693,Skyler Flatten\skyler-flatten-1,2017-18,South Dakota State,G,35,31,922,84,170,.494,29,58,.500,55,112,.491,15,21,.714,16,94,110,41,16,12,13,43,238,6.1
4694,Tyler Melville\tyler-melville-1,2013-14,Dartmouth,G,28,25,650,76,195,.390,47,128,.367,29,67,.433,57,84,.679,14,36,50,36,17,8,39,72,238,4.3
4695,Jordan Wilson\jordan-wilson-1,2013-14,Northern Colorado,G,32,23,781,89,209,.426,57,116,.491,32,93,.344,28,37,.757,12,37,49,77,26,1,41,58,238,5.0
4696,Casey Wells\casey-wells-1,2016-17,Savannah State,G,27,3,450,71,202,.351,3,13,.231,68,189,.360,28,37,.757,14,25,39,15,9,2,12,29,238,5.0
4697,Miles Reynolds\miles-reynolds-1,2015-16,Saint Louis,G,29,15,593,65,149,.436,59,127,.465,6,22,.273,102,130,.785,9,54,63,73,29,3,51,63,238,6.1
4698,Troymain Crosby\troymain-crosby-1,2017-18,Alcorn State,G,32,2,622,88,199,.442,85,167,.509,3,32,.094,59,80,.738,46,92,138,22,22,6,68,92,238,3.8
4699,Kasheem Thomas\kasheem-thomas-1,2016-17,Cleveland State,G,31,30,876,75,201,.373,46,105,.438,29,96,.302,59,84,.702,13,72,85,102,26,0,49,70,238,5.4
4700,Jordan Horn\jordan-horn-1,2017-18,Siena,G,30,13,592,78,206,.379,30,69,.435,48,137,.350,34,43,.791,19,52,71,31,17,4,34,37,238,4.8
4701,Chris Howell\chris-howell-2,2016-17,South Dakota State,G,31,14,504,82,164,.500,82,163,.503,0,1,.000,74,99,.747,37,93,130,48,13,4,68,55,238,5.1
4702,Phil Greene\phil-greene-1,2013-14,St. John's (NY),G,32,28,797,90,226,.398,60,151,.397,30,75,.400,28,43,.651,16,65,81,49,22,3,18,40,238,5.2
4703,Kaleb Johnson\kaleb-johnson-1,2017-18,Georgetown,G,30,30,813,84,155,.542,68,108,.630,16,47,.340,54,73,.740,47,78,125,60,18,21,43,67,238,7.2
4704,Kris Martin\kris-martin-1,2015-16,Oral Roberts,G,31,14,649,82,203,.404,45,93,.484,37,110,.336,37,54,.685,8,73,81,38,16,12,39,28,238,4.8
4705,Silas Melson\silas-melson-1,2015-16,Gonzaga,G,36,1,780,78,202,.386,46,103,.447,32,99,.323,50,65,.769,8,85,93,30,21,6,24,70,238,4.1
4706,Jordan Bowden\jordan-bowden-1,2016-17,Tennessee,G,30,27,683,75,202,.371,40,91,.440,35,111,.315,53,63,.841,24,63,87,40,27,5,22,62,238,5.7
4707,Ethan Montalvo\ethan-montalvo-1,2014-15,Texas State,G,31,11,664,73,209,.349,22,47,.468,51,162,.315,41,51,.804,3,38,41,42,18,4,37,46,238,4.0
4708,Omari Grier\omari-grier-1,2014-15,Bradley,G,30,11,682,74,196,.378,40,89,.449,34,107,.318,55,70,.786,12,41,53,27,11,1,37,37,237,4.1
4709,Schadrac Casimir\schadrac-casimir-1,2016-17,Iona,G,34,8,683,74,174,.425,33,78,.423,41,96,.427,48,51,.941,18,34,52,49,19,2,28,38,237,5.2
4710,Mikey Thompson\mikey-thompson-1,2014-15,Boise State,G,31,20,754,66,182,.363,52,137,.380,14,45,.311,91,117,.778,14,58,72,55,16,0,47,40,237,4.7
4711,Josh Kozinski\josh-kozinski-1,2014-15,Central Michigan,G,32,0,563,76,202,.376,2,4,.500,74,198,.374,11,15,.733,9,32,41,9,13,0,5,39,237,4.3
4712,Patrick Steeves\patrick-steeves-1,2015-16,Harvard,G,26,4,590,83,185,.449,50,112,.446,33,73,.452,38,57,.667,15,84,99,62,20,17,55,42,237,6.6
4713,Mitchell Badillo\mitchell-badillo-1,2014-15,Incarnate Word,G,27,19,847,76,156,.487,56,99,.566,20,57,.351,65,83,.783,23,58,81,135,29,1,59,58,237,8.4
4714,Antwon Lillard\antwon-lillard-1,2016-17,Bowling Green State,G,30,17,690,79,182,.434,67,132,.508,12,50,.240,67,99,.677,36,89,125,45,22,12,52,63,237,5.5
4715,Fatts Russell\fatts-russell-1,2017-18,Rhode Island,G,34,0,608,82,233,.352,43,102,.422,39,131,.298,34,42,.810,16,40,56,53,27,1,27,70,237,4.0
4716,Cavon Baker\cavon-baker-1,2016-17,Saint Peter's,G,36,2,571,93,198,.470,72,147,.490,21,51,.412,30,41,.732,21,74,95,27,25,8,35,51,237,4.5
4717,Justinian Jessup\justinian-jessup-1,2016-17,Boise State,G,32,31,754,77,204,.377,27,63,.429,50,141,.355,33,43,.767,12,77,89,45,31,10,38,61,237,5.0
4718,Zach Stahl\zach-stahl-1,2013-14,Northeastern,G,32,9,722,87,197,.442,84,179,.469,3,18,.167,60,100,.600,58,99,157,36,21,8,51,92,237,4.8
4719,Antoine Pittman\antoine-pittman-1,2015-16,Bradley,G,29,26,795,81,223,.363,56,135,.415,25,88,.284,50,66,.758,24,42,66,36,22,5,62,80,237,3.2
4720,Yettra Specks\yettra-specks-1,2015-16,Jackson State,G,36,35,1083,75,192,.391,31,69,.449,44,123,.358,43,52,.827,24,52,76,94,35,1,60,102,237,4.5
4721,Ahmad Walker\ahmad-walker-1,2013-14,Stony Brook,G,34,31,817,83,196,.423,81,174,.466,2,22,.091,69,114,.605,49,130,179,70,31,5,63,86,237,5.1
4722,Omari Grier\omari-grier-1,2015-16,Rutgers,G,31,18,652,79,180,.439,45,96,.469,34,84,.405,45,54,.833,11,35,46,23,12,2,32,36,237,4.5
4723,Ben Dillard\ben-dillard-1,2014-15,Little Rock,G,31,23,782,70,200,.350,36,76,.474,34,124,.274,63,77,.818,15,35,50,46,15,2,28,56,237,4.5
4724,Giddy Potts\giddy-potts-1,2014-15,Middle Tennessee,G,36,21,649,80,213,.376,34,91,.374,46,122,.377,31,41,.756,10,88,98,31,26,4,40,64,237,3.7
4725,Steven Spieth\steven-spieth-1,2013-14,Brown,G,29,29,932,71,142,.500,56,104,.538,15,38,.395,80,93,.860,37,123,160,68,35,8,52,71,237,8.0
4726,Dashawn King\dashawn-king-1,2016-17,Missouri-Kansas City,G,34,25,576,82,185,.443,65,136,.478,17,49,.347,56,87,.644,25,61,86,44,26,7,50,75,237,4.3
4727,Antwoine Anderson\antwoine-anderson-1,2017-18,Connecticut,G,32,16,1004,77,197,.391,51,101,.505,26,96,.271,56,75,.747,13,78,91,65,34,5,51,93,236,4.6
4728,Gabe DeVoe\gabe-devoe-1,2016-17,Clemson,G,33,7,792,87,228,.382,43,94,.457,44,134,.328,18,30,.600,22,71,93,62,37,7,47,51,236,4.9
4729,Devonte Green\devonte-green-1,2017-18,Indiana,G,31,12,697,80,220,.364,47,122,.385,33,98,.337,43,61,.705,9,51,60,76,32,6,59,33,236,4.7
4730,Zavier Turner\zavier-turner-1,2014-15,Ball State,G,27,12,802,70,195,.359,34,82,.415,36,113,.319,60,85,.706,6,46,52,88,20,1,87,62,236,3.9
4731,Cassius Winston\cassius-winston-1,2016-17,Michigan State,G,35,5,724,77,182,.423,50,111,.450,27,71,.380,55,70,.786,6,58,64,182,26,5,77,72,236,5.9
4732,Marcus Allen\marcus-allen-2,2016-17,Stanford,G,29,26,762,91,210,.433,81,160,.506,10,50,.200,44,70,.629,12,55,67,52,36,2,47,57,236,5.0
4733,Jordan Green\jordan-green-1,2013-14,Texas A&M,G,34,27,862,85,186,.457,66,123,.537,19,63,.302,47,74,.635,14,63,77,54,25,4,36,62,236,4.8
4734,Kasey Hill\kasey-hill-1,2014-15,Florida,G,33,32,1000,89,235,.379,81,206,.393,8,29,.276,50,95,.526,13,64,77,149,32,8,72,66,236,4.9
4735,Gavin Block\gavin-block-1,2016-17,Ohio,G,31,31,870,77,180,.428,50,102,.490,27,78,.346,55,84,.655,23,110,133,64,31,6,47,63,236,6.0
4736,Sam Mills\sam-mills-1,2013-14,La Salle,G,31,30,970,80,206,.388,29,83,.349,51,123,.415,25,31,.806,14,64,78,63,29,5,51,64,236,4.9
4737,Angel Rivera\angel-rivera-2,2014-15,Stetson,G,31,8,751,72,158,.456,37,70,.529,35,88,.398,57,84,.679,12,61,73,120,17,1,50,60,236,6.4
4738,Mike Hughes\mike-hughes-1,2014-15,Georgia Southern,G,31,31,940,80,185,.432,50,89,.562,30,96,.313,46,68,.676,49,102,151,70,40,7,43,60,236,7.1
4739,Khalil Ahmad\khalil-ahmad-1,2016-17,Cal State Fullerton,G,21,10,576,88,219,.402,60,130,.462,28,89,.315,32,44,.727,20,64,84,29,24,3,47,48,236,6.0
4740,LeRon Barnes\leron-barnes-1,2014-15,Houston,G,32,31,1083,82,199,.412,55,116,.474,27,83,.325,45,63,.714,68,138,206,43,26,22,40,86,236,6.5
4741,J.C. Show\jc-show-1,2014-15,Bucknell,G,34,3,621,79,200,.395,31,69,.449,48,131,.366,30,42,.714,13,41,54,27,8,1,29,42,236,3.7
4742,Jacob Ledoux\jacob-ledoux-1,2017-18,McNeese State,G,29,1,561,81,187,.433,57,118,.483,24,69,.348,50,68,.735,13,62,75,56,34,2,52,41,236,5.7
4743,PJ Pipes\pj-pipes-1,2017-18,Green Bay,G,33,26,740,75,202,.371,48,119,.403,27,83,.325,59,69,.855,15,62,77,64,22,3,46,69,236,4.4
4744,Carlos Morris\carlos-morris-2,2015-16,Minnesota,G,24,16,613,86,221,.389,61,150,.407,25,71,.352,39,56,.696,13,72,85,34,19,6,44,32,236,5.4
4745,Davonta Jordan\davonta-jordan-1,2017-18,Buffalo,G,36,35,907,99,211,.469,80,147,.544,19,64,.297,18,37,.486,13,90,103,144,41,13,82,105,235,5.1
4746,Bobby Brown\bobby-brown-2,2014-15,Alabama State,G,28,24,639,81,215,.377,45,120,.375,36,95,.379,37,50,.740,38,107,145,32,8,21,40,37,235,5.7
4747,Matt Howard\matt-howard-2,2014-15,Pennsylvania,G,28,24,736,84,179,.469,67,126,.532,17,53,.321,50,72,.694,23,66,89,26,28,7,37,53,235,5.8
4748,Bishop Daniels\bishop-daniels-1,2014-15,Rutgers,G,28,20,694,82,212,.387,67,159,.421,15,53,.283,56,78,.718,10,50,60,47,18,14,71,60,235,3.5
4749,Ryan Andino\ryan-andino-1,2014-15,Maryland-Eastern Shore,G,33,4,709,75,182,.412,11,30,.367,64,152,.421,21,27,.778,9,25,34,24,16,0,18,38,235,4.5
4750,Lucas Nutt\lucas-nutt-1,2013-14,Southeast Missouri State,G,32,31,923,66,165,.400,43,100,.430,23,65,.354,80,98,.816,5,67,72,191,25,1,71,67,235,7.0
4751,Aubrey Dawkins\aubrey-dawkins-1,2015-16,Michigan,G,36,9,568,85,170,.500,41,70,.586,44,100,.440,21,29,.724,23,66,89,18,16,5,21,45,235,4.9
4752,Aaron Graham\aaron-graham-1,2013-14,Stetson,G,30,24,765,77,211,.365,37,91,.407,40,120,.333,41,53,.774,11,36,47,31,21,2,43,54,235,3.7
4753,Nate Hickman\nate-hickman-1,2017-18,Columbia,G,27,27,735,76,207,.367,45,102,.441,31,105,.295,52,66,.788,11,74,85,38,18,5,43,56,235,4.7
4754,Demetrius Troy\demetrius-troy-1,2016-17,North Carolina-Greensboro,G,34,2,708,83,199,.417,39,84,.464,44,115,.383,25,33,.758,15,62,77,117,36,1,60,46,235,5.7
4755,Karon Wright\karon-wright-1,2014-15,South Carolina State,G,33,7,571,77,257,.300,17,66,.258,60,191,.314,21,28,.750,15,20,35,10,11,0,37,67,235,1.6
4756,Zalmico Harmon\zalmico-harmon-1,2013-14,UC-Santa Barbara,G,30,30,925,70,186,.376,49,125,.392,21,61,.344,74,98,.755,11,53,64,153,18,0,33,64,235,7.1
4757,Nick Zeisloft\nick-zeisloft-1,2013-14,Illinois State,G,34,30,873,74,196,.378,14,27,.519,60,169,.355,27,30,.900,24,91,115,31,21,4,20,59,235,5.1
4758,DeAngelo Isby\deangelo-isby-1,2017-18,Utah State,G,28,5,521,79,187,.422,57,109,.523,22,78,.282,55,69,.797,23,57,80,32,13,2,43,44,235,5.0
4759,Armani Chaney\armani-chaney-1,2017-18,Tennessee State,G,30,28,870,82,222,.369,53,126,.421,29,96,.302,42,58,.724,18,75,93,111,43,2,84,72,235,5.0
4760,Ryan Taylor\ryan-taylor-2,2014-15,Ohio,G,29,27,874,88,203,.433,60,106,.566,28,97,.289,31,41,.756,15,57,72,37,12,10,33,60,235,4.8
4761,Jordan Roland\jordan-roland-1,2016-17,George Washington,G,35,11,703,88,185,.476,45,82,.549,43,103,.417,16,23,.696,16,54,70,48,27,10,24,56,235,5.3
4762,LaDarius White\ladarius-white-1,2013-14,Mississippi,G,33,16,709,80,216,.370,55,130,.423,25,86,.291,50,72,.694,11,88,99,67,24,4,47,46,235,4.5
4763,Toddrick Gotcher\toddrick-gotcher-1,2014-15,Texas Tech,G,32,10,775,72,191,.377,30,79,.380,42,112,.375,49,72,.681,27,58,85,48,25,13,31,58,235,5.3
4764,JoJo Anderson\jojo-anderson-1,2016-17,Northern Arizona,G,32,6,739,60,147,.408,38,79,.481,22,68,.324,93,134,.694,8,95,103,80,19,1,57,55,235,5.3
4765,Devonte Klines\devonte-klines-1,2017-18,Montana State,G,32,28,745,87,223,.390,76,177,.429,11,46,.239,49,82,.598,22,34,56,45,18,6,54,77,234,2.9
4766,Timmy Rose\timmy-rose-1,2016-17,Binghamton,G,32,27,844,81,179,.453,55,123,.447,26,56,.464,46,64,.719,9,75,84,116,28,1,59,53,234,6.0
4767,Eric Davis Jr.\eric-davisjr-1,2016-17,Texas,G,33,22,880,82,252,.325,44,105,.419,38,147,.259,32,48,.667,10,71,81,34,22,3,39,63,234,2.9
4768,Kyle Dranginis\kyle-dranginis-1,2015-16,Gonzaga,G,36,25,1123,85,195,.436,44,82,.537,41,113,.363,23,40,.575,49,112,161,109,36,12,35,85,234,6.8
4769,Jamal Reynolds\jamal-reynolds-1,2014-15,Canisius,G,33,33,829,75,150,.500,74,147,.503,1,3,.333,83,112,.741,71,148,219,54,26,12,32,63,234,7.8
4770,Mike Crawford\mike-crawford-1,2014-15,Saint Louis,G,32,1,609,77,166,.464,52,100,.520,25,66,.379,55,69,.797,15,37,52,33,10,1,31,48,234,4.6
4771,Byron Hawkins\byron-hawkins-1,2014-15,Towson,G,32,21,613,74,219,.338,47,126,.373,27,93,.290,59,79,.747,12,48,60,49,11,3,44,64,234,3.2
4772,Jordan Daniels\jordan-daniels-1,2013-14,Drake,G,23,10,629,79,184,.429,45,111,.405,34,73,.466,42,47,.894,7,43,50,59,14,1,43,48,234,6.4
4773,Azar Swain\azar-swain-1,2017-18,Yale,G,31,5,610,77,192,.401,23,54,.426,54,138,.391,26,36,.722,11,62,73,38,16,1,19,30,234,5.3
4774,Charles Hankerson\charles-hankerson-jr-1,2014-15,Wyoming,G,34,33,974,83,215,.386,41,93,.441,42,122,.344,26,57,.456,12,96,108,89,31,0,47,69,234,4.7
4775,Matt Jones\matt-jones-3,2014-15,Duke,G,39,14,847,84,205,.410,43,96,.448,41,109,.376,25,35,.714,34,57,91,39,37,3,29,66,234,4.4
4776,Antonio Woods\antonio-woods-1,2014-15,Pennsylvania,G,28,15,890,83,221,.376,60,138,.435,23,83,.277,45,66,.682,12,53,65,106,19,2,59,55,234,5.1
4777,Kareem Storey\kareem-storey-1,2014-15,Morehead State,G,31,31,931,75,192,.391,50,123,.407,25,69,.362,59,70,.843,17,49,66,140,42,2,76,71,234,6.1
4778,Rodell Wigginton\rodell-wigginton-1,2014-15,Buffalo,G,32,7,715,89,208,.428,77,159,.484,12,49,.245,44,76,.579,47,90,137,30,26,17,33,58,234,5.4
4779,Marcus Owens\marcus-owens-1,2015-16,Lamar,G,30,23,632,80,202,.396,42,97,.433,38,105,.362,36,49,.735,45,68,113,39,17,5,32,63,234,5.4
4780,Chris Jones\chris-jones-4,2013-14,North Texas,G,31,25,774,86,211,.408,81,193,.420,5,18,.278,57,90,.633,19,96,115,127,48,0,64,65,234,6.3
4781,Marcus Jackson\marcus-jackson-6,2017-18,UC-Santa Barbara,G,28,26,933,82,205,.400,39,85,.459,43,120,.358,27,45,.600,3,63,66,113,21,7,52,34,234,6.3
4782,Tyler Les\tyler-lee-1,2014-15,UC-Davis,G,32,1,771,69,151,.457,4,12,.333,65,139,.468,30,32,.938,6,46,52,48,10,0,29,47,233,5.2
4783,Kyre' Hamer\kyre-hamer-1,2014-15,Campbell,G,28,28,841,82,159,.516,61,109,.560,21,50,.420,48,65,.738,23,87,110,63,45,11,71,65,233,6.8
4784,JT Terrell\jt-terrell-1,2013-14,Southern California,G,24,14,586,83,230,.361,54,118,.458,29,112,.259,38,52,.731,18,51,69,23,9,6,44,45,233,4.0
4785,Antwoine Anderson\antwoine-anderson-1,2015-16,Fordham,G,28,19,675,77,167,.461,60,114,.526,17,53,.321,62,90,.689,11,52,63,72,32,9,67,77,233,5.4
4786,Avery Johnson\avery-johnson-3,2016-17,Alabama,G,34,6,664,84,254,.331,51,148,.345,33,106,.311,32,42,.762,11,46,57,49,25,1,36,58,233,3.2
4787,Emanuel Chapman\emanuel-chapman-1,2013-14,North Carolina Central,G,34,34,1158,87,196,.444,64,130,.492,23,66,.348,36,44,.818,25,120,145,217,69,12,84,64,233,8.8
4788,Chris Clover\chris-clover-1,2016-17,Saint Joseph's,G,30,18,680,84,232,.362,62,157,.395,22,75,.293,43,65,.662,17,48,65,30,17,1,33,62,233,3.4
4789,Toddrick Gotcher\toddrick-gotcher-1,2013-14,Texas Tech,G,32,22,854,70,175,.400,45,99,.455,25,76,.329,68,95,.716,21,71,92,61,21,4,33,57,233,5.5
4790,Jourdan Grant\jourdan-grant-1,2016-17,Maryland-Baltimore County,G,33,2,701,80,166,.482,65,122,.533,15,44,.341,58,95,.611,11,99,110,65,12,2,45,74,233,4.7
4791,Winfield Willis\winfield-willis-1,2013-14,NJIT,G,29,17,633,79,190,.416,47,108,.435,32,82,.390,43,52,.827,6,49,55,54,23,3,39,65,233,5.0
4792,Carlos Anderson\carlos-anderson-1,2016-17,Southern Illinois-Edwardsville,G,30,20,752,81,213,.380,74,169,.438,7,44,.159,64,94,.681,22,70,92,42,18,2,57,59,233,3.6
4793,Ryan Majerle\ryan-majerle-2,2014-15,Grand Canyon,G,32,2,772,78,176,.443,32,55,.582,46,121,.380,31,38,.816,37,63,100,21,8,4,19,55,233,5.2
4794,Jordan Poole\jordan-poole-1,2017-18,Michigan,G,38,0,476,75,175,.429,35,67,.522,40,108,.370,43,52,.827,3,50,53,22,20,6,25,40,233,4.0
4795,Willie Moore\willie-moore-2,2014-15,Miami (OH),G,32,8,665,75,179,.419,42,91,.462,33,88,.375,50,69,.725,10,78,88,34,47,3,58,84,233,4.4
4796,Devonte Hampton\devonte-hampton-1,2015-16,Alcorn State,G,27,26,800,80,223,.359,43,106,.406,37,117,.316,36,53,.679,15,85,100,63,28,6,59,79,233,4.6
4797,Josh Hopkins\josh-hopkins-1,2017-18,New Hampshire,G,31,10,722,75,226,.332,23,56,.411,52,170,.306,31,40,.775,21,48,69,19,7,7,24,57,233,3.5
4798,Matej Kavas\matej-kavas-1,2016-17,Seattle,G,27,0,544,81,185,.438,39,81,.481,42,104,.404,29,42,.690,11,68,79,15,6,9,23,51,233,5.1
4799,Adam Wing\adam-wing-1,2013-14,Evansville,G,33,33,1035,84,209,.402,70,159,.440,14,50,.280,51,64,.797,27,99,126,63,28,7,54,88,233,4.6
4800,Everson Davis\everson-davis-1,2017-18,Binghamton,G,31,27,736,76,165,.461,60,131,.458,16,34,.471,65,88,.739,29,84,113,67,26,3,39,58,233,6.4
4801,Jeffrey Simmons\jeffrey-simmons-1,2013-14,Mississippi Valley State,G,22,5,498,96,192,.500,89,164,.543,7,28,.250,34,56,.607,8,59,67,37,21,2,68,35,233,5.4
4802,Brent Jones\brent-jones-1,2013-14,St. Francis (NY),G,31,17,825,76,178,.427,56,119,.471,20,59,.339,61,84,.726,15,77,92,187,33,3,70,74,233,7.4
4803,Jamal Wright\jamal-wright-1,2016-17,High Point,G,29,29,835,78,195,.400,46,105,.438,32,90,.356,45,67,.672,5,60,65,101,34,3,61,67,233,5.5
4804,Jamal Johnson\jamal-johnson-5,2017-18,Memphis,G,34,26,901,70,200,.350,23,59,.390,47,141,.333,46,66,.697,25,86,111,35,22,16,32,65,233,4.6
4805,Max Joseph\max-joseph-1,2017-18,Valparaiso,G,32,19,842,84,173,.486,67,126,.532,17,47,.362,48,80,.600,31,104,135,66,48,2,47,73,233,6.4
4806,Chris Dixon\chris-dixon-2,2013-14,North Carolina-Wilmington,G,32,24,755,82,226,.363,62,134,.463,20,92,.217,49,65,.754,11,81,92,66,31,2,57,43,233,4.3
4807,Ivory Young\ivory-young-1,2015-16,Utah Valley,G,26,24,696,83,238,.349,34,108,.315,49,130,.377,18,25,.720,7,56,63,52,26,0,50,45,233,4.3
4808,Quan Jackson\quan-jackson-1,2017-18,Georgia Southern,G,33,8,689,80,193,.415,56,122,.459,24,71,.338,49,93,.527,30,75,105,29,48,9,33,53,233,5.3
4809,Spike Albrecht\spike-albrecht-1,2014-15,Michigan,G,31,18,991,78,193,.404,43,97,.443,35,96,.365,42,46,.913,4,68,72,121,27,1,41,49,233,6.5
4810,Nick Hornsby\nick-hornsby-1,2015-16,Sacramento State,G,30,28,835,90,208,.433,88,195,.451,2,13,.154,51,77,.662,65,142,207,49,36,21,56,94,233,6.4
4811,Jourdan Grant\jourdan-grant-1,2015-16,Maryland-Baltimore County,G,32,21,779,74,159,.465,70,142,.493,4,17,.235,81,139,.583,12,84,96,76,41,4,67,85,233,4.9
4812,Joel Hernandez\joel-hernandez-1,2014-15,Long Island University,G,29,14,688,84,215,.391,74,181,.409,10,34,.294,55,106,.519,36,81,117,23,22,11,47,63,233,4.1
4813,Aaric Armstead\aaric-armstead-1,2013-14,Northern Illinois,G,30,21,766,82,211,.389,66,150,.440,16,61,.262,52,78,.667,45,78,123,13,30,12,51,58,232,4.5
4814,Ben Emelogu\ben-emelogu-1,2013-14,Virginia Tech,G,22,12,599,80,202,.396,40,94,.426,40,108,.370,32,47,.681,11,57,68,41,13,5,34,48,232,6.1
4815,Rodell Wigginton\rodell-wigginton-1,2015-16,Buffalo,G,33,10,588,86,188,.457,81,167,.485,5,21,.238,55,83,.663,61,113,174,24,18,18,58,73,232,4.9
4816,Jerry Johnson Jr.\jerry-johnsonjr-1,2015-16,Fairfield,G,29,1,536,75,172,.436,32,65,.492,43,107,.402,39,56,.696,12,63,75,39,22,2,40,37,232,5.4
4817,Trayvon Palmer\trayvon-palmer-1,2014-15,Chicago State,G,30,19,736,87,187,.465,64,131,.489,23,56,.411,35,52,.673,54,90,144,21,25,18,55,84,232,5.3
4818,Elijah Davis\elijah-davis-1,2017-18,Wagner,G,33,5,662,79,201,.393,64,133,.481,15,68,.221,59,73,.808,42,101,143,25,23,11,55,68,232,4.3
4819,Dimitri Batten\dimitri-batten-1,2014-15,Boston College,G,32,25,819,80,175,.457,51,98,.520,29,77,.377,43,69,.623,12,77,89,39,34,6,42,91,232,4.7
4820,Caleb Homesley\caleb-homesley-1,2015-16,Liberty,G,32,20,640,85,178,.478,55,94,.585,30,84,.357,32,48,.667,18,92,110,42,27,14,36,93,232,5.3
4821,Kris Clyburn\kris-clyburn-1,2016-17,Nevada-Las Vegas,G,32,22,781,80,220,.364,55,134,.410,25,86,.291,47,67,.701,48,122,170,40,22,6,34,49,232,5.4
4822,Josh Gentry\josh-gentry-2,2013-14,Cal State Fullerton,G,31,10,710,82,186,.441,56,109,.514,26,77,.338,42,64,.656,21,47,68,32,10,7,33,50,232,4.5
4823,Jalen Lindsey\jalen-lindsey-1,2015-16,Providence,G,33,17,861,80,210,.381,41,65,.631,39,145,.269,33,45,.733,46,98,144,24,17,4,23,49,232,5.1
4824,Jeremy Hemsley\jeremy-hemsley-1,2017-18,San Diego State,G,32,7,698,81,188,.431,60,109,.550,21,79,.266,49,80,.613,6,49,55,67,21,5,55,58,232,4.1
4825,Demetrious Floyd\demetrious-floyd-1,2014-15,Stephen F. Austin,G,34,0,497,86,191,.450,35,68,.515,51,123,.415,9,18,.500,3,32,35,46,7,0,31,32,232,4.0
4826,Josh Brown\josh-brown-3,2014-15,Temple,G,37,2,809,74,186,.398,53,130,.408,21,56,.375,63,73,.863,19,94,113,57,29,10,35,60,232,5.0
4827,Joe Kilgore\joe-kilgore-1,2015-16,Texas A&M-Corpus Christi,G,33,0,634,80,180,.444,67,139,.482,13,41,.317,59,79,.747,30,57,87,33,15,21,37,53,232,4.9
4828,Christopher Anderson\christopher-anderson-1,2014-15,San Diego,G,30,30,973,78,210,.371,48,116,.414,30,94,.319,46,76,.605,14,73,87,197,58,2,85,75,232,7.3
4829,Jaron Cornish\jaron-cornish-1,2017-18,Stony Brook,G,27,14,596,84,210,.400,62,134,.463,22,76,.289,42,65,.646,18,82,100,77,26,14,75,72,232,4.9
4830,Rashann London\rashann-london-1,2015-16,Drexel,G,31,24,934,84,244,.344,55,140,.393,29,104,.279,35,50,.700,21,50,71,71,12,1,48,64,232,3.5
4831,Speedy Smith\kenneth-smith-1,2014-15,Louisiana Tech,G,36,36,1190,75,198,.379,40,102,.392,35,96,.365,47,61,.770,28,115,143,267,69,4,89,84,232,8.6
4832,Freddie Jackson\freddie-jackson-1,2013-14,North Carolina-Wilmington,G,32,17,687,89,213,.418,74,159,.465,15,54,.278,39,62,.629,31,59,90,36,17,12,37,49,232,4.5
4833,Marcus Roper\marcus-roper-1,2015-16,Tennessee State,G,31,4,570,79,185,.427,36,70,.514,43,115,.374,31,45,.689,9,41,50,14,18,7,14,52,232,4.7
4834,Wes Clark\wes-clark-2,2014-15,Missouri,G,23,20,713,81,233,.348,49,131,.374,32,102,.314,38,51,.745,10,71,81,71,38,4,45,54,232,6.4
4835,Aaron Parks\aaron-parks-1,2013-14,Cal State Northridge,G,35,1,652,59,181,.326,51,153,.333,8,28,.286,106,150,.707,17,50,67,48,27,1,42,91,232,3.5
4836,Sean McDermott\sean-mcdermott-1,2017-18,Butler,G,31,14,739,83,162,.512,36,53,.679,47,109,.431,18,22,.818,37,84,121,32,21,7,27,69,231,6.3
4837,Markell Johnson\markell-johnson-1,2017-18,North Carolina State,G,26,24,756,81,176,.460,54,110,.491,27,66,.409,42,69,.609,15,73,88,190,44,6,84,63,231,9.0
4838,Devontavius Payne\devontavius-payne-1,2016-17,East Tennessee State,G,35,1,534,76,181,.420,29,61,.475,47,120,.392,32,41,.780,15,39,54,26,24,4,31,60,231,4.1
4839,Michael Buckland\michael-buckland-1,2017-18,Lipscomb,G,31,27,941,69,181,.381,30,72,.417,39,109,.358,54,67,.806,18,112,130,98,31,21,66,82,231,6.1
4840,Jared Savage\jared-savag-1,2015-16,Austin Peay,G,36,7,709,75,178,.421,23,47,.489,52,131,.397,29,36,.806,20,89,109,30,24,1,18,58,231,5.0
4841,Ezekiel Charles\ezekiel-charles-1,2017-18,New Orleans,G,31,18,669,76,174,.437,25,65,.385,51,109,.468,28,39,.718,35,65,100,30,19,6,32,40,231,5.7
4842,Branford Jones\branford-jones--1,2014-15,Cal State Long Beach,G,33,12,807,73,181,.403,46,105,.438,27,76,.355,58,72,.806,25,72,97,61,34,1,53,53,231,5.2
4843,Paris Lee\paris-lee-1,2014-15,Illinois State,G,34,34,1013,80,184,.435,54,113,.478,26,71,.366,45,62,.726,12,69,81,124,82,2,65,62,231,7.0
4844,Bolden Brace\bolden-brace-1,2016-17,Northeastern,G,31,8,757,75,207,.362,19,35,.543,56,172,.326,25,31,.806,14,88,102,49,12,9,20,49,231,5.3
4845,Justin Davis\justin-davis-3,2017-18,Cal State Bakersfield,G,30,10,652,80,176,.455,56,108,.519,24,68,.353,47,55,.855,51,114,165,25,26,2,34,73,231,6.3
4846,Steve Santa Ana\steve-santaana-1,2015-16,Elon,G,27,1,499,77,189,.407,35,73,.479,42,116,.362,35,53,.660,28,63,91,36,6,4,33,38,231,5.4
4847,Tyler Blount\tyler-blount-1,2017-18,Texas State,G,33,31,768,84,199,.422,33,74,.446,51,125,.408,12,22,.545,10,52,62,37,11,1,24,38,231,4.3
4848,Mitchell Wilbekin\mitchell-wilbekin-1,2017-18,Wake Forest,G,27,23,714,73,185,.395,22,65,.338,51,120,.425,34,42,.810,10,53,63,39,17,0,19,49,231,5.8
4849,Darnell Foreman\darnell-foreman-1,2016-17,Pennsylvania,G,28,21,801,83,206,.403,60,137,.438,23,69,.333,42,60,.700,11,85,96,96,22,2,48,69,231,5.8
4850,Tradarrius McPhearson\tradarrius-mcphearson-1,2013-14,New Orleans,G,25,21,619,70,174,.402,50,111,.450,20,63,.317,71,102,.696,9,49,58,41,22,7,46,44,231,5.5
4851,Adam Thoseby\adam-thoseby-1,2013-14,South Dakota,G,30,11,552,76,194,.392,51,111,.459,25,83,.301,54,67,.806,10,60,70,20,11,8,37,47,231,4.0
4852,Rashad Ray\rashad-ray-1,2013-14,Tulsa,G,34,0,716,77,160,.481,67,125,.536,10,35,.286,67,91,.736,8,65,73,85,34,1,40,68,231,5.7
4853,Robert Hubbs\robert-hubbs-1,2014-15,Tennessee,G,32,20,795,88,215,.409,57,122,.467,31,93,.333,24,33,.727,36,57,93,28,16,4,26,48,231,4.6
4854,Austin Tilghman\austin-tilghman-1,2016-17,Monmouth,G,33,1,662,64,126,.508,54,104,.519,10,22,.455,93,125,.744,21,84,105,46,23,0,36,39,231,6.0
4855,Shane McLaughlin\shane-mclaughlin-1,2014-15,Bryant,G,31,31,1138,83,207,.401,66,155,.426,17,52,.327,48,74,.649,15,103,118,148,29,1,83,62,231,5.7
4856,Trey Norris\trey-norris-1,2013-14,South Dakota,G,29,28,847,80,188,.426,52,118,.441,28,70,.400,43,60,.717,7,48,55,116,36,1,55,61,231,6.3
4857,Anthlon Bell\anthlon-bell-1,2013-14,Arkansas,G,32,14,515,84,222,.378,34,71,.479,50,151,.331,12,15,.800,14,26,40,23,11,2,21,44,230,3.6
4858,Dre Marin\dre-marin-1,2017-18,Southern Utah,G,31,28,900,70,176,.398,36,72,.500,34,104,.327,56,72,.778,16,100,116,61,31,5,50,87,230,5.2
4859,Cameron Bacote\cameron-bacote-1,2017-18,Maryland-Eastern Shore,G,32,16,849,85,235,.362,40,84,.476,45,151,.298,15,19,.789,10,48,58,62,15,0,43,30,230,3.8
4860,JR Hobbie\norman-hobbie-1,2016-17,Brown,G,29,2,486,68,144,.472,2,3,.667,66,141,.468,28,29,.966,2,17,19,14,9,2,12,53,230,5.2
4861,Kevin Holland\kevin-holland-1,2017-18,Southern Mississippi,G,34,32,1121,80,192,.417,21,50,.420,59,142,.415,11,14,.786,10,54,64,48,26,4,17,70,230,4.9
4862,Ore Arogundade\ore-arogundade-1,2017-18,Drake,G,34,26,877,75,188,.399,40,96,.417,35,92,.380,45,56,.804,29,79,108,47,29,3,38,62,230,5.0
4863,Chris Barton\chris-barton-1,2016-17,Niagara,G,32,21,703,69,153,.451,42,96,.438,27,57,.474,65,84,.774,24,61,85,30,7,1,40,63,230,4.4
4864,Mike Green\mike-green-5,2015-16,Northern Arizona,G,29,6,706,81,228,.355,39,110,.355,42,118,.356,26,40,.650,10,56,66,54,23,0,55,33,230,3.9
4865,Tra'von Joseph\travon-joseph-1,2016-17,Northwestern State,G,29,28,724,87,167,.521,78,133,.586,9,34,.265,47,65,.723,46,114,160,51,22,10,50,84,230,6.5
4866,Jorden Duffy\jorden-duffy-1,2017-18,North Texas,G,26,6,525,79,198,.399,38,89,.427,41,109,.376,31,41,.756,12,74,86,29,9,2,24,34,230,5.5
4867,Matt Harris\matt-harris-1,2014-15,Massachusetts-Lowell,G,26,0,534,77,185,.416,30,58,.517,47,127,.370,29,38,.763,10,37,47,20,17,2,24,40,230,5.3
4868,Kory Brown\kory-brown-1,2013-14,North Dakota State,G,33,32,899,88,151,.583,86,143,.601,2,8,.250,52,66,.788,57,83,140,55,37,25,30,104,230,7.3
4869,Kyre' Hamer\kyre-hamer-1,2016-17,Campbell,G,26,20,684,82,148,.554,63,112,.563,19,36,.528,47,59,.797,8,64,72,52,28,6,55,54,230,6.6
4870,Louie Pillari\louie-pillari-1,2017-18,Monmouth,G,31,8,507,79,169,.467,35,70,.500,44,99,.444,28,31,.903,7,30,37,16,7,2,25,44,230,4.3
4871,Carlin Dupree\carlin-dupree-1,2014-15,North Dakota State,G,33,33,1077,89,241,.369,80,199,.402,9,42,.214,43,77,.558,29,121,150,86,40,2,58,60,230,4.8
4872,Stanley Davis\stanley-davis-1,2017-18,Morgan State,G,31,15,675,87,207,.420,78,167,.467,9,40,.225,47,65,.723,27,65,92,53,23,4,58,62,230,4.2
4873,Dalan Ancrum\dalan-ancrum-1,2016-17,Western Illinois,G,28,13,605,77,183,.421,46,123,.374,31,60,.517,45,51,.882,21,65,86,28,12,10,43,48,230,5.0
4874,Mathieu Kamba\mathieu-kamba-1,2014-15,Central Arkansas,G,29,13,776,76,160,.475,75,150,.500,1,10,.100,77,131,.588,44,85,129,46,19,15,69,79,230,5.0
4875,Thomas Neff\thomas-neff-1,2016-17,Denver,G,29,28,796,71,167,.425,25,59,.424,46,108,.426,42,52,.808,19,66,85,47,14,7,24,61,230,6.0
4876,Stevie Repichowski\stevie-repichowski-1,2016-17,Nicholls State,G,31,13,784,78,188,.415,20,28,.714,58,160,.363,16,21,.762,5,70,75,18,17,0,21,69,230,4.3
4877,Riley LaChance\riley-lachance-1,2015-16,Vanderbilt,G,33,19,820,80,226,.354,37,107,.346,43,119,.361,26,34,.765,11,69,80,81,20,1,44,61,229,4.2
4878,Stevie Taylor\stevie-taylor-1,2014-15,Ohio,G,30,9,759,74,225,.329,52,128,.406,22,97,.227,59,81,.728,9,68,77,80,36,2,51,52,229,4.7
4879,Tyler Madison\tyler-madison-1,2014-15,Alabama-Birmingham,G,36,5,618,77,170,.453,71,153,.464,6,17,.353,69,91,.758,70,53,123,37,12,6,34,87,229,4.7
4880,Austen Awosika\austen-awosika-1,2017-18,Cal State Fullerton,G,32,14,873,79,193,.409,72,159,.453,7,34,.206,64,97,.660,18,97,115,85,32,7,56,41,229,5.6
4881,Chris Jones\chris-jones-5,2016-17,Pittsburgh,G,32,31,1026,76,161,.472,64,121,.529,12,40,.300,65,95,.684,20,77,97,70,18,9,53,73,229,5.1
4882,PJ Dozier\pj-dozier-1,2015-16,South Carolina,G,34,28,647,91,239,.381,81,192,.422,10,47,.213,37,68,.544,27,74,101,70,34,13,90,83,229,2.8
4883,Troy Holston\troy-holston-1,2014-15,South Florida,G,29,11,671,73,219,.333,34,93,.366,39,126,.310,44,62,.710,19,56,75,19,18,7,30,57,229,3.8
4884,Donovan Mitchell\donovan-mitchell-1,2015-16,Louisville,G,31,5,591,84,190,.442,66,118,.559,18,72,.250,43,57,.754,34,70,104,52,25,3,30,78,229,5.5
4885,Jeremy Underwood\jeremy-underwood-1,2013-14,North Carolina A&T,G,31,31,977,62,199,.312,25,81,.309,37,118,.314,68,104,.654,18,68,86,89,23,1,94,104,229,2.7
4886,Diamante Lewis\diamante-lewis-1,2015-16,Bethune-Cookman,G,30,9,628,86,216,.398,59,147,.401,27,69,.391,30,49,.612,42,75,117,44,22,3,37,74,229,4.8
4887,Josh Kozinski\josh-kozinski-1,2016-17,Central Michigan,G,32,31,968,76,223,.341,7,15,.467,69,208,.332,8,14,.571,11,91,102,20,37,3,8,76,229,4.7
4888,Marcus Allen\marcus-allen-2,2014-15,Stanford,G,36,23,820,89,174,.511,76,134,.567,13,40,.325,38,71,.535,41,84,125,41,30,4,41,88,229,4.7
4889,Khari Price\khari-price-1,2013-14,Dayton,G,37,37,829,65,164,.396,19,46,.413,46,118,.390,53,60,.883,3,49,52,66,24,2,41,78,229,4.2
4890,Sherron Dorsey-Walker\sherron-dorsey-walker-1,2015-16,Oakland,G,35,29,852,65,180,.361,32,91,.352,33,89,.371,66,95,.695,61,114,175,49,27,5,50,63,229,5.3
4891,DJ Clayton\dj-clayton-1,2016-17,Illinois State,G,35,6,861,87,205,.424,73,156,.468,14,49,.286,41,75,.547,59,92,151,50,31,3,51,69,229,4.7
4892,Jonathan Williams\jonathan-williams-2,2013-14,Toledo,G,34,2,596,74,184,.402,40,79,.506,34,105,.324,47,57,.825,12,38,50,37,13,4,33,57,229,3.9
4893,Frankie Hughes\frankie-hughes-1,2016-17,Missouri,G,30,11,578,77,260,.296,32,92,.348,45,168,.268,30,53,.566,14,64,78,35,19,2,39,44,229,2.9
4894,Tariq Simmons\tariq-simmons-1,2017-18,Citadel,G,32,7,487,87,230,.378,60,138,.435,27,92,.293,27,50,.540,14,53,67,60,25,2,49,27,228,4.0
4895,Jerian Grant\jerian-grant-1,2013-14,Notre Dame,G,12,12,427,72,139,.518,52,90,.578,20,49,.408,64,74,.865,4,26,30,74,24,4,22,24,228,17.8
4896,Anthony Collins\anthony-collins-1,2014-15,South Florida,G,32,32,1084,91,206,.442,83,177,.469,8,29,.276,38,56,.679,10,73,83,167,49,3,76,74,228,6.4
4897,Bo Barnes\bo-barnes-1,2014-15,Arizona State,G,33,0,634,76,178,.427,30,55,.545,46,123,.374,30,35,.857,33,42,75,25,22,5,19,47,228,5.2
4898,Cole Gentry\cole-gentry-1,2017-18,Wright State,G,25,18,771,79,186,.425,44,91,.484,35,95,.368,35,43,.814,10,61,71,65,35,0,36,42,228,7.2
4899,Chris Burke\chris-burke-1,2013-14,Saint Peter's,G,31,30,861,80,200,.400,45,106,.425,35,94,.372,33,47,.702,28,97,125,43,27,29,42,51,228,5.7
4900,Spencer Haldeman\spencer-haldeman-1,2016-17,Northern Iowa,G,30,8,678,68,192,.354,19,38,.500,49,154,.318,43,50,.860,4,61,65,22,25,1,30,68,228,4.1
4901,Anson Winder\anson-winder-1,2013-14,Brigham Young,G,35,8,586,76,141,.539,51,79,.646,25,62,.403,51,69,.739,6,56,62,45,20,2,19,55,228,5.3
4902,Jordon Talley\jordon-talley-1,2016-17,North Carolina-Wilmington,G,30,0,521,68,181,.376,54,138,.391,14,43,.326,78,97,.804,11,41,52,79,18,2,33,82,228,5.0
4903,Tre Harris\tre-harris-1,2016-17,Southern Illinois-Edwardsville,G,17,1,413,73,208,.351,27,85,.318,46,123,.374,36,49,.735,13,51,64,12,10,0,35,41,228,5.8
4904,Chaundee Brown\chaundee-brown-1,2017-18,Wake Forest,G,30,29,628,88,214,.411,61,135,.452,27,79,.342,25,31,.806,27,64,91,34,7,5,37,42,228,4.3
4905,Casey Benson\casey-benson-1,2015-16,Oregon,G,38,38,1091,75,177,.424,41,83,.494,34,94,.362,44,63,.698,16,70,86,117,27,1,24,65,228,5.7
4906,Jelan Kendrick\jelan-kendrick-1,2014-15,Nevada-Las Vegas,G,32,26,842,85,206,.413,62,142,.437,23,64,.359,35,57,.614,20,114,134,94,27,11,49,59,228,5.8
4907,Eric Davis Jr.\eric-davisjr-1,2017-18,Texas,G,26,1,680,75,189,.397,35,74,.473,40,115,.348,38,51,.745,6,57,63,16,17,0,24,47,228,4.9
4908,Ridge Shipley\ridge-shipley-1,2014-15,Cal Poly,G,27,16,703,72,201,.358,27,67,.403,45,134,.336,39,52,.750,9,43,52,59,16,1,36,39,228,5.1
4909,Nick Zeisloft\nick-zeisloft-1,2015-16,Indiana,G,35,8,703,72,172,.419,7,16,.438,65,156,.417,19,21,.905,11,46,57,29,7,3,17,44,228,4.3
4910,Jabari Sandifer\jabari-sandifer-1,2015-16,Western Illinois,G,27,27,880,71,187,.380,51,132,.386,20,55,.364,66,91,.725,14,97,111,128,48,4,63,72,228,7.5
4911,Miguel Dicent\miguel-dicent-1,2015-16,Morehead State,G,31,15,597,78,180,.433,44,91,.484,34,89,.382,38,48,.792,18,48,66,44,17,5,33,80,228,4.6
4912,Levi Bradley\levi-bradley-1,2015-16,Northern Illinois,G,34,1,543,85,173,.491,64,122,.525,21,51,.412,37,48,.771,38,82,120,14,13,10,22,75,228,4.9
4913,Denzel Richardson\denzel-richardson-1,2014-15,Eastern Kentucky,G,33,9,646,76,182,.418,42,88,.477,34,94,.362,42,56,.750,22,82,104,21,20,1,41,40,228,4.4
4914,Brandon Averette\brandon-averette-1,2017-18,Oklahoma State,G,36,6,715,87,212,.410,77,175,.440,10,37,.270,44,59,.746,6,58,64,104,22,1,49,53,228,4.3
4915,Marcus DeBerry\marcus-deberry-1,2015-16,Northern Arizona,G,30,23,870,81,226,.358,31,79,.392,50,147,.340,15,18,.833,14,69,83,47,24,6,34,33,227,4.8
4916,Trantell Knight\trantell-knight-1,2013-14,Middle Tennessee,G,33,31,923,76,173,.439,72,148,.486,4,25,.160,71,122,.582,20,88,108,152,66,3,92,86,227,6.2
4917,Delbert Love\delbert-love-1,2014-15,Kennesaw State,G,32,26,912,80,231,.346,49,117,.419,31,114,.272,36,49,.735,38,90,128,83,35,2,62,34,227,5.1
4918,Grant Lozoya\grant-lozoya-1,2015-16,Stetson,G,31,28,654,84,221,.380,57,103,.553,27,118,.229,32,43,.744,2,76,78,49,28,6,54,101,227,3.2
4919,Dajuan Graf\dajuan-graf-1,2015-16,North Carolina Central,G,29,17,844,84,187,.449,71,142,.500,13,45,.289,46,64,.719,11,77,88,115,27,1,67,56,227,5.9
4920,Nico Clareth\nico-clareth-1,2017-18,Siena,G,15,6,398,71,189,.376,38,100,.380,33,89,.371,52,60,.867,9,42,51,27,12,7,45,52,227,7.3
4921,Max Guercy\max-guercy-1,2015-16,Rice,G,32,32,1074,60,159,.377,41,99,.414,19,60,.317,88,105,.838,20,70,90,182,30,1,91,70,227,6.5
4922,Noah Blackwell\noah-blackwell-1,2016-17,Cal State Long Beach,G,28,15,684,86,206,.417,37,77,.481,49,129,.380,6,7,.857,9,60,69,53,20,5,33,49,227,5.3
4923,Luke Eddy\luke-eddy-1,2016-17,Elon,G,31,9,796,69,171,.404,36,73,.493,33,98,.337,56,71,.789,15,83,98,114,24,9,60,42,227,6.4
4924,Terry Rose\terry-rose-1,2013-14,Grambling,G,23,15,624,81,207,.391,27,48,.563,54,159,.340,11,15,.733,8,34,42,19,9,0,27,23,227,5.0
4925,Ty Charles\ty-charles-1,2017-18,Stephen F. Austin,G,29,10,674,84,199,.422,62,130,.477,22,69,.319,37,54,.685,36,97,133,49,32,7,41,92,227,5.6
4926,Darius Moore\darius-moore-1,2016-17,Presbyterian,G,29,15,730,76,201,.378,28,90,.311,48,111,.432,27,41,.659,12,75,87,74,22,2,64,69,227,4.3
4927,Eric Cooper\eric-cooper-1,2014-15,Nevada,G,31,14,736,73,245,.298,35,97,.361,38,148,.257,43,55,.782,20,47,67,42,24,1,51,43,227,3.0
4928,Nick Daniels\nick-daniels-2,2015-16,Oakland,G,35,24,711,72,195,.369,25,72,.347,47,123,.382,36,47,.766,17,67,84,56,26,1,39,55,227,4.3
4929,Reggie Arceneaux\reggie-arceneaux-1,2014-15,Wright State,G,31,21,821,82,230,.357,38,96,.396,44,134,.328,19,26,.731,7,43,50,66,22,0,32,33,227,4.4
4930,Jerome Segura\jerome-segura-1,2015-16,Fairfield,G,32,32,954,94,225,.418,82,188,.436,12,37,.324,27,50,.540,26,69,95,160,30,0,90,58,227,5.2
4931,Kenny Cooper\kenny-cooper-2,2016-17,Lipscomb,G,33,1,710,75,176,.426,56,106,.528,19,70,.271,58,88,.659,11,63,74,99,49,17,62,90,227,5.5
4932,Jon Severe\jon-severe-1,2015-16,Fordham,G,30,16,521,81,186,.435,51,103,.495,30,83,.361,35,48,.729,15,34,49,47,29,9,48,58,227,4.7
4933,Paris Lee\paris-lee-1,2013-14,Illinois State,G,34,33,935,74,215,.344,37,96,.385,37,119,.311,42,59,.712,13,54,67,78,47,1,63,68,227,4.0
4934,Mason Archie\mason-archie-1,2014-15,IUPUI,G,30,20,741,80,208,.385,47,103,.456,33,105,.314,34,46,.739,17,34,51,36,20,0,49,61,227,3.4
4935,Charles Oliver\charles-oliver-2,2013-14,Robert Morris,G,36,0,542,74,188,.394,39,82,.476,35,106,.330,43,51,.843,9,44,53,12,12,1,24,47,226,3.3
4936,Casey Teson\casey-teson-1,2015-16,Eastern Illinois,G,30,28,848,74,198,.374,10,32,.313,64,166,.386,14,18,.778,4,66,70,21,16,2,19,39,226,4.5
4937,Marcus Stroman\marcus-stroman-1,2017-18,Louisiana,G,33,31,917,63,148,.426,53,104,.510,10,44,.227,90,120,.750,17,89,106,213,56,8,97,91,226,7.6
4938,Dreon Barlett\dreon-barlett-1,2015-16,Sacramento State,G,30,23,786,71,184,.386,18,46,.391,53,138,.384,31,35,.886,9,87,96,25,14,9,24,69,226,4.8
4939,Drew Barham\drew-barham-1,2013-14,Gonzaga,G,36,6,632,77,157,.490,16,30,.533,61,127,.480,11,17,.647,34,75,109,10,24,9,14,84,226,5.0
4940,C.J. Duff\cj-duff-1,2017-18,Western Illinois,G,28,28,883,84,215,.391,49,111,.441,35,104,.337,23,29,.793,7,49,56,27,18,2,26,54,226,4.2
4941,Nick Zeisloft\nick-zeisloft-1,2014-15,Indiana,G,34,7,665,75,158,.475,12,18,.667,63,140,.450,13,17,.765,22,54,76,22,11,2,14,72,226,4.7
4942,Josh Williams\josh-williams-5,2015-16,Akron,G,34,5,643,74,183,.404,16,43,.372,58,140,.414,20,26,.769,16,69,85,47,14,4,49,44,226,4.1
4943,Andrew Nicholas\andrew-nicholas-1,2014-15,Monmouth,G,29,1,750,81,224,.362,38,100,.380,43,124,.347,21,30,.700,22,74,96,41,22,12,28,76,226,4.7
4944,Caleb Tanner\caleb-tanner-1,2017-18,Radford,G,36,1,468,67,162,.414,6,21,.286,61,141,.433,31,32,.969,2,13,15,16,6,0,10,30,226,3.9
4945,Royce Woolridge\royce-woolridge-1,2013-14,Washington State,G,31,28,874,77,201,.383,67,148,.453,10,53,.189,62,110,.564,9,50,59,84,24,5,59,65,226,3.9
4946,Adam Wing\adam-wing-1,2014-15,Evansville,G,30,25,825,83,159,.522,74,137,.540,9,22,.409,51,63,.810,25,88,113,56,26,5,57,73,226,5.7
4947,Mitchell Wilbekin\mitchell-wilbekin-1,2015-16,Wake Forest,G,31,30,875,71,206,.345,21,59,.356,50,147,.340,34,40,.850,9,52,61,42,18,1,18,66,226,4.3
4948,Daniel Grieves\daniel-grieves-1,2014-15,Southeastern Louisiana,G,30,10,763,79,177,.446,54,100,.540,25,77,.325,43,68,.632,45,89,134,30,30,10,57,94,226,4.8
4949,Denzel Ingram\denzel-ingram-1,2013-14,Charlotte,G,28,10,756,79,183,.432,38,90,.422,41,93,.441,27,39,.692,11,49,60,52,19,2,36,54,226,5.2
4950,T.J. Taylor\tj-taylor-2,2014-15,North Texas,G,27,20,781,78,183,.426,49,98,.500,29,85,.341,41,55,.745,18,70,88,62,27,6,59,32,226,5.9
4951,Rashaun Madison\rashaun-madison-1,2015-16,North Carolina Central,G,31,17,728,79,196,.403,22,46,.478,57,150,.380,10,16,.625,9,37,46,34,33,0,20,44,225,5.0
4952,Ty'Lik Evans\tylik-evans-1,2017-18,Savannah State,G,27,4,492,75,222,.338,47,98,.480,28,124,.226,47,69,.681,47,40,87,69,36,0,48,57,225,5.5
4953,Eric Garcia\eric-garcia-2,2013-14,Wofford,G,31,26,825,73,169,.432,30,75,.400,43,94,.457,36,52,.692,8,47,55,78,20,0,29,42,225,5.7
4954,Ryan Oliver\ryan-oliver-1,2014-15,Siena,G,31,6,748,74,175,.423,35,64,.547,39,111,.351,38,50,.760,23,68,91,42,34,4,30,67,225,5.6
4955,Ade Murkey\ade-murkey-1,2017-18,Denver,G,30,29,744,86,202,.426,85,194,.438,1,8,.125,52,81,.642,43,82,125,82,21,13,72,66,225,5.0
4956,Stanford Robinson\stanford-robinson-1,2016-17,Rhode Island,G,35,0,636,81,182,.445,60,126,.476,21,56,.375,42,68,.618,26,63,89,60,38,10,30,77,225,5.2
4957,Vertrail Vaughns\vertrail-vaughns-1,2013-14,North Texas,G,31,8,572,63,177,.356,44,119,.370,19,58,.328,80,99,.808,10,34,44,36,22,1,33,56,225,4.1
4958,Jaizec Lottie\jaizec-lottie-1,2017-18,Little Rock,G,32,30,801,76,208,.365,56,135,.415,20,73,.274,53,92,.576,12,74,86,93,33,1,70,70,225,3.9
4959,Christian Juzang\christian-juzang-1,2017-18,Harvard,G,31,21,847,70,171,.409,32,75,.427,38,96,.396,47,53,.887,9,77,86,81,14,5,67,49,225,4.8
4960,Jordan Geist\jordan-geist-1,2016-17,Missouri,G,32,14,707,66,182,.363,44,105,.419,22,77,.286,71,94,.755,10,84,94,63,22,0,38,53,225,4.8
4961,JaJuan Johnson\jajuan-johnson-2,2014-15,Marquette,G,31,10,673,84,225,.373,68,152,.447,16,73,.219,41,55,.745,15,66,81,55,34,11,49,34,225,4.6
4962,Marshall Harris\marshall-harris-1,2013-14,Citadel,G,32,29,866,66,147,.449,39,69,.565,27,78,.346,66,89,.742,8,74,82,131,29,4,65,86,225,6.0
4963,Darrell Riley\darrell-riley-1,2016-17,Mississippi Valley State,G,25,11,637,73,207,.353,43,138,.312,30,69,.435,49,69,.710,15,46,61,72,19,1,63,44,225,4.6
4964,Cody Benzel\cody-benzel-1,2017-18,Eastern Washington,G,34,20,687,70,177,.395,3,16,.188,67,161,.416,18,19,.947,5,35,40,18,20,5,12,49,225,4.3
4965,Isaiah Lamb\isaiah-lamb-1,2015-16,Marist,G,29,22,656,80,192,.417,46,96,.479,34,96,.354,31,54,.574,20,65,85,12,13,5,23,50,225,4.4
4966,Shaun Lawton\shaun-lawton-1,2013-14,Maine,G,28,18,764,70,181,.387,59,138,.428,11,43,.256,74,107,.692,16,61,77,118,56,2,89,82,225,5.7
4967,Tra Holder\tra-holder-1,2014-15,Arizona State,G,32,23,865,58,183,.317,46,133,.346,12,50,.240,97,137,.708,9,60,69,115,16,0,80,57,225,3.8
4968,Ahmad Abdullah\ahmad-abdullah-1,2014-15,North Carolina A&T,G,32,23,925,81,201,.403,56,130,.431,25,71,.352,38,52,.731,14,75,89,82,28,3,58,59,225,4.7
4969,Jeremiah Jones\jeremiah-jones-1,2014-15,Duquesne,G,31,31,923,78,213,.366,58,146,.397,20,67,.299,49,76,.645,52,89,141,101,17,5,62,59,225,5.3
4970,Anton Wilson\anton-wilson-1,2013-14,Detroit Mercy,G,32,3,725,73,182,.401,20,50,.400,53,132,.402,26,33,.788,10,61,71,42,15,5,27,68,225,4.5
4971,Brian Brown\brian-brown-5,2013-14,Virginia Military Institute,G,33,25,824,78,204,.382,28,52,.538,50,152,.329,19,23,.826,20,43,63,55,18,0,28,58,225,4.4
4972,Ja'Donta Blakley\jadonta-blakely-1,2016-17,Prairie View,G,33,31,922,88,197,.447,85,183,.464,3,14,.214,46,79,.582,31,103,134,132,74,18,83,88,225,6.7
4973,Dre Wills\dre-willis-1,2016-17,Vermont,G,35,3,682,94,153,.614,94,149,.631,0,4,.000,37,83,.446,39,87,126,49,32,21,34,44,225,6.3
4974,Kevin Baker\kevin-baker-2,2017-18,Troy,G,33,21,817,61,225,.271,16,59,.271,45,166,.271,57,81,.704,9,77,86,104,25,0,63,67,224,3.6
4975,Anthony Wright\anthony-wright-2,2017-18,Cleveland State,G,28,24,731,85,173,.491,66,111,.595,19,62,.306,35,45,.778,52,110,162,43,31,10,38,61,224,7.4
4976,Joey Frenchwood\joseph-frenchwood-1,2017-18,Lamar,G,29,25,813,73,209,.349,31,83,.373,42,126,.333,36,52,.692,11,60,71,122,47,4,69,62,224,5.8
4977,Jubril Adekoya\jubril-adekoya-1,2015-16,Valparaiso,G,37,1,684,79,157,.503,61,126,.484,18,31,.581,48,61,.787,41,110,151,35,30,12,50,85,224,4.9
4978,Patrell Rogers\patrell-rogers-1,2017-18,South Carolina State,G,20,11,434,78,189,.413,63,128,.492,15,61,.246,53,78,.679,15,39,54,23,7,4,28,35,224,6.0
4979,Nick Hornsby\nick-hornsby-1,2014-15,Sacramento State,G,33,30,806,87,185,.470,83,175,.474,4,10,.400,46,72,.639,46,126,172,54,44,11,56,84,224,5.7
4980,Deondre Burns\deondre-burns-1,2016-17,Little Rock,G,32,14,606,75,166,.452,43,88,.489,32,78,.410,42,52,.808,11,38,49,28,15,3,45,52,224,3.9
4981,T.J. Wallace\tj-wallace-1,2013-14,Pacific,G,32,3,622,70,185,.378,37,91,.407,33,94,.351,51,74,.689,13,55,68,37,29,1,47,75,224,3.7
4982,Devonte Klines\devonte-klines-1,2016-17,Montana State,G,32,20,749,82,218,.376,66,157,.420,16,61,.262,44,75,.587,16,61,77,61,26,9,48,79,224,3.6
4983,Sir Washington\sir-washington-1,2016-17,Eastern Washington,G,34,10,847,69,183,.377,51,132,.386,18,51,.353,68,94,.723,36,80,116,64,12,8,48,90,224,4.1
4984,Corban Collins\corban-collins-1,2016-17,Alabama,G,32,14,698,70,199,.352,25,70,.357,45,129,.349,39,60,.650,9,49,58,47,18,0,30,58,224,3.8
4985,Joe Toye\joe-toye-1,2016-17,Vanderbilt,G,35,13,739,70,175,.400,39,97,.402,31,78,.397,53,78,.679,21,71,92,38,14,5,44,70,224,3.6
4986,Isaac McGlone\isaac-mcglone-1,2016-17,Eastern Kentucky,G,28,26,919,72,190,.379,27,56,.482,45,134,.336,35,43,.814,10,52,62,78,38,3,56,78,224,5.2
4987,Everett Duncan\everett-duncan-1,2017-18,Vermont,G,35,34,990,71,143,.497,20,35,.571,51,108,.472,31,36,.861,30,118,148,16,9,4,15,67,224,5.4
4988,Canyon Barry\canyon-barry-1,2013-14,College of Charleston,G,24,12,573,71,210,.338,45,125,.360,26,85,.306,56,76,.737,16,42,58,33,11,6,52,44,224,3.7
4989,Miles Wright\miles-wright-1,2014-15,Dartmouth,G,29,24,609,81,191,.424,54,113,.478,27,78,.346,35,54,.648,33,50,83,9,42,3,26,56,224,5.4
4990,Tahj Eaddy\tahj-eaddy-1,2016-17,Southeast Missouri State,G,30,12,666,74,198,.374,35,107,.327,39,91,.429,37,40,.925,11,57,68,68,24,1,34,30,224,5.5
4991,Isaiah Lamb\isaiah-lamb-1,2017-18,Marist,G,29,3,638,74,180,.411,54,112,.482,20,68,.294,56,73,.767,16,65,81,17,14,5,46,49,224,4.0
4992,Quinton Marshall\quinton-marshall-1,2013-14,Citadel,G,33,14,767,88,199,.442,83,178,.466,5,21,.238,43,83,.518,43,55,98,34,20,10,51,61,224,3.8
4993,Darrian Gray\darrian-gray-1,2013-14,Southeast Missouri State,G,32,15,681,85,195,.436,53,95,.558,32,100,.320,22,34,.647,27,71,98,38,14,8,32,48,224,4.7
4994,Cortez Seales\cortez-seales-1,2015-16,North Dakota,G,30,9,616,90,192,.469,84,166,.506,6,26,.231,38,62,.613,20,42,62,36,17,10,27,29,224,5.1
4995,Dakarai Tucker\dakarai-tucker-1,2013-14,Utah,G,33,22,662,80,184,.435,33,64,.516,47,120,.392,17,20,.850,10,49,59,25,11,2,13,48,224,4.4
4996,Brandon Cyrus\brandon-cyrus-1,2017-18,DePaul,G,31,21,824,80,195,.410,62,143,.434,18,52,.346,45,65,.692,54,53,107,50,16,11,39,60,223,5.2
4997,Graham Woodward\graham-woodward-1,2016-17,Drake,G,31,15,684,80,193,.415,45,93,.484,35,100,.350,28,43,.651,6,47,53,64,13,1,56,49,223,3.7
4998,Tyler Smithpeters\tyler-smithpeters-1,2015-16,Southern Illinois,G,32,31,766,62,160,.388,15,44,.341,47,116,.405,52,68,.765,15,77,92,62,35,4,51,95,223,4.9
4999,Mike La Tulip\mike-latulip-1,2016-17,Wright State,G,32,26,836,65,167,.389,16,39,.410,49,128,.383,44,53,.830,6,88,94,48,32,2,25,59,223,5.5
5000,Sam Burmeister\sam-burmeister-1,2016-17,Incarnate Word,G,29,9,761,70,177,.395,37,91,.407,33,86,.384,50,72,.694,7,80,87,38,7,2,50,79,223,3.5
5001,Xavier McDaniel Jr.\xavier-mcdanieljr-1,2016-17,Texas-Rio Grande Valley,G,32,16,606,83,211,.393,55,137,.401,28,74,.378,29,43,.674,36,91,127,29,17,11,43,92,223,3.8
5002,Tyler Lewis\tyler-lewis-1,2016-17,Butler,G,34,23,743,71,137,.518,49,81,.605,22,56,.393,59,80,.738,9,40,49,137,22,1,33,58,223,6.7
5003,Jacob Kessler\jacob-kessler-1,2016-17,Army,G,32,31,807,87,187,.465,48,84,.571,39,103,.379,10,21,.476,24,111,135,60,31,4,53,62,223,5.3
5004,Dusty Baker\dusty-baker-1,2017-18,Weber State,G,31,6,789,64,140,.457,20,47,.426,44,93,.473,51,57,.895,6,120,126,115,24,3,41,47,223,7.6
5005,Austin Stewart\austin-stewart-1,2013-14,Central Michigan,G,31,31,680,79,148,.534,70,122,.574,9,26,.346,56,70,.800,49,77,126,21,42,2,41,65,223,6.3
5006,Gary Browne\gary-browne-1,2014-15,West Virginia,G,32,22,644,61,163,.374,31,85,.365,30,78,.385,71,102,.696,22,40,62,46,39,0,40,58,223,4.9
5007,Donovan Jackson\donovan-jackson-1,2016-17,Iowa State,G,35,0,588,73,163,.448,29,66,.439,44,97,.454,33,41,.805,2,31,33,43,18,0,19,44,223,4.5
5008,Isaac Johnson\isaac-johnson-22,2017-18,Western Illinois,G,27,12,567,81,187,.433,67,144,.465,14,43,.326,47,62,.758,17,108,125,23,15,3,39,44,223,5.2
5009,Mitchell Wilbekin\mitchell-wilbekin-1,2016-17,Wake Forest,G,32,10,792,63,177,.356,16,61,.262,47,116,.405,50,56,.893,5,42,47,49,25,2,21,59,223,4.8
5010,R.J. Williams\rj-williams-1,2013-14,Loyola (MD),G,27,25,824,66,182,.363,49,129,.380,17,53,.321,74,107,.692,12,53,65,108,59,3,68,68,223,6.5
5011,Anthony Durham\anthony-durham-2,2017-18,Rider,G,32,31,858,78,171,.456,57,107,.533,21,64,.328,46,58,.793,33,81,114,93,30,5,37,73,223,6.5
5012,Kassius Robertson\kassius-robertson-1,2014-15,Canisius,G,33,0,631,74,156,.474,45,80,.563,29,76,.382,46,55,.836,27,45,72,37,15,1,25,42,223,5.2
5013,Wesley Davis\wesley-davis-1,2014-15,Texas State,G,29,29,834,82,206,.398,61,127,.480,21,79,.266,38,55,.691,23,70,93,57,55,5,44,74,223,5.7
5014,Ethan Stair\ethan-stair-1,2015-16,Mercer,G,34,11,823,86,201,.428,68,137,.496,18,64,.281,33,52,.635,44,98,142,37,22,6,44,76,223,4.3
5015,Roman Penn\roman-penn-1,2017-18,Siena,G,23,19,742,67,164,.409,43,93,.462,24,71,.338,65,78,.833,38,74,112,69,29,5,45,68,223,8.1
5016,Demarquelle Tabb\demarquelle-tabb-1,2013-14,Alabama A&M,G,28,0,623,87,184,.473,87,184,.473,0,0,,49,81,.605,40,110,150,28,22,41,35,88,223,6.3
5017,Ojai Black\ojai-black-1,2015-16,Texas State,G,31,30,969,80,202,.396,74,168,.440,6,34,.176,57,79,.722,12,56,68,120,41,9,43,85,223,5.9
5018,Tony Wills\tony-willis-1,2016-17,Illinois State,G,35,32,943,78,202,.386,37,67,.552,41,135,.304,25,38,.658,14,81,95,56,43,24,31,88,222,5.0
5019,Daiquan Walker\daiquan-walker-1,2014-15,Central Florida,G,30,2,702,83,211,.393,46,115,.400,37,96,.385,19,26,.731,7,48,55,55,22,8,47,46,222,4.2
5020,Ryan Manuel\ryan-manuel-1,2014-15,Southern Methodist,G,34,29,983,77,152,.507,73,141,.518,4,11,.364,64,108,.593,25,88,113,72,19,13,39,78,222,5.3
5021,Ali Faruq-Bey\ali-faruq-bey-1,2015-16,Idaho State,G,17,9,402,73,183,.399,41,85,.482,32,98,.327,44,61,.721,9,30,39,15,20,2,41,26,222,6.6
5022,Dakarai Tucker\dakarai-tucker-1,2014-15,Utah,G,31,3,627,73,167,.437,33,56,.589,40,111,.360,36,44,.818,14,59,73,18,12,9,25,36,222,4.8
5023,RaShawn Stores\rashawn-stores-1,2015-16,Manhattan,G,28,28,826,68,172,.395,24,67,.358,44,105,.419,42,63,.667,16,47,63,85,40,0,48,76,222,6.0
5024,Lexus Williams\lexus-williams-1,2013-14,Valparaiso,G,34,23,796,71,187,.380,43,104,.413,28,83,.337,52,66,.788,12,58,70,81,35,3,59,70,222,4.3
5025,Tevin Mack\tevin-mack-1,2016-17,Texas,G,15,10,470,79,172,.459,45,86,.523,34,86,.395,30,51,.588,22,51,73,12,7,8,21,24,222,9.7
5026,Wyatt Lohaus\wyatt-lohaus-1,2017-18,Northern Iowa,G,24,0,571,73,173,.422,30,78,.385,43,95,.453,33,44,.750,3,59,62,33,8,0,24,42,222,5.7
5027,Brandan Walton\brandan-walton-1,2013-14,North Texas,G,31,10,558,68,180,.378,26,62,.419,42,118,.356,44,66,.667,20,45,65,18,24,1,28,70,222,4.0
5028,JoJo Zamora\jojo-zamora-1,2016-17,Utah,G,32,20,641,80,176,.455,48,87,.552,32,89,.360,30,37,.811,9,37,46,35,18,8,38,44,222,4.3
5029,C.J. Duff\cj-duff-1,2016-17,Western Illinois,G,28,28,913,78,217,.359,31,100,.310,47,117,.402,19,35,.543,15,55,70,68,20,1,36,66,222,4.6
5030,Hassani Gravett\hassani-gravett-1,2017-18,South Carolina,G,30,22,778,75,188,.399,47,101,.465,28,87,.322,44,64,.688,17,92,109,107,12,7,68,58,222,5.1
5031,C.J. Jones\cj-jones-3,2017-18,Arkansas,G,35,0,519,80,189,.423,37,73,.507,43,116,.371,19,24,.792,4,46,50,14,8,5,13,30,222,3.8
5032,David Blanks\david-blanks-1,2014-15,Texas Southern,G,34,10,780,70,140,.500,52,94,.553,18,46,.391,64,96,.667,28,86,114,55,20,0,43,46,222,5.3
5033,James McGee\james-mcgee-1,2014-15,Southern Utah,G,27,8,467,70,143,.490,9,23,.391,61,120,.508,21,30,.700,7,33,40,36,11,2,16,49,222,6.0
5034,Travis Fields\travis-fields-1,2017-18,Radford,G,35,1,712,81,206,.393,50,119,.420,31,87,.356,29,37,.784,15,58,73,76,33,4,48,45,222,4.5
5035,Rashard Odomes\rashard-odomes-1,2017-18,Oklahoma,G,31,25,654,86,170,.506,79,154,.513,7,16,.438,43,80,.538,48,60,108,35,10,2,26,55,222,5.2
5036,Barrington Stevens\barrington-stevens-1,2013-14,South Alabama,G,31,23,887,76,189,.402,49,107,.458,27,82,.329,43,60,.717,8,52,60,86,20,5,43,55,222,4.9
5037,Matt Taylor\matt-taylor-1,2016-17,New Mexico State,G,34,9,747,81,170,.476,58,96,.604,23,74,.311,37,54,.685,28,74,102,56,24,21,40,73,222,5.3
5038,Deonte Burton\deonte-burton-2,2013-14,Marquette,G,32,3,402,87,182,.478,83,174,.477,4,8,.500,44,68,.647,32,37,69,17,35,14,28,58,222,5.0
5039,Sean O'Brien\sean-obrien-1,2013-14,Southern Illinois,G,33,24,797,86,182,.473,75,146,.514,11,36,.306,39,74,.527,42,130,172,38,20,11,42,71,222,5.1
5040,Jalen Hudson\jalen-hudson-1,2014-15,Virginia Tech,G,32,3,535,80,167,.479,65,114,.570,15,53,.283,47,73,.644,23,40,63,37,17,10,51,58,222,4.1
5041,Isiah Brown\isiah-brown-2,2016-17,Northwestern,G,35,2,519,70,211,.332,51,145,.352,19,66,.288,63,82,.768,10,32,42,41,19,7,39,58,222,2.9
5042,Josh Newkirk\josh-newkirk-1,2017-18,Indiana,G,31,24,721,73,193,.378,44,98,.449,29,95,.305,46,57,.807,12,53,65,86,15,8,57,56,221,4.4
5043,Reggie Oliver\reggie-oliver-1,2016-17,Quinnipiac,G,29,11,630,72,220,.327,32,96,.333,40,124,.323,37,52,.712,16,67,83,65,17,0,62,72,221,3.2
5044,Jonah Radebaugh\jonah-radebaugh-1,2016-17,Northern Colorado,G,29,28,981,78,169,.462,34,58,.586,44,111,.396,21,35,.600,34,125,159,55,31,3,26,60,221,7.3
5045,Carlin Dupree\carlin-dupree-1,2015-16,North Dakota State,G,27,16,747,85,186,.457,76,154,.494,9,32,.281,42,71,.592,16,72,88,55,40,2,52,46,221,5.8
5046,Kevin Vannatta\kevin-vannatta-1,2014-15,North Carolina-Asheville,G,29,18,753,71,149,.477,43,77,.558,28,72,.389,51,72,.708,22,81,103,72,29,0,41,34,221,6.9
5047,Darreon Reddick\darreon-reddick-1,2017-18,Tennessee State,G,30,24,848,65,193,.337,37,99,.374,28,94,.298,63,87,.724,12,78,90,50,25,5,57,48,221,4.0
5048,Dontel Highsmith\dontel-highsmith-1,2016-17,Northern Illinois,G,32,29,769,71,175,.406,52,114,.456,19,61,.311,60,83,.723,31,48,79,54,31,4,53,59,221,4.7
5049,Leron Fisher\leron-fisher-1,2013-14,Longwood,G,32,24,881,62,210,.295,39,141,.277,23,69,.333,74,105,.705,4,50,54,75,53,2,61,51,221,4.1
5050,Ilker Er\ilker-er-1,2017-18,Maine,G,28,6,521,82,241,.340,52,111,.468,30,130,.231,27,39,.692,27,75,102,13,11,2,19,64,221,3.5
5051,Jaylen Adams\jaylen-adams-1,2014-15,St. Bonaventure,G,22,22,714,61,158,.386,27,53,.509,34,105,.324,65,83,.783,6,49,55,99,25,1,43,47,221,8.2
5052,Jay Harris\jay-harris-2,2013-14,Tennessee State,G,30,14,692,71,193,.368,49,112,.438,22,81,.272,57,75,.760,30,43,73,39,24,1,29,76,221,4.5
5053,Josh Gray\josh-gray-1,2014-15,Louisiana State,G,31,20,770,86,217,.396,72,164,.439,14,53,.264,35,60,.583,13,53,66,118,31,1,81,61,221,4.1
5054,Quayson Williams\quayson-williams-1,2017-18,Citadel,G,31,4,492,69,187,.369,24,47,.511,45,140,.321,38,48,.792,23,66,89,49,34,3,46,46,221,5.0
5055,Devin Brooks\devin-brooks-1,2013-14,Creighton,G,34,0,566,75,169,.444,66,137,.482,9,32,.281,62,89,.697,43,81,124,95,23,2,62,37,221,5.6
5056,Jon Williams\jon-williams-1,2017-18,Robert Morris,G,33,31,1044,71,182,.390,13,48,.271,58,134,.433,21,28,.750,5,67,72,114,19,0,84,90,221,3.7
5057,Gino Littles\gino-littles-1,2016-17,Texas-San Antonio,G,33,23,922,70,190,.368,39,110,.355,31,80,.388,50,76,.658,14,98,112,72,27,1,45,51,221,4.8
5058,Duane Gibson\duane-gibson-1,2013-14,Evansville,G,33,30,843,73,157,.465,73,156,.468,0,1,.000,75,111,.676,19,99,118,124,23,8,102,97,221,4.3
5059,Malik Maitland\malik-maitland-1,2017-18,Bethune-Cookman,G,22,20,644,76,219,.347,48,136,.353,28,83,.337,41,59,.695,17,43,60,99,34,3,42,48,221,7.3
5060,Tra'Vaughn White\travaughn-white-1,2013-14,Duquesne,G,30,8,498,78,189,.413,55,127,.433,23,62,.371,42,61,.689,8,47,55,38,11,1,30,36,221,4.2
5061,JoJo Cooper\jojo-cooper-1,2016-17,Wagner,G,27,22,855,68,197,.345,48,119,.403,20,78,.256,65,98,.663,27,109,136,96,31,1,74,63,221,5.5
5062,Gary Chivichyan\gary-chivichyan-1,2015-16,Idaho State,G,29,15,538,72,185,.389,9,19,.474,63,166,.380,13,17,.765,6,64,70,12,11,7,16,35,220,4.7
5063,Aaron Calixte\aaron-calixte-1,2014-15,Maine,G,30,28,956,84,209,.402,65,137,.474,19,72,.264,33,40,.825,19,61,80,101,14,2,85,71,220,3.6
5064,Jordan Richardson\jordan-richardson-1,2013-14,Weber State,G,31,28,898,66,185,.357,15,37,.405,51,148,.345,37,54,.685,8,63,71,78,15,3,51,57,220,4.3
5065,Wesley Myers\wesley-myers-1,2013-14,Niagara,G,33,14,747,78,198,.394,58,135,.430,20,63,.317,44,66,.667,19,73,92,39,21,6,47,61,220,3.6
5066,Isaiah Moss\isaiah-moss-1,2016-17,Iowa,G,34,28,580,84,204,.412,55,123,.447,29,81,.358,23,31,.742,9,46,55,29,19,13,36,42,220,3.6
5067,Ty Gibson\ty-gibson-1,2017-18,Eastern Washington,G,35,29,915,72,184,.391,11,20,.550,61,164,.372,15,20,.750,12,64,76,43,22,1,23,49,220,4.5
5068,Kennedy Eubanks\kennedy-eubanks-1,2013-14,Tennessee State,G,29,24,779,85,204,.417,71,141,.504,14,63,.222,36,69,.522,36,118,154,21,17,21,33,74,220,4.9
5069,Lindsey Drew\lindsey-drew-1,2017-18,Nevada,G,27,26,789,77,159,.484,61,118,.517,16,41,.390,50,62,.806,25,86,111,117,26,24,35,72,220,8.8
5070,Jaylen Allen\jaylen-allen-1,2014-15,Wofford,G,35,0,618,75,171,.439,35,76,.461,40,95,.421,30,43,.698,16,45,61,25,29,3,33,60,220,4.0
5071,Sabri Thompson\sabri-thompson-1,2014-15,Northwestern State,G,31,11,624,75,186,.403,39,93,.419,36,93,.387,34,44,.773,31,69,100,49,23,9,37,54,220,5.3
5072,Omega Harris\omega-harris-1,2014-15,Texas-El Paso,G,33,20,882,74,195,.379,43,109,.394,31,86,.360,41,54,.759,9,58,67,62,28,4,65,54,220,3.6
5073,Matt Hauser\matt-hauser-1,2017-18,Santa Clara,G,23,22,759,80,204,.392,34,76,.447,46,128,.359,14,21,.667,4,59,63,75,25,0,37,29,220,6.8
5074,Olin Carter III\olin-carteriii-1,2015-16,San Diego,G,30,27,764,74,221,.335,30,80,.375,44,141,.312,28,41,.683,10,72,82,46,17,6,41,73,220,3.4
5075,Jerome Seagears\jerome-seagears-1,2013-14,Rutgers,G,31,12,654,74,185,.400,37,93,.398,37,92,.402,35,46,.761,8,54,62,99,18,4,42,59,220,5.2
5076,Jimario Rivers\jimario-rivers-1,2017-18,Memphis,G,32,24,761,80,165,.485,75,150,.500,5,15,.333,55,76,.724,45,70,115,61,20,17,58,84,220,5.1
5077,Jake Bittle\jake-bittle-1,2015-16,South Dakota State,G,26,26,664,75,184,.408,54,113,.478,21,71,.296,49,61,.803,36,84,120,55,27,3,52,69,220,6.0
5078,Brian Richardson\brian-richardson-1,2014-15,High Point,G,32,30,790,75,187,.401,51,109,.468,24,78,.308,45,63,.714,15,62,77,62,17,14,41,63,219,4.5
5079,T.J. Hall\tj-hall-1,2013-14,Ohio,G,35,11,667,71,196,.362,52,119,.437,19,77,.247,58,87,.667,34,85,119,59,27,9,52,90,219,3.8
5080,Khalil Alford\khalil-alford-1,2015-16,Rider,G,32,17,621,82,199,.412,63,136,.463,19,63,.302,36,49,.735,36,61,97,24,8,16,36,80,219,3.7
5081,Sam Logwood\sam-logwood-1,2016-17,New Mexico,G,30,18,672,80,178,.449,70,153,.458,10,25,.400,49,73,.671,20,84,104,33,22,4,41,50,219,4.8
5082,Eric Childress\eric-childress-1,2015-16,UC-Santa Barbara,G,33,33,886,80,187,.428,48,116,.414,32,71,.451,27,33,.818,19,108,127,142,41,5,68,75,219,6.3
5083,Craig Bowman\craig-bowman-1,2014-15,Florida A&M,G,29,23,747,68,210,.324,55,154,.357,13,56,.232,70,100,.700,13,62,75,57,35,2,70,58,219,3.4
5084,Jovan Crnic\jovan-crnic-1,2015-16,Abilene Christian,G,31,14,640,71,192,.370,38,96,.396,33,96,.344,44,55,.800,8,71,79,78,23,3,67,66,219,3.9
5085,TJ Lang\tj-lang-1,2015-16,Auburn,G,31,28,772,64,151,.424,16,32,.500,48,119,.403,43,63,.683,19,46,65,20,16,1,20,73,219,4.5
5086,Jaron Martin\jaron-martin-1,2014-15,UC-Irvine,G,33,9,619,74,175,.423,29,82,.354,45,93,.484,26,31,.839,8,28,36,49,16,5,33,40,219,4.3
5087,Kareem Storey\kareem-storey-1,2013-14,Morehead State,G,32,31,963,64,175,.366,49,117,.419,15,58,.259,76,107,.710,23,66,89,162,40,0,111,77,219,4.9
5088,Antonio Biglow\antonio-biglow-1,2013-14,Montana State,G,30,15,747,74,195,.379,64,150,.427,10,45,.222,61,87,.701,9,52,61,77,31,1,49,56,219,4.6
5089,Raekwon Miller\raekwon-miller-1,2016-17,North Carolina-Asheville,G,33,9,667,67,189,.354,26,56,.464,41,133,.308,44,56,.786,8,59,67,49,34,8,49,61,219,4.0
5090,Isaac Fleming\isaac-fleming-1,2015-16,Hawaii,G,23,5,542,73,164,.445,46,76,.605,27,88,.307,46,62,.742,16,40,56,54,29,1,36,49,219,7.0
5091,Marques Townes\marques-townes-1,2014-15,Fairleigh Dickinson,G,24,2,524,88,167,.527,76,126,.603,12,41,.293,31,55,.564,30,50,80,30,38,4,25,35,219,7.8
5092,I.J. Ready\ij-ready-1,2016-17,Mississippi State,G,28,20,801,79,188,.420,68,144,.472,11,44,.250,50,58,.862,8,68,76,127,45,1,54,36,219,7.4
5093,Dane Kuiper\dane-kuiper-1,2017-18,New Mexico,G,34,26,755,69,192,.359,29,63,.460,40,129,.310,41,49,.837,15,95,110,51,32,7,26,73,219,4.9
5094,Jalyn Pennie\jalyn-penne-1,2015-16,New Mexico State,G,34,24,917,82,200,.410,47,98,.480,35,102,.343,20,33,.606,43,100,143,41,15,18,43,57,219,4.6
5095,Ray Gallegos\ray-gallegos-1,2013-14,Nebraska,G,30,18,846,78,214,.364,24,53,.453,54,161,.335,9,12,.750,6,54,60,42,25,4,17,56,219,4.6
5096,Josh Sharkey\josh-sharkey-1,2017-18,Samford,G,30,8,729,64,151,.424,59,125,.472,5,26,.192,86,114,.754,11,52,63,152,46,0,97,58,219,6.1
5097,DeAndre Haywood\deandre-haywood-1,2014-15,Delaware State,G,35,19,654,71,184,.386,54,128,.422,17,56,.304,60,86,.698,17,50,67,45,29,4,62,58,219,3.2
5098,Angel Rivera\angel-rivera-2,2015-16,Stetson,G,34,4,802,61,143,.427,47,92,.511,14,51,.275,83,108,.769,18,55,73,150,40,2,47,80,219,6.8
5099,Jack Gibbs\jack-gibbs-1,2013-14,Davidson,G,32,0,647,63,165,.382,38,87,.437,25,78,.321,67,86,.779,9,51,60,67,26,0,40,50,218,4.8
5100,Jazz Johnson\jazz-johnson-1,2015-16,Portland,G,32,1,527,78,187,.417,45,100,.450,33,87,.379,29,42,.690,7,29,36,39,19,1,40,70,218,3.3
5101,Darius Austin\darius-austin-1,2015-16,Missouri-Kansas City,G,30,26,762,80,220,.364,68,179,.380,12,41,.293,46,74,.622,35,99,134,44,23,12,49,77,218,4.0
5102,Antonio Bivins\antonio-bivins-1,2013-14,Massachusetts-Lowell,G,16,3,440,72,142,.507,72,140,.514,0,2,.000,74,97,.763,38,56,94,7,20,5,27,47,218,10.3
5103,Corey Littlejohn\corey-littlejohn-1,2013-14,North Carolina-Asheville,G,31,7,857,72,175,.411,54,118,.458,18,57,.316,56,75,.747,47,88,135,71,43,10,57,86,218,5.9
5104,Aaron Armstead\aaron-armstead-1,2013-14,Northern Illinois,G,32,7,618,68,172,.395,44,91,.484,24,81,.296,58,71,.817,22,55,77,12,12,6,32,84,218,3.5
5105,Kendrick Nunn\kendrick-nunn-1,2013-14,Illinois,G,35,12,682,83,182,.456,52,102,.510,31,80,.388,21,26,.808,7,51,58,39,21,5,35,41,218,4.1
5106,Kyle Dranginis\kyle-dranginis-1,2013-14,Gonzaga,G,36,8,840,83,171,.485,55,99,.556,28,72,.389,24,40,.600,45,95,140,92,42,18,49,72,218,6.3
5107,Remy Abell\remy-abell-1,2015-16,Xavier,G,34,34,828,69,173,.399,41,94,.436,28,79,.354,52,66,.788,11,45,56,51,17,2,34,45,218,4.2
5108,Jordan Daniels\jordan-daniels-1,2014-15,Drake,G,31,6,588,78,176,.443,50,101,.495,28,75,.373,34,41,.829,2,36,38,42,17,2,30,48,218,4.3
5109,Anthony Glover\anthony-glover-2,2014-15,Chicago State,G,32,14,679,74,204,.363,35,88,.398,39,116,.336,31,47,.660,14,30,44,38,26,2,43,40,218,3.5
5110,Kenny Carpenter\kenny-carpenter-1,2015-16,Cleveland State,G,32,7,655,86,206,.417,63,134,.470,23,72,.319,23,36,.639,14,75,89,48,21,6,27,38,218,4.7
5111,Greg Bowie\greg-bowie-1,2017-18,Texas-Rio Grande Valley,G,29,15,619,81,212,.382,46,111,.414,35,101,.347,21,30,.700,18,49,67,41,32,1,39,47,218,4.5
5112,Brandon Childress\brandon-childress-1,2016-17,Wake Forest,G,33,0,710,63,177,.356,36,100,.360,27,77,.351,65,84,.774,6,65,71,71,27,1,47,54,218,4.4
5113,Idris Taqqee\idris-taqqee-1,2016-17,St. Bonaventure,G,32,31,1082,83,200,.415,71,152,.467,12,48,.250,40,56,.714,74,97,171,56,43,20,38,88,218,6.5
5114,Christian Ellis\christian-ellis-1,2016-17,Southern Illinois-Edwardsville,G,30,28,765,80,175,.457,80,162,.494,0,13,.000,58,131,.443,47,72,119,96,31,3,87,100,218,4.2
5115,Marcus Tarrance\marcus-tarrance-1,2014-15,Middle Tennessee,G,36,19,733,65,154,.422,32,66,.485,33,88,.375,55,77,.714,34,47,81,29,19,1,34,69,218,4.0
5116,Aaron Anderson\aaron-anderson-4,2016-17,Oral Roberts,G,26,24,762,69,140,.493,53,98,.541,16,42,.381,63,78,.808,43,103,146,93,26,3,53,66,217,8.3
5117,Antino Jackson\antino-jackson-1,2014-15,Akron,G,35,10,600,76,214,.355,38,92,.413,38,122,.311,27,37,.730,10,43,53,56,20,1,52,58,217,2.8
5118,Michael Zeno\michael-zeno-1,2015-16,New Orleans,G,29,17,543,82,186,.441,82,184,.446,0,2,.000,53,99,.535,59,79,138,25,28,17,49,67,217,5.1
5119,Davon Reed\davon-reed-1,2013-14,Miami (FL),G,33,10,683,71,207,.343,31,95,.326,40,112,.357,35,52,.673,12,43,55,38,16,4,44,55,217,2.9
5120,Joshua Floyd\joshua-floyd-1,2016-17,Savannah State,G,29,25,614,73,190,.384,40,89,.449,33,101,.327,38,62,.613,30,50,80,75,20,1,50,30,217,5.2
5121,Justin Massey\justin-massey-1,2014-15,Florida Atlantic,G,29,11,734,69,165,.418,31,71,.437,38,94,.404,41,59,.695,10,78,88,38,18,2,30,58,217,5.0
5122,DJ Mlachnik\dj-mlachnik-1,2013-14,Massachusetts-Lowell,G,28,28,857,66,199,.332,27,76,.355,39,123,.317,46,58,.793,15,79,94,40,15,0,52,53,217,3.7
5123,Rodrick Caldwell\rodrick-caldwell-1,2016-17,Bowling Green State,G,32,12,582,67,183,.366,34,91,.374,33,92,.359,50,71,.704,12,46,58,53,19,1,34,55,217,4.1
5124,Lamarr Kimble\lamarr-kimble-1,2015-16,Saint Joseph's,G,36,0,651,71,174,.408,42,96,.438,29,78,.372,46,62,.742,10,44,54,91,15,4,45,55,217,4.2
5125,Greg Heckstall\greg-heckstall-1,2017-18,Hampton,G,27,15,682,75,186,.403,47,106,.443,28,80,.350,39,50,.780,27,137,164,58,8,14,32,65,217,6.4
5126,J.C. Hampton\jc-hampton-1,2014-15,Lipscomb,G,29,27,758,80,239,.335,52,126,.413,28,113,.248,29,40,.725,11,73,84,89,24,2,43,60,217,4.4
5127,Sir Washington\sir-washington-1,2017-18,Eastern Washington,G,34,8,782,75,200,.375,54,129,.419,21,71,.296,46,75,.613,16,83,99,55,23,4,38,76,217,3.7
5128,Codi Miller-McIntyre\codi-miller-mcintyre-1,2015-16,Wake Forest,G,23,20,701,81,196,.413,66,150,.440,15,46,.326,40,61,.656,39,64,103,92,18,2,54,62,217,6.8
5129,Jay Harris\jay-harris-3,2013-14,Wagner,G,21,17,620,69,179,.385,25,65,.385,44,114,.386,35,39,.897,13,46,59,58,18,0,48,33,217,6.6
5130,Rozell Nunn\rozell-nunn-1,2014-15,Southern Illinois-Edwardsville,G,23,22,608,67,174,.385,46,119,.387,21,55,.382,62,85,.729,19,92,111,39,26,0,58,42,217,5.7
5131,Amorie Archibald\amorie-archibald-1,2017-18,Louisiana Tech,G,29,17,604,71,181,.392,52,117,.444,19,64,.297,56,77,.727,19,58,77,117,24,4,55,43,217,6.1
5132,Kyre' Hamer\kyre-hamer-1,2013-14,Campbell,G,30,0,618,75,175,.429,61,117,.521,14,58,.241,53,82,.646,20,65,85,49,23,3,47,56,217,4.5
5133,Jack Lopez\jack-lopez-1,2016-17,Montana,G,32,31,787,71,174,.408,17,51,.333,54,123,.439,21,30,.700,16,86,102,22,12,8,28,89,217,4.0
5134,Byron Ashe\byron-ashe-1,2013-14,Mount St. Mary's,G,31,14,684,71,188,.378,23,55,.418,48,133,.361,27,41,.659,26,36,62,21,20,2,18,66,217,4.2
5135,Aaron Bodager\aaron-bodager-1,2015-16,North Florida,G,34,0,728,69,139,.496,12,19,.632,57,120,.475,22,27,.815,26,68,94,40,18,3,24,59,217,5.4
5136,Christian Peevy\christian-peevy-1,2017-18,Incarnate Word,G,28,6,444,71,133,.534,70,127,.551,1,6,.167,74,89,.831,36,65,101,15,11,11,46,64,217,5.3
5137,Maurice Howard\maurice-howard-1,2016-17,Alcorn State,G,32,5,668,68,185,.368,25,75,.333,43,110,.391,37,45,.822,15,56,71,61,26,3,53,59,216,4.1
5138,Andre Nation\andre-nation-1,2013-14,James Madison,G,14,10,472,77,158,.487,69,118,.585,8,40,.200,54,88,.614,24,50,74,23,28,14,18,46,216,12.3
5139,Bruce Brown\bruce-brown-2,2017-18,Miami (FL),G,19,19,640,78,188,.415,62,128,.484,16,60,.267,44,70,.629,25,110,135,76,25,15,43,43,216,9.7
5140,Curtis Diamond\curtis-diamond-1,2013-14,Georgia Southern,G,34,5,731,76,226,.336,37,94,.394,39,132,.295,25,33,.758,7,62,69,28,20,4,30,49,216,3.0
5141,Malik Harmon\malik-harmon-1,2015-16,Saint Francis (PA),G,27,27,803,60,201,.299,22,85,.259,38,116,.328,58,83,.699,11,58,69,80,26,0,48,49,216,4.8
5142,Brandyn Curry\brandyn-curry-1,2013-14,Harvard,G,23,4,600,77,168,.458,46,85,.541,31,83,.373,31,53,.585,12,56,68,64,32,12,33,45,216,7.8
5143,Sanjay Lumpkin\sanjay-lumpkin-1,2016-17,Northwestern,G,36,36,1007,77,138,.558,62,88,.705,15,50,.300,47,69,.681,52,144,196,49,22,15,25,113,216,6.0
5144,Treshawn Hagood\treshawn-hagood-1,2013-14,Prairie View,G,33,25,935,68,181,.376,60,148,.405,8,33,.242,72,115,.626,23,82,105,124,44,0,88,75,216,4.6
5145,Rayjon Tucker\rayjon-tucker-1,2015-16,Florida Gulf Coast,G,35,1,649,66,121,.545,52,82,.634,14,39,.359,70,98,.714,24,82,106,28,21,8,41,63,216,4.8
5146,K.J. Riley\kj-riley-1,2017-18,Evansville,G,32,17,767,54,131,.412,53,122,.434,1,9,.111,107,139,.770,18,92,110,91,33,5,64,73,216,5.6
5147,Manuale Watkins\manuale-watkins-1,2016-17,Arkansas,G,36,23,802,93,165,.564,80,137,.584,13,28,.464,17,30,.567,37,107,144,65,45,1,20,70,216,6.5
5148,Rodney Elliott\rodney-elliott-2,2016-17,Maryland-Baltimore County,G,26,2,507,68,147,.463,33,61,.541,35,86,.407,45,65,.692,14,35,49,40,13,0,32,61,216,5.3
5149,Trivante Bloodman\trivante-bloodman-1,2013-14,Mississippi State,G,33,17,816,63,132,.477,54,100,.540,9,32,.281,81,111,.730,19,46,65,82,30,0,58,55,216,5.2
5150,Colton Ray-St Cyr\colton-ray-st-cyr-1,2015-16,Coastal Carolina,G,25,12,608,74,158,.468,59,112,.527,15,46,.326,53,88,.602,29,111,140,45,26,16,38,53,216,7.4
5151,Daryl Edwards\daryl-edwards-1,2017-18,Louisiana State,G,32,16,705,73,158,.462,34,53,.642,39,105,.371,31,39,.795,7,48,55,42,23,3,29,57,216,4.8
5152,Antwon Lillard\antwon-lillard-1,2017-18,Bowling Green State,G,23,13,553,67,156,.429,46,91,.505,21,65,.323,61,77,.792,17,83,100,45,26,9,41,77,216,6.8
5153,Michael Messer\michael-messer-1,2014-15,Southern Illinois-Edwardsville,G,28,28,604,84,183,.459,60,124,.484,24,59,.407,23,37,.622,33,53,86,23,17,3,37,72,215,4.4
5154,Josh Reaves\josh-reaves-1,2016-17,Penn State,G,28,23,759,81,181,.448,62,122,.508,19,59,.322,34,48,.708,37,75,112,59,60,21,54,84,215,6.9
5155,Sedrick Barefield\sedrick-barefield-1,2016-17,Utah,G,24,3,542,70,168,.417,37,84,.440,33,84,.393,42,57,.737,8,36,44,47,19,0,44,43,215,5.3
5156,Kendal Yancy\kendal-yancy-1,2014-15,Texas,G,34,18,724,76,189,.402,48,105,.457,28,84,.333,35,45,.778,28,67,95,59,9,5,37,42,215,4.4
5157,Chris Caird\chris-caird-1,2014-15,Drake,G,31,13,618,72,162,.444,29,61,.475,43,101,.426,28,32,.875,16,48,64,32,10,2,38,61,215,4.1
5158,Ty Charles\ty-charles-1,2016-17,Stephen F. Austin,G,23,16,672,81,192,.422,69,139,.496,12,53,.226,41,62,.661,37,79,116,49,25,4,53,78,215,5.7
5159,Chris Burgess\chris-burgess-3,2015-16,Appalachian State,G,31,31,653,70,170,.412,25,52,.481,45,118,.381,30,37,.811,10,26,36,68,14,0,27,60,215,4.7
5160,R.J. Fuqua\rj-fuqua-1,2017-18,Oral Roberts,G,27,21,794,75,214,.350,47,127,.370,28,87,.322,37,48,.771,8,64,72,79,31,3,55,60,215,4.6
5161,Nathan Moran\nathan-moran-1,2014-15,Lipscomb,G,26,15,560,63,181,.348,12,33,.364,51,148,.345,38,50,.760,9,39,48,68,17,0,48,57,215,4.6
5162,Byron Hawkins\byron-hawkins-1,2017-18,Murray State,G,30,2,561,70,158,.443,35,70,.500,35,88,.398,40,57,.702,15,23,38,30,19,0,24,44,215,4.7
5163,D.J. Brown\dj-brown-1,2014-15,Texas State,G,30,30,911,63,170,.371,20,49,.408,43,121,.355,46,59,.780,9,70,79,81,33,0,41,54,215,5.7
5164,Johnathan Walker\johnathan-walker-1,2017-18,Delaware State,G,27,16,708,78,181,.431,61,123,.496,17,58,.293,42,60,.700,22,32,54,57,30,3,52,59,215,5.0
5165,Jamaal Calvin\jamaal-calvin-1,2016-17,Southeast Missouri State,G,31,29,812,69,180,.383,15,49,.306,54,131,.412,23,26,.885,11,68,79,68,44,2,35,46,215,5.9
5166,Mitchell Badillo\mitchell-badillo-1,2013-14,Incarnate Word,G,27,5,708,70,147,.476,51,99,.515,19,48,.396,56,72,.778,25,69,94,117,32,0,49,54,215,8.0
5167,Tim Johnson\tim-johnson-5,2013-14,Southern Illinois-Edwardsville,G,30,12,543,78,172,.453,61,118,.517,17,54,.315,42,57,.737,26,45,71,32,25,12,43,50,215,4.8
5168,Richaud Gittens\richaud-gittens-1,2013-14,Weber State,G,31,3,705,74,160,.463,58,127,.457,16,33,.485,51,80,.638,13,78,91,68,19,6,58,57,215,4.6
5169,Justin Seymour\justin-seymour-1,2015-16,Murray State,G,30,8,710,77,190,.405,33,73,.452,44,117,.376,16,22,.727,10,79,89,48,27,6,36,73,214,4.7
5170,Atif Russell\atif-russell-1,2016-17,Houston Baptist,G,26,5,440,79,162,.488,66,115,.574,13,47,.277,43,74,.581,32,53,85,33,18,4,42,46,214,5.4
5171,Paul Miller\paul-miller-2,2014-15,North Dakota State,G,32,6,912,67,177,.379,30,80,.375,37,97,.381,43,56,.768,9,113,122,32,18,3,26,56,214,4.6
5172,Jeff Newberry\jeff-newberry-1,2014-15,Oklahoma State,G,32,20,672,70,169,.414,42,90,.467,28,79,.354,46,57,.807,23,50,73,45,29,12,33,59,214,5.1
5173,Dominique Major\dominique-major-1,2013-14,Saint Francis (PA),G,31,12,766,73,193,.378,18,45,.400,55,148,.372,13,32,.406,10,25,35,25,21,0,20,50,214,3.7
5174,Jalen Ray\jalen-ray-1,2017-18,Hofstra,G,31,4,650,62,172,.360,14,51,.275,48,121,.397,42,58,.724,7,37,44,36,24,6,22,63,214,4.3
5175,Jaqawn Raymond\jaqawn-raymond-1,2013-14,Middle Tennessee,G,33,7,695,69,175,.394,24,64,.375,45,111,.405,31,44,.705,13,61,74,42,15,4,37,67,214,3.8
5176,Ryan Betley\ryan-betley-1,2016-17,Pennsylvania,G,18,15,505,75,158,.475,40,71,.563,35,87,.402,29,32,.906,20,63,83,17,20,9,23,35,214,9.2
5177,Gentrey Thomas\gentrey-thomas-1,2016-17,UC-Riverside,G,26,13,658,88,213,.413,64,130,.492,24,83,.289,14,23,.609,16,81,97,39,26,8,50,41,214,4.8
5178,Chris Burgess\chris-burgess-3,2013-14,Appalachian State,G,30,26,754,73,180,.406,44,92,.478,29,88,.330,39,47,.830,8,37,45,70,17,0,43,72,214,4.2
5179,Shawn Johnson\shawn-johnson-1,2014-15,Incarnate Word,G,29,13,699,67,150,.447,40,79,.506,27,71,.380,53,74,.716,24,103,127,23,33,26,28,74,214,6.4
5180,Tim Marshall\tim-marshall-1,2015-16,Virginia Military Institute,G,28,20,600,74,218,.339,23,49,.469,51,169,.302,15,25,.600,12,55,67,31,19,2,34,62,214,3.4
5181,Jeff Thomas\jeff-thomas-2,2016-17,Georgia State,G,33,5,618,73,172,.424,31,66,.470,42,106,.396,26,35,.743,19,62,81,27,19,21,26,48,214,4.8
5182,Lonnie Jackson\lonnie-jackson-2,2015-16,Boise State,G,32,20,678,70,171,.409,16,31,.516,54,140,.386,20,27,.741,7,52,59,49,15,1,31,51,214,4.3
5183,Paul Jackson\paul-johnson-3,2015-16,Eastern Kentucky,G,30,20,816,65,144,.451,41,87,.471,24,57,.421,60,90,.667,16,43,59,149,25,3,67,92,214,6.0
5184,Evan Cooper\evan-cooper-1,2013-14,Hartford,G,30,13,689,70,162,.432,29,58,.500,41,104,.394,33,42,.786,8,47,55,49,27,0,40,58,214,4.8
5185,Isaac Mack\isaac-mack-1,2013-14,New Orleans,G,25,25,734,77,204,.377,57,135,.422,20,69,.290,40,58,.690,14,45,59,82,24,0,65,60,214,4.4
5186,Corbin Miller\corbin-miller-1,2015-16,Harvard,G,30,5,739,71,202,.351,14,49,.286,57,153,.373,15,24,.625,7,46,53,40,17,2,35,24,214,3.9
5187,Race Parsons\race-parsons-1,2015-16,Southern Utah,G,25,25,706,70,171,.409,30,66,.455,40,105,.381,33,46,.717,28,77,105,40,12,7,27,56,213,6.2
5188,Anthony Stitt\anthony-stitt-1,2014-15,College of Charleston,G,26,17,824,76,235,.323,48,148,.324,28,87,.322,33,56,.589,20,48,68,66,26,3,62,53,213,3.4
5189,Isaiah McCray\isaiah-mccray-1,2013-14,Purdue-Fort Wayne,G,32,28,737,66,181,.365,44,108,.407,22,73,.301,59,116,.509,20,68,88,69,30,15,35,71,213,4.7
5190,Brandon Key\brandon-key-2,2017-18,South Dakota State,G,34,5,632,72,157,.459,59,116,.509,13,41,.317,56,81,.691,11,40,51,112,19,0,55,35,213,5.0
5191,Romone Saunders\romone-saunders--1,2014-15,Wagner,G,27,11,622,71,187,.380,42,101,.416,29,86,.337,42,57,.737,38,72,110,41,23,0,33,59,213,5.5
5192,Cam Ward\cam-ward-1,2014-15,Vermont,G,34,1,688,67,154,.435,30,60,.500,37,94,.394,42,73,.575,9,57,66,73,14,5,25,37,213,5.1
5193,Jaylen Minnett\jaylen-minnett-1,2017-18,IUPUI,G,30,4,630,69,173,.399,18,47,.383,51,126,.405,24,30,.800,12,24,36,35,14,1,39,42,213,3.9
5194,Daniel Dion\daniel-dion-1,2013-14,New Hampshire,G,26,11,631,76,199,.382,30,77,.390,46,122,.377,15,23,.652,8,44,52,63,12,4,57,48,213,3.9
5195,Storm Murphy\storm-murphy-1,2017-18,Wofford,G,34,28,932,70,160,.438,29,53,.547,41,107,.383,32,38,.842,7,68,75,135,30,1,56,44,213,6.0
5196,Leroy Isler\leroy-isler-1,2013-14,Little Rock,G,30,28,785,61,166,.367,47,121,.388,14,45,.311,77,105,.733,42,59,101,42,14,5,47,85,213,4.1
5197,Austin McBroom\austin-mcbroom-1,2014-15,Saint Louis,G,32,14,645,69,183,.377,27,85,.318,42,98,.429,33,43,.767,10,29,39,52,24,0,35,28,213,4.3
5198,Duane Gibson\duane-gibson-1,2016-17,Evansville,G,30,27,848,82,174,.471,82,172,.477,0,2,.000,49,69,.710,25,101,126,114,30,17,68,85,213,6.1
5199,Adam McDermott\adam-mcdermott-1,2015-16,North Dakota,G,32,1,725,66,161,.410,10,24,.417,56,137,.409,25,29,.862,14,60,74,17,19,0,15,49,213,4.7
5200,Malik Thames\malik-thames-1,2015-16,UC-Riverside,G,31,17,815,66,171,.386,39,98,.398,27,73,.370,54,69,.783,9,69,78,91,24,6,35,49,213,5.7
5201,Devin Wilson\devin-wilson-2,2014-15,Virginia Tech,G,33,28,990,63,140,.450,55,113,.487,8,27,.296,79,112,.705,13,84,97,140,29,2,63,69,213,6.0
5202,Cole Martinez\cole-martinez-1,2016-17,Texas A&M-Corpus Christi,G,30,12,590,66,131,.504,20,31,.645,46,100,.460,35,37,.946,11,36,47,29,13,2,12,45,213,5.7
5203,Karonn Davis\karonn-davis-1,2014-15,Niagara,G,29,26,886,67,197,.340,32,89,.360,35,108,.324,44,58,.759,16,65,81,81,18,3,31,70,213,5.0
5204,Teyvon Myers\teyvon-myers-1,2016-17,West Virginia,G,37,1,480,79,180,.439,67,150,.447,12,30,.400,43,62,.694,17,34,51,53,22,1,39,38,213,3.7
5205,K.J. Walton\kj-walton-1,2016-17,Missouri,G,32,17,608,69,175,.394,64,152,.421,5,23,.217,70,116,.603,44,62,106,31,37,0,37,53,213,4.7
5206,Jared Nickens\jared-nickens-1,2014-15,Maryland,G,35,9,674,71,188,.378,14,42,.333,57,146,.390,14,19,.737,12,37,49,14,9,8,11,29,213,3.7
5207,Quinten Rollins\quinten-rollins-1,2013-14,Miami (OH),G,31,31,959,74,176,.420,73,172,.424,1,4,.250,64,98,.653,19,101,120,122,73,2,76,84,213,6.4
5208,Devin Liggeons\devin-liggeons-1,2017-18,Wagner,G,33,22,715,74,167,.443,53,98,.541,21,69,.304,43,58,.741,51,102,153,29,18,17,39,79,212,5.0
5209,Darian Anderson\darin-anderson-1,2017-18,Fairleigh Dickinson,G,15,12,433,72,208,.346,42,113,.372,30,95,.316,38,50,.760,9,45,54,51,32,4,29,38,212,9.1
5210,Khyri Thomas\khyri-thomas-1,2015-16,Creighton,G,34,28,634,82,174,.471,59,119,.496,23,55,.418,25,48,.521,28,97,125,46,33,3,37,63,212,4.9
5211,Johnny Hill\johnny-hill-2,2014-15,Texas-Arlington,G,21,15,565,69,149,.463,61,117,.521,8,32,.250,66,96,.688,21,70,91,75,26,3,65,48,212,7.4
5212,Kennedy Eubanks\kennedy-eubanks-1,2015-16,Texas-Arlington,G,34,7,552,74,175,.423,44,78,.564,30,97,.309,34,58,.586,26,81,107,23,11,13,38,77,212,3.5
5213,Kelton Ford\kelton-ford-1,2014-15,Troy,G,29,15,744,65,183,.355,45,100,.450,20,83,.241,62,100,.620,4,63,67,68,51,4,63,72,212,4.3
5214,Nate Britt\nate-britt-1,2015-16,North Carolina,G,39,0,600,73,189,.386,47,109,.431,26,80,.325,40,50,.800,13,44,57,69,25,0,35,46,212,3.8
5215,Jalen Pendleton\jalen-pendleton-1,2014-15,Southern Illinois,G,32,14,710,74,173,.428,70,156,.449,4,17,.235,60,90,.667,33,61,94,51,34,1,36,68,212,4.9
5216,Joe'Randle Toliver\joerandle-toliver-1,2016-17,Arkansas-Pine Bluff,G,32,22,819,70,205,.341,12,31,.387,58,174,.333,14,18,.778,13,65,78,59,32,4,58,47,212,3.8
5217,Micheal Warren\michael-warren-1,2016-17,Cal State Northridge,G,29,4,706,71,147,.483,41,81,.506,30,66,.455,40,53,.755,13,75,88,49,32,9,35,76,212,5.9
5218,Nick Daniels\nick-daniels-2,2016-17,Oakland,G,34,1,615,70,183,.383,28,68,.412,42,115,.365,30,41,.732,15,58,73,68,30,0,47,29,212,4.5
5219,Devin Peterson\devin-peterson-1,2017-18,Western Carolina,G,30,16,672,79,197,.401,60,147,.408,19,50,.380,35,52,.673,12,50,62,90,22,5,46,50,212,4.8
5220,Chandler Hutchison\chandler-hutchison-1,2015-16,Boise State,G,31,8,615,80,161,.497,77,148,.520,3,13,.231,49,77,.636,51,76,127,41,21,11,31,65,212,5.8
5221,Jaylen Benton\jaylen-benton-1,2017-18,Youngstown State,G,32,4,500,77,186,.414,41,96,.427,36,90,.400,22,36,.611,19,35,54,64,34,2,44,66,212,4.4
5222,Corey Johnson\corey-johnson-4,2016-17,Harvard,G,26,18,620,71,169,.420,9,19,.474,62,150,.413,8,10,.800,11,63,74,27,12,8,24,47,212,5.4
5223,Charles Callison\charles-callison-1,2015-16,Washington State,G,27,22,670,80,205,.390,56,130,.431,24,75,.320,28,42,.667,9,35,44,81,30,3,47,58,212,4.8
5224,Connor Miller\connor-miller-1,2013-14,Samford,G,33,33,1037,71,187,.380,27,71,.380,44,116,.379,26,42,.619,26,104,130,68,24,7,44,89,212,4.5
5225,Troy Thompson\troy-thompson-2,2017-18,Prairie View,G,31,16,572,68,187,.364,23,55,.418,45,132,.341,31,43,.721,25,39,64,24,18,8,31,38,212,4.1
5226,Zaynah Robinson\zaynah-robinson-1,2015-16,Norfolk State,G,34,25,893,67,190,.353,33,104,.317,34,86,.395,44,51,.863,3,71,74,98,41,2,26,56,212,5.6
5227,Ron Mvouika\ron-mvouika-1,2013-14,Missouri State,G,31,9,563,71,168,.423,46,105,.438,25,63,.397,45,76,.592,37,76,113,54,13,3,46,50,212,4.7
5228,Jarvis Garrett\jarvis-garrett-1,2014-15,Rhode Island,G,33,18,852,63,186,.339,39,99,.394,24,87,.276,61,91,.670,9,68,77,93,31,1,45,61,211,4.5
5229,D'Vonne Pickett\dvonne-pickett-1,2013-14,Seattle,G,29,6,610,83,183,.454,83,182,.456,0,1,.000,45,74,.608,28,48,76,99,22,2,61,70,211,4.9
5230,Kieran Woods\kieran-woods-1,2015-16,Chicago State,G,22,10,475,75,177,.424,69,149,.463,6,28,.214,55,92,.598,32,60,92,60,39,8,51,58,211,7.1
5231,Blake Bozeman\blake-bozeman-1,2013-14,Morgan State,G,31,31,961,71,245,.290,25,85,.294,46,160,.288,23,32,.719,17,43,60,58,16,1,42,68,211,2.5
5232,Donte Pretlow\donte-pretlow-1,2015-16,Morgan State,G,30,27,892,78,209,.373,69,171,.404,9,38,.237,46,74,.622,14,77,91,123,40,0,63,48,211,5.4
5233,Ben Dillard\ben-dillard-1,2013-14,Little Rock,G,29,21,714,54,130,.415,27,62,.435,27,68,.397,76,91,.835,8,52,60,25,20,3,35,69,211,4.6
5234,Rasheed Brooks\rasheed-brooks-1,2016-17,Mississippi,G,33,12,737,74,211,.351,32,88,.364,42,123,.341,21,23,.913,22,64,86,53,27,6,44,44,211,4.0
5235,C.J. Carr\cj-carr-1,2015-16,Southern Illinois-Edwardsville,G,28,23,733,77,223,.345,51,130,.392,26,93,.280,31,41,.756,17,58,75,88,28,2,62,57,211,4.2
5236,James Gollon\james-gollon-1,2017-18,Ohio,G,31,7,669,67,147,.456,32,56,.571,35,91,.385,42,48,.875,16,94,110,40,31,5,37,51,211,5.7
5237,Zjori Bosha\zjori-bosha-1,2016-17,Lamar,G,33,23,733,67,158,.424,39,73,.534,28,85,.329,49,70,.700,45,79,124,38,48,13,26,68,211,6.2
5238,Matt McQuaid\matt-mcquaid-1,2017-18,Michigan State,G,35,2,718,67,165,.406,15,32,.469,52,133,.391,25,29,.862,26,42,68,45,11,3,25,59,211,4.2
5239,Matt Bingaya\matt-bingaya-1,2013-14,Southern Mississippi,G,36,8,506,80,156,.513,79,149,.530,1,7,.143,50,82,.610,47,86,133,18,27,10,30,55,211,4.8
5240,Kyle Foster\kyle-foster-1,2017-18,Howard,G,33,3,594,62,204,.304,9,33,.273,53,171,.310,34,52,.654,5,55,60,25,17,6,40,63,211,2.4
5241,Alexander Aka Gorski\alexander-aka-gorski-1,2017-18,Wyoming,G,31,11,698,67,195,.344,22,39,.564,45,156,.288,32,43,.744,8,52,60,31,12,1,34,59,211,3.1
5242,DeAndre Abram\deandre-abram-1,2015-16,George Mason,G,32,13,658,76,221,.344,43,101,.426,33,120,.275,26,37,.703,25,69,94,6,6,12,21,46,211,3.1
5243,Virshon Cotton\virshon-cotton-1,2017-18,Akron,G,29,6,595,59,163,.362,22,64,.344,37,99,.374,56,74,.757,4,54,58,51,21,0,57,42,211,4.0
5244,Bryan Smith\bryan-smith-1,2013-14,Fordham,G,29,28,765,73,216,.338,35,76,.461,38,140,.271,27,34,.794,40,85,125,36,32,7,39,84,211,4.5
5245,Jordan Walker\jordan-walker-2,2016-17,Morehead State,G,30,0,525,70,150,.467,32,73,.438,38,77,.494,33,40,.825,17,36,53,37,17,2,20,60,211,5.1
5246,Julian Jacobs\julian-jacobs-1,2013-14,Southern California,G,32,19,904,72,176,.409,54,118,.458,18,58,.310,49,65,.754,15,125,140,116,34,14,87,73,211,5.2
5247,Aaron Hines\aaron-hines-1,2016-17,Saint Louis,G,33,24,940,70,222,.315,38,119,.319,32,103,.311,39,59,.661,9,74,83,84,30,1,54,70,211,3.4
5248,Armani Branch\armani-branch-1,2016-17,Virginia Military Institute,G,27,16,464,85,187,.455,65,137,.474,20,50,.400,21,33,.636,38,57,95,12,9,23,35,38,211,5.0
5249,DJ Sylvester\dj-sylvester-1,2017-18,UC-Riverside,G,27,14,652,65,186,.349,38,105,.362,27,81,.333,54,80,.675,15,62,77,26,15,1,36,56,211,3.7
5250,Cameron Johnson\cameron-johnson-3,2014-15,College of Charleston,G,33,16,895,72,180,.400,37,90,.411,35,90,.389,32,43,.744,13,70,83,38,21,3,42,90,211,3.4
5251,Bobby Word\bobby-word-1,2013-14,Oral Roberts,G,32,21,737,64,172,.372,22,50,.440,42,122,.344,41,55,.745,14,72,86,29,15,8,24,72,211,4.1
5252,Jashire Hardnett\jashire-hardnett-1,2017-18,Brigham Young,G,35,32,945,75,164,.457,60,118,.508,15,46,.326,46,57,.807,11,85,96,71,25,3,59,91,211,3.9
5253,Ricky Madison\ricky-madison-1,2016-17,High Point,G,31,29,672,78,170,.459,76,160,.475,2,10,.200,53,81,.654,66,117,183,14,12,13,52,76,211,4.6
5254,Justin Graham\justin-graham-2,2015-16,Hartford,G,30,21,766,69,209,.330,45,126,.357,24,83,.289,48,71,.676,9,48,57,61,35,1,58,55,210,3.4
5255,Aaron Armstead\aaron-armstead-1,2014-15,Northern Illinois,G,29,5,607,77,171,.450,40,82,.488,37,89,.416,19,30,.633,19,44,63,20,31,2,36,64,210,4.4
5256,Kevin Johnson\kevin-johnson-23,2017-18,Nicholls State,G,32,28,962,78,199,.392,52,112,.464,26,87,.299,28,38,.737,26,63,89,84,61,0,37,68,210,6.0
5257,Cleon Roberts\cleon-roberts-1,2016-17,La Salle,G,30,13,687,60,150,.400,19,57,.333,41,93,.441,49,65,.754,18,46,64,35,36,8,34,62,210,5.2
5258,Mareik Isom\mareik-isom-1,2014-15,Little Rock,G,31,8,494,68,148,.459,32,68,.471,36,80,.450,38,44,.864,25,65,90,11,10,11,25,72,210,4.5
5259,Cody Doolin\cody-doolin-1,2014-15,Nevada-Las Vegas,G,33,33,1035,75,162,.463,52,93,.559,23,69,.333,37,53,.698,13,81,94,128,34,1,35,68,210,6.5
5260,Terrence Samuel\terrence-samuel-1,2017-18,South Florida,G,32,31,909,60,153,.392,47,121,.388,13,32,.406,77,96,.802,19,112,131,93,35,0,69,51,210,5.5
5261,Max DiLeo\max-dileo-1,2014-15,Monmouth,G,33,22,823,63,161,.391,41,87,.471,22,74,.297,62,87,.713,25,73,98,49,47,4,30,71,210,5.4
5262,Obi Okolie\obi-okolie-1,2017-18,Brown,G,24,8,600,67,158,.424,56,115,.487,11,43,.256,65,95,.684,22,71,93,38,11,4,29,36,210,6.2
5263,Phil Booth\phil-booth-1,2014-15,Villanova,G,36,0,521,72,128,.563,40,62,.645,32,66,.485,34,46,.739,9,46,55,51,10,1,27,52,210,4.5
5264,Deion Lavender\deion-lavender-1,2014-15,Southern Illinois,G,32,13,734,74,171,.433,50,95,.526,24,76,.316,38,46,.826,9,71,80,26,14,1,36,33,210,4.0
5265,Christian Salecich\christian-salecich-1,2013-14,Southern Illinois-Edwardsville,G,31,11,713,74,177,.418,34,66,.515,40,111,.360,22,32,.688,13,52,65,70,22,1,35,44,210,5.0
5266,Evan Taylor\evan-taylor-1,2017-18,Nebraska,G,33,20,851,68,159,.428,52,123,.423,16,36,.444,58,81,.716,26,87,113,74,32,15,40,65,210,5.7
5267,Johnathan Burroughs-Cook\johnathan-burroughs-cook-1,2015-16,Chattanooga,G,35,1,520,70,173,.405,55,117,.470,15,56,.268,55,81,.679,16,46,62,43,20,2,41,56,210,3.4
5268,Jalyn Patterson\jalyn-patterson-1,2014-15,Louisiana State,G,31,11,764,75,184,.408,31,66,.470,44,118,.373,16,19,.842,13,62,75,68,37,4,26,27,210,6.1
5269,Rashann London\rashann-london-1,2014-15,Drexel,G,30,30,910,85,226,.376,71,174,.408,14,52,.269,26,41,.634,7,56,63,47,20,3,55,68,210,2.5
5270,Malcolm Brent\malcolm-brent-1,2014-15,Maryland-Baltimore County,G,30,17,846,68,198,.343,20,67,.299,48,131,.366,26,32,.813,16,61,77,34,22,2,56,45,210,3.3
5271,Bryce Brown\bryce-brown-1,2016-17,Auburn,G,28,13,592,68,189,.360,12,49,.245,56,140,.400,18,27,.667,12,43,55,35,26,6,26,49,210,4.7
5272,Sebastian Douglas\sebastian-douglas-1,2013-14,Cleveland State,G,26,7,628,89,145,.614,86,139,.619,3,6,.500,29,53,.547,35,51,86,35,18,0,44,45,210,6.0
5273,Kellon Thomas\kellon-thomas-1,2013-14,Kent State,G,32,15,701,68,154,.442,49,105,.467,19,49,.388,54,69,.783,7,56,63,64,21,0,43,86,209,4.1
5274,Tyler Ulis\tyler-ulis-1,2014-15,Kentucky,G,37,0,882,67,165,.406,34,88,.386,33,77,.429,42,52,.808,16,51,67,135,37,2,38,56,209,5.8
5275,Ryan Kreklow\ryan-kreklow-1,2016-17,Missouri State,G,33,9,584,70,157,.446,28,55,.509,42,102,.412,27,31,.871,15,45,60,22,19,2,34,57,209,3.9
5276,Mitchell Wilbekin\mitchell-wilbekin-1,2014-15,Wake Forest,G,29,26,815,65,179,.363,16,52,.308,49,127,.386,30,41,.732,10,57,67,47,31,2,26,51,209,5.1
5277,Ray Penn\ray-penn-1,2013-14,Texas Southern,G,25,10,563,60,151,.397,17,51,.333,43,100,.430,46,50,.920,6,33,39,72,8,1,49,52,209,5.2
5278,Turner Botz\turner-botz-1,2015-16,Green Bay,G,36,4,691,63,178,.354,28,78,.359,35,100,.350,48,66,.727,29,86,115,32,21,4,23,65,209,4.0
5279,Tyler Sharpe\tyler-sharpe-1,2017-18,Northern Kentucky,G,31,0,459,64,151,.424,18,30,.600,46,121,.380,35,47,.745,6,29,35,19,26,3,16,44,209,4.7
5280,Cedric Hankerson\cedric-hankerson-1,2013-14,Boston University,G,35,0,512,61,148,.412,21,45,.467,40,103,.388,47,69,.681,21,50,71,12,27,2,15,57,209,4.3
5281,Cameron Corcoran\cameron-corcoran-1,2017-18,Little Rock,G,31,2,516,64,152,.421,18,44,.409,46,108,.426,35,45,.778,4,16,20,28,9,1,29,18,209,4.0
5282,Xavier Richards\xavier-richards-1,2014-15,Tennessee State,G,31,15,707,81,171,.474,81,170,.476,0,1,.000,47,89,.528,51,94,145,43,18,24,51,71,209,5.0
5283,T.J. Taylor\tj-taylor-2,2013-14,North Texas,G,30,2,569,76,170,.447,59,113,.522,17,57,.298,40,66,.606,28,59,87,38,19,6,46,48,209,4.4
5284,Dimi Cook\dimi-cook-1,2015-16,Southeastern Louisiana,G,28,7,537,59,135,.437,42,93,.452,17,42,.405,74,91,.813,6,34,40,34,22,1,36,76,209,4.5
5285,Jarod Williams\jarod-williams-1,2014-15,Detroit Mercy,G,33,21,673,74,168,.440,59,127,.465,15,41,.366,46,71,.648,32,59,91,63,40,8,63,62,209,4.6
5286,Aubrey Dawkins\aubrey-dawkins-1,2014-15,Michigan,G,30,13,620,75,157,.478,36,68,.529,39,89,.438,20,23,.870,22,41,63,11,10,7,19,49,209,4.7
5287,Joe'Randle Toliver\joerandle-toliver-1,2017-18,Arkansas-Pine Bluff,G,35,2,701,69,174,.397,8,13,.615,61,161,.379,10,17,.588,12,75,87,60,28,2,32,35,209,4.8
5288,Phil Hawkins\phil-hawkins-1,2013-14,Texas State,G,31,30,910,67,188,.356,40,105,.381,27,83,.325,48,63,.762,10,60,70,55,19,1,36,31,209,4.3
5289,Brandon Morris\brandon-morris-2,2013-14,Houston,G,33,23,664,68,155,.439,26,58,.448,42,97,.433,31,38,.816,18,52,70,41,21,6,23,57,209,4.9
5290,Devon Begley\devon-begley-1,2017-18,Northeastern,G,33,7,703,67,186,.360,37,86,.430,30,100,.300,45,65,.692,22,80,102,48,30,5,43,50,209,4.3
5291,Malcolm Porter\malcolm-porter-1,2017-18,Portland,G,30,7,592,76,178,.427,60,125,.480,16,53,.302,41,61,.672,5,48,53,59,16,0,45,37,209,4.1
5292,Alex Ramon\alex-ramon-1,2015-16,Colgate,G,30,7,688,71,155,.458,43,83,.518,28,72,.389,39,55,.709,27,62,89,44,18,6,46,69,209,4.6
5293,Miles Overton\miles-overton-1,2016-17,Drexel,G,22,6,524,62,218,.284,35,111,.315,27,107,.252,58,76,.763,9,36,45,35,19,3,47,46,209,3.2
5294,Jaylen Fisher\jaylen-fisher-1,2017-18,Texas Christian,G,17,14,465,74,147,.503,45,81,.556,29,66,.439,32,38,.842,6,20,26,91,19,1,34,36,209,10.5
5295,Raquan Mitchell\raquan-mitchell-1,2017-18,Colorado State,G,30,9,692,83,203,.409,73,150,.487,10,53,.189,33,45,.733,17,69,86,49,19,6,27,46,209,4.7
5296,Kavon Stewart\kavon-stewart-1,2014-15,Robert Morris,G,34,32,964,61,179,.341,48,133,.361,13,46,.283,74,118,.627,15,68,83,156,56,1,85,61,209,5.2
5297,Keith Frazier\keith-frazier-1,2017-18,Texas-El Paso,G,19,12,469,73,181,.403,33,62,.532,40,119,.336,23,31,.742,9,81,90,20,9,7,32,27,209,6.5
5298,Jake Ohmer\jake-ohmer-1,2017-18,Western Kentucky,G,37,2,609,68,184,.370,33,70,.471,35,114,.307,38,48,.792,12,28,40,34,23,0,20,51,209,3.4
5299,Ronnie Harrell\ronnie-harrell-1,2017-18,Creighton,G,30,14,761,72,155,.465,54,101,.535,18,54,.333,47,59,.797,35,153,188,79,17,8,39,46,209,7.2
5300,Armani Cotton\armani-cotton-1,2014-15,Yale,G,32,32,832,69,171,.404,31,67,.463,38,104,.365,32,48,.667,49,132,181,38,21,8,38,73,208,5.3
5301,Nick Hopkins\nick-hopkins-1,2017-18,Belmont,G,28,0,461,70,167,.419,14,26,.538,56,141,.397,12,16,.750,12,43,55,25,18,1,16,37,208,5.2
5302,Xavier Bishop\xavier-bishop-1,2016-17,Missouri-Kansas City,G,35,7,599,65,167,.389,44,97,.454,21,70,.300,57,77,.740,2,52,54,72,17,0,61,57,208,3.1
5303,D'Mitrik Trice\dmitrik-trice-1,2016-17,Wisconsin,G,37,2,674,70,184,.380,32,93,.344,38,91,.418,30,38,.789,7,62,69,63,20,3,37,51,208,3.7
5304,T.J. Williams\tj-williams-4,2013-14,Northeastern,G,30,19,712,62,162,.383,52,126,.413,10,36,.278,74,109,.679,14,56,70,59,17,2,43,49,208,4.3
5305,Ben Wilson\ben-wilson-2,2014-15,Idaho State,G,30,29,1040,74,179,.413,73,176,.415,1,3,.333,59,90,.656,20,82,102,107,34,3,61,69,208,5.4
5306,Tyler Williams\tyler-williams-3,2016-17,San Diego,G,31,26,1041,63,171,.368,33,90,.367,30,81,.370,52,64,.813,28,114,142,80,10,7,62,49,208,4.9
5307,Lafayette Rutledge\lafayette-rutledge-1,2016-17,Nicholls State,G,19,1,414,62,162,.383,5,11,.455,57,151,.377,27,33,.818,3,18,21,5,5,0,12,30,208,5.7
5308,Bryce Barnes\bryce-barnes-1,2017-18,Milwaukee,G,32,24,665,71,196,.362,51,126,.405,20,70,.286,46,68,.676,9,60,69,56,28,3,45,65,208,3.5
5309,Alani Moore\alani-moore-1,2016-17,Temple,G,32,21,824,65,157,.414,19,46,.413,46,111,.414,32,39,.821,27,49,76,56,25,2,32,42,208,5.4
5310,Brandon Sampson\brandon-sampson-1,2017-18,Louisiana State,G,27,9,510,70,147,.476,42,67,.627,28,80,.350,40,57,.702,18,52,70,22,21,2,27,44,208,5.5
5311,Rakiya Battle\rakiya-battle-1,2014-15,Alabama A&M,G,29,29,859,55,141,.390,49,113,.434,6,28,.214,92,127,.724,26,59,85,168,38,4,86,54,208,7.0
5312,Lucas Woodhouse\lucas-woodhouse-1,2015-16,Stony Brook,G,31,16,821,67,149,.450,19,42,.452,48,107,.449,26,30,.867,7,73,80,111,30,1,39,44,208,6.7
5313,Devon Williams\devon-williams-1,2014-15,New Mexico,G,31,30,701,75,164,.457,70,145,.483,5,19,.263,53,76,.697,48,56,104,20,17,20,46,63,208,4.5
5314,Grant Gibbs\grant-gibbs-1,2013-14,Creighton,G,29,28,758,74,133,.556,55,89,.618,19,44,.432,41,67,.612,27,69,96,112,16,11,54,87,208,6.4
5315,Gian Clavell\gian-clavell-1,2015-16,Colorado State,G,10,10,369,66,146,.452,39,82,.476,27,64,.422,49,65,.754,18,51,69,31,8,5,19,21,208,16.0
5316,Lindsey Drew\lindsey-drew-1,2016-17,Nevada,G,35,31,1121,74,162,.457,48,102,.471,26,60,.433,34,60,.567,40,132,172,164,42,30,64,94,208,7.4
5317,Robert Cartwright\robert-cartwright-1,2016-17,Stanford,G,31,12,765,74,209,.354,46,105,.438,28,104,.269,32,42,.762,5,51,56,110,30,1,48,50,208,4.7
5318,Emarius Logan\emarius-logan-1,2016-17,Appalachian State,G,29,27,738,61,184,.332,29,85,.341,32,99,.323,54,64,.844,11,35,46,72,18,3,57,53,208,3.8
5319,Joshua Filmore\joshua-filmore-1,2013-14,Southeastern Louisiana,G,30,18,794,73,189,.386,46,97,.474,27,92,.293,35,65,.538,5,63,68,86,17,2,39,53,208,4.5
5320,JeQuan Lewis\jequan-lewis-1,2013-14,Virginia Commonwealth,G,35,0,563,64,151,.424,40,84,.476,24,67,.358,56,71,.789,12,34,46,69,38,0,62,81,208,3.8
5321,Devonne Pinkard\devonne-pinkard-1,2016-17,Delaware,G,33,16,662,72,199,.362,34,68,.500,38,131,.290,26,37,.703,15,67,82,20,14,7,28,92,208,2.8
5322,Collin Stewart\collin-stewart-1,2016-17,Monmouth,G,33,8,511,66,172,.384,34,71,.479,32,101,.317,44,59,.746,20,41,61,15,17,15,28,50,208,3.8
5323,Darius Perkins\darius-perkins-1,2015-16,Utah State,G,31,29,761,73,176,.415,29,66,.439,44,110,.400,18,22,.818,3,65,68,56,16,2,39,45,208,4.3
5324,Matt Frierson\matt-frierson-1,2016-17,Citadel,G,33,2,561,68,190,.358,3,9,.333,65,181,.359,7,9,.778,7,33,40,48,23,0,16,34,208,4.3
5325,Chad Sherwood\chad-sherwood-1,2016-17,Idaho,G,33,24,800,61,176,.347,15,41,.366,46,135,.341,40,44,.909,12,54,66,44,13,8,42,84,208,3.2
5326,Marlon Beck\marlon-beck-1,2016-17,Binghamton,G,32,16,680,70,196,.357,26,49,.531,44,147,.299,24,37,.649,9,66,75,47,39,1,25,39,208,4.7
5327,Galen Robinson Jr.\galen-robinsonjr-1,2016-17,Houston,G,32,28,1031,77,210,.367,64,161,.398,13,49,.265,41,69,.594,12,93,105,155,31,4,62,55,208,5.5
5328,Nate Britt\nate-britt-1,2014-15,North Carolina,G,38,3,581,61,159,.384,35,88,.398,26,71,.366,60,68,.882,11,43,54,57,18,1,38,69,208,3.5
5329,Tavon Blackmon\tavon-blackmon-1,2013-14,Brown,G,28,27,825,80,201,.398,72,176,.409,8,25,.320,39,69,.565,2,38,40,98,19,2,72,57,207,3.3
5330,Perris Hicks\perris-hicks-1,2017-18,Fordham,G,29,13,713,65,166,.392,30,54,.556,35,112,.313,42,56,.750,8,28,36,29,36,0,27,63,207,4.5
5331,Dominique Williams\dominique-williams-2,2014-15,Florida International,G,30,11,708,81,186,.435,71,151,.470,10,35,.286,35,48,.729,34,100,134,18,22,3,36,57,207,4.5
5332,Nathan Hawkins\nathan-hawkins-2,2017-18,Texas-Arlington,G,33,31,944,80,219,.365,52,114,.456,28,105,.267,19,36,.528,14,73,87,69,39,3,58,91,207,3.2
5333,Mike Williams\mike-williams-9,2017-18,Rutgers,G,25,6,583,73,187,.390,57,113,.504,16,74,.216,45,58,.776,43,59,102,22,21,14,30,39,207,5.9
5334,Marcus Sheffield\marcus-sheffield-1,2016-17,Stanford,G,31,5,587,66,182,.363,43,111,.387,23,71,.324,52,64,.813,1,47,48,48,26,2,38,39,207,4.0
5335,Ray Bowles\ray-bowles-1,2014-15,Pacific,G,31,31,804,71,172,.413,54,119,.454,17,53,.321,48,74,.649,47,71,118,53,31,2,44,80,207,4.9
5336,J.C. Hampton\jc-hampton-1,2016-17,Texas A&M,G,31,22,776,60,153,.392,17,49,.347,43,104,.413,44,56,.786,4,57,61,56,17,0,35,62,207,4.4
5337,Isaiah Lamb\isaiah-lamb-1,2016-17,Marist,G,32,18,657,70,193,.363,46,98,.469,24,95,.253,43,64,.672,15,85,100,20,14,4,39,60,207,3.0
5338,Denzell Watts\denzell-watts-1,2016-17,Alabama-Birmingham,G,31,19,655,67,149,.450,20,43,.465,47,106,.443,26,33,.788,4,56,60,58,17,1,31,31,207,5.2
5339,Gino Littles\gino-littles-1,2017-18,Northern Arizona,G,30,30,927,70,208,.337,39,112,.348,31,96,.323,36,62,.581,13,75,88,76,26,1,57,49,207,3.8
5340,Khwan Fore\khwan-fore-1,2015-16,Richmond,G,32,3,651,81,156,.519,69,123,.561,12,33,.364,33,57,.579,26,72,98,46,38,2,31,73,207,5.4
5341,David Jean-Baptiste\david-jean-baptiste-1,2017-18,Chattanooga,G,33,17,891,75,198,.379,40,84,.476,35,114,.307,22,31,.710,23,47,70,63,26,3,39,48,207,4.2
5342,C.J. Siples\cj-siples-1,2015-16,Air Force,G,32,12,708,71,137,.518,51,95,.537,20,42,.476,45,69,.652,9,84,93,69,29,8,42,69,207,5.5
5343,Alec Wintering\alec-wintering-1,2013-14,Portland,G,27,27,750,52,151,.344,34,102,.333,18,49,.367,85,102,.833,7,54,61,122,42,0,55,74,207,6.6
5344,Ty Outlaw\ty-outlaw-1,2016-17,Virginia Tech,G,33,14,585,70,145,.483,13,29,.448,57,116,.491,10,13,.769,11,82,93,11,9,10,15,62,207,4.5
5345,Tucker Haymond\tucker-haymond-1,2013-14,Western Michigan,G,29,24,694,73,168,.435,54,108,.500,19,60,.317,42,62,.677,34,75,109,26,15,3,43,57,207,4.4
5346,Corban Wroe\corban-wroe-1,2013-14,Hartford,G,33,33,834,71,146,.486,42,79,.532,29,67,.433,36,45,.800,23,82,105,57,20,2,51,86,207,4.4
5347,Hayward Register\hayward-register-1,2014-15,Louisiana,G,31,14,427,68,181,.376,6,25,.240,62,156,.397,9,15,.600,9,40,49,11,6,6,10,40,207,3.7
5348,Elijah Stewart\elijah-stewart-1,2014-15,Southern California,G,32,18,705,74,198,.374,37,91,.407,37,107,.346,21,31,.677,17,60,77,22,31,37,36,82,206,4.0
5349,Charles Jackson\charles-jackson-4,2015-16,Arkansas-Pine Bluff,G,33,5,586,71,168,.423,36,64,.563,35,104,.337,29,43,.674,20,38,58,32,22,5,56,85,206,2.9
5350,London Perrantes\london-perrantes-1,2014-15,Virginia,G,32,32,1065,67,189,.354,37,94,.394,30,95,.316,42,54,.778,7,77,84,148,25,7,49,42,206,6.0
5351,Xavian Stapleton\xavian-stapleton-1,2017-18,Mississippi State,G,32,7,630,76,196,.388,44,101,.436,32,95,.337,22,29,.759,20,62,82,16,21,12,29,80,206,3.4
5352,Jabari Sandifer\jabari-sandifer-1,2014-15,Western Illinois,G,28,25,822,72,201,.358,51,131,.389,21,70,.300,41,68,.603,7,77,84,119,25,6,61,72,206,4.8
5353,Darius Thompson\darius-thompson-2,2017-18,Tennessee-Martin,G,31,19,739,64,167,.383,40,90,.444,24,77,.312,54,64,.844,6,58,64,45,30,15,40,68,206,4.4
5354,James Blackmon\james-blackmon-1,2015-16,Indiana,G,13,12,319,73,152,.480,36,72,.500,37,80,.463,23,27,.852,17,37,54,22,16,5,25,19,206,11.7
5355,JoJo Cooper\jojo-cooper-1,2014-15,Wagner,G,30,24,856,62,172,.360,45,109,.413,17,63,.270,65,100,.650,22,78,100,121,33,1,82,72,206,4.8
5356,E. Victor Nickerson\e-victor-nickerson-1,2014-15,Valparaiso,G,33,17,629,70,170,.412,57,127,.449,13,43,.302,53,75,.707,18,53,71,64,23,5,68,60,206,3.5
5357,Marcel Smith\marcel-smith-1,2014-15,Houston Baptist,G,28,11,617,71,167,.425,35,76,.461,36,91,.396,28,34,.824,12,25,37,52,18,0,18,39,206,5.4
5358,Darrell Bowie\darrell-bowie-1,2014-15,Northern Illinois,G,21,17,494,67,161,.416,58,126,.460,9,35,.257,63,93,.677,40,73,113,25,28,11,62,46,206,6.2
5359,Dulani Robinson\dulani-robinson-1,2016-17,Texas Southern,G,33,20,767,64,192,.333,25,77,.325,39,115,.339,39,47,.830,12,63,75,82,40,0,46,53,206,4.6
5360,De'Sean Parsons\desean-parsons-1,2015-16,Portland State,G,30,6,514,76,150,.507,72,124,.581,4,26,.154,50,81,.617,22,62,84,36,21,9,28,50,206,5.3
5361,Justin Graham\justin-graham-2,2014-15,Hartford,G,30,4,735,65,155,.419,40,82,.488,25,73,.342,51,70,.729,8,58,66,49,25,1,38,46,206,4.8
5362,De'Andre Davis\deandre-davis-1,2015-16,Grand Canyon,G,33,1,543,67,145,.462,64,125,.512,3,20,.150,69,102,.676,26,39,65,63,24,5,49,54,206,4.5
5363,Andrew Kostecka\andrew-kostecka-1,2016-17,Loyola (MD),G,29,17,625,71,151,.470,39,68,.574,32,83,.386,32,41,.780,21,56,77,33,27,12,31,60,206,5.5
5364,Malik Nichols\malik-nichols-1,2014-15,Hofstra,G,34,22,578,83,162,.512,81,148,.547,2,14,.143,38,82,.463,70,95,165,41,27,4,50,97,206,4.6
5365,Rene Castro\rene-castro-1,2016-17,Duquesne,G,29,1,553,70,168,.417,43,90,.478,27,78,.346,39,56,.696,8,35,43,62,13,0,34,34,206,4.6
5366,Marquel Curtis\marquel-curtis-1,2015-16,Tulsa,G,31,5,763,72,167,.431,57,115,.496,15,52,.288,47,70,.671,45,86,131,67,25,6,43,55,206,5.7
5367,Quinton Everett\quinton-everett-1,2015-16,Montana State,G,29,17,647,71,184,.386,53,127,.417,18,57,.316,46,81,.568,52,100,152,38,28,14,29,72,206,5.7
5368,JaQuail Townser\jaquail-townser-1,2014-15,Jacksonville State,G,26,25,737,72,200,.360,51,130,.392,21,70,.300,41,55,.745,10,56,66,87,33,5,64,69,206,4.6
5369,D'Andre Johnson\dandre-johnson-1,2013-14,Florida Atlantic,G,32,7,737,65,176,.369,37,85,.435,28,91,.308,48,63,.762,9,55,64,67,19,0,57,66,206,3.4
5370,Gentrey Thomas\gentrey-thomas-1,2015-16,UC-Riverside,G,29,8,646,81,182,.445,63,112,.563,18,70,.257,26,38,.684,31,81,112,45,17,3,49,52,206,4.6
5371,Dorrian Williams\dorrian-williams-1,2014-15,Missouri State,G,29,29,918,78,209,.373,63,153,.412,15,56,.268,34,47,.723,15,106,121,128,44,0,80,64,205,5.3
5372,Shaun Lawton\shaun-lawton-1,2015-16,Maine,G,24,8,594,67,158,.424,47,109,.431,20,49,.408,51,70,.729,18,74,92,51,45,3,52,70,205,6.3
5373,Dexter Kernich-Drew\dexter-kernich-drew-1,2014-15,Washington State,G,31,12,587,69,165,.418,27,68,.397,42,97,.433,25,32,.781,14,35,49,18,4,5,29,55,205,3.3
5374,David Humphries\david-humphries-1,2014-15,Loyola Marymount,G,31,18,796,70,178,.393,38,92,.413,32,86,.372,33,49,.673,33,95,128,57,26,5,47,56,205,5.0
5375,Paul Jesperson\paul-jesperson-1,2014-15,Northern Iowa,G,35,0,637,69,143,.483,21,31,.677,48,112,.429,19,22,.864,11,69,80,11,11,2,14,46,205,4.2
5376,Alex Barlow\alex-barlow-1,2013-14,Butler,G,31,31,1021,70,190,.368,32,89,.360,38,101,.376,27,35,.771,21,95,116,110,61,8,36,101,205,6.7
5377,Stanford Robinson\stanford-robinson-1,2013-14,Indiana,G,32,9,540,74,165,.448,71,149,.477,3,16,.188,54,90,.600,19,60,79,32,18,3,47,50,205,3.5
5378,Rayvon Harris\rayvon-harris-1,2013-14,Niagara,G,33,3,606,67,122,.549,62,110,.564,5,12,.417,66,103,.641,51,87,138,19,22,5,54,88,205,4.3
5379,Joey McLean\joey-mclean-1,2017-18,James Madison,G,25,17,624,73,192,.380,52,117,.444,21,75,.280,38,46,.826,8,33,41,52,23,4,38,62,205,4.5
5380,James Currington\james-currington-1,2017-18,Southeastern Louisiana,G,27,23,550,87,166,.524,87,161,.540,0,5,.000,31,63,.492,68,72,140,12,34,16,28,61,205,6.7
5381,Trevis Wyche\trevis-wyche-1,2014-15,Saint Peter's,G,34,30,927,61,159,.384,43,100,.430,18,59,.305,65,94,.691,19,82,101,114,41,0,56,79,205,5.2
5382,Jordan Cornish\jordan-cornish-1,2015-16,Nevada-Las Vegas,G,33,7,714,68,193,.352,37,90,.411,31,103,.301,38,64,.594,9,74,83,50,16,1,47,58,205,2.9
5383,Diogo Brito\diogo-brito-1,2017-18,Utah State,G,34,22,836,76,165,.461,55,95,.579,21,70,.300,32,53,.604,21,97,118,68,27,2,53,53,205,4.6
5384,Caleb Crayton\caleb-crayton-1,2013-14,Houston Baptist,G,29,28,631,66,170,.388,49,110,.445,17,60,.283,56,72,.778,37,81,118,29,12,5,53,79,205,3.7
5385,Turner Botz\turner-botz-1,2016-17,Green Bay,G,32,28,803,63,171,.368,13,37,.351,50,134,.373,29,37,.784,17,109,126,30,16,4,22,61,205,4.5
5386,Kyron Cartwright\kyron-cartwright-1,2015-16,Providence,G,35,10,847,73,201,.363,53,146,.363,20,55,.364,39,58,.672,11,67,78,139,32,2,49,72,205,4.8
5387,Dylan Chatman\dylan-chatman-1,2014-15,Eastern Illinois,G,33,31,927,65,172,.378,8,26,.308,57,146,.390,18,28,.643,8,95,103,58,30,4,39,57,205,4.6
5388,Jaren Sina\jaren-sina-1,2013-14,Seton Hall,G,34,19,884,58,155,.374,19,53,.358,39,102,.382,50,65,.769,8,39,47,81,12,0,50,53,205,3.8
5389,Justin McFadden\justin-mcfadden-1,2014-15,Binghamton,G,30,23,812,54,140,.386,40,94,.426,14,46,.304,83,112,.741,31,76,107,49,26,15,49,96,205,4.8
5390,Julian Daughtry\julian-daughtry-1,2017-18,Jackson State,G,32,19,807,65,176,.369,34,92,.370,31,84,.369,44,62,.710,26,42,68,39,30,4,32,65,205,4.2
5391,James Ford\james-ford-1,2015-16,Quinnipiac,G,30,30,838,66,206,.320,32,101,.317,34,105,.324,39,69,.565,39,77,116,48,20,2,48,73,205,3.4
5392,Josh Fortune\josh-fortune-1,2016-17,Colorado,G,34,17,691,63,178,.354,32,76,.421,31,102,.304,48,56,.857,23,80,103,51,13,10,44,55,205,3.9
5393,E.J. Stephens\ej-stephens-1,2017-18,Lafayette,G,30,3,634,81,157,.516,58,95,.611,23,62,.371,20,33,.606,10,58,68,23,8,9,18,32,205,4.9
5394,Malik Thomas\malik-thomas-1,2013-14,Boston University,G,35,3,671,77,182,.423,65,139,.468,12,43,.279,38,56,.679,41,100,141,41,18,14,56,62,204,3.8
5395,Chauncey Hawkins\chauncey-hawkins-1,2017-18,St. Francis (NY),G,31,2,602,63,180,.350,42,105,.400,21,75,.280,57,77,.740,10,34,44,46,23,5,47,65,204,3.2
5396,Jamel Fuentes\jamel-fuentes-1,2013-14,Norfolk State,G,34,24,873,61,155,.394,60,145,.414,1,10,.100,81,126,.643,31,70,101,163,38,2,64,66,204,6.1
5397,Biggie Minnis\deshon-minnis-1,2015-16,Wright State,G,29,4,660,86,174,.494,80,152,.526,6,22,.273,26,57,.456,19,66,85,94,26,6,49,77,204,5.3
5398,Demetrius Pollard\demetrius-pollard-1,2015-16,Charleston Southern,G,22,13,581,69,184,.375,33,66,.500,36,118,.305,30,47,.638,5,47,52,43,7,2,39,43,204,4.4
5399,Jared Johnson\jared-johnson-2,2015-16,Stephen F. Austin,G,34,1,391,71,180,.394,23,55,.418,48,125,.384,14,23,.609,8,22,30,39,12,1,30,55,204,3.0
5400,Bobby Hunter\bobby-hunter-1,2014-15,Illinois State,G,30,2,585,70,159,.440,34,71,.479,36,88,.409,28,40,.700,17,42,59,42,19,0,31,46,204,4.6
5401,Derrick Walton\derrick-walton-1,2014-15,Michigan,G,19,19,633,55,159,.346,26,78,.333,29,81,.358,65,78,.833,8,81,89,57,23,1,35,33,204,8.1
5402,Lonnie Jackson\lonnie-jackson-2,2013-14,Boston College,G,29,12,684,66,169,.391,13,29,.448,53,140,.379,19,28,.679,15,50,65,51,20,4,33,47,204,4.9
5403,Taylor Dyson\taylor-dyson-1,2015-16,Hartford,G,28,19,540,67,178,.376,21,58,.362,46,120,.383,24,29,.828,11,52,63,17,14,2,28,45,204,3.9
5404,Darius Thompson\darius-thompson-1,2016-17,Virginia,G,33,14,686,76,171,.444,50,97,.515,26,74,.351,26,43,.605,6,48,54,73,28,12,33,33,204,5.1
5405,Namon Wright\namon-wright-1,2014-15,Missouri,G,30,20,607,77,186,.414,37,83,.446,40,103,.388,10,18,.556,6,63,69,19,17,3,37,64,204,3.1
5406,Nate Pierre-Louis\nate-pierre-louis-1,2017-18,Temple,G,27,1,457,75,163,.460,56,106,.528,19,57,.333,34,59,.576,30,51,81,15,25,8,20,33,203,5.7
5407,Justin Edwards\justin-edwards-2,2014-15,Kansas State,G,32,14,675,75,193,.389,54,122,.443,21,71,.296,32,56,.571,36,69,105,54,37,11,34,75,203,4.8
5408,Willie Moore\willie-moore-2,2013-14,Miami (OH),G,22,7,569,67,169,.396,48,104,.462,19,65,.292,50,63,.794,19,55,74,37,34,4,57,74,203,5.1
5409,Gerard Coleman\gerard-coleman-1,2013-14,Gonzaga,G,34,0,386,83,168,.494,82,160,.513,1,8,.125,36,62,.581,27,29,56,28,18,5,38,33,203,3.7
5410,London Perrantes\london-perrantes-1,2013-14,Virginia,G,37,33,1105,61,159,.384,23,72,.319,38,87,.437,43,50,.860,8,73,81,140,33,4,40,62,203,5.7
5411,Chuks Iroegbu\chuks-iroegbu-1,2015-16,Northern Illinois,G,34,12,561,70,109,.642,68,100,.680,2,9,.222,61,99,.616,32,50,82,23,19,15,25,66,203,5.0
5412,Matt Mobley\matt-mobley-1,2013-14,Central Connecticut State,G,30,21,732,68,184,.370,38,81,.469,30,103,.291,37,42,.881,8,56,64,50,25,1,46,57,203,3.8
5413,Gary Franklin\gary-franklin-1,2013-14,Baylor,G,38,21,830,65,182,.357,22,51,.431,43,131,.328,30,40,.750,9,50,59,91,20,0,52,51,203,3.4
5414,Keyshawn Evans\keyshawn-evans-1,2016-17,Illinois State,G,35,4,672,70,176,.398,17,37,.459,53,139,.381,10,20,.500,8,43,51,70,24,1,42,48,203,3.9
5415,Jeremy Johnson\jeremy-johnson-3,2016-17,Milwaukee,G,34,18,669,68,175,.389,45,103,.437,23,72,.319,44,52,.846,17,64,81,36,8,4,33,66,203,3.3
5416,Gary Williams Jr.\gary-williamsjr-1,2015-16,San Jose State,G,30,4,454,62,177,.350,48,116,.414,14,61,.230,65,77,.844,16,54,70,40,14,3,41,51,203,3.6
5417,Patrick Good\patrick-good-1,2016-17,Appalachian State,G,29,0,655,65,155,.419,10,22,.455,55,133,.414,18,23,.783,17,51,68,45,18,1,23,53,203,5.2
5418,Elijah Brown\elijah-brown-1,2013-14,Butler,G,30,1,558,66,196,.337,36,88,.409,30,108,.278,41,48,.854,3,63,66,36,12,3,38,45,203,3.1
5419,Steve Rogers\steve-rogers-1,2015-16,Alabama State,G,31,17,749,65,208,.313,35,96,.365,30,112,.268,43,57,.754,18,36,54,33,19,5,28,65,203,3.0
5420,Malik Muller\malik-muller-1,2014-15,Virginia Tech,G,33,20,661,72,184,.391,31,77,.403,41,107,.383,18,32,.563,7,74,81,47,29,3,44,56,203,3.7
5421,Edon Maxhuni\edon-maxhuni-1,2017-18,Cal State Long Beach,G,33,15,570,69,179,.385,35,91,.385,34,88,.386,31,33,.939,10,45,55,33,12,0,55,46,203,2.6
5422,Myles Smith\myles-smith-1,2017-18,Texas A&M-Corpus Christi,G,26,17,636,67,149,.450,47,93,.505,20,56,.357,49,61,.803,14,53,67,50,19,1,52,71,203,4.6
5423,Darius Graham\darius-graham-1,2013-14,UC-Davis,G,31,18,791,65,161,.404,49,110,.445,16,51,.314,57,81,.704,10,59,69,93,13,0,65,62,203,3.9
5424,D.J. McCall\dj-mccall-1,2017-18,IUPUI,G,29,26,799,70,173,.405,60,133,.451,10,40,.250,53,74,.716,48,73,121,57,43,11,41,67,203,6.2
5425,Daquan Brickhouse\daquan-brickhouse-1,2013-14,Coppin State,G,30,5,588,58,168,.345,40,115,.348,18,53,.340,69,84,.821,21,46,67,73,27,1,30,28,203,5.6
5426,Deion Lavender\deion-lavender-1,2016-17,Alabama-Birmingham,G,33,14,773,73,184,.397,66,144,.458,7,40,.175,50,69,.725,8,83,91,113,25,2,65,52,203,4.4
5427,Jelan Kendrick\jelan-kendrick-1,2013-14,Nevada-Las Vegas,G,32,8,667,77,180,.428,59,126,.468,18,54,.333,31,57,.544,11,66,77,46,20,6,46,53,203,3.6
5428,Tyrik Dixon\tyrik-dixon-1,2016-17,Middle Tennessee,G,36,32,905,73,177,.412,48,114,.421,25,63,.397,32,49,.653,11,94,105,119,45,4,46,71,203,5.4
5429,Jordan Barnes\jordan-barnes-1,2016-17,Indiana State,G,31,2,648,62,174,.356,21,53,.396,41,121,.339,38,42,.905,11,71,82,65,17,1,34,55,203,4.5
5430,Kyle Williams\kyle-williams-4,2016-17,Norfolk State,G,33,7,614,68,188,.362,26,70,.371,42,118,.356,25,34,.735,18,67,85,27,17,4,36,42,203,3.4
5431,Tahjere McCall\tahjere-mccall-1,2013-14,Niagara,G,27,14,612,71,172,.413,69,148,.466,2,24,.083,58,79,.734,33,48,81,53,34,7,59,80,202,4.6
5432,Chris Jones\chris-jones-5,2015-16,Pittsburgh,G,33,9,628,71,167,.425,50,94,.532,21,73,.288,39,56,.696,29,41,70,48,14,11,28,66,202,4.2
5433,Bryan Smith\bryan-smith-1,2014-15,Fordham,G,31,19,734,73,188,.388,52,102,.510,21,86,.244,35,43,.814,30,66,96,64,30,11,41,77,202,4.8
5434,Nick Victor\nick-victor-1,2015-16,Yale,G,30,30,851,72,152,.474,40,78,.513,32,74,.432,26,49,.531,47,170,217,73,22,39,58,91,202,6.8
5435,Richaud Pack\richaud-pack-1,2014-15,Maryland,G,35,27,899,64,163,.393,36,77,.468,28,86,.326,46,66,.697,24,91,115,42,18,8,33,46,202,4.3
5436,Ismail Ali\ismail-ali-1,2016-17,Bowling Green State,G,30,20,711,73,182,.401,67,159,.421,6,23,.261,50,78,.641,11,51,62,117,39,9,65,78,202,4.9
5437,Frankie Johnson\frankie-johnson-1,2017-18,Citadel,G,32,31,864,67,171,.392,44,99,.444,23,72,.319,45,66,.682,31,73,104,138,57,3,73,74,202,6.2
5438,Davell Roby\davell-roby-1,2014-15,Saint Louis,G,31,30,768,62,168,.369,37,91,.407,25,77,.325,53,85,.624,16,71,87,55,29,1,51,70,202,3.8
5439,Daniel Fowler\daniel-fowler-1,2015-16,Furman,G,32,26,805,68,159,.428,35,72,.486,33,87,.379,33,51,.647,39,83,122,55,35,7,56,78,202,4.8
5440,Keith Smith\keith-smith-46,2017-18,Virginia Military Institute,G,29,29,775,72,187,.385,41,110,.373,31,77,.403,27,43,.628,6,65,71,91,40,5,69,49,202,4.7
5441,Aaron Hines\aaron-hines-1,2017-18,Saint Louis,G,33,1,747,69,216,.319,37,110,.336,32,106,.302,32,50,.640,3,49,52,53,26,1,47,63,202,2.4
5442,Dillon Avare\dillon-avare-1,2016-17,Eastern Kentucky,G,31,10,811,65,188,.346,3,10,.300,62,178,.348,10,13,.769,12,40,52,40,17,0,22,62,202,3.7
5443,Daylen Harrison\daylen-harrison-1,2013-14,Eastern Michigan,G,37,27,855,74,175,.423,61,132,.462,13,43,.302,41,51,.804,41,104,145,37,44,22,33,72,202,5.1
5444,Sam Logwood\sam-logwood-1,2015-16,New Mexico,G,32,32,836,75,171,.439,58,128,.453,17,43,.395,35,60,.583,37,93,130,58,24,14,49,78,202,4.7
5445,Jerron Granberry\jerron-granberry-1,2013-14,Wyoming,G,33,7,831,64,147,.435,35,72,.486,29,75,.387,45,53,.849,13,56,69,39,22,16,36,68,202,4.4
5446,Perrion Callandret\perrion-callandret-1,2014-15,Idaho,G,30,2,639,67,152,.441,29,65,.446,38,87,.437,30,42,.714,5,69,74,49,17,6,32,59,202,4.7
5447,Kevin Zabo\kevin-zabo-1,2016-17,Kent State,G,36,9,650,69,190,.363,40,97,.412,29,93,.312,35,47,.745,9,40,49,58,23,1,44,85,202,2.7
5448,John Brown\john-brown-4,2014-15,South Alabama,G,32,13,644,72,167,.431,53,105,.505,19,62,.306,39,56,.696,21,46,67,30,21,18,44,53,202,3.9
5449,Ryan Woolridge\ryan-woolridge-1,2016-17,North Texas,G,21,12,598,75,149,.503,65,121,.537,10,28,.357,42,73,.575,27,75,102,67,41,3,65,36,202,8.0
5450,James Fives\james-fives-1,2016-17,Loyola (MD),G,33,29,762,55,155,.355,30,83,.361,25,72,.347,67,91,.736,39,46,85,21,24,2,50,75,202,3.2
5451,Jordan Green\jordan-green-1,2014-15,Texas A&M,G,33,33,803,71,143,.497,55,101,.545,16,42,.381,43,55,.782,12,49,61,61,15,4,35,68,201,4.4
5452,Corey Johnson\corey-johnson-4,2017-18,Harvard,G,31,26,887,67,185,.362,14,25,.560,53,160,.331,14,16,.875,7,82,89,39,16,4,21,67,201,4.0
5453,Keith Washington\keith-washington-1,2013-14,Rice,G,26,9,600,71,186,.382,50,119,.420,21,67,.313,38,59,.644,7,56,63,67,13,1,70,45,201,3.3
5454,Kyle Foreman\kyle-foreman-1,2016-17,Boston University,G,30,27,783,67,184,.364,52,127,.409,15,57,.263,52,66,.788,15,57,72,136,57,3,81,56,201,5.7
5455,Aksel Bolin\askel-bolin-1,2013-14,Northern Illinois,G,31,25,800,63,155,.406,40,87,.460,23,68,.338,52,75,.693,37,101,138,33,20,5,51,78,201,4.2
5456,Keaton Hervey\keaton-hervey-1,2017-18,Incarnate Word,G,25,17,587,60,160,.375,49,121,.405,11,39,.282,70,90,.778,19,39,58,29,11,6,40,46,201,4.3
5457,Brandon Cyrus\brandon-cyrus-1,2016-17,DePaul,G,32,32,840,72,190,.379,62,151,.411,10,39,.256,47,67,.701,52,81,133,29,28,7,46,76,201,3.9
5458,Phil Gaetano\phil-gaetano-1,2013-14,Sacred Heart,G,31,31,1048,61,176,.347,18,49,.367,43,127,.339,36,41,.878,6,76,82,194,30,2,87,61,201,5.9
5459,Ishmail Wainright\ish-wainright-1,2015-16,Baylor,G,34,34,841,73,171,.427,45,102,.441,28,69,.406,27,37,.730,58,88,146,90,34,19,45,100,201,5.8
5460,Leondre Washington\leondre-washington-1,2017-18,Robert Morris,G,24,1,569,56,168,.333,32,89,.360,24,79,.304,65,87,.747,11,38,49,51,22,0,46,45,201,4.6
5461,Blake Francis\blake-francis-1,2016-17,Wagner,G,28,3,575,64,151,.424,21,49,.429,43,102,.422,30,40,.750,20,18,38,31,18,0,21,66,201,4.6
5462,Lindsey Drew\lindsey-drew-1,2015-16,Nevada,G,37,35,1067,65,181,.359,43,105,.410,22,76,.289,49,71,.690,32,135,167,103,56,31,66,107,201,5.3
5463,Davion Mintz\davion-mintz-1,2017-18,Creighton,G,33,32,696,61,151,.404,42,97,.433,19,54,.352,60,82,.732,8,96,104,102,14,3,36,44,201,5.4
5464,Bryant Rucker\bryant-rucker-1,2013-14,Denver,G,30,13,658,69,139,.496,38,70,.543,31,69,.449,32,43,.744,6,52,58,36,20,1,24,60,201,4.8
5465,Marco Banegas-Flores\marco-banegas-flores-2,2014-15,Massachusetts-Lowell,G,27,25,747,62,164,.378,31,82,.378,31,82,.378,46,58,.793,9,59,68,52,50,1,55,51,201,5.3
5466,Keith Carter\keith-carter-2,2014-15,Valparaiso,G,24,17,662,74,161,.460,42,75,.560,32,86,.372,21,31,.677,12,72,84,89,30,6,43,48,201,7.4
5467,Abdoulaye Harouna\abdoulaye-harouna-1,2016-17,Miami (OH),G,30,27,758,59,173,.341,30,81,.370,29,92,.315,54,76,.711,15,58,73,31,38,6,44,93,201,3.5
5468,Dylan Chatman\dylan-chatman-1,2013-14,Eastern Illinois,G,30,19,723,66,167,.395,30,64,.469,36,103,.350,33,48,.688,8,59,67,56,36,1,38,63,201,4.7
5469,Larry McKnight\larry-mcknight-1,2017-18,North Carolina Central,G,34,0,561,70,189,.370,46,112,.411,24,77,.312,37,53,.698,34,45,79,11,22,5,32,63,201,3.0
5470,Mareik Isom\mareik-isom-1,2015-16,Little Rock,G,34,9,646,65,160,.406,23,54,.426,42,106,.396,29,37,.784,23,68,91,15,11,16,14,94,201,3.8
5471,Justin Childs\justin-childs-1,2013-14,Tennessee-Martin,G,31,16,663,76,177,.429,68,142,.479,8,35,.229,41,61,.672,31,72,103,30,43,5,38,63,201,4.7
5472,Jack Lopez\jack-lopez-1,2015-16,Montana,G,33,14,776,72,132,.545,30,41,.732,42,91,.462,15,20,.750,17,68,85,41,18,9,37,84,201,4.5
5473,Terrance LeFlore\terrance-leflore-1,2015-16,Alabama State,G,31,8,597,65,194,.335,36,117,.308,29,77,.377,42,58,.724,12,44,56,57,19,3,45,61,201,3.2
5474,Alex Mitola\alex-mitola-1,2015-16,George Washington,G,38,1,592,57,168,.339,19,61,.311,38,107,.355,48,56,.857,17,38,55,67,21,0,29,54,200,3.8
5475,Mike Felt\mike-felt-1,2013-14,North Dakota State,G,33,1,484,61,148,.412,17,36,.472,44,112,.393,34,40,.850,5,32,37,15,14,0,18,36,200,3.7
5476,Jordan Roper\jordan-roper-1,2014-15,Clemson,G,31,10,591,68,200,.340,40,108,.370,28,92,.304,36,44,.818,10,35,45,47,17,3,39,27,200,3.3
5477,Aaron Parks\aaron-parks-1,2015-16,Cal State Northridge,G,15,14,467,64,159,.403,62,151,.411,2,8,.250,70,87,.805,18,45,63,28,23,0,31,45,200,8.5
5478,Dmitri Thompson\dmitri-thompson-1,2014-15,Elon,G,33,0,619,84,179,.469,79,156,.506,5,23,.217,27,55,.491,27,95,122,14,23,1,32,48,200,3.8
5479,Justin Robinson\justin-robinson-2,2013-14,Monmouth,G,28,25,628,70,185,.378,41,103,.398,29,82,.354,31,41,.756,8,57,65,83,27,1,55,37,200,4.8
5480,Clay Wilson\clay-wilson-1,2014-15,Princeton,G,30,3,599,66,146,.452,24,40,.600,42,106,.396,26,35,.743,5,31,36,23,13,0,14,46,200,4.3
5481,Sam Burmeister\sam-burmeister-1,2017-18,Incarnate Word,G,26,8,610,70,159,.440,44,89,.494,26,70,.371,34,51,.667,3,70,73,26,18,3,37,58,200,4.3
5482,Tyree Crump\tyree-crump-1,2017-18,Georgia,G,31,2,460,61,175,.349,17,42,.405,44,133,.331,34,45,.756,0,37,37,39,12,2,37,24,200,3.3
5483,Demarius Smith\demarius-smith-1,2013-14,Austin Peay,G,25,20,738,69,138,.500,57,101,.564,12,37,.324,50,84,.595,22,60,82,139,32,6,96,61,200,6.6
5484,Troy Joseph\troy-joseph-1,2013-14,Long Island University,G,29,23,771,65,182,.357,32,71,.451,33,111,.297,37,46,.804,39,89,128,16,18,14,35,65,200,4.4
5485,Jordan Baker\jordan-baker-3,2016-17,Old Dominion,G,30,30,937,63,172,.366,10,22,.455,53,150,.353,21,25,.840,14,60,74,73,37,2,41,69,200,5.1
5486,Malcolm Canada\malcolm-canada-1,2014-15,Auburn,G,35,3,777,61,166,.367,52,120,.433,9,46,.196,69,100,.690,14,78,92,69,38,14,45,100,200,4.0
5487,Josh Newkirk\josh-newkirk-1,2014-15,Pittsburgh,G,34,4,704,75,199,.377,53,126,.421,22,73,.301,28,42,.667,8,37,45,93,17,0,49,72,200,3.1
5488,Blake Simmons\blake-simmons-1,2015-16,Evansville,G,34,34,951,71,168,.423,42,78,.538,29,90,.322,29,37,.784,5,62,67,100,19,9,45,63,200,4.6
5489,Andre Yates\andre-yates-1,2014-15,Cleveland State,G,33,22,729,75,176,.426,49,93,.527,26,83,.313,24,38,.632,21,35,56,28,48,3,32,84,200,4.0
5490,Terrance LeFlore\terrance-leflore-1,2016-17,Alabama State,G,31,10,711,75,204,.368,60,134,.448,15,70,.214,35,63,.556,21,47,68,81,31,7,75,70,200,3.0
5491,Ryan Jones\ryan-jones-4,2015-16,Massachusetts-Lowell,G,29,27,584,66,173,.382,37,84,.440,29,89,.326,39,55,.709,11,32,43,28,17,2,41,45,200,3.3
5492,Jordan Fouse\jordan-fouse-1,2013-14,Green Bay,G,31,31,978,75,155,.484,75,152,.493,0,3,.000,50,92,.543,82,150,232,90,68,48,59,84,200,9.0
5493,Matt Bohannon\matt-bohannon-1,2014-15,Northern Iowa,G,35,35,911,63,155,.406,9,17,.529,54,138,.391,20,26,.769,0,60,60,30,20,1,15,54,200,3.9
5494,Rakym Felder\rakym-felder-1,2016-17,South Carolina,G,36,1,538,61,150,.407,27,70,.386,34,80,.425,44,67,.657,7,46,53,47,21,4,49,51,200,3.2
5495,Ray Ona Embo\rayona-embo-1,2016-17,Tulane,G,31,25,779,66,180,.367,53,128,.414,13,52,.250,54,70,.771,14,58,72,69,22,4,43,67,199,4.0
5496,Casey Teson\casey-teson-1,2016-17,Eastern Illinois,G,29,3,603,64,153,.418,23,48,.479,41,105,.390,30,31,.968,1,45,46,27,16,1,18,42,199,4.6
5497,Jeff Stubbs\jeff-stubbs-1,2013-14,Jackson State,G,28,8,657,58,141,.411,57,121,.471,1,20,.050,82,92,.891,8,40,48,46,28,1,63,81,199,3.7
5498,Jordon Harris\jordon-harris-1,2016-17,Louisiana-Monroe,G,23,10,545,71,176,.403,26,64,.406,45,112,.402,12,16,.750,7,39,46,40,21,1,42,35,199,4.9
5499,Austin Hamilton\austin-hamilton-1,2013-14,Elon,G,32,21,586,74,147,.503,60,99,.606,14,48,.292,37,58,.638,12,47,59,80,22,1,39,48,199,5.0
5500,Steve Frankoski\steve-frankoski-1,2014-15,Columbia,G,26,4,573,70,168,.417,24,57,.421,46,111,.414,13,14,.929,4,43,47,16,8,5,19,37,199,4.4
5501,Todd Johnson\todd-johnson-1,2013-14,Northern Kentucky,G,23,23,687,59,140,.421,19,47,.404,40,93,.430,41,53,.774,18,70,88,46,29,3,36,59,199,6.8
5502,Ben Wilson\ben-wilson-2,2015-16,Idaho State,G,29,26,921,78,156,.500,78,156,.500,0,0,,43,68,.632,34,140,174,64,19,6,42,60,199,6.2
5503,Jeff Lowery\jeff-lowery-1,2016-17,Central Arkansas,G,32,7,728,71,164,.433,57,129,.442,14,35,.400,43,62,.694,4,37,41,93,32,1,56,64,199,4.2
5504,Ivory Young\ivory-young-1,2016-17,Utah Valley,G,32,8,551,58,153,.379,23,51,.451,35,102,.343,48,62,.774,5,52,57,59,14,0,44,36,199,3.9
5505,Cullen Hamilton\cullen-hamilton-1,2014-15,Holy Cross,G,30,14,611,73,186,.392,47,109,.431,26,77,.338,27,33,.818,27,44,71,26,15,0,26,27,199,4.1
5506,Daniel Harris\daniel-harris-1,2016-17,Quinnipiac,G,31,22,716,71,200,.355,30,73,.411,41,127,.323,16,20,.800,35,87,122,46,35,4,24,72,199,5.0
5507,Matt Mooney\matt-mooney-1,2014-15,Air Force,G,29,8,558,74,165,.448,45,90,.500,29,75,.387,22,28,.786,13,43,56,52,24,4,32,31,199,5.2
5508,Avery Johnson\avery-johnson-2,2014-15,UC-Davis,G,32,32,891,60,138,.435,28,60,.467,32,78,.410,47,57,.825,13,80,93,58,39,8,44,58,199,5.4
5509,Sheldon Hagigal\sheldon-hagigal-1,2013-14,St. Francis (NY),G,23,10,465,67,171,.392,45,98,.459,22,73,.301,43,57,.754,16,37,53,25,20,3,44,54,199,4.2
5510,Cameron Harvey\cameron-harvey-1,2015-16,Stetson,G,34,33,683,65,189,.344,24,77,.312,41,112,.366,28,36,.778,8,37,45,15,8,2,23,41,199,2.6
5511,Jordan Lyons\jordan-lyons-1,2016-17,Furman,G,34,0,557,66,171,.386,18,36,.500,48,135,.356,19,28,.679,7,42,49,36,17,0,29,26,199,3.6
5512,Austin Luke\austin-luke-1,2015-16,Belmont,G,32,30,888,64,143,.448,24,41,.585,40,102,.392,31,42,.738,11,76,87,200,19,2,121,59,199,5.2
5513,P.J. Thompson\pj-thompson-1,2015-16,Purdue,G,35,24,791,56,128,.438,22,46,.478,34,82,.415,53,64,.828,20,52,72,93,24,0,23,55,199,5.7
5514,Jagan Mosely\jagan-mosely-1,2017-18,Georgetown,G,30,1,696,70,144,.486,56,108,.519,14,36,.389,44,65,.677,9,74,83,86,25,6,61,55,198,5.1
5515,Lincoln Davis\lincoln-davis-1,2015-16,Lamar,G,30,21,587,53,146,.363,40,94,.426,13,52,.250,79,123,.642,19,62,81,46,26,8,41,53,198,4.4
5516,Jimario Rivers\jimario-rivers-1,2016-17,Memphis,G,31,19,686,82,144,.569,82,140,.586,0,4,.000,34,61,.557,45,62,107,29,21,27,24,89,198,5.5
5517,Anton Beard\anton-beard-1,2014-15,Arkansas,G,35,16,662,66,172,.384,35,84,.417,31,88,.352,35,55,.636,31,36,67,53,35,0,32,84,198,3.9
5518,Matt Thomas\matt-thomas-2,2013-14,Iowa State,G,36,15,763,66,180,.367,22,49,.449,44,131,.336,22,33,.667,6,70,76,40,20,7,17,52,198,3.7
5519,Raiquan Clark\raiquan-clark-1,2016-17,Long Island University,G,32,1,578,63,131,.481,63,130,.485,0,1,.000,72,99,.727,79,54,133,10,17,20,34,60,198,5.4
5520,Bo Zeigler\bo-zeigler-1,2014-15,South Florida,G,31,15,753,83,164,.506,83,161,.516,0,3,.000,32,78,.410,41,97,138,16,11,35,46,92,198,3.9
5521,Jabril Durham\jabril-durham-1,2015-16,Arkansas,G,32,32,891,59,168,.351,40,101,.396,19,67,.284,61,77,.792,15,96,111,204,53,2,58,70,198,7.8
5522,Brynton Lemar\brynton-lemar-1,2013-14,UC-Davis,G,25,13,593,68,179,.380,61,146,.418,7,33,.212,55,76,.724,11,36,47,43,10,3,34,48,198,4.0
5523,Trey Phills\trey-phills-1,2016-17,Yale,G,28,25,662,60,138,.435,47,99,.475,13,39,.333,65,82,.793,24,55,79,41,27,13,43,60,198,5.3
5524,Manny Thomas\manny-thomas-1,2014-15,Marist,G,32,15,851,52,157,.331,12,44,.273,40,113,.354,54,66,.818,12,63,75,39,26,7,44,61,198,3.8
5525,Jordan Reed\jordan-reed-2,2017-18,New Hampshire,G,27,18,758,69,209,.330,20,52,.385,49,157,.312,11,13,.846,14,57,71,55,14,4,46,51,198,3.5
5526,Isaiah Brown\isaiah-brown-1,2017-18,Northern Iowa,G,32,32,815,71,197,.360,38,95,.400,33,102,.324,23,33,.697,11,86,97,51,26,12,50,64,198,3.5
5527,Kyle Stout\kyle-stout-1,2016-17,Lafayette,G,30,13,802,67,180,.372,26,54,.481,41,126,.325,23,35,.657,17,99,116,34,11,9,34,63,198,3.9
5528,Kamau Stokes\kamau-stokes-1,2015-16,Kansas State,G,21,20,563,62,170,.365,27,67,.403,35,103,.340,39,54,.722,13,45,58,57,20,0,44,49,198,5.6
5529,Brannen Greene\brannen-greene-1,2014-15,Kansas,G,35,2,525,57,135,.422,17,36,.472,40,99,.404,44,48,.917,9,65,74,27,10,4,30,45,198,3.8
5530,James Washington\james-washington-2,2015-16,American,G,31,26,784,73,210,.348,43,104,.413,30,106,.283,22,34,.647,6,46,52,33,23,2,49,65,198,2.1
5531,Cameron Reynolds\cameron-reynolds-1,2015-16,Tulane,G,30,8,617,73,209,.349,49,119,.412,24,90,.267,28,34,.824,29,74,103,17,18,7,38,66,198,3.0
5532,William Tinsley\william-tinsley-1,2017-18,Illinois State,G,33,20,871,72,199,.362,25,51,.490,47,148,.318,7,14,.500,27,151,178,31,19,35,28,72,198,4.8
5533,Evan Taylor\evan-taylor-1,2014-15,Samford,G,31,15,693,74,190,.389,60,149,.403,14,41,.341,36,58,.621,23,80,103,37,33,7,47,57,198,3.9
5534,Amir Bell\amir-bell-2,2016-17,Princeton,G,30,5,707,73,165,.442,49,99,.495,24,66,.364,28,39,.718,11,60,71,61,19,10,32,70,198,4.7
5535,Brandon Roberts\brandon-roberts-2,2014-15,Samford,G,32,0,415,71,180,.394,38,81,.469,33,99,.333,23,30,.767,11,26,37,31,17,0,29,30,198,3.5
5536,Christian Benzon\christian-benzon-1,2016-17,Evansville,G,33,14,852,67,147,.456,61,135,.452,6,12,.500,58,115,.504,33,117,150,47,23,8,40,62,198,4.7
5537,Khalid Lewis\khalid-lewis-1,2014-15,La Salle,G,33,18,907,74,198,.374,53,134,.396,21,64,.328,29,47,.617,6,59,65,72,33,8,53,57,198,3.5
5538,Derrick Millinghaus\derrick-millinghaus-1,2013-14,Mississippi,G,30,9,541,68,197,.345,49,123,.398,19,74,.257,42,68,.618,4,47,51,68,29,1,32,36,197,4.1
5539,Charlie Jones\charlie-jones-2,2016-17,American,G,30,18,1004,75,136,.551,54,82,.659,21,54,.389,26,40,.650,29,152,181,78,53,18,36,73,197,8.2
5540,Chris Jenkins\chris-jenkins-2,2015-16,NJIT,G,28,0,482,68,166,.410,11,23,.478,57,143,.399,4,9,.444,1,21,22,9,11,0,14,30,197,3.7
5541,Bryce Aiken\bryce-aiken-1,2017-18,Harvard,G,14,8,388,57,152,.375,41,84,.488,16,68,.235,67,83,.807,2,27,29,41,4,0,38,24,197,7.3
5542,McKay LaSalle\mckay-lasalle-1,2014-15,Cal State Long Beach,G,33,31,760,66,170,.388,11,19,.579,55,151,.364,10,13,.769,5,42,47,23,15,0,14,64,197,3.4
5543,Thomas Capuano\thomas-capuano-1,2016-17,Manhattan,G,32,24,871,70,176,.398,38,79,.481,32,97,.330,25,34,.735,9,74,83,52,36,2,38,77,197,4.1
5544,Duane Wilson\duane-wilson-1,2017-18,Texas A&M,G,22,16,528,68,175,.389,48,107,.449,20,68,.294,41,52,.788,2,44,46,89,25,6,52,39,197,6.2
5545,Dejan Vasiljevic\dejan-vasiljevic-1,2016-17,Miami (FL),G,33,0,575,65,182,.357,14,36,.389,51,146,.349,16,20,.800,5,39,44,15,11,1,13,31,197,3.2
5546,Jelani Pruitt\jelani-pruitt-1,2017-18,Chicago State,G,30,1,470,78,183,.426,71,159,.447,7,24,.292,34,64,.531,43,73,116,24,16,3,49,51,197,3.5
5547,Tim Abruzzo\tim-abruzzo-1,2015-16,Navy,G,30,1,588,66,189,.349,26,59,.441,40,130,.308,25,35,.714,16,84,100,29,35,9,23,23,197,5.1
5548,Bryson Scott\bryson-scott-1,2013-14,Purdue,G,32,2,501,61,170,.359,56,157,.357,5,13,.385,70,95,.737,22,60,82,44,30,3,46,54,197,3.8
5549,Brian Starr\brian-starr-1,2016-17,Towson,G,33,23,807,74,176,.420,55,102,.539,19,74,.257,30,47,.638,9,61,70,60,30,3,40,57,197,4.0
5550,Max Heidegger\max-heidegger-1,2016-17,UC-Santa Barbara,G,26,2,533,55,205,.268,38,122,.311,17,83,.205,70,96,.729,9,45,54,36,8,0,40,35,197,2.5
5551,Trey Kell\trey-kell-1,2014-15,San Diego State,G,35,15,709,62,186,.333,47,118,.398,15,68,.221,58,91,.637,19,79,98,56,20,3,38,33,197,3.6
5552,LeTrell Viser\letrell-viser-1,2014-15,Eastern Illinois,G,32,21,730,71,194,.366,27,62,.435,44,132,.333,11,21,.524,6,74,80,34,40,15,39,70,197,3.7
5553,Saul Phiri\saul-phiri-1,2017-18,La Salle,G,32,27,976,59,182,.324,23,57,.404,36,125,.288,43,55,.782,32,120,152,47,35,18,31,76,197,5.2
5554,Michael Ramey\michael-ramey-1,2016-17,Southern Mississippi,G,31,21,679,68,187,.364,26,63,.413,42,124,.339,19,28,.679,3,43,46,22,7,1,20,46,197,2.9
5555,Scottie Lindsey\scottie-lindsey-1,2015-16,Northwestern,G,31,3,585,71,163,.436,33,70,.471,38,93,.409,17,23,.739,12,60,72,43,15,7,26,67,197,4.3
5556,Collin Stewart\collin-stewart-1,2014-15,Monmouth,G,33,0,469,67,153,.438,44,86,.512,23,67,.343,40,58,.690,5,32,37,25,14,9,41,47,197,3.0
5557,Jeremy Morgan\jeremy-morgan-1,2014-15,Northern Iowa,G,35,35,821,64,151,.424,33,58,.569,31,93,.333,38,52,.731,27,81,108,30,40,19,17,63,197,5.3
5558,Mike Poole\mike-poole-1,2013-14,Iona,G,33,27,705,82,170,.482,78,151,.517,4,19,.211,29,35,.829,36,102,138,62,41,20,38,89,197,5.7
5559,RaShawn Stores\rashawn-stores-1,2014-15,Manhattan,G,31,25,803,54,145,.372,15,47,.319,39,98,.398,49,69,.710,13,44,57,93,39,0,32,90,196,5.4
5560,Jaryd Eustace\jaryd-eustace-1,2013-14,Miami (OH),G,31,2,576,64,167,.383,29,54,.537,35,113,.310,33,47,.702,10,71,81,24,20,2,35,31,196,3.8
5561,Steven Kaspar\steven-kaspar-1,2013-14,Bucknell,G,30,26,731,69,169,.408,65,151,.430,4,18,.222,54,93,.581,15,112,127,139,32,10,71,50,196,6.0
5562,Doug Brooks\doug-brooks-1,2016-17,Virginia Commonwealth,G,35,20,709,61,181,.337,26,63,.413,35,118,.297,39,58,.672,18,84,102,67,56,4,36,110,196,4.3
5563,Matty McConnell\matty-mcconnell-1,2015-16,Robert Morris,G,29,26,862,68,218,.312,27,64,.422,41,154,.266,19,28,.679,15,56,71,66,57,6,27,47,196,5.4
5564,LaDarrien Williams\ladarrien-williams-1,2013-14,Abilene Christian,G,16,14,474,65,175,.371,51,131,.389,14,44,.318,52,73,.712,12,72,84,62,19,4,34,42,196,8.5
5565,Ben Cherry\ben-cherry-1,2013-14,Charlotte,G,31,25,673,59,135,.437,10,28,.357,49,107,.458,29,34,.853,5,26,31,22,10,0,18,54,196,3.9
5566,Marquis Eaton\marquis-eaton-1,2017-18,Arkansas State,G,32,10,641,69,176,.392,56,129,.434,13,47,.277,45,54,.833,10,40,50,69,26,6,50,52,196,3.9
5567,Trevor Anderson\trevor-anderson-1,2016-17,Green Bay,G,20,20,570,58,145,.400,23,52,.442,35,93,.376,45,56,.804,11,46,57,53,15,1,37,32,196,6.9
5568,Austen Awosika\austen-awosika-1,2016-17,Cal State Fullerton,G,32,1,617,77,145,.531,66,118,.559,11,27,.407,31,50,.620,16,71,87,57,26,6,33,39,196,5.4
5569,Leandro Allende\leandro-allende-1,2016-17,Citadel,G,33,19,560,66,177,.373,39,76,.513,27,101,.267,37,55,.673,30,60,90,29,16,3,28,74,196,3.4
5570,Lenny Antwi\lenny-antwi-1,2014-15,North Dakota,G,29,3,618,65,154,.422,25,56,.446,40,98,.408,26,31,.839,4,37,41,29,12,0,17,41,196,4.3
5571,Obadiah Noel\obadiah-noel-1,2017-18,Massachusetts-Lowell,G,30,0,552,58,145,.400,40,97,.412,18,48,.375,62,91,.681,28,47,75,34,19,11,33,65,196,4.4
5572,Josh Boyd\josh-boyd-1,2016-17,Northwestern State,G,25,1,448,58,150,.387,33,76,.434,25,74,.338,55,88,.625,22,42,64,57,15,2,65,71,196,3.7
5573,Jubril Adekoya\jubril-adekoya-1,2013-14,Valparaiso,G,34,24,650,73,136,.537,68,107,.636,5,29,.172,45,73,.616,24,93,117,43,15,2,43,73,196,4.1
5574,Cameron Jones\cameron-jones-3,2017-18,Saint Peter's,G,32,2,724,64,177,.362,26,68,.382,38,109,.349,30,43,.698,16,66,82,44,30,4,46,80,196,3.4
5575,James Whitaker\james-whitaker-1,2016-17,North Carolina A&T,G,28,9,504,63,175,.360,41,100,.410,22,75,.293,48,61,.787,22,62,84,8,13,5,27,60,196,3.5
5576,Austin Keel\austin-keel-1,2013-14,Central Michigan,G,31,14,532,69,172,.401,51,92,.554,18,80,.225,40,51,.784,19,42,61,20,21,1,23,28,196,4.1
5577,Harrison Hawkins\harrison-hawkins-1,2013-14,Abilene Christian,G,16,16,481,55,147,.374,30,85,.353,25,62,.403,61,72,.847,5,36,41,51,17,0,49,47,196,6.9
5578,Jason Richardson\jason-richardson-2,2015-16,Cal State Northridge,G,30,12,587,71,175,.406,62,141,.440,9,34,.265,45,71,.634,13,40,53,71,21,1,51,65,196,3.6
5579,Tyler Bey\tyler-bey-1,2017-18,Colorado,G,32,21,629,73,145,.503,73,139,.525,0,6,.000,50,73,.685,48,116,164,16,20,22,38,84,196,4.9
5580,Loren Jackson\loren-jackson-1,2016-17,Cal State Long Beach,G,34,5,642,66,151,.437,43,85,.506,23,66,.348,41,59,.695,4,35,39,52,21,0,46,55,196,3.3
5581,Kaelon Harris\kaelon-harris-1,2016-17,Citadel,G,21,6,406,66,136,.485,53,97,.546,13,39,.333,51,87,.586,39,63,102,21,10,5,45,55,196,5.7
5582,Jordan Ratliffe\jordan-ratliffe-1,2017-18,Virginia Military Institute,G,27,0,471,72,185,.389,49,100,.490,23,85,.271,29,39,.744,23,42,65,20,20,1,41,37,196,3.7
5583,Jake Bittle\jake-bittle-1,2013-14,South Dakota State,G,23,20,696,72,167,.431,56,120,.467,16,47,.340,35,53,.660,37,69,106,52,42,10,40,74,195,7.0
5584,Deandre Burnett\deandre-burnett-1,2014-15,Miami (FL),G,28,3,488,64,180,.356,36,84,.429,28,96,.292,39,53,.736,13,43,56,18,14,4,24,32,195,3.7
5585,Khalen Cumberlander\khalen-cumberlander-1,2013-14,Central Connecticut State,G,30,19,706,79,179,.441,59,119,.496,20,60,.333,17,29,.586,14,41,55,50,22,6,29,49,195,4.4
5586,Quentin Goodin\quentin-goodin-1,2016-17,Xavier,G,38,19,916,70,200,.350,57,149,.383,13,51,.255,42,73,.575,6,71,77,131,35,7,74,80,195,3.2
5587,Eric Green\eric-green-1,2014-15,Holy Cross,G,30,16,699,86,199,.432,86,195,.441,0,4,.000,23,43,.535,26,71,97,27,43,19,36,63,195,4.5
5588,Marcus Johnson\marcus-johnson-8,2014-15,Samford,G,32,1,610,66,148,.446,36,65,.554,30,83,.361,33,49,.673,13,51,64,54,23,2,35,33,195,4.7
5589,Dana Raysor\dana-raysor-1,2015-16,Delaware State,G,30,18,590,60,171,.351,22,53,.415,38,118,.322,37,54,.685,18,49,67,25,17,2,27,62,195,3.5
5590,Casey Kasperbauer\casey-kasperbauer-1,2013-14,South Dakota,G,29,1,528,62,150,.413,16,41,.390,46,109,.422,25,31,.806,4,42,46,22,13,0,14,24,195,4.6
5591,Richard Lee\richard-lee-1,2015-16,Tennessee-Martin,G,35,16,591,70,157,.446,30,62,.484,40,95,.421,15,21,.714,10,48,58,14,11,1,20,34,195,3.4
5592,Adrian Rich\adrian-rich-1,2016-17,Virginia Military Institute,G,30,27,800,74,183,.404,47,96,.490,27,87,.310,20,24,.833,7,30,37,59,34,3,48,74,195,3.6
5593,Keith Frazier\keith-frazier-1,2013-14,Southern Methodist,G,36,0,534,69,169,.408,28,66,.424,41,103,.398,16,22,.727,14,52,66,31,17,11,35,38,195,3.4
5594,Gee McGhee\gee-mcghee-1,2016-17,Murray State,G,28,9,695,52,132,.394,33,71,.465,19,61,.311,72,97,.742,39,98,137,40,19,5,29,71,195,5.8
5595,KiShawn Pritchett\kishawn-pritchett-1,2017-18,Davidson,G,33,32,824,67,143,.469,28,54,.519,39,89,.438,22,24,.917,22,48,70,109,17,9,60,53,195,5.1
5596,James Scott\james-scott-2,2016-17,Kennesaw State,G,23,1,354,65,159,.409,42,96,.438,23,63,.365,42,61,.689,11,24,35,26,11,2,33,19,195,4.7
5597,Johnathan Stove\johnathan-stove-1,2014-15,Louisiana,G,36,15,674,70,141,.496,63,117,.538,7,24,.292,48,61,.787,27,47,74,65,14,12,42,82,195,4.0
5598,Isaiah Taylor\isaiah-taylor-2,2016-17,Stephen F. Austin,G,33,0,511,60,155,.387,25,50,.500,35,105,.333,40,52,.769,13,35,48,18,10,6,43,46,195,2.7
5599,Zach Fong\zach-fong-1,2013-14,Navy,G,29,0,485,63,166,.380,11,32,.344,52,134,.388,17,22,.773,5,33,38,18,10,1,24,46,195,3.3
5600,Hakeem Baxter\hakeem-baxter-1,2015-16,Alabama-Birmingham,G,33,32,803,62,156,.397,52,123,.423,10,33,.303,61,84,.726,20,74,94,68,18,9,48,55,195,4.2
5601,Nori Johnson\nori-johnson-1,2013-14,College of Charleston,G,25,14,562,62,148,.419,11,29,.379,51,119,.429,20,23,.870,11,36,47,20,17,10,15,69,195,5.2
5602,Morgan Means\morgan-means-1,2016-17,Seattle,G,29,29,683,67,165,.406,42,95,.442,25,70,.357,36,56,.643,12,65,77,60,27,0,56,69,195,3.8
5603,Junior Lomomba\junior-lomomba-1,2016-17,Western Kentucky,G,32,32,921,62,182,.341,45,128,.352,17,54,.315,54,78,.692,4,70,74,109,20,1,91,70,195,2.6
5604,James Daniel\james-daniel-1,2017-18,Tennessee,G,35,3,691,59,161,.366,14,40,.350,45,121,.372,32,44,.727,13,37,50,97,28,4,49,68,195,4.1
5605,Elijah Hughes\elijah-hughes-1,2016-17,East Carolina,G,25,7,512,58,166,.349,34,78,.436,24,88,.273,54,79,.684,10,48,58,32,14,11,24,46,194,4.6
5606,Jimmy Whitt\jimmy-whitt-1,2015-16,Arkansas,G,32,10,550,75,194,.387,69,178,.388,6,16,.375,38,48,.792,11,42,53,34,20,6,31,66,194,3.0
5607,Alante Fenner\alante-fenner-1,2013-14,Savannah State,G,31,7,495,66,160,.413,51,113,.451,15,47,.319,47,62,.758,16,35,51,23,18,2,46,47,194,3.1
5608,Travis Daniels\travis-daniels-1,2014-15,Mississippi State,G,32,25,632,70,176,.398,46,93,.495,24,83,.289,30,45,.667,39,85,124,18,14,5,49,52,194,3.3
5609,Ryan Richardson\ryan-richardson-1,2015-16,Weber State,G,29,26,574,62,162,.383,14,29,.483,48,133,.361,22,26,.846,4,47,51,36,19,3,34,52,194,3.9
5610,Max Hooper\max-hooper-1,2014-15,Oakland,G,33,8,618,64,167,.383,4,8,.500,60,159,.377,6,8,.750,4,39,43,9,9,1,12,32,194,3.3
5611,Tyler Peterson\tyler-peterson-2,2016-17,South Dakota,G,34,0,579,66,155,.426,46,81,.568,20,74,.270,42,64,.656,20,82,102,35,22,8,35,78,194,3.8
5612,Will Adams\will-adams-2,2016-17,Presbyterian,G,30,13,592,70,184,.380,31,84,.369,39,100,.390,15,19,.789,8,35,43,26,22,3,13,38,194,4.1
5613,Jared Nickens\jared-nickens-1,2015-16,Maryland,G,36,0,694,65,177,.367,13,27,.481,52,150,.347,12,15,.800,11,57,68,17,11,7,19,50,194,3.0
5614,T.J. Buchanan\tj-buchanan-1,2014-15,Rhode Island,G,33,1,744,61,127,.480,58,118,.492,3,9,.333,69,103,.670,33,77,110,84,40,7,49,84,194,5.6
5615,Aakim Saintil\aakim-saintill-1,2013-14,South Alabama,G,31,10,705,55,167,.329,36,97,.371,19,70,.271,65,88,.739,16,46,62,57,32,2,45,102,194,3.3
5616,Amari Hamilton\amari-hamilton-1,2016-17,North Carolina A&T,G,29,12,628,62,173,.358,24,65,.369,38,108,.352,32,41,.780,7,52,59,42,14,1,41,29,194,3.7
5617,Cedric Russell\cedric-russell-1,2017-18,Louisiana,G,34,1,514,67,160,.419,12,33,.364,55,127,.433,5,8,.625,7,30,37,23,15,0,23,57,194,3.1
5618,Marquise Pointer\marquise-pointer-1,2017-18,College of Charleston,G,34,2,850,68,169,.402,41,85,.482,27,84,.321,31,44,.705,27,75,102,62,27,6,32,50,194,4.8
5619,Michael Orris\michael-orris-1,2016-17,South Dakota State,G,24,20,724,71,146,.486,65,129,.504,6,17,.353,46,68,.676,10,35,45,95,17,1,57,65,194,5.4
5620,Ben Richardson\ben-richardson-1,2017-18,Loyola (IL),G,28,28,869,65,141,.461,27,46,.587,38,95,.400,26,38,.684,3,82,85,106,34,10,44,59,194,6.8
5621,Ishmail Wainright\ish-wainright-1,2016-17,Baylor,G,35,35,1028,70,172,.407,44,83,.530,26,89,.292,28,41,.683,54,125,179,111,59,8,56,84,194,6.4
5622,Davell Roby\davell-roby-1,2015-16,Saint Louis,G,31,7,633,56,141,.397,27,67,.403,29,74,.392,53,72,.736,7,66,73,50,18,3,43,69,194,3.8
5623,Sir'Dominic Pointer\sirdominic-pointer-1,2013-14,St. John's (NY),G,33,1,698,67,153,.438,64,133,.481,3,20,.150,57,78,.731,18,86,104,61,40,35,40,71,194,5.5
5624,Jonathan Wade\jonathan-wade-1,2015-16,Norfolk State,G,33,2,532,63,158,.399,44,102,.431,19,56,.339,49,58,.845,33,55,88,19,13,2,29,55,194,3.7
5625,Malcolm Duvivier\malcolm-duvivier-1,2015-16,Oregon State,G,32,32,809,66,175,.377,36,92,.391,30,83,.361,32,53,.604,12,64,76,69,12,5,52,53,194,3.4
5626,Shaq Shannon\shaq-shannon-1,2013-14,Quinnipiac,G,32,32,767,58,153,.379,31,86,.360,27,67,.403,51,85,.600,27,89,116,80,12,5,45,62,194,4.5
5627,Rondale Watson\rondale-watson-1,2017-18,Marshall,G,25,2,642,74,164,.451,51,100,.510,23,64,.359,23,35,.657,28,61,89,33,26,7,30,59,194,5.7
5628,Desure Buie\desure-buie-1,2017-18,Hofstra,G,30,18,670,66,152,.434,44,89,.494,22,63,.349,39,48,.813,6,40,46,100,22,1,44,50,193,5.1
5629,Caleb Daniels\caleb-daniels-1,2017-18,Tulane,G,30,0,550,60,140,.429,39,87,.448,21,53,.396,52,65,.800,20,46,66,44,7,10,35,82,193,4.0
5630,Josh Gentry\josh-gentry-2,2014-15,Cal State Fullerton,G,31,21,732,58,132,.439,52,102,.510,6,30,.200,71,78,.910,21,55,76,41,17,8,48,52,193,4.3
5631,Deon Edwin\deon-edwin-1,2015-16,Kent State,G,32,20,537,70,141,.496,46,76,.605,24,65,.369,29,44,.659,34,64,98,21,28,1,28,45,193,4.9
5632,Jack Gordon\jack-gordon-2,2017-18,Cornell,G,27,13,684,63,132,.477,23,39,.590,40,93,.430,27,39,.692,16,49,65,52,14,1,47,56,193,4.8
5633,Devontae Shuler\devontae-shuler-1,2017-18,Mississippi,G,32,9,604,74,210,.352,44,94,.468,30,116,.259,15,20,.750,26,61,87,34,32,3,25,33,193,4.1
5634,B.J. Glasford\bj-glasford-1,2016-17,Stetson,G,32,5,635,75,183,.410,47,97,.485,28,86,.326,15,28,.536,15,82,97,32,32,7,28,82,193,3.9
5635,Justin Kier\justin-kier-1,2016-17,George Mason,G,33,29,913,59,138,.428,42,94,.447,17,44,.386,58,78,.744,24,124,148,37,20,5,53,63,193,4.2
5636,Alexander Aka Gorski\alexander-aka-gorski-1,2015-16,Wyoming,G,32,11,600,54,135,.400,17,39,.436,37,96,.385,48,67,.716,12,50,62,34,7,0,27,60,193,3.6
5637,Dakarai Henderson\dakarai-henderson-1,2013-14,Sam Houston State,G,31,0,372,64,155,.413,23,54,.426,41,101,.406,24,38,.632,2,24,26,13,13,1,23,29,193,3.3
5638,Tim Douglas\tim-douglas-1,2014-15,Portland State,G,29,7,685,62,162,.383,35,86,.407,27,76,.355,42,50,.840,9,49,58,80,24,2,33,49,193,5.2
5639,Khion Sankey\khion-sankey-1,2013-14,Lipscomb,G,27,25,683,62,160,.388,29,68,.426,33,92,.359,36,59,.610,38,110,148,57,29,17,31,81,193,6.4
5640,Ar'Mond Davis\armond-davis-1,2016-17,Alabama,G,32,0,440,67,201,.333,35,81,.432,32,120,.267,27,33,.818,7,40,47,4,13,3,20,22,193,2.6
5641,Maurice Aniefiok\maurice-aniefiok-1,2013-14,North Texas,G,29,2,574,63,162,.389,24,57,.421,39,105,.371,28,35,.800,12,88,100,18,14,7,25,90,193,3.7
5642,Jack Montague\jack-montague-1,2015-16,Yale,G,20,20,567,60,162,.370,13,44,.295,47,118,.398,26,31,.839,9,40,49,59,22,0,41,39,193,6.3
5643,Madison Jones\madison-jones-1,2016-17,Seton Hall,G,33,31,973,69,168,.411,55,123,.447,14,45,.311,41,60,.683,15,67,82,104,58,4,65,91,193,4.8
5644,Hugh Greenwood\hugh-greenwood-1,2013-14,New Mexico,G,31,31,986,67,168,.399,28,50,.560,39,118,.331,20,31,.645,39,118,157,105,27,9,30,86,193,6.5
5645,Shawndale Jones\shawndale-jones-1,2017-18,NJIT,G,30,1,486,71,166,.428,51,112,.455,20,54,.370,31,42,.738,22,58,80,30,16,2,24,31,193,4.5
5646,Jeff Wu\jeff-wu-1,2015-16,Sacramento State,G,31,0,530,71,164,.433,42,78,.538,29,86,.337,22,39,.564,4,36,40,30,15,4,30,48,193,3.3
5647,McKay Cannon\mckay-cannon-1,2015-16,Weber State,G,35,33,750,60,155,.387,19,46,.413,41,109,.376,32,45,.711,11,57,68,96,32,1,53,84,193,4.0
5648,Luke Roh\luke-roh-1,2013-14,Colgate,G,31,31,939,87,145,.600,86,143,.601,1,2,.500,18,48,.375,37,132,169,98,24,7,56,71,193,6.2
5649,Dakarai Tucker\dakarai-tucker-1,2015-16,Utah,G,36,0,667,63,145,.434,18,37,.486,45,108,.417,22,29,.759,12,75,87,25,15,16,26,43,193,4.0
5650,Jalen James\jalen-james-1,2016-17,San Jose State,G,30,17,632,59,169,.349,32,92,.348,27,77,.351,48,56,.857,9,69,78,65,20,2,48,44,193,4.1
5651,Quinton Campbell\quinton-campbell-1,2015-16,Southern Mississippi,G,29,20,661,64,163,.393,21,34,.618,43,129,.333,22,33,.667,11,86,97,30,12,4,27,39,193,4.4
5652,Zach Rufer\zach-rufer-1,2015-16,Lafayette,G,28,9,664,63,161,.391,15,35,.429,48,126,.381,19,30,.633,20,79,99,49,33,3,29,60,193,5.5
5653,Jadon Cohee\jadon-cohee-1,2014-15,Seattle,G,34,6,625,71,184,.386,60,149,.403,11,35,.314,40,56,.714,4,52,56,51,13,0,46,37,193,2.7
5654,Derek Reese\derek-reese-1,2014-15,Tennessee,G,32,11,810,65,160,.406,45,100,.450,20,60,.333,42,57,.737,56,114,170,28,21,10,37,69,192,4.9
5655,ShawnDre' Jones\shawndre-jones-1,2013-14,Richmond,G,30,2,409,61,153,.399,27,64,.422,34,89,.382,36,41,.878,8,23,31,24,15,2,30,34,192,3.6
5656,Brocke Stepteau\brocke-stepteau-1,2016-17,Hawaii,G,30,22,776,51,139,.367,32,73,.438,19,66,.288,71,88,.807,9,44,53,90,6,0,52,57,192,4.1
5657,Max DiLeo\max-dileo-1,2013-14,Monmouth,G,28,0,546,61,119,.513,34,63,.540,27,56,.482,43,57,.754,19,42,61,35,41,10,27,68,192,6.1
5658,Rashad Jackson\rashad-jackson-1,2016-17,Portland,G,30,14,639,58,169,.343,40,111,.360,18,58,.310,58,76,.763,12,62,74,19,27,6,33,46,192,3.7
5659,Justin Thomas\justin-thomas-4,2017-18,Northern Illinois,G,32,16,846,68,152,.447,47,98,.480,21,54,.389,35,57,.614,13,77,90,61,42,3,33,45,192,5.4
5660,Chris McNeal\chris-mcneal-1,2015-16,Western Kentucky,G,34,29,952,58,179,.324,24,60,.400,34,119,.286,42,61,.689,21,114,135,134,19,1,67,61,192,4.5
5661,Ikenna Ndugba\ikenna-ndugba-1,2016-17,Bryant,G,32,28,913,64,177,.362,43,97,.443,21,80,.263,43,57,.754,16,111,127,131,38,0,74,96,192,4.7
5662,Charles Jackson\charles-jackson-4,2016-17,Arkansas-Pine Bluff,G,29,5,581,59,144,.410,15,43,.349,44,101,.436,30,43,.698,11,56,67,43,21,0,43,64,192,4.0
5663,Jalen James\jalen-james-1,2013-14,San Jose State,G,29,29,796,68,194,.351,49,126,.389,19,68,.279,37,56,.661,12,109,121,89,8,6,76,73,192,3.0
5664,J.T. Thomas\jt-thomas-1,2014-15,Little Rock,G,31,25,796,61,177,.345,32,88,.364,29,89,.326,41,69,.594,3,52,55,75,14,5,33,40,192,3.9
5665,James Currington\james-currington-1,2016-17,Southeastern Louisiana,G,22,17,605,82,139,.590,82,138,.594,0,1,.000,28,44,.636,64,83,147,12,25,11,33,64,192,7.9
5666,Zalmico Harmon\zalmico-harmon-1,2014-15,UC-Santa Barbara,G,31,31,981,54,155,.348,27,81,.333,27,74,.365,57,70,.814,16,33,49,108,19,5,49,70,192,4.6
5667,Jordan Barham\jordan-barham-1,2013-14,Davidson,G,33,0,411,72,116,.621,71,112,.634,1,4,.250,47,83,.566,29,71,100,8,12,2,16,53,192,4.5
5668,Earl Potts\earl-potts-1,2014-15,Fairleigh Dickinson,G,29,17,527,67,162,.414,53,104,.510,14,58,.241,44,63,.698,22,61,83,14,21,9,13,85,192,4.2
5669,Lamond Murray\lamond-murray-2,2014-15,Pepperdine,G,28,0,519,80,172,.465,78,165,.473,2,7,.286,30,37,.811,24,62,86,26,15,9,34,48,192,4.4
5670,Michael Bibby\michael-bibby-1,2016-17,South Florida,G,29,14,669,59,144,.410,20,44,.455,39,100,.390,35,41,.854,1,49,50,57,21,5,60,64,192,3.7
5671,Shembari Phillips\shembari-phillips-1,2016-17,Tennessee,G,31,13,645,58,151,.384,40,103,.388,18,48,.375,58,75,.773,21,74,95,52,19,4,44,74,192,4.0
5672,Bjorn Broman\bjorn-broman-1,2015-16,Winthrop,G,32,26,903,54,171,.316,11,36,.306,43,135,.319,41,49,.837,12,50,62,62,24,0,29,64,192,4.0
5673,Troy Whiteside\troy-whiteside-1,2016-17,Cornell,G,29,23,683,79,150,.527,64,111,.577,15,39,.385,19,27,.704,20,70,90,40,18,3,35,68,192,4.7
5674,Noah Blackwell\noah-blackwell-1,2015-16,Cal State Long Beach,G,33,3,669,65,184,.353,21,63,.333,44,121,.364,18,26,.692,15,46,61,72,11,2,29,57,192,3.7
5675,Galal Cancer\galal-cancer-1,2015-16,Kent State,G,32,21,777,61,157,.389,24,55,.436,37,102,.363,33,52,.635,29,61,90,47,31,2,37,68,192,4.3
5676,Duda Sanadze\duda-sanadze-1,2014-15,San Diego,G,29,14,511,63,181,.348,41,107,.383,22,74,.297,44,65,.677,18,53,71,24,14,7,37,49,192,3.1
5677,Anthony Thompson\anthony-thompson-2,2016-17,Holy Cross,G,32,27,1067,58,180,.322,21,59,.356,37,121,.306,38,57,.667,22,80,102,70,57,1,45,54,191,5.0
5678,Nick Gruninger\nick-gruninger-1,2014-15,UC-Riverside,G,31,18,722,62,147,.422,40,77,.519,22,70,.314,45,48,.938,7,46,53,101,22,0,53,63,191,4.7
5679,Makai Mason\makai-mason-1,2014-15,Yale,G,31,0,595,63,139,.453,46,91,.505,17,48,.354,48,66,.727,14,55,69,49,20,2,33,52,191,4.5
5680,Retin Obasohan\retin-obasohan-1,2014-15,Alabama,G,31,12,604,67,150,.447,50,105,.476,17,45,.378,40,66,.606,21,68,89,24,28,16,35,67,191,4.2
5681,Frank Mason\frank-mason-1,2013-14,Kansas,G,35,3,565,63,151,.417,45,96,.469,18,55,.327,47,71,.662,8,38,46,72,18,1,37,65,191,3.5
5682,David Cohn\david-cohn-1,2016-17,William & Mary,G,31,29,901,65,157,.414,42,94,.447,23,63,.365,38,52,.731,6,76,82,139,29,1,51,39,191,6.1
5683,Kimbal MacKenzie\kimbal-mackenzie-1,2017-18,Bucknell,G,23,22,639,61,174,.351,20,57,.351,41,117,.350,28,29,.966,16,27,43,57,13,2,33,47,191,5.0
5684,Dakota Mathias\dakota-mathias-1,2015-16,Purdue,G,35,5,665,64,157,.408,20,43,.465,44,114,.386,19,22,.864,2,75,77,82,11,2,21,53,191,4.5
5685,Clemmye Owens\clemmye-owens-1,2015-16,Chicago State,G,21,8,530,67,197,.340,36,92,.391,31,105,.295,26,31,.839,10,42,52,38,22,1,30,44,191,4.7
5686,Dustin Thomas\dustin-thomas-1,2016-17,Arkansas,G,36,27,648,72,148,.486,71,143,.497,1,5,.200,46,70,.657,45,91,136,40,23,9,36,104,191,4.0
5687,Michael Perez\michael-perez-1,2014-15,Nevada,G,30,22,803,66,203,.325,44,120,.367,22,83,.265,37,55,.673,9,82,91,58,31,3,46,58,191,3.5
5688,Jaysean Paige\jaysean-paige-1,2014-15,West Virginia,G,34,10,452,68,168,.405,33,77,.429,35,91,.385,20,38,.526,36,27,63,22,37,5,31,77,191,3.6
5689,Rapheal Davis\rapheal-davis-1,2013-14,Purdue,G,32,15,593,61,141,.433,52,108,.481,9,33,.273,60,77,.779,49,70,119,42,16,10,27,61,191,5.2
5690,Erick Neal\erick-neal-1,2014-15,Texas-Arlington,G,29,11,537,66,167,.395,31,60,.517,35,107,.327,24,37,.649,7,46,53,86,34,0,59,38,191,4.6
5691,Jelani Currie\jelani-currie-1,2014-15,Texas A&M-Corpus Christi,G,33,9,671,63,131,.481,46,94,.489,17,37,.459,48,68,.706,29,65,94,28,22,14,30,56,191,4.7
5692,Julion Pearre\julion-pearre-1,2014-15,Utah State,G,31,24,727,63,180,.350,27,75,.360,36,105,.343,29,39,.744,4,60,64,51,21,2,38,63,191,3.3
5693,Najja Hunter\najja-hunter-1,2017-18,Rice,G,30,10,529,71,164,.433,58,122,.475,13,42,.310,36,61,.590,36,56,92,33,18,9,48,40,191,4.0
5694,Casey Benson\casey-benson-1,2016-17,Oregon,G,39,4,816,61,140,.436,29,61,.475,32,79,.405,37,48,.771,13,52,65,74,25,1,34,51,191,4.1
5695,Matthew Fisher-Davis\matthew-fisher-davis-1,2017-18,Vanderbilt,G,17,10,443,61,162,.377,26,57,.456,35,105,.333,34,39,.872,18,63,81,21,19,9,19,40,191,8.0
5696,Moe McDonald\moe-mcdonald-1,2017-18,Texas-Rio Grande Valley,G,32,12,694,55,167,.329,34,85,.400,21,82,.256,59,79,.747,15,69,84,70,24,1,56,55,190,3.6
5697,Isaiah Zierden\isaiah-zierden-1,2014-15,Creighton,G,20,7,558,55,139,.396,11,28,.393,44,111,.396,36,40,.900,3,42,45,29,12,1,13,25,190,6.9
5698,Hayward Register\hayward-register-1,2015-16,Louisiana,G,34,5,448,63,213,.296,15,48,.313,48,165,.291,16,21,.762,10,38,48,9,15,6,11,37,190,2.4
5699,Julian Chiera\julian-chiera-1,2013-14,Southeastern Louisiana,G,30,18,614,61,125,.488,31,57,.544,30,68,.441,38,43,.884,12,62,74,22,13,0,32,73,190,4.0
5700,Jeremiah Jones\jeremiah-jones-1,2013-14,Duquesne,G,30,30,741,61,163,.374,44,107,.411,17,56,.304,51,71,.718,32,71,103,49,11,3,31,52,190,4.4
5701,Ryan Andino\ryan-andino-1,2015-16,Maryland-Eastern Shore,G,31,7,677,64,179,.358,8,20,.400,56,159,.352,6,10,.600,7,29,36,32,13,0,32,35,190,3.0
5702,Quentin Jones\quentin-jones-1,2013-14,Maryland-Baltimore County,G,26,19,639,62,144,.431,28,66,.424,34,78,.436,32,44,.727,21,24,45,40,24,0,39,65,190,4.5
5703,Obi Okolie\obi-okolie-1,2015-16,Brown,G,19,11,471,67,143,.469,58,117,.496,9,26,.346,47,72,.653,26,56,82,19,18,3,23,34,190,7.3
5704,Chris Sarbaugh\chris-sarbaugh-1,2015-16,Idaho,G,34,34,860,68,137,.496,67,131,.511,1,6,.167,53,75,.707,37,113,150,109,32,6,75,72,190,5.3
5705,Mario Dunn\mario-dunn-1,2013-14,Montana,G,30,16,724,58,109,.532,44,77,.571,14,32,.438,60,98,.612,16,65,81,41,27,12,36,70,190,5.1
5706,T.J. Williams\tj-williams-4,2015-16,Northeastern,G,28,19,656,62,132,.470,55,100,.550,7,32,.219,59,93,.634,10,46,56,75,19,3,38,50,190,5.2
5707,Undra Mitchem\undra-mitchem-1,2013-14,Jacksonville State,G,31,22,643,61,173,.353,21,74,.284,40,99,.404,28,40,.700,15,40,55,41,29,5,41,60,190,3.5
5708,Laquincy Rideau\laquincy-rideau-1,2015-16,Gardner-Webb,G,33,1,523,69,158,.437,54,108,.500,15,50,.300,37,81,.457,16,58,74,84,67,2,55,92,190,4.6
5709,Darrell Bowie\darrell-bowie-1,2016-17,Iowa State,G,33,9,562,78,160,.488,73,145,.503,5,15,.333,29,68,.426,47,87,134,22,22,18,39,66,190,4.2
5710,Darius Austin\darius-austin-1,2017-18,Jackson State,G,30,24,656,70,187,.374,46,120,.383,24,67,.358,26,51,.510,37,76,113,35,28,7,50,65,190,3.6
5711,Charles Glover\charles-glover-1,2015-16,Mount St. Mary's,G,33,3,722,57,161,.354,22,55,.400,35,106,.330,41,55,.745,7,83,90,33,24,4,42,89,190,2.9
5712,Emmett Naar\emmett-naar-1,2014-15,Saint Mary's (CA),G,30,9,842,54,137,.394,19,59,.322,35,78,.449,47,59,.797,8,51,59,118,13,2,61,42,190,5.0
5713,Malik Clements\malik-clements-1,2015-16,North Dakota State,G,30,10,490,69,191,.361,39,88,.443,30,103,.291,22,36,.611,15,52,67,13,14,1,27,27,190,3.0
5714,Kam Williams\kam-williams-1,2014-15,Ohio State,G,35,0,500,70,155,.452,42,74,.568,28,81,.346,21,23,.913,6,28,34,18,17,2,6,22,189,3.9
5715,Ben Brackney\ben-brackney-1,2013-14,Bucknell,G,25,22,591,58,153,.379,12,46,.261,46,107,.430,27,31,.871,23,72,95,9,7,0,20,46,189,4.6
5716,T.J. Henderson\tj-henderson-1,2016-17,IUPUI,G,32,1,566,60,134,.448,30,59,.508,30,75,.400,39,56,.696,10,40,50,52,32,5,38,58,189,4.4
5717,Alpha Diallo\alpha-diallo-1,2016-17,Providence,G,33,16,705,59,145,.407,50,108,.463,9,37,.243,62,84,.738,32,73,105,39,29,5,41,78,189,4.1
5718,Jaylon Brown\jaylon-brown-1,2014-15,Evansville,G,36,13,694,67,142,.472,58,117,.496,9,25,.360,46,60,.767,6,62,68,88,26,4,48,75,189,4.1
5719,Mike'l Simms\mikel-simms-1,2017-18,Virginia Commonwealth,G,33,0,571,70,171,.409,36,67,.537,34,104,.327,15,23,.652,14,54,68,37,24,2,27,49,189,3.8
5720,Alex Austin\alex-austin-1,2013-14,Eastern Illinois,G,27,16,599,57,149,.383,26,53,.491,31,96,.323,44,53,.830,6,59,65,28,19,1,24,36,189,4.7
5721,Ka'Darryl Bell\kadarryl-bell-1,2014-15,Bradley,G,31,23,808,58,169,.343,37,110,.336,21,59,.356,52,77,.675,19,53,72,66,30,3,59,86,189,3.2
5722,Kasheem Thomas\kasheem-thomas-1,2017-18,Cleveland State,G,35,10,737,61,173,.353,46,112,.411,15,61,.246,52,72,.722,6,59,65,79,14,0,50,44,189,3.1
5723,Fabyon Harris\fabyon-harris-1,2013-14,Texas A&M,G,30,7,698,63,150,.420,39,71,.549,24,79,.304,39,50,.780,5,58,63,51,23,2,33,45,189,4.5
5724,Brandon Pye\brandon-pye-1,2013-14,Texas A&M-Corpus Christi,G,33,23,625,72,157,.459,36,85,.424,36,72,.500,9,16,.563,5,23,28,29,12,0,20,44,189,3.3
5725,Brett Frantz\brett-frantz-1,2016-17,Youngstown State,G,33,18,798,60,177,.339,25,61,.410,35,116,.302,34,40,.850,9,59,68,46,14,4,35,61,189,3.0
5726,Matt McQuaid\matt-mcquaid-1,2016-17,Michigan State,G,34,11,714,61,173,.353,19,53,.358,42,120,.350,25,35,.714,19,45,64,41,14,2,27,67,189,3.1
5727,Spencer Haldeman\spencer-haldeman-1,2017-18,Northern Iowa,G,31,0,549,56,138,.406,13,34,.382,43,104,.413,34,48,.708,4,40,44,35,14,0,27,46,189,3.8
5728,Que Johnson\que-johnson-1,2014-15,Washington State,G,31,3,559,60,155,.387,32,78,.410,28,77,.364,41,48,.854,15,56,71,32,10,4,33,55,189,3.5
5729,Jeff Lowery\jeff-lowery-1,2015-16,Central Arkansas,G,27,11,671,62,161,.385,56,143,.392,6,18,.333,59,81,.728,10,45,55,78,27,3,55,63,189,4.3
5730,Vernon Lowndes Jr.\vernon-lowndesjr-1,2017-18,Maine,G,29,6,466,68,142,.479,53,94,.564,15,48,.313,38,56,.679,21,74,95,16,22,7,51,50,189,3.9
5731,Chris Porter-Bunton\chris-porter-bunton-1,2016-17,Austin Peay,G,30,26,664,65,136,.478,47,89,.528,18,47,.383,41,65,.631,31,77,108,31,23,7,34,100,189,4.4
5732,Chris Kendrix\chris-kendrix-1,2014-15,Missouri State,G,30,18,708,53,128,.414,33,66,.500,20,62,.323,63,83,.759,41,70,111,25,18,11,38,54,189,4.9
5733,Dexter Kernich-Drew\dexter-kernich-drew-1,2013-14,Washington State,G,30,21,667,63,160,.394,27,61,.443,36,99,.364,26,35,.743,11,41,52,25,11,6,27,65,188,3.2
5734,Randy Reed\randy-reed-1,2015-16,Omaha,G,31,0,513,68,132,.515,65,125,.520,3,7,.429,49,64,.766,23,74,97,15,15,8,32,62,188,4.2
5735,Anthony Adger\anthony-adger-1,2017-18,Florida Atlantic,G,31,15,623,66,198,.333,60,145,.414,6,53,.113,50,61,.820,8,51,59,72,19,0,53,43,188,3.0
5736,J.P. Macura\jp-macura-1,2014-15,Xavier,G,35,3,463,62,150,.413,30,55,.545,32,95,.337,32,42,.762,15,27,42,22,26,3,33,50,188,3.2
5737,Evan Cooper\evan-cooper-1,2015-16,Hartford,G,33,0,520,59,148,.399,20,40,.500,39,108,.361,31,36,.861,10,37,47,33,16,2,25,65,188,3.4
5738,Brandone Francis\brandone-francis-1,2017-18,Texas Tech,G,37,1,566,72,165,.436,39,79,.494,33,86,.384,11,25,.440,17,55,72,30,15,2,26,55,188,3.1
5739,Leland Green\leland-green-1,2016-17,Hawaii,G,27,18,664,70,187,.374,40,104,.385,30,83,.361,18,35,.514,22,72,94,31,16,3,31,77,188,3.5
5740,Braxton Huggins\braxton-huggins-1,2015-16,New Mexico State,G,32,9,456,59,157,.376,27,63,.429,32,94,.340,38,45,.844,9,54,63,34,9,5,35,34,188,3.4
5741,Shivaughn Wiggins\shivaughn-wiggins-1,2016-17,Coastal Carolina,G,19,11,536,59,154,.383,43,94,.457,16,60,.267,54,78,.692,13,38,51,51,12,0,30,26,188,6.4
5742,Gary Browne\gary-browne-1,2013-14,West Virginia,G,32,0,653,57,141,.404,36,78,.462,21,63,.333,53,73,.726,25,51,76,49,30,1,30,52,188,4.7
5743,Aaron Young\aaron-young-1,2014-15,Oral Roberts,G,31,25,724,62,126,.492,33,61,.541,29,65,.446,35,47,.745,6,38,44,60,19,1,35,53,188,4.5
5744,C.J. Rivers\cj-rivers-1,2017-18,Drake,G,34,31,966,74,138,.536,68,113,.602,6,25,.240,34,52,.654,24,177,201,113,39,5,52,34,188,7.1
5745,Kai Healy\kai-healy-1,2015-16,Santa Clara,G,31,22,643,63,157,.401,38,87,.437,25,70,.357,37,44,.841,9,91,100,32,14,8,35,58,188,3.8
5746,Marcel White\marcel-white-1,2014-15,Jacksonville,G,31,3,582,51,125,.408,21,56,.375,30,69,.435,56,81,.691,20,48,68,9,11,7,17,56,188,3.9
5747,Dominique Raney\dominique-raney-1,2013-14,Canisius,G,34,14,529,71,168,.423,55,110,.500,16,58,.276,30,41,.732,14,32,46,21,18,5,27,39,188,3.2
5748,Charles Tucker Jr.\charles-tuckerjr-1,2016-17,Sacred Heart,G,32,32,875,59,142,.415,47,98,.480,12,44,.273,58,83,.699,10,52,62,130,24,2,91,69,188,3.8
5749,Jarod Williams\jarod-williams-1,2016-17,Detroit Mercy,G,30,8,621,65,149,.436,53,106,.500,12,43,.279,46,65,.708,22,83,105,48,25,8,62,85,188,3.7
5750,Solomon Poole\solomon-poole-1,2015-16,Florida Atlantic,G,28,1,538,73,195,.374,50,104,.481,23,91,.253,19,31,.613,12,48,60,41,20,2,50,51,188,2.8
5751,Sviatoslav Mykhailiuk\sviatoslav-mykhailiuk-1,2015-16,Kansas,G,35,0,449,67,149,.450,30,57,.526,37,92,.402,17,25,.680,12,35,47,32,12,5,26,42,188,3.5
5752,Jabbar Singleton\jabbar-singleton-1,2017-18,Southeastern Louisiana,G,29,28,806,59,145,.407,19,46,.413,40,99,.404,30,44,.682,6,38,44,66,26,0,38,45,188,4.7
5753,Luka Pajkovic\luka-pajkovic-1,2013-14,Morehead State,G,33,0,522,54,158,.342,28,58,.483,26,100,.260,54,85,.635,7,49,56,31,26,1,62,45,188,2.3
5754,Eric McGill\eric-mcgill-1,2015-16,Southeast Missouri State,G,27,12,741,70,189,.370,40,97,.412,30,92,.326,18,41,.439,11,53,64,50,38,0,37,42,188,4.3
5755,Aaron Walker\aaron-walker-1,2017-18,Manhattan,G,23,11,480,62,163,.380,43,109,.394,19,54,.352,45,69,.652,9,36,45,46,33,3,55,43,188,4.4
5756,Dre Wills\dre-willis-1,2015-16,Vermont,G,24,6,555,74,134,.552,73,130,.562,1,4,.250,38,72,.528,36,82,118,54,27,13,53,49,187,6.7
5757,Isaiah Coleman-Lands\isaiah-coleman-lands-1,2017-18,Miami (OH),G,34,5,611,64,153,.418,21,46,.457,43,107,.402,16,25,.640,17,46,63,64,23,2,42,54,187,3.9
5758,Michael Onyebalu\michael-onyebalu-1,2017-18,UC-Davis,G,32,31,872,55,123,.447,23,52,.442,32,71,.451,45,56,.804,9,114,123,33,26,1,50,84,187,3.9
5759,Jacob Young\jacob-young-1,2017-18,Texas,G,30,5,503,71,172,.413,41,79,.519,30,93,.323,15,22,.682,6,45,51,22,20,1,19,30,187,3.8
5760,Darrell Davis\darrell-davis-2,2015-16,Dayton,G,32,2,631,67,183,.366,35,73,.479,32,110,.291,21,32,.656,3,73,76,42,11,1,41,53,187,2.6
5761,Ryan Kreklow\ryan-kreklow-1,2015-16,Missouri State,G,28,6,596,57,164,.348,18,51,.353,39,113,.345,34,45,.756,12,50,62,35,21,7,33,62,187,3.8
5762,Barrington Stevens\barrington-stevens-1,2015-16,South Alabama,G,33,33,932,60,170,.353,33,96,.344,27,74,.365,40,53,.755,14,74,88,82,22,1,64,64,187,3.3
5763,Juhwan Harris-Dyson\juhwan-harris-dyson-1,2017-18,University of California,G,30,19,582,70,142,.493,70,129,.543,0,13,.000,47,82,.573,46,56,102,31,34,7,54,73,187,4.3
5764,Austin Tilghman\austin-tilghman-1,2015-16,Monmouth,G,36,0,619,64,115,.557,62,105,.590,2,10,.200,57,96,.594,21,72,93,38,33,0,49,46,187,4.0
5765,Thomas Neff\thomas-neff-1,2015-16,Denver,G,31,31,873,63,148,.426,25,58,.431,38,90,.422,23,36,.639,20,64,84,46,26,7,42,79,187,4.1
5766,Tyler Hubbard\tyler-hubbard-1,2013-14,Loyola (MD),G,30,7,571,59,154,.383,15,33,.455,44,121,.364,25,36,.694,10,40,50,15,11,2,19,49,187,3.4
5767,Marcus Owens\marcus-owens-1,2014-15,Lamar,G,30,22,624,61,176,.347,26,64,.406,35,112,.313,30,46,.652,41,68,109,15,22,3,27,71,187,3.7
5768,Jaron Hopkins\jaron-hopkins-1,2014-15,Colorado,G,32,17,670,73,153,.477,60,114,.526,13,39,.333,28,52,.538,22,85,107,42,32,4,55,66,187,3.9
5769,Clive Allen\clive-allen-1,2016-17,Robert Morris,G,33,2,578,64,173,.370,45,110,.409,19,63,.302,40,56,.714,7,37,44,58,18,18,63,85,187,2.3
5770,Sir Washington\sir-washington-1,2015-16,Eastern Washington,G,33,6,585,63,134,.470,52,94,.553,11,40,.275,50,75,.667,35,57,92,26,20,4,24,75,187,4.2
5771,Phil Gaetano\phil-gaetano-1,2014-15,Sacred Heart,G,32,32,989,55,160,.344,11,42,.262,44,118,.373,33,36,.917,13,85,98,185,28,3,84,69,187,5.6
5772,Ta'Jon Welcome\tajon-welcome-1,2014-15,Northwestern State,G,32,28,504,72,168,.429,50,87,.575,22,81,.272,21,39,.538,18,49,67,32,17,10,28,54,187,3.6
5773,Ryan Frazier\ryan-frazier-1,2014-15,Bucknell,G,34,31,761,50,127,.394,32,78,.410,18,49,.367,69,92,.750,8,46,54,62,17,3,32,61,187,4.0
5774,Meiko Lyles\meiko-lyles-1,2013-14,Columbia,G,33,9,748,61,151,.404,15,41,.366,46,110,.418,19,22,.864,21,100,121,16,19,5,31,51,187,4.0
5775,Christavious Gill\christavious-gill-1,2013-14,New Orleans,G,24,2,476,56,149,.376,30,73,.411,26,76,.342,49,65,.754,23,28,51,31,24,0,26,42,187,5.3
5776,Yosef Yacob\yosef-yacob-1,2014-15,Binghamton,G,32,15,730,53,157,.338,24,57,.421,29,100,.290,52,69,.754,6,27,33,38,19,1,53,52,187,2.4
5777,Emmanuel Chibuogwu\emmanuel-chibuogwu-1,2016-17,Seattle,G,30,30,852,62,163,.380,21,41,.512,41,122,.336,21,31,.677,17,109,126,65,18,12,31,85,186,4.8
5778,Kasim Chandler\kasim-chandler-1,2013-14,Quinnipiac,G,23,0,450,56,149,.376,52,121,.430,4,28,.143,70,100,.700,8,37,45,62,14,2,46,32,186,4.7
5779,DJ Draper\dj-draper-1,2017-18,North Texas,G,34,2,653,58,131,.443,9,13,.692,49,118,.415,21,29,.724,9,39,48,20,23,0,22,63,186,3.6
5780,Chris Robinson\chris-robinson-2,2016-17,Sacred Heart,G,32,8,711,67,169,.396,31,68,.456,36,101,.356,16,21,.762,32,70,102,35,25,2,26,78,186,4.1
5781,Mark Alstork\mark-alstork-1,2017-18,Illinois,G,32,32,724,56,167,.335,37,88,.420,19,79,.241,55,72,.764,42,67,109,59,26,13,44,83,186,4.2
5782,Tim Smallwood\tim-smallwood-1,2015-16,Omaha,G,32,1,521,64,169,.379,21,51,.412,43,118,.364,15,21,.714,12,53,65,20,20,3,25,61,186,3.2
5783,Paul Jorgensen\paul-jorgensen-1,2015-16,George Washington,G,38,2,595,63,177,.356,41,112,.366,22,65,.338,38,53,.717,17,56,73,81,20,2,43,36,186,3.4
5784,Chris Thomas\chris-thomas-6,2017-18,Southern,G,31,22,688,71,188,.378,58,134,.433,13,54,.241,31,62,.500,34,76,110,19,10,10,27,61,186,3.1
5785,D.J. Ursery\dj-ursery-1,2016-17,Pacific,G,31,1,500,68,165,.412,63,149,.423,5,16,.313,45,75,.600,19,53,72,44,7,1,40,57,186,2.9
5786,Jaqawn Raymond\jaqawn-raymond-1,2015-16,Middle Tennessee,G,35,15,829,59,146,.404,27,55,.491,32,91,.352,36,56,.643,13,59,72,64,34,4,46,83,186,3.7
5787,Matt Williams\matt-williams-4,2013-14,Central Florida,G,31,2,608,62,158,.392,6,12,.500,56,146,.384,6,11,.545,14,60,74,29,13,2,25,47,186,3.8
5788,Jeremy Morgan\jeremy-morgan-1,2013-14,Northern Iowa,G,31,10,679,65,154,.422,33,64,.516,32,90,.356,24,31,.774,35,49,84,43,18,15,35,79,186,4.3
5789,Matt Glover\matt-glover-1,2014-15,San Francisco,G,32,27,846,61,152,.401,42,93,.452,19,59,.322,45,96,.469,39,136,175,98,40,9,62,97,186,5.2
5790,Chad Lott\chad-lott-1,2016-17,Rice,G,32,0,628,70,132,.530,67,124,.540,3,8,.375,43,67,.642,27,74,101,51,31,11,43,58,186,5.0
5791,Jordan Andrews\jordan-andrews-1,2017-18,South Alabama,G,30,6,482,51,191,.267,13,45,.289,38,146,.260,46,52,.885,3,45,48,28,16,4,33,44,186,2.5
5792,Schane Rillieux\shane-rillieux-1,2015-16,Nicholls State,G,34,25,912,63,159,.396,53,125,.424,10,34,.294,50,105,.476,8,59,67,96,49,3,75,84,186,3.3
5793,DeAndre Harris\deandre-harris-1,2014-15,North Texas,G,27,4,515,64,172,.372,47,100,.470,17,72,.236,41,73,.562,8,57,65,27,21,3,54,67,186,2.3
5794,L.J. Rose\lj-rose-2,2014-15,Houston,G,19,19,657,64,172,.372,40,91,.440,24,81,.296,34,56,.607,11,37,48,101,17,3,51,44,186,6.4
5795,Nick Coppola\nick-coppola-1,2013-14,Louisiana-Monroe,G,27,27,899,65,174,.374,39,100,.390,26,74,.351,30,45,.667,13,58,71,88,12,0,61,57,186,3.7
5796,Brandon Armstrong\brandon-armstrong-2,2017-18,South Dakota,G,35,0,515,63,148,.426,29,62,.468,34,86,.395,26,37,.703,5,53,58,25,7,1,13,22,186,3.6
5797,Osandai Vaughn\osandai-vaughn-1,2014-15,Youngstown State,G,28,17,572,60,143,.420,40,96,.417,20,47,.426,46,61,.754,27,59,86,18,20,9,24,57,186,4.7
5798,Ty Allen\ty-allen-1,2013-14,Tennessee Tech,G,24,13,461,60,173,.347,38,93,.409,22,80,.275,44,56,.786,5,31,36,19,14,3,36,52,186,2.9
5799,Wil Bathurst\wil-bathurst-1,2016-17,Cornell,G,29,9,621,67,155,.432,56,105,.533,11,50,.220,41,61,.672,15,104,119,51,21,11,41,46,186,4.9
5800,Ismail Ali\ismail-ali-1,2015-16,Bowling Green State,G,34,1,718,48,124,.387,41,99,.414,7,25,.280,82,117,.701,10,61,71,130,28,9,73,81,185,4.4
5801,Malik Dunbar\malik-dunbar-1,2017-18,Auburn,G,34,3,482,70,167,.419,43,89,.483,27,78,.346,18,31,.581,18,65,83,8,13,8,27,65,185,2.8
5802,Patrick Heckmann\patrick-heckmann-1,2013-14,Boston College,G,31,8,500,60,134,.448,33,56,.589,27,78,.346,38,53,.717,11,55,66,26,9,4,27,69,185,3.5
5803,T.J. Dunans\tj-dunans-1,2015-16,Auburn,G,16,14,470,65,141,.461,51,99,.515,14,42,.333,41,59,.695,10,30,40,54,25,17,49,53,185,7.9
5804,Joe Chealey\joe-chealey-1,2013-14,College of Charleston,G,27,10,559,58,159,.365,39,95,.411,19,64,.297,50,75,.667,11,43,54,53,18,7,46,61,185,3.6
5805,T.J. Buchanan\tj-buchanan-1,2013-14,Rhode Island,G,32,14,816,56,122,.459,52,104,.500,4,18,.222,69,106,.651,19,83,102,80,22,7,46,58,185,5.0
5806,Tyrell Corbin\tyrell-corbin-2,2014-15,Cal State Bakersfield,G,33,27,732,57,154,.370,33,86,.384,24,68,.353,47,60,.783,16,59,75,74,30,2,62,36,185,4.0
5807,Cullen Neal\cullen-neal-1,2017-18,Saint Mary's (CA),G,35,0,484,52,138,.377,26,66,.394,26,72,.361,55,69,.797,7,55,62,33,11,0,29,48,185,3.2
5808,Jackson Donahue\jackson-donahue-1,2016-17,Pennsylvania,G,27,17,563,62,183,.339,15,30,.500,47,153,.307,14,22,.636,6,36,42,41,14,0,24,43,185,3.5
5809,John Azzinaro\john-azzinaro-1,2014-15,Bucknell,G,34,13,566,60,180,.333,15,60,.250,45,120,.375,20,26,.769,9,45,54,34,11,1,25,57,185,2.6
5810,Preston Mattingly\preston-mattingly-1,2015-16,Lamar,G,30,13,715,62,117,.530,60,112,.536,2,5,.400,59,85,.694,47,93,140,37,27,6,21,66,185,6.3
5811,Alec Kobre\alec-kobre-1,2014-15,Pacific,G,31,4,525,56,147,.381,11,24,.458,45,123,.366,28,30,.933,5,24,29,14,6,1,15,56,185,3.0
5812,Isaiah Jackson\isaiah-jackson-2,2016-17,Providence,G,33,11,552,64,133,.481,45,86,.523,19,47,.404,38,51,.745,12,68,80,41,18,9,36,47,185,4.2
5813,Laquarious Paige\laguarious-paige-1,2016-17,Indiana State,G,29,23,641,71,152,.467,51,96,.531,20,56,.357,23,27,.852,5,65,70,46,21,13,58,69,185,3.6
5814,Jordan Potts\jordan-potts-1,2013-14,North Carolina-Greensboro,G,28,4,597,53,129,.411,14,29,.483,39,100,.390,40,51,.784,3,62,65,61,22,2,36,74,185,4.7
5815,Troy Caupain\troy-caupain-1,2013-14,Cincinnati,G,34,0,650,54,142,.380,35,84,.417,19,58,.328,58,74,.784,13,66,79,76,31,2,42,50,185,4.5
5816,Chris Clarke\chris-clarke-2,2015-16,Virginia Tech,G,22,10,478,63,135,.467,62,127,.488,1,8,.125,58,86,.674,44,89,133,33,21,1,33,43,185,7.1
5817,Amos Olatayo\amos-olatayo-2,2013-14,Louisiana-Monroe,G,14,11,392,68,150,.453,48,87,.552,20,63,.317,29,51,.569,22,52,74,10,13,8,32,23,185,8.1
5818,Mitch Peterson\mitch-peterson-1,2016-17,Kent State,G,36,25,689,65,184,.353,33,77,.429,32,107,.299,23,34,.676,29,74,103,25,22,9,27,50,185,3.3
5819,Jeff Thomas\jeff-thomas-2,2015-16,Georgia State,G,30,9,492,64,173,.370,24,65,.369,40,108,.370,16,20,.800,21,39,60,12,11,6,14,44,184,3.5
5820,Keaton Moffitt\keaton-moffitt-1,2015-16,South Dakota State,G,33,11,768,73,144,.507,69,132,.523,4,12,.333,34,56,.607,43,101,144,65,25,5,40,74,184,5.1
5821,Matt Taylor\matt-taylor-1,2015-16,New Mexico State,G,34,32,874,68,181,.376,58,138,.420,10,43,.233,38,68,.559,31,90,121,85,16,19,79,75,184,3.0
5822,Bobby Moorehead\bobby-moorehead-1,2015-16,Montana,G,33,0,585,65,160,.406,17,37,.459,48,123,.390,6,11,.545,8,58,66,20,8,3,21,47,184,3.1
5823,Branford Jones\branford-jones--1,2013-14,Cal State Long Beach,G,32,8,595,61,147,.415,36,80,.450,25,67,.373,37,50,.740,8,59,67,59,26,0,30,48,184,4.4
5824,Junior Lomomba\junior-lomomba-1,2015-16,Providence,G,35,35,855,63,156,.404,48,109,.440,15,47,.319,43,64,.672,29,60,89,68,13,1,44,63,184,3.5
5825,Jackson Kent\jackson-kent-1,2013-14,James Madison,G,31,4,660,58,158,.367,34,80,.425,24,78,.308,44,60,.733,6,72,78,25,17,2,50,47,184,2.7
5826,Jahir Cabeza\jahir-cabeza-1,2017-18,Savannah State,G,30,1,508,68,148,.459,42,69,.609,26,79,.329,22,35,.629,32,59,91,24,21,27,24,59,184,5.1
5827,Kaleb Joseph\kaleb-joseph-1,2014-15,Syracuse,G,31,30,847,68,181,.376,61,146,.418,7,35,.200,41,57,.719,14,54,68,119,28,3,72,58,184,3.9
5828,Clemmye Owens\clemmye-owens-1,2014-15,Bethune-Cookman,G,12,6,395,61,148,.412,36,69,.522,25,79,.316,37,50,.740,6,15,21,16,13,0,22,27,184,8.3
5829,Dorrian Williams\dorrian-williams-1,2013-14,Missouri State,G,33,24,890,53,159,.333,28,81,.346,25,78,.321,53,74,.716,11,91,102,112,21,1,47,54,184,4.6
5830,Thatch Unruh\thatch-unruh-1,2014-15,Central Arkansas,G,29,19,596,61,177,.345,19,48,.396,42,129,.326,20,25,.800,18,49,67,39,17,5,46,72,184,2.9
5831,Chazz Patterson\chazz-patterson-1,2016-17,Saint Peter's,G,36,36,990,53,142,.373,21,51,.412,32,91,.352,46,57,.807,14,116,130,64,58,8,41,46,184,5.4
5832,Mike Williams\mike-williams-9,2014-15,Rutgers,G,29,11,643,66,206,.320,42,106,.396,24,100,.240,28,36,.778,20,45,65,34,21,15,20,60,184,3.5
5833,Donte Ingram\donte-ingram-1,2014-15,Loyola (IL),G,37,1,677,71,159,.447,49,100,.490,22,59,.373,20,31,.645,26,90,116,23,10,5,25,59,184,3.3
5834,Mark Cornelius\mark-cornelius-1,2015-16,Massachusetts-Lowell,G,29,16,546,72,127,.567,59,99,.596,13,28,.464,27,46,.587,30,82,112,47,28,1,43,57,184,5.4
5835,Christian Hairston\christian-hairston-1,2014-15,Elon,G,33,5,636,73,118,.619,73,117,.624,0,1,.000,38,55,.691,38,92,130,22,21,4,47,80,184,4.2
5836,Francis Kiapway\francis-kiapway-1,2014-15,Ball State,G,28,20,734,60,161,.373,10,35,.286,50,126,.397,14,20,.700,10,40,50,29,11,0,27,45,184,3.5
5837,Pat Birt\pat-birt-1,2013-14,Illinois-Chicago,G,29,15,563,64,156,.410,40,94,.426,24,62,.387,32,37,.865,11,39,50,23,10,5,22,66,184,3.4
5838,Keenan Evans\keenan-evans-1,2014-15,Texas Tech,G,32,3,582,55,149,.369,39,96,.406,16,53,.302,58,81,.716,13,51,64,44,24,11,43,38,184,3.8
5839,Jayvon Graves\jayvon-graves-1,2017-18,Buffalo,G,36,1,587,65,171,.380,38,88,.432,27,83,.325,27,45,.600,27,55,82,37,17,29,27,56,184,3.7
5840,Cam Miller\cam-miller-1,2015-16,Lipscomb,G,33,20,753,70,128,.547,57,98,.582,13,30,.433,31,49,.633,22,53,75,63,41,8,26,55,184,5.7
5841,Isaiah Blackmon\isaiah-blackmon-1,2015-16,Saint Francis (PA),G,19,4,429,70,130,.538,58,100,.580,12,30,.400,32,45,.711,27,38,65,24,19,5,28,39,184,7.5
5842,Duane Gibson\duane-gibson-1,2014-15,Evansville,G,36,23,667,66,127,.520,66,127,.520,0,0,,52,72,.722,9,48,57,97,36,12,63,102,184,4.0
5843,Chris Jenkins\chris-jenkins-3,2014-15,Detroit Mercy,G,23,8,493,63,140,.450,40,90,.444,23,50,.460,35,52,.673,32,76,108,24,17,6,26,49,184,6.2
5844,Chris Jenkins\chris-jenkins-2,2016-17,NJIT,G,29,9,528,64,170,.376,10,24,.417,54,146,.370,2,3,.667,5,32,37,16,5,1,17,32,184,3.1
5845,YaYa Anderson\yaya-anderson-1,2015-16,Radford,G,26,16,713,63,182,.346,29,73,.397,34,109,.312,24,27,.889,18,50,68,39,14,1,22,34,184,4.4
5846,Isaac McGlone\isaac-mcglone-1,2014-15,Eastern Kentucky,G,33,27,953,64,164,.390,22,41,.537,42,123,.341,13,20,.650,7,67,74,86,56,2,36,71,183,5.1
5847,Darin Johnson\darin-johnson-1,2013-14,Washington,G,31,1,499,56,156,.359,43,102,.422,13,54,.241,58,74,.784,12,38,50,18,12,6,32,37,183,3.0
5848,Greg Pryor\greg-pryor-1,2013-14,Chattanooga,G,33,33,683,57,181,.315,46,118,.390,11,63,.175,58,72,.806,15,44,59,67,33,0,51,76,183,2.9
5849,Rich Williams\rich-williams-1,2014-15,Manhattan,G,33,12,536,67,183,.366,33,76,.434,34,107,.318,15,23,.652,18,31,49,28,28,1,34,70,183,2.6
5850,Dwayne Lautier-Ogunleye\dwayne-lautier-ogunleye-1,2016-17,Bradley,G,30,9,596,50,127,.394,34,86,.395,16,41,.390,67,103,.650,13,75,88,47,22,2,46,56,183,4.0
5851,Preston Bungei\preston-bungei-1,2015-16,Norfolk State,G,34,12,553,63,136,.463,62,127,.488,1,9,.111,56,77,.727,41,71,112,29,14,32,44,77,183,4.0
5852,Michael Kolawole\michael-kolawole-1,2016-17,Illinois-Chicago,G,35,13,562,68,147,.463,64,125,.512,4,22,.182,43,58,.741,18,52,70,41,9,2,53,29,183,3.0
5853,Dusty Baker\dusty-baker-1,2015-16,Weber State,G,34,11,621,54,140,.386,30,79,.380,24,61,.393,51,63,.810,16,68,84,62,16,4,50,43,183,3.8
5854,Joe Toye\joe-toye-1,2017-18,Vanderbilt,G,32,9,602,68,170,.400,48,94,.511,20,76,.263,27,44,.614,17,48,65,26,9,9,42,66,183,2.4
5855,Caleb Crayton\caleb-crayton-1,2015-16,Houston Baptist,G,34,12,631,62,148,.419,42,77,.545,20,71,.282,39,61,.639,29,65,94,39,13,2,44,70,183,3.1
5856,Ian Boyd\ian-boyd-2,2016-17,George Mason,G,31,4,589,60,152,.395,45,95,.474,15,57,.263,48,66,.727,34,42,76,20,23,6,26,70,183,3.8
5857,Torey Noel\torey-noel-1,2016-17,Lamar,G,32,11,548,56,150,.373,41,102,.402,15,48,.313,56,88,.636,10,38,48,88,37,3,57,72,183,3.8
5858,Rakiya Battle\rakiya-battle-1,2015-16,Alabama A&M,G,29,24,756,50,155,.323,33,95,.347,17,60,.283,66,84,.786,16,54,70,153,25,2,59,40,183,6.0
5859,Ty-Shon Alexander\ty-shon-alexander-1,2017-18,Creighton,G,33,1,584,61,146,.418,29,50,.580,32,96,.333,29,41,.707,6,63,69,58,9,4,41,31,183,3.7
5860,Elijah Pughsley\elijah-pughsley-1,2016-17,Western Carolina,G,28,6,550,56,215,.260,19,75,.253,37,140,.264,34,51,.667,7,49,56,47,9,1,65,54,183,0.8
5861,Cody Wichmann\cody-wichmann-1,2014-15,Milwaukee,G,30,3,669,62,150,.413,15,33,.455,47,117,.402,12,15,.800,17,51,68,32,19,8,21,52,183,4.5
5862,Marcus Dickinson\marcus-dickinson-1,2017-18,Boise State,G,32,0,675,51,144,.354,18,52,.346,33,92,.359,47,59,.797,2,74,76,44,12,0,31,56,182,3.4
5863,PJ Savoy\pj-savoy-1,2017-18,Florida State,G,27,4,355,58,158,.367,8,23,.348,50,135,.370,16,22,.727,5,33,38,15,6,1,17,28,182,3.5
5864,Jake Kocher\jake-kocher-1,2013-14,Texas A&M-Corpus Christi,G,32,3,549,69,146,.473,54,99,.545,15,47,.319,29,40,.725,27,53,80,25,46,3,27,42,182,5.0
5865,Devonte Boykins\devonte-boykins-1,2015-16,Georgia Southern,G,31,10,729,56,157,.357,39,92,.424,17,65,.262,53,75,.707,13,56,69,56,18,3,33,55,182,3.7
5866,Idris Taqqee\idris-taqqee-1,2017-18,St. Bonaventure,G,34,33,964,71,163,.436,65,145,.448,6,18,.333,34,59,.576,63,116,179,52,39,25,23,91,182,5.8
5867,Rakiya Battle\rakiya-battle-1,2016-17,Alabama A&M,G,29,28,910,59,212,.278,42,142,.296,17,70,.243,47,69,.681,15,79,94,138,30,2,84,54,182,3.6
5868,Nick Wiggins\nick-wiggins-1,2013-14,Wichita State,G,36,0,546,58,161,.360,36,74,.486,22,87,.253,44,75,.587,21,61,82,20,9,9,30,45,182,2.6
5869,Tre'Shaun Fletcher\treshaun-fletcher-1,2014-15,Colorado,G,34,17,622,65,143,.455,43,95,.453,22,48,.458,30,42,.714,28,58,86,34,11,3,42,46,182,3.4
5870,Parker Jackson-Cartwright\parker-jackson-cartwright-1,2016-17,Arizona,G,31,10,773,57,133,.429,27,62,.435,30,71,.423,38,54,.704,10,66,76,127,37,4,41,55,182,6.4
5871,Payton Hulsey\payton-hulsey-2,2017-18,Florida Atlantic,G,28,16,723,62,178,.348,55,151,.364,7,27,.259,51,76,.671,29,98,127,96,42,1,73,71,182,4.7
5872,Jeffrey Altidort\jeffrey-altidort-1,2016-17,Bethune-Cookman,G,31,11,690,62,161,.385,43,109,.394,19,52,.365,39,68,.574,10,51,61,96,28,7,74,64,182,3.4
5873,Curran Scott\curran-scott-1,2017-18,Tulsa,G,31,8,461,53,133,.398,35,82,.427,18,51,.353,58,69,.841,17,49,66,21,10,1,35,37,182,3.5
5874,Bosko Kostur\bosco-kostur-1,2014-15,Bryant,G,23,12,460,61,124,.492,38,75,.507,23,49,.469,37,49,.755,21,51,72,13,5,0,28,62,182,4.6
5875,Bryan Sekunda\bryan-sekunda-1,2015-16,Stony Brook,G,25,16,500,64,159,.403,17,41,.415,47,118,.398,7,9,.778,11,29,40,34,10,1,17,24,182,4.8
5876,Anthony Black\anthony-black-2,2017-18,Little Rock,G,26,13,543,71,169,.420,38,75,.507,33,94,.351,7,11,.636,10,46,56,42,25,0,21,40,182,5.0
5877,Nick Gruninger\nick-gruninger-1,2013-14,UC-Riverside,G,29,14,649,56,149,.376,33,91,.363,23,58,.397,47,55,.855,5,69,74,75,34,0,39,64,182,4.9
5878,Triston Simpson\triston-simpson-1,2016-17,South Dakota,G,34,0,738,52,131,.397,33,81,.407,19,50,.380,59,79,.747,22,68,90,85,18,0,36,54,182,4.7
5879,Sam Hunt\sam-hunt-1,2017-18,North Carolina State,G,33,7,530,57,135,.422,6,13,.462,51,122,.418,17,18,.944,3,24,27,9,14,0,10,39,182,3.5
5880,Joe Mooney\joe-mooney-1,2017-18,UC-Davis,G,28,1,526,65,156,.417,27,55,.491,38,101,.376,14,22,.636,9,36,45,25,25,1,25,42,182,4.1
5881,Lysander Bracey\lysander-bracey-1,2017-18,Hampton,G,34,6,490,59,142,.415,19,36,.528,40,106,.377,24,30,.800,6,34,40,15,8,6,21,30,182,3.2
5882,Marcus Jackson\marcus-jackson-6,2013-14,Rice,G,27,20,697,56,174,.322,30,75,.400,26,99,.263,44,59,.746,8,51,59,87,26,2,53,35,182,4.4
5883,Max Joseph\max-joseph-1,2016-17,Valparaiso,G,32,4,705,60,145,.414,39,82,.476,21,63,.333,41,57,.719,28,65,93,57,27,10,32,77,182,4.6
5884,Carlos Johnson\carlos-johnson-1,2016-17,Washington,G,31,4,555,71,175,.406,64,143,.448,7,32,.219,33,54,.611,45,47,92,21,9,7,38,72,182,2.8
5885,Nate Kennell\nate-kennell-1,2016-17,Bradley,G,32,16,572,59,139,.424,28,64,.438,31,75,.413,32,44,.727,4,56,60,53,16,6,43,73,181,3.4
5886,Rob Ukawuba\rob-ukawuba-1,2014-15,NJIT,G,28,0,531,63,121,.521,46,81,.568,17,40,.425,38,59,.644,26,70,96,26,18,6,22,63,181,5.2
5887,Kemy Osse\kemy-osse-1,2015-16,Little Rock,G,35,24,579,62,171,.363,17,54,.315,45,117,.385,12,20,.600,12,59,71,27,33,7,16,41,181,3.8
5888,Bryan Sekunda\bryan-sekunda-1,2016-17,Stony Brook,G,31,0,634,59,184,.321,11,35,.314,48,149,.322,15,21,.714,26,41,67,29,16,10,14,43,181,3.7
5889,Malik Thames\malik-thames-1,2016-17,UC-Riverside,G,22,11,622,60,169,.355,31,84,.369,29,85,.341,32,42,.762,8,70,78,45,27,4,34,36,181,5.6
5890,Jerron Wilbut\jerron-wilbut-1,2015-16,Cal State Northridge,G,19,0,329,64,162,.395,39,77,.506,25,85,.294,28,39,.718,10,17,27,17,13,2,32,49,181,4.0
5891,Demetrius Jackson\demetrius-jackson-2,2013-14,Notre Dame,G,30,15,666,55,131,.420,30,71,.423,25,60,.417,46,59,.780,15,49,64,55,12,1,37,58,181,4.1
5892,Nate Britt\nate-britt-1,2016-17,North Carolina,G,40,7,759,64,181,.354,38,103,.369,26,78,.333,27,37,.730,11,62,73,94,41,2,37,71,181,3.6
5893,Avery Moore\avery-moore-1,2013-14,Jacksonville State,G,22,12,465,57,155,.368,18,44,.409,39,111,.351,28,33,.848,4,29,33,31,18,0,27,31,181,4.8
5894,K'ja Johnson\kja-johnson-1,2015-16,Florida A&M,G,24,9,675,60,159,.377,41,94,.436,19,65,.292,42,77,.545,9,53,62,60,27,6,58,45,181,4.1
5895,Dana Raysor\dana-raysor-1,2016-17,Delaware State,G,28,4,472,52,133,.391,9,27,.333,43,106,.406,34,48,.708,9,35,44,27,12,2,28,45,181,3.8
5896,Tobi Ewuosho\tobi-ewuosho-1,2017-18,Alabama State,G,30,20,660,64,153,.418,55,129,.426,9,24,.375,44,75,.587,39,89,128,43,27,5,49,79,181,4.0
5897,Dwight Meikle\dwight-meikle-1,2013-14,Hampton,G,31,1,447,67,139,.482,62,125,.496,5,14,.357,42,61,.689,43,63,106,13,15,17,36,65,181,4.1
5898,Trey Norris\trey-norris-1,2014-15,South Dakota,G,33,0,803,59,127,.465,48,91,.527,11,36,.306,52,71,.732,9,37,46,89,29,0,33,81,181,4.6
5899,Jax Levitch\jax-levitch-1,2017-18,Purdue-Fort Wayne,G,33,32,873,55,130,.423,8,21,.381,47,109,.431,24,37,.649,24,111,135,34,30,9,20,55,181,5.3
5900,Payton Willis\payton-willis-1,2016-17,Vanderbilt,G,35,12,614,62,142,.437,37,62,.597,25,80,.313,32,51,.627,12,51,63,64,16,6,56,35,181,3.4
5901,Kedren Johnson\kedren-johnson-1,2014-15,Memphis,G,27,17,634,58,144,.403,34,76,.447,24,68,.353,41,50,.820,8,50,58,74,11,5,54,57,181,4.1
5902,Kevin Booze\kevin-booze-1,2014-15,Lamar,G,29,13,534,52,149,.349,24,71,.338,28,78,.359,49,60,.817,8,34,42,85,25,0,55,70,181,3.8
5903,Amar Stukes\amar-stukes-1,2015-16,La Salle,G,31,28,954,62,202,.307,42,137,.307,20,65,.308,37,56,.661,11,59,70,100,40,3,42,86,181,3.8
5904,Malcolm Drumwright\malcolm-drumwright-1,2014-15,Jacksonville State,G,30,9,653,61,167,.365,41,101,.406,20,66,.303,39,47,.830,6,37,43,47,22,3,31,58,181,3.4
5905,Sean Hill\sean-hill-1,2014-15,Chicago State,G,22,14,547,65,180,.361,44,105,.419,21,75,.280,29,38,.763,11,36,47,46,25,3,43,41,180,4.3
5906,Terrell Brown\terrell-brown-4,2016-17,San Jose State,G,25,9,541,53,150,.353,36,98,.367,17,52,.327,57,76,.750,8,33,41,43,17,1,36,52,180,3.8
5907,Michael Zeno\michael-zeno-1,2017-18,New Orleans,G,33,17,599,65,187,.348,65,183,.355,0,4,.000,50,82,.610,30,73,103,45,27,11,54,49,180,3.0
5908,Nyles Evans\nyles-evans-1,2013-14,Akron,G,34,17,705,55,165,.333,17,45,.378,38,120,.317,32,49,.653,8,50,58,49,23,5,35,64,180,3.0
5909,Jordon King\jordon-king-1,2017-18,Purdue-Fort Wayne,G,33,0,374,64,136,.471,33,58,.569,31,78,.397,21,43,.488,9,47,56,12,18,3,26,45,180,3.2
5910,Deshaun Morman\deshaun-morman-1,2017-18,Towson,G,23,0,477,58,117,.496,46,89,.517,12,28,.429,52,65,.800,14,51,65,35,29,8,40,42,180,6.2
5911,Ishaq Pitt\ishaq-pitt-1,2014-15,Maryland-Eastern Shore,G,33,21,830,64,137,.467,63,132,.477,1,5,.200,51,99,.515,35,89,124,137,38,6,71,61,180,5.6
5912,JaMarcus Weatherspoon\jamarcus-witherspoon-1,2014-15,Texas State,G,31,15,611,62,151,.411,60,138,.435,2,13,.154,54,82,.659,34,61,95,18,18,9,39,65,180,3.3
5913,Ore Arogundade\ore-arogundade-1,2015-16,Drake,G,31,14,736,67,163,.411,44,100,.440,23,63,.365,23,30,.767,15,124,139,23,26,4,28,55,180,4.3
5914,Ghiavonni Robinson\ghiavonni-robinson-1,2013-14,Arkansas-Pine Bluff,G,29,28,722,58,194,.299,15,60,.250,43,134,.321,21,29,.724,14,53,67,25,26,3,34,61,180,2.7
5915,Darian Bryant\darian-bryant-1,2017-18,Delaware,G,31,15,919,74,181,.409,54,104,.519,20,77,.260,12,31,.387,14,66,80,53,22,6,41,50,180,3.5
5916,Jahlil Nails\jahlil-nails-1,2015-16,Central Connecticut State,G,27,12,535,55,140,.393,21,53,.396,34,87,.391,36,46,.783,9,45,54,12,8,1,28,35,180,3.5
5917,Jalen Avery\jalen-avery-1,2016-17,Kent State,G,35,25,850,51,139,.367,18,54,.333,33,85,.388,45,58,.776,14,53,67,76,14,0,20,23,180,4.6
5918,Shawn Amiker\shawn-amiker-1,2013-14,Youngstown State,G,32,4,512,66,108,.611,63,100,.630,3,8,.375,45,62,.726,22,50,72,20,13,6,34,75,180,3.8
5919,Aaron Young\aaron-young-1,2016-17,Oral Roberts,G,28,12,691,57,141,.404,28,59,.475,29,82,.354,37,42,.881,8,49,57,30,17,3,24,74,180,3.9
5920,John Marshall\john-marshall-1,2015-16,Southern Utah,G,30,16,622,56,127,.441,44,98,.449,12,29,.414,56,75,.747,15,49,64,69,25,2,35,64,180,4.8
5921,Chris Harrison-Docks\chris-harrison-docks-1,2015-16,Western Kentucky,G,18,1,431,58,148,.392,20,48,.417,38,100,.380,26,33,.788,3,15,18,35,8,0,19,25,180,5.9
5922,Chivarsky Corbett\chivarsky-corbett-1,2016-17,Delaware,G,28,15,517,64,154,.416,30,56,.536,34,98,.347,18,31,.581,17,66,83,13,12,6,18,37,180,4.2
5923,Cullen VanLeer\cullen-vanleer-1,2016-17,Missouri,G,32,17,759,58,160,.363,14,28,.500,44,132,.333,20,24,.833,6,51,57,43,23,8,26,66,180,3.6
5924,Tim Peete\tim-peete-1,2013-14,Tulsa,G,34,33,757,62,139,.446,45,86,.523,17,53,.321,39,55,.709,24,88,112,58,36,5,41,51,180,4.8
5925,Isaac White\isaac-white-2,2017-18,Stanford,G,33,9,550,56,152,.368,18,40,.450,38,112,.339,30,40,.750,1,40,41,25,6,0,28,22,180,2.8
5926,Zane Martin\zane-martin-1,2016-17,Towson,G,33,1,468,64,166,.386,47,113,.416,17,53,.321,35,49,.714,14,43,57,33,22,2,38,44,180,3.0
5927,A.J. Astroth\aj-astroth-1,2016-17,Hampton,G,28,8,514,67,134,.500,64,119,.538,3,15,.200,43,67,.642,58,116,174,18,17,6,26,47,180,6.0
5928,Lance Potier\lance-potier-1,2016-17,McNeese State,G,26,23,655,73,149,.490,58,102,.569,15,47,.319,19,31,.613,32,132,164,26,9,12,36,81,180,5.0
5929,Robert Hatter\robert-hatter-1,2013-14,Cornell,G,20,16,397,67,165,.406,40,91,.440,27,74,.365,19,41,.463,7,24,31,41,5,1,40,51,180,3.4
5930,Lucas Williamson\lucas-williamson-1,2017-18,Loyola (IL),G,38,5,768,54,124,.435,20,42,.476,34,82,.415,38,54,.704,13,72,85,38,30,10,29,74,180,3.8
5931,Dashawn Richmond\dashawn-richmond-1,2014-15,Cal State Bakersfield,G,29,5,463,59,147,.401,33,80,.413,26,67,.388,36,50,.720,19,54,73,19,17,3,30,65,180,3.5
5932,Unique McLean\unique-mclean-1,2017-18,Massachusetts,G,33,20,859,74,201,.368,60,149,.403,14,52,.269,18,31,.581,48,114,162,59,24,13,40,85,180,4.0
5933,Tra'von Joseph\travon-joseph-1,2014-15,Northwestern State,G,30,19,565,66,114,.579,60,101,.594,6,13,.462,42,64,.656,53,82,135,26,16,7,39,68,180,5.1
5934,Tony Kynard\tony-kynard-1,2013-14,Bethune-Cookman,G,32,6,641,61,187,.326,58,155,.374,3,32,.094,54,65,.831,25,49,74,99,43,3,64,65,179,3.9
5935,Abdoulaye Harouna\abdoulaye-harouna-1,2015-16,Miami (OH),G,33,18,630,57,157,.363,24,60,.400,33,97,.340,32,45,.711,6,53,59,14,26,5,38,64,179,2.5
5936,Landon Drew\landon-drew-1,2013-14,Cal State Northridge,G,35,26,820,61,152,.401,38,87,.437,23,65,.354,34,45,.756,8,46,54,114,26,6,62,92,179,3.5
5937,Elijah Gonzales\elijah-gonzales-1,2017-18,Saint Peter's,G,29,19,671,68,161,.422,43,92,.467,25,69,.362,18,32,.563,7,57,64,87,46,1,55,48,179,4.9
5938,Jalyn Patterson\jalyn-patterson-1,2016-17,Louisiana State,G,31,10,689,65,171,.380,36,71,.507,29,100,.290,20,32,.625,14,80,94,93,38,3,54,41,179,4.8
5939,Peter Moller\peter-moller-1,2014-15,Liberty,G,25,19,630,67,159,.421,46,94,.489,21,65,.323,24,35,.686,7,51,58,31,11,0,45,21,179,3.6
5940,Jordan Griffin\jordan-griffin-2,2017-18,Cal State Long Beach,G,33,7,496,61,153,.399,18,41,.439,43,112,.384,14,16,.875,7,39,46,15,7,1,17,9,179,3.3
5941,Deshawn Delaney\deshawn-delaney-1,2013-14,New Mexico,G,34,23,680,72,134,.537,56,86,.651,16,48,.333,19,39,.487,36,101,137,54,23,9,23,52,179,5.4
5942,Kyle Castlin\kyle-castlin-1,2017-18,Columbia,G,17,5,418,63,127,.496,48,84,.571,15,43,.349,38,43,.884,19,46,65,24,22,4,19,34,179,8.8
5943,Kaelon Wilson\kaelon-wilson-1,2014-15,Texas-Arlington,G,31,6,608,66,150,.440,49,96,.510,17,54,.315,30,51,.588,32,75,107,17,11,19,30,65,179,3.8
5944,Durrell McDonald\durrell-mcdonald-1,2013-14,DePaul,G,33,7,647,65,159,.409,38,94,.404,27,65,.415,22,33,.667,18,42,60,39,37,4,31,74,179,3.7
5945,Jarvis Garrett\jarvis-garrett-1,2017-18,Rhode Island,G,34,10,694,63,155,.406,35,82,.427,28,73,.384,25,36,.694,23,57,80,78,23,0,34,59,179,4.3
5946,Zac Seljaas\zac-seljaas-1,2017-18,Brigham Young,G,35,11,696,66,145,.455,43,67,.642,23,78,.295,24,29,.828,15,49,64,49,13,10,27,61,179,3.7
5947,C.J. Jackson\cj-jackson-1,2016-17,Ohio State,G,32,9,611,58,147,.395,32,66,.485,26,81,.321,37,55,.673,13,66,79,92,27,0,42,52,179,4.7
5948,Chancellor Barnard\chancellor-barnard-1,2015-16,Loyola (MD),G,28,22,617,70,115,.609,68,107,.636,2,8,.250,37,53,.698,40,58,98,21,12,19,28,74,179,5.3
5949,Aaron Simpson\aaron-simpson-1,2015-16,DePaul,G,30,20,718,60,160,.375,23,69,.333,37,91,.407,22,32,.688,16,64,80,49,22,3,34,69,179,3.8
5950,Derrick Wilson\derrick-wilson-1,2014-15,Marquette,G,32,27,1053,68,165,.412,59,126,.468,9,39,.231,34,72,.472,29,97,126,150,38,10,51,65,179,6.2
5951,Stevie Clark\stevie-clark-1,2016-17,Oakland,G,27,18,495,52,143,.364,31,67,.463,21,76,.276,54,63,.857,5,52,57,108,32,1,58,49,179,5.4
5952,James White\james-white-2,2014-15,Little Rock,G,15,14,407,67,148,.453,66,147,.449,1,1,1.000,44,61,.721,35,64,99,13,8,25,30,45,179,8.4
5953,Myles Davis\myles-davis-1,2013-14,Xavier,G,34,2,609,54,161,.335,13,37,.351,41,124,.331,30,45,.667,4,48,52,29,15,1,20,45,179,2.9
5954,Tyrone Johnson\ty-johnson-1,2013-14,South Carolina,G,16,10,430,52,133,.391,44,114,.386,8,19,.421,67,89,.753,10,37,47,55,10,1,30,25,179,7.8
5955,Andre Spight\andre-spight-1,2015-16,Arizona State,G,27,8,526,60,177,.339,24,63,.381,36,114,.316,23,29,.793,7,17,24,34,13,0,20,42,179,3.2
5956,Derrico Peck\derrico-peck-1,2016-17,Maryland-Eastern Shore,G,34,5,741,78,120,.650,78,119,.655,0,1,.000,23,52,.442,58,82,140,24,30,44,37,93,179,5.4
5957,Ron Trapps\ron-trapps-1,2016-17,North Carolina Central,G,34,2,565,62,179,.346,25,59,.424,37,120,.308,18,24,.750,20,63,83,22,18,2,22,39,179,3.1
5958,Atif Russell\atif-russell-1,2014-15,Pepperdine,G,32,22,619,62,154,.403,48,110,.436,14,44,.318,41,54,.759,24,70,94,29,17,4,22,57,179,3.9
5959,Mark Smith\mark-smith-5,2017-18,Illinois,G,31,18,591,60,178,.337,44,109,.404,16,69,.232,43,54,.796,18,24,42,42,18,2,39,77,179,2.3
5960,Keith Frazier\keith-frazier-1,2014-15,Southern Methodist,G,17,16,473,61,136,.449,38,67,.567,23,69,.333,34,42,.810,10,58,68,23,14,6,21,26,179,7.8
5961,Everson Davis\everson-davis-1,2016-17,Binghamton,G,32,17,541,58,155,.374,51,127,.402,7,28,.250,55,76,.724,17,63,80,36,13,4,30,48,178,3.3
5962,Todd Johnson\todd-johnson-1,2014-15,Northern Kentucky,G,29,4,550,60,155,.387,8,18,.444,52,137,.380,6,13,.462,8,49,57,32,29,1,19,47,178,4.3
5963,Joey McLean\joey-mclean-1,2015-16,James Madison,G,31,11,621,62,145,.428,32,69,.464,30,76,.395,24,29,.828,8,34,42,54,17,2,31,69,178,3.6
5964,Green Hill\green-hill-1,2013-14,Alabama A&M,G,30,2,572,47,125,.376,39,91,.429,8,34,.235,76,102,.745,20,42,62,68,13,0,38,57,178,4.2
5965,Traci Carter\traci-carter-1,2015-16,Marquette,G,33,19,790,54,157,.344,32,87,.368,22,70,.314,48,65,.738,14,68,82,153,47,5,77,99,178,4.7
5966,Chris Martin\chris-martin-3,2014-15,Mount St. Mary's,G,24,7,539,68,189,.360,39,90,.433,29,99,.293,13,16,.813,10,50,60,18,15,0,20,26,178,3.8
5967,Taylor Sutlive\taylor-sutlive-1,2015-16,Cal Poly,G,29,15,624,63,148,.426,17,33,.515,46,115,.400,6,9,.667,14,38,52,43,23,6,16,48,178,4.9
5968,Jerome Segura\jerome-segura-1,2016-17,Fairfield,G,30,30,918,69,177,.390,56,125,.448,13,52,.250,27,49,.551,15,70,85,122,32,1,77,63,178,4.0
5969,Kevin Dorsey\kevin-dorsey-1,2015-16,Minnesota,G,26,0,484,58,161,.360,50,118,.424,8,43,.186,54,75,.720,11,49,60,37,12,6,36,43,178,3.5
5970,Jordan Stevens\jordan-stevens-2,2014-15,Duquesne,G,20,0,375,69,186,.371,47,106,.443,22,80,.275,18,26,.692,6,26,32,53,11,2,36,13,178,4.6
5971,John Ogwuche\john-ogwuche-1,2017-18,New Hampshire,G,30,19,671,59,146,.404,29,65,.446,30,81,.370,30,38,.789,21,66,87,29,14,6,25,52,178,4.1
5972,Parker Jackson-Cartwright\parker-jackson-cartwright-1,2015-16,Arizona,G,34,6,722,57,142,.401,30,70,.429,27,72,.375,37,57,.649,9,47,56,116,21,7,48,73,178,4.2
5973,Jordan Johnson\jordan-johnson-2,2013-14,Tennessee Tech,G,33,18,573,56,159,.352,15,42,.357,41,117,.350,25,38,.658,3,43,46,29,25,3,36,43,178,2.8
5974,Max Hazzard\max-hazzard-1,2016-17,UC-Irvine,G,36,16,560,63,159,.396,38,77,.494,25,82,.305,27,44,.614,10,50,60,48,15,1,35,56,178,2.8
5975,Patrick Steeves\patrick-steeves-1,2016-17,George Washington,G,27,11,505,68,141,.482,64,121,.529,4,20,.200,38,52,.731,26,52,78,30,15,11,31,34,178,5.0
5976,Felix Balamou\felix-balamou-1,2015-16,St. John's (NY),G,26,13,591,71,160,.444,70,155,.452,1,5,.200,35,59,.593,29,57,86,62,18,5,48,71,178,4.3
5977,Ben Marcus\ben-marcus-1,2017-18,Little Rock,G,30,8,495,77,114,.675,77,114,.675,0,0,,24,59,.407,38,68,106,18,17,9,37,66,178,4.5
5978,Dominique Hawkins\dominique-hawkins-1,2016-17,Kentucky,G,38,4,731,56,139,.403,34,75,.453,22,64,.344,44,53,.830,23,39,62,64,30,0,18,78,178,4.0
5979,Devonte Brown\devonte-brown-1,2013-14,Indiana State,G,34,4,656,52,124,.419,44,95,.463,8,29,.276,66,99,.667,13,71,84,57,37,5,44,74,178,4.0
5980,Justin Massey\justin-massey-1,2016-17,Florida Atlantic,G,22,0,430,58,148,.392,29,62,.468,29,86,.337,33,43,.767,10,30,40,16,13,0,21,23,178,4.7
5981,Jaycee Hillsman\jaycee-hillsman-1,2016-17,San Jose State,G,30,18,570,53,115,.461,43,80,.538,10,35,.286,62,75,.827,26,52,78,29,10,4,48,61,178,3.6
5982,Markel Crawford\markel-crawford-1,2014-15,Memphis,G,30,22,682,67,166,.404,42,83,.506,25,83,.301,19,26,.731,16,54,70,54,32,3,36,54,178,4.3
5983,Justin Mitchell\justin-mitchell-1,2017-18,Wright State,G,16,14,443,68,157,.433,64,138,.464,4,19,.211,38,54,.704,23,90,113,50,31,5,59,40,178,7.9
5984,Mason Faulkner\mason-faulkner-1,2017-18,Northern Kentucky,G,32,0,548,58,141,.411,26,51,.510,32,90,.356,30,34,.882,7,52,59,73,24,0,44,55,178,4.1
5985,Darien Fernandez\darien-fernandez-1,2015-16,Jacksonville,G,32,10,741,59,179,.330,27,80,.338,32,99,.323,28,44,.636,20,88,108,86,54,1,46,90,178,4.5
5986,Jalen White\jalen-white-1,2013-14,South Carolina State,G,23,17,517,58,158,.367,56,141,.397,2,17,.118,60,78,.769,18,41,59,56,14,3,48,41,178,4.3
5987,Jeremy Lieberman\jeremy-lieberman-1,2016-17,Wyoming,G,37,37,836,69,163,.423,42,72,.583,27,91,.297,13,17,.765,8,67,75,88,33,2,46,94,178,3.5
5988,Landon Drew\landon-drew-1,2014-15,Cal State Northridge,G,31,31,819,63,179,.352,33,90,.367,30,89,.337,22,32,.688,7,62,69,139,25,1,56,75,178,4.3
5989,Johnny Hill\johnny-hill-2,2015-16,Purdue,G,35,11,619,58,108,.537,56,99,.566,2,9,.222,59,71,.831,42,50,92,81,35,11,46,61,177,5.5
5990,Asa Cantwell\asa-cantwell-1,2015-16,Houston Baptist,G,34,2,485,57,142,.401,8,16,.500,49,126,.389,14,19,.737,4,34,38,27,14,0,22,49,177,3.0
5991,Sterling Brown\sterling-brown-2,2014-15,Southern Methodist,G,34,17,814,64,122,.525,44,77,.571,20,45,.444,29,37,.784,51,104,155,70,29,8,31,63,177,6.1
5992,Shembari Phillips\shembari-phillips-1,2015-16,Tennessee,G,33,11,535,60,147,.408,39,90,.433,21,57,.368,36,47,.766,14,47,61,32,8,5,45,72,177,2.4
5993,Pat Benzan\pat-benzan-1,2017-18,Holy Cross,G,28,14,764,57,139,.410,52,112,.464,5,27,.185,58,73,.795,14,79,93,58,30,0,34,52,177,5.2
5994,Bjorn Broman\bjorn-broman-1,2016-17,Winthrop,G,33,29,913,56,156,.359,11,27,.407,45,129,.349,20,27,.741,8,47,55,72,26,6,35,59,177,3.9
5995,Jalen Poyser\jalen-poyser-1,2015-16,Nevada-Las Vegas,G,33,1,534,58,155,.374,37,96,.385,21,59,.356,40,61,.656,18,50,68,37,18,1,36,50,177,3.0
5996,P.J. Hardy\pj-hardy-1,2016-17,Louisiana,G,33,0,505,60,135,.444,15,33,.455,45,102,.441,12,20,.600,8,28,36,34,11,7,31,41,177,3.3
5997,Remond Brown\remond-brown-1,2014-15,Grambling,G,29,25,814,66,193,.342,65,179,.363,1,14,.071,44,67,.657,27,66,93,39,35,4,58,62,177,2.8
5998,Hunter Janacek\hunter-janacek-1,2016-17,Lafayette,G,30,12,545,54,156,.346,13,35,.371,41,121,.339,28,31,.903,9,48,57,24,12,0,24,33,177,3.4
5999,Emarius Logan\emarius-logan-1,2015-16,Appalachian State,G,31,0,578,58,159,.365,35,93,.376,23,66,.348,38,48,.792,18,42,60,38,7,2,56,33,177,2.4
6000,Ty Gibson\ty-gibson-1,2016-17,Eastern Washington,G,34,7,588,52,109,.477,4,10,.400,48,99,.485,25,29,.862,3,50,53,25,12,2,10,60,177,3.9
6001,Evan Gordon\evan-gordon-1,2013-14,Indiana,G,32,3,654,56,140,.400,38,86,.442,18,54,.333,47,58,.810,18,54,72,46,25,10,36,58,177,4.1
6002,Mike Anderson\mike-anderson-2,2013-14,Washington,G,32,18,816,50,119,.420,39,81,.481,11,38,.289,66,89,.742,47,130,177,56,16,8,36,90,177,5.2
6003,Ryan McMahon\ryan-mcmahon-1,2017-18,Louisville,G,29,0,451,54,128,.422,12,25,.480,42,103,.408,27,32,.844,5,27,32,44,25,2,30,48,177,4.4
6004,Mack Foster\mack-foster-1,2014-15,Louisiana-Monroe,G,38,8,676,68,172,.395,45,94,.479,23,78,.295,18,32,.563,18,49,67,34,23,9,30,54,177,2.8
6005,Jordan Burgess\jordan-burgess-1,2014-15,Virginia Commonwealth,G,35,29,779,59,162,.364,35,71,.493,24,91,.264,35,65,.538,39,113,152,27,21,17,27,63,177,3.9
6006,TeNale Roland\tenale-roland-1,2013-14,Utah State,G,32,20,725,58,147,.395,20,55,.364,38,92,.413,23,34,.676,12,43,55,89,12,1,27,61,177,4.3
6007,D.J. Brown\dj-brown-1,2013-14,San Jose State,G,31,14,655,53,147,.361,21,47,.447,32,100,.320,39,56,.696,10,61,71,86,30,0,37,58,177,4.6
6008,Anthony Holliday\anthony-holliday-1,2013-14,Lamar,G,28,18,609,56,114,.491,54,104,.519,2,10,.200,63,85,.741,10,41,51,45,19,4,50,60,177,3.9
6009,Terance Mann\terance-mann-1,2015-16,Florida State,G,34,0,577,73,125,.584,69,112,.616,4,13,.308,27,59,.458,44,82,126,30,21,7,24,62,177,4.7
6010,Jeff Dowtin\jeff-dowtin-1,2016-17,Rhode Island,G,32,19,711,64,153,.418,44,96,.458,20,57,.351,28,49,.571,16,32,48,69,17,7,25,56,176,4.1
6011,Jontray Harris\jontray-harris-1,2017-18,Oral Roberts,G,30,1,679,60,147,.408,34,76,.447,26,71,.366,30,35,.857,39,88,127,48,11,3,32,52,176,4.8
6012,Zach Sellers\zach-sellers-2,2016-17,Savannah State,G,29,12,595,59,152,.388,19,49,.388,40,103,.388,18,33,.545,15,56,71,95,32,1,52,52,176,4.9
6013,Kasey Hill\kasey-hill-1,2013-14,Florida,G,32,8,700,57,140,.407,52,105,.495,5,35,.143,57,86,.663,9,53,62,100,37,5,50,67,176,4.5
6014,Thomas Dziagwa\thomas-dziagwa-1,2017-18,Oklahoma State,G,36,0,364,55,153,.359,8,26,.308,47,127,.370,19,20,.950,6,38,44,17,10,1,23,35,176,2.5
6015,Jaylen Benton\jaylen-benton-1,2016-17,Southeast Missouri State,G,30,21,580,63,162,.389,41,81,.506,22,81,.272,28,34,.824,13,49,62,77,30,5,41,73,176,4.2
6016,Reveal Chukwujekwu\reveal-chukwujekwu-1,2014-15,Houston Baptist,G,28,26,626,65,143,.455,63,135,.467,2,8,.250,44,57,.772,42,78,120,32,12,8,41,52,176,4.6
6017,Malik Ellison\malik-ellison-1,2015-16,St. John's (NY),G,24,9,511,48,130,.369,34,86,.395,14,44,.318,66,101,.653,15,44,59,62,9,2,63,64,176,3.3
6018,Jake Babic\jake-babic-1,2014-15,Appalachian State,G,29,9,654,58,162,.358,28,59,.475,30,103,.291,30,46,.652,16,56,72,55,8,3,38,46,176,3.4
6019,Josh Heath\josh-heath-2,2016-17,Georgia Tech,G,33,24,1014,67,169,.396,56,126,.444,11,43,.256,31,44,.705,13,73,86,144,39,6,83,68,176,4.4
6020,Melvin Frazier\melvin-frazier-1,2015-16,Tulane,G,34,11,662,63,157,.401,45,94,.479,18,63,.286,32,62,.516,41,66,107,24,31,9,38,49,176,3.7
6021,Wes VanBeck\wes-vanbeck-1,2017-18,Houston,G,29,8,488,52,125,.416,17,32,.531,35,93,.376,37,48,.771,28,53,81,31,15,2,33,55,176,4.3
6022,Trey Kennedy\trey-kennedy-1,2014-15,Southern Utah,G,29,23,644,59,148,.399,45,115,.391,14,33,.424,44,67,.657,6,64,70,58,14,6,44,41,176,3.7
6023,Marcus Merriweather\marcus-merriweather-1,2017-18,Alabama A&M,G,29,13,491,53,146,.363,26,63,.413,27,83,.325,43,47,.915,7,29,36,28,5,0,36,40,176,2.7
6024,Terrell Allen\terrell-allen-2,2017-18,Central Florida,G,32,22,960,63,156,.404,53,126,.421,10,30,.333,40,58,.690,21,75,96,88,43,0,55,77,176,4.4
6025,August Haas\august-haas-1,2016-17,Milwaukee,G,35,35,968,66,174,.379,46,107,.430,20,67,.299,24,46,.522,13,84,97,134,21,1,84,87,176,2.9
6026,LeRon Barnes\leron-barnes-1,2015-16,Houston,G,29,20,718,67,133,.504,35,57,.614,32,76,.421,10,19,.526,46,106,152,29,19,15,18,64,176,6.1
6027,Raemond Robinson\raemond-robinson-1,2016-17,Charleston Southern,G,31,11,575,56,158,.354,3,14,.214,53,144,.368,11,15,.733,3,57,60,35,15,2,20,54,176,3.4
6028,Talbott Denny\talbott-denny-1,2014-15,Lipscomb,G,30,17,693,58,113,.513,55,103,.534,3,10,.300,57,93,.613,62,82,144,32,17,3,39,88,176,4.7
6029,Marcellus Garrick\marcellus-garrick-1,2017-18,Cal Poly,G,27,6,451,61,148,.412,33,75,.440,28,73,.384,25,33,.758,16,27,43,12,8,2,15,33,175,3.8
6030,Ismael Sanogo\ismael-sanogo-1,2017-18,Seton Hall,G,32,17,739,67,125,.536,56,101,.554,11,24,.458,30,53,.566,54,115,169,30,34,30,28,95,175,5.9
6031,Hunter Ware\hunter-ware-1,2014-15,Bryant,G,31,0,524,59,157,.376,34,82,.415,25,75,.333,32,39,.821,12,27,39,33,25,2,35,42,175,3.2
6032,Julian Harrell\julian-harrell-1,2015-16,Eastern Washington,G,21,19,470,63,126,.500,39,63,.619,24,63,.381,25,41,.610,13,45,58,22,13,7,21,64,175,5.5
6033,Jalen White\jalen-white-1,2014-15,South Carolina State,G,28,22,516,62,158,.392,48,125,.384,14,33,.424,37,61,.607,9,42,51,58,15,4,49,43,175,3.2
6034,Jordan Cornish\jordan-cornish-1,2014-15,Nevada-Las Vegas,G,32,2,521,53,125,.424,15,47,.319,38,78,.487,31,39,.795,1,50,51,29,9,4,26,40,175,3.5
6035,Darreon Reddick\darreon-reddick-1,2015-16,Tennessee State,G,31,26,721,54,170,.318,30,82,.366,24,88,.273,43,53,.811,9,52,61,42,17,0,38,38,175,2.9
6036,Luke Moyer\luke-moyer-1,2013-14,Campbell,G,29,0,442,56,122,.459,12,32,.375,44,90,.489,19,27,.704,6,28,34,33,6,0,31,36,175,3.6
6037,Cavon Baker\cavon-baker-1,2014-15,Houston,G,27,6,431,54,142,.380,26,57,.456,28,85,.329,39,51,.765,9,31,40,34,18,2,44,45,175,3.3
6038,Winston Grays\winston-grays-1,2015-16,James Madison,G,32,1,526,52,126,.413,22,46,.478,30,80,.375,41,53,.774,18,61,79,33,10,5,19,42,175,4.2
6039,Jalen Love\jalen-love-1,2014-15,Denver,G,25,24,797,60,152,.395,34,73,.466,26,79,.329,29,34,.853,7,48,55,67,32,1,28,64,175,5.4
6040,Justin Brown\justin-brown-116,2017-18,South Florida,G,32,7,658,62,173,.358,27,63,.429,35,110,.318,16,21,.762,39,48,87,24,8,2,30,62,175,2.8
6041,Tucker Blackwell\tucker-blackwell-1,2017-18,Army,G,29,0,494,59,148,.399,26,66,.394,33,82,.402,24,38,.632,9,35,44,32,22,2,25,50,175,3.7
6042,Cezar Guerrero\cezar-guerrero-1,2014-15,Fresno State,G,15,10,388,54,124,.435,27,60,.450,27,64,.422,40,55,.727,6,41,47,39,17,0,28,42,175,8.0
6043,Yonel Brown\yonel-brown-1,2013-14,Kennesaw State,G,31,14,650,55,148,.372,37,90,.411,18,58,.310,47,57,.825,5,21,26,72,13,1,52,37,175,3.1
6044,Laytwan Porter\laytwan-porter-1,2016-17,Northern Illinois,G,27,9,515,55,140,.393,30,78,.385,25,62,.403,40,56,.714,9,50,59,60,32,6,60,67,175,3.9
6045,Isaiah Tripp\isaiah-tripp-1,2016-17,Abilene Christian,G,29,14,662,55,129,.426,27,51,.529,28,78,.359,37,47,.787,8,34,42,46,16,1,31,69,175,3.8
6046,Payton Hulsey\peyton-hulsey-1,2015-16,College of Charleston,G,31,30,891,72,156,.462,70,145,.483,2,11,.182,29,54,.537,45,131,176,103,55,5,45,79,175,6.8
6047,Travon Langston\travon-langston-1,2014-15,Southern Utah,G,29,14,559,56,140,.400,44,107,.411,12,33,.364,51,76,.671,22,61,83,41,25,2,44,62,175,3.8
6048,Antoine Pittman\antoine-pittman-1,2016-17,Bradley,G,31,19,547,60,145,.414,43,95,.453,17,50,.340,38,65,.585,12,45,57,26,22,6,47,54,175,2.7
6049,Nick Daniels\nick-daniels-2,2014-15,Oakland,G,28,7,461,56,123,.455,20,49,.408,36,74,.486,27,38,.711,6,37,43,28,21,2,29,41,175,4.2
6050,Troy Harper\troy-harper-1,2014-15,Campbell,G,26,0,444,49,141,.348,24,73,.329,25,68,.368,51,84,.607,4,24,28,22,13,2,34,56,174,2.5
6051,De'Von Cooper\devon-cooper-1,2017-18,Morehead State,G,29,12,592,58,168,.345,29,76,.382,29,92,.315,29,35,.829,14,63,77,39,12,5,34,38,174,3.4
6052,Jared Samuelson\jared-samuelson-12,2017-18,North Dakota State,G,32,12,595,54,128,.422,4,11,.364,50,117,.427,16,19,.842,4,49,53,22,14,0,10,42,174,3.9
6053,Kevin McClain\kevin-mcclain-1,2015-16,Belmont,G,32,0,348,63,148,.426,43,81,.531,20,67,.299,28,42,.667,9,32,41,24,9,4,41,47,174,2.3
6054,Amar Stukes\amar-stukes-1,2014-15,La Salle,G,33,15,736,64,143,.448,63,130,.485,1,13,.077,45,70,.643,12,33,45,42,29,0,40,57,174,3.1
6055,Aleksa Jugovic\aleksa-jugovic-1,2014-15,Tennessee Tech,G,30,3,538,54,130,.415,23,40,.575,31,90,.344,35,43,.814,4,33,37,60,23,1,35,45,174,4.2
6056,Markel Crawford\markel-crawford-1,2015-16,Memphis,G,33,24,657,67,143,.469,64,120,.533,3,23,.130,37,58,.638,19,88,107,46,28,7,30,70,174,4.2
6057,Keierre Richards\keierre-richards-1,2013-14,Savannah State,G,32,25,737,50,148,.338,38,112,.339,12,36,.333,62,78,.795,17,51,68,46,27,3,58,72,174,2.7
6058,C.J. Carr\cj-carr-1,2014-15,Southern Illinois-Edwardsville,G,28,0,495,53,147,.361,32,84,.381,21,63,.333,47,57,.825,10,41,51,61,22,0,41,30,174,4.3
6059,Kerwin Okoro\kerwin-okoro-1,2016-17,Norfolk State,G,24,18,440,61,167,.365,31,80,.388,30,87,.345,22,32,.688,10,45,55,27,14,12,40,39,174,3.5
6060,Austin Williams\austin-williams-14,2017-18,Marist,G,29,2,483,68,143,.476,63,112,.563,5,31,.161,33,58,.569,11,71,82,35,20,4,63,69,174,2.6
6061,Josh Gray\josh-gray-1,2015-16,Louisiana State,G,32,9,496,70,159,.440,62,121,.512,8,38,.211,26,40,.650,8,58,66,58,31,1,46,54,174,3.5
6062,Justin Jenifer\justin-jenifer-1,2017-18,Cincinnati,G,36,33,704,50,137,.365,20,53,.377,30,84,.357,44,57,.772,8,29,37,91,17,0,24,43,174,4.1
6063,Nnamdi Enechionyia\nnamdi-enechionyia-1,2016-17,Saint Peter's,G,36,36,747,59,141,.418,19,40,.475,40,101,.396,16,19,.842,30,56,86,20,15,12,24,64,174,3.4
6064,Ryan Oliver\ryan-oliver-1,2013-14,Siena,G,37,5,614,59,150,.393,21,46,.457,38,104,.365,18,27,.667,26,70,96,30,9,2,19,47,174,3.3
6065,Will Tavares\will-tavares-1,2016-17,Fordham,G,31,9,644,60,165,.364,41,108,.380,19,57,.333,35,53,.660,12,57,69,30,28,5,40,56,174,2.9
6066,Joe Crisman\joe-crisman-1,2013-14,Loyola (IL),G,32,32,891,66,138,.478,50,95,.526,16,43,.372,26,37,.703,18,83,101,49,30,12,30,74,174,4.7
6067,Marcus Bartley\marcus-bartley-1,2017-18,Southern Illinois,G,26,21,709,57,153,.373,16,46,.348,41,107,.383,19,24,.792,0,37,37,90,22,7,55,75,174,4.0
6068,Jordan Capps\jordan-capps-1,2013-14,Samford,G,33,10,516,65,124,.524,64,120,.533,1,4,.250,43,89,.483,51,65,116,26,9,12,30,70,174,3.9
6069,Tanner Milson\tanner-milson-1,2013-14,North Carolina-Wilmington,G,32,13,641,51,159,.321,6,31,.194,45,128,.352,27,35,.771,5,28,33,35,27,0,34,42,174,2.9
6070,Taylor Johnson\taylor-johnson-2,2015-16,Dartmouth,G,25,15,479,57,109,.523,36,64,.563,21,45,.467,39,43,.907,26,37,63,36,15,3,43,51,174,5.1
6071,Noah Frederking\noah-frederking-1,2017-18,Evansville,G,32,10,690,57,149,.383,33,83,.398,24,66,.364,35,43,.814,13,43,56,36,12,3,30,28,173,3.4
6072,Jacob Perry\jacob-perry-1,2015-16,Alabama A&M,G,27,0,431,50,127,.394,31,59,.525,19,68,.279,54,77,.701,8,21,29,43,8,0,35,52,173,3.3
6073,Donivine Stewart\donivine-stewart-1,2015-16,Portland State,G,30,24,904,67,148,.453,49,95,.516,18,53,.340,21,42,.500,19,48,67,111,36,2,39,43,173,5.8
6074,Quinton Marshall\quinton-marshall-1,2014-15,Citadel,G,29,25,729,59,144,.410,51,122,.418,8,22,.364,47,70,.671,32,61,93,35,14,11,46,76,173,3.3
6075,Hallice Cooke\hallice-cooke-1,2017-18,Nevada,G,37,12,743,56,129,.434,13,39,.333,43,90,.478,18,22,.818,8,68,76,57,21,4,21,76,173,3.8
6076,Nate Britt\nate-britt-1,2013-14,North Carolina,G,34,16,710,58,158,.367,55,146,.377,3,12,.250,54,68,.794,7,42,49,80,37,3,58,84,173,3.0
6077,Tyson Ward\tyson-ward-1,2016-17,North Dakota State,G,30,1,576,64,146,.438,38,76,.500,26,70,.371,19,28,.679,31,63,94,29,18,3,42,67,173,3.5
6078,Jordan Smith\jordan-smith-3,2013-14,South Carolina State,G,29,12,419,59,178,.331,22,52,.423,37,126,.294,18,21,.857,8,23,31,13,6,1,24,24,173,2.3
6079,Evann Hall\evann-hall-1,2013-14,Idaho State,G,29,0,488,57,142,.401,47,109,.431,10,33,.303,49,63,.778,14,48,62,25,25,5,55,78,173,2.6
6080,Antwain Johnson\antwain-johnson-1,2016-17,Middle Tennessee,G,36,2,474,53,136,.390,37,88,.420,16,48,.333,51,74,.689,8,33,41,38,16,2,30,65,173,2.6
6081,Maurice White\maurice-white-1,2013-14,Siena,G,38,7,479,59,169,.349,58,155,.374,1,14,.071,54,79,.684,40,52,92,21,20,6,40,60,173,2.3
6082,DeVonte Smith\devonte-smith-1,2013-14,Little Rock,G,32,28,897,59,149,.396,43,98,.439,16,51,.314,39,54,.722,8,64,72,97,36,1,34,60,173,4.9
6083,Eric Weary\eric-weary-1,2014-15,Houston,G,31,10,558,59,182,.324,27,52,.519,32,130,.246,23,32,.719,34,76,110,17,16,12,28,39,173,3.4
6084,Tramaine Isabell\tramaine-isabell-1,2015-16,Missouri,G,28,2,457,59,156,.378,46,105,.438,13,51,.255,42,57,.737,8,40,48,35,23,1,41,31,173,3.4
6085,Ja'Michael Brown\jamichael-brown-1,2016-17,North Texas,G,30,12,736,64,188,.340,38,85,.447,26,103,.252,19,32,.594,4,53,57,45,37,4,42,50,173,3.0
6086,Malik Gill\malik-gill-1,2014-15,Dartmouth,G,29,0,537,51,124,.411,33,66,.500,18,58,.310,53,70,.757,11,51,62,93,43,2,56,55,173,5.3
6087,Terry Tarpey\terry-tarpey-1,2013-14,William & Mary,G,32,31,792,61,113,.540,57,97,.588,4,16,.250,47,75,.627,40,155,195,57,35,26,41,65,173,6.5
6088,Jaylen Babb-Harrison\jaylen-babb-harrison-1,2015-16,Eastern Kentucky,G,30,2,381,57,127,.449,14,32,.438,43,95,.453,16,19,.842,10,52,62,24,14,2,13,30,173,4.5
6089,Elijah Jordan\elijah-jordan-1,2017-18,New Hampshire,G,28,17,656,61,167,.365,30,84,.357,31,83,.373,20,30,.667,12,49,61,87,12,0,56,53,173,3.4
6090,Josh Gantz\josh-gantz-1,2015-16,Massachusetts-Lowell,G,29,29,672,66,162,.407,47,98,.480,19,64,.297,22,40,.550,34,62,96,47,16,28,38,82,173,4.1
6091,Jordan Reed\jordan-reed-2,2016-17,New Hampshire,G,32,26,892,55,177,.311,13,42,.310,42,135,.311,21,29,.724,12,42,54,50,19,2,48,59,173,2.3
6092,Antonio Gillespie\antonio-gillespie-1,2016-17,Morgan State,G,30,8,543,55,158,.348,14,47,.298,41,111,.369,22,28,.786,8,20,28,20,13,0,11,58,173,2.9
6093,Shyquan Gibbs\shyquan-gibbs-1,2017-18,NJIT,G,30,30,671,55,117,.470,31,69,.449,24,48,.500,39,48,.813,10,56,66,57,31,2,29,73,173,4.9
6094,Jamie Batish\jamie-batish-1,2014-15,Western Illinois,G,27,11,683,59,137,.431,14,29,.483,45,108,.417,9,11,.818,5,47,52,17,6,2,9,44,172,4.0
6095,Justin Hopkins\justin-hopkins-1,2016-17,Samford,G,34,0,543,55,113,.487,46,87,.529,9,26,.346,53,68,.779,24,63,87,18,7,2,27,40,172,3.6
6096,Darrion Allen\darrion-allen-1,2014-15,Longwood,G,33,14,686,58,158,.367,42,103,.408,16,55,.291,40,54,.741,31,41,72,30,24,14,35,63,172,3.3
6097,Daniel Simmons\daniel-simmons-1,2016-17,Southeast Missouri State,G,32,0,514,60,177,.339,32,91,.352,28,86,.326,24,37,.649,10,53,63,46,16,2,43,38,172,2.5
6098,Daquan Cook\daquan-cook-2,2016-17,Prairie View,G,16,13,437,58,171,.339,36,94,.383,22,77,.286,34,44,.773,16,23,39,24,21,0,28,26,172,5.6
6099,Steven Kaspar\steven-kaspar-1,2014-15,Bucknell,G,34,4,757,48,110,.436,36,77,.468,12,33,.364,64,90,.711,13,80,93,121,33,12,48,81,172,5.4
6100,Lexus Williams\lexus-williams-1,2016-17,Valparaiso,G,33,21,756,63,153,.412,35,67,.522,28,86,.326,18,27,.667,9,64,73,66,46,4,44,65,172,4.2
6101,Darrell Davis\darrell-davis-2,2016-17,Dayton,G,31,17,644,50,146,.342,10,42,.238,40,104,.385,32,44,.727,8,52,60,38,14,1,24,55,172,3.3
6102,Michael Kolawole\michael-kolawole-1,2015-16,Illinois-Chicago,G,30,14,563,58,164,.354,46,115,.400,12,49,.245,44,68,.647,16,61,77,36,17,0,42,39,172,2.8
6103,Everett Clemons\everett-clemons-1,2015-16,Indiana State,G,32,11,828,60,135,.444,59,128,.461,1,7,.143,51,84,.607,47,153,200,89,33,1,45,63,172,6.0
6104,Marcus Marshall\marcus-marshall-1,2013-14,Missouri State,G,12,11,343,49,115,.426,28,62,.452,21,53,.396,53,67,.791,5,27,32,25,0,0,18,29,172,8.8
6105,Conner Frankamp\conner-frankamp-1,2015-16,Wichita State,G,28,0,479,57,147,.388,22,47,.468,35,100,.350,23,26,.885,3,38,41,28,9,5,5,26,172,4.3
6106,Mike Brown\mike-brown-5,2013-14,Western Carolina,G,34,2,563,58,147,.395,41,92,.446,17,55,.309,39,66,.591,62,52,114,39,22,10,24,78,172,4.2
6107,Javon McKay\javon-mckay-1,2013-14,Tennessee Tech,G,32,32,675,54,121,.446,43,89,.483,11,32,.344,53,68,.779,35,65,100,41,26,21,30,86,172,4.7
6108,Cody Kelley\cody-kelley-1,2017-18,Wyoming,G,33,23,767,57,146,.390,24,52,.462,33,94,.351,25,39,.641,13,66,79,96,29,1,51,67,172,4.1
6109,Nnamdi Enechionyia\nnamdi-enechionyia-1,2017-18,Saint Peter's,G,32,32,852,56,165,.339,27,76,.355,29,89,.326,31,41,.756,21,63,84,39,19,9,39,57,172,3.1
6110,Isaiah Zierden\isaiah-zierden-1,2016-17,Creighton,G,35,4,699,47,112,.420,6,13,.462,41,99,.414,37,40,.925,4,65,69,29,15,2,22,48,172,3.7
6111,De'Andre Davis\deandre-davis-1,2014-15,Grand Canyon,G,30,0,534,64,123,.520,61,105,.581,3,18,.167,41,62,.661,25,45,70,56,23,4,38,67,172,4.5
6112,Darrell Davis\darrell-davis-2,2014-15,Dayton,G,36,0,673,54,141,.383,7,37,.189,47,104,.452,17,23,.739,3,56,59,23,14,3,25,55,172,2.7
6113,Gavin Block\gavin-block-1,2015-16,Ohio,G,34,2,611,48,121,.397,25,56,.446,23,65,.354,53,64,.828,7,64,71,52,13,1,31,54,172,3.6
6114,Chris Bolden\chris-bolden-1,2014-15,Georgia Tech,G,25,11,532,66,161,.410,36,69,.522,30,92,.326,10,13,.769,2,43,45,25,17,3,26,49,172,3.6
6115,Marcus Harris\marcus-harris-1,2015-16,San Diego,G,26,21,662,53,160,.331,26,55,.473,27,105,.257,39,52,.750,6,54,60,19,21,2,27,66,172,3.0
6116,Aaron Young\aaron-young-1,2015-16,Oral Roberts,G,31,14,570,56,122,.459,24,52,.462,32,70,.457,27,34,.794,4,27,31,44,13,0,23,45,171,3.8
6117,Juwan McCloud\juwan-mccloud-1,2017-18,Northern Iowa,G,26,26,673,67,189,.354,49,118,.415,18,71,.254,19,35,.543,5,40,45,62,33,2,43,43,171,3.5
6118,Dwaun Anderson\dwaun-anderson-1,2013-14,Wagner,G,31,21,685,69,190,.363,57,132,.432,12,58,.207,21,32,.656,27,66,93,28,24,14,37,58,171,3.0
6119,Devin Peterson\devin-peterson-1,2015-16,Western Carolina,G,34,15,696,61,176,.347,48,111,.432,13,65,.200,36,52,.692,14,46,60,51,29,4,47,70,171,2.4
6120,Jordan Usher\jordan-usher-1,2017-18,Southern California,G,36,2,509,60,135,.444,33,69,.478,27,66,.409,24,32,.750,21,50,71,34,18,4,25,65,171,3.4
6121,Brandon Averette\brandon-averette-1,2016-17,Oklahoma State,G,33,1,488,61,137,.445,51,115,.443,10,22,.455,39,52,.750,3,46,49,60,27,0,51,53,171,3.2
6122,Elijah Mays\elijah-mays-1,2016-17,Florida A&M,G,28,18,652,62,173,.358,45,110,.409,17,63,.270,30,43,.698,14,47,61,90,27,1,34,57,171,4.5
6123,Eric Stafford\eric-stafford-1,2016-17,Lafayette,G,26,17,643,54,129,.419,32,71,.451,22,58,.379,41,56,.732,11,60,71,55,16,4,50,67,171,3.9
6124,Eric McClellan\eric-mcclellan-1,2013-14,Vanderbilt,G,12,12,369,58,133,.436,52,100,.520,6,33,.182,49,81,.605,8,45,53,38,15,2,42,29,171,8.1
6125,Daishon Smith\daishon-smith-1,2016-17,Wichita State,G,36,12,536,50,121,.413,22,48,.458,28,73,.384,43,58,.741,11,68,79,68,35,2,39,51,171,4.3
6126,Traevon Jackson\traevon-jackson-1,2014-15,Wisconsin,G,21,17,506,60,139,.432,49,100,.490,11,39,.282,40,47,.851,4,31,35,54,19,3,32,27,171,5.9
6127,Ben Millaud-Meunier\ben-millaud-meunier-1,2014-15,Saint Francis (PA),G,31,0,481,52,130,.400,16,26,.615,36,104,.346,31,39,.795,7,47,54,27,10,2,26,22,171,3.6
6128,Trent Forrest\trent-forrest-1,2016-17,Florida State,G,35,0,538,61,129,.473,60,121,.496,1,8,.125,48,71,.676,31,63,94,55,43,5,35,40,171,4.9
6129,Tyler Lewis\tyler-lewis-1,2015-16,Butler,G,29,16,553,53,137,.387,34,72,.472,19,65,.292,46,54,.852,7,36,43,82,21,0,23,45,171,5.0
6130,Patrick Swilling\patrick-swilling--1,2013-14,Tulsa,G,20,0,452,59,159,.371,22,48,.458,37,111,.333,16,26,.615,3,36,39,24,11,2,25,34,171,4.1
6131,Dajuan Graf\dajuan-graf-1,2013-14,Florida Gulf Coast,G,35,1,806,61,137,.445,54,107,.505,7,30,.233,42,59,.712,11,64,75,73,31,1,39,77,171,3.8
6132,Ehab Amin\ehab-amin-1,2014-15,Texas A&M-Corpus Christi,G,33,5,496,56,131,.427,46,79,.582,10,52,.192,49,71,.690,14,66,80,27,35,5,40,71,171,3.4
6133,Will Goff\will-goff-1,2017-18,Boston University,G,30,14,762,55,138,.399,10,21,.476,45,117,.385,16,29,.552,9,35,44,30,22,8,26,46,171,3.7
6134,Julius Johnson\julius-johnson-1,2016-17,Richmond,G,35,17,781,59,142,.415,33,59,.559,26,83,.313,27,34,.794,19,71,90,34,23,5,24,88,171,3.4
6135,Doug Brooks\doug-brooks-1,2014-15,Virginia Commonwealth,G,33,7,499,61,145,.421,30,69,.435,31,76,.408,18,29,.621,10,57,67,21,39,3,28,77,171,3.4
6136,Darraja Parnell\darraja-parnell-1,2016-17,Central Arkansas,G,31,1,443,57,111,.514,51,92,.554,6,19,.316,51,64,.797,13,48,61,49,20,5,45,50,171,4.1
6137,Gavin Peppers\gavin-peppers-1,2017-18,Central Michigan,G,33,0,438,59,148,.399,39,84,.464,20,64,.313,33,41,.805,11,28,39,39,16,1,24,31,171,3.4
6138,Payten Ricks\payten-ricks-1,2017-18,Abilene Christian,G,26,17,586,53,137,.387,26,68,.382,27,69,.391,38,51,.745,7,40,47,44,20,1,34,43,171,4.2
6139,Sam Logwood\sam-logwood-1,2014-15,New Mexico,G,28,16,572,57,146,.390,40,90,.444,17,56,.304,40,55,.727,24,52,76,31,9,3,29,46,171,3.7
6140,Garrett Gilkeson\garrett-gilkeson-1,2017-18,Virginia Military Institute,G,30,30,686,60,167,.359,42,97,.433,18,70,.257,33,42,.786,27,92,119,39,37,1,38,62,171,4.1
6141,Jaylen Allen\jaylen-allen-1,2013-14,Wofford,G,33,6,440,61,140,.436,33,67,.493,28,73,.384,21,31,.677,10,41,51,18,27,1,28,55,171,3.1
6142,Jaylin Walker\jaylin-walker-1,2015-16,Kent State,G,22,8,420,53,143,.371,23,53,.434,30,90,.333,34,43,.791,19,25,44,17,13,0,23,26,170,4.5
6143,Anthony Eaves\anthony-eaves-1,2015-16,Chicago State,G,29,2,416,67,163,.411,40,85,.471,27,78,.346,9,12,.750,12,44,56,37,15,3,40,24,170,3.3
6144,Ryan Kreklow\ryan-kreklow-1,2017-18,Missouri State,G,33,10,656,49,160,.306,15,45,.333,34,115,.296,38,42,.905,9,57,66,50,24,6,30,64,170,3.2
6145,Romeo Crouch\romeo-crouch-1,2017-18,Presbyterian,G,32,9,756,59,143,.413,29,64,.453,30,79,.380,22,39,.564,44,76,120,36,32,2,47,34,170,4.3
6146,Justin Benton\justin-benton-1,2017-18,Southern Illinois-Edwardsville,G,26,18,749,61,136,.449,36,84,.429,25,52,.481,23,34,.676,14,41,55,70,15,1,42,61,170,4.4
6147,Tyler Davis\tyler-davis-3,2014-15,Alabama A&M,G,29,23,758,55,151,.364,23,53,.434,32,98,.327,28,42,.667,18,34,52,43,27,1,53,54,170,3.0
6148,Clifton Powell\clifton-powell-1,2016-17,UC-Santa Barbara,G,28,14,536,66,185,.357,47,132,.356,19,53,.358,19,36,.528,20,47,67,37,15,2,42,54,170,2.4
6149,Jelani Currie\jelani-currie-1,2015-16,Texas A&M-Corpus Christi,G,33,32,766,60,160,.375,47,111,.423,13,49,.265,37,55,.673,37,73,110,35,21,9,35,63,170,3.5
6150,Stephan Holm\stephan-holm-1,2013-14,Montana State,G,30,0,415,62,137,.453,21,42,.500,41,95,.432,5,7,.714,6,32,38,6,14,1,16,17,170,3.6
6151,Jawad Adekoya\jawad-adekova-1,2015-16,Chicago State,G,22,12,405,54,146,.370,23,61,.377,31,85,.365,31,44,.705,11,46,57,13,11,1,24,37,170,4.0
6152,Lafayette Dorsey\lafayette-dorsey-2,2017-18,Pacific,G,24,0,369,61,136,.449,46,86,.535,15,50,.300,33,39,.846,7,55,62,15,13,1,27,34,170,4.2
6153,David Joseph\david-joseph-1,2015-16,Bowling Green State,G,34,33,699,61,158,.386,41,113,.363,20,45,.444,28,43,.651,7,75,82,100,38,6,49,54,170,4.3
6154,Josh Anderson\josh-anderson-2,2017-18,Western Kentucky,G,23,3,390,63,114,.553,62,107,.579,1,7,.143,43,73,.589,19,39,58,17,23,8,19,50,170,5.6
6155,Remond Brown\remond-brown-1,2013-14,Grambling,G,19,11,500,66,149,.443,46,92,.500,20,57,.351,18,34,.529,14,25,39,25,24,3,28,28,170,5.7
6156,Jordan Burgess\jordan-burgess-1,2016-17,Virginia Commonwealth,G,35,24,748,68,157,.433,47,93,.505,21,64,.328,13,31,.419,33,89,122,35,24,9,30,95,170,3.3
6157,Ike Iroegbu\ike-iroegbu-1,2013-14,Washington State,G,31,3,560,55,154,.357,31,81,.383,24,73,.329,36,52,.692,11,47,58,45,16,3,41,40,170,3.0
6158,Cameron Reed\cameron-reed-1,2015-16,New Orleans,G,29,7,571,54,160,.338,10,34,.294,44,126,.349,18,22,.818,9,26,35,26,11,6,25,52,170,2.7
6159,Fred Thomas\fred-thomas-1,2015-16,Mississippi State,G,31,6,629,54,135,.400,22,37,.595,32,98,.327,30,39,.769,10,79,89,31,10,13,17,50,170,4.1
6160,Xavier Talton\xavier-talton-1,2013-14,Colorado,G,35,13,724,58,143,.406,30,68,.441,28,75,.373,26,39,.667,11,65,76,55,20,6,47,63,170,3.0
6161,Dylan Poston\dylan-poston-1,2014-15,Gardner-Webb,G,35,0,472,55,149,.369,6,20,.300,49,129,.380,11,15,.733,11,38,49,17,14,4,18,46,170,2.8
6162,Keelan Garrett\keelan-garrett-1,2013-14,McNeese State,G,28,1,412,57,177,.322,21,68,.309,36,109,.330,20,26,.769,7,21,28,17,9,0,17,31,170,2.5
6163,Cole Murray\cole-murray-1,2013-14,Northern Kentucky,G,30,9,516,54,137,.394,6,13,.462,48,124,.387,14,19,.737,8,42,50,19,7,10,10,41,170,3.8
6164,Tony Wills\tony-willis-1,2015-16,Illinois State,G,32,23,814,64,156,.410,39,82,.476,25,74,.338,17,26,.654,13,51,64,57,35,11,34,82,170,3.8
6165,K.J. Byers\kj-byers-1,2017-18,Cal State Long Beach,G,33,2,667,58,119,.487,52,79,.658,6,40,.150,48,85,.565,34,106,140,31,33,32,55,59,170,4.5
6166,Frederic Dure\frederic-dure-1,2015-16,Arkansas State,G,30,9,693,45,139,.324,30,78,.385,15,61,.246,65,97,.670,10,85,95,57,17,19,52,68,170,3.4
6167,Darrick Wood\darrick-wood-1,2015-16,DePaul,G,29,0,531,69,193,.358,60,146,.411,9,47,.191,23,33,.697,10,70,80,47,24,5,39,56,170,2.9
6168,Trevon Allen\trevon-allen-1,2016-17,Idaho,G,33,12,605,44,132,.333,18,54,.333,26,78,.333,55,64,.859,7,62,69,47,8,4,49,39,169,2.8
6169,Bryce Moore\bryce-moore-1,2015-16,Western Michigan,G,31,13,660,53,145,.366,31,80,.388,22,65,.338,41,56,.732,11,57,68,41,19,2,46,62,169,2.8
6170,Elijah Mitrou-Long\elijah-mitrou-long-1,2015-16,Mount St. Mary's,G,30,22,687,63,185,.341,50,146,.342,13,39,.333,30,48,.625,10,66,76,66,32,3,47,47,169,3.3
6171,Devonte Hampton\devonte-hampton-1,2013-14,Alcorn State,G,29,16,695,61,160,.381,36,85,.424,25,75,.333,22,39,.564,13,79,92,47,25,6,48,62,169,3.3
6172,Nick Davis\nick-davis-2,2017-18,South Alabama,G,30,24,732,66,144,.458,48,81,.593,18,63,.286,19,40,.475,37,135,172,30,23,31,43,87,169,4.7
6173,Ronnye Beamon\ronnye-beamon-1,2016-17,Morehead State,G,30,22,707,59,117,.504,45,87,.517,14,30,.467,37,60,.617,34,76,110,29,22,3,37,83,169,4.1
6174,Jaren Sina\jaren-sina-1,2014-15,Seton Hall,G,24,23,772,51,158,.323,11,33,.333,40,125,.320,27,34,.794,21,39,60,55,10,0,33,27,169,4.5
6175,Corey Gray\corey-gray-1,2013-14,Chicago State,G,31,15,669,56,145,.386,24,66,.364,32,79,.405,25,39,.641,15,35,50,50,19,1,40,63,169,3.1
6176,Jonathan Sanks\jonathan-sanks-1,2017-18,Canisius,G,31,0,499,57,140,.407,20,50,.400,37,90,.411,18,28,.643,9,39,48,30,6,1,18,54,169,3.1
6177,Tadric Jackson\tadric-jackson-1,2015-16,Georgia Tech,G,36,1,496,60,156,.385,42,91,.462,18,65,.277,31,52,.596,8,34,42,44,16,3,30,48,169,2.5
6178,Chance McSpadden\chance-mcspadden-1,2015-16,Central Florida,G,30,7,484,56,123,.455,41,77,.532,15,46,.326,42,51,.824,9,41,50,46,16,3,50,31,169,3.6
6179,Reggie Groves\reggie-groves-1,2013-14,North Carolina Central,G,34,1,596,52,160,.325,11,34,.324,41,126,.325,24,34,.706,9,45,54,48,16,3,22,40,169,3.2
6180,Jordan Robertson\jordan-robertson-2,2017-18,Colgate,G,32,1,417,61,150,.407,47,105,.448,14,45,.311,33,50,.660,22,25,47,13,11,8,27,52,169,2.6
6181,Dantez Walton\dantez-walton-1,2017-18,Northern Kentucky,G,32,6,524,68,152,.447,54,84,.643,14,68,.206,19,31,.613,45,63,108,34,21,14,26,61,169,4.4
6182,Keljin Blevins\keljin-blevins-1,2015-16,Southern Mississippi,G,29,24,648,53,156,.340,42,107,.393,11,49,.224,52,81,.642,31,69,100,21,12,7,49,55,169,2.5
6183,Glenn Sanabria\glenn-sanabria-1,2014-15,St. Francis (NY),G,28,0,633,49,117,.419,18,48,.375,31,69,.449,40,60,.667,23,31,54,58,20,4,31,49,169,4.9
6184,Yosef Yacob\yosef-yacob-1,2016-17,Binghamton,G,28,2,493,55,129,.426,26,60,.433,29,69,.420,30,43,.698,3,29,32,35,10,0,32,35,169,3.4
6185,Sam Bittner\sam-bittner-1,2017-18,Fresno State,G,32,26,817,57,113,.504,18,32,.563,39,81,.481,16,20,.800,27,65,92,52,35,10,27,91,169,5.1
6186,Tevin Findlay\tevin-findlay-1,2015-16,Green Bay,G,35,0,463,59,123,.480,42,86,.488,17,37,.459,34,50,.680,11,37,48,40,23,4,30,39,169,3.6
6187,Jayden Hodgson\jayden-hodgson-1,2016-17,Bradley,G,33,10,690,56,150,.373,24,68,.353,32,82,.390,25,36,.694,12,49,61,57,17,2,50,60,169,2.7
6188,Marcus Sheffield\marcus-sheffield-1,2015-16,Stanford,G,28,4,447,56,145,.386,39,100,.390,17,45,.378,40,57,.702,16,47,63,28,13,2,32,40,169,3.4
6189,Troy Reid-Knight\troy-reid-knight-1,2013-14,Maine,G,26,2,469,53,129,.411,30,70,.429,23,59,.390,40,52,.769,10,34,44,61,19,0,47,52,169,4.1
6190,Leland Green\leland-green-1,2017-18,Hawaii,G,30,17,690,66,197,.335,38,99,.384,28,98,.286,9,22,.409,13,45,58,25,22,2,47,56,169,1.5
6191,Jeremie Tyler\jeremie-tyler-1,2016-17,Ball State,G,20,0,395,61,135,.452,37,70,.529,24,65,.369,23,25,.920,4,25,29,20,19,3,31,38,169,4.9
6192,Mike Davis\mike-davis-9,2014-15,Alcorn State,G,26,20,632,60,151,.397,49,122,.402,11,29,.379,37,47,.787,22,35,57,42,29,1,37,39,168,4.4
6193,A.C. Reid\ac-reid-1,2016-17,Liberty,G,35,1,748,55,167,.329,9,22,.409,46,145,.317,12,18,.667,0,54,54,57,23,5,38,69,168,2.5
6194,Connor Burchfield\connor-burchfield-1,2015-16,William & Mary,G,31,0,371,59,100,.590,19,29,.655,40,71,.563,10,11,.909,1,43,44,15,5,0,18,22,168,4.0
6195,Paul Scruggs\paul-scruggs-1,2017-18,Xavier,G,34,0,571,60,132,.455,46,86,.535,14,46,.304,34,47,.723,5,62,67,59,18,9,49,66,168,3.1
6196,JoJo McGlaston\jojo-mcglaston-1,2014-15,Utah State,G,30,7,654,51,160,.319,30,97,.309,21,63,.333,45,73,.616,11,79,90,58,12,18,40,49,168,3.4
6197,Asa Cantwell\asa-cantwell-1,2016-17,Houston Baptist,G,29,17,571,53,147,.361,2,14,.143,51,133,.383,11,11,1.000,5,31,36,40,11,0,29,55,168,3.0
6198,Bryant Rucker\bryant-rucker-1,2015-16,Denver,G,31,19,509,56,109,.514,35,61,.574,21,48,.438,35,44,.795,2,31,33,47,15,1,31,30,168,4.1
6199,Jonathan Mulmore\jonathan-mulmore-1,2017-18,Georgetown,G,30,29,683,45,98,.459,30,66,.455,15,32,.469,63,82,.768,11,52,63,102,29,5,56,78,168,5.0
6200,Marco Porcher Jimenez\marco-porcher-1,2013-14,Florida International,G,30,1,463,61,149,.409,21,35,.600,40,114,.351,6,10,.600,15,40,55,10,10,4,16,41,168,3.2
6201,Jair Bolden\jair-bolden-1,2016-17,George Washington,G,35,16,627,59,164,.360,32,83,.386,27,81,.333,23,35,.657,16,46,62,66,16,9,54,46,168,2.7
6202,Martez Cameron\martez-cameron-1,2016-17,Morgan State,G,30,25,871,60,180,.333,59,168,.351,1,12,.083,47,72,.653,28,66,94,130,30,0,74,85,168,3.6
6203,Ryan Cline\ryan-cline-1,2016-17,Purdue,G,31,7,663,57,134,.425,12,25,.480,45,109,.413,9,11,.818,5,57,62,50,11,3,22,43,168,4.1
6204,Darrion Allen\darrion-allen-1,2013-14,Longwood,G,30,6,573,65,160,.406,58,122,.475,7,38,.184,31,40,.775,18,31,49,26,12,5,32,46,168,2.8
6205,Brandon Harris\brandon-harris-2,2013-14,Western Kentucky,G,29,8,550,47,154,.305,7,28,.250,40,126,.317,34,47,.723,34,63,97,32,16,2,26,35,168,4.0
6206,Joey McLean\joey-mclean-1,2014-15,James Madison,G,26,9,558,51,129,.395,22,40,.550,29,89,.326,37,48,.771,10,42,52,50,35,0,38,63,168,4.6
6207,Temple Gibbs\temple-gibbs-1,2016-17,Notre Dame,G,36,1,539,51,136,.375,34,83,.410,17,53,.321,49,59,.831,12,41,53,62,26,2,28,49,168,3.7
6208,Justin James\justin-james-2,2015-16,Wyoming,G,31,3,516,59,141,.418,40,86,.465,19,55,.345,31,55,.564,11,55,66,25,10,11,23,47,168,3.3
6209,Jeremiah Paige\jeremiah-paige-1,2015-16,Colorado State,G,34,1,573,53,157,.338,30,86,.349,23,71,.324,39,52,.750,8,53,61,46,12,7,31,58,168,2.7
6210,Montana Byrd\montana-byrd-1,2017-18,Chicago State,G,32,28,572,59,147,.401,21,53,.396,38,94,.404,12,18,.667,4,58,62,17,13,7,26,78,168,2.5
6211,Eric Stafford\eric-stafford-1,2017-18,Lafayette,G,31,31,794,55,146,.377,38,94,.404,17,52,.327,41,51,.804,19,72,91,96,23,11,54,75,168,4.3
6212,Anthony D'Orazio\anthony-dorazio-1,2014-15,Rider,G,33,26,775,62,158,.392,42,95,.442,20,63,.317,24,40,.600,21,76,97,70,39,6,41,63,168,4.2
6213,Tevin Mack\tevin-mack-1,2015-16,Texas,G,33,0,439,51,176,.290,17,62,.274,34,114,.298,32,50,.640,19,47,66,11,8,9,18,41,168,2.2
6214,Josh Nicholas\josh-nicholas-2,2017-18,St. Francis (NY),G,31,0,577,58,148,.392,29,72,.403,29,76,.382,23,38,.605,23,43,66,26,27,11,29,77,168,3.3
6215,Malik Crowfield\malik-crowfield-1,2017-18,Virginia Commonwealth,G,29,13,697,54,152,.355,8,24,.333,46,128,.359,14,18,.778,4,35,39,44,23,4,24,48,168,3.7
6216,Jalen Harris\jalen-harris-2,2017-18,Louisiana Tech,G,11,11,276,54,113,.478,38,77,.494,16,36,.444,44,53,.830,8,40,48,26,12,3,28,22,168,10.9
6217,Jaron Hopkins\jaron-hopkins-1,2013-14,Colorado,G,35,9,638,60,157,.382,38,86,.442,22,71,.310,26,52,.500,23,64,87,36,27,3,38,77,168,2.6
6218,Wheeler Baker\wheeler-baker-1,2014-15,Albany (NY),G,30,1,417,56,143,.392,21,50,.420,35,93,.376,21,29,.724,5,37,42,11,10,3,27,39,168,2.6
6219,Chip Armelin\chip-armelin-1,2013-14,Southern Mississippi,G,35,5,470,71,139,.511,54,83,.651,17,56,.304,9,18,.500,16,49,65,16,25,2,23,48,168,3.3
6220,Michael Dison\michael-dison-1,2013-14,Montana State,G,27,17,545,63,160,.394,47,108,.435,16,52,.308,26,44,.591,8,46,54,33,20,2,21,57,168,3.5
6221,Laytwan Porter\laytwan-porter-1,2015-16,Northern Illinois,G,34,1,591,55,146,.377,34,76,.447,21,70,.300,36,48,.750,14,63,77,78,37,4,49,61,167,3.9
6222,Kenny Carpenter\kenny-carpenter-1,2016-17,Cleveland State,G,31,0,527,66,186,.355,57,140,.407,9,46,.196,26,36,.722,16,43,59,25,9,6,35,39,167,2.0
6223,Andre Fox\andre-fox-1,2015-16,High Point,G,31,1,488,53,147,.361,36,88,.409,17,59,.288,44,52,.846,27,39,66,18,16,7,39,41,167,2.9
6224,Mark Alstork\mark-alstork-1,2013-14,Ball State,G,30,15,678,45,144,.313,26,85,.306,19,59,.322,58,83,.699,30,64,94,45,14,12,57,76,167,2.7
6225,Hayden Schenck\hayden-schenck-1,2015-16,Utah Valley,G,26,0,558,45,108,.417,30,58,.517,15,50,.300,62,74,.838,21,84,105,47,25,10,50,87,167,4.8
6226,Jacob Van\jacob-van-1,2015-16,Air Force,G,28,8,395,58,123,.472,40,81,.494,18,42,.429,33,43,.767,7,24,31,27,16,0,27,23,167,4.0
6227,Javares Brent\javeres-brent-1,2015-16,Jackson State,G,36,7,515,55,183,.301,6,24,.250,49,159,.308,8,10,.800,8,46,54,28,12,4,16,34,167,2.3
6228,Brent Wrapp\brent-wrapp-1,2015-16,Cal State Bakersfield,G,33,31,942,50,126,.397,40,87,.460,10,39,.256,57,81,.704,30,90,120,139,41,10,50,79,167,6.1
6229,Shawn Occeus\shawn-occeus-1,2016-17,Northeastern,G,31,27,653,56,137,.409,21,44,.477,35,93,.376,20,38,.526,10,50,60,28,26,7,33,64,167,3.2
6230,Dontay Caruthers\dontay-caruthers-1,2017-18,Buffalo,G,25,3,449,67,112,.598,53,82,.646,14,30,.467,19,33,.576,19,40,59,49,22,1,34,76,167,5.1
6231,Jamal Reynolds\jamal-reynolds-1,2015-16,Canisius,G,32,27,600,55,116,.474,54,114,.474,1,2,.500,56,92,.609,76,80,156,31,23,12,32,58,167,5.3
6232,DeAndre Haywood\deandre-haywood-1,2013-14,Delaware State,G,27,10,377,55,138,.399,44,95,.463,11,43,.256,46,66,.697,15,31,46,18,13,1,26,38,167,3.3
6233,Ibn Muhammad\ibn-muhammad-1,2015-16,Iona,G,33,25,866,57,135,.422,20,43,.465,37,92,.402,16,24,.667,10,52,62,86,33,0,32,63,167,4.6
6234,Rodney Simeon\rodney-simeon-1,2017-18,Alabama State,G,23,5,440,54,169,.320,15,46,.326,39,123,.317,20,25,.800,16,28,44,6,8,4,28,43,167,2.5
6235,Craig Randall\craig-randall-1,2016-17,Memphis,G,32,0,579,58,166,.349,22,41,.537,36,125,.288,15,29,.517,14,31,45,33,20,5,28,32,167,2.9
6236,Javaris Jenkins\javaris-jenkins-1,2014-15,Savannah State,G,24,13,485,57,169,.337,29,80,.363,28,89,.315,25,39,.641,26,57,83,13,16,14,24,48,167,3.9
6237,Frank Booker\frank-booker-1,2016-17,Florida Atlantic,G,30,10,502,57,152,.375,22,33,.667,35,119,.294,18,22,.818,13,36,49,16,12,2,19,54,167,2.9
6238,Jimmy Sotos\jimmy-sotos-1,2017-18,Bucknell,G,35,13,782,47,119,.395,23,58,.397,24,61,.393,49,63,.778,10,89,99,70,29,3,50,64,167,3.9
6239,Haiishen McIntyre\haiishen-mcintyre-1,2015-16,High Point,G,32,27,710,51,134,.381,45,113,.398,6,21,.286,59,77,.766,14,63,77,105,52,4,30,58,167,5.9
6240,Cam Davis\cam-davis-1,2017-18,Navy,G,32,2,549,58,125,.464,32,60,.533,26,65,.400,24,30,.800,3,29,32,22,9,1,22,25,166,3.2
6241,Igor Hadziomerovic\igor-hadziomerovic-1,2014-15,Boise State,G,33,19,785,56,123,.455,41,87,.471,15,36,.417,39,58,.672,26,76,102,88,16,6,54,53,166,4.3
6242,Jeffery Ricard\jeffery-ricard--1,2013-14,Southeastern Louisiana,G,26,14,591,50,130,.385,34,85,.400,16,45,.356,50,68,.735,19,64,83,42,20,2,45,73,166,3.7
6243,Quentin Jackson\quentin-jackson-1,2016-17,Charlotte,G,30,5,512,63,160,.394,56,124,.452,7,36,.194,33,51,.647,8,49,57,38,26,10,37,64,166,3.0
6244,Jason Massey\jason-massey-1,2015-16,Brown,G,27,18,535,59,133,.444,52,106,.491,7,27,.259,41,70,.586,26,70,96,29,13,3,27,55,166,4.1
6245,J.R. Lynch\jr-lynch-1,2015-16,Hartford,G,32,23,620,55,128,.430,32,60,.533,23,68,.338,33,44,.750,6,43,49,34,24,1,26,74,166,3.3
6246,Tyler Russell\tyler-russell-1,2014-15,Houston Baptist,G,28,18,546,59,160,.369,45,111,.405,14,49,.286,34,40,.850,11,36,47,33,22,4,43,55,166,2.7
6247,P.J. Boutte\pj-boutte-1,2014-15,IUPUI,G,29,6,663,51,167,.305,29,99,.293,22,68,.324,42,54,.778,22,48,70,83,29,0,60,50,166,3.5
6248,Jordan Bone\jordan-bone-1,2016-17,Tennessee,G,23,17,450,61,164,.372,47,118,.398,14,46,.304,30,39,.769,6,33,39,66,12,0,32,29,166,4.4
6249,Andrew Brown\andrew-brown-3,2016-17,Furman,G,35,16,636,58,133,.436,15,34,.441,43,99,.434,7,13,.538,26,60,86,38,20,6,24,67,166,3.7
6250,Josh Reaves\josh-reaves-1,2015-16,Penn State,G,27,20,620,66,176,.375,63,137,.460,3,39,.077,31,41,.756,34,62,96,50,36,23,36,68,166,4.9
6251,Matt Weir\matt-weir-1,2017-18,Purdue-Fort Wayne,G,33,1,677,47,127,.370,13,42,.310,34,85,.400,38,43,.884,4,42,46,89,13,0,42,38,166,3.9
6252,Marcel White\marcel-white-1,2016-17,Jacksonville,G,12,9,338,56,130,.431,26,53,.491,30,77,.390,24,34,.706,5,28,33,13,12,3,19,20,166,8.5
6253,Anthony Fields\anthony-fields-2,2015-16,Liberty,G,32,11,768,63,141,.447,51,107,.477,12,34,.353,28,39,.718,8,28,36,91,15,0,56,57,166,3.2
6254,Lance Whitaker\lance-whitaker-1,2015-16,Illinois-Chicago,G,30,26,879,52,150,.347,32,92,.348,20,58,.345,42,75,.560,18,96,114,98,23,16,41,109,166,4.3
6255,Antonio Robinson\antonio-robinson-1,2013-14,East Carolina,G,34,23,738,61,153,.399,56,131,.427,5,22,.227,39,55,.709,19,107,126,91,37,8,50,62,166,4.5
6256,Stephan Holm\stephan-holm-1,2015-16,Montana State,G,25,4,450,62,138,.449,28,58,.483,34,80,.425,8,17,.471,9,49,58,16,10,2,22,29,166,4.0
6257,Tyler Hooker\tyler-hooker-1,2016-17,Kennesaw State,G,27,1,510,54,145,.372,43,111,.387,11,34,.324,47,83,.566,12,39,51,60,21,4,44,45,166,3.5
6258,Jay Estime'\jay-estime-1,2017-18,North Carolina-Wilmington,G,32,3,626,59,160,.369,30,62,.484,29,98,.296,19,26,.731,26,56,82,33,12,3,30,55,166,3.0
6259,Jake Wright\jake-wright-1,2017-18,Miami (OH),G,31,4,496,54,132,.409,5,12,.417,49,120,.408,9,12,.750,1,31,32,10,11,1,9,23,166,3.4
6260,Anthony Collins\anthony-collins-1,2015-16,Texas A&M,G,37,37,950,52,138,.377,24,76,.316,28,62,.452,34,39,.872,7,47,54,155,38,4,53,72,166,4.7
6261,Nyles Evans\nyles-evans-1,2014-15,Akron,G,35,34,674,59,157,.376,27,62,.435,32,95,.337,16,23,.696,16,72,88,57,33,0,31,64,166,3.6
6262,Chris Harrison-Docks\chris-harrison-docks-1,2016-17,DePaul,G,26,0,508,55,152,.362,15,37,.405,40,115,.348,15,16,.938,6,14,20,21,15,0,27,40,165,2.9
6263,Isaac Belton\isaac-belton-1,2016-17,Longwood,G,30,12,609,59,159,.371,41,76,.539,18,83,.217,29,36,.806,16,52,68,32,16,11,36,78,165,2.7
6264,Justin Jones\justin-jones-3,2017-18,South Carolina State,G,32,6,469,59,169,.349,29,74,.392,30,95,.316,17,30,.567,13,38,51,19,12,1,30,20,165,2.3
6265,Ben Hazel\ben-hazel-1,2013-14,Princeton,G,27,16,629,51,135,.378,19,42,.452,32,93,.344,31,34,.912,4,64,68,14,21,5,24,36,165,4.0
6266,Nazeer Bostick\nazeer-bostick-1,2017-18,Penn State,G,35,3,601,56,134,.418,49,106,.462,7,28,.250,46,63,.730,30,49,79,24,22,6,38,56,165,3.0
6267,Caleb Bennett\caleb-bennett-1,2017-18,Lehigh,G,30,1,551,59,131,.450,45,97,.464,14,34,.412,33,44,.750,12,58,70,24,11,6,42,64,165,2.8
6268,Rayshawn Miller\rayshawn-miller-1,2017-18,Massachusetts,G,33,14,820,61,169,.361,30,70,.429,31,99,.313,12,17,.706,7,46,53,64,13,2,35,51,165,2.8
6269,Tevin Jackson\tevin-jackson-1,2015-16,McNeese State,G,29,18,512,67,163,.411,56,126,.444,11,37,.297,20,31,.645,24,74,98,45,16,6,43,56,165,3.4
6270,Devon Walker\devon-walker-2,2013-14,Maryland-Eastern Shore,G,24,7,401,58,143,.406,22,50,.440,36,93,.387,13,17,.765,15,27,42,21,24,1,25,38,165,4.3
6271,K.J. Walton\kj-walton-1,2015-16,Missouri,G,31,7,427,50,115,.435,39,85,.459,11,30,.367,54,78,.692,24,34,58,27,14,2,23,35,165,3.8
6272,Te'Jon Lucas\tejon-lucas-1,2017-18,Illinois,G,29,19,620,64,134,.478,59,115,.513,5,19,.263,32,52,.615,12,53,65,94,31,3,56,74,165,4.4
6273,Dallas Cameron\dallas-cameron-1,2014-15,Stephen F. Austin,G,34,14,649,47,115,.409,26,61,.426,21,54,.389,50,69,.725,10,37,47,49,19,5,44,52,165,3.1
6274,Quavius Copeland\quavius-copeland-1,2015-16,Middle Tennessee,G,35,8,524,66,158,.418,55,112,.491,11,46,.239,22,34,.647,2,30,32,63,13,0,53,41,165,2.1
6275,Josh Herbeck\josh-herbeck-1,2013-14,Army,G,31,7,450,56,164,.341,10,27,.370,46,137,.336,7,13,.538,10,20,30,22,11,0,18,31,165,2.6
6276,Justin Bassey\justin-bassey-1,2016-17,Harvard,G,27,20,740,57,101,.564,37,52,.712,20,49,.408,31,38,.816,22,101,123,41,18,2,25,55,165,6.0
6277,Nigel Johnson\nigel-johnson-2,2014-15,Kansas State,G,32,7,572,51,128,.398,31,69,.449,20,59,.339,43,64,.672,11,41,52,55,32,0,32,34,165,4.1
6278,Alex Robinson\alex-robinson-2,2014-15,Texas A&M,G,32,0,600,65,155,.419,52,119,.437,13,36,.361,22,37,.595,15,60,75,84,15,2,53,45,165,3.4
6279,Chad Brown\chad-brown-1,2017-18,Central Florida,G,32,15,597,56,110,.509,56,110,.509,0,0,,53,93,.570,57,90,147,5,16,34,26,72,165,4.7
6280,Jordan Robertson\jordan-robertson-2,2015-16,Colgate,G,27,9,453,58,132,.439,35,72,.486,23,60,.383,26,44,.591,22,33,55,12,6,3,21,45,165,3.4
6281,Zach Thomas\zach-thomas-1,2014-15,Bucknell,G,22,9,356,45,98,.459,27,63,.429,18,35,.514,56,74,.757,21,63,84,19,8,6,29,36,164,5.5
6282,Josh Williams\josh-williams-4,2015-16,Lipscomb,G,14,13,322,58,126,.460,31,63,.492,27,63,.429,21,31,.677,12,26,38,20,14,5,26,37,164,7.3
6283,Galen Robinson Jr.\galen-robinsonjr-1,2017-18,Houston,G,35,32,859,63,141,.447,59,119,.496,4,22,.182,34,48,.708,11,74,85,130,46,3,58,68,164,4.8
6284,Devonte' Graham\devonte-graham-1,2014-15,Kansas,G,29,0,517,46,117,.393,29,77,.377,17,40,.425,55,76,.724,8,35,43,61,25,0,33,44,164,4.3
6285,UC Iroegbu\uc-iroegbu-1,2016-17,Stony Brook,G,32,9,571,54,171,.316,14,37,.378,40,134,.299,16,21,.762,12,51,63,27,11,9,18,55,164,2.6
6286,Dakota Mathias\dakota-mathias-1,2014-15,Purdue,G,34,17,667,52,159,.327,14,41,.341,38,118,.322,22,31,.710,3,69,72,47,17,3,26,58,164,2.8
6287,Frank Booker\frank-booker-1,2013-14,Oklahoma,G,32,0,451,49,134,.366,7,20,.350,42,114,.368,24,36,.667,14,35,49,17,14,5,19,50,164,3.0
6288,Josh Langford\josh-langford-1,2013-14,Southeast Missouri State,G,22,18,413,70,116,.603,65,104,.625,5,12,.417,19,38,.500,33,44,77,12,11,3,30,76,164,4.6
6289,Austin Stewart\austin-stewart-1,2014-15,Central Michigan,G,32,0,479,52,102,.510,36,72,.500,16,30,.533,44,65,.677,45,65,110,13,25,0,30,43,164,4.5
6290,William Gates\william-gates-2,2017-18,Houston Baptist,G,29,23,579,69,158,.437,60,118,.508,9,40,.225,17,37,.459,11,28,39,16,10,2,22,31,164,2.7
6291,Cameron Allen\cameron-allen-1,2017-18,Loyola Marymount,G,31,4,556,59,162,.364,41,109,.376,18,53,.340,28,42,.667,10,37,47,57,13,5,41,44,164,2.7
6292,Javon McKay\javon-mckay-1,2014-15,Tennessee Tech,G,29,21,580,58,119,.487,50,91,.549,8,28,.286,40,54,.741,34,51,85,35,19,13,38,49,164,4.6
6293,Asad Lamot\asad-lamot-1,2015-16,North Carolina-Greensboro,G,34,4,762,54,131,.412,15,32,.469,39,99,.394,17,21,.810,10,52,62,22,17,3,23,84,164,2.7
6294,Julian Boatner\julian-boatner-1,2013-14,William & Mary,G,32,25,664,55,124,.444,8,14,.571,47,110,.427,7,11,.636,3,42,45,48,16,2,21,45,164,3.9
6295,Broderick Robinson\broderick-robinson-1,2016-17,Missouri-Kansas City,G,35,7,795,50,135,.370,12,42,.286,38,93,.409,26,39,.667,29,100,129,61,38,2,47,64,164,4.1
6296,Jarvis Pugh\jarvis-pugh-1,2016-17,Santa Clara,G,19,11,512,56,125,.448,37,73,.507,19,52,.365,33,47,.702,17,70,87,25,18,6,23,54,164,6.4
6297,Rex Pflueger\rex-pfleuger-1,2016-17,Notre Dame,G,35,11,751,59,133,.444,32,65,.492,27,68,.397,19,29,.655,18,78,96,53,31,12,24,60,164,4.4
6298,Josh Newkirk\josh-newkirk-1,2013-14,Pittsburgh,G,36,0,617,62,134,.463,39,81,.481,23,53,.434,17,38,.447,6,37,43,61,14,1,30,60,164,2.9
6299,Amauri Hardy\amauri-hardy-1,2017-18,Nevada-Las Vegas,G,33,0,625,60,148,.405,40,80,.500,20,68,.294,24,33,.727,7,44,51,54,14,6,25,43,164,3.4
6300,Ismael Sanogo\ismael-sanogo-1,2015-16,Seton Hall,G,33,31,922,61,122,.500,61,121,.504,0,1,.000,42,73,.575,90,148,238,44,46,35,39,106,164,6.6
6301,Travis Daniels\travis-daniels-1,2015-16,Mississippi State,G,29,26,677,63,133,.474,43,83,.518,20,50,.400,18,27,.667,55,76,131,22,14,19,30,66,164,4.8
6302,Ronnie Rousseau III\ronnie-rousseauiii-1,2016-17,Missouri State,G,14,14,379,58,119,.487,44,84,.524,14,35,.400,33,41,.805,4,26,30,40,11,0,22,20,163,8.5
6303,RaShawn Stores\rashawn-stores-1,2013-14,Manhattan,G,33,25,740,49,133,.368,16,45,.356,33,88,.375,32,42,.762,17,50,67,64,36,1,33,93,163,3.7
6304,Rodney Chatman\rodney-chatman-1,2016-17,Chattanooga,G,31,3,623,51,139,.367,42,104,.404,9,35,.257,52,72,.722,6,60,66,69,25,2,66,74,163,2.6
6305,Schane Rillieux\shane-rillieux-1,2013-14,Nicholls State,G,27,27,832,56,139,.403,49,107,.458,7,32,.219,44,98,.449,12,56,68,70,20,2,54,59,163,3.1
6306,Jahaad Proctor\jahaad-proctor-1,2015-16,Iona,G,32,5,486,61,133,.459,44,73,.603,17,60,.283,24,34,.706,15,49,64,34,14,2,22,31,163,3.8
6307,Jonathan Dalton\jonathan-dalton-1,2017-18,Southeast Missouri State,G,31,29,998,51,107,.477,32,57,.561,19,50,.380,42,62,.677,19,50,69,168,38,0,62,61,163,6.4
6308,Langston Morris-Walker\langston-morris-walker-1,2015-16,Oregon State,G,32,16,539,52,145,.359,27,74,.365,25,71,.352,34,54,.630,20,57,77,28,20,1,19,32,163,3.6
6309,Anthony Clemmons\anthony-clemmons-1,2014-15,Iowa,G,34,12,677,48,126,.381,26,67,.388,22,59,.373,45,60,.750,12,54,66,64,24,1,38,53,163,3.6
6310,Ryan Manuel\ryan-manuel-1,2013-14,Southern Methodist,G,36,11,620,42,93,.452,39,86,.453,3,7,.429,76,115,.661,19,62,81,32,22,15,32,67,163,3.5
6311,Armon Fletcher\armon-fletcher-1,2015-16,Southern Illinois,G,32,0,462,60,137,.438,39,72,.542,21,65,.323,22,36,.611,33,42,75,15,20,7,25,65,163,3.3
6312,Justin Cousin\justin-cousin-1,2015-16,Radford,G,31,13,513,58,154,.377,23,49,.469,35,105,.333,12,19,.632,12,29,41,30,12,1,24,43,163,2.7
6313,Michael Bethea Jr.\michael-betheajr-1,2015-16,Grambling,G,31,20,589,52,174,.299,19,45,.422,33,129,.256,26,32,.813,12,51,63,20,26,3,24,39,163,2.8
6314,Gabe DeVoe\gabe-devoe-1,2015-16,Clemson,G,31,0,606,57,167,.341,26,64,.406,31,103,.301,18,25,.720,14,72,86,43,14,5,34,55,163,2.9
6315,Jorden Kite\jorden-kite-1,2016-17,Incarnate Word,G,26,6,415,47,132,.356,11,27,.407,36,105,.343,33,36,.917,3,31,34,13,12,0,15,27,163,3.7
6316,Jarvis Garrett\jarvis-garrett-1,2016-17,Rhode Island,G,27,16,601,53,137,.387,34,76,.447,19,61,.311,38,52,.731,8,39,47,79,23,3,38,45,163,4.6
6317,Cam Ward\cam-ward-1,2017-18,Vermont,G,35,3,531,53,117,.453,25,49,.510,28,68,.412,29,48,.604,6,40,46,45,12,0,28,42,163,3.1
6318,Chris Kendrix\chris-kendrix-1,2016-17,Missouri State,G,30,1,411,47,128,.367,21,47,.447,26,81,.321,43,52,.827,15,68,83,8,16,12,30,44,163,3.4
6319,Ty Outlaw\ty-outlaw-1,2013-14,North Carolina-Greensboro,G,30,5,437,57,138,.413,40,86,.465,17,52,.327,32,39,.821,29,34,63,16,21,10,22,37,163,4.0
6320,Allerik Freeman\allerik-freeman-2,2014-15,Baylor,G,34,1,581,55,129,.426,35,67,.522,20,62,.323,33,47,.702,16,48,64,34,10,0,39,29,163,2.9
6321,Jaylen Brantley\jaylen-brantley-1,2016-17,Maryland,G,33,0,555,55,144,.382,23,61,.377,32,83,.386,21,34,.618,9,56,65,32,17,0,21,44,163,3.1
6322,Marquise Pointer\marquise-pointer-1,2016-17,College of Charleston,G,35,1,773,56,181,.309,32,88,.364,24,93,.258,27,42,.643,23,47,70,62,26,8,45,48,163,2.7
6323,Marqueze Coleman\marqueze-coleman-1,2013-14,Nevada,G,27,3,479,53,134,.396,44,99,.444,9,35,.257,48,65,.738,15,41,56,17,16,5,34,64,163,2.9
6324,Tadric Jackson\tadric-jackson-1,2014-15,Georgia Tech,G,30,6,451,55,201,.274,39,111,.351,16,90,.178,37,60,.617,16,35,51,28,4,4,17,36,163,1.7
6325,Benny Parker\benny-parker-1,2015-16,Nebraska,G,34,34,878,57,148,.385,33,72,.458,24,76,.316,25,29,.862,14,64,78,74,38,2,41,77,163,3.8
6326,Carson Warren-Newsome\carson-warren-newsome-1,2017-18,Milwaukee,G,27,4,433,54,148,.365,31,65,.477,23,83,.277,32,41,.780,11,40,51,20,19,2,21,30,163,3.6
6327,Jordan Hunter\jordan-hunter-1,2016-17,New Mexico,G,29,13,575,49,109,.450,29,63,.460,20,46,.435,45,53,.849,8,50,58,75,15,1,40,54,163,4.5
6328,Matt Milon\matt-milon-1,2015-16,Boston College,G,30,3,499,55,119,.462,16,40,.400,39,79,.494,14,14,1.000,10,31,41,16,8,2,26,32,163,3.3
6329,Demetrius Troy\demetrius-troy-1,2015-16,North Carolina-Greensboro,G,27,0,525,57,152,.375,25,74,.338,32,78,.410,17,23,.739,10,47,57,61,30,2,39,54,163,4.1
6330,J.R. Lyle\jr-lyle-1,2014-15,Milwaukee,G,26,16,601,54,131,.412,32,64,.500,22,67,.328,33,50,.660,14,25,39,30,27,1,34,69,163,3.5
6331,Kasey Shepherd\kasey-shepherd-1,2013-14,Louisiana,G,20,1,338,53,99,.535,27,51,.529,26,48,.542,31,33,.939,6,42,48,26,24,2,29,35,163,6.6
6332,Jared Nickens\jared-nickens-1,2017-18,Maryland,G,32,2,514,56,135,.415,13,31,.419,43,104,.413,8,13,.615,10,34,44,10,5,4,16,28,163,2.9
6333,Jaden Jackson\jaden-jackson-1,2014-15,Utah Valley,G,30,2,537,58,177,.328,34,90,.378,24,87,.276,23,32,.719,6,39,45,41,17,0,22,37,163,2.8
6334,Dontay Caruthers\dontay-caruthers-1,2016-17,Buffalo,G,32,15,708,52,117,.444,37,64,.578,15,53,.283,44,61,.721,18,53,71,73,58,2,46,99,163,4.6
6335,Maishe Dailey\maishe-dailey-1,2017-18,Iowa,G,33,0,544,58,136,.426,30,64,.469,28,72,.389,19,33,.576,6,58,64,52,10,2,29,23,163,3.5
6336,Manuale Watkins\manuale-watkins-1,2015-16,Arkansas,G,32,9,629,69,145,.476,69,144,.479,0,1,.000,25,46,.543,29,67,96,66,25,3,24,55,163,4.6
6337,Madison Williams\madison-williams-1,2017-18,Illinois State,G,31,27,754,56,175,.320,18,57,.316,38,118,.322,13,17,.765,9,67,76,43,33,10,40,87,163,2.7
6338,Chris Bolden\chris-bolden-1,2013-14,Georgia Tech,G,30,14,725,59,198,.298,27,93,.290,32,105,.305,13,19,.684,15,58,73,38,17,3,33,54,163,2.2
6339,Devin Harris\devin-harris-2,2014-15,East Tennessee State,G,27,1,587,52,130,.400,47,115,.409,5,15,.333,54,81,.667,52,102,154,27,24,5,42,65,163,4.7
6340,Isaac Thornton\isaac-thornton-1,2015-16,San Jose State,G,31,20,602,51,125,.408,39,87,.448,12,38,.316,49,72,.681,14,69,83,78,43,15,50,79,163,4.6
6341,Jacob Van\jacob-van-1,2017-18,Air Force,G,31,10,481,44,123,.358,18,52,.346,26,71,.366,48,54,.889,4,32,36,35,16,2,33,30,162,3.2
6342,Khufu Najee\khufu-najee-1,2014-15,IUPUI,G,22,18,520,64,144,.444,58,122,.475,6,22,.273,28,35,.800,19,49,68,26,16,4,37,45,162,4.3
6343,Tevin Broyles\tevin-broyles-1,2015-16,New Orleans,G,22,20,496,52,141,.369,43,112,.384,9,29,.310,49,69,.710,12,42,54,34,26,1,54,64,162,3.1
6344,Xavier Talton\xavier-talton-1,2015-16,Colorado,G,34,10,696,49,144,.340,26,80,.325,23,64,.359,41,45,.911,16,70,86,66,25,3,41,73,162,3.4
6345,Josh Castellanos\josh-castellanos-1,2013-14,Gardner-Webb,G,33,5,669,41,113,.363,25,68,.368,16,45,.356,64,88,.727,7,39,46,93,25,2,40,49,162,4.2
6346,Evan Conti\evan-conti-1,2013-14,Quinnipiac,G,32,6,603,56,144,.389,35,75,.467,21,69,.304,29,38,.763,23,101,124,69,15,2,30,56,162,4.3
6347,Kenny Williams\kenny-williams-3,2016-17,North Carolina,G,26,22,617,58,139,.417,31,59,.525,27,80,.338,19,30,.633,34,52,86,56,23,8,30,40,162,5.6
6348,Twann Oakley\twann-oakley-1,2013-14,Alcorn State,G,28,7,445,50,126,.397,23,43,.535,27,83,.325,35,46,.761,11,30,41,16,16,3,16,21,162,4.0
6349,Remond Brown\remond-brown-1,2015-16,Grambling,G,15,13,432,58,130,.446,51,99,.515,7,31,.226,39,60,.650,21,62,83,32,11,8,32,40,162,7.3
6350,JR Hobbie\norman-hobbie-1,2013-14,Brown,G,27,1,409,51,121,.421,5,14,.357,46,107,.430,14,16,.875,1,20,21,9,3,0,14,32,162,3.2
6351,John Brown\john-brown-4,2015-16,South Alabama,G,32,1,519,62,147,.422,46,96,.479,16,51,.314,22,28,.786,21,45,66,28,19,13,28,33,162,3.6
6352,Eric Robertson\eric-robertson-1,2013-14,Chattanooga,G,33,0,535,54,142,.380,23,67,.343,31,75,.413,23,36,.639,33,34,67,35,18,7,28,74,162,3.1
6353,Briante Weber\briante-weber-1,2014-15,Virginia Commonwealth,G,20,19,529,55,137,.401,43,108,.398,12,29,.414,40,54,.741,14,59,73,85,78,4,34,39,162,10.0
6354,Ben Nakwaasah\ben-nakwaasah-1,2017-18,Utah Valley,G,34,1,585,54,149,.362,25,66,.379,29,83,.349,25,30,.833,10,60,70,74,23,2,41,66,162,3.3
6355,Dontae Caldwell\dontae-caldwell-1,2015-16,Maryland-Eastern Shore,G,32,0,424,51,125,.408,27,56,.482,24,69,.348,36,44,.818,20,33,53,15,16,6,38,42,162,2.9
6356,C.J. Anderson\cj-anderson-3,2016-17,Massachusetts,G,33,8,727,61,122,.500,43,72,.597,18,50,.360,22,34,.647,23,67,90,75,30,1,37,51,162,4.8
6357,Daniel Norl\daniel-norl-1,2016-17,Omaha,G,29,0,446,52,129,.403,22,49,.449,30,80,.375,28,35,.800,6,36,42,29,9,2,32,36,162,3.1
6358,Xavian Stapleton\xavian-stapleton-1,2016-17,Mississippi State,G,23,6,385,58,128,.453,40,74,.541,18,54,.333,28,44,.636,24,42,66,7,22,10,21,66,162,4.6
6359,Drew Charles\drew-charles-1,2014-15,Texas-Arlington,G,23,18,460,53,126,.421,30,70,.429,23,56,.411,33,41,.805,12,42,54,34,13,0,26,50,162,4.5
6360,Kain Harris\kain-harris-1,2015-16,Tulane,G,33,2,523,51,162,.315,27,78,.346,24,84,.286,36,45,.800,7,41,48,12,4,4,22,54,162,1.6
6361,Oliver Lynch-Daniels\oliver-lynch-daniels-1,2017-18,Houston Baptist,G,30,0,494,58,154,.377,34,87,.391,24,67,.358,22,30,.733,24,30,54,52,16,6,34,60,162,3.3
6362,Colton Weisbrod\colton-weisbrod-1,2014-15,New Orleans,G,23,12,428,65,124,.524,65,122,.533,0,2,.000,32,57,.561,32,40,72,10,14,5,18,54,162,4.8
6363,Riley Norris\riley-norris-1,2014-15,Alabama,G,34,8,712,55,145,.379,30,71,.423,25,74,.338,26,43,.605,40,102,142,22,21,7,31,79,161,3.3
6364,Marcus Garrett\marcus-garrett-1,2017-18,Kansas,G,39,7,748,62,136,.456,50,91,.549,12,45,.267,25,51,.490,36,95,131,44,35,8,30,60,161,3.9
6365,Jonathan Milligan\jonathan-milligan-1,2017-18,Pittsburgh,G,32,10,562,52,125,.416,42,76,.553,10,49,.204,47,63,.746,4,31,35,47,10,1,40,30,161,2.9
6366,Marcus Owens\marcus-owens-1,2016-17,Lamar,G,33,11,537,53,135,.393,14,36,.389,39,99,.394,16,18,.889,26,71,97,13,13,3,14,70,161,3.3
6367,Raymon Pratt\raymon-pratt-1,2016-17,North Carolina A&T,G,31,15,590,66,161,.410,57,123,.463,9,38,.237,20,35,.571,19,60,79,25,12,5,30,45,161,2.7
6368,Connor Burchfield\connor-burchfield-1,2016-17,William & Mary,G,31,5,446,53,114,.465,12,29,.414,41,85,.482,14,20,.700,4,37,41,22,15,3,10,36,161,3.9
6369,Kendall Knorr\kendall-knorr-1,2013-14,Navy,G,30,27,671,55,146,.377,33,69,.478,22,77,.286,29,37,.784,35,73,108,57,27,4,36,49,161,4.6
6370,JC Younger\jc-younger-1,2016-17,Presbyterian,G,21,14,516,52,140,.371,26,68,.382,26,72,.361,31,37,.838,11,48,59,24,9,2,40,41,161,3.5
6371,CJ Walker\cj-walker-2,2016-17,Florida State,G,33,0,414,54,136,.397,37,80,.463,17,56,.304,36,55,.655,13,33,46,44,20,2,25,55,161,3.2
6372,Derrick Wilson\derrick-wilson-1,2013-14,Marquette,G,32,31,987,61,156,.391,60,142,.423,1,14,.071,38,86,.442,40,82,122,135,41,2,48,80,161,5.2
6373,Evan Taylor\evan-taylor-1,2016-17,Nebraska,G,31,21,755,64,155,.413,58,130,.446,6,25,.240,27,37,.730,17,72,89,37,28,3,37,54,161,3.4
6374,Chris Thomas\chris-thomas-6,2015-16,Southern,G,35,0,591,56,154,.364,55,136,.404,1,18,.056,48,79,.608,38,88,126,13,18,10,36,81,161,2.3
6375,Sterling Brown\sterling-brown-2,2013-14,Southern Methodist,G,37,26,719,60,128,.469,43,81,.531,17,47,.362,24,42,.571,45,94,139,40,27,11,43,60,161,3.9
6376,Devon Hall\devon-hall-1,2015-16,Virginia,G,37,20,809,57,153,.373,36,89,.404,21,64,.328,26,34,.765,8,90,98,74,17,10,33,52,161,3.5
6377,Brent Wrapp\brent-wrapp-1,2016-17,Cal State Bakersfield,G,34,34,824,48,119,.403,34,76,.447,14,43,.326,51,75,.680,18,108,126,122,35,9,53,80,161,5.1
6378,Dion Wiley\dion-wiley-1,2017-18,Maryland,G,28,16,608,59,141,.418,23,43,.535,36,98,.367,7,9,.778,7,44,51,19,13,4,22,31,161,3.5
6379,D.J. Jackson\dj-jackson-2,2013-14,Oral Roberts,G,31,19,820,45,134,.336,24,67,.358,21,67,.313,50,62,.806,15,44,59,95,25,0,45,44,161,4.3
6380,Ron Trapps\ron-trapps-1,2015-16,Coastal Carolina,G,31,0,378,57,150,.380,24,51,.471,33,99,.333,14,20,.700,18,35,53,23,11,0,26,21,161,3.0
6381,Robert Heyer\robert-heyer-1,2014-15,Boise State,G,34,5,704,54,103,.524,32,50,.640,22,53,.415,31,36,.861,43,64,107,24,14,7,24,63,161,4.2
6382,Jason Boswell\jason-boswell-1,2015-16,Florida International,G,32,31,831,57,140,.407,34,76,.447,23,64,.359,24,35,.686,11,59,70,54,14,7,34,94,161,2.9
6383,Aqeel Quinn\aqeel-quinn-1,2013-14,San Diego State,G,32,1,515,53,146,.363,25,66,.379,28,80,.350,27,37,.730,11,41,52,31,23,2,23,42,161,3.2
6384,Stephon Whyatt\stephon-whyatt-1,2013-14,Saint Francis (PA),G,30,7,539,59,127,.465,46,78,.590,13,49,.265,30,47,.638,8,27,35,40,21,2,20,45,161,3.8
6385,Davion Turner\davion-turner-1,2017-18,Texas-Arlington,G,30,7,448,52,108,.481,22,40,.550,30,68,.441,27,37,.730,23,63,86,18,7,15,22,37,161,4.4
6386,Brannen Greene\brannen-greene-1,2015-16,Kansas,G,30,1,371,44,84,.524,13,21,.619,31,63,.492,42,50,.840,4,59,63,25,9,1,28,32,161,4.1
6387,Jake Lindsey\jake-lindsey-1,2016-17,Baylor,G,35,4,790,59,132,.447,38,80,.475,21,52,.404,22,31,.710,17,61,78,110,17,13,39,71,161,4.4
6388,Anthony Harris\anthony-harris-9,2017-18,Chicago State,G,28,16,556,56,126,.444,44,89,.494,12,37,.324,37,52,.712,21,51,72,34,26,14,35,73,161,4.1
6389,Nick Robinson\nick-robinson-2,2016-17,Saint Joseph's,G,31,19,724,52,146,.356,42,102,.412,10,44,.227,46,81,.568,27,86,113,60,14,15,49,74,160,3.1
6390,Ishaq Pitt\ishaq-pitt-1,2013-14,Maryland-Eastern Shore,G,30,13,629,52,112,.464,52,111,.468,0,1,.000,56,99,.566,35,95,130,41,25,5,32,72,160,4.5
6391,Jahir Cabeza\jahir-cabeza-1,2016-17,Savannah State,G,29,15,540,54,164,.329,25,49,.510,29,115,.252,23,41,.561,32,87,119,43,28,34,28,77,160,4.5
6392,Anton Beard\anton-beard-1,2015-16,Arkansas,G,23,1,481,57,164,.348,38,98,.388,19,66,.288,27,42,.643,13,40,53,40,23,2,17,53,160,4.2
6393,Lew Stallworth\lew-stallworth-1,2017-18,Texas-Rio Grande Valley,G,28,5,544,54,137,.394,35,76,.461,19,61,.311,33,46,.717,16,65,81,90,17,1,43,52,160,4.6
6394,Gabe Stefanini\gabe-stefanini-1,2017-18,Columbia,G,27,1,354,61,137,.445,35,80,.438,26,57,.456,12,19,.632,19,33,52,27,21,2,31,42,160,3.8
6395,Freddie Wilson\freddie-wilson-1,2014-15,Drexel,G,30,6,636,53,160,.331,23,61,.377,30,99,.303,24,39,.615,4,41,45,45,18,2,36,46,160,2.5
6396,Marcel Smith\marcel-smith-1,2013-14,Houston Baptist,G,26,18,635,52,134,.388,28,69,.406,24,65,.369,32,36,.889,10,33,43,78,14,0,44,52,160,4.1
6397,Lapri McCray-Pace\lapri-mccray-pace-1,2017-18,Morgan State,G,27,10,461,50,133,.376,35,96,.365,15,37,.405,45,63,.714,34,40,74,22,21,7,24,56,160,4.1
6398,Frank Booker\frank-booker-1,2014-15,Oklahoma,G,32,0,459,48,146,.329,12,27,.444,36,119,.303,28,34,.824,10,34,44,18,16,5,23,45,160,2.6
6399,Eric Childress\eric-childress-1,2013-14,UC-Santa Barbara,G,30,2,627,51,119,.429,41,90,.456,10,29,.345,48,73,.658,18,47,65,94,28,0,57,60,160,4.2
6400,Jahmiah Simmons\jahmiah-simmons-1,2016-17,Arkansas State,G,25,9,462,57,106,.538,57,104,.548,0,2,.000,46,69,.667,44,80,124,6,9,21,26,85,160,4.9
6401,Ridge Shipley\ridge-shipley-1,2015-16,Cal Poly,G,29,20,671,51,150,.340,16,42,.381,35,108,.324,23,36,.639,8,41,49,62,20,2,35,45,160,3.4
6402,Devin Mitchell\devin-mitchell-1,2016-17,Georgia State,G,33,5,390,52,129,.403,18,34,.529,34,95,.358,22,33,.667,6,27,33,20,10,3,19,40,160,2.7
6403,Michael Ramey\michael-ramey-1,2015-16,Southern Mississippi,G,29,5,488,58,149,.389,21,52,.404,37,97,.381,6,9,.667,3,34,37,11,6,0,15,48,159,2.4
6404,Houston Smith\houston-smith-1,2017-18,Bethune-Cookman,G,32,6,704,61,113,.540,50,82,.610,11,31,.355,26,46,.565,47,83,130,38,12,9,36,79,159,4.1
6405,Idris Taqqee\idris-taqqee-1,2015-16,St. Bonaventure,G,31,30,802,61,132,.462,45,86,.523,16,46,.348,21,33,.636,49,76,125,36,25,11,23,82,159,4.7
6406,Jalen Little\jalen-little-1,2015-16,Abilene Christian,G,26,22,737,48,125,.384,26,63,.413,22,62,.355,41,49,.837,9,68,77,116,33,2,50,67,159,5.9
6407,Charles Tucker\charles-tucker-1,2014-15,Tennessee State,G,31,18,668,43,107,.402,29,65,.446,14,42,.333,59,74,.797,4,36,40,71,13,0,54,49,159,3.2
6408,Eric Lockett\eric-lockett-1,2016-17,Florida International,G,31,13,795,62,138,.449,54,109,.495,8,29,.276,27,48,.563,16,75,91,75,22,10,47,70,159,3.8
6409,J.C. Show\jc-show-1,2016-17,Binghamton,G,12,12,346,51,120,.425,27,53,.509,24,67,.358,33,40,.825,8,39,47,21,7,0,25,21,159,8.2
6410,Michael Grant\michael-grant-2,2013-14,Abilene Christian,G,31,17,642,55,111,.495,55,106,.519,0,5,.000,49,72,.681,26,45,71,32,30,12,49,71,159,3.5
6411,Cheikh Diallo\cheikh-diallo-1,2017-18,American,G,30,21,723,57,137,.416,24,37,.649,33,100,.330,12,17,.706,14,55,69,28,17,2,47,64,159,2.5
6412,Karim Rowson\karim-rowson-1,2013-14,South Dakota,G,30,20,550,49,112,.438,42,88,.477,7,24,.292,54,82,.659,21,71,92,17,17,6,34,38,159,3.6
6413,Exavian Christon\exavian-christon-1,2017-18,Louisiana Tech,G,33,3,542,57,135,.422,34,65,.523,23,70,.329,22,25,.880,11,59,70,21,18,2,25,45,159,3.1
6414,Travis Hammonds\travis-hammonds-1,2014-15,Cal State Long Beach,G,25,3,423,53,113,.469,35,67,.522,18,46,.391,35,50,.700,16,51,67,12,15,4,28,54,159,3.9
6415,James Whitaker\james-whitaker-1,2014-15,North Carolina A&T,G,32,5,518,50,155,.323,34,85,.400,16,70,.229,43,56,.768,18,35,53,10,15,8,42,43,159,1.8
6416,Aleksa Nikolic\aleksa-nikolic-1,2014-15,Marshall,G,32,25,833,63,225,.280,50,161,.311,13,64,.203,20,28,.714,21,110,131,111,34,4,95,63,159,2.0
6417,Dupree McBrayer\dupree-mcbrayer-1,2015-16,Minnesota,G,27,14,617,44,135,.326,32,87,.368,12,48,.250,59,95,.621,7,56,63,68,27,3,33,50,159,4.2
6418,Na'Quan Council\naquan-council-1,2016-17,Manhattan,G,32,2,417,46,158,.291,21,58,.362,25,100,.250,42,54,.778,17,32,49,18,30,0,27,38,159,2.6
6419,Devonte Hall\devonte-hall-1,2014-15,Northwestern State,G,32,3,641,61,177,.345,54,129,.419,7,48,.146,30,43,.698,18,48,66,56,31,4,37,76,159,2.7
6420,Camron Reedus\camron-reedus-1,2017-18,Little Rock,G,22,6,410,49,118,.415,17,35,.486,32,83,.386,29,35,.829,6,33,39,13,14,1,31,37,159,3.9
6421,JaMarcus Weatherspoon\jamarcus-witherspoon-1,2016-17,Southern,G,33,3,482,56,125,.448,56,123,.455,0,2,.000,47,70,.671,33,57,90,19,13,6,30,54,159,3.1
6422,Ryan Majerle\ryan-majerle-2,2015-16,Grand Canyon,G,34,1,522,50,125,.400,8,20,.400,42,105,.400,17,21,.810,10,30,40,17,7,7,10,28,159,3.2
6423,Jordan Baker\jordan-baker-3,2013-14,Old Dominion,G,36,2,659,50,141,.355,17,52,.327,33,89,.371,26,36,.722,11,65,76,41,23,0,45,77,159,2.2
6424,Arturs Bremers\arturs-bremers-1,2014-15,North Carolina A&T,G,26,22,645,48,144,.333,2,11,.182,46,133,.346,17,19,.895,10,36,46,28,11,1,32,30,159,3.1
6425,Jeffrey Altidort\jeffrey-altidort-1,2017-18,Bethune-Cookman,G,25,21,646,52,129,.403,32,68,.471,20,61,.328,35,49,.714,3,56,59,59,21,8,41,71,159,4.1
6426,Micah Bradford\micah-bradford-1,2017-18,Valparaiso,G,31,0,506,55,161,.342,30,70,.429,25,91,.275,24,49,.490,4,41,45,68,21,2,38,60,159,2.6
6427,Myles Stephens\myles-stephens-1,2015-16,Princeton,G,29,0,423,56,116,.483,47,85,.553,9,31,.290,38,58,.655,15,54,69,11,12,13,28,36,159,3.6
6428,Balint Mocsan\balint-mocsan-1,2016-17,Idaho State,G,28,8,500,51,119,.429,11,26,.423,40,93,.430,16,26,.615,7,39,46,12,11,0,18,56,158,3.1
6429,Matt Thomas\matt-thomas-2,2014-15,Iowa State,G,32,0,488,53,144,.368,21,47,.447,32,97,.330,20,28,.714,6,57,63,22,11,2,15,36,158,3.0
6430,Mason Archie\mason-archie-1,2015-16,IUPUI,G,32,23,807,51,156,.327,33,85,.388,18,71,.254,38,51,.745,28,68,96,29,14,2,33,73,158,2.4
6431,Marcus Bartley\marcus-bartley-1,2014-15,Saint Louis,G,32,16,613,52,126,.413,15,40,.375,37,86,.430,17,29,.586,6,47,53,55,12,3,44,82,158,2.5
6432,Darius Thompson\darius-thompson-1,2015-16,Virginia,G,37,10,648,58,108,.537,42,67,.627,16,41,.390,26,36,.722,8,36,44,53,27,7,32,53,158,3.6
6433,Detrick Mostella\detrick-mostella-1,2016-17,Tennessee,G,15,1,323,53,131,.405,27,61,.443,26,70,.371,26,37,.703,8,51,59,18,6,6,22,31,158,6.2
6434,Christopher Hyder\christopher-hyder-1,2014-15,Southern,G,35,35,1025,52,125,.416,50,112,.446,2,13,.154,52,73,.712,25,109,134,137,45,1,58,64,158,5.5
6435,Amadi Udenyi\amadi-udenyi-1,2015-16,Pepperdine,G,32,3,756,53,157,.338,33,81,.407,20,76,.263,32,58,.552,7,61,68,145,31,1,49,62,158,4.4
6436,Bryce Moore\bryce-moore-1,2016-17,Western Michigan,G,31,16,766,50,143,.350,16,48,.333,34,95,.358,24,38,.632,9,45,54,39,18,2,25,70,158,2.8
6437,DeAngelo Stewart\deangelo-stewart-1,2016-17,Purdue-Fort Wayne,G,32,5,528,54,139,.388,18,35,.514,36,104,.346,14,19,.737,13,57,70,25,20,3,15,37,158,3.6
6438,Thomas Capuano\thomas-capuano-1,2015-16,Manhattan,G,31,9,824,59,150,.393,30,70,.429,29,80,.363,11,20,.550,11,41,52,58,43,0,33,64,158,3.8
6439,C.J. Jones\cj-jones-44,2017-18,Northwestern State,G,29,19,715,52,158,.329,36,102,.353,16,56,.286,38,60,.633,3,28,31,39,17,1,48,46,158,1.7
6440,Ramon Mercado\ramon-mercado-1,2013-14,Hampton,G,30,2,451,50,135,.370,18,43,.419,32,92,.348,26,33,.788,11,52,63,19,17,9,21,40,158,3.5
6441,Dominic Magee\dominic-magee-1,2015-16,Grand Canyon,G,22,0,343,55,146,.377,45,112,.402,10,34,.294,38,62,.613,9,37,46,34,17,0,31,29,158,3.8
6442,Ollie Jackson\ollie-jackson-1,2013-14,Saint Francis (PA),G,31,18,633,52,191,.272,23,71,.324,29,120,.242,24,33,.727,19,74,93,37,15,9,41,67,157,1.8
6443,Dalique Mingo\dalique-mingo-1,2017-18,Howard,G,33,18,567,48,119,.403,43,93,.462,5,26,.192,56,67,.836,24,55,79,44,17,3,46,57,157,3.1
6444,Tyler Lewis\tyler-lewis-1,2013-14,North Carolina State,G,36,18,716,55,159,.346,40,95,.421,15,64,.234,32,43,.744,11,34,45,135,7,0,38,51,157,3.5
6445,Thomas Capuano\thomas-capuano-1,2017-18,Manhattan,G,31,23,705,60,122,.492,29,61,.475,31,61,.508,6,14,.429,11,49,60,36,18,2,26,59,157,3.5
6446,Mike Laster\mike-laster-1,2016-17,Ohio,G,30,0,455,61,115,.530,46,81,.568,15,34,.441,20,32,.625,25,31,56,12,9,2,23,40,157,3.4
6447,Cody Benzel\cody-benzel-1,2016-17,Eastern Washington,G,34,6,473,54,118,.458,7,13,.538,47,105,.448,2,3,.667,4,25,29,16,14,2,13,61,157,2.8
6448,King McClure\king-mcclure-1,2016-17,Baylor,G,32,13,458,53,121,.438,26,45,.578,27,76,.355,24,32,.750,9,31,40,26,14,2,25,41,157,3.1
6449,Kendall Small\kendall-small-1,2017-18,Pacific,G,19,13,516,61,148,.412,59,142,.415,2,6,.333,33,58,.569,8,36,44,52,32,2,39,53,157,4.9
6450,Shaq Preston\shaq-preston-1,2017-18,Prairie View,G,30,3,527,59,132,.447,53,103,.515,6,29,.207,33,50,.660,23,52,75,21,20,8,26,71,157,3.3
6451,Patrick Wallace\patrick-wallace-1,2016-17,Charleston Southern,G,31,4,499,52,135,.385,12,20,.600,40,115,.348,13,17,.765,3,25,28,30,9,1,32,50,157,2.3
6452,Xavier Green\xavier-green-1,2017-18,Old Dominion,G,31,0,691,55,142,.387,40,97,.412,15,45,.333,32,44,.727,10,54,64,56,24,2,31,58,157,3.5
6453,Fard Muhammad\fard-muhammad-1,2016-17,Binghamton,G,27,8,385,53,142,.373,16,46,.348,37,96,.385,14,15,.933,9,26,35,8,12,1,15,23,157,3.2
6454,Dominique Williams\dominique-williams-2,2017-18,Tennessee-Martin,G,29,16,502,61,132,.462,54,103,.524,7,29,.241,28,43,.651,32,65,97,22,7,7,27,42,157,3.7
6455,Greg Elliott\greg-elliott-1,2017-18,Marquette,G,35,4,639,54,107,.505,43,77,.558,11,30,.367,38,48,.792,23,58,81,48,30,24,30,67,157,4.5
6456,Denzell Watts\denzell-watts-1,2014-15,Alabama-Birmingham,G,36,3,659,51,138,.370,33,88,.375,18,50,.360,37,50,.740,5,56,61,68,30,1,42,48,157,3.1
6457,Nick Victor\nick-victor-1,2013-14,Yale,G,32,30,795,67,145,.462,58,113,.513,9,32,.281,14,50,.280,20,102,122,53,32,22,64,93,157,3.0
6458,Tyree Griffin\tyree-griffin-1,2015-16,Oklahoma State,G,30,15,820,45,137,.328,31,79,.392,14,58,.241,53,72,.736,17,73,90,118,24,1,52,41,157,4.8
6459,Steven Wronkoski\steven-wronkoski-1,2015-16,Louisiana,G,34,20,614,54,133,.406,25,52,.481,29,81,.358,20,21,.952,18,54,72,22,13,2,19,40,157,3.2
6460,Braian Angola-Rodas\braian-angola-rodas-1,2016-17,Florida State,G,34,0,402,52,115,.452,31,65,.477,21,50,.420,32,41,.780,11,44,55,42,15,4,18,40,157,3.8
6461,Gerard Martin\gerard-martin-1,2016-17,Grand Canyon,G,31,24,906,51,154,.331,20,38,.526,31,116,.267,24,41,.585,22,105,127,78,42,10,47,71,157,4.4
6462,Payton Willis\payton-willis-1,2017-18,Vanderbilt,G,31,4,573,48,138,.348,10,29,.345,38,109,.349,23,35,.657,10,49,59,43,14,3,29,41,157,3.1
6463,Alex Phillips\alex-phillips-1,2013-14,Omaha,G,31,1,507,55,130,.423,24,51,.471,31,79,.392,16,23,.696,13,51,64,44,8,3,30,54,157,3.2
6464,T.J. Curry\tj-curry-1,2013-14,Marist,G,31,22,795,47,135,.348,18,48,.375,29,87,.333,34,51,.667,25,69,94,65,22,1,40,64,157,3.7
6465,Cody Wichmann\cody-wichmann-1,2015-16,Milwaukee,G,33,0,507,52,109,.477,10,22,.455,42,87,.483,11,17,.647,22,45,67,28,12,2,10,56,157,3.9
6466,Isaiah Dennis\isaiah-dennis-1,2016-17,Georgia State,G,33,9,511,62,101,.614,60,98,.612,2,3,.667,31,53,.585,14,49,63,60,29,2,45,51,157,4.1
6467,Jovante' Spivey\jovante-spivey-1,2016-17,Sam Houston State,G,33,2,494,36,111,.324,26,70,.371,10,41,.244,74,94,.787,9,41,50,51,14,4,34,50,156,3.1
6468,Donte Pretlow\donte-pretlow-1,2014-15,Morgan State,G,31,31,783,58,225,.258,49,176,.278,9,49,.184,31,59,.525,19,60,79,101,34,2,59,56,156,2.1
6469,Aaren Edmead\aaren-edmead-1,2015-16,Wagner,G,32,3,524,47,134,.351,21,54,.389,26,80,.325,36,43,.837,4,27,31,42,15,3,34,45,156,2.6
6470,Martez Walker\martez-walker-1,2013-14,Texas,G,33,2,419,50,127,.394,26,59,.441,24,68,.353,32,40,.800,34,41,75,13,15,1,23,26,156,3.4
6471,Justin McKie\justin-mckie-1,2016-17,South Carolina,G,37,7,615,58,149,.389,33,76,.434,25,73,.342,15,24,.625,23,53,76,46,21,3,22,51,156,3.1
6472,Marques Wilson\marques-wilson-1,2017-18,Lehigh,G,29,10,491,55,118,.466,29,58,.500,26,60,.433,20,23,.870,17,57,74,35,23,4,27,39,156,4.5
6473,Quincy Smith\quincy-smith-1,2014-15,Hawaii,G,35,2,576,52,120,.433,46,95,.484,6,25,.240,46,82,.561,19,74,93,30,43,3,41,60,156,3.3
6474,Josh Ritchart\josh-ritchart-1,2013-14,UC-Davis,G,9,9,260,60,95,.632,42,63,.667,18,32,.563,18,33,.545,13,46,59,7,9,12,13,24,156,14.5
6475,Jordan Cohen\jordan-cohen-1,2016-17,Lehigh,G,29,3,621,55,120,.458,31,56,.554,24,64,.375,22,24,.917,16,45,61,60,20,5,37,53,156,4.3
6476,Sheldon Eberhardt\sheldon-eberhardt-1,2017-18,Elon,G,31,0,588,62,130,.477,50,79,.633,12,51,.235,20,33,.606,16,73,89,79,12,7,39,55,156,4.2
6477,Jacob Kessler\jacob-kessler-1,2017-18,Army,G,30,30,689,59,133,.444,50,81,.617,9,52,.173,29,40,.725,47,74,121,54,20,12,30,65,156,4.9
6478,D'Angelo Richardson\dangelo-richardson-1,2017-18,Southern Mississippi,G,34,8,656,50,139,.360,32,71,.451,18,68,.265,38,46,.826,6,43,49,59,19,2,41,72,156,2.5
6479,Keyon Jones\keyon-jones-1,2017-18,New Mexico State,G,30,0,424,54,121,.446,14,25,.560,40,96,.417,8,13,.615,9,42,51,16,19,1,20,49,156,3.4
6480,Charlie Reddick\charlie-reddick-1,2013-14,Furman,G,23,17,612,54,133,.406,37,72,.514,17,61,.279,31,42,.738,23,105,128,41,27,8,37,66,156,5.5
6481,Kenny Wormley\kenny-wormley-1,2015-16,Siena,G,34,28,699,50,123,.407,38,94,.404,12,29,.414,43,64,.672,20,69,89,62,20,3,50,74,155,3.0
6482,Josh Delaney\josh-delaney-1,2015-16,Sam Houston State,G,31,0,467,52,140,.371,16,39,.410,36,101,.356,15,23,.652,7,40,47,67,16,1,27,44,155,3.6
6483,Cameron Harvey\cameron-harvey-1,2014-15,Stetson,G,31,21,586,53,170,.312,18,64,.281,35,106,.330,14,18,.778,5,33,38,15,4,0,24,41,155,1.4
6484,Matt Hauser\matt-hauser-1,2015-16,Santa Clara,G,31,4,600,51,146,.349,25,73,.342,26,73,.356,27,36,.750,8,37,45,40,15,0,27,35,155,2.8
6485,Christian Bradford\christian-bradford-1,2017-18,Radford,G,36,35,792,53,148,.358,26,59,.441,27,89,.303,22,28,.786,9,55,64,68,21,2,37,42,155,3.0
6486,Denzel Brito\denzel-brito-1,2014-15,Loyola (MD),G,30,23,771,51,158,.323,34,95,.358,17,63,.270,36,49,.735,8,80,88,69,23,1,49,35,155,3.3
6487,Clay Byrd\clay-byrd-1,2014-15,North Carolina-Greensboro,G,28,13,639,48,149,.322,4,12,.333,44,137,.321,15,17,.882,2,21,23,25,8,3,18,44,155,2.5
6488,Jordan Watkins\jordan-watkins-1,2015-16,Davidson,G,27,3,595,50,126,.397,13,28,.464,37,98,.378,18,22,.818,15,45,60,30,12,2,23,50,155,3.7
6489,Jamal Johnson\jamal-johnson-1,2013-14,Cal Poly,G,34,33,775,48,133,.361,31,85,.365,17,48,.354,42,62,.677,14,61,75,94,29,2,38,61,155,4.0
6490,Terrance LeFlore\terrance-leflore-1,2017-18,Alabama State,G,31,1,547,59,196,.301,46,130,.354,13,66,.197,24,48,.500,21,39,60,52,28,7,42,51,155,2.1
6491,Dane Kuiper\dane-kuiper-1,2016-17,New Mexico,G,26,14,560,57,131,.435,34,70,.486,23,61,.377,18,23,.783,15,55,70,35,20,7,22,69,155,4.3
6492,Chad Sherwood\chad-sherwood-1,2017-18,Idaho,G,31,11,653,53,123,.431,10,26,.385,43,97,.443,6,8,.750,7,45,52,52,11,5,24,64,155,3.5
6493,Kyle Dranginis\kyle-dranginis-1,2014-15,Gonzaga,G,38,0,654,50,107,.467,34,60,.567,16,47,.340,39,49,.796,34,64,98,63,23,15,32,74,155,4.1
6494,Noah Baumann\noah-baumann-1,2017-18,San Jose State,G,30,17,535,54,133,.406,14,46,.304,40,87,.460,7,14,.500,8,48,56,39,12,2,52,25,155,2.6
6495,Kendal Yancy\kendal-yancy-1,2016-17,Texas,G,29,7,539,55,126,.437,41,80,.513,14,46,.304,31,47,.660,27,37,64,16,25,5,22,45,155,3.9
6496,Cameron Johnson\cameron-johnson-4,2015-16,Pittsburgh,G,32,1,373,52,131,.397,22,51,.431,30,80,.375,21,26,.808,13,46,59,16,10,5,15,41,155,3.1
6497,Victor Robbins\victor-robbins-1,2014-15,Oregon State,G,15,0,325,53,115,.461,43,82,.524,10,33,.303,39,55,.709,20,33,53,9,14,2,17,23,155,7.2
6498,LaDavius Draine\ladavius-draine-1,2017-18,Southern Mississippi,G,28,0,330,58,125,.464,28,50,.560,30,75,.400,9,18,.500,15,47,62,8,7,2,7,33,155,3.8
6499,Shane Gatling\shane-gatling-1,2016-17,Niagara,G,33,4,384,53,147,.361,23,59,.390,30,88,.341,19,26,.731,5,19,24,19,7,0,22,25,155,2.1
6500,PJ Savoy\pj-savoy-1,2016-17,Florida State,G,28,0,227,47,114,.412,7,14,.500,40,100,.400,21,30,.700,4,19,23,7,10,1,9,15,155,3.6
6501,Jeremiah Ingram\jeremiah-ingram-1,2014-15,North Carolina Central,G,33,1,519,46,85,.541,44,76,.579,2,9,.222,61,99,.616,41,52,93,17,20,11,45,83,155,3.2
6502,Ray Rodriguez\ray-rodriguez-2,2014-15,Florida International,G,32,7,675,48,129,.372,11,26,.423,37,103,.359,22,32,.688,8,48,56,50,12,1,41,41,155,2.8
6503,Bobby Sharp\bobby-sharp-1,2014-15,Portland,G,31,9,484,51,168,.304,9,33,.273,42,135,.311,11,13,.846,1,35,36,22,13,1,9,46,155,2.3
6504,Marcus Tarrance\marcus-tarrance-1,2013-14,Middle Tennessee,G,30,5,481,44,129,.341,27,63,.429,17,66,.258,50,72,.694,17,33,50,20,14,3,23,45,155,2.8
6505,Hunter Ware\hunter-ware-1,2017-18,Bryant,G,31,18,698,64,143,.448,58,127,.457,6,16,.375,20,28,.714,22,81,103,45,30,6,36,75,154,3.7
6506,Tyrell Corbin\tyrell-corbin-2,2013-14,Cal State Bakersfield,G,32,10,449,40,115,.348,32,88,.364,8,27,.296,66,84,.786,9,51,60,64,17,0,46,30,154,3.4
6507,Avery Johnson\avery-johnson-3,2017-18,Alabama,G,36,0,501,51,146,.349,31,79,.392,20,67,.299,32,40,.800,12,27,39,27,17,1,19,54,154,2.3
6508,Omar Calhoun\omar-calhoun-1,2014-15,Connecticut,G,28,5,484,54,143,.378,28,67,.418,26,76,.342,20,26,.769,12,32,44,20,14,4,26,21,154,3.1
6509,Zedric Sadler\zedric-sadler-1,2015-16,Rider,G,29,18,717,54,173,.312,35,84,.417,19,89,.213,27,33,.818,11,71,82,59,38,18,35,55,154,4.0
6510,Quinton Adlesh\quinton-adlesh-1,2016-17,Columbia,G,27,1,547,54,132,.409,18,44,.409,36,88,.409,10,16,.625,2,55,57,62,36,0,32,38,154,4.8
6511,Shawn Smith\shawn-smith-4,2013-14,Texas A&M,G,27,17,600,51,156,.327,39,100,.390,12,56,.214,40,60,.667,16,70,86,35,14,5,23,33,154,3.5
6512,Kyle Clarke\kyle-clarke-1,2016-17,Kennesaw State,G,32,31,681,64,156,.410,64,153,.418,0,3,.000,26,37,.703,17,40,57,80,20,5,69,67,154,2.3
6513,Ajay Sanders\ajay-sanders-1,2017-18,Coastal Carolina,G,32,16,752,53,161,.329,18,60,.300,35,101,.347,13,18,.722,24,89,113,39,11,5,44,63,154,2.4
6514,Zach Green\zach-green-2,2017-18,Montana State,G,32,3,529,51,126,.405,46,104,.442,5,22,.227,47,68,.691,45,87,132,32,15,8,35,67,154,3.6
6515,Arkel Lamar\arkel-lamar-1,2016-17,Maryland-Baltimore County,G,32,1,498,56,142,.394,38,79,.481,18,63,.286,24,36,.667,31,88,119,18,25,14,25,70,154,3.6
6516,Jourdan Stickler\jourdan-stickler-1,2014-15,Houston Baptist,G,26,2,375,51,125,.408,31,68,.456,20,57,.351,32,47,.681,23,35,58,18,12,0,22,31,154,3.8
6517,Steve Rogers\steve-rogers-1,2014-15,Alabama State,G,29,1,423,47,113,.416,17,47,.362,30,66,.455,30,37,.811,13,25,38,29,7,1,29,47,154,3.0
6518,Malcolm Hill\malcolm-hill-1,2013-14,Illinois,G,35,12,495,46,120,.383,31,76,.408,15,44,.341,47,61,.770,21,64,85,23,10,4,30,34,154,2.9
6519,Austin White\austin-white-1,2015-16,High Point,G,32,10,487,52,105,.495,41,80,.513,11,25,.440,39,48,.813,6,37,43,24,15,1,20,40,154,3.4
6520,Marco Smith\marco-smith-1,2017-18,Missouri-Kansas City,G,31,2,516,59,130,.454,47,91,.516,12,39,.308,24,35,.686,14,57,71,29,29,13,29,49,154,3.8
6521,Christiaan Jones\christiaan-jones-1,2017-18,Stetson,G,31,0,437,55,139,.396,26,57,.456,29,82,.354,15,26,.577,16,49,65,24,15,5,19,18,154,3.5
6522,Daeqwon Plowden\daeqwon-plowden-1,2017-18,Bowling Green State,G,32,1,484,62,147,.422,49,98,.500,13,49,.265,17,33,.515,33,61,94,13,14,13,27,56,154,2.9
6523,Zeke Moore\zeke-moore-1,2016-17,Saint Louis,G,29,1,604,47,127,.370,20,58,.345,27,69,.391,33,43,.767,8,49,57,27,16,6,27,50,154,3.2
6524,Hunter Maldonado\hunter-maldonado-1,2017-18,Wyoming,G,29,19,615,50,129,.388,33,73,.452,17,56,.304,36,49,.735,12,51,63,41,28,5,29,57,153,3.8
6525,Damien Jefferson\damien-jefferson-1,2016-17,New Mexico,G,29,6,437,60,137,.438,51,95,.537,9,42,.214,24,49,.490,12,56,68,29,11,4,33,45,153,2.7
6526,Grayson Allen\grayson-allen-1,2014-15,Duke,G,35,0,322,45,106,.425,27,54,.500,18,52,.346,45,53,.849,9,26,35,14,10,5,15,42,153,2.8
6527,Spencer Foley\spencer-foley-1,2017-18,Canisius,G,28,0,367,55,111,.495,21,33,.636,34,78,.436,9,13,.692,25,20,45,22,8,1,14,21,153,4.3
6528,Richaud Gittens\richaud-gittens-1,2015-16,Weber State,G,35,0,622,52,143,.364,21,52,.404,31,91,.341,18,28,.643,6,68,74,45,24,2,30,49,153,2.9
6529,Ja'Mill Powell\jamill-powell-1,2015-16,Eastern Kentucky,G,27,10,427,49,120,.408,26,56,.464,23,64,.359,32,42,.762,21,36,57,17,13,6,22,59,153,3.5
6530,Connor Ferrell\connor-ferrell-1,2016-17,Wagner,G,28,20,575,49,139,.353,29,62,.468,20,77,.260,35,50,.700,16,51,67,23,9,4,23,58,153,2.8
6531,Juwan Major\juwan-major-1,2014-15,Southern Utah,G,29,21,620,59,111,.532,56,97,.577,3,14,.214,32,54,.593,12,42,54,39,12,5,50,73,153,2.6
6532,Omar Calhoun\omar-calhoun-1,2015-16,Connecticut,G,36,5,513,50,121,.413,22,49,.449,28,72,.389,25,31,.806,15,47,62,31,12,8,20,34,153,3.2
6533,Gerard Martin\gerard-martin-1,2015-16,Grand Canyon,G,34,33,786,50,127,.394,17,45,.378,33,82,.402,20,25,.800,11,73,84,86,34,14,38,76,153,4.3
6534,Maliik Love\malik-love-1,2014-15,Cal Poly,G,29,29,819,63,144,.438,60,135,.444,3,9,.333,24,47,.511,48,58,106,79,22,6,50,48,153,4.5
6535,Drake Green\drake-green-1,2016-17,Abilene Christian,G,27,19,648,50,129,.388,6,20,.300,44,109,.404,9,9,1.000,4,51,55,30,22,6,23,61,153,3.7
6536,Marcellous Bell\marcellous-bell-1,2014-15,Jacksonville,G,25,0,362,46,124,.371,14,34,.412,32,90,.356,29,33,.879,5,21,26,18,16,0,5,20,153,4.3
6537,Chaz Glotta\chaz-glotta-1,2017-18,Northern Colorado,G,35,0,454,53,126,.421,15,27,.556,38,99,.384,9,18,.500,3,25,28,23,8,0,15,44,153,2.4
6538,Ge'Lawn Guyn\gelawn-guyn-1,2013-14,Cincinnati,G,34,33,647,55,166,.331,26,72,.361,29,94,.309,14,26,.538,16,52,68,33,22,6,35,67,153,2.0
6539,I.J. Ready\ij-ready-1,2013-14,Mississippi State,G,26,21,626,59,159,.371,42,111,.378,17,48,.354,18,21,.857,15,40,55,69,32,0,41,31,153,4.4
6540,John Marshall\john-marshall-1,2013-14,Southern Utah,G,29,18,594,44,95,.463,43,93,.462,1,2,.500,64,92,.696,10,35,45,68,29,0,37,59,153,4.4
6541,Jordan Burgess\jordan-burgess-1,2013-14,Virginia Commonwealth,G,31,19,673,50,163,.307,24,85,.282,26,78,.333,27,40,.675,18,63,81,32,28,9,35,62,153,2.6
6542,Dwayne Sutton\dwayne-sutton-1,2017-18,Louisville,G,36,4,549,53,119,.445,36,71,.507,17,48,.354,30,44,.682,40,104,144,21,30,13,17,70,153,4.3
6543,Shaun Stewart\shaun-stewart-1,2014-15,Youngstown State,G,32,3,552,52,152,.342,21,49,.429,31,103,.301,18,26,.692,14,51,65,36,10,4,21,40,153,2.8
6544,Arnold Richmond\arnold-richmond-2,2015-16,Grambling,G,31,0,420,47,123,.382,40,87,.460,7,36,.194,52,77,.675,9,26,35,35,19,2,57,42,153,2.0
6545,Damion Rosser\damion-rosser-1,2017-18,New Orleans,G,33,10,505,60,124,.484,58,117,.496,2,7,.286,31,59,.525,30,47,77,34,8,3,37,54,153,2.7
6546,Dionte Champion\dionte-champion-1,2017-18,New Orleans,G,30,11,515,51,98,.520,47,77,.610,4,21,.190,47,67,.701,27,55,82,21,25,9,26,62,153,4.2
6547,Quincy Smith\quincy-smith-1,2013-14,Hawaii,G,31,1,531,47,115,.409,42,99,.424,5,16,.313,54,86,.628,11,25,36,84,26,3,43,68,153,3.6
6548,Denny Slay\denny-slay-1,2017-18,High Point,G,30,21,662,58,147,.395,43,96,.448,15,51,.294,22,30,.733,8,46,54,53,19,0,34,37,153,3.2
6549,James Ford\james-ford-1,2014-15,Quinnipiac,G,29,17,517,46,140,.329,15,50,.300,31,90,.344,30,37,.811,20,53,73,32,10,3,24,58,153,3.0
6550,Keith Charleston\keith-charleston-1,2017-18,Southeastern Louisiana,G,34,19,738,56,135,.415,36,85,.424,20,50,.400,21,48,.438,45,94,139,45,13,8,49,68,153,3.1
6551,Greg King\greg-king-1,2017-18,Niagara,G,33,19,557,67,114,.588,67,114,.588,0,0,,19,54,.352,69,117,186,11,9,23,29,82,153,4.3
6552,Chad Brown\chad-brown-1,2016-17,Central Florida,G,36,1,466,44,91,.484,44,91,.484,0,0,,65,104,.625,52,75,127,6,8,26,31,75,153,3.3
6553,Dustin Clarke\dustin-clarke-1,2014-15,Appalachian State,G,29,20,571,54,166,.325,28,71,.394,26,95,.274,18,25,.720,33,72,105,30,15,2,20,27,152,3.7
6554,Mario Blessing\mario-blessing-1,2014-15,South Carolina Upstate,G,36,35,968,55,150,.367,19,35,.543,36,115,.313,6,9,.667,26,55,81,93,34,0,37,72,152,3.8
6555,Demetrius Walker\demetrius-walker-1,2013-14,Grand Canyon,G,9,7,278,44,105,.419,29,54,.537,15,51,.294,49,60,.817,1,49,50,20,9,1,20,19,152,11.5
6556,Karon Wright\karon-wright-1,2013-14,South Carolina State,G,30,2,347,51,147,.347,17,41,.415,34,106,.321,16,24,.667,11,15,26,20,8,0,25,42,152,2.0
6557,Tre' Thomas\tre-thomas-1,2017-18,Coppin State,G,28,3,543,55,177,.311,32,88,.364,23,89,.258,19,21,.905,5,40,45,23,10,1,37,40,152,1.4
6558,Jake Lindsey\jake-lindsey-1,2017-18,Baylor,G,34,14,794,57,125,.456,42,81,.519,15,44,.341,23,35,.657,13,74,87,115,37,13,41,89,152,4.8
6559,D.J. McCall\dj-mccall-1,2016-17,IUPUI,G,32,22,678,51,120,.425,46,102,.451,5,18,.278,45,77,.584,66,95,161,48,22,8,41,71,152,4.4
6560,Aaron Simpson\aaron-simpson-1,2014-15,DePaul,G,32,10,544,50,131,.382,23,53,.434,27,78,.346,25,37,.676,17,48,65,36,13,2,31,54,152,2.8
6561,Akim Mitchell\akim-mitchell-1,2016-17,Hampton,G,30,20,570,60,129,.465,53,107,.495,7,22,.318,25,34,.735,36,62,98,29,19,2,42,68,152,3.2
6562,Tamarcio Wilson\tamarcio-wilson-1,2014-15,Alcorn State,G,27,6,480,57,134,.425,46,97,.474,11,37,.297,27,45,.600,10,42,52,24,13,3,31,28,152,3.1
6563,Sam Singer\sam-singer-1,2016-17,University of California,G,34,9,682,63,144,.438,53,106,.500,10,38,.263,16,37,.432,12,88,100,67,23,2,39,62,152,3.2
6564,Ryan Kemrite\ryan-kemrite-1,2014-15,Liberty,G,32,15,487,46,107,.430,10,25,.400,36,82,.439,24,44,.545,12,37,49,13,18,0,19,55,152,2.9
6565,Tavarius Shine\tavarius-shine-1,2015-16,Oklahoma State,G,25,4,566,45,131,.344,18,44,.409,27,87,.310,35,46,.761,16,67,83,14,19,9,27,70,152,3.4
6566,Dylan Ennis\dylan-ennis-1,2013-14,Villanova,G,30,0,481,47,133,.353,22,50,.440,25,83,.301,33,42,.786,6,46,52,49,8,8,20,47,152,3.4
6567,Barry Ogalue\barry-ogalue-1,2017-18,Cal State Long Beach,G,23,13,347,60,112,.536,57,95,.600,3,17,.176,29,37,.784,20,29,49,18,11,2,22,18,152,4.9
6568,Nasir Core\nasir-core-1,2017-18,Florida A&M,G,34,12,510,48,129,.372,33,80,.413,15,49,.306,41,67,.612,19,61,80,42,23,4,48,69,152,2.4
6569,Isaac Thornton\isaac-thornton-1,2013-14,San Jose State,G,31,20,640,46,128,.359,29,84,.345,17,44,.386,43,59,.729,25,75,100,48,27,18,60,79,152,3.1
6570,Tyrik Dixon\tyrik-dixon-1,2017-18,Middle Tennessee,G,32,24,720,52,139,.374,31,75,.413,21,64,.328,27,34,.794,13,83,96,100,27,2,42,89,152,4.0
6571,Kealen Ives\kealen-ives-1,2015-16,Rider,G,32,8,583,47,147,.320,24,81,.296,23,66,.348,35,45,.778,7,49,56,62,23,1,41,54,152,2.8
6572,Ryan Funk\ryan-funk-1,2015-16,Marist,G,25,7,448,52,144,.361,25,49,.510,27,95,.284,21,26,.808,21,33,54,9,8,1,13,45,152,3.1
6573,Ka'Darryl Bell\kadarryl-bell-1,2013-14,Bradley,G,32,7,631,47,134,.351,31,89,.348,16,45,.356,42,59,.712,7,53,60,35,40,5,54,93,152,2.1
6574,Aubrey Ball\aubrey-ball-1,2013-14,Central Arkansas,G,28,2,347,48,127,.378,15,48,.313,33,79,.418,23,34,.676,5,29,34,19,9,0,18,20,152,3.1
6575,Nigel Johnson\nigel-johnson-2,2017-18,Virginia,G,31,1,512,56,145,.386,40,96,.417,16,49,.327,23,38,.605,2,47,49,50,23,1,24,17,151,3.5
6576,Issac Smith\issac-smith-1,2013-14,Maryland-Eastern Shore,G,26,13,572,47,165,.285,29,102,.284,18,63,.286,39,52,.750,8,40,48,56,21,1,44,23,151,2.9
6577,Kevin Anderson\kevin-anderson-6,2017-18,Delaware,G,11,11,365,51,114,.447,31,61,.508,20,53,.377,29,38,.763,11,43,54,32,13,8,18,33,151,10.8
6578,Kyle Allman\kyle-allman-1,2015-16,Cal State Fullerton,G,30,3,563,42,115,.365,33,79,.418,9,36,.250,58,90,.644,3,46,49,31,13,3,48,64,151,1.8
6579,Mychal Mulder\mychal-mulder-1,2016-17,Kentucky,G,32,2,338,52,128,.406,17,32,.531,35,96,.365,12,13,.923,16,32,48,12,8,6,11,27,151,3.2
6580,Sammy Mojica\sammy-mojica-1,2014-15,Drexel,G,24,4,593,57,145,.393,33,80,.413,24,65,.369,13,28,.464,29,41,70,41,23,3,26,44,151,4.5
6581,Kelvin Robinson\kelvin-robinson-2,2016-17,Appalachian State,G,19,18,361,49,131,.374,33,84,.393,16,47,.340,37,54,.685,24,38,62,47,13,1,29,41,151,5.3
6582,T.J. Curry\tj-curry-1,2014-15,Marist,G,17,17,500,48,119,.403,15,33,.455,33,86,.384,22,28,.786,17,51,68,26,24,0,27,27,151,6.8
6583,Adedeji Ibitayo\adedeji-ibitayo-1,2013-14,Akron,G,29,20,438,54,116,.466,28,50,.560,26,66,.394,17,38,.447,24,40,64,14,14,11,18,41,151,3.8
6584,Jubril Adekoya\jubril-adekoya-1,2014-15,Valparaiso,G,32,4,633,56,117,.479,55,114,.482,1,3,.333,38,68,.559,50,84,134,21,17,8,29,73,151,3.7
6585,Madison Jones\madison-jones-1,2014-15,Wake Forest,G,32,6,673,50,117,.427,50,114,.439,0,3,.000,51,86,.593,10,65,75,97,34,7,62,65,151,3.8
6586,Sheldon Blackwell\sheldon-blackwell-1,2013-14,Cal State Fullerton,G,31,20,720,59,133,.444,53,106,.500,6,27,.222,27,52,.519,22,70,92,61,16,3,38,54,151,3.5
6587,Doug Brooks\doug-brooks-1,2015-16,Virginia Commonwealth,G,36,0,579,43,148,.291,12,38,.316,31,110,.282,34,47,.723,13,76,89,48,69,5,26,98,151,3.7
6588,Chris Porter-Bunton\chris-porter-bunton-1,2015-16,Austin Peay,G,36,1,448,55,105,.524,42,79,.532,13,26,.500,28,40,.700,23,46,69,20,14,3,18,80,151,2.9
6589,Darnell Foreman\darnell-foreman-1,2015-16,Pennsylvania,G,28,6,523,47,145,.324,37,95,.389,10,50,.200,47,67,.701,14,61,75,61,21,5,30,52,151,3.7
6590,Jerrelle DeBerry\jerrelle-deberry-1,2017-18,Utah Valley,G,19,0,309,44,114,.386,26,68,.382,18,46,.391,45,62,.726,16,36,52,14,2,5,25,46,151,4.0
6591,King McClure\king-mcclure-1,2015-16,Baylor,G,34,0,444,52,116,.448,23,39,.590,29,77,.377,18,27,.667,8,31,39,22,30,4,14,47,151,3.5
6592,Dominique Collier\dominique-collier-1,2016-17,Colorado,G,25,15,463,44,130,.338,18,52,.346,26,78,.333,37,50,.740,6,22,28,40,24,3,27,45,151,3.7
6593,Chris Jenkins\chris-jenkins-2,2013-14,Hofstra,G,28,0,593,49,160,.306,7,19,.368,42,141,.298,11,16,.688,4,32,36,15,14,5,13,30,151,2.6
6594,Ethan Kay\ethan-kay-1,2017-18,Presbyterian,G,31,4,344,50,145,.345,3,8,.375,47,137,.343,4,5,.800,5,26,31,9,16,0,4,7,151,3.1
6595,Jure Span\jure-span-1,2015-16,South Carolina Upstate,G,32,6,715,52,123,.423,22,55,.400,30,68,.441,17,29,.586,14,47,61,100,19,11,45,89,151,3.8
6596,Ishmael El-Amin\ishmael-el-amin-1,2017-18,Ball State,G,31,0,579,52,141,.369,34,85,.400,18,56,.321,29,40,.725,7,55,62,47,17,3,39,39,151,2.8
6597,Cameron Delaney\cameron-delaney-1,2017-18,Sam Houston State,G,35,4,541,47,147,.320,22,55,.400,25,92,.272,32,39,.821,17,91,108,31,20,6,27,57,151,2.8
6598,Cameron Harvey\cameron-harvey-1,2016-17,Milwaukee,G,35,16,564,57,155,.368,27,67,.403,30,88,.341,7,15,.467,10,33,43,17,3,1,19,34,151,1.8
6599,Hunter Miller\hunter-miller-1,2013-14,Stetson,G,31,16,746,44,130,.338,25,61,.410,19,69,.275,43,54,.796,10,59,69,67,15,2,32,53,150,3.5
6600,Cortez Conners\cortez-connors-1,2014-15,Cal State Bakersfield,G,32,12,498,52,141,.369,24,62,.387,28,79,.354,18,19,.947,12,35,47,26,20,1,25,50,150,2.6
6601,Gary Williams Jr.\gary-williamsjr-1,2016-17,San Jose State,G,21,9,286,51,132,.386,45,103,.437,6,29,.207,42,52,.808,23,31,54,20,6,2,27,24,150,4.0
6602,Thomas Rivera\thomas-rivera-1,2016-17,Maryland-Eastern Shore,G,33,7,580,50,155,.323,24,73,.329,26,82,.317,24,34,.706,16,43,59,91,24,1,51,70,150,2.8
6603,Jason Todd\jason-todd-1,2014-15,Portland,G,31,4,722,56,118,.475,34,68,.500,22,50,.440,16,28,.571,29,82,111,50,15,3,27,34,150,4.6
6604,Lawrence White\lawrence-white-1,2015-16,UC-Davis,G,28,13,635,58,130,.446,47,87,.540,11,43,.256,23,55,.418,16,70,86,33,38,6,33,72,150,3.8
6605,Vincent Garrett\vincent-garrett-1,2013-14,Green Bay,G,24,13,377,53,131,.405,37,99,.374,16,32,.500,28,39,.718,22,45,67,33,7,10,29,48,150,3.9
6606,Scott Meredith\scott-meredith-1,2017-18,Saint Francis (PA),G,31,1,453,51,122,.418,20,35,.571,31,87,.356,17,20,.850,7,34,41,20,17,2,16,27,150,3.4
6607,Ricky Madison\ricky-madison-1,2017-18,High Point,G,28,5,454,57,108,.528,57,108,.528,0,0,,36,53,.679,49,72,121,9,11,6,23,48,150,4.5
6608,Ben Richardson\ben-richardson-1,2014-15,Loyola (IL),G,36,12,720,51,134,.381,21,49,.429,30,85,.353,18,22,.818,9,56,65,55,33,7,29,62,150,3.4
6609,Deshaun Thrower\deshaun-thrower-1,2014-15,Stony Brook,G,35,11,668,49,163,.301,30,102,.294,19,61,.311,33,44,.750,14,44,58,45,17,0,32,53,150,2.0
6610,Ja'Rob McCallum\jarob-mccallum-1,2013-14,IUPUI,G,16,3,338,54,123,.439,28,58,.483,26,65,.400,16,17,.941,4,29,33,20,11,1,23,31,150,5.4
6611,Drake Wilks\drake-wilks-1,2016-17,Grambling,G,33,14,558,54,137,.394,33,68,.485,21,69,.304,21,33,.636,22,49,71,26,14,7,26,52,150,2.8
6612,Tyler Larson\tyler-larson-1,2013-14,South Dakota,G,30,7,492,49,110,.445,36,75,.480,13,35,.371,39,56,.696,23,70,93,35,13,1,34,36,150,3.8
6613,Jestin Lewis\jestin-lewis-1,2014-15,Mercer,G,35,2,473,47,126,.373,12,34,.353,35,92,.380,21,32,.656,4,57,61,22,27,0,18,26,150,3.1
6614,Edward Simpson\edward-simpson-1,2015-16,Middle Tennessee,G,30,14,651,51,137,.372,22,52,.423,29,85,.341,19,39,.487,12,67,79,54,15,2,26,53,150,3.4
6615,Brian Pegg\brian-pegg-1,2016-17,Stetson,G,21,14,406,65,116,.560,65,116,.560,0,0,,20,48,.417,33,66,99,15,10,9,32,53,150,4.8
6616,Matt Scott\matt-scott-1,2014-15,Niagara,G,30,11,510,41,126,.325,25,76,.329,16,50,.320,52,69,.754,30,51,81,23,20,3,44,49,150,2.7
6617,Ben Emelogu\ben-emelogu-1,2016-17,Southern Methodist,G,35,3,725,55,165,.333,29,76,.382,26,89,.292,14,26,.538,23,71,94,64,26,3,38,66,150,2.8
6618,Shaqquan Aaron\shaqquan-aaron-1,2017-18,Southern California,G,35,10,557,60,131,.458,39,67,.582,21,64,.328,9,25,.360,12,60,72,28,12,5,30,55,150,2.4
6619,Marial Shayok\marial-shayok-1,2015-16,Virginia,G,35,8,526,58,118,.492,41,79,.519,17,39,.436,17,31,.548,8,58,66,39,11,5,28,52,150,2.9
6620,John Davis\john-davis-5,2015-16,Furman,G,33,18,695,45,135,.333,21,64,.328,24,71,.338,36,43,.837,6,47,53,57,25,0,34,51,150,3.0
6621,Jake Babic\jake-babic-1,2016-17,Appalachian State,G,30,6,514,47,130,.362,26,55,.473,21,75,.280,34,43,.791,16,37,53,63,10,1,40,56,149,2.9
6622,Kevin Blake\kevin-blake-1,2013-14,Elon,G,32,10,457,51,91,.560,47,74,.635,4,17,.235,43,70,.614,23,48,71,32,17,2,26,45,149,3.8
6623,David Simmons\david-simmons-4,2017-18,Middle Tennessee,G,32,4,573,54,103,.524,48,84,.571,6,19,.316,35,55,.636,26,57,83,51,17,3,37,78,149,3.5
6624,Ahmaad Rorie\ahmaad-rorie-1,2014-15,Oregon,G,36,15,675,52,125,.416,36,77,.468,16,48,.333,29,39,.744,14,65,79,66,6,4,36,45,149,3.0
6625,Aaron Thompson\aaron-thompson-3,2017-18,Butler,G,35,32,845,53,134,.396,51,119,.429,2,15,.133,41,76,.539,6,42,48,118,39,13,58,103,149,3.2
6626,Terrance LeFlore\terrance-leflore-1,2013-14,Alabama State,G,32,6,540,53,149,.356,31,69,.449,22,80,.275,21,32,.656,18,38,56,36,22,3,40,55,149,2.3
6627,Frank Howard\franklin-howard-1,2016-17,Syracuse,G,33,14,533,49,139,.353,31,82,.378,18,57,.316,33,53,.623,18,36,54,120,38,5,57,56,149,4.0
6628,Tony Dobbinson\tony-dobbinson-1,2014-15,Northwestern State,G,27,0,365,52,139,.374,19,48,.396,33,91,.363,12,18,.667,12,26,38,19,8,2,36,22,149,2.4
6629,Bryce White\bryce-white-1,2015-16,Portland State,G,13,11,342,52,131,.397,37,87,.425,15,44,.341,30,40,.750,4,31,35,25,17,4,18,21,149,7.5
6630,Justin Jordan\justin-jordan-2,2014-15,Milwaukee,G,30,15,642,52,138,.377,30,70,.429,22,68,.324,23,36,.639,8,57,65,33,9,2,34,41,149,2.5
6631,Anthony Dallier\anthony-dallier-1,2015-16,Yale,G,30,10,598,53,123,.431,34,72,.472,19,51,.373,24,40,.600,18,77,95,39,25,5,29,58,149,3.9
6632,Deverell Biggs\deverell-biggs-1,2013-14,Nebraska,G,15,0,308,50,117,.427,44,100,.440,6,17,.353,43,64,.672,13,37,50,23,15,6,34,42,149,5.6
6633,Je'lon Hornbeak\jelon-hornbeak-1,2013-14,Oklahoma,G,29,0,529,47,118,.398,34,60,.567,13,58,.224,42,55,.764,7,44,51,74,22,3,38,52,149,4.0
6634,Sammy Barnes-Thompkins\sammy-barnes-thompkins-1,2015-16,Boston College,G,27,10,457,53,137,.387,22,58,.379,31,79,.392,12,21,.571,6,37,43,18,16,5,25,58,149,2.6
6635,Aaron Ray\aaron-ray-1,2017-18,Southern,G,29,2,412,46,129,.357,24,77,.312,22,52,.423,35,57,.614,19,62,81,13,19,1,37,62,149,2.3
6636,Avery Patterson\avery-patterson-2,2017-18,Alcorn State,G,25,23,510,45,123,.366,26,63,.413,19,60,.317,40,54,.741,13,39,52,53,14,1,43,47,149,3.4
6637,Michael Zeno\michael-zeno-1,2016-17,New Orleans,G,32,4,540,57,144,.396,57,142,.401,0,2,.000,35,58,.603,38,60,98,18,18,16,53,44,149,2.4
6638,C.J. Foster\cj-foster-1,2016-17,Arkansas State,G,32,32,618,52,111,.468,39,67,.582,13,44,.295,32,55,.582,32,39,71,27,12,5,34,71,149,2.8
6639,Rasheed Sulaimon\rasheed-sulaimon-1,2014-15,Duke,G,20,0,386,52,126,.413,29,69,.420,23,57,.404,22,33,.667,4,36,40,35,19,1,26,39,149,4.7
6640,D.J. McCall\dj-mccall-1,2014-15,IUPUI,G,31,15,664,52,124,.419,46,105,.438,6,19,.316,39,61,.639,31,58,89,38,19,1,55,49,149,2.7
6641,Daeshon Francis\daeshon-francis-1,2014-15,Green Bay,G,33,0,447,54,87,.621,53,85,.624,1,2,.500,40,62,.645,35,35,70,25,11,9,20,49,149,4.0
6642,Jacobi Boykins\jacobi-boykins-1,2014-15,Louisiana Tech,G,36,0,383,51,113,.451,19,32,.594,32,81,.395,15,25,.600,9,27,36,8,22,5,19,49,149,2.6
6643,Dru Smith\dru-smith-1,2016-17,Evansville,G,28,8,630,53,119,.445,37,70,.529,16,49,.327,27,33,.818,7,67,74,81,23,12,33,85,149,4.7
6644,Cullen Hamilton\cullen-hamilton-1,2013-14,Holy Cross,G,18,8,363,50,136,.368,21,56,.375,29,80,.363,19,23,.826,10,22,32,16,10,0,15,23,148,4.5
6645,Kealen Washington-Ives\kealen-washington-ives-1,2016-17,Rider,G,33,5,654,44,125,.352,24,62,.387,20,63,.317,40,51,.784,5,55,60,103,10,1,52,72,148,2.9
6646,Bryan Sekunda\bryan-sekunda-1,2017-18,Stony Brook,G,28,12,623,50,138,.362,11,34,.324,39,104,.375,9,11,.818,16,40,56,51,7,5,13,39,148,4.0
6647,Kaza Keane\kaza-keane-1,2014-15,Cleveland State,G,34,20,723,55,134,.410,43,90,.478,12,44,.273,26,44,.591,22,43,65,73,34,1,28,61,148,3.8
6648,Sterling Smith\sterling-smith-1,2015-16,Pittsburgh,G,33,23,573,44,120,.367,8,30,.267,36,90,.400,24,26,.923,12,87,99,37,12,5,18,27,148,3.9
6649,Thatch Unruh\thatch-unruh-1,2016-17,Central Arkansas,G,29,6,433,46,121,.380,18,33,.545,28,88,.318,28,35,.800,13,41,54,23,9,3,28,40,148,2.9
6650,Myles Hamilton\myles-hamilton-1,2013-14,Kennesaw State,G,24,17,489,52,133,.391,41,89,.461,11,44,.250,33,44,.750,12,46,58,56,21,1,54,66,148,3.1
6651,Caleb Donnelly\caleb-donnelly-1,2015-16,Northeastern,G,32,9,653,48,126,.381,7,22,.318,41,104,.394,11,15,.733,13,40,53,25,8,1,18,31,148,2.9
6652,Prentiss Nixon\prentiss-nixon-1,2015-16,Colorado State,G,31,8,488,49,126,.389,18,44,.409,31,82,.378,19,29,.655,2,51,53,37,4,1,29,67,148,2.2
6653,Jaleen Smith\jaleen-smith-1,2013-14,New Hampshire,G,28,12,576,46,140,.329,24,67,.358,22,73,.301,34,44,.773,21,56,77,35,15,5,34,45,148,3.1
6654,Drew Rackley\drew-rackley-1,2017-18,North Carolina-Asheville,G,33,10,485,49,112,.438,20,45,.444,29,67,.433,21,30,.700,5,27,32,31,19,2,24,49,148,2.9
6655,Jamal Williams\jamal-williams-3,2014-15,Sam Houston State,G,33,1,438,52,108,.481,45,87,.517,7,21,.333,37,52,.712,16,51,67,33,16,7,37,42,148,3.1
6656,Princeton Onwas\princeton-onwas-1,2013-14,Utah,G,31,11,554,57,111,.514,52,86,.605,5,25,.200,29,69,.420,17,63,80,25,25,8,30,71,148,3.1
6657,Corey Edwards\corey-edwards-1,2014-15,George Mason,G,30,18,733,46,130,.354,20,51,.392,26,79,.329,30,40,.750,3,49,52,76,46,1,47,71,148,3.8
6658,Te'Jon Lucas\tejon-lucas-1,2016-17,Illinois,G,31,15,642,47,115,.409,35,83,.422,12,32,.375,42,71,.592,7,51,58,95,32,1,51,58,148,3.9
6659,Demarcus Bryant\demarcus-bryant-1,2014-15,Savannah State,G,30,10,472,52,161,.323,15,38,.395,37,123,.301,7,8,.875,8,19,27,11,6,1,34,39,148,1.1
6660,Justin Moore\justin-moore-2,2016-17,Georgia Tech,G,34,18,638,59,137,.431,56,127,.441,3,10,.300,27,51,.529,15,45,60,81,15,4,51,58,148,2.7
6661,Corey Spence\corey-spence-1,2014-15,Northern Colorado,G,30,20,626,49,128,.383,37,86,.430,12,42,.286,38,45,.844,16,45,61,63,21,0,35,44,148,3.7
6662,Justin Colvin\justin-colvin-1,2014-15,Alabama A&M,G,28,7,502,48,138,.348,23,53,.434,25,85,.294,27,43,.628,12,37,49,31,15,3,27,49,148,2.7
6663,Aaron Cosby\aaron-cosby-1,2014-15,Illinois,G,19,13,480,46,157,.293,14,54,.259,32,103,.311,24,30,.800,6,63,69,32,5,0,25,27,148,3.6
6664,Brady Ellingson\brady-ellingson-1,2016-17,Iowa,G,34,0,484,49,111,.441,17,43,.395,32,68,.471,18,18,1.000,7,32,39,37,11,0,14,28,148,3.4
6665,Joe Retic\joe-retic-1,2013-14,Liberty,G,31,5,590,45,108,.417,39,91,.429,6,17,.353,52,71,.732,9,61,70,82,29,3,66,69,148,3.3
6666,Quinton Forrest\quinton-forrest-1,2015-16,Bethune-Cookman,G,30,11,495,61,116,.526,57,95,.600,4,21,.190,22,44,.500,39,41,80,18,22,5,27,29,148,4.1
6667,Aljami Durham\aljami-durham-1,2017-18,Indiana,G,31,9,583,47,115,.409,33,66,.500,14,49,.286,40,56,.714,5,54,59,39,11,4,25,57,148,3.0
6668,Kyle Castlin\kyle-castlin-1,2015-16,Columbia,G,31,15,529,51,118,.432,44,94,.468,7,24,.292,39,65,.600,29,48,77,24,9,5,25,41,148,3.2
6669,Jon Severe\jon-severe-1,2014-15,Fordham,G,22,1,416,52,151,.344,38,93,.409,14,58,.241,30,37,.811,18,39,57,32,19,5,44,42,148,3.1
6670,John Comeaux\john-comeaux-1,2017-18,Stephen F. Austin,G,35,1,482,56,120,.467,51,92,.554,5,28,.179,31,51,.608,21,47,68,54,44,2,29,83,148,3.7
6671,Jarrey Foster\jarrey-foster-1,2015-16,Southern Methodist,G,30,1,523,55,127,.433,42,87,.483,13,40,.325,24,48,.500,42,59,101,40,10,11,28,48,147,3.9
6672,Ty Jerome\ty-jerome-1,2016-17,Virginia,G,34,5,473,52,110,.473,23,37,.622,29,73,.397,14,18,.778,1,54,55,50,15,2,30,59,147,3.1
6673,Izaiah Brockington\izaiah-brockington-1,2017-18,St. Bonaventure,G,34,1,396,52,118,.441,30,65,.462,22,53,.415,21,39,.538,8,34,42,30,14,5,14,27,147,3.2
6674,Malik Maitland\malik-maitland-1,2015-16,Morehead State,G,27,8,448,43,139,.309,26,86,.302,17,53,.321,44,57,.772,11,29,40,80,31,4,54,43,147,3.6
6675,Justin Coleman\justin-coleman-2,2014-15,Alabama,G,34,9,614,41,158,.259,15,49,.306,26,109,.239,39,52,.750,8,28,36,48,19,0,37,33,147,1.9
6676,Julian Walters\julian-walters-1,2017-18,Alabama A&M,G,22,19,672,50,120,.417,33,64,.516,17,56,.304,30,43,.698,13,86,99,80,26,0,47,44,147,5.9
6677,Austin Quick\austin-quick-1,2013-14,UC-Riverside,G,31,9,542,45,124,.363,22,57,.386,23,67,.343,34,43,.791,7,52,59,55,33,2,45,38,147,3.5
6678,Devon Baulkman\devon-baulkman-1,2014-15,Tennessee,G,31,7,457,45,118,.381,19,50,.380,26,68,.382,31,39,.795,28,44,72,19,19,3,24,35,147,3.5
6679,Javon Greene\javon-greene-1,2017-18,George Mason,G,33,1,583,51,144,.354,31,60,.517,20,84,.238,25,39,.641,4,87,91,31,25,7,31,58,147,2.6
6680,Lucian Brownlee\lucian-brownlee-1,2017-18,Coppin State,G,30,0,356,48,122,.393,17,44,.386,31,78,.397,20,24,.833,3,23,26,17,8,1,32,38,147,2.1
6681,Kavon Stewart\kavon-stewart-1,2013-14,Robert Morris,G,30,0,601,43,106,.406,41,99,.414,2,7,.286,59,98,.602,15,42,57,84,33,1,60,37,147,3.8
6682,Myles Cale\myles-cale-1,2017-18,Seton Hall,G,34,5,584,56,120,.467,43,74,.581,13,46,.283,22,35,.629,18,37,55,22,20,5,31,49,147,2.7
6683,Kevin Holland\kevin-holland-1,2016-17,Southern Mississippi,G,31,31,857,52,157,.331,24,78,.308,28,79,.354,15,23,.652,10,80,90,59,11,2,31,57,147,2.8
6684,David Efianayi\david-efianayi-1,2015-16,Gardner-Webb,G,20,3,347,60,123,.488,52,93,.559,8,30,.267,19,32,.594,7,30,37,32,13,6,26,16,147,5.0
6685,Ryan Cline\ryan-cline-1,2017-18,Purdue,G,37,0,640,51,129,.395,11,28,.393,40,101,.396,5,6,.833,3,61,64,63,13,2,19,35,147,3.3
6686,Charlie Jones\charlie-jones-2,2015-16,American,G,31,15,673,49,96,.510,34,63,.540,15,33,.455,34,48,.708,13,90,103,38,34,16,30,50,147,4.9
6687,Keleaf Tate\keleaf-tate-1,2017-18,Niagara,G,32,14,505,55,158,.348,29,85,.341,26,73,.356,11,21,.524,18,42,60,13,20,0,20,40,147,2.3
6688,Herb Jones\herb-jones-3,2017-18,Alabama,G,35,13,741,58,143,.406,51,117,.436,7,26,.269,24,48,.500,27,95,122,48,44,22,56,94,147,3.1
6689,Race Parsons\race-parsons-1,2014-15,Southern Utah,G,27,6,416,50,132,.379,22,45,.489,28,87,.322,19,24,.792,18,41,59,19,8,2,19,43,147,3.1
6690,Tim Marshall\tim-marshall-1,2013-14,Virginia Military Institute,G,34,0,332,48,127,.378,18,41,.439,30,86,.349,21,36,.583,12,32,44,24,16,0,14,47,147,2.6
6691,Randy Onwuasor\randy-onwuasor-1,2017-18,Louisiana State,G,32,11,498,51,113,.451,40,83,.482,11,30,.367,34,46,.739,23,44,67,27,16,2,28,48,147,3.2
6692,Francisco Amiel\francisco-amiel-1,2016-17,Colgate,G,32,14,866,48,134,.358,25,60,.417,23,74,.311,28,40,.700,8,62,70,78,33,1,64,59,147,2.9
6693,Tanner Johnson\tanner-johnson-1,2017-18,Bryant,G,24,7,384,49,139,.353,5,12,.417,44,127,.346,5,7,.714,8,33,41,15,2,0,12,26,147,3.1
6694,Dylan Smith\dylan-smith-1,2017-18,Arizona,G,34,8,498,49,135,.363,17,38,.447,32,97,.330,17,21,.810,12,41,53,36,5,7,31,49,147,2.2
6695,Zach Fong\zach-fong-1,2014-15,Navy,G,31,5,422,48,130,.369,14,30,.467,34,100,.340,17,22,.773,1,20,21,20,7,1,22,25,147,2.2
6696,T.J. Henderson\tj-henderson-1,2015-16,IUPUI,G,32,4,522,49,129,.380,27,66,.409,22,63,.349,27,39,.692,5,48,53,35,30,2,44,48,147,2.6
6697,Jordan Lauf\jordan-lauf-1,2015-16,Toledo,G,32,1,774,47,91,.516,37,59,.627,10,32,.313,43,62,.694,61,60,121,42,23,3,18,67,147,5.2
6698,Quentin Snider\quentin-snider-1,2014-15,Louisville,G,36,10,589,53,152,.349,34,85,.400,19,67,.284,21,38,.553,9,49,58,47,11,1,29,43,146,2.0
6699,Jerome Segura\jerome-segura-1,2014-15,Fairfield,G,30,13,623,59,162,.364,46,116,.397,13,46,.283,15,31,.484,5,30,35,64,15,2,60,48,146,1.5
6700,Dominique Major\dominique-major-1,2014-15,Saint Francis (PA),G,31,4,559,44,148,.297,4,18,.222,40,130,.308,18,26,.692,4,16,20,19,16,1,14,32,146,2.2
6701,Jorge Rosa\jorge-rosa-1,2016-17,New Orleans,G,31,3,382,52,123,.423,21,44,.477,31,79,.392,11,17,.647,14,26,40,20,14,1,17,32,146,3.1
6702,Jodan Price\jodan-price-1,2014-15,Eastern Michigan,G,34,3,533,50,181,.276,13,46,.283,37,135,.274,9,13,.692,11,55,66,14,16,19,20,37,146,1.9
6703,Xavier Adams\xavier-adams-1,2015-16,New Mexico,G,32,3,446,50,102,.490,46,78,.590,4,24,.167,42,63,.667,33,49,82,32,16,8,34,88,146,3.1
6704,Nick Masterson\nick-masterson-1,2015-16,Kennesaw State,G,31,30,696,55,154,.357,24,65,.369,31,89,.348,5,10,.500,13,40,53,37,17,8,33,54,146,2.4
6705,Martavious Newby\martavious-newby-1,2015-16,Mississippi,G,30,22,835,38,113,.336,30,77,.390,8,36,.222,62,88,.705,69,94,163,71,41,6,49,76,146,5.5
6706,Milan Acquaah\milan-acquaah-1,2017-18,Washington State,G,30,9,525,52,134,.388,37,77,.481,15,57,.263,27,50,.540,6,48,54,58,17,1,70,61,146,1.5
6707,Michael Buckland\michael-buckland-1,2016-17,Lipscomb,G,32,0,592,50,127,.394,24,49,.490,26,78,.333,20,29,.690,15,75,90,51,11,13,39,51,146,3.2
6708,Khalen Pinkett\khaleen-pinkett-1,2014-15,Savannah State,G,30,19,711,57,149,.383,53,128,.414,4,21,.190,28,61,.459,18,45,63,34,44,3,88,59,146,1.2
6709,Jordan Strawberry\jordan-strawberry-1,2014-15,Mercer,G,34,0,501,59,149,.396,45,111,.405,14,38,.368,14,18,.778,11,29,40,70,15,0,42,47,146,2.5
6710,Ayron Hutton\ayron-hutton-1,2015-16,Quinnipiac,G,29,2,531,44,151,.291,13,65,.200,31,86,.360,27,45,.600,20,60,80,56,14,1,50,50,146,2.3
6711,Terel Hall\terel-hall-1,2013-14,Savannah State,G,32,13,709,50,125,.400,46,110,.418,4,15,.267,42,87,.483,15,65,80,91,41,6,65,60,146,3.5
6712,Ben Richardson\ben-richardson-1,2015-16,Loyola (IL),G,31,18,739,48,127,.378,12,46,.261,36,81,.444,14,16,.875,5,54,59,52,32,5,26,71,146,3.6
6713,Ronnel Jordan\ronnel-jordan-1,2014-15,New Hampshire,G,30,2,439,56,138,.406,39,88,.443,17,50,.340,17,27,.630,11,57,68,15,4,0,22,34,146,2.4
6714,Marcel White\marcel-white-1,2013-14,Jacksonville,G,30,4,499,53,124,.427,36,76,.474,17,48,.354,23,43,.535,23,48,71,8,14,8,18,56,146,2.9
6715,David Appolon\david-appolon-1,2013-14,Robert Morris,G,35,15,582,53,118,.449,49,92,.533,4,26,.154,36,50,.720,44,69,113,31,24,1,22,54,146,3.8
6716,Kanayo Obi-Rapu\kanayo-obi-rapu-1,2014-15,Longwood,G,33,5,532,51,133,.383,22,46,.478,29,87,.333,15,25,.600,7,61,68,23,18,4,39,72,146,1.9
6717,Kadeem Smithen\kadeem-smithen-1,2017-18,Siena,G,29,15,550,45,108,.417,33,77,.429,12,31,.387,44,55,.800,32,70,102,42,19,9,24,59,146,4.6
6718,Kendall Stephens\kendall-stephens-1,2015-16,Purdue,G,24,0,340,48,140,.343,10,20,.500,38,120,.317,12,20,.600,5,25,30,21,10,4,12,28,146,3.3
6719,Todd Hughes\todd-hughes-1,2015-16,Delaware State,G,28,12,463,58,153,.379,53,124,.427,5,29,.172,25,34,.735,15,45,60,20,15,12,37,28,146,2.6
6720,Charles Taylor\charles-taylor-1,2013-14,Maryland-Baltimore County,G,29,9,524,53,147,.361,49,118,.415,4,29,.138,36,63,.571,31,49,80,16,14,8,33,69,146,2.1
6721,Everett Osborne\everett-osborne-1,2014-15,Texas-Rio Grande Valley,G,31,6,491,48,140,.343,36,99,.364,12,41,.293,38,50,.760,11,32,43,21,9,6,35,38,146,1.9
6722,Jalin Barnes\jalin-barnes-1,2015-16,Sam Houston State,G,34,13,642,55,149,.369,35,88,.398,20,61,.328,16,25,.640,7,80,87,61,27,5,49,77,146,2.4
6723,Hudson Price\hudson-price-1,2016-17,Charlotte,G,28,2,597,49,116,.422,19,33,.576,30,83,.361,18,24,.750,12,52,64,16,16,8,20,57,146,3.4
6724,Gary Chivichyan\gary-chivichyan-1,2017-18,Idaho State,G,21,4,331,49,113,.434,14,34,.412,35,79,.443,13,21,.619,3,26,29,5,3,3,8,25,146,4.0
6725,DeShawndre Black\deshawndre-black-1,2017-18,Detroit Mercy,G,32,10,561,50,133,.376,31,76,.408,19,57,.333,27,35,.771,16,41,57,58,22,2,41,72,146,2.7
6726,Monty Boykins\monty-boykins-1,2014-15,Lafayette,G,31,7,391,50,131,.382,25,70,.357,25,61,.410,21,36,.583,7,38,45,25,10,2,34,30,146,2.2
6727,Colen Gaynor\colen-gaynor-1,2017-18,Maryland-Eastern Shore,G,27,13,621,54,135,.400,36,77,.468,18,58,.310,19,36,.528,43,76,119,8,18,7,29,69,145,3.3
6728,Tray Buchanan\tray-buchanan-1,2017-18,North Dakota,G,31,1,372,45,130,.346,20,51,.392,25,79,.316,30,38,.789,7,25,32,21,27,0,26,45,145,2.5
6729,Matt Hart\matt-hart-1,2015-16,George Washington,G,38,0,333,49,112,.438,25,55,.455,24,57,.421,23,26,.885,4,29,33,12,10,0,12,46,145,2.2
6730,Desmond Ridenour\desmond-ridenour-1,2016-17,Kent State,G,35,5,589,56,150,.373,43,90,.478,13,60,.217,20,27,.741,29,54,83,56,33,5,22,49,145,3.7
6731,Randall Gaskins Jr.\randall-gaskinsjr-1,2017-18,Saint Francis (PA),G,28,25,723,57,127,.449,52,103,.505,5,24,.208,26,42,.619,22,44,66,36,25,6,20,50,145,4.1
6732,Darius Austin\darius-austin-1,2014-15,Missouri-Kansas City,G,33,20,638,58,145,.400,54,133,.406,4,12,.333,25,50,.500,51,88,139,25,22,23,33,76,145,3.4
6733,Andre Wolford\andre-wolford-1,2016-17,Saint Francis (PA),G,31,3,321,52,106,.491,26,40,.650,26,66,.394,15,21,.714,12,23,35,8,10,5,14,26,145,3.2
6734,Rusty Reigel\rusty-reigel-1,2016-17,Davidson,G,31,17,789,50,126,.397,23,45,.511,27,81,.333,18,25,.720,28,91,119,55,13,4,37,63,145,3.6
6735,Wyatt Lohaus\wyatt-lohaus-1,2015-16,Northern Iowa,G,36,0,660,53,136,.390,35,80,.438,18,56,.321,21,27,.778,3,53,56,36,13,0,31,39,145,2.2
6736,Karmari Newman\karmari-newman-1,2016-17,George Mason,G,31,0,470,51,142,.359,22,54,.407,29,88,.330,14,17,.824,4,34,38,12,5,1,16,36,145,2.0
6737,Dorrian Williams\dorrian-williams-1,2015-16,Missouri State,G,20,17,606,56,151,.371,49,115,.426,7,36,.194,26,35,.743,4,83,87,77,27,1,32,44,145,5.9
6738,D'Marques Tyson\dmarques-tyson-1,2014-15,Portland,G,25,0,248,48,113,.425,13,24,.542,35,89,.393,14,17,.824,3,18,21,7,5,1,14,18,145,3.2
6739,Matt Hart\matt-hart-1,2016-17,George Washington,G,35,7,489,50,123,.407,19,50,.380,31,73,.425,14,16,.875,14,40,54,31,10,2,22,26,145,2.9
6740,David Humphries\david-humphries-1,2015-16,Loyola Marymount,G,29,5,528,47,126,.373,13,33,.394,34,93,.366,17,22,.773,22,75,97,27,16,1,18,41,145,3.9
6741,Lincoln Davis\lincoln-davis-1,2016-17,Lamar,G,28,15,372,52,114,.456,29,62,.468,23,52,.442,18,28,.643,2,32,34,21,9,5,21,38,145,3.0
6742,Andrew Guillory\andrew-guillory-1,2014-15,Southeastern Louisiana,G,18,17,486,46,101,.455,41,80,.513,5,21,.238,48,67,.716,16,47,63,37,12,1,26,25,145,6.3
6743,Michael Calder\michael-calder-1,2014-15,Purdue-Fort Wayne,G,31,0,482,46,109,.422,23,56,.411,23,53,.434,30,48,.625,6,58,64,38,11,0,46,41,145,2.5
6744,Jake Pemberton\jake-pemberton-1,2015-16,Denver,G,31,19,845,45,99,.455,32,54,.593,13,45,.289,42,50,.840,9,76,85,84,45,5,54,64,145,4.8
6745,Ta'Jon Welcome\tajon-welcome-1,2015-16,Northwestern State,G,28,15,436,53,129,.411,37,65,.569,16,64,.250,23,30,.767,12,31,43,26,9,4,26,32,145,2.9
6746,Kevin Hicks\kevin-hicks-3,2017-18,Sacramento State,G,31,9,525,47,140,.336,18,37,.486,29,103,.282,22,25,.880,10,34,44,17,8,0,11,38,145,2.4
6747,Xavier Talton\xavier-talton-1,2014-15,Colorado,G,34,15,763,45,149,.302,20,70,.286,25,79,.316,30,41,.732,4,54,58,54,20,3,48,68,145,1.7
6748,Mark Cornelius\mark-cornelius-1,2013-14,Massachusetts-Lowell,G,28,0,609,50,125,.400,32,72,.444,18,53,.340,27,39,.692,33,58,91,48,20,6,37,57,145,4.0
6749,Bryce Barnes\bryce-barnes-1,2016-17,Milwaukee,G,35,1,425,47,110,.427,33,79,.418,14,31,.452,37,51,.725,4,31,35,20,22,1,35,45,145,2.2
6750,Tavian Dunn-Martin\tavian-dunn-martin-1,2016-17,Akron,G,36,1,384,49,126,.389,16,38,.421,33,88,.375,14,18,.778,2,27,29,38,12,0,25,37,145,2.3
6751,Jamal Branch\jamal-branch-1,2014-15,St. John's (NY),G,30,14,673,59,127,.465,49,96,.510,10,31,.323,17,23,.739,16,58,74,71,18,0,29,51,145,4.1
6752,Jordan McNeil\jordan-mcneil-1,2017-18,Towson,G,31,2,523,53,121,.438,28,57,.491,25,64,.391,14,23,.609,6,44,50,24,18,3,25,40,145,2.9
6753,Lysander Bracey\lysander-bracey-1,2016-17,Hampton,G,29,15,514,47,144,.326,13,29,.448,34,115,.296,17,21,.810,10,33,43,30,14,4,28,33,145,2.6
6754,Duane Wilson\duane-wilson-1,2016-17,Marquette,G,30,7,492,54,128,.422,40,80,.500,14,48,.292,22,32,.688,3,50,53,49,29,3,25,59,144,3.5
6755,Brent Wrapp\brent-wrapp-1,2014-15,Cal State Bakersfield,G,33,6,679,42,89,.472,42,83,.506,0,6,.000,60,86,.698,21,84,105,111,22,2,42,79,144,4.7
6756,Marcus Keene\marcus-keene-1,2013-14,Youngstown State,G,22,1,359,47,127,.370,25,59,.424,22,68,.324,28,37,.757,3,38,41,49,11,0,29,29,144,4.0
6757,Jayrn Johnson\jayrn-johnson-1,2014-15,Prairie View,G,33,1,401,50,131,.382,40,99,.404,10,32,.313,34,42,.810,7,20,27,15,26,8,18,45,144,2.6
6758,Parker Van Dyke\parker-vandyke-1,2016-17,Utah,G,31,11,537,54,136,.397,24,50,.480,30,86,.349,6,13,.462,3,55,58,39,16,3,12,29,144,3.5
6759,Dimi Cook\dimi-cook-1,2016-17,Southeastern Louisiana,G,32,0,572,42,101,.416,33,72,.458,9,29,.310,51,71,.718,14,33,47,49,12,0,40,57,144,2.7
6760,Steven Wronkoski\steven-wronkoski-1,2013-14,Louisiana,G,33,14,606,45,119,.378,19,38,.500,26,81,.321,28,38,.737,18,49,67,26,8,0,43,62,144,1.8
6761,Ryan Pippins\ryan-pippins-1,2017-18,Little Rock,G,19,12,465,47,131,.359,24,77,.312,23,54,.426,27,36,.750,3,38,41,25,12,0,28,39,144,3.5
6762,Zach Radz\zach-radz-1,2017-18,Sacred Heart,G,21,0,478,47,132,.356,28,67,.418,19,65,.292,31,39,.795,10,72,82,22,6,2,24,26,144,4.0
6763,Matt Frierson\matt-frierson-1,2015-16,Citadel,G,31,1,307,49,131,.374,9,15,.600,40,116,.345,6,8,.750,11,12,23,18,16,0,9,24,144,3.0
6764,Nick Malonga\nick-malonga-1,2015-16,North Florida,G,34,34,581,54,134,.403,39,78,.500,15,56,.268,21,42,.500,24,59,83,23,9,6,33,58,144,2.1
6765,Kofi Andoh\kofi-andoh-1,2015-16,Howard,G,32,12,551,42,112,.375,36,93,.387,6,19,.316,54,66,.818,25,60,85,15,15,5,32,64,144,2.6
6766,Marcus Cohen\marcus-cohen-2,2017-18,Mercer,G,34,1,486,61,135,.452,60,128,.469,1,7,.143,21,52,.404,6,35,41,84,17,1,63,47,144,2.1
6767,McKenzie Moore\mckenzie-moore-1,2013-14,Texas-El Paso,G,11,9,300,40,90,.444,30,63,.476,10,27,.370,54,67,.806,9,40,49,30,8,5,32,31,144,8.9
6768,Vasa Pusica\vasa-pusica-1,2014-15,San Diego,G,31,1,470,47,122,.385,34,75,.453,13,47,.277,37,49,.755,14,51,65,42,15,3,27,55,144,3.1
6769,Desmond Ridenour\desmond-ridenour-1,2013-14,Duquesne,G,30,0,476,55,150,.367,46,105,.438,9,45,.200,25,46,.543,6,39,45,59,28,3,41,37,144,2.8
6770,Peyton Allen\peyton-allen-1,2014-15,Texas A&M,G,32,8,452,49,129,.380,19,36,.528,30,93,.323,16,20,.800,5,19,24,15,8,4,18,42,144,2.1
6771,Darnell Edge\darnell-edge-1,2015-16,Fairleigh Dickinson,G,33,1,435,53,119,.445,34,74,.459,19,45,.422,19,20,.950,19,22,41,28,11,0,14,33,144,3.2
6772,Marcus Merriweather\marcus-merriweather-1,2016-17,Alabama A&M,G,26,10,449,50,151,.331,29,76,.382,21,75,.280,23,30,.767,9,31,40,22,5,0,30,38,144,1.8
6773,Daniel Dingle\daniel-dingle-1,2015-16,Temple,G,33,13,684,48,146,.329,33,84,.393,15,62,.242,33,61,.541,32,61,93,50,13,14,27,64,144,2.9
6774,Timmy Falls\timmy-falls-1,2017-18,Montana,G,33,0,563,48,116,.414,26,62,.419,22,54,.407,26,36,.722,7,25,32,51,25,2,41,78,144,2.4
6775,Sam Singer\sam-singer-1,2014-15,University of California,G,33,10,793,57,131,.435,44,84,.524,13,47,.277,17,35,.486,12,74,86,97,24,5,45,79,144,3.6
6776,Quinton Hooker\quinton-hooker-1,2013-14,North Dakota,G,34,15,600,46,117,.393,36,77,.468,10,40,.250,42,54,.778,17,48,65,63,35,6,35,68,144,3.6
6777,Diontae Jones\diontae-jones-1,2017-18,Grambling,G,18,8,351,50,116,.431,34,78,.436,16,38,.421,28,35,.800,18,51,69,7,11,6,19,43,144,5.1
6778,Sean Hoehn\sean-hoehn-1,2015-16,Sacred Heart,G,30,21,677,49,114,.430,28,55,.509,21,59,.356,25,35,.714,13,42,55,57,28,0,47,66,144,3.2
6779,Aaron Wright\aaron-wright-1,2013-14,UC-Irvine,G,35,0,513,46,105,.438,39,83,.470,7,22,.318,45,69,.652,10,55,65,63,27,3,40,77,144,3.0
6780,Kamil Chapman\kamil-chapman-1,2017-18,Longwood,G,28,6,399,41,122,.336,15,35,.429,26,87,.299,35,43,.814,3,37,40,11,19,0,32,40,143,2.2
6781,Jason Todd\jason-todd-1,2015-16,Portland,G,29,16,599,52,119,.437,32,62,.516,20,57,.351,19,25,.760,19,47,66,28,22,7,23,25,143,4.1
6782,Rayshawn Simmons\rayshawn-simmons-1,2013-14,Central Michigan,G,31,0,668,45,114,.395,37,94,.394,8,20,.400,45,62,.726,47,49,96,65,23,1,40,75,143,3.9
6783,Devin Joint\devin-joint-1,2013-14,South Carolina State,G,29,23,610,66,118,.559,66,116,.569,0,2,.000,11,23,.478,52,78,130,39,35,12,28,80,143,5.3
6784,Jalen Reeder\jalen-reeder-1,2017-18,Alabama A&M,G,28,7,473,52,144,.361,32,69,.464,20,75,.267,19,29,.655,18,42,60,23,7,3,37,29,143,2.2
6785,Talbott Denny\talbott-denny-1,2013-14,Lipscomb,G,29,20,751,41,114,.360,31,85,.365,10,29,.345,51,97,.526,42,92,134,29,24,3,28,116,143,3.1
6786,Rayvon Harris\rayvon-harris-1,2014-15,Niagara,G,25,15,426,46,106,.434,41,89,.461,5,17,.294,46,72,.639,29,52,81,15,7,7,52,52,143,2.5
6787,Luke Eddy\luke-eddy-1,2014-15,Elon,G,11,2,214,51,88,.580,34,54,.630,17,34,.500,24,31,.774,2,24,26,23,13,2,20,21,143,10.0
6788,Jake Silpe\jake-silpe-1,2015-16,Pennsylvania,G,28,19,628,45,124,.363,30,76,.395,15,48,.313,38,60,.633,23,49,72,89,27,2,60,77,143,3.4
6789,Ryan Richardson\ryan-richardson-1,2014-15,Weber State,G,24,0,372,47,129,.364,14,34,.412,33,95,.347,16,19,.842,3,27,30,21,6,8,25,37,143,2.8
6790,Dion Wiley\dion-wiley-1,2014-15,Maryland,G,35,2,474,48,126,.381,24,53,.453,24,73,.329,23,36,.639,11,41,52,20,10,7,31,34,143,2.1
6791,E. Victor Nickerson\e-victor-nickerson-1,2015-16,Valparaiso,G,32,7,482,41,136,.301,35,96,.365,6,40,.150,55,79,.696,17,52,69,40,15,2,47,64,143,1.7
6792,Rakeem Dickerson\rakeem-dickerson-1,2013-14,Arkansas State,G,32,12,591,36,97,.371,23,63,.365,13,34,.382,58,81,.716,9,49,58,65,30,2,35,49,143,3.9
6793,Tyrik Edwards\tyrik-edwards-1,2016-17,Jacksonville State,G,34,4,468,48,105,.457,46,93,.495,2,12,.167,45,60,.750,10,38,48,65,14,1,25,21,143,3.8
6794,Keith Smith\keith-smith-46,2016-17,Virginia Military Institute,G,30,2,613,50,123,.407,30,57,.526,20,66,.303,23,34,.676,8,36,44,56,23,12,43,77,143,2.9
6795,Nolan Cressler\nolan-cressler-1,2015-16,Vanderbilt,G,30,2,370,57,125,.456,40,63,.635,17,62,.274,12,23,.522,10,55,65,23,3,3,21,41,143,2.7
6796,Jordan Lauf\jordan-lauf-1,2014-15,Toledo,G,33,0,633,44,93,.473,32,59,.542,12,34,.353,43,64,.672,46,72,118,36,30,4,20,65,143,4.6
6797,Gilbert Parga\gilbert-parga-1,2013-14,Long Island University,G,19,5,349,37,104,.356,23,56,.411,14,48,.292,55,74,.743,7,42,49,15,5,1,23,24,143,4.1
6798,John Murry\john-murry-1,2015-16,Austin Peay,G,27,0,293,43,95,.453,30,57,.526,13,38,.342,43,58,.741,10,35,45,12,10,0,25,23,142,3.3
6799,Marcus Wallace\marcus-wallace-1,2014-15,Southeast Missouri State,G,29,2,460,47,100,.470,34,66,.515,13,34,.382,35,51,.686,15,33,48,44,35,3,35,50,142,4.1
6800,Matt Fox\matt-fox-1,2017-18,Bowling Green State,G,31,3,516,44,105,.419,6,21,.286,38,84,.452,16,19,.842,8,46,54,32,9,3,14,23,142,3.7
6801,Chancellor Barnard\chancellor-barnard-1,2016-17,Loyola (MD),G,33,7,730,53,108,.491,52,101,.515,1,7,.143,35,63,.556,38,56,94,20,13,19,34,68,142,3.0
6802,Khalil Alford\khalil-alford-1,2013-14,Rider,G,31,0,381,57,117,.487,36,67,.537,21,50,.420,7,17,.412,24,36,60,15,11,3,17,49,142,3.0
6803,Dominique Collier\dominique-collier-1,2014-15,Colorado,G,30,10,579,48,139,.345,30,72,.417,18,67,.269,28,46,.609,9,41,50,44,18,5,38,72,142,2.0
6804,James Palmer\james-palmer-1,2014-15,Miami (FL),G,38,5,504,52,126,.413,29,63,.460,23,63,.365,15,23,.652,14,40,54,25,5,9,28,28,142,2.2
6805,Davon Dillard\davon-dillard-1,2016-17,Oklahoma State,G,25,0,324,52,98,.531,39,71,.549,13,27,.481,25,37,.676,30,51,81,14,14,4,29,35,142,4.4
6806,Timmy Rose\timmy-rose-1,2017-18,Binghamton,G,31,12,677,52,121,.430,37,82,.451,15,39,.385,23,42,.548,8,44,52,87,14,3,55,39,142,3.1
6807,A.J. Merriweather\aj-merriweather-1,2015-16,East Tennessee State,G,21,12,365,51,100,.510,43,79,.544,8,21,.381,32,42,.762,20,52,72,16,15,1,26,37,142,5.0
6808,Kimbal MacKenzie\kimbal-mackenzie-1,2015-16,Bucknell,G,31,0,483,44,110,.400,21,50,.420,23,60,.383,31,38,.816,3,33,36,51,15,3,41,62,142,2.5
6809,T.J. Parham\tj-parham-1,2017-18,Green Bay,G,27,2,350,45,140,.321,19,66,.288,26,74,.351,26,38,.684,15,50,65,17,17,1,27,32,142,2.7
6810,Isaac McGlone\isaac-mcglone-1,2015-16,Eastern Kentucky,G,31,30,877,46,116,.397,7,20,.350,39,96,.406,11,15,.733,5,49,54,57,39,3,10,75,142,4.4
6811,Dillon Avare\dillon-avare-1,2017-18,Eastern Kentucky,G,30,5,560,47,121,.388,1,1,1.000,46,120,.383,2,2,1.000,5,17,22,29,9,1,20,33,142,2.7
6812,Joe Burton\joe-burton-2,2015-16,Oklahoma State,G,30,0,377,47,106,.443,22,43,.512,25,63,.397,23,39,.590,8,35,43,19,7,2,19,39,142,2.8
6813,Henry Baddley\henry-baddley-1,2017-18,Butler,G,35,0,531,50,96,.521,30,53,.566,20,43,.465,22,26,.846,13,54,67,19,16,13,19,47,142,3.4
6814,Lavar Harewood\lavar-harewood-1,2015-16,Maine,G,28,8,404,42,131,.321,23,73,.315,19,58,.328,39,55,.709,13,58,71,25,22,7,33,53,142,2.8
6815,Emmanuel Chibuogwu\emmanuel-chibuogwu-1,2015-16,Seattle,G,31,23,631,54,124,.435,53,115,.461,1,9,.111,33,43,.767,23,73,96,29,15,6,37,60,142,2.9
6816,Ke'Ron Brown\keron-brown-1,2013-14,Hampton,G,31,30,793,47,137,.343,42,105,.400,5,32,.156,43,80,.538,51,98,149,51,52,7,52,109,142,3.6
6817,Ryan Fazekas\ryan-fazekas-1,2015-16,Providence,G,28,12,526,47,129,.364,13,30,.433,34,99,.343,14,19,.737,20,46,66,9,11,6,8,36,142,3.4
6818,Jaylen Allen\jaylen-allen-1,2015-16,Wofford,G,30,9,445,52,149,.349,26,63,.413,26,86,.302,12,27,.444,15,39,54,26,25,3,24,56,142,2.5
6819,Tommy Pereira\tommy-pereira-1,2013-14,Rider,G,31,6,561,46,114,.404,5,11,.455,41,103,.398,9,12,.750,10,34,44,23,20,0,11,39,142,3.4
6820,Devonte Green\devonte-green-1,2016-17,Indiana,G,32,3,485,47,106,.443,23,51,.451,24,55,.436,24,34,.706,9,48,57,34,22,6,40,24,142,3.2
6821,George Willborn III\george-willborniii-1,2016-17,Texas-San Antonio,G,31,6,395,48,120,.400,43,102,.422,5,18,.278,40,83,.482,23,34,57,14,15,5,33,41,141,2.1
6822,Tevin Broyles\tevin-broyles-1,2013-14,New Orleans,G,25,20,429,49,106,.462,42,85,.494,7,21,.333,36,63,.571,27,42,69,24,16,1,43,58,141,3.0
6823,Kris Gulley\kris-gulley-1,2014-15,Florida International,G,33,27,656,54,139,.388,30,50,.600,24,89,.270,9,16,.563,22,80,102,24,22,6,32,59,141,2.7
6824,Rashaan Surles\rashaan-surles-1,2015-16,Mississippi Valley State,G,34,9,644,52,165,.315,34,107,.318,18,58,.310,19,35,.543,14,79,93,78,22,15,49,55,141,2.6
6825,Juwan Major\juwan-major-1,2015-16,Southern Utah,G,30,18,615,53,131,.405,53,128,.414,0,3,.000,35,56,.625,19,48,67,37,19,12,58,78,141,1.8
6826,Jordan Harris\jordan-harris-4,2016-17,Georgia,G,30,12,494,46,106,.434,24,57,.421,22,49,.449,27,37,.730,7,35,42,45,16,6,56,47,141,2.5
6827,Austin Ruder\austin-ruder-1,2016-17,Missouri State,G,29,7,390,47,131,.359,7,20,.350,40,111,.360,7,9,.778,3,24,27,9,8,3,6,30,141,2.6
6828,Jamal Branch\jamal-branch-1,2013-14,St. John's (NY),G,31,7,449,50,107,.467,44,89,.494,6,18,.333,35,46,.761,7,34,41,53,21,5,37,42,141,3.4
6829,Marcus Wallace\marcus-wallace-3,2015-16,Arkansas-Pine Bluff,G,31,23,664,48,129,.372,25,55,.455,23,74,.311,22,31,.710,17,31,48,24,24,0,47,35,141,2.2
6830,Kamil Williams\kamil-williams-1,2015-16,Savannah State,G,28,0,310,42,125,.336,9,21,.429,33,104,.317,24,38,.632,4,31,35,11,11,1,19,42,141,2.2
6831,Jayden Hodgson\jayden-hodgson-1,2017-18,Bradley,G,32,18,750,45,106,.425,20,43,.465,25,63,.397,26,36,.722,5,48,53,45,28,0,37,60,141,3.0
6832,Shaq Carr\shaq-carr-1,2016-17,Grand Canyon,G,30,6,552,49,104,.471,45,96,.469,4,8,.500,39,47,.830,16,50,66,73,22,1,57,38,141,3.7
6833,Parker Van Dyke\parker-vandyke-1,2017-18,Utah,G,35,12,652,47,129,.364,16,28,.571,31,101,.307,16,24,.667,4,35,39,52,16,1,23,29,141,2.8
6834,Kevin Crescenzi\kevin-crescenzi-1,2013-14,Dartmouth,G,27,2,475,53,126,.421,33,76,.434,20,50,.400,15,26,.577,18,51,69,24,21,2,19,53,141,3.6
6835,Jeff Wu\jeff-wu-1,2017-18,Sacramento State,G,25,22,594,55,133,.414,33,70,.471,22,63,.349,9,11,.818,4,41,45,44,17,1,26,36,141,3.7
6836,Jeremiah Davis\jeremiah-davis-1,2014-15,Ball State,G,20,17,575,55,167,.329,39,101,.386,16,66,.242,15,20,.750,10,54,64,62,29,4,42,57,141,3.9
6837,Cameron Jones\cameron-jones-3,2015-16,Saint Peter's,G,30,1,527,48,146,.329,8,16,.500,40,130,.308,5,8,.625,14,45,59,9,15,4,14,54,141,2.3
6838,Joshea Singleton\joshea-singleton-1,2015-16,North Carolina A&T,G,16,16,390,47,121,.388,34,78,.436,13,43,.302,34,48,.708,24,34,58,15,8,6,30,36,141,4.7
6839,James Miller\james-miller-2,2013-14,Howard,G,23,14,417,50,122,.410,27,53,.509,23,69,.333,18,29,.621,13,40,53,17,19,7,38,50,141,3.0
6840,Aaron Korn\aaron-korn-1,2017-18,Lipscomb,G,33,0,511,46,122,.377,22,42,.524,24,80,.300,25,38,.658,34,89,123,34,11,2,28,48,141,3.3
6841,Kylan Phillips\kylan-phillips-1,2015-16,Mississippi Valley State,G,34,21,809,48,192,.250,30,124,.242,18,68,.265,27,35,.771,10,41,51,59,29,1,56,62,141,0.9
6842,Zach Horstman\zach-horstman-1,2014-15,South Dakota State,G,33,16,506,50,107,.467,37,69,.536,13,38,.342,28,43,.651,32,47,79,17,10,5,18,57,141,3.1
6843,Connor Kern\connor-kern-1,2016-17,Arkansas State,G,32,1,545,42,99,.424,4,16,.250,38,83,.458,19,24,.792,7,64,71,11,9,3,5,48,141,3.3
6844,Jordan Baker\jordan-baker-3,2015-16,Old Dominion,G,38,27,975,48,145,.331,16,28,.571,32,117,.274,13,29,.448,5,86,91,81,38,3,39,74,141,2.9
6845,Tim Bond\tim-bond-1,2014-15,Eastern Michigan,G,22,6,495,56,130,.431,46,100,.460,10,30,.333,19,33,.576,13,46,59,26,17,19,38,36,141,3.9
6846,Darius Perry\darius-perry-1,2017-18,Louisville,G,36,3,513,40,114,.351,17,44,.386,23,70,.329,38,44,.864,6,37,43,54,21,3,39,65,141,2.4
6847,Jevon Thomas\jevon-thomas-1,2014-15,Kansas State,G,31,25,799,45,119,.378,37,91,.407,8,28,.286,42,80,.525,20,72,92,102,35,1,72,85,140,3.1
6848,Dustin Thomas\dustin-thomas-1,2014-15,Colorado,G,32,11,535,49,110,.445,43,91,.473,6,19,.316,36,53,.679,26,53,79,29,12,8,34,81,140,2.5
6849,Iverson Fleming\iverson-fleming-1,2014-15,Long Island University,G,30,1,555,46,132,.348,24,64,.375,22,68,.324,26,40,.650,6,28,34,43,23,1,32,63,140,2.3
6850,Tyson Batiste\tyson-batiste-1,2016-17,Central Connecticut State,G,27,21,686,57,146,.390,43,108,.398,14,38,.368,12,32,.375,16,61,77,79,22,2,64,70,140,2.5
6851,Josh Schuler\josh-schuler-1,2013-14,North Dakota,G,24,13,503,49,130,.377,25,50,.500,24,80,.300,18,22,.818,4,29,33,27,13,2,11,41,140,3.5
6852,Juwan Major\juwan-major-1,2013-14,Southern Utah,G,29,11,596,53,131,.405,50,120,.417,3,11,.273,31,44,.705,13,33,46,35,13,8,57,66,140,1.5
6853,John Johnson\john-johnson-3,2013-14,Penn State,G,21,2,429,51,135,.378,30,69,.435,21,66,.318,17,22,.773,4,31,35,12,6,1,26,42,140,2.3
6854,Stefan Gonzalez\stefan-gonzalez-1,2015-16,Saint Mary's (CA),G,35,0,349,45,87,.517,5,11,.455,40,76,.526,10,15,.667,4,54,58,14,8,0,11,25,140,3.2
6855,Derrick Henry\derrick-henry-1,2014-15,Winthrop,G,32,3,515,46,132,.348,36,79,.456,10,53,.189,38,52,.731,10,43,53,20,18,2,23,28,140,2.5
6856,Keith Hayes II\keith-hayesii-1,2015-16,Massachusetts-Lowell,G,23,3,320,41,92,.446,27,54,.500,14,38,.368,44,54,.815,8,25,33,16,14,1,16,29,140,4.3
6857,Kennedy McKinney\kennedy-mckinney-1,2016-17,Arkansas-Pine Bluff,G,32,3,570,54,132,.409,51,113,.451,3,19,.158,29,41,.707,34,37,71,37,40,3,65,52,140,2.5
6858,Skyler Flatten\skyler-flatten-1,2016-17,South Dakota State,G,27,2,474,46,100,.460,17,28,.607,29,72,.403,19,21,.905,9,41,50,20,14,4,9,22,140,4.4
6859,Jabbar Singleton\jabbar-singleton-1,2016-17,Southeastern Louisiana,G,32,31,717,44,140,.314,13,49,.265,31,91,.341,21,32,.656,10,35,45,81,20,0,53,51,140,2.4
6860,Caden Dickerson\caden-dickerson-1,2013-14,Western Kentucky,G,30,26,748,57,125,.456,35,58,.603,22,67,.328,4,8,.500,13,51,64,37,10,0,33,28,140,3.0
6861,David Joseph\david-joseph-1,2014-15,Bowling Green State,G,33,25,709,50,168,.298,40,116,.345,10,52,.192,30,35,.857,9,73,82,109,30,0,56,47,140,3.0
6862,Guilien Smith\guilien-smith-1,2015-16,Dartmouth,G,28,8,412,49,129,.380,36,84,.429,13,45,.289,29,37,.784,7,30,37,14,11,0,18,35,140,2.5
6863,Deonte Houston\deonte-houston-1,2013-14,Southern Mississippi,G,36,5,651,40,116,.345,32,88,.364,8,28,.286,52,81,.642,15,35,50,64,29,0,37,55,140,2.8
6864,Tahj Shamsid-Deen\tahj-shamsid-deen-1,2014-15,Auburn,G,23,15,534,48,134,.358,30,71,.423,18,63,.286,26,36,.722,5,21,26,35,16,0,17,42,140,3.4
6865,Darryl Smith\darryl-smith-1,2013-14,Cornell,G,28,10,548,58,129,.450,48,102,.471,10,27,.370,14,18,.778,14,51,65,22,16,7,34,39,140,3.0
6866,Daniel Peace\daniel-peace-1,2015-16,Troy,G,31,30,762,50,130,.385,50,126,.397,0,4,.000,39,89,.438,6,50,56,97,44,1,71,102,139,2.2
6867,Troy Reid-Knight\troy-reid-knight-1,2015-16,Maine,G,29,5,531,45,138,.326,19,54,.352,26,84,.310,23,36,.639,21,42,63,37,21,1,47,62,139,2.0
6868,Denzel Dulin\denzel-dulin-1,2014-15,Bethune-Cookman,G,25,22,583,46,125,.368,40,95,.421,6,30,.200,41,76,.539,21,56,77,12,19,10,44,55,139,2.2
6869,Eric Nottage\eric-nottage-1,2015-16,Florida International,G,32,10,661,41,106,.387,15,39,.385,26,67,.388,31,42,.738,16,87,103,81,22,1,53,68,139,3.5
6870,Carter Sanderson\carter-sanderson-1,2013-14,Lipscomb,G,26,0,360,45,121,.372,25,59,.424,20,62,.323,29,50,.580,5,28,33,21,12,0,26,21,139,2.6
6871,Tony Wills\tony-willis-1,2014-15,Illinois State,G,32,16,606,45,97,.464,37,69,.536,8,28,.286,41,53,.774,24,45,69,29,19,5,27,56,139,3.4
6872,Jalen Harris\jalen-harris-13,2016-17,New Mexico,G,31,18,639,47,107,.439,40,80,.500,7,27,.259,38,51,.745,2,54,56,72,25,3,39,64,139,3.5
6873,Isaac Thornton\isaac-thornton-1,2016-17,San Jose State,G,30,17,582,43,111,.387,29,68,.426,14,43,.326,39,52,.750,13,58,71,61,38,11,33,80,139,4.1
6874,Tyler Smithpeters\tyler-smithpeters-1,2014-15,Southern Illinois,G,32,20,638,39,111,.351,14,43,.326,25,68,.368,36,51,.706,6,50,56,21,24,7,48,68,139,1.8
6875,Nate Engesser\nate-engesser-1,2013-14,Denver,G,29,1,382,51,105,.486,24,42,.571,27,63,.429,10,12,.833,10,16,26,29,7,0,14,26,139,3.4
6876,Antonio Woods\antonio-woods-1,2015-16,Pennsylvania,G,13,13,402,53,137,.387,40,84,.476,13,53,.245,20,38,.526,5,24,29,43,11,1,24,25,139,5.8
6877,Dexter McClanahan\dexter-mcclanahan-1,2015-16,Savannah State,G,32,0,486,41,97,.423,30,57,.526,11,40,.275,46,68,.676,12,26,38,31,20,5,26,48,139,3.0
6878,Sanjay Lumpkin\sanjay-lumpkin-1,2014-15,Northwestern,G,32,26,720,50,95,.526,37,60,.617,13,35,.371,26,38,.684,33,87,120,26,21,9,27,91,139,3.7
6879,Dujuanta Weaver\dujuanta-weaver-1,2017-18,Eastern Kentucky,G,21,16,565,45,130,.346,9,30,.300,36,100,.360,13,15,.867,11,40,51,52,22,2,35,49,139,4.3
6880,Tarin Smith\tarin-smith-1,2014-15,Nebraska,G,31,3,545,53,119,.445,43,89,.483,10,30,.333,23,38,.605,11,38,49,22,18,9,24,39,139,2.9
6881,Dylan Windler\dylan-windler-1,2015-16,Belmont,G,32,1,590,49,100,.490,38,54,.704,11,46,.239,30,44,.682,40,105,145,29,20,19,33,70,139,4.2
6882,Devon Thomas\devon-thomas-1,2016-17,Texas Tech,G,32,19,732,55,116,.474,48,90,.533,7,26,.269,22,33,.667,15,56,71,81,32,3,34,61,139,4.2
6883,William Jackson II\william-jacksonii-1,2016-17,Georgia,G,34,16,594,48,135,.356,22,59,.373,26,76,.342,17,24,.708,7,33,40,37,14,7,26,40,139,2.3
6884,Ronnie Rousseau III\ronnie-rousseauiii-1,2017-18,Missouri State,G,27,11,582,51,146,.349,30,76,.395,21,70,.300,16,30,.533,6,30,36,42,10,1,32,47,139,2.0
6885,Tevin King\tevin-king-1,2016-17,South Dakota State,G,32,16,719,46,100,.460,39,73,.534,7,27,.259,40,63,.635,33,96,129,57,36,8,37,76,139,4.5
6886,Robert Champion\robert-champion-1,2014-15,Holy Cross,G,29,0,400,51,109,.468,29,51,.569,22,58,.379,15,25,.600,18,34,52,11,17,4,24,49,139,3.0
6887,Nick Weiler-Babb\nick-weiler-babb-1,2016-17,Iowa State,G,35,0,576,51,113,.451,43,87,.494,8,26,.308,29,41,.707,27,82,109,55,27,5,23,36,139,4.3
6888,Gairges Daow\gairges-daow-1,2017-18,Northern Illinois,G,32,22,699,48,121,.397,32,72,.444,16,49,.327,27,36,.750,31,88,119,26,21,5,34,68,139,3.1
6889,Jamaal Calvin\jamaal-calvin-1,2015-16,Southeast Missouri State,G,21,13,559,40,130,.308,13,40,.325,27,90,.300,32,39,.821,15,54,69,49,18,1,29,39,139,4.6
6890,Jaleel Wheeler\jaleel-wheeler-1,2017-18,Tulsa,G,31,12,568,49,116,.422,47,101,.465,2,15,.133,38,61,.623,34,78,112,23,13,6,35,53,138,3.0
6891,Avery Johnson\avery-johnson-2,2013-14,UC-Davis,G,31,16,769,49,111,.441,31,60,.517,18,51,.353,22,35,.629,21,69,90,41,34,8,34,62,138,3.9
6892,Durrell McDonald\durrell-mcdonald-1,2014-15,DePaul,G,32,21,764,51,134,.381,30,65,.462,21,69,.304,15,21,.714,13,76,89,72,44,7,43,78,138,3.7
6893,Aaron Augustin\aaron-augustin-1,2017-18,Stephen F. Austin,G,34,27,794,43,107,.402,25,58,.431,18,49,.367,34,54,.630,8,60,68,111,52,3,54,75,138,4.2
6894,Race Parsons\race-parsons-1,2016-17,Southern Utah,G,19,12,415,41,100,.410,16,34,.471,25,66,.379,31,39,.795,10,52,62,21,9,2,24,44,138,4.6
6895,Denzel Keyes\denzel-keyes-1,2014-15,North Carolina A&T,G,27,4,532,48,117,.410,37,72,.514,11,45,.244,31,53,.585,52,53,105,19,17,0,27,37,138,4.0
6896,Antonio Robinson\antonio-robinson-1,2014-15,East Carolina,G,33,33,800,50,139,.360,39,111,.351,11,28,.393,27,42,.643,17,89,106,122,55,4,52,59,138,4.9
6897,Louis Bell\louis-bell-1,2013-14,Maryland-Eastern Shore,G,29,6,535,47,157,.299,19,48,.396,28,109,.257,16,18,.889,11,33,44,37,13,3,19,61,138,2.1
6898,Carlton Hurst\carlton-hurst-1,2017-18,South Dakota,G,22,18,495,49,80,.613,46,70,.657,3,10,.300,37,55,.673,32,61,93,18,17,7,23,34,138,6.0
6899,Julian Batts\julian-batts-1,2016-17,Long Island University,G,32,17,748,44,123,.358,20,63,.317,24,60,.400,26,33,.788,9,59,68,54,26,0,36,73,138,2.8
6900,L.J. Rose\lj-rose-2,2016-17,Brigham Young,G,25,25,652,41,116,.353,25,60,.417,16,56,.286,40,47,.851,15,101,116,117,22,2,42,35,138,6.4
6901,Xavier Richards\xavier-richards-1,2015-16,Tennessee State,G,30,11,464,57,88,.648,56,85,.659,1,3,.333,23,43,.535,28,63,91,20,15,14,24,57,138,4.1
6902,Chuck Champion\chuck-champion-1,2016-17,Loyola (MD),G,29,12,571,46,146,.315,30,87,.345,16,59,.271,30,41,.732,15,31,46,28,27,3,38,42,138,2.2
6903,Jeremiah Davis\jeremiah-davis-1,2015-16,Ball State,G,22,2,388,44,105,.419,35,69,.507,9,36,.250,41,53,.774,1,60,61,55,11,10,47,35,138,4.2
6904,Nnamdi Enechionyia\nnamdi-enechionyia-1,2014-15,Samford,G,32,12,461,47,132,.356,17,42,.405,30,90,.333,14,23,.609,22,36,58,21,17,13,19,48,138,2.8
6905,Deckie Johnson\deckie-johnson-1,2016-17,North Texas,G,17,10,358,40,123,.325,24,57,.421,16,66,.242,42,49,.857,12,29,41,26,10,3,21,41,138,4.4
6906,Greg Malinowski\greg-malinowski-1,2014-15,William & Mary,G,33,4,544,48,110,.436,19,48,.396,29,62,.468,13,19,.684,23,47,70,21,12,4,37,48,138,2.5
6907,Jarryn Skeete\jarryn-skeete-1,2013-14,Buffalo,G,25,11,557,41,136,.301,11,39,.282,30,97,.309,26,30,.867,14,67,81,42,9,4,32,42,138,3.2
6908,Chris Adams\chris-adams-4,2014-15,San Francisco,G,32,2,589,48,133,.361,10,19,.526,38,114,.333,4,4,1.000,1,44,45,28,7,1,16,41,138,2.3
6909,Tarik Phillip\tarik-phillip-1,2014-15,West Virginia,G,34,0,439,45,96,.469,39,68,.574,6,28,.214,42,61,.689,21,30,51,28,38,2,33,49,138,3.3
6910,Mareik Isom\mareik-isom-1,2013-14,Little Rock,G,30,1,375,44,125,.352,27,60,.450,17,65,.262,33,51,.647,19,48,67,6,10,6,9,62,138,2.4
6911,Josh Oglesby\josh-oglesby-1,2013-14,Iowa,G,21,1,409,48,110,.436,17,33,.515,31,77,.403,11,15,.733,10,21,31,27,10,1,10,35,138,4.6
6912,Nick Rogers\nick-rogers-2,2017-18,IUPUI,G,27,25,635,40,120,.333,23,71,.324,17,49,.347,40,56,.714,8,35,43,81,12,1,56,54,137,2.6
6913,Keith Belfield\keith-belfield-1,2013-14,Furman,G,25,7,478,43,119,.361,20,58,.345,23,61,.377,28,38,.737,21,42,63,18,10,2,26,56,137,2.8
6914,Trey Touchet\trey-touchet-1,2016-17,Texas-El Paso,G,32,2,569,40,98,.408,17,32,.531,23,66,.348,34,38,.895,9,49,58,38,15,0,24,36,137,3.3
6915,Craig Ponder\craig-ponder-1,2013-14,North Carolina-Wilmington,G,31,2,422,48,137,.350,36,99,.364,12,38,.316,29,53,.547,15,39,54,28,9,3,24,39,137,2.1
6916,Leo Svete\leo-svete-1,2014-15,IUPUI,G,31,4,435,44,148,.297,14,36,.389,30,112,.268,19,27,.704,2,25,27,9,7,1,23,36,137,1.1
6917,Bryant Rucker\bryant-rucker-1,2014-15,Denver,G,29,8,532,49,106,.462,32,57,.561,17,49,.347,22,32,.688,5,39,44,39,12,0,32,59,137,2.7
6918,Ridge Shipley\ridge-shipley-1,2013-14,Cal Poly,G,34,3,511,39,112,.348,13,39,.333,26,73,.356,33,40,.825,6,16,22,60,8,0,23,45,137,2.6
6919,Christian Carlyle\christian-carlyle-1,2017-18,Florida Gulf Coast,G,27,5,506,47,109,.431,38,90,.422,9,19,.474,34,41,.829,26,37,63,31,22,4,31,65,137,3.5
6920,Branford Jones\branford-jones--1,2015-16,Cal State Long Beach,G,34,6,567,49,144,.340,35,90,.389,14,54,.259,25,36,.694,24,63,87,50,24,0,36,49,137,2.7
6921,Will Bond\will-bond-2,2013-14,Sam Houston State,G,35,0,494,43,106,.406,9,16,.563,34,90,.378,17,17,1.000,5,36,41,26,7,4,13,51,137,2.5
6922,Tanner Krebs\tanner-krebs-1,2016-17,Saint Mary's (CA),G,32,0,411,43,113,.381,11,25,.440,32,88,.364,19,22,.864,6,43,49,8,7,0,13,34,137,2.4
6923,Khalid Nwandu\khalid-nwandu-1,2014-15,Mount St. Mary's,G,29,13,571,52,118,.441,51,114,.447,1,4,.250,32,68,.471,29,52,81,61,22,0,54,52,137,3.0
6924,Nathan Hawkins\nathan-hawkins-2,2016-17,Texas-Arlington,G,36,0,516,49,125,.392,31,60,.517,18,65,.277,21,36,.583,11,64,75,33,16,3,21,50,137,2.5
6925,Austin Quick\austin-quick-1,2014-15,UC-Riverside,G,30,2,551,48,124,.387,33,69,.478,15,55,.273,26,47,.553,17,52,69,67,27,3,40,53,137,3.4
6926,Cam Ward\cam-ward-1,2016-17,Vermont,G,35,0,517,44,125,.352,22,56,.393,22,69,.319,27,43,.628,1,39,40,60,13,0,31,40,137,2.3
6927,Corey Schaefer\corey-schaefer-1,2014-15,Lehigh,G,29,29,715,47,115,.409,29,66,.439,18,49,.367,25,31,.806,6,84,90,42,8,1,26,32,137,3.5
6928,Kevin McClain\kevin-mcclain-1,2016-17,Belmont,G,30,0,346,44,121,.364,27,58,.466,17,63,.270,32,45,.711,8,31,39,32,14,4,34,43,137,2.3
6929,Quan Jones\quan-jones-1,2015-16,Lamar,G,29,13,408,38,106,.358,22,60,.367,16,46,.348,45,59,.763,6,22,28,32,17,2,34,53,137,2.4
6930,Charles Hankerson\charles-hankerson-jr-1,2013-14,Wyoming,G,27,1,463,42,98,.429,28,63,.444,14,35,.400,39,60,.650,6,29,35,35,8,1,30,48,137,2.7
6931,Yettra Specks\yettra-specks-1,2014-15,Jackson State,G,31,19,707,45,161,.280,22,73,.301,23,88,.261,24,38,.632,12,49,61,55,29,2,60,72,137,1.3
6932,Evann Hall\evann-hall-1,2014-15,Idaho State,G,30,0,442,50,141,.355,44,118,.373,6,23,.261,30,61,.492,7,58,65,14,22,1,30,43,136,1.8
6933,Kristinn Palsson\kristinn-palsson-1,2016-17,Marist,G,31,16,751,42,128,.328,10,20,.500,32,108,.296,20,26,.769,7,75,82,43,13,5,36,57,136,2.5
6934,Jordan Gathers\jordan-gathers-1,2015-16,Butler,G,33,4,433,48,119,.403,18,43,.419,30,76,.395,10,18,.556,8,33,41,25,14,1,20,55,136,2.3
6935,Tyler Stewart\tyler-stewart-1,2017-18,Binghamton,G,24,8,349,51,120,.425,38,81,.469,13,39,.333,21,32,.656,14,37,51,14,12,8,25,40,136,3.1
6936,Gary Stewart\gary-stewart-2,2013-14,Northwestern State,G,25,6,393,46,104,.442,22,48,.458,24,56,.429,20,25,.800,16,38,54,22,5,1,20,24,136,3.7
6937,D.J. Ursery\dj-ursery-1,2015-16,Pacific,G,28,0,423,45,120,.375,41,92,.446,4,28,.143,42,57,.737,17,50,67,39,17,2,39,55,136,2.7
6938,Denzel Keyes\denzel-keyes-1,2015-16,North Carolina A&T,G,17,14,552,51,113,.451,45,86,.523,6,27,.222,28,47,.596,62,66,128,18,15,5,23,45,136,7.2
6939,Jaycee Hillsman\jaycee-hillsman-1,2015-16,San Jose State,G,30,21,529,39,126,.310,19,50,.380,20,76,.263,38,49,.776,14,23,37,44,9,5,35,68,136,1.9
6940,Jamall Robinson\jamall-robinson-1,2014-15,Hofstra,G,34,6,576,46,151,.305,25,81,.309,21,70,.300,23,36,.639,33,43,76,26,13,6,17,32,136,2.5
6941,Rich Williams\rich-williams-1,2013-14,Manhattan,G,31,7,370,51,98,.520,39,67,.582,12,31,.387,22,34,.647,26,42,68,14,10,6,37,56,136,2.5
6942,Jamaal Calvin\jamaal-calvin-1,2013-14,Southeast Missouri State,G,29,2,414,44,120,.367,16,39,.410,28,81,.346,20,26,.769,9,30,39,42,25,0,25,34,136,3.4
6943,Aaron Wright\aaron-wright-1,2015-16,UC-Irvine,G,35,4,710,38,104,.365,23,59,.390,15,45,.333,45,68,.662,16,90,106,70,31,2,45,92,136,3.1
6944,Scottie Lindsey\scottie-lindsey-1,2014-15,Northwestern,G,31,10,467,51,126,.405,28,61,.459,23,65,.354,11,17,.647,13,57,70,17,10,15,20,60,136,2.6
6945,Collin Gillespie\collin-gillespie-1,2017-18,Villanova,G,32,1,460,42,93,.452,14,22,.636,28,71,.394,24,30,.800,4,38,42,34,19,2,14,46,136,3.5
6946,Moe McDonald\moe-mcdonald-1,2016-17,Texas-Rio Grande Valley,G,32,5,493,42,106,.396,26,44,.591,16,62,.258,36,51,.706,15,28,43,37,12,1,38,49,136,2.3
6947,Elijah Lee\elijah-lee-1,2016-17,Pepperdine,G,31,9,653,41,114,.360,26,75,.347,15,39,.385,39,52,.750,9,55,64,86,31,3,63,49,136,3.3
6948,Jamal Williams\jamal-williams-3,2016-17,Sam Houston State,G,34,2,534,48,113,.425,45,102,.441,3,11,.273,37,57,.649,30,65,95,39,14,9,37,38,136,3.1
6949,Adonis Filer\adonis-filer-1,2013-14,Clemson,G,35,4,514,45,135,.333,26,71,.366,19,64,.297,27,34,.794,13,34,47,42,23,1,44,48,136,1.9
6950,Ben Hazel\ben-hazel-1,2014-15,Princeton,G,24,6,429,38,96,.396,17,33,.515,21,63,.333,39,50,.780,4,30,34,23,14,2,22,24,136,3.8
6951,Wes Clark\wes-clark-2,2013-14,Missouri,G,33,0,673,42,117,.359,21,60,.350,21,57,.368,31,49,.633,12,60,72,70,26,2,53,88,136,2.4
6952,Ty Toney\ty-toney-1,2013-14,Appalachian State,G,22,6,426,43,110,.391,39,88,.443,4,22,.182,46,64,.719,8,36,44,37,16,3,29,39,136,3.9
6953,Sid Tomes\sid-tomes-1,2017-18,Air Force,G,29,11,507,47,121,.388,16,32,.500,31,89,.348,11,16,.688,8,38,46,35,21,4,22,36,136,3.3
6954,Jordan Burgess\jordan-burgess-1,2015-16,Virginia Commonwealth,G,28,14,612,48,143,.336,28,62,.452,20,81,.247,20,39,.513,28,90,118,37,15,12,26,55,136,3.4
6955,Marlon Hunter\marlon-hunter-1,2015-16,Western Kentucky,G,32,5,390,53,122,.434,50,111,.450,3,11,.273,27,40,.675,27,31,58,13,24,2,17,37,136,3.0
6956,Ricky Nelson\ricky-nelson-1,2017-18,Weber State,G,31,0,600,40,91,.440,29,63,.460,11,28,.393,45,63,.714,8,28,36,62,17,0,23,55,136,3.6
6957,Michael Bolden\michael-bolden-1,2014-15,Cal Poly,G,29,18,669,45,136,.331,15,39,.385,30,97,.309,16,22,.727,20,45,65,19,23,7,9,36,136,3.5
6958,Martavious Newby\martavious-newby-1,2014-15,Mississippi,G,34,26,693,44,113,.389,31,65,.477,13,48,.271,35,45,.778,51,132,183,49,41,8,40,75,136,4.6
6959,Darius Graham\darius-graham-1,2014-15,UC-Davis,G,32,31,857,42,113,.372,26,72,.361,16,41,.390,36,53,.679,12,41,53,102,16,0,74,58,136,2.4
6960,Isaac Cohen\isaac-cohen-1,2014-15,Columbia,G,28,24,799,60,97,.619,56,86,.651,4,11,.364,11,28,.393,36,116,152,111,18,8,43,62,135,6.4
6961,Lucian Brownlee\lucian-brownlee-1,2016-17,Coppin State,G,31,0,337,45,103,.437,13,28,.464,32,75,.427,13,18,.722,6,21,27,11,8,0,25,21,135,2.3
6962,Everett Osborne\everett-osborne-1,2015-16,Texas-Rio Grande Valley,G,29,7,486,48,138,.348,33,73,.452,15,65,.231,24,33,.727,12,63,75,26,17,4,32,28,135,2.6
6963,Parrish Hewitt\parrish-hewitt-1,2017-18,Tennessee-Martin,G,29,4,389,51,113,.451,37,63,.587,14,50,.280,19,25,.760,9,42,51,23,10,6,14,29,135,3.4
6964,Patrick Ingram\patrick-ingram-1,2016-17,Idaho,G,33,1,471,48,112,.429,36,82,.439,12,30,.400,27,47,.574,31,60,91,30,19,5,26,58,135,3.1
6965,Ja'Quan Newton\jaquan-newton-1,2014-15,Miami (FL),G,34,3,459,45,111,.405,41,101,.406,4,10,.400,41,64,.641,8,35,43,47,8,4,39,34,135,2.2
6966,Andrew Jones\andrew-jones-3,2017-18,Texas,G,10,8,226,47,90,.522,28,49,.571,19,41,.463,22,30,.733,4,20,24,20,6,2,17,16,135,9.4
6967,Ghassan Nehme\ghasson-nehme-1,2015-16,Fairleigh Dickinson,G,33,0,361,46,115,.400,16,43,.372,30,72,.417,13,16,.813,5,48,53,21,13,2,23,62,135,2.1
6968,Donte Watson\donte-watson-1,2016-17,North Carolina A&T,G,20,8,397,53,104,.510,36,55,.655,17,49,.347,12,14,.857,6,60,66,27,11,1,27,24,135,4.9
6969,Ryan Bernstein\ryan-bernstein-1,2016-17,Maine,G,32,29,855,50,150,.333,29,72,.403,21,78,.269,14,26,.538,22,81,103,93,25,1,33,50,135,3.8
6970,Tyler Smithpeters\tyler-smithpeters-1,2013-14,Southern Illinois,G,28,12,532,36,91,.396,10,27,.370,26,64,.406,37,54,.685,9,28,37,25,14,5,23,54,135,3.0
6971,Jerry Jones\jerry-jones-2,2013-14,Duquesne,G,28,0,483,47,114,.412,28,56,.500,19,58,.328,22,34,.647,32,36,68,42,20,10,17,53,135,4.3
6972,Ryan Cline\ryan-cline-1,2015-16,Purdue,G,35,0,475,43,121,.355,1,12,.083,42,109,.385,7,13,.538,1,42,43,46,7,1,11,42,135,2.6
6973,Isaac Thornton\isaac-thornton-1,2014-15,San Jose State,G,29,24,805,45,156,.288,35,97,.361,10,59,.169,35,56,.625,12,85,97,63,36,22,67,86,135,2.2
6974,Steve Vasturia\steve-vasturia-1,2013-14,Notre Dame,G,27,12,623,41,117,.350,14,35,.400,27,82,.329,26,38,.684,15,54,69,32,17,3,20,35,135,3.7
6975,Ke'Ron Brown\keron-brown-1,2014-15,Hampton,G,30,19,659,48,147,.327,42,105,.400,6,42,.143,33,65,.508,21,64,85,43,46,8,43,77,135,2.7
6976,Anthony Roberson\anthony-roberson-2,2015-16,Texas State,G,29,11,620,50,94,.532,48,86,.558,2,8,.250,33,64,.516,63,83,146,19,19,17,22,77,135,4.7
6977,D.J. Peterson\dj-peterson-1,2013-14,La Salle,G,31,9,729,45,123,.366,23,45,.511,22,78,.282,23,34,.676,22,68,90,48,25,7,30,61,135,3.5
6978,D'Von Campbell\dvon-campbell-2,2013-14,Rutgers,G,25,4,434,45,117,.385,24,54,.444,21,63,.333,24,36,.667,8,22,30,37,9,1,22,32,135,3.2
6979,Mitch Baenziger\mitch-baenziger-1,2013-14,Oakland,G,33,3,525,43,111,.387,13,31,.419,30,80,.375,19,29,.655,12,30,42,18,14,2,17,66,135,2.2
6980,Jared Norsworthy\jared-norsworthy-1,2014-15,Howard,G,32,5,559,43,106,.406,32,70,.457,11,36,.306,38,65,.585,24,47,71,13,27,4,36,62,135,2.4
6981,Lance Tejada\lance-tejada-1,2015-16,East Carolina,G,31,1,463,35,120,.292,8,39,.205,27,81,.333,38,60,.633,3,28,31,38,16,1,30,50,135,1.9
6982,Kobe Magee\kobe-magee-1,2017-18,Texas-El Paso,G,30,16,581,50,113,.442,19,40,.475,31,73,.425,4,9,.444,12,48,60,52,9,0,33,22,135,3.3
6983,Dion Wade\dion-wade-1,2015-16,Miami (OH),G,33,17,580,41,137,.299,11,29,.379,30,108,.278,23,30,.767,23,98,121,24,34,13,17,66,135,3.5
6984,Dalique Mingo\dalique-mingo-1,2015-16,Howard,G,31,18,573,47,123,.382,42,91,.462,5,32,.156,36,49,.735,34,56,90,23,23,1,26,60,135,3.0
6985,Marcus Thomas\marcus-thomas-4,2017-18,Western Carolina,G,24,1,276,47,115,.409,35,79,.443,12,36,.333,28,39,.718,22,23,45,15,16,2,21,33,134,3.5
6986,Trey Lowe\trey-lowe-1,2015-16,Temple,G,28,5,342,51,128,.398,34,62,.548,17,66,.258,15,19,.789,15,29,44,16,13,1,11,16,134,3.2
6987,Jordan Johnson\jordan-johnson-2,2014-15,Tennessee Tech,G,28,6,443,46,118,.390,16,40,.400,30,78,.385,12,16,.750,7,27,34,30,7,2,20,26,134,2.9
6988,Renard Suggs\renard-suggs-1,2015-16,Washington State,G,25,0,314,48,125,.384,30,64,.469,18,61,.295,20,33,.606,8,39,47,24,6,4,24,25,134,2.8
6989,Knox Hellums\knox-hellums-1,2016-17,Pepperdine,G,30,8,496,42,118,.356,9,40,.225,33,78,.423,17,20,.850,5,29,34,9,6,3,24,42,134,1.8
6990,Terence Smith\terence-smith-1,2014-15,Mississippi,G,34,2,539,48,125,.384,24,58,.414,24,67,.358,14,19,.737,2,40,42,58,9,2,19,48,134,2.6
6991,David Knudsen\david-knudsen-1,2016-17,Marist,G,31,6,485,48,135,.356,27,59,.458,21,76,.276,17,28,.607,16,46,62,19,14,3,23,25,134,2.4
6992,Jordan Baker\jordan-baker-3,2014-15,Old Dominion,G,34,33,722,44,132,.333,10,29,.345,34,103,.330,12,22,.545,19,58,77,47,29,2,24,61,134,3.0
6993,Fred Gulley\fred-gulley-1,2013-14,Arkansas,G,34,32,623,47,120,.392,28,66,.424,19,54,.352,21,32,.656,19,41,60,65,26,2,16,67,134,3.5
6994,Rasham Suarez\rasham-suarez-1,2014-15,Southern Mississippi,G,18,18,550,45,115,.391,15,38,.395,30,77,.390,14,23,.609,5,53,58,65,15,1,45,39,134,4.9
6995,Chris Barton\chris-barton-1,2017-18,Niagara,G,27,16,445,40,101,.396,35,83,.422,5,18,.278,49,61,.803,14,29,43,23,7,0,32,49,134,2.4
6996,Juwan Parker\juwan-parker-1,2013-14,Georgia,G,33,3,577,38,130,.292,30,88,.341,8,42,.190,50,63,.794,19,80,99,38,19,4,25,43,134,2.9
6997,Austin Reaves\austin-reaves-1,2016-17,Wichita State,G,33,0,390,39,87,.448,11,32,.344,28,55,.509,28,37,.757,10,49,59,37,12,10,18,26,134,3.7
6998,Shaun Johnson\shaun-johnson-1,2014-15,McNeese State,G,31,1,395,43,146,.295,7,24,.292,36,122,.295,12,17,.706,11,19,30,23,11,3,11,26,134,2.2
6999,Aaron Jackson\aaron-jackson-2,2016-17,Akron,G,32,9,423,44,101,.436,17,33,.515,27,68,.397,19,28,.679,19,40,59,18,13,4,19,44,134,3.0
7000,Dave Sobolewski\dave-sobolewski-1,2013-14,Northwestern,G,27,21,579,34,130,.262,19,48,.396,15,82,.183,51,67,.761,5,51,56,64,18,5,43,59,134,2.5
7001,Lamont Berzat\lamont-berzat-1,2017-18,New Orleans,G,31,11,506,43,106,.406,21,44,.477,22,62,.355,26,39,.667,4,30,34,56,34,0,34,49,134,3.3
7002,Anthony White\anthony-white-2,2013-14,St. Francis (NY),G,23,22,530,51,129,.395,43,91,.473,8,38,.211,24,28,.857,16,70,86,41,14,12,31,55,134,4.0
7003,Lance Tejada\lance-tejada-1,2014-15,East Carolina,G,33,0,458,42,138,.304,22,67,.328,20,71,.282,30,55,.545,4,39,43,55,15,1,33,38,134,2.0
7004,Joe Bramanti\joe-bramanti-1,2015-16,New Hampshire,G,30,27,893,43,124,.347,29,76,.382,14,48,.292,34,58,.586,21,87,108,78,22,3,52,94,134,2.8
7005,Phil Winston\phil-winston-1,2016-17,Quinnipiac,G,31,19,488,39,99,.394,32,73,.438,7,26,.269,49,75,.653,14,38,52,96,10,1,47,47,134,3.3
7006,Troy Whiteside\troy-whiteside-1,2015-16,Cornell,G,28,8,526,53,144,.368,37,91,.407,16,53,.302,12,23,.522,25,35,60,27,21,0,30,57,134,2.3
7007,Curtis Oakley\curtis-oakley-1,2015-16,Bryant,G,28,5,466,48,146,.329,29,69,.420,19,77,.247,19,32,.594,11,60,71,23,6,1,29,49,134,1.6
7008,JoJo Fallas\jojo-fallas-1,2015-16,Cornell,G,27,2,442,47,123,.382,14,45,.311,33,78,.423,7,11,.636,1,37,38,26,18,1,14,45,134,3.0
7009,Brendan Barry\brendan-barry-1,2016-17,Dartmouth,G,24,0,437,41,89,.461,16,34,.471,25,55,.455,27,34,.794,2,33,35,42,14,3,17,36,134,4.6
7010,Todd Hughes\todd-hughes-1,2014-15,Delaware State,G,25,5,380,54,130,.415,45,103,.437,9,27,.333,17,30,.567,21,35,56,9,10,11,23,28,134,3.0
7011,Evan Wessel\evan-wessel-1,2014-15,Wichita State,G,32,30,756,47,120,.392,16,34,.471,31,86,.360,9,17,.529,48,69,117,22,25,5,14,44,134,4.1
7012,Osa Izevbuwa\osa-izevbuwa-1,2014-15,NJIT,G,32,0,430,48,119,.403,23,57,.404,25,62,.403,13,23,.565,11,33,44,19,12,1,27,35,134,2.1
7013,James Towns\james-towns-1,2016-17,Niagara,G,33,3,430,43,115,.374,27,67,.403,16,48,.333,31,39,.795,4,36,40,34,19,0,31,38,133,2.3
7014,Quan Jones\quan-jones-1,2014-15,Lamar,G,30,16,515,36,98,.367,23,64,.359,13,34,.382,48,69,.696,11,39,50,45,20,1,50,38,133,2.6
7015,Shadell Millinghaus\shadell-millinghaus-1,2014-15,Southern Mississippi,G,18,6,300,41,91,.451,23,52,.442,18,39,.462,33,50,.660,17,26,43,16,13,2,20,31,133,5.1
7016,Rafael Farley\rafael-farley-1,2013-14,Abilene Christian,G,27,11,421,44,111,.396,11,35,.314,33,76,.434,12,18,.667,8,27,35,12,4,2,18,33,133,2.5
7017,Amadi Udenyi\amadi-udenyi-1,2014-15,Pepperdine,G,22,9,572,41,123,.333,17,62,.274,24,61,.393,27,41,.659,8,38,46,97,17,1,41,38,133,4.7
7018,Josh Heath\josh-heath-2,2014-15,Georgia Tech,G,31,4,605,47,114,.412,44,101,.436,3,13,.231,36,53,.679,9,35,44,83,20,3,40,37,133,3.5
7019,Chris Barton\chris-barton-1,2015-16,Niagara,G,32,5,557,41,116,.353,28,61,.459,13,55,.236,38,48,.792,12,41,53,25,5,0,29,59,133,1.7
7020,Jake Allsmiller\jake-allsmiller-1,2014-15,Georgia Southern,G,31,19,656,44,120,.367,4,9,.444,40,111,.360,5,8,.625,6,49,55,27,13,3,20,61,133,2.4
7021,Kameron Mitchell\kameron-mitchell-1,2014-15,Stony Brook,G,35,10,739,45,117,.385,18,48,.375,27,69,.391,16,26,.615,11,36,47,34,15,4,26,89,133,1.8
7022,JJ Cratit\jj-cratit-1,2015-16,Central Connecticut State,G,18,5,346,44,139,.317,25,84,.298,19,55,.345,26,42,.619,5,21,26,9,7,6,22,30,133,2.2
7023,Markese McGuire\markese-mcguire-1,2014-15,Illinois-Chicago,G,32,13,565,40,129,.310,19,69,.275,21,60,.350,32,45,.711,15,53,68,26,15,4,24,32,133,2.5
7024,Kai Healy\kai-healy-1,2016-17,Santa Clara,G,32,6,549,39,97,.402,20,48,.417,19,49,.388,36,46,.783,10,69,79,34,13,1,17,43,133,3.4
7025,Pancake Thomas\cleveland-thomas-1,2013-14,New Mexico,G,34,10,516,39,115,.339,18,56,.321,21,59,.356,34,40,.850,28,53,81,25,8,1,18,31,133,2.9
7026,Matthew Mondesir\matthew-mondesir-1,2017-18,Central Arkansas,G,35,8,501,49,121,.405,40,96,.417,9,25,.360,26,46,.565,24,41,65,36,15,2,21,39,133,2.7
7027,Armani Chaney\armani-chaney-1,2016-17,Tennessee State,G,29,7,529,43,125,.344,30,79,.380,13,46,.283,34,40,.850,5,35,40,48,20,2,40,42,133,2.5
7028,Joe Retic\joe-retic-1,2014-15,Liberty,G,20,15,560,40,115,.348,31,84,.369,9,31,.290,44,55,.800,10,40,50,98,38,3,73,51,133,4.9
7029,Jordan Roberts\jordan-roberts-3,2017-18,Cal State Long Beach,G,31,14,529,54,110,.491,53,106,.500,1,4,.250,24,41,.585,34,51,85,32,21,6,33,52,133,3.3
7030,Daquan Brickhouse\daquan-brickhouse-1,2014-15,Coppin State,G,18,5,414,41,112,.366,22,60,.367,19,52,.365,32,35,.914,14,29,43,39,21,0,21,28,133,5.8
7031,Avery Patterson\avery-patterson-2,2016-17,Alcorn State,G,30,23,511,47,122,.385,28,55,.509,19,67,.284,20,27,.741,16,35,51,48,24,0,46,52,133,2.5
7032,Nick Billingsley\nick-billingsley-1,2016-17,Texas-San Antonio,G,12,0,181,42,108,.389,18,45,.400,24,63,.381,25,30,.833,7,29,36,4,5,7,20,24,133,5.7
7033,Amedeo Della Valle\amedeo-della-valle-1,2013-14,Ohio State,G,33,0,393,42,121,.347,18,47,.383,24,74,.324,25,38,.658,19,39,58,6,7,8,21,30,133,2.1
7034,Cody John\cody-john-1,2015-16,Weber State,G,30,0,509,49,131,.374,40,74,.541,9,57,.158,26,43,.605,3,45,48,46,9,5,31,39,133,2.3
7035,Javien Williams\javien-williams-1,2016-17,Alabama-Birmingham,G,33,3,505,42,112,.375,39,88,.443,3,24,.125,46,68,.676,26,38,64,36,11,7,26,26,133,2.9
7036,Matt Fox\matt-fox-1,2016-17,Bowling Green State,G,32,0,506,43,110,.391,10,22,.455,33,88,.375,14,16,.875,11,44,55,17,14,1,12,42,133,2.8
7037,Thomas Rivera\thomas-rivera-1,2015-16,Maryland-Eastern Shore,G,29,11,636,45,127,.354,34,80,.425,11,47,.234,32,48,.667,13,41,54,99,29,2,70,64,133,2.8
7038,Denzell Watts\denzell-watts-1,2015-16,Alabama-Birmingham,G,33,2,497,45,113,.398,20,46,.435,25,67,.373,18,25,.720,2,49,51,55,16,1,37,36,133,2.7
7039,Rick Kreklow\ricky-kreklow-1,2013-14,University of California,G,24,16,568,41,115,.357,14,34,.412,27,81,.333,23,32,.719,16,46,62,43,17,0,23,55,132,3.8
7040,J.J. Thompson\jj-thompson-1,2014-15,Southeast Missouri State,G,28,20,600,45,114,.395,30,81,.370,15,33,.455,27,39,.692,12,35,47,78,16,1,47,50,132,3.2
7041,Daouda Berete\daouda-berete-1,2013-14,Central Arkansas,G,29,18,580,38,116,.328,30,91,.330,8,25,.320,48,66,.727,17,83,100,37,36,6,47,89,132,2.7
7042,Xavian Rimmer\xavian-rimmer-2,2014-15,Louisiana,G,35,10,492,39,117,.333,20,47,.426,19,70,.271,35,46,.761,8,37,45,24,10,0,34,36,132,1.6
7043,Ashton Spears\ashton-spears-1,2017-18,Jacksonville State,G,34,5,464,34,93,.366,19,44,.432,15,49,.306,49,62,.790,13,50,63,33,15,1,23,40,132,2.9
7044,Kevin Douglas\kevin-douglas-1,2014-15,St. Francis (NY),G,26,11,399,46,109,.422,32,63,.508,14,46,.304,26,39,.667,30,57,87,13,11,11,25,55,132,3.4
7045,Jalyn Patterson\jalyn-patterson-1,2015-16,Louisiana State,G,28,15,617,46,122,.377,16,32,.500,30,90,.333,10,17,.588,10,28,38,44,34,1,21,39,132,3.8
7046,Taylor Johnson\taylor-johnson-2,2016-17,Dartmouth,G,25,5,354,46,106,.434,26,54,.481,20,52,.385,20,25,.800,11,32,43,31,9,1,51,39,132,2.3
7047,Wyatt Lohaus\wyatt-lohaus-1,2014-15,Northern Iowa,G,35,0,468,46,110,.418,29,74,.392,17,36,.472,23,27,.852,2,39,41,23,20,0,19,33,132,2.5
7048,Chrishawn Hopkins\chrishawn-hopkins-1,2013-14,Wright State,G,25,2,508,39,91,.429,24,57,.421,15,34,.441,39,53,.736,6,42,48,52,14,0,46,41,132,3.3
7049,Bo Zeigler\bo-zeigler-1,2016-17,South Florida,G,28,15,573,60,110,.545,60,106,.566,0,4,.000,12,31,.387,34,65,99,40,21,19,46,76,132,3.6
7050,Antwoine Anderson\antwoine-anderson-1,2014-15,Fordham,G,29,11,530,37,101,.366,28,73,.384,9,28,.321,49,74,.662,5,27,32,70,22,5,61,60,132,2.3
7051,Drake Green\drake-green-1,2017-18,Abilene Christian,G,32,8,524,47,111,.423,15,25,.600,32,86,.372,6,7,.857,3,35,38,29,15,2,25,61,132,2.3
7052,Elliott Pitts\elliott-pitts-1,2014-15,Arizona,G,38,1,565,43,109,.394,16,35,.457,27,74,.365,19,24,.792,15,24,39,17,12,2,12,57,132,2.1
7053,Nelson Kaputo\nelson-kaputo-1,2015-16,St. Bonaventure,G,30,1,502,44,131,.336,9,33,.273,35,98,.357,9,11,.818,3,47,50,55,29,0,31,45,132,3.1
7054,Scoochie Smith\scoochie-smith-1,2013-14,Dayton,G,37,1,640,49,139,.353,32,77,.416,17,62,.274,17,30,.567,4,43,47,73,27,5,41,50,132,2.3
7055,K.J. Rose\kj-rose-1,2014-15,Fairfield,G,28,14,648,42,134,.313,32,100,.320,10,34,.294,38,65,.585,15,59,74,76,24,2,55,54,132,2.7
7056,Jacob Kurtz\jacob-kurtz-1,2014-15,Florida,G,33,8,610,51,85,.600,51,83,.614,0,2,.000,30,43,.698,51,66,117,32,23,1,36,47,132,4.1
7057,Dagur Jonsson\dagur-jonsson-1,2015-16,St. Francis (NY),G,32,1,542,42,149,.282,18,56,.321,24,93,.258,24,34,.706,8,32,40,43,7,0,38,31,132,1.3
7058,Amin Torres\amin-torres-1,2013-14,Nicholls State,G,28,1,303,45,120,.375,28,60,.467,17,60,.283,25,35,.714,4,18,22,25,12,1,30,38,132,2.0
7059,Joel Davis\joel-davis-1,2017-18,Cornell,G,28,14,494,46,122,.377,38,88,.432,8,34,.235,32,49,.653,19,50,69,30,24,10,32,46,132,3.1
7060,Shelton Mitchell\shelton-mitchell-1,2014-15,Vanderbilt,G,31,11,619,45,123,.366,38,92,.413,7,31,.226,35,49,.714,5,53,58,103,4,3,60,34,132,2.7
7061,Frank Bartley\frank-bartley-1,2013-14,Brigham Young,G,34,0,369,44,119,.370,32,83,.386,12,36,.333,32,62,.516,21,51,72,25,13,6,15,26,132,2.8
7062,Shawn Anderson\shawn-anderson-1,2014-15,Navy,G,31,6,499,45,107,.421,45,94,.479,0,13,.000,42,63,.667,33,65,98,35,13,2,25,39,132,3.5
7063,Izayah Mauriohooho-Le'afa\izayah-mauriohooho-leafa-1,2016-17,Sacramento State,G,29,28,728,46,125,.368,18,44,.409,28,81,.346,12,14,.857,8,56,64,57,20,1,31,43,132,3.3
7064,Jamall Robinson\jamall-robinson-1,2017-18,Long Island University,G,35,2,608,49,139,.353,18,38,.474,31,101,.307,3,6,.500,18,49,67,19,19,6,13,52,132,2.4
7065,Justin Thomas\justin-thomas-4,2016-17,Northern Illinois,G,32,16,543,48,101,.475,47,84,.560,1,17,.059,34,59,.576,4,52,56,37,34,2,27,45,131,3.3
7066,Tre' Ivory\tre-ivory-1,2017-18,Austin Peay,G,34,34,897,44,169,.260,37,128,.289,7,41,.171,36,67,.537,17,53,70,134,39,0,62,82,131,2.5
7067,Stef Smith\stef-smith-1,2017-18,Vermont,G,34,1,374,43,113,.381,19,48,.396,24,65,.369,21,32,.656,5,53,58,34,13,0,29,34,131,2.3
7068,Michael Messer\michael-messer-1,2013-14,Southern Illinois-Edwardsville,G,18,5,357,44,98,.449,34,67,.507,10,31,.323,33,47,.702,11,41,52,23,12,2,23,40,131,4.7
7069,Austin Keel\austin-keel-1,2014-15,Central Michigan,G,30,0,254,46,90,.511,33,46,.717,13,44,.295,26,36,.722,8,32,40,15,10,1,17,13,131,3.2
7070,Jamal Norman\jamal-norman-1,2014-15,Savannah State,G,31,15,557,49,135,.363,41,104,.394,8,31,.258,25,53,.472,25,61,86,26,28,4,45,57,131,2.0
7071,Julion Pearre\julion-pearre-1,2016-17,Utah State,G,32,0,502,49,113,.434,30,51,.588,19,62,.306,14,21,.667,3,56,59,27,10,1,28,47,131,2.2
7072,Ahsante Shivers\ahsante-shivers-1,2016-17,Siena,G,33,15,599,42,92,.457,34,68,.500,8,24,.333,39,60,.650,19,63,82,33,15,4,28,61,131,2.9
7073,Lindy Waters\lindy-waters-1,2016-17,Oklahoma State,G,23,12,367,46,93,.495,27,50,.540,19,43,.442,20,28,.714,19,23,42,19,14,1,24,38,131,3.9
7074,Khalil Alford\khalil-alford-1,2014-15,Rider,G,33,0,339,52,120,.433,46,95,.484,6,25,.240,21,29,.724,31,34,65,12,7,3,21,35,131,2.4
7075,Rashad Ray\rashad-ray-1,2015-16,Tulsa,G,32,7,563,45,131,.344,21,53,.396,24,78,.308,17,27,.630,9,37,46,61,31,0,21,51,131,3.2
7076,Jaylen Shead\jaylen-snead-1,2015-16,Cal Poly,G,30,8,585,45,128,.352,28,71,.394,17,57,.298,24,32,.750,27,57,84,84,17,0,38,49,131,3.7
7077,Gino Littles\gino-littles-1,2015-16,Texas-San Antonio,G,17,15,503,47,93,.505,40,78,.513,7,15,.467,30,47,.638,7,44,51,53,20,0,35,26,131,6.3
7078,Dustin Thomas\dustin-thomas-1,2017-18,Arkansas,G,26,17,500,48,94,.511,47,91,.516,1,3,.333,34,51,.667,31,76,107,26,20,3,29,69,131,4.1
7079,Jagan Mosely\jagan-mosely-1,2016-17,Georgetown,G,31,20,621,36,97,.371,27,60,.450,9,37,.243,50,65,.769,9,60,69,79,23,5,42,67,131,3.5
7080,Anthony Durham\anthony-durham-2,2016-17,Rider,G,32,0,411,49,121,.405,36,88,.409,13,33,.394,20,28,.714,16,44,60,27,9,0,23,43,131,2.3
7081,Micah Bradford\micah-bradford-1,2016-17,Valparaiso,G,33,12,461,46,149,.309,21,64,.328,25,85,.294,14,25,.560,5,42,47,26,12,0,38,48,131,0.9
7082,Rob Shaw\rob-shaw-1,2017-18,Chicago State,G,30,11,530,57,162,.352,57,148,.385,0,14,.000,17,23,.739,14,33,47,74,28,0,51,33,131,2.4
7083,Karim Mawuenyega\karim-mawuenyega-1,2013-14,South Carolina Upstate,G,31,8,422,48,124,.387,23,53,.434,25,71,.352,10,18,.556,4,28,32,35,17,1,27,40,131,2.3
7084,Iverson Fleming\iverson-fleming-1,2015-16,Long Island University,G,27,8,539,48,132,.364,33,80,.413,15,52,.288,20,31,.645,9,31,40,33,22,3,25,38,131,2.8
7085,Richie Lewis\richie-lewis-1,2014-15,Nicholls State,G,26,18,671,44,119,.370,40,99,.404,4,20,.200,39,57,.684,13,44,57,68,45,4,76,70,131,2.8
7086,Zach McCormick\zach-mccormick-1,2014-15,Miami (OH),G,31,4,603,53,145,.366,37,81,.457,16,64,.250,9,19,.474,13,27,40,30,27,3,18,59,131,2.3
7087,Josh James\josh-james-2,2015-16,Monmouth,G,36,23,901,46,135,.341,34,95,.358,12,40,.300,27,44,.614,31,80,111,54,23,3,29,67,131,2.8
7088,Roddy Peters\roddy-peters-1,2013-14,Maryland,G,32,10,484,50,123,.407,49,114,.430,1,9,.111,29,45,.644,11,30,41,67,19,2,56,33,130,2.3
7089,Frankie Ferrari\frankie-ferrari-1,2016-17,San Francisco,G,25,4,411,41,110,.373,13,39,.333,28,71,.394,20,27,.741,11,46,57,48,21,0,24,47,130,4.0
7090,Cameron Reynolds\cameron-reynolds-1,2013-14,Tulane,G,34,1,603,40,153,.261,15,57,.263,25,96,.260,25,46,.543,11,59,70,16,10,6,25,51,130,1.1
7091,Kelvin Amayo\kelvin-amayo-1,2016-17,Loyola Marymount,G,28,2,504,50,110,.455,42,86,.488,8,24,.333,22,55,.400,19,91,110,52,31,8,35,40,130,4.4
7092,Chris Chiozza\chris-chiozza-1,2014-15,Florida,G,33,11,752,44,113,.389,23,48,.479,21,65,.323,21,44,.477,13,59,72,72,39,1,41,54,130,3.4
7093,Makai Ashton-Langford\makai-ashton-langford-1,2017-18,Providence,G,31,4,406,47,124,.379,44,99,.444,3,25,.120,33,63,.524,4,47,51,52,20,5,43,44,130,2.1
7094,Zjori Bosha\zjori-bosha-1,2014-15,Lamar,G,26,3,467,42,129,.326,11,19,.579,31,110,.282,15,29,.517,12,39,51,21,23,1,14,48,130,2.9
7095,Mario Blessing\mario-blessing-1,2013-14,South Carolina Upstate,G,34,26,800,42,118,.356,16,41,.390,26,77,.338,20,29,.690,11,52,63,78,24,2,40,82,130,2.7
7096,Lucian Brownlee\lucian-brownlee-1,2015-16,Coppin State,G,31,0,363,39,112,.348,19,53,.358,20,59,.339,32,42,.762,4,23,27,13,7,1,33,40,130,1.3
7097,Anthony Lindauer\anthony-lindauer-1,2013-14,High Point,G,30,6,435,43,101,.426,10,27,.370,33,74,.446,11,13,.846,1,28,29,33,8,1,32,43,130,2.2
7098,Rinardo Perry\rinardo-perry-1,2016-17,Massachusetts-Lowell,G,30,22,492,49,140,.350,36,88,.409,13,52,.250,19,37,.514,17,39,56,33,18,7,30,46,130,2.2
7099,Troy Reid-Knight\troy-reid-knight-1,2014-15,Maine,G,27,7,517,43,101,.426,23,46,.500,20,55,.364,24,37,.649,18,43,61,34,18,2,40,59,130,2.8
7100,Duane Gibson\duane-gibson-1,2017-18,Evansville,G,20,14,446,52,119,.437,52,119,.437,0,0,,26,38,.684,8,50,58,53,22,7,45,52,130,4.1
7101,Daniel Dingle\daniel-dingle-1,2014-15,Temple,G,36,12,593,43,133,.323,26,56,.464,17,77,.221,27,47,.574,29,65,94,39,11,10,33,55,130,2.1
7102,Reilly Walsh\reilly-walsh-1,2017-18,NJIT,G,30,30,586,52,110,.473,37,65,.569,15,45,.333,11,19,.579,26,55,81,34,31,1,26,62,130,3.7
7103,Jahvari Josiah\jahvari-josiah-1,2014-15,Coppin State,G,31,2,389,42,120,.350,36,79,.456,6,41,.146,40,65,.615,34,37,71,11,16,6,41,47,130,1.8
7104,Jordan Lauf\jordan-lauf-1,2013-14,Toledo,G,34,1,496,42,80,.525,36,58,.621,6,22,.273,40,59,.678,52,66,118,18,19,0,16,79,130,3.6
7105,Mike Okauru\mike-okauru-1,2017-18,Florida,G,34,1,377,47,101,.465,28,54,.519,19,47,.404,17,30,.567,5,29,34,21,18,2,13,35,130,2.7
7106,Travis Hammonds\travis-hammonds-1,2013-14,Cal State Long Beach,G,20,2,356,47,103,.456,31,60,.517,16,43,.372,20,30,.667,24,36,60,24,19,4,21,45,130,5.0
7107,Anthony Masinton-Bonner\anthony-masinton-bonner-1,2016-17,Colorado State,G,36,0,528,42,106,.396,24,51,.471,18,55,.327,28,30,.933,3,42,45,16,10,0,13,43,130,2.2
7108,Trevon Allen\trevon-allen-1,2017-18,Idaho,G,31,0,510,44,118,.373,19,48,.396,25,70,.357,17,25,.680,2,58,60,46,11,2,26,26,130,2.9
7109,Marial Shayok\marial-shayok-1,2014-15,Virginia,G,34,1,496,47,116,.405,28,66,.424,19,50,.380,17,27,.630,8,53,61,35,19,10,21,44,130,2.9
7110,Hayden Schenck\hayden-schenck-1,2016-17,Utah Valley,G,32,9,572,40,83,.482,29,55,.527,11,28,.393,39,66,.591,19,79,98,56,32,8,35,64,130,4.1
7111,Desmond Ridenour\desmond-ridenour-1,2017-18,Kent State,G,34,2,528,53,119,.445,44,86,.512,9,33,.273,15,30,.500,17,52,69,20,26,7,31,61,130,2.3
7112,Benny Parker\benny-parker-1,2014-15,Nebraska,G,31,25,874,39,114,.342,27,73,.370,12,41,.293,40,56,.714,8,61,69,54,45,1,37,71,130,3.3
7113,Muhammad-Ali Abdur-Rahkman\muhammad-ali-abdur-rahkman-1,2014-15,Michigan,G,29,13,550,52,124,.419,40,83,.482,12,41,.293,14,15,.933,8,40,48,27,16,0,28,43,130,2.4
7114,Jibri Bryan\jibri-bryan-1,2013-14,Mercer,G,36,0,336,40,106,.377,15,33,.455,25,73,.342,25,37,.676,13,47,60,16,9,1,23,45,130,1.9
7115,Haiishen McIntyre\haiishen-mcintyre-1,2014-15,High Point,G,31,18,632,42,101,.416,36,83,.434,6,18,.333,40,55,.727,7,50,57,83,29,4,47,45,130,3.7
7116,P.J. Hardwick\pj-hardwick-1,2014-15,Arkansas State,G,27,20,776,42,119,.353,40,109,.367,2,10,.200,44,55,.800,21,64,85,130,19,0,59,55,130,4.5
7117,Chris Smith\chris-smith-19,2017-18,UCLA,G,33,0,431,47,107,.439,42,79,.532,5,28,.179,31,53,.585,16,46,62,18,8,7,38,39,130,1.9
7118,Rayner Moquete\rayner-moquete-1,2013-14,Binghamton,G,29,9,593,44,133,.331,19,43,.442,25,90,.278,17,31,.548,17,43,60,16,18,1,11,57,130,2.4
7119,Frank Eaves\frank-eaves-1,2013-14,Appalachian State,G,26,3,422,42,133,.316,27,68,.397,15,65,.231,31,43,.721,12,32,44,17,13,0,15,35,130,2.4
7120,Marese Phelps\marese-phelps-1,2013-14,Norfolk State,G,33,4,659,49,151,.325,31,84,.369,18,67,.269,14,28,.500,14,42,56,77,43,0,52,60,130,2.5
7121,Bronson Koenig\bronson-koenig-1,2013-14,Wisconsin,G,37,0,572,51,115,.443,29,48,.604,22,67,.328,6,8,.750,18,28,46,41,11,3,18,50,130,2.5
7122,Justin Pride\justin-pride-1,2015-16,Cal State Bakersfield,G,33,10,587,35,101,.347,35,100,.350,0,1,.000,59,102,.578,21,53,74,94,27,4,40,80,129,3.3
7123,Jarod Williams\jarod-williams-1,2015-16,Detroit Mercy,G,31,6,377,42,100,.420,31,68,.456,11,32,.344,34,52,.654,9,47,56,41,12,4,34,39,129,2.7
7124,Jason McManamen\jason-mcmanamen-1,2014-15,Wyoming,G,35,4,589,48,118,.407,21,38,.553,27,80,.338,6,14,.429,6,47,53,33,12,0,12,50,129,2.4
7125,Anthony Gaines\anthony-gaines-2,2017-18,Northwestern,G,32,5,597,42,112,.375,34,79,.430,8,33,.242,37,47,.787,24,57,81,37,17,4,29,52,129,2.9
7126,D'Angelo Jackson\dangelo-jackson-2,2017-18,Eastern Illinois,G,17,9,339,35,94,.372,30,84,.357,5,10,.500,54,82,.659,20,35,55,37,14,1,52,32,129,3.9
7127,Zach Green\zach-green-2,2014-15,Montana State,G,30,17,510,50,123,.407,49,112,.438,1,11,.091,28,41,.683,34,33,67,25,14,7,24,58,129,2.7
7128,K.J. Lee\kj-lee-2,2014-15,Marist,G,30,12,783,45,113,.398,31,75,.413,14,38,.368,25,39,.641,11,67,78,50,21,2,45,32,129,3.0
7129,David Rivers\david-rivers-2,2014-15,Nebraska,G,30,25,709,52,109,.477,51,108,.472,1,1,1.000,24,39,.615,56,70,126,20,13,7,16,75,129,3.8
7130,Tevin Findlay\tevin-findlay-1,2016-17,Green Bay,G,30,11,518,50,146,.342,48,120,.400,2,26,.077,27,47,.574,14,72,86,76,30,7,56,35,129,2.9
7131,Danny Evans\danny-evans-2,2016-17,Maine,G,32,22,646,47,113,.416,21,41,.512,26,72,.361,9,14,.643,17,68,85,31,16,4,45,53,129,2.3
7132,Caleb Homesley\caleb-homesley-1,2016-17,Liberty,G,10,8,280,45,102,.441,32,58,.552,13,44,.295,26,50,.520,7,56,63,29,10,8,21,19,129,9.5
7133,Malik Johnson\malik-johnson-2,2016-17,Canisius,G,34,34,923,42,138,.304,29,86,.337,13,52,.250,32,49,.653,12,78,90,148,34,1,59,83,129,3.5
7134,Matt Gramling\matt-gramling-1,2013-14,Army,G,31,1,555,51,143,.357,43,97,.443,8,46,.174,19,29,.655,29,30,59,51,22,3,25,31,129,3.1
7135,Andrew Ramirez\andrew-ramirez-1,2016-17,Hartford,G,32,6,524,40,108,.370,26,58,.448,14,50,.280,35,50,.700,13,41,54,42,28,0,44,33,129,2.7
7136,Sterling Carter\sterling-carter-1,2013-14,Purdue,G,27,6,408,44,122,.361,16,31,.516,28,91,.308,13,20,.650,9,40,49,31,25,10,21,63,129,3.1
7137,Marqueese Grayson\marqueese-grayson-1,2016-17,Albany (NY),G,27,18,455,44,124,.355,22,67,.328,22,57,.386,19,27,.704,3,53,56,27,14,2,34,36,129,2.2
7138,Jacquess Hobbs\jacquess-hobbs-1,2017-18,Eastern Kentucky,G,22,17,549,44,138,.319,32,89,.360,12,49,.245,29,39,.744,13,51,64,83,32,0,33,54,129,4.8
7139,Aaren Edmead\aaren-edmead-1,2014-15,Wagner,G,30,2,460,40,120,.333,16,54,.296,24,66,.364,25,42,.595,11,14,25,41,13,0,40,47,129,1.6
7140,Justin Roberts\justin-roberts-2,2017-18,DePaul,G,30,0,451,51,133,.383,39,96,.406,12,37,.324,15,21,.714,8,29,37,62,15,3,45,29,129,2.4
7141,Daveon Balls\daveon-balls-1,2013-14,Northern Illinois,G,32,1,576,40,127,.315,29,79,.367,11,48,.229,38,46,.826,8,48,56,46,19,1,45,59,129,1.8
7142,Jared Stutzman\jared-stutzman-1,2016-17,Utah Valley,G,34,4,435,38,100,.380,11,18,.611,27,82,.329,26,32,.813,9,77,86,26,8,13,25,38,129,2.8
7143,Amari Hamilton\amari-hamilton-1,2017-18,North Carolina A&T,G,33,1,322,44,142,.310,20,46,.435,24,96,.250,17,24,.708,6,19,25,16,6,1,23,29,129,1.1
7144,Andrew Robinson\andrew-robinson-1,2017-18,Quinnipiac,G,22,0,424,42,120,.350,5,13,.385,37,107,.346,8,13,.615,7,44,51,7,4,0,9,20,129,3.2
7145,Kevin McAdoo\kevin-mcadoo-2,2017-18,Eastern Michigan,G,28,2,319,46,100,.460,24,43,.558,22,57,.386,15,19,.789,4,14,18,16,4,3,19,14,129,2.7
7146,Ahmad Thomas\ahmad-thomas-1,2014-15,North Carolina-Asheville,G,23,2,404,51,128,.398,44,101,.436,7,27,.259,20,35,.571,15,62,77,24,19,9,31,31,129,3.5
7147,Christian Wilson\christian-wilson-1,2014-15,Texas-San Antonio,G,26,1,448,38,132,.288,27,88,.307,11,44,.250,42,74,.568,23,27,50,42,17,3,33,51,129,2.2
7148,Tamron Manning\tamron-manning-1,2013-14,Marshall,G,31,4,729,38,119,.319,20,56,.357,18,63,.286,34,48,.708,13,71,84,45,32,5,24,56,128,3.4
7149,Terrance McBride\terrance-mcbride-1,2017-18,Cornell,G,26,17,684,49,88,.557,40,61,.656,9,27,.333,21,28,.750,10,52,62,68,13,1,24,34,128,5.0
7150,Dontel Highsmith\dontel-highsmith-1,2017-18,Cleveland State,G,26,1,506,50,124,.403,42,88,.477,8,36,.222,20,28,.714,16,40,56,29,21,2,30,42,128,3.0
7151,Matt Hein\matt-hein-1,2017-18,Illinois State,G,32,12,701,39,128,.305,13,45,.289,26,83,.313,24,37,.649,12,57,69,33,27,3,49,81,128,1.4
7152,Jared Dimakos\jared-dimakos-1,2014-15,Chicago State,G,21,12,378,44,98,.449,27,51,.529,17,47,.362,23,30,.767,19,47,66,13,12,0,34,57,128,3.1
7153,Christian Gore\christian-gore-1,2013-14,Texas Christian,G,31,6,552,33,96,.344,20,55,.364,13,41,.317,49,65,.754,16,61,77,39,16,2,29,51,128,3.0
7154,Ray Kowalski\ray-kowalski-1,2017-18,Southeast Missouri State,G,26,5,437,43,112,.384,13,38,.342,30,74,.405,12,12,1.000,4,27,31,17,6,0,21,24,128,2.5
7155,Ryan Murphy\ryan-murphy-3,2017-18,Charlotte,G,19,5,379,46,113,.407,14,33,.424,32,80,.400,4,8,.500,1,21,22,18,10,0,18,28,128,3.5
7156,Phillip Leonard\phillip-leonard-1,2013-14,Mercer,G,32,0,288,36,82,.439,32,64,.500,4,18,.222,52,86,.605,15,28,43,17,6,0,16,34,128,2.5
7157,Austin Starr\austin-starr-1,2017-18,Prairie View,G,33,3,485,36,126,.286,6,24,.250,30,102,.294,26,32,.813,15,29,44,28,15,0,22,62,128,1.8
7158,Haboubacar Mutombo\haboubacar-mutombo-1,2015-16,Western Carolina,G,32,5,517,55,109,.505,47,88,.534,8,21,.381,10,17,.588,37,59,96,19,15,7,10,38,128,3.8
7159,Jamel Fields\jamel-fields-1,2013-14,Saint Peter's,G,29,1,431,35,90,.389,27,63,.429,8,27,.296,50,82,.610,10,23,33,24,23,6,33,49,128,2.5
7160,Jalen Richard\jalen-richard-1,2013-14,Santa Clara,G,33,16,516,42,116,.362,28,66,.424,14,50,.280,30,44,.682,10,66,76,37,18,2,27,48,128,2.5
7161,Samajae Haynes-Jones\samajae-haynes-jones-1,2017-18,Wichita State,G,24,0,263,45,109,.413,31,77,.403,14,32,.438,24,35,.686,4,21,25,30,6,0,18,24,128,3.1
7162,Davide Moretti\davide-moretti-1,2017-18,Texas Tech,G,37,1,455,39,116,.336,13,34,.382,26,82,.317,24,28,.857,6,23,29,42,16,0,28,50,128,1.9
7163,JerShon Cobb\jershon-cobb-1,2014-15,Northwestern,G,21,16,469,44,109,.404,20,43,.465,24,66,.364,16,22,.727,7,61,68,33,4,1,19,35,128,4.0
7164,Jonathan Wiley\jonathan-wiley-1,2017-18,Southern Illinois,G,22,9,420,51,108,.472,51,105,.486,0,3,.000,26,40,.650,23,77,100,21,9,11,23,50,128,4.3
7165,Khalen Pinkett\khaleen-pinkett-1,2015-16,Savannah State,G,32,12,632,43,122,.352,40,106,.377,3,16,.188,39,68,.574,11,44,55,50,34,2,76,69,128,1.1
7166,Fiifi Aidoo\fiifi-aidoo-1,2016-17,Grand Canyon,G,28,2,449,39,116,.336,19,47,.404,20,69,.290,30,44,.682,21,37,58,23,21,7,24,33,128,3.1
7167,Austin Stewart\austin-stewart-1,2015-16,Central Michigan,G,33,8,448,43,95,.453,34,58,.586,9,37,.243,33,46,.717,21,59,80,10,14,4,17,48,128,2.8
7168,Jon'te Dotson\jonte-dotson-1,2016-17,Northern Colorado,G,29,17,652,40,125,.320,24,62,.387,16,63,.254,32,54,.593,32,88,120,26,15,15,30,58,128,3.0
7169,Damon Collins\damon-collins-1,2014-15,Howard,G,30,28,922,44,107,.411,39,91,.429,5,16,.313,34,56,.607,38,109,147,40,37,9,65,60,127,3.4
7170,Justin Mitchell\justin-mitchell-1,2014-15,Wright State,G,28,12,481,46,98,.469,46,98,.469,0,0,,35,52,.673,16,64,80,32,25,5,20,49,127,4.0
7171,Mike Fleming\mike-fleming-2,2016-17,Dartmouth,G,27,22,689,41,99,.414,22,41,.537,19,58,.328,26,30,.867,8,37,45,68,13,2,22,62,127,3.9
7172,Austin White\austin-white-1,2016-17,High Point,G,31,22,688,45,122,.369,39,98,.398,6,24,.250,31,47,.660,3,45,48,37,24,0,23,56,127,2.4
7173,Sam Singer\sam-singer-1,2015-16,University of California,G,34,9,678,49,122,.402,39,85,.459,10,37,.270,19,31,.613,15,70,85,88,17,2,47,69,127,2.7
7174,Czar Perry\czar-perry-1,2017-18,Northwestern State,G,14,4,299,52,120,.433,44,86,.512,8,34,.235,15,27,.556,8,21,29,26,6,1,55,30,127,2.1
7175,Sabri Thompson\sabri-thompson-1,2013-14,Northwestern State,G,31,4,385,41,116,.353,16,46,.348,25,70,.357,20,27,.741,16,29,45,27,15,3,25,41,127,2.4
7176,Jake Duncan\jake-duncan-1,2013-14,NJIT,G,24,2,316,42,99,.424,16,28,.571,26,71,.366,17,23,.739,5,28,33,13,5,3,16,22,127,3.1
7177,Greg Brown\greg-brown-4,2013-14,Saint Francis (PA),G,31,28,730,49,121,.405,42,91,.462,7,30,.233,22,36,.611,9,77,86,59,22,10,35,57,127,3.2
7178,Sam Burmeister\sam-burmeister-1,2015-16,Incarnate Word,G,22,17,519,44,133,.331,29,76,.382,15,57,.263,24,39,.615,3,65,68,31,13,3,36,55,127,2.1
7179,Robert Cartwright\robert-cartwright-1,2017-18,Stanford,G,27,6,482,43,117,.368,25,62,.403,18,55,.327,23,31,.742,7,37,44,62,16,1,29,30,127,3.5
7180,Jalen Lindsey\jalen-lindsey-1,2014-15,Providence,G,33,13,590,43,119,.361,12,25,.480,31,94,.330,10,18,.556,17,34,51,6,14,3,8,39,127,2.3
7181,Justin McCloud\justin-mccloud-1,2015-16,Illinois State,G,32,2,546,44,123,.358,7,12,.583,37,111,.333,2,4,.500,5,50,55,25,11,1,11,43,127,2.4
7182,Ny Redding\ny-redding-1,2014-15,Washington State,G,31,17,602,36,90,.400,30,64,.469,6,26,.231,49,61,.803,7,45,52,101,16,2,56,71,127,3.1
7183,Aaron Anderson\aaron-anderson-4,2015-16,Oral Roberts,G,30,17,681,41,91,.451,30,62,.484,11,29,.379,34,44,.773,21,74,95,73,15,1,54,70,127,3.2
7184,K.K. Simmons\kk-simmons-2,2013-14,Kent State,G,29,0,371,41,94,.436,20,43,.465,21,51,.412,24,28,.857,7,28,35,26,13,2,21,36,127,3.0
7185,Khameron Davis\khameron-davis-1,2017-18,Pittsburgh,G,32,23,769,45,111,.405,22,49,.449,23,62,.371,14,20,.700,8,82,90,31,19,16,36,53,127,2.8
7186,Torin Childs-Harris\torin-childs-harris-1,2014-15,Morgan State,G,22,13,395,40,126,.317,32,83,.386,8,43,.186,39,55,.709,18,28,46,11,19,1,20,45,127,2.7
7187,Torey Noel\torey-noel-1,2017-18,Lamar,G,33,9,576,44,130,.338,34,75,.453,10,55,.182,29,44,.659,9,45,54,91,45,0,56,67,127,2.8
7188,Gianni Ford\gianni-ford-1,2016-17,St. Francis (NY),G,26,0,375,42,127,.331,20,57,.351,22,70,.314,21,29,.724,8,18,26,11,9,2,17,33,127,1.9
7189,Marvin Bragg\marvin-bragg-1,2017-18,American,G,27,16,579,46,93,.495,26,39,.667,20,54,.370,15,29,.517,18,62,80,26,18,12,19,60,127,4.0
7190,Dustin Thomas\dustin-thomas-1,2013-14,Colorado,G,35,6,527,46,111,.414,40,78,.513,6,33,.182,29,53,.547,33,53,86,19,7,3,49,83,127,1.1
7191,Benji Bell\benji-bell-1,2015-16,Florida State,G,33,1,342,39,99,.394,16,45,.356,23,54,.426,25,45,.556,8,26,34,29,10,0,22,29,126,2.3
7192,Bo Zeigler\bo-zeigler-1,2015-16,South Florida,G,32,17,711,54,97,.557,53,87,.609,1,10,.100,17,37,.459,30,61,91,45,23,29,51,75,126,3.3
7193,Reggie Reid\reggie-reid-1,2015-16,Florida Gulf Coast,G,34,14,572,42,116,.362,26,63,.413,16,53,.302,26,44,.591,5,40,45,106,23,3,41,63,126,3.0
7194,Casey Benson\casey-benson-1,2014-15,Oregon,G,36,9,707,42,109,.385,17,36,.472,25,73,.342,17,25,.680,8,61,69,72,23,1,23,56,126,3.2
7195,Jordan Giddings\jordan-giddings-1,2015-16,Prairie View,G,31,5,411,41,115,.357,35,88,.398,6,27,.222,38,53,.717,13,20,33,16,14,2,18,48,126,1.9
7196,James White\james-white-2,2015-16,Georgia Tech,G,36,11,522,56,112,.500,56,112,.500,0,0,,14,31,.452,63,96,159,16,10,28,24,89,126,3.3
7197,Keith Carter\keith-carter-2,2013-14,Valparaiso,G,22,4,407,43,101,.426,25,56,.446,18,45,.400,22,33,.667,3,36,39,51,23,3,37,47,126,3.9
7198,Terrence Samuel\terrence-samuel-1,2014-15,Connecticut,G,35,8,715,43,111,.387,43,94,.457,0,17,.000,40,52,.769,22,64,86,55,16,1,47,36,126,2.5
7199,David Appolon\david-appolon-1,2014-15,Robert Morris,G,21,9,460,39,96,.406,35,82,.427,4,14,.286,44,59,.746,29,45,74,34,22,0,30,50,126,4.7
7200,TJ Lang\tj-lang-1,2016-17,Auburn,G,29,9,476,35,88,.398,5,12,.417,30,76,.395,26,39,.667,16,35,51,14,10,2,16,55,126,2.7
7201,Davion Mitchell\davion-mitchell-1,2017-18,Auburn,G,34,0,581,45,105,.429,30,53,.566,15,52,.288,21,31,.677,9,30,39,63,18,1,38,73,126,2.3
7202,Tevin King\tevin-king-1,2015-16,South Dakota State,G,34,2,485,39,95,.411,35,81,.432,4,14,.286,44,73,.603,19,42,61,27,27,3,32,64,126,2.3
7203,Matthew Cotton\matthew-cotton-1,2016-17,Alabama A&M,G,29,3,564,37,112,.330,15,44,.341,22,68,.324,30,39,.769,13,30,43,24,11,0,22,55,126,2.1
7204,Kobe Gantz\kobe-gantz-1,2016-17,Delaware State,G,27,2,502,42,105,.400,33,70,.471,9,35,.257,33,62,.532,21,33,54,67,11,2,43,55,126,2.8
7205,Paul Jorgensen\paul-jorgensen-1,2014-15,George Washington,G,35,0,356,49,131,.374,33,91,.363,16,40,.400,12,20,.600,5,39,44,31,10,0,25,52,126,1.5
7206,Christopher Thomas\christopher-thomas-2,2015-16,Alabama A&M,G,28,19,480,49,113,.434,35,59,.593,14,54,.259,14,23,.609,25,45,70,14,5,2,13,37,126,2.9
7207,Joshua White\joshua-white-1,2016-17,Southern Illinois-Edwardsville,G,23,11,375,49,127,.386,33,68,.485,16,59,.271,12,17,.706,15,31,46,23,8,2,13,34,126,3.2
7208,Khalid Lewis\khalid-lewis-1,2015-16,Illinois,G,32,18,741,47,127,.370,41,103,.398,6,24,.250,26,37,.703,7,46,53,96,29,4,40,52,126,3.4
7209,Dominique Dunning\dominique-dunning-1,2013-14,UC-Irvine,G,29,0,341,45,90,.500,43,82,.524,2,8,.250,34,54,.630,23,52,75,15,12,1,18,39,126,3.3
7210,Jeremy Lieberman\jeremy-lieberman-1,2015-16,Wyoming,G,32,23,677,41,124,.331,14,45,.311,27,79,.342,17,22,.773,10,59,69,43,11,0,35,57,126,1.9
7211,Jerome Segura\jerome-segura-1,2017-18,Fairfield,G,30,17,588,49,127,.386,37,97,.381,12,30,.400,16,23,.696,5,28,33,71,19,0,33,45,126,2.8
7212,Ryann Green\ryann-green-1,2014-15,Georgia State,G,35,27,705,40,98,.408,21,39,.538,19,59,.322,27,38,.711,12,53,65,50,39,2,27,64,126,3.3
7213,Chris Adams\chris-adams-4,2013-14,San Francisco,G,33,0,644,44,127,.346,6,25,.240,38,102,.373,0,0,,4,49,53,31,9,1,19,55,126,1.9
7214,Tai Webster\tai-webster-1,2013-14,Nebraska,G,32,30,729,34,112,.304,28,77,.364,6,35,.171,52,84,.619,14,52,66,63,24,3,58,74,126,1.8
7215,Tyler Madison\tyler-madison-1,2016-17,Alabama-Birmingham,G,30,1,332,44,79,.557,43,73,.589,1,6,.167,36,59,.610,27,47,74,26,8,6,17,64,125,3.3
7216,Cullen VanLeer\cullen-vanleer-1,2015-16,Missouri,G,31,3,533,45,138,.326,15,28,.536,30,110,.273,5,8,.625,7,29,36,24,10,1,14,37,125,1.9
7217,Shane McLaughlin\shane-mclaughlin-1,2013-14,Bryant,G,32,16,654,39,75,.520,23,40,.575,16,35,.457,31,43,.721,2,56,58,83,24,0,43,41,125,3.9
7218,Gene Davis\gene-davis-1,2017-18,Alabama State,G,31,22,567,42,123,.341,29,72,.403,13,51,.255,28,32,.875,7,40,47,67,13,1,67,51,125,1.4
7219,Isaiah Nichols\isaiah-nichols-1,2016-17,San Jose State,G,29,11,482,42,100,.420,32,71,.451,10,29,.345,31,61,.508,5,53,58,54,20,0,46,62,125,2.3
7220,DeShawndre Black\deshawndre-black-1,2016-17,Detroit Mercy,G,31,7,526,42,126,.333,22,72,.306,20,54,.370,21,33,.636,9,35,44,68,18,0,35,60,125,2.3
7221,Edward Simpson\edward-simpson-1,2016-17,Middle Tennessee,G,36,23,865,42,111,.378,11,27,.407,31,84,.369,10,22,.455,4,71,75,78,23,2,22,58,125,3.3
7222,Ryan Frazier\ryan-frazier-1,2013-14,Bucknell,G,30,7,553,39,105,.371,26,65,.400,13,40,.325,34,46,.739,11,29,40,26,14,3,22,63,125,2.2
7223,Jamal Smith\jamal-smith-2,2017-18,Cal State Fullerton,G,32,18,721,35,84,.417,22,49,.449,13,35,.371,42,56,.750,6,75,81,61,18,6,52,96,125,2.4
7224,Devonte Boykins\devonte-boykins-1,2016-17,Georgia Southern,G,33,1,621,41,106,.387,19,44,.432,22,62,.355,21,36,.583,5,53,58,34,18,1,30,49,125,2.2
7225,Jack Ferguson\jack-ferguson-1,2017-18,Colgate,G,30,0,290,37,115,.322,7,19,.368,30,96,.313,21,29,.724,6,20,26,18,12,2,8,35,125,2.3
7226,Jaylon Brown\jaylon-brown-1,2013-14,Evansville,G,32,2,579,48,99,.485,46,89,.517,2,10,.200,27,51,.529,10,55,65,51,20,4,34,60,125,2.8
7227,Randy Onwuasor\randy-onwuasor-1,2014-15,Texas Tech,G,30,14,545,38,123,.309,27,77,.351,11,46,.239,38,60,.633,20,61,81,37,28,5,47,50,125,2.3
7228,Shirmane Thomas\shirmane-thomas-1,2013-14,Tennessee Tech,G,32,0,492,36,110,.327,25,86,.291,11,24,.458,42,76,.553,14,50,64,43,13,8,47,73,125,1.4
7229,Joel Berry\joel-berry-1,2014-15,North Carolina,G,30,0,397,40,99,.404,23,51,.451,17,48,.354,28,37,.757,3,23,26,46,12,1,21,44,125,2.8
7230,De'Angelo Bruster\deangelo-bruster-1,2017-18,Western Illinois,G,28,0,475,44,101,.436,33,66,.500,11,35,.314,26,34,.765,3,39,42,40,19,0,38,44,125,2.6
7231,Isaiah Williams\isaiah-williams-3,2017-18,Liberty,G,30,10,416,41,91,.451,38,80,.475,3,11,.273,40,68,.588,24,41,65,22,9,6,40,59,125,2.0
7232,Kevin Seymour\kevin-seymour-1,2015-16,Central Connecticut State,G,29,18,525,51,133,.383,41,103,.398,10,30,.333,13,18,.722,6,41,47,65,10,1,39,23,125,2.6
7233,Sanjay Lumpkin\sanjay-lumpkin-1,2013-14,Northwestern,G,33,32,965,43,117,.368,30,68,.441,13,49,.265,26,43,.605,48,110,158,41,37,12,55,118,125,2.8
7234,Carlton Hurst\carlton-hurst-1,2013-14,Colorado State,G,30,6,491,40,91,.440,39,82,.476,1,9,.111,44,68,.647,18,48,66,25,6,5,23,43,125,2.7
7235,Rusty Reigel\rusty-reigel-1,2017-18,Davidson,G,33,1,629,41,81,.506,13,24,.542,28,57,.491,15,20,.750,18,70,88,56,18,1,24,67,125,3.7
7236,Tre Campbell\tre-campbell-1,2015-16,Georgetown,G,30,20,627,40,131,.305,20,57,.351,20,74,.270,24,31,.774,13,41,54,50,22,2,26,43,124,2.7
7237,Travon Bell\travon-bell-1,2017-18,Chicago State,G,25,2,345,47,134,.351,20,40,.500,27,94,.287,3,4,.750,10,38,48,18,20,2,22,34,124,2.6
7238,Lance Potier\lance-potier-1,2015-16,McNeese State,G,28,15,595,47,137,.343,27,70,.386,20,67,.299,10,20,.500,23,73,96,30,15,25,23,61,124,3.1
7239,Miguel Dicent\miguel-dicent-1,2014-15,Morehead State,G,33,0,470,42,115,.365,19,45,.422,23,70,.329,17,24,.708,6,25,31,31,17,2,33,87,124,1.3
7240,Desmond Johnson\desmond-johnson-1,2017-18,Western Carolina,G,31,13,488,46,120,.383,37,91,.407,9,29,.310,23,41,.561,14,53,67,48,39,3,54,49,124,2.5
7241,Leandro Allende\leandro-allende-1,2017-18,Citadel,G,32,18,568,48,99,.485,37,67,.552,11,32,.344,17,26,.654,26,68,94,49,10,3,23,61,124,3.4
7242,Jermaine Long\jermaine-long-1,2017-18,East Tennessee State,G,34,29,698,39,117,.333,20,40,.500,19,77,.247,27,33,.818,8,67,75,87,34,4,55,89,124,2.6
7243,Bobby Moorehead\bobby-moorehead-1,2016-17,Montana,G,32,9,575,41,128,.320,14,35,.400,27,93,.290,15,22,.682,10,81,91,18,10,9,19,69,124,1.9
7244,Kevin Douglas\kevin-douglas-1,2013-14,St. Francis (NY),G,31,16,453,45,109,.413,31,61,.508,14,48,.292,20,30,.667,27,53,80,11,12,6,34,66,124,1.9
7245,Brandon Gfeller\brandon-gfeller-1,2016-17,Montana,G,32,11,402,43,111,.387,12,25,.480,31,86,.360,7,14,.500,9,33,42,12,11,3,12,49,124,2.1
7246,Noah Thomas\noah-thomas-12,2017-18,Drake,G,34,2,410,46,118,.390,24,50,.480,22,68,.324,10,17,.588,9,34,43,34,19,2,38,40,124,1.9
7247,Tre Gray\tre-gray-1,2017-18,Texas A&M-Corpus Christi,G,24,0,249,39,88,.443,20,38,.526,19,50,.380,27,38,.711,1,11,12,9,9,0,20,33,124,2.5
7248,Fiifi Aidoo\fiifi-aidoo-1,2017-18,Grand Canyon,G,32,4,393,46,115,.400,28,50,.560,18,65,.277,14,19,.737,16,23,39,33,15,7,22,41,124,2.6
7249,Bryce White\bryce-white-1,2014-15,Portland State,G,13,10,339,34,91,.374,23,55,.418,11,36,.306,45,58,.776,5,48,53,23,9,5,17,30,124,6.6
7250,Jonathan Williams\jonathan-williams-3,2015-16,Virginia Commonwealth,G,32,11,456,48,105,.457,46,95,.484,2,10,.200,26,40,.650,5,36,41,55,24,0,30,51,124,2.8
7251,Devin Foster\devin-foster-1,2015-16,Penn State,G,31,4,588,43,95,.453,33,72,.458,10,23,.435,28,48,.583,21,53,74,36,10,1,25,62,124,2.7
7252,Jaylin McCoy\jaylin-mccoy-1,2017-18,Southern Illinois-Edwardsville,G,24,9,402,42,120,.350,14,35,.400,28,85,.329,11,13,.846,2,17,19,18,11,0,17,28,123,2.4
7253,Jay Jay Chandler\jayjay-chandler-1,2017-18,Texas A&M,G,33,4,377,42,111,.378,32,70,.457,10,41,.244,29,40,.725,15,23,38,24,10,1,24,43,123,1.9
7254,Don Coleman\don-coleman-1,2016-17,University of California,G,27,1,309,42,112,.375,38,92,.413,4,20,.200,35,57,.614,14,27,41,15,4,1,28,44,123,1.5
7255,Wes Cole\wes-cole-1,2014-15,Hartford,G,27,4,454,40,131,.305,12,38,.316,28,93,.301,15,17,.882,10,15,25,14,13,0,20,31,123,1.8
7256,Nigel Ribeiro\nigel-ribeiro-1,2017-18,Grambling,G,19,1,397,44,118,.373,33,88,.375,11,30,.367,24,37,.649,5,44,49,31,21,3,25,34,123,4.0
7257,Matt McQuaid\matt-mcquaid-1,2015-16,Michigan State,G,35,1,553,44,113,.389,17,47,.362,27,66,.409,8,11,.727,10,19,29,57,13,10,27,59,123,2.4
7258,Sidy N'Dir\sidy-ndir-2,2016-17,New Mexico State,G,9,9,269,38,77,.494,25,41,.610,13,36,.361,34,45,.756,4,20,24,19,4,6,20,20,123,9.1
7259,Jan Svandrlik\jan-svandrlik-1,2017-18,Iona,G,34,0,332,37,90,.411,7,15,.467,30,75,.400,19,23,.826,21,36,57,9,9,6,4,43,123,2.9
7260,JaQuel Richmond\jaquel-richmond-1,2016-17,North Carolina-Wilmington,G,27,2,347,46,109,.422,39,82,.476,7,27,.259,24,32,.750,7,24,31,31,9,0,22,47,123,2.4
7261,Rayshawn Neal\rayshawn-neal-1,2017-18,South Carolina State,G,31,1,374,48,105,.457,47,97,.485,1,8,.125,26,33,.788,15,40,55,47,12,0,46,40,123,2.3
7262,Armoni Brooks\armoni-brooks-1,2016-17,Houston,G,28,3,341,45,104,.433,20,35,.571,25,69,.362,8,10,.800,11,52,63,7,11,2,15,25,123,3.0
7263,Malik Metoyer\malik-metoyer-1,2017-18,Northwestern State,G,25,18,528,48,114,.421,40,80,.500,8,34,.235,19,32,.594,38,69,107,26,16,13,32,65,123,3.6
7264,Nigel Johnson\nigel-johnson-2,2013-14,Kansas State,G,30,0,414,41,110,.373,24,49,.490,17,61,.279,24,35,.686,14,31,45,48,23,1,26,40,123,3.1
7265,Jermaine Long\jermaine-long-1,2016-17,East Tennessee State,G,34,1,447,35,88,.398,30,56,.536,5,32,.156,48,75,.640,16,44,60,60,42,7,44,58,123,3.3
7266,DeVante Jones\devante-jones-1,2014-15,Middle Tennessee,G,27,2,285,39,105,.371,15,36,.417,24,69,.348,21,28,.750,8,21,29,22,16,1,15,33,123,2.9
7267,Savion Flagg\savion-flagg-1,2017-18,Texas A&M,G,30,5,469,45,104,.433,32,63,.508,13,41,.317,20,34,.588,38,65,103,21,9,2,22,34,123,3.3
7268,Travis Souza\travis-souza-1,2013-14,UC-Irvine,G,35,2,515,36,105,.343,3,10,.300,33,95,.347,18,22,.818,15,46,61,37,8,0,9,25,123,2.9
7269,Jabbar Singleton\jabbar-singleton-1,2013-14,Oral Roberts,G,33,17,757,38,113,.336,19,56,.339,19,57,.333,28,50,.560,7,49,56,76,20,2,41,46,123,2.6
7270,August Haas\august-haas-1,2017-18,Milwaukee,G,32,6,644,44,113,.389,32,69,.464,12,44,.273,23,42,.548,1,64,65,89,27,3,41,64,123,3.1
7271,Karon Waller\karon-waller-1,2013-14,Binghamton,G,20,15,416,35,84,.417,16,38,.421,19,46,.413,34,41,.829,16,50,66,17,10,1,19,30,123,4.7
7272,Matt Hayes\matt-hayes-1,2014-15,Loyola Marymount,G,29,7,421,42,118,.356,10,39,.256,32,79,.405,7,8,.875,9,29,38,21,7,0,16,21,123,2.4
7273,Amadi Udenyi\amadi-udenyi-1,2013-14,Pepperdine,G,21,15,461,35,112,.313,15,50,.300,20,62,.323,33,49,.673,8,19,27,57,19,0,33,41,123,3.5
7274,Thomas Akyazili\thomas-akyazili-1,2015-16,Colorado,G,33,1,528,41,125,.328,24,66,.364,17,59,.288,24,35,.686,3,49,52,53,17,8,31,76,123,1.9
7275,Trevin Woods\trevin-woods-1,2014-15,Long Island University,G,29,0,432,44,116,.379,22,49,.449,22,67,.328,13,15,.867,37,64,101,10,10,18,15,48,123,3.4
7276,Paris Austin\paris-austin-1,2015-16,Boise State,G,30,3,368,41,103,.398,35,80,.438,6,23,.261,35,57,.614,4,42,46,35,9,0,22,25,123,2.5
7277,Sanjay Lumpkin\sanjay-lumpkin-1,2015-16,Northwestern,G,32,32,757,42,86,.488,29,50,.580,13,36,.361,26,38,.684,45,114,159,40,17,8,34,93,123,3.7
7278,Jordan McNeil\jordan-mcneil-1,2016-17,Towson,G,32,3,332,41,95,.432,25,51,.490,16,44,.364,25,41,.610,1,23,24,13,14,5,24,29,123,2.0
7279,Steven Jones\steven-jones-1,2013-14,UC-Riverside,G,31,19,646,50,141,.355,40,102,.392,10,39,.256,13,24,.542,6,58,64,55,13,4,38,76,123,1.5
7280,Lourawls Nairn\lourawls-tum-tum-nairn-1,2016-17,Michigan State,G,35,30,799,48,115,.417,36,78,.462,12,37,.324,14,27,.519,3,84,87,127,15,4,39,59,122,3.6
7281,Jeremiah Ferguson\jeremiah-ferguson-1,2017-18,Youngstown State,G,29,4,430,43,132,.326,29,90,.322,14,42,.333,22,34,.647,3,22,25,38,20,1,32,42,122,1.7
7282,Malik Massey\malik-massey-1,2016-17,North Carolina-Greensboro,G,35,0,554,43,109,.394,18,53,.340,25,56,.446,11,19,.579,3,27,30,34,18,0,23,38,122,2.1
7283,Collin Jennings\collin-jennings-1,2014-15,Missouri-Kansas City,G,30,3,443,44,99,.444,24,50,.480,20,49,.408,14,19,.737,16,23,39,27,14,3,26,51,122,2.5
7284,Munis Tutu\munis-tutu-1,2015-16,Loyola Marymount,G,31,4,565,36,121,.298,26,81,.321,10,40,.250,40,52,.769,14,44,58,94,26,3,35,65,122,3.3
7285,Shadell Millinghaus\shadell-millinghaus-1,2016-17,Texas Tech,G,31,5,403,43,93,.462,39,65,.600,4,28,.143,32,51,.627,20,46,66,25,22,3,26,34,122,3.1
7286,Josh James\josh-james-2,2016-17,Monmouth,G,30,27,688,48,116,.414,44,95,.463,4,21,.190,22,33,.667,28,87,115,41,18,2,31,59,122,3.2
7287,Marcus Bartley\marcus-bartley-1,2015-16,Saint Louis,G,32,2,467,38,100,.380,9,27,.333,29,73,.397,17,18,.944,1,23,24,40,14,3,21,71,122,2.2
7288,Broderick Newbill\broderick-newbill-1,2014-15,Missouri-Kansas City,G,29,3,350,49,106,.462,45,89,.506,4,17,.235,20,39,.513,21,41,62,10,19,8,29,29,122,2.7
7289,Omar Calhoun\omar-calhoun-1,2013-14,Connecticut,G,32,11,428,40,131,.305,21,52,.404,19,79,.241,23,30,.767,10,35,45,12,7,4,31,23,122,1.2
7290,Nathan Hawkins\nathan-hawkins-2,2015-16,Texas-Arlington,G,33,2,515,45,134,.336,23,52,.442,22,82,.268,10,21,.476,15,52,67,48,16,3,53,46,122,1.5
7291,Dinjiyl Walker\dinjiyl-walker-1,2015-16,Oklahoma,G,37,0,437,43,125,.344,16,48,.333,27,77,.351,9,20,.450,13,40,53,29,17,1,27,46,122,1.6
7292,Derrick Bruce\derrick-bruce-1,2015-16,Oregon State,G,28,0,342,35,93,.376,13,50,.260,22,43,.512,30,48,.625,1,27,28,39,7,1,23,34,122,2.5
7293,Tyler Wilson\tyler-wilson-1,2015-16,Manhattan,G,31,25,885,29,83,.349,25,73,.342,4,10,.400,60,101,.594,12,50,62,161,45,1,80,101,122,3.9
7294,Biggie Minnis\deshon-minnis-1,2014-15,Rhode Island,G,33,17,653,46,115,.400,40,92,.435,6,23,.261,24,50,.480,13,66,79,72,18,6,44,69,122,2.4
7295,Jaylen Allen\jaylen-allen-1,2016-17,Wofford,G,32,18,451,43,122,.352,20,63,.317,23,59,.390,13,20,.650,8,47,55,25,32,2,35,65,122,1.9
7296,Justin McFadden\justin-mcfadden-1,2015-16,Binghamton,G,29,21,662,34,98,.347,23,55,.418,11,43,.256,43,61,.705,31,78,109,28,22,11,45,70,122,2.8
7297,Andre Wallace\andre-wallace-1,2016-17,South Dakota State,G,26,6,388,40,109,.367,22,48,.458,18,61,.295,24,49,.490,4,35,39,29,10,1,24,24,122,2.4
7298,Jacoby Green\jacoby-green-1,2014-15,Prairie View,G,33,10,497,42,119,.353,17,46,.370,25,73,.342,13,19,.684,12,29,41,33,18,1,35,56,122,1.7
7299,Sam Hunt\sam-hunt-1,2013-14,Jacksonville,G,30,0,345,32,82,.390,15,34,.441,17,48,.354,41,48,.854,5,16,21,26,11,1,26,35,122,2.4
7300,Jodan Price\jodan-price-1,2015-16,Eastern Michigan,G,29,7,448,40,117,.342,14,31,.452,26,86,.302,16,26,.615,6,34,40,8,17,10,16,43,122,2.2
7301,Kimar Williams\kimar-williams-1,2015-16,Florida International,G,32,21,632,41,114,.360,38,97,.392,3,17,.176,37,63,.587,16,79,95,79,28,2,36,56,122,3.4
7302,Ryan Johnson\ryan-johnson-1,2016-17,Mercer,G,32,0,334,42,99,.424,26,55,.473,16,44,.364,22,30,.733,20,61,81,15,7,1,18,42,122,2.6
7303,Carrington Ward\carrington-ward-1,2015-16,North Texas,G,30,2,406,38,98,.388,24,48,.500,14,50,.280,32,43,.744,10,26,36,21,18,2,28,58,122,2.1
7304,Jacob Young\jacob-young-1,2016-17,Texas,G,33,5,541,43,150,.287,18,40,.450,25,110,.227,11,14,.786,4,26,30,28,8,1,31,49,122,0.6
7305,Marcus Stroman\marcus-stroman-1,2014-15,South Carolina,G,28,0,573,39,104,.375,37,86,.430,2,18,.111,41,63,.651,16,57,73,87,22,4,57,61,121,3.1
7306,Agunwa Okolie\agunwa-okolie-1,2014-15,Harvard,G,28,27,694,52,100,.520,51,91,.560,1,9,.111,16,33,.485,32,74,106,27,20,13,29,38,121,4.1
7307,DuShaun Rice\dushaun-rice-1,2013-14,Central Arkansas,G,29,14,476,37,108,.343,19,50,.380,18,58,.310,29,40,.725,19,37,56,44,18,3,28,44,121,2.9
7308,Spencer Foley\spencer-foley-1,2016-17,Canisius,G,30,0,282,39,101,.386,10,20,.500,29,81,.358,14,15,.933,16,9,25,11,5,2,11,32,121,2.3
7309,Isaac Gassman\isaac-gassman-1,2017-18,Illinois State,G,32,0,469,44,102,.431,19,38,.500,25,64,.391,8,15,.533,18,41,59,16,19,2,14,39,121,2.9
7310,Aric Dickerson\aric-dickerson-1,2015-16,Delaware State,G,27,5,365,40,96,.417,7,18,.389,33,78,.423,8,12,.667,6,16,22,15,3,1,17,18,121,2.5
7311,Spike Albrecht\spike-albrecht-1,2013-14,Michigan,G,37,1,546,38,94,.404,14,32,.438,24,62,.387,21,27,.778,6,35,41,75,18,1,16,47,121,3.2
7312,Aaryn Rai\aaryn-rai-1,2017-18,Dartmouth,G,25,17,459,39,107,.364,18,59,.305,21,48,.438,22,30,.733,30,45,75,20,16,6,28,48,121,3.2
7313,Evan Wessel\evan-wessel-1,2015-16,Wichita State,G,35,35,742,43,134,.321,15,29,.517,28,105,.267,7,15,.467,49,58,107,24,17,2,13,62,121,2.6
7314,Brandon Hatton\brandon-hatton-1,2014-15,Vermont,G,31,0,447,41,111,.369,17,35,.486,24,76,.316,15,22,.682,7,45,52,13,10,4,11,36,121,2.3
7315,Nick Severado\nick-severado-1,2017-18,Florida A&M,G,32,23,765,46,109,.422,46,108,.426,0,1,.000,29,45,.644,47,90,137,14,17,23,32,98,121,2.8
7316,Mardracus Wade\mardracus-wade-1,2013-14,Arkansas,G,31,3,456,34,81,.420,14,34,.412,20,47,.426,33,44,.750,7,19,26,27,25,1,16,59,121,2.9
7317,Steve Johnston\steve-johnston-1,2014-15,Fairfield,G,31,8,577,33,117,.282,7,17,.412,26,100,.260,29,41,.707,4,32,36,15,17,1,23,51,121,1.4
7318,Montigo Alford\montigo-alford-1,2014-15,Boise State,G,30,0,352,43,108,.398,24,64,.375,19,44,.432,16,26,.615,1,26,27,38,13,4,29,33,121,2.2
7319,Tyler Singleton\tyler-singleton-1,2015-16,Incarnate Word,G,26,1,434,44,102,.431,44,100,.440,0,2,.000,33,47,.702,11,32,43,36,14,1,28,39,121,2.9
7320,Kyle Clarke\kyle-clarke-1,2017-18,Kennesaw State,G,29,15,517,46,118,.390,46,112,.411,0,6,.000,29,46,.630,14,58,72,56,35,3,48,55,121,2.9
7321,Knox Hellums\knox-hellums-1,2017-18,Pepperdine,G,27,0,386,41,95,.432,13,24,.542,28,71,.394,11,16,.688,5,35,40,16,9,3,6,27,121,3.3
7322,Aaron Wright\aaron-wright-1,2014-15,UC-Irvine,G,33,5,567,40,100,.400,28,71,.394,12,29,.414,29,50,.580,12,54,66,52,26,2,51,69,121,2.1
7323,Derrico Peck\derrico-peck-1,2015-16,Maryland-Eastern Shore,G,32,5,489,56,74,.757,56,74,.757,0,0,,9,19,.474,37,53,90,28,22,21,25,66,121,4.2
7324,Marshall Harris\marshall-harris-1,2014-15,Citadel,G,27,15,550,35,70,.500,13,26,.500,22,44,.500,29,32,.906,9,25,34,77,27,0,53,42,121,4.1
7325,Jermaine Haley\jermaine-haley-1,2016-17,New Mexico State,G,31,16,656,38,99,.384,26,49,.531,12,50,.240,33,56,.589,20,68,88,46,14,4,48,60,121,2.2
7326,Trivante Bloodman\trivante-bloodman-1,2014-15,Mississippi State,G,32,12,589,38,94,.404,37,78,.474,1,16,.063,43,61,.705,11,36,47,64,25,1,50,46,120,2.6
7327,Taj Owens\taj-owens-1,2015-16,Radford,G,31,2,390,41,94,.436,33,73,.452,8,21,.381,30,35,.857,8,37,45,48,16,1,23,41,120,3.1
7328,Alex O'Connell\alex-oconnell-1,2017-18,Duke,G,36,1,378,42,88,.477,20,43,.465,22,45,.489,14,19,.737,18,32,50,19,11,4,16,16,120,2.8
7329,Kerry Weldon\kerry-weldon-1,2014-15,Massachusetts-Lowell,G,29,28,569,51,112,.455,51,111,.459,0,1,.000,18,61,.295,51,81,132,23,22,9,43,87,120,2.5
7330,JoJo Cooper\jojo-cooper-1,2015-16,Wagner,G,34,9,711,32,125,.256,25,81,.309,7,44,.159,49,73,.671,19,63,82,99,31,5,54,59,120,2.8
7331,Trey Pinkney\trey-pinkney-1,2014-15,Stephen F. Austin,G,34,34,885,34,96,.354,26,60,.433,8,36,.222,44,66,.667,7,52,59,131,46,0,51,94,120,3.7
7332,Drake Wilks\drake-wilks-1,2017-18,Grambling,G,28,5,384,44,102,.431,22,42,.524,22,60,.367,10,18,.556,21,41,62,11,12,4,27,33,120,2.6
7333,Bruno Skokna\bruno-skokna-1,2017-18,Loyola (IL),G,38,0,435,39,83,.470,22,34,.647,17,49,.347,25,29,.862,6,26,32,22,15,2,19,30,120,2.3
7334,John Davis\john-davis-5,2014-15,Furman,G,32,6,639,40,122,.328,24,66,.364,16,56,.286,24,41,.585,7,34,41,44,16,0,36,46,120,1.6
7335,Dennis Ashley\dennis-ashley-1,2017-18,Maine,G,31,0,405,40,119,.336,20,55,.364,20,64,.313,20,32,.625,8,38,46,19,13,0,21,31,120,1.9
7336,David Cohn\david-cohn-1,2013-14,Colorado State,G,31,5,464,31,81,.383,15,36,.417,16,45,.356,42,53,.792,4,33,37,29,12,0,14,35,120,2.8
7337,Javon Levi\javon-levi-1,2017-18,Texas-Rio Grande Valley,G,30,23,684,38,116,.328,31,89,.348,7,27,.259,37,61,.607,4,67,71,114,35,1,44,62,120,3.8
7338,Trey Dickerson\trey-dickerson-1,2017-18,Georgetown,G,27,0,363,47,110,.427,36,70,.514,11,40,.275,15,28,.536,9,23,32,57,22,2,39,51,120,2.7
7339,Larry Lewis\larry-lewis-1,2014-15,Texas-San Antonio,G,25,8,380,39,97,.402,34,78,.436,5,19,.263,37,59,.627,11,17,28,35,20,0,32,29,120,2.9
7340,Noah Knight\noah-knight-1,2014-15,Missouri-Kansas City,G,25,5,395,35,89,.393,24,48,.500,11,41,.268,39,67,.582,20,34,54,33,34,1,27,60,120,3.7
7341,Maurice Wiltz\maurice-wiltz-1,2014-15,Southern Illinois-Edwardsville,G,26,4,433,36,98,.367,17,42,.405,19,56,.339,29,42,.690,3,33,36,25,13,1,15,44,120,2.7
7342,Eric Monroe\eric-monroe-1,2017-18,Yale,G,31,12,526,41,102,.402,16,26,.615,25,76,.329,13,15,.867,5,44,49,61,17,4,43,41,120,2.7
7343,Colin Slater\colin-slater-1,2016-17,Tulane,G,30,9,390,34,118,.288,15,43,.349,19,75,.253,33,40,.825,11,18,29,25,9,1,28,40,120,1.5
7344,Isaac Cohen\isaac-cohen-1,2013-14,Columbia,G,34,34,945,47,85,.553,42,74,.568,5,11,.455,21,46,.457,38,139,177,101,21,1,53,63,120,4.5
7345,Karonn Davis\karonn-davis-1,2015-16,Niagara,G,28,2,573,38,143,.266,15,68,.221,23,75,.307,21,31,.677,15,45,60,54,12,1,25,49,120,2.2
7346,DeVince Boykins\devince-boykins-1,2015-16,Georgia Southern,G,30,5,454,46,107,.430,29,65,.446,17,42,.405,11,42,.262,19,45,64,29,14,3,39,58,120,1.7
7347,Cavit Havsa\cavit-havsa-1,2017-18,Fordham,G,30,10,746,46,102,.451,37,61,.607,9,41,.220,19,25,.760,15,42,57,93,27,4,43,41,120,4.1
7348,Devonne Pinkard\devonne-pinkard-1,2014-15,Delaware,G,29,7,568,39,116,.336,15,49,.306,24,67,.358,18,34,.529,13,70,83,22,5,6,20,48,120,2.2
7349,Kyron Cartwright\kyron-cartwright-1,2014-15,Providence,G,34,8,639,46,121,.380,42,88,.477,4,33,.121,23,31,.742,7,46,53,89,22,2,41,41,119,2.8
7350,Jordan Shepherd\jordan-shepherd-1,2016-17,Oklahoma,G,28,4,475,37,103,.359,21,56,.375,16,47,.340,29,38,.763,4,29,33,43,16,6,27,54,119,2.5
7351,Janeil Jenkins\janeil-jenkins-1,2015-16,Presbyterian,G,22,12,374,35,70,.500,22,41,.537,13,29,.448,36,40,.900,4,18,22,22,11,0,20,31,119,3.8
7352,Brandon Rachal\brandon-rachal-1,2017-18,Louisiana State,G,27,0,429,48,90,.533,47,85,.553,1,5,.200,22,40,.550,30,58,88,18,26,5,19,58,119,3.9
7353,Ivy Smith Jr.\ivy-smithjr-1,2016-17,Grambling,G,31,4,325,39,116,.336,35,86,.407,4,30,.133,37,49,.755,5,18,23,46,25,1,31,33,119,2.3
7354,DJ Clayton\dj-clayton-1,2014-15,Western Kentucky,G,29,2,466,45,130,.346,28,71,.394,17,59,.288,12,27,.444,34,36,70,21,10,5,25,36,119,2.2
7355,J.R. Lyle\jr-lyle-1,2015-16,Milwaukee,G,30,1,379,41,87,.471,26,40,.650,15,47,.319,22,33,.667,11,14,25,12,13,1,17,41,119,2.4
7356,Emmanuel Owootoah\emmanuel-owootoah-1,2014-15,Fresno State,G,31,12,706,38,101,.376,17,42,.405,21,59,.356,22,34,.647,8,30,38,49,41,1,42,64,119,2.6
7357,Ayron Hutton\ayron-hutton-1,2014-15,Quinnipiac,G,26,17,529,42,132,.318,12,48,.250,30,84,.357,5,11,.455,13,53,66,62,11,0,42,43,119,2.4
7358,Jamal Thomas\jamal-thomas-1,2016-17,Charleston Southern,G,24,6,342,36,95,.379,14,30,.467,22,65,.338,25,39,.641,15,44,59,18,15,3,25,55,119,2.8
7359,Connor Kern\connor-kern-1,2017-18,Arkansas State,G,32,6,526,39,105,.371,12,27,.444,27,78,.346,14,20,.700,8,38,46,25,12,4,24,44,119,2.1
7360,Will Darley\will-darley-1,2014-15,Maryland-Baltimore County,G,19,15,480,42,96,.438,30,63,.476,12,33,.364,23,34,.676,10,48,58,18,6,5,37,24,119,3.2
7361,Peter Jok\peter-jok-1,2013-14,Iowa,G,27,0,255,38,95,.400,22,49,.449,16,46,.348,27,34,.794,5,20,25,19,9,3,13,18,119,2.9
7362,Jalen James\jalen-james-1,2017-18,San Jose State,G,27,19,545,41,124,.331,23,64,.359,18,60,.300,19,20,.950,6,55,61,66,14,4,51,49,119,2.3
7363,Daiquan Walker\daiquan-walker-1,2013-14,Central Florida,G,30,5,436,43,113,.381,29,63,.460,14,50,.280,19,25,.760,6,34,40,48,7,3,28,23,119,2.5
7364,DelFincko Bogan\delfincko-bogan-1,2015-16,Jacksonville State,G,30,0,391,43,120,.358,19,52,.365,24,68,.353,9,12,.750,9,30,39,33,16,1,27,33,119,2.2
7365,Justin Foreman\justin-foreman-1,2013-14,Grand Canyon,G,23,2,451,33,81,.407,19,40,.475,14,41,.341,39,65,.600,15,45,60,21,14,3,16,47,119,3.7
7366,Austin Anderson\austin-anderson-1,2014-15,Presbyterian,G,23,15,593,43,124,.347,26,57,.456,17,67,.254,16,22,.727,11,57,68,65,13,2,40,26,119,3.5
7367,Ny Redding\ny-redding-1,2017-18,Wyoming,G,32,9,445,28,78,.359,15,45,.333,13,33,.394,50,57,.877,5,28,33,42,15,0,28,49,119,2.5
7368,Keith Frazier\keith-frazier-1,2015-16,Southern Methodist,G,10,7,288,44,98,.449,29,57,.509,15,41,.366,16,20,.800,7,37,44,19,9,5,16,20,119,8.4
7369,Kenny Wormley\kenny-wormley-1,2017-18,Hofstra,G,30,12,444,42,116,.362,31,92,.337,11,24,.458,24,36,.667,8,31,39,39,9,0,33,63,119,1.4
7370,Kimar Williams\kimar-williams-1,2016-17,Florida International,G,18,14,460,42,108,.389,37,86,.430,5,22,.227,30,45,.667,7,42,49,48,19,0,28,36,119,4.6
7371,Jason Dunne\jason-dunne-1,2015-16,Hartford,G,33,8,504,44,102,.431,32,52,.615,12,50,.240,19,27,.704,19,36,55,26,20,2,21,62,119,2.4
7372,Igor Hadziomerovic\igor-hadziomerovic-1,2013-14,Boise State,G,32,16,581,49,124,.395,46,106,.434,3,18,.167,18,33,.545,25,69,94,49,16,2,29,54,119,2.7
7373,Clive Vaughan\clive-vaughan-1,2015-16,Morgan State,G,31,1,331,44,113,.389,23,46,.500,21,67,.313,10,20,.500,12,29,41,7,4,0,19,35,119,1.5
7374,Bilal Abdur-Rahim\bilal-abdur-rahim-1,2016-17,Southern Mississippi,G,26,1,312,46,86,.535,43,77,.558,3,9,.333,24,43,.558,24,43,67,23,12,1,21,54,119,3.3
7375,Tilman Dunbar\tilman-dunbar-1,2013-14,Navy,G,10,10,309,42,96,.438,42,91,.462,0,5,.000,35,51,.686,2,28,30,50,8,1,27,19,119,8.1
7376,Trevor Moore\trevor-moore-1,2017-18,Cincinnati,G,35,0,419,35,105,.333,9,23,.391,26,82,.317,23,34,.676,14,47,61,14,18,2,15,40,119,2.2
7377,Desonta Bradford\desonta-bradford-1,2014-15,East Tennessee State,G,29,1,355,36,85,.424,28,63,.444,8,22,.364,39,54,.722,6,26,32,29,13,5,29,33,119,2.6
7378,Gunnar Olafsson\gunnar-olafsson-1,2016-17,St. Francis (NY),G,27,23,602,45,116,.388,29,57,.509,16,59,.271,13,30,.433,46,91,137,17,19,4,25,66,119,3.4
7379,Markell Johnson\markell-johnson-1,2016-17,North Carolina State,G,30,3,611,46,122,.377,34,74,.459,12,48,.250,15,26,.577,15,34,49,68,26,10,32,56,119,3.2
7380,Mladen Djordjevic\mladen-djordjevic-1,2016-17,San Francisco,G,33,26,646,45,105,.429,27,54,.500,18,51,.353,11,26,.423,3,67,70,73,26,2,40,59,119,2.9
7381,Maliek White\maliek-white-1,2017-18,Providence,G,25,1,326,42,95,.442,26,48,.542,16,47,.340,19,31,.613,4,22,26,19,17,3,18,21,119,3.2
7382,Antonio Gillespie\antonio-gillespie-1,2017-18,Morgan State,G,31,15,435,40,105,.381,9,21,.429,31,84,.369,8,10,.800,11,27,38,14,11,1,15,56,119,2.0
7383,Kane Williams\kane-williams-1,2017-18,Georgia State,G,34,2,367,32,69,.464,31,57,.544,1,12,.083,54,76,.711,13,34,47,42,21,2,30,52,119,2.8
7384,Eric Bowles\eric-bowles-1,2017-18,Central Connecticut State,G,29,27,746,42,93,.452,35,70,.500,7,23,.304,28,52,.538,20,41,61,83,25,1,46,66,119,3.4
7385,Ethan Stair\ethan-stair-1,2017-18,Mercer,G,20,5,353,43,91,.473,31,59,.525,12,32,.375,20,28,.714,11,38,49,25,15,1,30,36,118,3.8
7386,Alex Hobbs\alex-hobbs-1,2016-17,Boise State,G,26,0,330,43,93,.462,33,68,.485,10,25,.400,22,31,.710,7,32,39,18,6,2,23,30,118,2.5
7387,Aaron Young\aaron-young-2,2017-18,Princeton,G,28,3,486,38,97,.392,9,19,.474,29,78,.372,13,13,1.000,3,22,25,30,10,0,14,45,118,2.6
7388,Tai Webster\tai-webster-1,2014-15,Nebraska,G,30,4,550,39,109,.358,27,57,.474,12,52,.231,28,38,.737,12,45,57,35,21,4,39,64,118,2.0
7389,Jeremy Miller\jeremy-miller-2,2016-17,Northeastern,G,16,13,299,43,80,.538,27,43,.628,16,37,.432,16,25,.640,21,42,63,5,4,17,9,42,118,6.0
7390,Andris Misters\andris-misters-1,2016-17,Jacksonville,G,26,8,369,42,88,.477,22,39,.564,20,49,.408,14,15,.933,5,39,44,19,9,1,21,27,118,3.0
7391,Kemy Osse\kemy-osse-1,2013-14,Little Rock,G,24,0,345,41,109,.376,25,53,.472,16,56,.286,20,31,.645,10,40,50,11,11,2,22,27,118,2.5
7392,Matthew Grant\matthew-grant-1,2014-15,Detroit Mercy,G,33,20,679,38,116,.328,19,50,.380,19,66,.288,23,30,.767,11,64,75,54,22,5,22,62,118,2.8
7393,Matt Smith\matt-smith-8,2015-16,Cal State Bakersfield,G,26,1,377,50,85,.588,50,85,.588,0,0,,18,43,.419,37,36,73,6,14,19,15,68,118,3.6
7394,Caleb Wood\caleb-wood-2,2016-17,Pennsylvania,G,20,10,327,38,95,.400,11,23,.478,27,72,.375,15,16,.938,8,26,34,17,10,0,36,29,118,2.7
7395,Tony Wills\tony-willis-1,2013-14,Illinois State,G,33,0,534,37,94,.394,33,78,.423,4,16,.250,40,53,.755,30,61,91,20,22,5,19,76,118,2.8
7396,Maliik Love\malik-love-1,2013-14,Cal Poly,G,34,5,554,39,110,.355,36,100,.360,3,10,.300,37,60,.617,25,40,65,54,16,4,33,43,118,2.5
7397,Montigo Alford\montigo-alford-1,2015-16,Boise State,G,29,9,417,37,102,.363,19,41,.463,18,61,.295,26,36,.722,1,36,37,44,15,4,35,51,118,2.1
7398,Kerry Weldon\kerry-weldon-1,2013-14,Massachusetts-Lowell,G,28,28,646,49,102,.480,49,102,.480,0,0,,20,65,.308,60,90,150,26,29,22,41,89,118,3.7
7399,Dallas Cameron\dallas-cameron-1,2015-16,Stephen F. Austin,G,34,3,603,37,107,.346,23,56,.411,14,51,.275,30,42,.714,14,21,35,56,12,5,17,48,118,2.6
7400,Jarrel Marshall\jarrel-marshall-1,2016-17,Portland,G,18,8,358,43,100,.430,39,80,.488,4,20,.200,28,35,.800,7,44,51,8,10,10,15,29,118,4.3
7401,Anthony Lindauer\anthony-lindauer-1,2014-15,High Point,G,30,1,366,37,90,.411,12,30,.400,25,60,.417,19,19,1.000,3,42,45,27,18,3,28,34,118,2.7
7402,James Westbrook\james-westbrook-1,2016-17,Prairie View,G,18,7,388,37,92,.402,27,59,.458,10,33,.303,34,47,.723,4,46,50,22,18,1,39,36,118,3.4
7403,Nate Hickman\nate-hickman-1,2015-16,Columbia,G,31,0,359,37,79,.468,25,42,.595,12,37,.324,32,49,.653,9,23,32,17,12,0,24,43,118,2.1
7404,John Johnson\john-johnson-3,2014-15,Penn State,G,16,0,330,33,77,.429,20,42,.476,13,35,.371,39,55,.709,6,21,27,23,11,0,17,20,118,5.2
7405,Damari Milstead\damari-milstead-1,2017-18,Grand Canyon,G,26,0,245,30,64,.469,20,45,.444,10,19,.526,48,57,.842,3,16,19,28,11,2,28,21,118,3.2
7406,Tyson Smith\tyson-smith-1,2015-16,Loyola (IL),G,25,9,424,35,104,.337,15,48,.313,20,56,.357,28,38,.737,5,26,31,24,13,4,17,44,118,2.6
7407,Kendall Smith\kendall-smith-2,2013-14,Nevada-Las Vegas,G,31,13,447,46,113,.407,39,93,.419,7,20,.350,19,39,.487,8,33,41,47,11,2,41,27,118,1.9
7408,Kendall Griffin\kendall-griffin-1,2013-14,Wright State,G,23,17,567,34,85,.400,21,41,.512,13,44,.295,37,48,.771,12,51,63,48,20,4,30,44,118,4.4
7409,Elijah Joiner\elijah-joiner-1,2017-18,Tulsa,G,31,1,522,32,108,.296,8,41,.195,24,67,.358,30,49,.612,9,56,65,63,9,0,45,53,118,1.9
7410,Allante Holston\allante-holston-1,2015-16,North Texas,G,31,13,575,35,87,.402,34,81,.420,1,6,.167,46,66,.697,7,66,73,28,16,7,23,56,117,2.6
7411,Jovan Austin\jovan-austin-1,2014-15,Bowling Green State,G,33,5,545,36,95,.379,29,73,.397,7,22,.318,38,60,.633,7,40,47,87,16,3,63,36,117,2.3
7412,Pookie Powell\rashawn-powell-1,2014-15,Memphis,G,27,11,416,43,114,.377,28,62,.452,15,52,.288,16,24,.667,4,32,36,72,20,4,54,30,117,2.6
7413,Anastasios Demogerontas\anastasios-demogerontas-1,2017-18,Northern Illinois,G,30,0,450,44,94,.468,37,72,.514,7,22,.318,22,33,.667,23,40,63,21,20,3,28,39,117,2.9
7414,Ashley Williams\ashley-williams-1,2017-18,Western Carolina,G,25,12,261,33,91,.363,17,43,.395,16,48,.333,35,42,.833,19,16,35,12,7,3,12,31,117,3.0
7415,Josh Delaney\josh-delaney-1,2016-17,Sam Houston State,G,30,0,334,39,103,.379,10,22,.455,29,81,.358,10,15,.667,3,19,22,25,11,0,18,36,117,2.1
7416,Algie Key\algie-kay-1,2013-14,Alabama,G,32,9,492,40,99,.404,39,92,.424,1,7,.143,36,54,.667,24,48,72,45,17,4,25,53,117,2.9
7417,David Knudsen\david-knudsen-1,2015-16,Marist,G,27,3,369,42,123,.341,19,47,.404,23,76,.303,10,11,.909,14,23,37,19,7,3,20,30,117,2.0
7418,Kelton Ford\kelton-ford-1,2013-14,Troy,G,31,0,386,31,88,.352,19,44,.432,12,44,.273,43,75,.573,7,26,33,31,16,1,24,33,117,2.2
7419,Michael Williams\michael-williams-6,2015-16,Texas Christian,G,28,15,743,42,119,.353,30,70,.429,12,49,.245,21,30,.700,9,50,59,74,12,2,32,66,117,2.7
7420,Julius Johnson\julius-johnson-1,2017-18,Richmond,G,32,0,510,39,99,.394,15,29,.517,24,70,.343,15,19,.789,10,43,53,26,17,1,16,58,117,2.4
7421,Darrick Wood\darrick-wood-1,2014-15,DePaul,G,27,0,364,45,124,.363,30,79,.380,15,45,.333,12,24,.500,11,28,39,29,9,1,42,45,117,1.1
7422,Jeffrey Gary\jeffrey-gary-1,2017-18,North Carolina-Wilmington,G,32,5,543,41,108,.380,16,34,.471,25,74,.338,10,12,.833,12,40,52,42,13,1,30,36,117,2.4
7423,Tione Womack\tione-womack-1,2013-14,Houston,G,32,9,620,44,101,.436,31,68,.456,13,33,.394,16,26,.615,13,51,64,66,17,2,33,61,117,2.9
7424,Cody Mann\cody-mann-1,2013-14,Florida International,G,20,13,481,40,97,.412,23,55,.418,17,42,.405,20,31,.645,8,39,47,44,17,0,24,26,117,4.6
7425,B.J. Miller\bj-miller-2,2015-16,Troy,G,31,0,529,45,105,.429,36,63,.571,9,42,.214,18,26,.692,15,48,63,54,21,3,45,44,117,2.6
7426,Nasir Core\nasir-core-1,2016-17,Florida A&M,G,28,1,419,24,79,.304,21,57,.368,3,22,.136,66,85,.776,6,43,49,44,19,4,47,50,117,2.4
7427,Jaylen Babb-Harrison\jaylen-babb-harrison-1,2014-15,Eastern Kentucky,G,21,4,264,42,105,.400,21,43,.488,21,62,.339,12,15,.800,8,25,33,21,15,0,16,20,117,3.7
7428,Anfernee Hampton\anfernee-hampton-1,2017-18,Southern Mississippi,G,28,2,324,41,110,.373,31,69,.449,10,41,.244,25,33,.758,15,37,52,8,9,4,12,23,117,2.5
7429,Jamonte Graham\jamonte-graham-1,2013-14,Tennessee State,G,26,6,438,41,112,.366,30,69,.435,11,43,.256,24,35,.686,11,25,36,35,11,1,31,51,117,1.9
7430,C.J. Wiggins\cj-wiggins-1,2017-18,North Carolina Central,G,25,8,373,38,101,.376,23,55,.418,15,46,.326,25,36,.694,3,19,22,54,18,0,25,10,116,3.6
7431,Allante Holston\allante-holston-1,2017-18,North Texas,G,37,14,678,44,99,.444,39,86,.453,5,13,.385,23,35,.657,29,80,109,39,16,5,36,50,116,2.6
7432,James Palmer\james-palmer-1,2015-16,Miami (FL),G,34,0,394,39,107,.364,26,60,.433,13,47,.277,25,37,.676,11,28,39,25,14,5,15,19,116,2.4
7433,Jure Span\jure-span-1,2016-17,South Carolina Upstate,G,33,11,771,43,128,.336,20,44,.455,23,84,.274,7,16,.438,16,52,68,86,19,6,40,75,116,2.4
7434,Keith Matthews\keith-matthews-2,2017-18,Stetson,G,31,0,322,46,98,.469,38,68,.559,8,30,.267,16,33,.485,18,49,67,10,12,2,18,35,116,2.4
7435,Jaleel Queary\jaleel-queary-1,2013-14,Tennessee State,G,27,18,529,46,105,.438,46,104,.442,0,1,.000,24,53,.453,30,40,70,28,11,5,37,67,116,1.9
7436,Jaylon Tate\jaylon-tate-1,2014-15,Illinois,G,32,13,652,28,76,.368,27,64,.422,1,12,.083,59,70,.843,2,37,39,92,26,3,45,59,116,3.3
7437,Hunter Crist\hunter-crist-1,2017-18,Green Bay,G,30,4,443,38,94,.404,19,45,.422,19,49,.388,21,33,.636,7,44,51,36,14,1,39,73,116,1.7
7438,Taylor Perry\taylor-perry-1,2015-16,Western Michigan,G,32,19,701,37,112,.330,24,69,.348,13,43,.302,29,38,.763,18,83,101,38,19,7,37,53,116,2.5
7439,Garet Beal\garet-beal-1,2013-14,Maine,G,26,9,366,40,105,.381,29,57,.509,11,48,.229,25,34,.735,8,43,51,23,13,7,31,47,116,2.2
7440,Andre Statam\andre-statam-1,2015-16,Jacksonville State,G,31,0,374,43,109,.394,20,37,.541,23,72,.319,7,8,.875,16,36,52,12,2,2,12,69,116,1.6
7441,Jalen James\jalen-james-1,2015-16,San Jose State,G,23,6,386,38,105,.362,27,61,.443,11,44,.250,29,42,.690,4,40,44,36,10,5,37,45,116,2.2
7442,Devin Gage\devin-gage-1,2016-17,DePaul,G,29,0,346,45,95,.474,40,74,.541,5,21,.238,21,29,.724,6,19,25,27,22,7,30,37,116,2.6
7443,Brandon Randolph\brandon-randolph-2,2017-18,Arizona,G,31,4,361,41,107,.383,26,61,.426,15,46,.326,19,26,.731,4,22,26,26,12,4,21,37,116,2.0
7444,Avery Dingman\avery-dingman-1,2014-15,Creighton,G,28,17,552,35,104,.337,17,48,.354,18,56,.321,28,43,.651,12,66,78,28,7,10,25,53,116,2.4
7445,Osa Izevbuwa\osa-izevbuwa-1,2016-17,NJIT,G,24,19,375,43,115,.374,25,59,.424,18,56,.321,12,14,.857,12,25,37,9,12,0,18,25,116,2.4
7446,Austin Anderson\austin-anderson-1,2013-14,Presbyterian,G,26,16,729,39,113,.345,21,54,.389,18,59,.305,20,27,.741,3,64,67,92,19,1,52,35,116,3.4
7447,Clay Yeo\clay-yeo-1,2013-14,Valparaiso,G,28,1,360,42,94,.447,22,50,.440,20,44,.455,12,17,.706,9,31,40,27,8,3,24,40,116,2.5
7448,Andre Statam\andre-statam-1,2016-17,Jacksonville State,G,34,0,350,38,100,.380,16,43,.372,22,57,.386,18,25,.720,18,55,73,9,9,1,20,54,116,1.8
7449,Dauson Womack\dauson-womack-1,2013-14,Houston Baptist,G,28,9,525,38,94,.404,36,86,.419,2,8,.250,38,62,.613,46,89,135,25,27,11,44,57,116,3.6
7450,Mark Hughes\mark-hughes-1,2015-16,Wright State,G,33,20,636,37,88,.420,19,36,.528,18,52,.346,24,33,.727,9,54,63,41,22,6,17,68,116,3.0
7451,Kasim Chandler\kasim-chandler-1,2014-15,Quinnipiac,G,26,13,460,28,99,.283,26,85,.306,2,14,.143,58,71,.817,26,41,67,74,10,1,51,31,116,3.2
7452,Tim Abruzzo\tim-abruzzo-1,2016-17,Navy,G,24,5,347,39,120,.325,21,37,.568,18,83,.217,19,26,.731,10,45,55,14,12,5,13,21,115,2.8
7453,Brandon Roberts\brandon-roberts-2,2013-14,Samford,G,29,4,345,44,114,.386,36,73,.493,8,41,.195,19,28,.679,3,24,27,18,4,0,29,26,115,1.2
7454,Langston Morris-Walker\langston-morris-walker-1,2013-14,Oregon State,G,29,17,521,37,89,.416,18,36,.500,19,53,.358,22,29,.759,18,44,62,10,7,1,15,45,115,2.5
7455,Jamal Shabazz\jamal-shabazz-1,2014-15,Samford,G,26,0,393,41,106,.387,30,73,.411,11,33,.333,22,42,.524,32,56,88,16,15,16,31,65,115,2.6
7456,Peyton Broughton\peyton-broughton-1,2017-18,Eastern Kentucky,G,28,4,447,38,96,.396,23,57,.404,15,39,.385,24,29,.828,16,26,42,22,10,2,15,32,115,2.8
7457,Anthony Thompson\anthony-thompson-2,2014-15,Holy Cross,G,19,13,448,36,110,.327,17,50,.340,19,60,.317,24,41,.585,14,26,40,37,24,0,20,38,115,4.1
7458,Keith Pickens\keith-pickens-1,2013-14,Missouri State,G,19,4,364,38,76,.500,38,75,.507,0,1,.000,39,60,.650,30,70,100,13,15,25,20,39,115,6.1
7459,Kameron Chatman\kameron-chatman-1,2014-15,Michigan,G,32,15,486,42,132,.318,32,94,.340,10,38,.263,21,31,.677,20,61,81,22,13,6,29,46,115,1.7
7460,Victor Sanders\victor-sanders-1,2014-15,Idaho,G,30,1,379,36,91,.396,15,37,.405,21,54,.389,22,35,.629,11,39,50,28,10,3,29,42,115,2.2
7461,Dontel Highsmith\dontel-highsmith-1,2013-14,Northern Illinois,G,11,8,251,41,76,.539,33,53,.623,8,23,.348,25,40,.625,14,25,39,12,11,2,10,17,115,8.5
7462,Hassani Gravett\hassani-gravett-1,2016-17,South Carolina,G,35,3,594,40,134,.299,25,65,.385,15,69,.217,20,31,.645,16,41,57,49,14,1,37,48,115,1.4
7463,Chris Atkinson\chris-atkinson-1,2015-16,Canisius,G,33,1,536,35,139,.252,16,47,.340,19,92,.207,26,35,.743,1,40,41,63,27,0,27,52,115,1.9
7464,Tamron Manning\tamron-manning-1,2014-15,Marshall,G,31,6,503,42,119,.353,35,88,.398,7,31,.226,24,43,.558,9,50,59,48,29,2,41,51,115,2.1
7465,Darin Johnson\darin-johnson-1,2014-15,Washington,G,26,1,447,32,107,.299,24,64,.375,8,43,.186,43,55,.782,10,32,42,19,8,4,17,32,115,2.3
7466,Jeremiah Jones\jeremiah-jones-1,2015-16,Duquesne,G,12,12,311,39,76,.513,27,45,.600,12,31,.387,25,38,.658,15,31,46,31,8,0,18,25,115,7.8
7467,A.C. Reid\ac-reid-1,2014-15,Liberty,G,29,5,525,37,130,.285,8,25,.320,29,105,.276,12,17,.706,6,45,51,32,11,2,30,48,115,1.4
7468,LaQuentin Collins\laquentin-collins-1,2016-17,Southern,G,24,17,404,43,114,.377,28,74,.378,15,40,.375,14,20,.700,16,38,54,17,8,5,19,26,115,2.8
7469,Matt Derenbecker\matt-derenbecker-1,2013-14,New Orleans,G,11,9,297,41,99,.414,26,50,.520,15,49,.306,18,28,.643,7,55,62,10,4,1,11,28,115,6.3
7470,Curtis Jones\curtis-jones-1,2016-17,Indiana,G,33,1,370,38,108,.352,17,48,.354,21,60,.350,18,25,.720,8,36,44,31,14,3,24,28,115,2.1
7471,Kalin Fisher\kalin-fisher-1,2015-16,Hampton,G,32,0,403,36,116,.310,26,70,.371,10,46,.217,33,55,.600,17,28,45,20,10,2,18,36,115,1.6
7472,Danny Evans\danny-evans-2,2017-18,Maine,G,31,8,419,40,103,.388,23,49,.469,17,54,.315,18,25,.720,17,48,65,24,16,4,26,38,115,2.5
7473,Christian Sanders\christian-sanders-1,2015-16,Stanford,G,27,23,605,32,106,.302,25,70,.357,7,36,.194,44,53,.830,6,54,60,70,16,0,42,41,115,2.9
7474,Joe Burton\joe-burton-3,2017-18,Valparaiso,G,10,10,251,39,81,.481,22,36,.611,17,45,.378,20,26,.769,8,26,34,8,1,6,16,14,115,7.4
7475,Kendal Yancy\kendal-yancy-1,2013-14,Texas,G,34,10,410,38,93,.409,32,76,.421,6,17,.353,33,59,.559,25,49,74,30,12,3,18,34,115,2.7
7476,Austin Williams\austin-williams-1,2014-15,North Carolina A&T,G,29,13,520,41,130,.315,37,106,.349,4,24,.167,29,68,.426,22,43,65,68,35,2,85,61,115,1.0
7477,Jonathan Mulmore\jonathan-mulmore-1,2016-17,Georgetown,G,32,12,646,30,84,.357,20,55,.364,10,29,.345,45,60,.750,6,37,43,60,17,4,37,74,115,2.3
7478,Cole Stefan\cole-stefan-1,2013-14,North Dakota,G,31,0,429,38,112,.339,15,39,.385,23,73,.315,16,24,.667,4,30,34,31,9,4,23,58,115,1.5
7479,Arthur Wade\arthur-wade-1,2015-16,Alabama A&M,G,29,12,625,37,103,.359,19,41,.463,18,62,.290,22,32,.688,22,33,55,29,25,8,20,82,114,2.6
7480,Cameron Dobbs\cameron-dobbs-1,2013-14,Mississippi Valley State,G,24,0,213,41,109,.376,21,39,.538,20,70,.286,12,18,.667,3,7,10,11,10,0,8,16,114,2.5
7481,Trevin Woods\trevin-woods-1,2015-16,Long Island University,G,30,0,498,39,126,.310,16,35,.457,23,91,.253,13,19,.684,30,64,94,10,18,12,20,66,114,2.2
7482,Jorge Perez-Laham\jorge-perez-laham-1,2013-14,High Point,G,31,20,628,40,110,.364,28,70,.400,12,40,.300,22,28,.786,3,53,56,105,16,1,54,52,114,2.7
7483,Marlin Davis\marlin-davis-1,2016-17,Texas State,G,36,0,477,43,115,.374,33,72,.458,10,43,.233,18,35,.514,5,38,43,54,16,1,31,30,114,2.0
7484,Deleon Brown\deleon-brown-1,2017-18,Colorado,G,23,7,418,39,112,.348,20,52,.385,19,60,.317,17,24,.708,4,23,27,18,11,4,25,48,114,1.8
7485,Delundre Dixon\delundre-dixon-1,2016-17,Chicago State,G,25,13,551,42,108,.389,30,60,.500,12,48,.250,18,31,.581,11,44,55,42,13,1,35,51,114,2.3
7486,Donovan Greer\donovan-greer-1,2017-18,NJIT,G,25,0,332,39,105,.371,11,26,.423,28,79,.354,8,10,.800,12,24,36,24,8,0,13,41,114,2.7
7487,Kevin Larkin\kevin-larkin-1,2017-18,Niagara,G,28,7,366,43,125,.344,26,68,.382,17,57,.298,11,15,.733,15,58,73,12,13,3,16,39,114,2.2
7488,Shawn Jones\shawn-jones-3,2017-18,Massachusetts-Lowell,G,28,1,408,35,98,.357,30,75,.400,5,23,.217,39,49,.796,16,18,34,45,16,3,30,41,114,2.7
7489,Thomas Booker\thomas-booker-1,2017-18,South Carolina Upstate,G,28,1,303,42,100,.420,31,76,.408,11,24,.458,19,21,.905,24,15,39,11,17,1,15,34,114,2.8
7490,Isaiah Ivey\isaiah-ivey-1,2014-15,Gardner-Webb,G,33,3,508,40,104,.385,27,55,.491,13,49,.265,21,28,.750,17,49,66,30,11,9,17,34,114,2.7
7491,Mitch Peterson\mitch-peterson-1,2017-18,Kent State,G,33,19,629,43,124,.347,27,62,.435,16,62,.258,12,22,.545,27,82,109,22,24,3,20,41,114,2.7
7492,Kofi Andoh\kofi-andoh-1,2016-17,Howard,G,34,8,546,31,84,.369,29,70,.414,2,14,.143,50,71,.704,24,63,87,30,21,2,35,48,114,2.5
7493,Lenell Brown\lenell-brown-1,2013-14,Central Arkansas,G,29,1,396,40,109,.367,19,41,.463,21,68,.309,13,26,.500,6,28,34,28,12,4,36,35,114,1.6
7494,Mike Laster\mike-laster-1,2014-15,Ohio,G,30,17,563,43,99,.434,39,88,.443,4,11,.364,24,32,.750,23,29,52,10,9,1,25,38,114,2.0
7495,Nikolas Skouen\nikolas-skouen-1,2013-14,Pepperdine,G,30,3,385,37,101,.366,14,29,.483,23,72,.319,17,17,1.000,5,35,40,18,8,3,22,33,114,2.0
7496,Cody Kelley\cody-kelley-1,2016-17,Wyoming,G,34,1,433,38,101,.376,13,36,.361,25,65,.385,13,24,.542,10,36,46,50,22,1,29,57,114,2.3
7497,Devonne Pinkard\devonne-pinkard-1,2015-16,Delaware,G,22,13,558,37,114,.325,16,40,.400,21,74,.284,19,26,.731,17,63,80,17,7,3,16,55,114,2.7
7498,Christion Thompson\christion-thompson-1,2015-16,Rhode Island,G,29,1,525,35,98,.357,15,37,.405,20,61,.328,24,40,.600,23,55,78,32,18,4,24,68,114,2.7
7499,Dimitri Floras\dimitri-floras-1,2015-16,Quinnipiac,G,29,1,404,38,139,.273,17,69,.246,21,70,.300,17,26,.654,17,27,44,50,16,0,33,45,114,1.7
7500,Dominique Dunning\dominique-dunning-1,2014-15,UC-Irvine,G,27,1,422,42,93,.452,35,74,.473,7,19,.368,23,34,.676,32,75,107,23,13,7,20,47,114,3.8
7501,Maxwell Evans\maxwell-evans-1,2017-18,Vanderbilt,G,29,15,378,34,95,.358,16,41,.390,18,54,.333,28,33,.848,15,41,56,14,9,0,25,33,114,2.2
7502,Ethan Layer\ethan-layer-1,2014-15,Liberty,G,32,3,358,32,85,.376,3,6,.500,29,79,.367,21,27,.778,5,25,30,24,7,2,14,39,114,2.2
7503,JT Gibson\jt-gibson-1,2016-17,Omaha,G,29,3,346,40,112,.357,13,30,.433,27,82,.329,7,14,.500,7,32,39,20,12,1,19,28,114,2.1
7504,Lawrence Brown\lawrence-brown-2,2015-16,Mercer,G,33,0,414,46,83,.554,46,83,.554,0,0,,22,31,.710,35,46,81,5,10,7,18,59,114,2.6
7505,Corey Littlejohn\corey-littlejohn-1,2014-15,North Carolina-Asheville,G,29,12,516,36,100,.360,23,53,.434,13,47,.277,28,37,.757,28,53,81,39,29,3,42,56,113,2.9
7506,Scott Morris\scott-morris-1,2013-14,New Hampshire,G,27,7,433,37,119,.311,4,20,.200,33,99,.333,6,7,.857,0,31,31,13,7,2,14,27,113,1.7
7507,Lawrence Cooks\lawrence-cooks-1,2013-14,Hampton,G,29,0,369,33,90,.367,21,61,.344,12,29,.414,35,45,.778,11,35,46,21,14,2,28,29,113,2.3
7508,Caleb Morris\caleb-morris-1,2017-18,Air Force,G,23,1,278,39,90,.433,21,38,.553,18,52,.346,17,24,.708,7,45,52,20,3,2,14,27,113,3.3
7509,Tre Campbell\tre-campbell-1,2014-15,Georgetown,G,33,1,452,37,98,.378,16,40,.400,21,58,.362,18,26,.692,4,30,34,29,19,0,10,30,113,2.6
7510,Bryce Peters\bryce-peters-2,2016-17,Colorado,G,24,1,379,40,102,.392,27,63,.429,13,39,.333,20,36,.556,7,26,33,24,10,1,17,37,113,2.5
7511,Ridell Camidge\ridell-camidge-1,2015-16,Charlotte,G,28,6,404,40,135,.296,16,40,.400,24,95,.253,9,18,.500,9,45,54,22,7,0,25,31,113,1.3
7512,Mo Williams\mo-williams-2,2013-14,Army,G,31,19,531,31,88,.352,11,29,.379,20,59,.339,31,38,.816,4,26,30,22,11,0,28,54,113,1.6
7513,Dantez Walton\dantez-walton-1,2016-17,Northern Kentucky,G,29,1,303,39,104,.375,19,35,.543,20,69,.290,15,21,.714,22,46,68,13,10,5,14,36,113,2.6
7514,Jermaine Ruttley\jermaine-ruttley-1,2015-16,Little Rock,G,35,17,642,40,109,.367,33,74,.446,7,35,.200,26,33,.788,17,85,102,54,19,1,24,64,113,2.7
7515,Justin Philippe\justin-philippe-1,2013-14,Incarnate Word,G,26,0,329,41,79,.519,41,79,.519,0,0,,31,42,.738,27,52,79,22,4,4,29,40,113,3.1
7516,Dederick Lee\dederick-lee-1,2017-18,South Alabama,G,32,2,515,36,102,.353,5,14,.357,31,88,.352,10,21,.476,6,47,53,71,14,3,45,53,113,2.2
7517,Matt Zignorski\matt-zignorski-1,2015-16,Holy Cross,G,32,0,435,41,113,.363,21,52,.404,20,61,.328,11,15,.733,6,24,30,21,17,1,22,25,113,1.9
7518,Joe Bramanti\joe-bramanti-1,2014-15,New Hampshire,G,25,19,630,32,79,.405,22,56,.393,10,23,.435,39,69,.565,15,68,83,61,19,0,38,64,113,3.5
7519,Jaylen Babb-Harrison\jaylen-babb-harrison-1,2016-17,Eastern Kentucky,G,9,9,276,36,102,.353,18,40,.450,18,62,.290,23,24,.958,5,40,45,20,13,1,17,19,113,8.2
7520,Tim Smallwood\tim-smallwood-1,2014-15,Omaha,G,25,6,380,39,109,.358,21,40,.525,18,69,.261,17,34,.500,8,43,51,23,19,3,23,41,113,2.5
7521,Dinjiyl Walker\dinjiyl-walker-1,2014-15,Oklahoma,G,34,0,360,41,113,.363,27,60,.450,14,53,.264,17,27,.630,8,24,32,18,12,3,27,52,113,1.1
7522,Jamall Robinson\jamall-robinson-1,2016-17,Hofstra,G,30,3,552,40,112,.357,12,38,.316,28,74,.378,5,11,.455,38,38,76,12,11,1,14,44,113,2.5
7523,Nathan Harries\nathan-harries-1,2016-17,Colgate,G,22,9,418,44,99,.444,32,68,.471,12,31,.387,13,21,.619,5,40,45,31,10,3,19,42,113,3.3
7524,Isaiah Ivey\isaiah-ivey-1,2013-14,Gardner-Webb,G,24,0,360,32,97,.330,10,30,.333,22,67,.328,27,38,.711,3,28,31,7,11,9,8,28,113,2.8
7525,Prince Ali\prince-ali-1,2015-16,UCLA,G,29,0,342,40,103,.388,28,63,.444,12,40,.300,21,37,.568,5,26,31,11,11,3,23,36,113,1.6
7526,Brandon Vega\brandon-vega-1,2013-14,Winthrop,G,32,1,416,39,84,.464,38,81,.469,1,3,.333,34,44,.773,12,36,48,61,11,1,37,37,113,2.7
7527,Chace Franklin\chace-franklin-1,2017-18,Jackson State,G,10,5,265,37,110,.336,23,59,.390,14,51,.275,24,34,.706,12,28,40,24,10,3,8,25,112,7.4
7528,Jared Klein\jared-klein-1,2013-14,Western Michigan,G,33,0,384,38,81,.469,21,44,.477,17,37,.459,19,21,.905,1,36,37,16,6,0,28,22,112,1.9
7529,Ryan Pearson\ryan-pearson-2,2016-17,Navy,G,28,6,374,40,122,.328,19,38,.500,21,84,.250,11,16,.688,3,24,27,18,9,0,31,22,112,1.1
7530,Herb McGee\herb-mcgee-1,2016-17,South Alabama,G,31,2,581,37,115,.322,17,47,.362,20,68,.294,18,33,.545,4,55,59,32,24,1,37,61,112,1.5
7531,C.J. Anderson\cj-anderson-3,2015-16,Massachusetts,G,32,11,774,38,102,.373,29,67,.433,9,35,.257,27,36,.750,18,111,129,67,25,3,37,54,112,3.5
7532,Tramaine Isabell\tramaine-isabell-1,2014-15,Missouri,G,27,1,405,37,118,.314,21,66,.318,16,52,.308,22,28,.786,9,27,36,39,17,0,33,35,112,2.0
7533,Larry Wideman\larry-wideman-1,2014-15,Furman,G,32,6,562,39,121,.322,18,47,.383,21,74,.284,13,21,.619,9,46,55,35,9,4,33,49,112,1.4
7534,Malachi Nix\malachi-nix-1,2013-14,Fairleigh Dickinson,G,30,1,471,30,102,.294,19,61,.311,11,41,.268,41,63,.651,8,36,44,29,18,1,45,50,112,1.1
7535,Bo Barnes\bo-barnes-1,2013-14,Arizona State,G,25,0,346,36,78,.462,15,26,.577,21,52,.404,19,29,.655,10,40,50,14,11,3,16,32,112,3.2
7536,Kyler Erickson\kyler-erickson-1,2015-16,Omaha,G,32,7,624,32,91,.352,14,35,.400,18,56,.321,30,41,.732,5,53,58,25,13,4,10,40,112,2.6
7537,Petey McClain\petey-mcclain-1,2013-14,East Tennessee State,G,33,30,690,32,80,.400,26,59,.441,6,21,.286,42,58,.724,9,65,74,111,36,0,43,78,112,3.9
7538,Isaiah Dennis\isaiah-dennis-1,2015-16,Georgia State,G,29,7,511,47,81,.580,46,79,.582,1,2,.500,17,40,.425,12,35,47,54,20,8,33,53,112,3.2
7539,Lavar Batts Jr.\lavar-battsjr-1,2017-18,North Carolina State,G,30,0,396,35,109,.321,26,61,.426,9,48,.188,33,56,.589,9,28,37,45,25,3,19,43,112,2.6
7540,Avery Dingman\avery-dingman-1,2013-14,Creighton,G,35,7,501,40,89,.449,29,46,.630,11,43,.256,21,29,.724,16,64,80,29,11,4,21,60,112,2.3
7541,Bishop Mency\bishop-mency-1,2015-16,Rice,G,32,15,743,41,128,.320,18,35,.514,23,93,.247,7,19,.368,22,61,83,27,12,11,27,53,112,1.8
7542,Billy Brown\billy-brown-1,2017-18,North Dakota,G,30,0,654,33,93,.355,9,18,.500,24,75,.320,22,29,.759,9,41,50,25,13,3,19,43,112,2.4
7543,Anthony Eaves\anthony-eaves-1,2016-17,Chicago State,G,26,5,393,40,125,.320,18,58,.310,22,67,.328,10,11,.909,11,34,45,26,12,4,24,32,112,2.1
7544,Aaron Korn\aaron-korn-1,2016-17,Lipscomb,G,27,4,390,38,77,.494,18,30,.600,20,47,.426,16,24,.667,17,55,72,24,12,4,17,51,112,3.4
7545,James Whitaker\james-whitaker-1,2015-16,North Carolina A&T,G,28,2,268,38,85,.447,33,62,.532,5,23,.217,31,38,.816,16,27,43,11,11,3,22,44,112,2.3
7546,Malachi Nix\malachi-nix-1,2014-15,Fairleigh Dickinson,G,28,1,433,24,80,.300,15,54,.278,9,26,.346,54,67,.806,4,21,25,53,29,0,46,43,111,2.6
7547,Manny Thomas\manny-thomas-1,2013-14,Marist,G,29,1,487,35,113,.310,20,60,.333,15,53,.283,26,38,.684,12,44,56,23,16,2,27,45,111,1.8
7548,Miles Simelton\miles-simelton-1,2014-15,Lehigh,G,30,2,467,38,98,.388,21,47,.447,17,51,.333,18,23,.783,4,30,34,39,20,3,29,40,111,2.4
7549,Paris Burns\paris-burns-1,2015-16,Illinois-Chicago,G,16,11,394,41,113,.363,30,72,.417,11,41,.268,18,25,.720,5,23,28,40,15,2,37,41,111,2.9
7550,Tanner Wozniak\tanner-wozniak-1,2013-14,Kennesaw State,G,28,0,316,34,104,.327,10,30,.333,24,74,.324,19,23,.826,7,14,21,10,6,1,22,21,111,1.5
7551,Michael Orris\michael-orris-1,2014-15,Northern Illinois,G,30,17,786,38,116,.328,28,70,.400,10,46,.217,25,39,.641,12,35,47,62,25,1,52,74,111,1.5
7552,Eric Johnson\eric-johnson-4,2016-17,Boston University,G,27,2,454,40,100,.400,15,40,.375,25,60,.417,6,12,.500,10,30,40,54,17,1,38,26,111,2.9
7553,Tyrin Atwood\tyrin-atwood-1,2017-18,Lamar,G,26,5,271,41,85,.482,37,75,.493,4,10,.400,25,38,.658,21,48,69,21,12,5,23,43,111,3.1
7554,Darrion Strong-Moore\darrion-strong-1,2016-17,Oklahoma,G,29,9,437,42,109,.385,22,44,.500,20,65,.308,7,13,.538,3,29,32,41,7,1,32,37,111,1.7
7555,Grant White\grant-white-1,2013-14,Jacksonville State,G,31,13,423,36,94,.383,27,63,.429,9,31,.290,30,46,.652,5,27,32,31,12,0,35,32,111,1.6
7556,Chris Robinson\chris-robinson-2,2015-16,Sacred Heart,G,23,1,475,41,118,.347,24,58,.414,17,60,.283,12,23,.522,18,66,84,17,6,2,24,46,111,2.2
7557,Zach Jackson\zach-jackson-1,2015-16,Omaha,G,32,24,482,39,103,.379,29,64,.453,10,39,.256,23,28,.821,22,44,66,28,23,5,21,64,111,2.5
7558,J.J. Frazier\jj-frazier-1,2013-14,Georgia,G,30,0,317,35,98,.357,12,27,.444,23,71,.324,18,27,.667,2,34,36,27,15,3,18,42,111,2.2
7559,Gerard Martin\gerard-martin-1,2017-18,Grand Canyon,G,34,0,569,40,99,.404,21,35,.600,19,64,.297,12,27,.444,18,78,96,45,19,6,29,64,111,2.6
7560,Lorenzo Jenkins\lorenzo-jenkins-1,2017-18,Colorado State,G,31,1,423,39,97,.402,17,43,.395,22,54,.407,11,20,.550,15,49,64,5,3,3,20,35,111,1.8
7561,Evan Leonard\evan-leonard-1,2016-17,UC-Irvine,G,31,1,381,34,107,.318,16,43,.372,18,64,.281,25,29,.862,9,38,47,18,12,1,20,54,111,1.6
7562,Craig Bowman\craig-bowman-1,2016-17,Florida A&M,G,19,7,260,36,101,.356,20,44,.455,16,57,.281,23,39,.590,4,20,24,19,11,0,23,34,111,2.4
7563,Dontaveon Robinson\dontaveon-robinson-1,2014-15,Jackson State,G,32,19,522,46,122,.377,46,120,.383,0,2,.000,19,33,.576,22,29,51,28,22,8,40,73,111,1.3
7564,Nigel Sydnor\nigel-sydnor-1,2013-14,NJIT,G,20,14,401,38,97,.392,27,63,.429,11,34,.324,24,42,.571,15,36,51,17,9,0,21,40,111,2.8
7565,Javaris Jenkins\javaris-jenkins-1,2015-16,Savannah State,G,21,3,395,34,91,.374,16,46,.348,18,45,.400,25,32,.781,9,53,62,19,13,3,16,39,111,3.7
7566,Travis Jorgenson\travis-jorgenson-1,2014-15,Georgia Tech,G,30,27,651,42,135,.311,27,85,.318,15,50,.300,12,16,.750,3,38,41,100,22,3,54,20,111,2.6
7567,Jacquan Nobles\jacquan-nobles-1,2013-14,Tennessee State,G,24,10,293,35,87,.402,6,8,.750,29,79,.367,12,17,.706,11,24,35,15,7,1,13,30,111,2.9
7568,Johnny Griffin\johnny-griffin-1,2014-15,Chicago State,G,31,11,574,41,86,.477,40,73,.548,1,13,.077,28,50,.560,47,74,121,9,34,21,20,72,111,3.9
7569,John Emezie\john-emezie-1,2017-18,Army,G,29,0,414,41,103,.398,23,57,.404,18,46,.391,11,21,.524,16,34,50,24,20,11,24,32,111,2.8
7570,Quinton Thomas\quinton-thomas-1,2015-16,Nicholls State,G,29,2,344,37,93,.398,14,31,.452,23,62,.371,14,27,.519,8,38,46,14,17,2,22,23,111,2.4
7571,Ilker Er\ilker-er-1,2016-17,Maine,G,11,8,216,38,103,.369,10,36,.278,28,67,.418,7,9,.778,12,32,44,3,1,0,11,31,111,4.6
7572,D.J. Harvey\dj-harvey-1,2017-18,Notre Dame,G,19,5,345,39,100,.390,24,55,.436,15,45,.333,18,29,.621,14,42,56,11,11,3,11,21,111,4.0
7573,Race Parsons\race-parsons-1,2013-14,Southern Utah,G,28,1,351,34,115,.296,7,22,.318,27,93,.290,15,20,.750,9,23,32,14,5,0,15,39,110,1.4
7574,Khailil Richard\khailil-richard-1,2016-17,Siena,G,30,8,388,43,89,.483,32,63,.508,11,26,.423,13,15,.867,13,32,45,23,6,2,27,35,110,2.2
7575,Jamir Harris\jamir-harris-1,2017-18,Minnesota,G,28,2,393,38,108,.352,10,27,.370,28,81,.346,6,12,.500,5,20,25,17,7,1,15,25,110,1.8
7576,Stuckey Mosley\stuckey-mosley-1,2014-15,Toledo,G,33,0,345,37,103,.359,26,63,.413,11,40,.275,25,40,.625,4,24,28,17,14,4,19,39,110,1.5
7577,Da'Monte Williams\damonte-williams-1,2017-18,Illinois,G,31,3,523,35,104,.337,26,64,.406,9,40,.225,31,44,.705,31,58,89,33,23,4,28,43,110,2.9
7578,Eric James\eric-james-2,2014-15,Duquesne,G,24,0,275,37,91,.407,24,44,.545,13,47,.277,23,41,.561,22,35,57,11,14,1,16,27,110,3.1
7579,Ryan Burkhardt\ryan-burkhardt-1,2017-18,North Florida,G,31,7,440,35,79,.443,0,4,.000,35,75,.467,5,7,.714,3,33,36,27,6,2,18,20,110,2.6
7580,Ade Murkey\ade-murkey-1,2016-17,Denver,G,27,2,287,38,77,.494,36,67,.537,2,10,.200,32,40,.800,12,31,43,25,13,5,17,28,110,3.4
7581,Barry Ogalue\barry-ogalue-1,2016-17,Cal State Long Beach,G,22,3,253,48,84,.571,47,78,.603,1,6,.167,13,25,.520,16,25,41,11,5,4,12,17,110,3.7
7582,Luke Doyle\luke-doyle-1,2013-14,Nicholls State,G,29,0,459,39,120,.325,13,30,.433,26,90,.289,6,8,.750,10,37,47,32,13,0,14,34,110,2.3
7583,Scott Mammel\scott-mammel-1,2016-17,Army,G,32,1,424,36,88,.409,6,18,.333,30,70,.429,8,12,.667,7,19,26,26,13,1,14,32,110,2.4
7584,Jordan Jackson\jordan-jackson-1,2014-15,Northern Kentucky,G,29,3,396,36,73,.493,34,68,.500,2,5,.400,36,48,.750,4,39,43,44,18,10,39,35,110,3.0
7585,Deaundrae Ballard\deaundrae-ballard-1,2017-18,Florida,G,30,1,315,43,112,.384,38,80,.475,5,32,.156,19,26,.731,16,35,51,9,8,1,14,33,110,1.9
7586,Christian Terrell\christian-terrell-1,2014-15,Florida Gulf Coast,G,33,1,391,38,99,.384,19,44,.432,19,55,.345,15,20,.750,7,45,52,26,9,7,28,33,110,1.9
7587,Rio Haskett\rio-haskett-1,2017-18,Harvard,G,32,3,502,42,126,.333,26,77,.338,16,49,.327,10,20,.500,15,40,55,34,20,1,35,59,110,1.3
7588,Juwan McCloud\juwan-mccloud-1,2016-17,Northern Iowa,G,30,28,608,39,135,.289,30,87,.345,9,48,.188,23,45,.511,5,34,39,45,32,2,36,33,110,1.7
7589,Kevin Seymour\kevin-seymour-1,2014-15,Central Connecticut State,G,28,22,846,44,120,.367,33,84,.393,11,36,.306,11,18,.611,8,60,68,96,17,5,57,29,110,3.0
7590,Rasean Simpson\rasean-simpson-1,2014-15,Morgan State,G,26,15,376,40,118,.339,38,100,.380,2,18,.111,28,45,.622,45,29,74,10,15,4,22,41,110,2.4
7591,Jontrell Walker\jontrell-walker-1,2017-18,Ball State,G,14,9,318,35,84,.417,16,34,.471,19,50,.380,21,26,.808,3,15,18,30,8,3,24,22,110,4.9
7592,KiShawn Pritchett\kishawn-pritchett-1,2016-17,Davidson,G,28,16,505,37,109,.339,20,50,.400,17,59,.288,18,31,.581,23,49,72,53,10,9,42,33,109,2.5
7593,Nelly Cummings\nelly-cummings-1,2017-18,Bowling Green State,G,30,1,396,41,108,.380,31,68,.456,10,40,.250,17,28,.607,7,27,34,29,20,2,19,31,109,2.3
7594,Tyler Thornton\tyler-thornton-1,2013-14,Duke,G,35,25,745,32,75,.427,5,15,.333,27,60,.450,18,21,.857,16,48,64,83,46,1,24,102,109,3.8
7595,Avi Toomer\avi-toomer-1,2016-17,Bucknell,G,35,22,676,36,80,.450,21,38,.553,15,42,.357,22,46,.478,15,64,79,33,36,2,39,70,109,2.3
7596,Deontaye Buskey\deontaye-buskey-1,2017-18,Charleston Southern,G,29,13,525,36,103,.350,24,63,.381,12,40,.300,25,38,.658,13,36,49,50,29,5,31,47,109,2.9
7597,Colton Ray-St Cyr\colton-ray-st-cyr-1,2013-14,Coastal Carolina,G,28,0,342,42,88,.477,26,42,.619,16,46,.348,9,16,.563,12,45,57,23,10,7,23,35,109,2.8
7598,Jamir Moultrie\jamir-moultrie-1,2017-18,La Salle,G,21,0,236,38,85,.447,13,27,.481,25,58,.431,8,13,.615,1,14,15,7,6,0,5,24,109,3.0
7599,Elisha Boone\elisha-boone-1,2015-16,Saint Peter's,G,30,11,413,47,90,.522,47,86,.547,0,4,.000,15,32,.469,34,83,117,20,8,13,30,47,109,3.0
7600,Ricardo Johnson\ricardo-johnson-1,2013-14,Ohio,G,15,14,339,32,80,.400,26,61,.426,6,19,.316,39,57,.684,22,40,62,20,9,8,24,40,109,5.0
7601,Donovan Franklin\donovan-franklin-1,2016-17,Indiana State,G,26,2,332,35,102,.343,21,49,.429,14,53,.264,25,33,.758,11,29,40,17,6,0,24,27,109,1.8
7602,Malik Harmon\malik-harmon-1,2017-18,Saint Francis (PA),G,30,6,583,36,126,.286,22,67,.328,14,59,.237,23,26,.885,1,46,47,72,15,0,30,28,109,2.4
7603,Matt O'Reilly\matt-oreilly-1,2016-17,Bucknell,G,32,1,348,37,117,.316,3,6,.500,34,111,.306,1,4,.250,3,15,18,5,4,1,8,31,109,1.1
7604,Bruno Skokna\bruno-skokna-1,2016-17,Loyola (IL),G,32,2,528,34,97,.351,20,47,.426,14,50,.280,27,36,.750,6,49,55,29,9,3,32,46,109,1.6
7605,Chase Cormier\chase-comier-1,2014-15,Grambling,G,23,23,676,30,108,.278,25,76,.329,5,32,.156,44,71,.620,11,58,69,75,27,0,58,59,109,2.5
7606,Ricky Madison\ricky-madison-1,2015-16,High Point,G,27,0,276,33,74,.446,33,69,.478,0,5,.000,43,64,.672,28,37,65,5,8,5,19,52,109,2.5
7607,Dean Danos\dean-danos-1,2013-14,Northern Kentucky,G,30,7,397,39,80,.488,20,41,.488,19,39,.487,12,12,1.000,7,25,32,25,10,0,28,42,109,2.1
7608,Marcus Owens\marcus-owens-1,2013-14,Lamar,G,27,8,390,36,105,.343,17,42,.405,19,63,.302,18,27,.667,17,34,51,9,12,2,15,50,109,2.0
7609,Nathan Scheer\nathan-scheer-1,2013-14,Missouri State,G,32,3,431,30,82,.366,8,20,.400,22,62,.355,27,36,.750,7,32,39,13,10,1,16,40,109,1.9
7610,Iverson Fleming\iverson-fleming-1,2013-14,Long Island University,G,28,4,339,39,107,.364,26,60,.433,13,47,.277,18,27,.667,11,28,39,11,7,1,16,22,109,1.9
7611,Christian Farmer\christian-farmer-1,2013-14,Winthrop,G,27,3,262,34,96,.354,12,22,.545,22,74,.297,19,23,.826,6,10,16,11,5,1,8,16,109,2.2
7612,Chuks Iroegbu\chuks-iroegbu-1,2014-15,Northern Illinois,G,30,0,326,35,59,.593,33,46,.717,2,13,.154,37,68,.544,16,27,43,11,18,3,24,30,109,2.7
7613,Gerdarius Troutman\gerdarius-troutman-1,2014-15,South Carolina State,G,31,0,313,33,125,.264,11,26,.423,22,99,.222,21,28,.750,12,25,37,19,9,0,7,18,109,1.8
7614,De'Angelo Bruster\deangelo-bruster-1,2016-17,Western Illinois,G,21,8,392,43,101,.426,31,69,.449,12,32,.375,10,12,.833,9,33,42,55,13,0,24,30,108,4.1
7615,P.J. Hubert\pj-hubert-1,2013-14,IUPUI,G,29,5,411,35,106,.330,8,23,.348,27,83,.325,11,11,1.000,1,31,32,24,8,2,11,27,108,2.1
7616,Kwinton Hinson\kwinton-hinson-1,2017-18,Washington State,G,28,9,381,41,105,.390,24,53,.453,17,52,.327,9,20,.450,14,49,63,18,7,4,28,56,108,1.5
7617,Khiry White\khiry-white-1,2013-14,Savannah State,G,21,19,459,40,85,.471,35,67,.522,5,18,.278,23,41,.561,11,31,42,36,14,0,43,51,108,2.4
7618,James Harrison\james-harrison-1,2013-14,New Orleans,G,23,2,278,38,76,.500,14,22,.636,24,54,.444,8,13,.615,3,12,15,12,8,1,14,26,108,2.9
7619,D'Shawn Schwartz\dshawn-schwartz-1,2017-18,Colorado,G,32,4,418,38,90,.422,20,43,.465,18,47,.383,14,19,.737,5,54,59,9,3,0,10,33,108,2.0
7620,Bryan Sekunda\bryan-sekunda-1,2014-15,Stony Brook,G,32,10,405,35,114,.307,5,31,.161,30,83,.361,8,8,1.000,10,19,29,16,7,3,25,22,108,1.3
7621,Kyle Clarke\kyle-clarke-1,2015-16,Kennesaw State,G,26,0,411,40,86,.465,39,83,.470,1,3,.333,27,43,.628,12,30,42,30,18,3,45,43,108,2.1
7622,Patrick Robinson Jr.\patrick-robinsonjr-1,2016-17,Detroit Mercy,G,25,5,343,36,77,.468,7,13,.538,29,64,.453,7,8,.875,12,14,26,19,6,4,5,43,108,3.2
7623,Nelson Kaputo\nelson-kaputo-1,2017-18,St. Bonaventure,G,33,5,336,35,84,.417,16,27,.593,19,57,.333,19,21,.905,3,18,21,35,17,0,15,26,108,2.6
7624,Damarcus Croaker\damarcus-croaker-1,2013-14,Texas,G,33,2,314,39,109,.358,17,35,.486,22,74,.297,8,12,.667,11,20,31,11,6,0,22,29,108,1.2
7625,Craig Brown\craig-brown-1,2013-14,Rutgers,G,30,4,440,36,126,.286,26,88,.295,10,38,.263,26,38,.684,25,51,76,10,7,6,23,56,108,1.2
7626,Nick Billingsley\nick-billingsley-1,2015-16,Texas-San Antonio,G,23,1,244,39,94,.415,32,66,.485,7,28,.250,23,32,.719,9,30,39,5,8,3,22,36,108,2.0
7627,Caleb Steffensmeier\caleb-steffensmeier-1,2013-14,Omaha,G,32,1,498,34,101,.337,9,30,.300,25,71,.352,15,19,.789,7,32,39,51,26,3,22,41,108,2.8
7628,Timmy Knipp\timmy-knipp-1,2013-14,Eastern Kentucky,G,31,4,325,35,77,.455,16,27,.593,19,50,.380,19,26,.731,11,21,32,8,10,14,19,45,108,2.2
7629,Sidy Ndir\sidy-ndir-1,2015-16,New Mexico State,G,28,0,305,34,83,.410,21,40,.525,13,43,.302,27,36,.750,6,36,42,20,3,4,20,31,108,2.2
7630,Isaiah Nichols\isaiah-nichols-1,2017-18,San Jose State,G,30,9,529,36,108,.333,20,56,.357,16,52,.308,20,34,.588,18,94,112,44,15,4,42,61,108,2.1
7631,Jeremie Tyler\jeremie-tyler-1,2014-15,Ball State,G,9,9,272,41,89,.461,23,47,.489,18,42,.429,8,11,.727,7,27,34,12,12,3,19,20,108,7.7
7632,JoJo Fallas\jojo-fallas-1,2016-17,Cornell,G,29,23,630,33,100,.330,5,19,.263,28,81,.346,14,15,.933,5,47,52,43,18,0,29,57,108,2.2
7633,Cody Benzel\cody-benzel-1,2015-16,Eastern Washington,G,33,1,194,37,89,.416,6,9,.667,31,80,.388,3,4,.750,3,12,15,7,6,3,4,19,108,2.0
7634,Tyler Wilson\tyler-wilson-1,2014-15,Manhattan,G,33,8,681,28,70,.400,27,65,.415,1,5,.200,51,87,.586,11,40,51,96,44,1,63,82,108,2.8
7635,Chancellor Barnard\chancellor-barnard-1,2014-15,Loyola (MD),G,30,14,557,36,83,.434,36,80,.450,0,3,.000,36,57,.632,41,59,100,18,5,26,31,53,108,2.9
7636,Joe Toye\joe-toye-1,2015-16,Vanderbilt,G,30,0,257,37,74,.500,28,53,.528,9,21,.429,25,39,.641,7,30,37,10,6,2,13,28,108,2.3
7637,Terrence Samuel\terrence-samuel-1,2016-17,Penn State,G,28,1,468,35,86,.407,29,68,.426,6,18,.333,32,44,.727,11,53,64,49,18,1,23,32,108,3.5
7638,Madison Jones\madison-jones-1,2013-14,Wake Forest,G,33,22,689,35,80,.438,33,75,.440,2,5,.400,36,73,.493,10,53,63,92,39,6,71,67,108,2.5
7639,Donovan Kates\donovan-kates-1,2014-15,Manhattan,G,32,12,749,30,99,.303,15,40,.375,15,59,.254,33,44,.750,22,49,71,32,14,3,25,60,108,2.1
7640,Paris Roberts-Campbell\paris-roberts-campbell-1,2014-15,East Carolina,G,22,1,416,37,95,.389,11,26,.423,26,69,.377,8,11,.727,10,39,49,24,21,6,12,34,108,4.1
7641,Andre Nation\andre-nation-1,2014-15,James Madison,G,12,6,330,40,92,.435,36,68,.529,4,24,.167,24,40,.600,10,20,30,22,20,4,25,25,108,5.8
7642,Hurley Johnson\hurley-johnson-1,2013-14,Texas-Rio Grande Valley,G,28,5,372,36,95,.379,27,49,.551,9,46,.196,27,47,.574,10,24,34,21,10,0,17,34,108,2.0
7643,Michael Miller\michael-miller-5,2017-18,North Texas,G,30,6,367,38,90,.422,27,48,.563,11,42,.262,21,30,.700,25,51,76,16,5,6,25,42,108,2.3
7644,Emerson Murray\emerson-murray-1,2013-14,Seattle,G,16,10,324,35,111,.315,18,46,.391,17,65,.262,21,31,.677,16,42,58,27,14,3,26,40,108,3.6
7645,Tavarius Shine\tavarius-shine-1,2014-15,Oklahoma State,G,32,0,420,37,89,.416,16,23,.696,21,66,.318,13,21,.619,16,36,52,10,16,8,24,49,108,2.0
7646,Charles McKinney\charles-mckinney-1,2013-14,DePaul,G,28,11,467,41,75,.547,41,65,.631,0,10,.000,26,43,.605,22,32,54,30,28,11,28,50,108,3.5
7647,Shirmane Thomas\shirmane-thomas-1,2015-16,Tennessee Tech,G,30,29,653,37,103,.359,30,75,.400,7,28,.250,27,50,.540,21,84,105,73,24,8,46,58,108,3.1
7648,Lamond Murray\lamond-murray-2,2013-14,Pepperdine,G,27,2,288,37,75,.493,34,62,.548,3,13,.231,31,48,.646,17,43,60,13,8,2,20,37,108,2.7
7649,Aidas Kavaliauskas\aidas-kavaliauskas-1,2017-18,Fairfield,G,20,16,602,42,90,.467,27,51,.529,15,39,.385,8,12,.667,5,50,55,92,27,1,44,41,107,5.5
7650,Kevin Crescenzi\kevin-crescenzi-1,2015-16,Dartmouth,G,24,5,450,37,105,.352,23,56,.411,14,49,.286,19,27,.704,19,50,69,44,17,6,21,46,107,3.6
7651,Jarvis Pugh\jarvis-pugh-1,2014-15,Santa Clara,G,32,15,633,51,88,.580,50,85,.588,1,3,.333,4,13,.308,48,71,119,35,26,8,23,84,107,3.6
7652,Malick Kone\malick-kone-1,2013-14,Rutgers,G,31,1,487,41,93,.441,39,78,.500,2,15,.133,23,37,.622,24,61,85,23,20,7,24,61,107,2.6
7653,Denzell Watts\denzell-watts-1,2013-14,Alabama-Birmingham,G,31,1,473,36,87,.414,25,50,.500,11,37,.297,24,38,.632,8,47,55,42,14,1,25,29,107,2.6
7654,Shelby Adams\shelby-adams-1,2017-18,Texas State,G,31,1,339,37,83,.446,31,59,.525,6,24,.250,27,45,.600,9,30,39,13,14,1,14,24,107,2.3
7655,Javontae Hawkins\javontae-hawkins-1,2013-14,South Florida,G,29,0,349,37,99,.374,26,62,.419,11,37,.297,22,36,.611,12,26,38,4,5,4,10,41,107,1.6
7656,Albert Thomas\albert-thomas-1,2013-14,Delaware State,G,28,28,727,39,106,.368,32,85,.376,7,21,.333,22,35,.629,22,41,63,70,17,0,42,48,107,2.7
7657,C.J. Rivers\cj-rivers-1,2016-17,Drake,G,31,10,537,40,108,.370,35,79,.443,5,29,.172,22,25,.880,20,79,99,52,23,1,27,36,107,3.3
7658,Stephen Brown\stephen-brown-2,2014-15,Bucknell,G,30,17,441,40,91,.440,32,73,.438,8,18,.444,19,40,.475,7,52,59,42,9,1,22,41,107,2.4
7659,Brendon Myles\brendon-myles-1,2016-17,Florida A&M,G,24,2,315,41,88,.466,24,49,.490,17,39,.436,8,12,.667,21,38,59,7,2,2,26,27,107,2.4
7660,Caleb Chowbay\caleb-chowbay-1,2013-14,Belmont,G,36,2,499,37,106,.349,19,45,.422,18,61,.295,15,17,.882,5,27,32,44,10,4,36,51,107,1.3
7661,Ty Solomon\ty-solomon-1,2015-16,South Carolina State,G,33,20,693,32,103,.311,12,32,.375,20,71,.282,23,28,.821,10,60,70,121,23,3,61,73,107,2.7
7662,Jalen Gibbs\jalen-gibbs-1,2017-18,Drake,G,32,0,344,38,97,.392,24,48,.500,14,49,.286,17,26,.654,7,47,54,13,12,0,15,10,107,2.2
7663,Willie Moore\willie-moore-2,2015-16,Miami (OH),G,29,3,524,29,110,.264,18,61,.295,11,49,.224,38,50,.760,19,64,83,33,21,2,42,46,107,1.9
7664,Josh Oglesby\josh-oglesby-1,2014-15,Iowa,G,33,1,625,35,124,.282,7,28,.250,28,96,.292,9,9,1.000,14,48,62,48,11,2,21,28,107,2.2
7665,Chris Howell\chris-howell-2,2017-18,South Dakota State,G,23,6,300,43,90,.478,41,87,.471,2,3,.667,19,34,.559,16,63,79,18,8,0,30,24,107,2.9
7666,Milik Gantz\milik-gantz-1,2017-18,North Carolina A&T,G,30,1,255,41,80,.513,39,65,.600,2,15,.133,23,36,.639,8,32,40,16,10,7,29,40,107,2.0
7667,Curtis Oakley\curtis-oakley-1,2013-14,Bryant,G,28,0,335,39,94,.415,21,37,.568,18,57,.316,11,18,.611,11,42,53,11,7,1,12,37,107,2.2
7668,Derek Reese\derek-reese-1,2015-16,Tennessee,G,34,15,653,40,86,.465,33,71,.465,7,15,.467,20,37,.541,61,123,184,29,17,20,18,64,107,4.2
7669,Torrey Patton\torrey-patton-1,2017-18,Akron,G,32,7,512,39,80,.488,36,64,.563,3,16,.188,26,42,.619,37,63,100,16,15,1,21,56,107,2.8
7670,Jordan Mason\jordan-mason-1,2014-15,Cal State Fullerton,G,19,0,249,40,95,.421,28,51,.549,12,44,.273,15,22,.682,12,32,44,11,7,1,15,30,107,3.2
7671,Lane Severyn\lane-severyn-1,2017-18,South Dakota State,G,34,4,501,35,67,.522,13,25,.520,22,42,.524,15,23,.652,33,40,73,21,13,6,16,56,107,2.9
7672,Nojel Eastern\nojel-eastern-1,2017-18,Purdue,G,37,0,467,42,87,.483,39,78,.500,3,9,.333,20,48,.417,37,56,93,39,21,5,40,57,107,2.3
7673,Jimmy Sherburne\jimmy-sherburne-1,2013-14,Princeton,G,25,14,467,34,98,.347,22,61,.361,12,37,.324,27,36,.750,6,48,54,40,7,1,31,44,107,2.2
7674,Zavion Williams\zavion-williams-1,2014-15,Austin Peay,G,23,8,373,38,106,.358,27,62,.435,11,44,.250,20,31,.645,13,31,44,42,22,0,38,51,107,2.4
7675,Akachi Okugo\akachi-okugo-1,2013-14,Grand Canyon,G,29,12,602,29,111,.261,15,53,.283,14,58,.241,35,50,.700,9,33,42,63,13,1,39,72,107,1.4
7676,Brandon Sampson\brandon-sampson-1,2015-16,Louisiana State,G,27,5,357,35,109,.321,17,42,.405,18,67,.269,19,27,.704,10,22,32,22,12,3,17,18,107,2.2
7677,Kris Gulley\kris-gulley-1,2013-14,Cal State Long Beach,G,32,4,488,34,105,.324,16,39,.410,18,66,.273,21,26,.808,27,42,69,21,8,2,21,48,107,1.9
7678,Corey Daugherty\corey-daugherty-1,2016-17,Brown,G,29,3,460,34,100,.340,7,21,.333,27,79,.342,12,14,.857,4,39,43,52,20,3,28,51,107,2.6
7679,Kai Healy\kai-healy-1,2017-18,Santa Clara,G,27,10,529,39,95,.411,23,50,.460,16,45,.356,13,22,.591,5,54,59,24,7,2,26,40,107,2.1
7680,Donte Pretlow\donte-pretlow-1,2013-14,Morgan State,G,30,3,691,40,154,.260,34,101,.337,6,53,.113,21,33,.636,16,64,80,73,41,1,33,65,107,2.5
7681,Trevian Bell\trevian-bell-1,2017-18,Green Bay,G,25,2,326,39,101,.386,26,67,.388,13,34,.382,16,22,.727,10,54,64,9,10,5,17,21,107,2.7
7682,Alex Hunter\alex-hunter-1,2017-18,Furman,G,33,1,463,40,86,.465,21,35,.600,19,51,.373,7,9,.778,5,44,49,37,5,1,16,32,106,2.4
7683,Daniel Grieves\daniel-grieves-1,2013-14,Louisiana-Monroe,G,25,1,318,36,102,.353,7,17,.412,29,85,.341,5,8,.625,9,29,38,9,5,2,9,40,106,2.0
7684,Ahmad Clark\ahmad-clark-1,2017-18,Albany (NY),G,29,1,308,31,91,.341,13,48,.271,18,43,.419,26,34,.765,6,27,33,26,15,3,27,33,106,2.0
7685,Josh Hall\josh-hall-2,2016-17,Nevada,G,29,9,435,39,90,.433,29,64,.453,10,26,.385,18,27,.667,22,54,76,30,15,0,17,31,106,3.2
7686,Jake Matthews\jake-matthews-1,2013-14,Cornell,G,25,2,431,31,95,.326,8,25,.320,23,70,.329,21,29,.724,5,19,24,17,19,1,14,39,106,2.4
7687,Devon Carter\devon-carter-1,2015-16,Lehigh,G,32,9,486,40,101,.396,25,56,.446,15,45,.333,11,16,.688,18,32,50,27,17,2,20,24,106,2.5
7688,B.J. Glasford\bj-glasford-1,2013-14,Stetson,G,31,0,366,37,115,.322,24,63,.381,13,52,.250,19,25,.760,9,40,49,21,11,3,22,39,106,1.5
7689,Kevin Larkin\kevin-larkin-1,2016-17,Niagara,G,22,0,256,36,104,.346,28,70,.400,8,34,.235,26,28,.929,16,51,67,12,13,2,9,17,106,3.7
7690,DeVince Boykins\devince-boykins-1,2013-14,Marshall,G,33,14,554,40,95,.421,22,48,.458,18,47,.383,8,34,.235,19,49,68,21,17,1,24,58,106,1.8
7691,Nick Hornsby\nick-hornsby-1,2013-14,Sacramento State,G,29,0,432,34,94,.362,29,74,.392,5,20,.250,33,46,.717,32,63,95,31,17,8,26,59,106,2.9
7692,John Crosby\john-crosby-1,2017-18,Dayton,G,26,9,383,34,86,.395,25,55,.455,9,31,.290,29,36,.806,4,33,37,49,6,0,31,32,106,2.5
7693,Ako Adams\ako-adams-1,2016-17,Rice,G,35,0,459,31,97,.320,10,38,.263,21,59,.356,23,28,.821,4,33,37,42,11,2,40,67,106,1.0
7694,Jordan Bell\jordan-bell-12,2016-17,Northwestern State,G,26,0,302,42,95,.442,33,63,.524,9,32,.281,13,20,.650,18,66,84,16,8,9,18,40,106,3.0
7695,Kevin Crescenzi\kevin-crescenzi-1,2014-15,Dartmouth,G,29,7,495,33,111,.297,12,53,.226,21,58,.362,19,24,.792,23,39,62,20,22,2,19,56,106,2.2
7696,Montay Brandon\montay-brandon-1,2015-16,Florida State,G,33,30,655,37,86,.430,35,79,.443,2,7,.286,30,55,.545,39,62,101,32,19,8,33,68,106,2.5
7697,Reggie Johnson\reggie-johnson-3,2013-14,Miami (OH),G,9,6,254,34,90,.378,28,56,.500,6,34,.176,32,45,.711,7,9,16,19,11,1,16,31,106,6.2
7698,Stephaun Adams\stephaun-adams-1,2016-17,Tennessee Tech,G,32,5,475,31,96,.323,18,57,.316,13,39,.333,31,42,.738,16,68,84,54,21,1,41,56,106,2.3
7699,Leron Fisher\leron-fisher-1,2015-16,Longwood,G,11,8,318,31,91,.341,19,52,.365,12,39,.308,32,45,.711,7,27,34,42,12,2,34,20,106,5.8
7700,B.J. Maxwell\bj-maxwell-1,2017-18,Abilene Christian,G,31,2,308,43,92,.467,32,61,.525,11,31,.355,9,16,.563,27,42,69,20,8,11,15,52,106,2.6
7701,Gabe Snider\gabe-snider-1,2015-16,Illinois-Chicago,G,18,1,281,36,92,.391,6,16,.375,30,76,.395,4,8,.500,7,27,34,20,7,6,13,32,106,3.7
7702,Armani Collins\armani-collins-1,2017-18,Bethune-Cookman,G,26,0,359,36,119,.303,12,22,.545,24,97,.247,10,13,.769,13,45,58,14,10,9,13,38,106,2.2
7703,Wayne Sparrow\wayne-sparrow-1,2013-14,Richmond,G,33,21,616,45,129,.349,34,74,.459,11,55,.200,5,23,.217,12,59,71,33,21,6,38,65,106,1.1
7704,Theron Stephens\theron-stephens-1,2013-14,South Carolina State,G,28,9,311,33,118,.280,6,35,.171,27,83,.325,13,15,.867,12,8,20,20,3,0,14,15,106,1.6
7705,Ian Sistare\ian-sistare-1,2016-17,Dartmouth,G,27,0,422,35,91,.385,30,55,.545,5,36,.139,31,40,.775,10,62,72,30,8,0,33,35,106,2.2
7706,Jamaal Calvin\jamaal-calvin-1,2014-15,Southeast Missouri State,G,27,7,447,32,89,.360,9,20,.450,23,69,.333,19,23,.826,12,25,37,21,12,0,15,35,106,2.5
7707,Jeremie Tyler\jeremie-tyler-1,2017-18,Ball State,G,15,0,274,37,88,.420,15,39,.385,22,49,.449,10,15,.667,5,18,23,14,13,9,18,13,106,4.8
7708,Michael Williams\michael-williams-6,2013-14,Texas Christian,G,30,2,460,31,101,.307,19,61,.311,12,40,.300,32,48,.667,6,30,36,25,13,1,26,25,106,1.7
7709,Raul Frias\raul-frias-1,2016-17,Long Island University,G,32,9,406,40,123,.325,16,40,.400,24,83,.289,2,4,.500,13,41,54,6,9,6,10,28,106,1.6
7710,Jordan Schakel\jordan-schakel-1,2017-18,San Diego State,G,33,0,455,33,100,.330,6,22,.273,27,78,.346,13,19,.684,18,50,68,19,12,3,9,66,106,2.0
7711,Jamel Fields\jamel-fields-1,2014-15,Saint Peter's,G,34,5,543,26,73,.356,14,38,.368,12,35,.343,42,67,.627,4,48,52,45,20,9,37,54,106,2.1
7712,Ore Arogundade\ore-arogundade-1,2014-15,Drake,G,29,2,371,31,77,.403,17,51,.333,14,26,.538,30,41,.732,10,37,47,19,15,1,28,40,106,2.2
7713,Brailen Neely\brailen-neely-1,2016-17,Oakland,G,34,15,558,30,91,.330,17,46,.370,13,45,.289,33,42,.786,6,51,57,103,31,0,37,42,106,3.5
7714,Jase Febres\jase-febres-1,2017-18,Texas,G,31,17,488,36,118,.305,8,25,.320,28,93,.301,6,8,.750,21,33,54,17,7,7,11,42,106,1.9
7715,Charles Tucker Jr.\charles-tuckerjr-1,2017-18,Sacred Heart,G,30,22,646,35,99,.354,28,68,.412,7,31,.226,29,48,.604,1,50,51,95,15,0,59,59,106,1.9
7716,Brent Wrapp\brent-wrapp-1,2017-18,Cal State Bakersfield,G,29,28,805,26,88,.295,17,53,.321,9,35,.257,44,62,.710,25,107,132,148,36,3,58,84,105,5.0
7717,Brett Frantz\brett-frantz-1,2015-16,Youngstown State,G,32,12,525,37,116,.319,13,28,.464,24,88,.273,7,10,.700,15,35,50,34,18,1,19,46,105,2.0
7718,Malik Marquetti\malik-marquetti-1,2014-15,Southern California,G,32,15,600,38,110,.345,23,60,.383,15,50,.300,14,25,.560,30,56,86,29,22,6,21,61,105,2.4
7719,Stephan Jiggetts\stephan-jiggetts-1,2014-15,Fairleigh Dickinson,G,20,0,327,33,116,.284,19,67,.284,14,49,.286,25,35,.714,10,18,28,23,8,1,41,35,105,0.8
7720,Arell Hennings\arell-hennings-1,2017-18,UC-Davis,G,33,1,343,32,75,.427,16,39,.410,16,36,.444,25,27,.926,6,16,22,46,12,0,25,29,105,2.5
7721,Trey Pinkney\trey-pinkney-1,2013-14,Stephen F. Austin,G,35,34,845,27,72,.375,24,47,.511,3,25,.120,48,76,.632,12,56,68,121,33,1,60,103,105,2.8
7722,Eli Wright\eli-wright-1,2016-17,Mississippi State,G,30,1,392,36,68,.529,25,41,.610,11,27,.407,22,31,.710,14,33,47,7,11,2,16,50,105,2.3
7723,Steve Rogers\steve-rogers-1,2016-17,Alabama State,G,27,8,584,37,132,.280,15,43,.349,22,89,.247,9,26,.346,15,37,52,27,17,2,35,51,105,0.9
7724,Riley Bradshaw\riley-bradshaw-1,2014-15,Montana,G,33,1,509,38,103,.369,22,51,.431,16,52,.308,13,15,.867,8,32,40,34,6,1,28,42,105,1.5
7725,Shawn Hopkins\shawn-hopkins-1,2015-16,Troy,G,29,11,403,32,104,.308,11,30,.367,21,74,.284,20,36,.556,16,50,66,12,7,4,19,33,105,1.8
7726,Chase Cormier\chase-comier-1,2013-14,Grambling,G,27,10,567,24,98,.245,12,59,.203,12,39,.308,45,79,.570,12,38,50,77,24,0,57,64,105,1.8
7727,Deon Barrett\deon-barrett-1,2016-17,Texas-El Paso,G,31,4,420,34,93,.366,9,30,.300,25,63,.397,12,14,.857,2,21,23,29,6,0,17,22,105,2.0
7728,Andre Jones\andre-jones-3,2016-17,Little Rock,G,30,0,324,40,96,.417,30,61,.492,10,35,.286,15,27,.556,17,30,47,15,12,4,30,22,105,1.9
7729,Trey Patterson\trey-patterson-1,2015-16,Houston Baptist,G,32,4,385,39,66,.591,38,57,.667,1,9,.111,26,57,.456,8,27,35,39,17,2,34,49,105,2.1
7730,Anthony Drmic\anthony-drmic-1,2014-15,Boise State,G,7,7,248,33,77,.429,17,34,.500,16,43,.372,23,30,.767,7,28,35,11,5,0,9,16,105,10.3
7731,TeShaun Hightower\teshaun-hightower-1,2017-18,Georgia,G,29,3,321,35,93,.376,23,52,.442,12,41,.293,23,51,.451,2,40,42,39,9,2,30,26,105,1.8
7732,Derrell Edwards\derrell-edwards-1,2013-14,High Point,G,31,16,646,36,90,.400,31,63,.492,5,27,.185,28,35,.800,10,52,62,48,23,1,33,55,105,2.5
7733,A.J. Youngman\aj-youngman-1,2017-18,Eastern Kentucky,G,28,6,403,36,95,.379,6,19,.316,30,76,.395,3,4,.750,4,33,37,16,10,2,13,39,105,2.1
7734,Ben Eblen\ben-eblen-1,2013-14,North Carolina-Wilmington,G,32,19,684,45,122,.369,42,104,.404,3,18,.167,11,30,.367,14,62,76,88,28,9,41,66,104,2.7
7735,Cameron Fowler\cameron-fowler-1,2015-16,Niagara,G,30,28,692,40,124,.323,29,75,.387,11,49,.224,13,27,.481,22,61,83,83,23,3,53,67,104,2.2
7736,Rashad Andrews\rashad-andrews-1,2015-16,Southern,G,27,14,347,36,82,.439,22,42,.524,14,40,.350,18,34,.529,6,39,45,11,8,4,17,38,104,2.1
7737,Jermaine Bishop\jermaine-bishop-2,2016-17,Saint Louis,G,9,7,290,38,105,.362,23,64,.359,15,41,.366,13,16,.813,1,25,26,42,16,3,32,21,104,6.6
7738,Malik Nichols\malik-nichols-1,2015-16,Hofstra,G,20,0,361,41,80,.513,38,70,.543,3,10,.300,19,40,.475,42,65,107,27,18,4,25,70,104,4.6
7739,Kyle Stout\kyle-stout-1,2017-18,Lafayette,G,28,20,523,35,104,.337,14,26,.538,21,78,.269,13,20,.650,8,69,77,23,14,8,13,52,104,2.5
7740,Brad Schaub\brad-schaub-1,2014-15,Massachusetts-Lowell,G,22,7,539,39,94,.415,23,61,.377,16,33,.485,10,22,.455,12,53,65,16,16,5,35,55,104,2.1
7741,Marcus LoVett\marcus-lovett-1,2017-18,St. John's (NY),G,7,7,229,39,93,.419,24,54,.444,15,39,.385,11,15,.733,2,13,15,12,15,0,13,16,104,8.9
7742,Marcus Harris\marcus-harris-1,2014-15,San Diego,G,31,0,336,35,91,.385,16,36,.444,19,55,.345,15,24,.625,6,18,24,12,6,1,14,34,104,1.5
7743,Ayo Akinwole\ayo-akinwole-1,2017-18,Omaha,G,31,3,481,39,90,.433,24,50,.480,15,40,.375,11,19,.579,10,45,55,44,23,1,18,25,104,3.2
7744,Detrick Mostella\detrick-mostella-1,2014-15,Tennessee,G,31,1,364,34,123,.276,12,42,.286,22,81,.272,14,20,.700,8,19,27,15,9,1,30,34,104,0.5
7745,De'Angelo Speech\deangelo-speech-1,2013-14,Central Connecticut State,G,28,9,468,35,87,.402,19,50,.380,16,37,.432,18,25,.720,18,56,74,34,21,2,30,49,104,2.9
7746,John Emezie\john-emezie-1,2015-16,Army,G,33,6,388,35,91,.385,27,58,.466,8,33,.242,26,48,.542,17,22,39,20,5,8,30,56,104,1.1
7747,Randy Reed\randy-reed-1,2014-15,Omaha,G,27,0,316,38,66,.576,36,57,.632,2,9,.222,26,37,.703,18,34,52,12,11,9,17,33,104,3.2
7748,Alex Dragicevich\alex-dragicevich-1,2013-14,Boston College,G,27,13,410,34,82,.415,14,24,.583,20,58,.345,16,23,.696,5,33,38,19,14,12,17,30,104,2.9
7749,Jimmie Duplessis\jimmie-duplessis-1,2014-15,Southeastern Louisiana,G,23,6,448,37,97,.381,32,73,.438,5,24,.208,25,44,.568,8,36,44,60,12,0,40,38,104,2.5
7750,Cole Murray\cole-murray-1,2014-15,Northern Kentucky,G,26,3,261,36,86,.419,4,5,.800,32,81,.395,0,0,,1,25,26,7,5,1,6,33,104,2.2
7751,Jaleni Neely\jaleni-neely-1,2016-17,Northern Arizona,G,12,11,307,28,97,.289,16,52,.308,12,45,.267,36,45,.800,5,26,31,43,8,0,32,22,104,4.4
7752,Jovan Crnic\jovan-crnic-1,2016-17,Abilene Christian,G,13,11,367,34,83,.410,12,20,.600,22,63,.349,14,20,.700,5,27,32,40,8,1,20,21,104,5.9
7753,Kahari Beaufort\kahari-beaufort-1,2016-17,Tennessee-Martin,G,33,6,322,35,89,.393,20,45,.444,15,44,.341,19,28,.679,9,41,50,10,11,2,24,36,104,1.6
7754,Eric Jamison\eric-jamison-1,2017-18,Gardner-Webb,G,27,1,412,41,83,.494,40,75,.533,1,8,.125,21,28,.750,17,84,101,10,8,3,15,46,104,3.0
7755,Justin Pride\justin-pride-1,2016-17,Cal State Bakersfield,G,35,1,602,31,80,.388,30,76,.395,1,4,.250,41,67,.612,21,56,77,80,38,0,49,76,104,2.7
7756,Diante Baldwin\diante-baldwin-1,2013-14,North Carolina-Greensboro,G,30,2,490,40,81,.494,33,63,.524,7,18,.389,17,47,.362,6,48,54,31,15,5,27,65,104,1.9
7757,Tra'von Joseph\travon-joseph-1,2015-16,Northwestern State,G,23,5,484,37,100,.370,29,76,.382,8,24,.333,22,29,.759,26,62,88,24,10,3,21,60,104,2.9
7758,Devon Goodman\devon-goodman-1,2016-17,Pennsylvania,G,24,3,368,40,104,.385,28,56,.500,12,48,.250,12,22,.545,10,27,37,42,16,2,29,32,104,2.6
7759,Miles Reynolds\miles-reynolds-1,2014-15,Saint Louis,G,26,2,327,19,66,.288,17,47,.362,2,19,.105,64,87,.736,7,34,41,30,17,1,27,37,104,2.6
7760,Josue Salaam\josue-salaam-1,2015-16,Bethune-Cookman,G,27,7,326,36,95,.379,10,25,.400,26,70,.371,5,9,.556,8,36,44,11,5,0,8,33,103,2.1
7761,Elvin Rodriguez\elvin-rodriguez-1,2017-18,Denver,G,24,0,245,36,103,.350,31,77,.403,5,26,.192,26,47,.553,8,20,28,16,11,2,22,24,103,1.7
7762,Devon Thomas\devon-thomas-1,2013-14,Missouri State,G,32,1,423,37,80,.463,35,66,.530,2,14,.143,27,49,.551,4,35,39,45,15,3,30,43,103,2.1
7763,Dominic Artis\dominic-artis-1,2013-14,Oregon,G,25,6,422,33,97,.340,25,66,.379,8,31,.258,29,43,.674,9,39,48,55,20,3,33,39,103,2.9
7764,Stefan Cvrkalj\stefan-cvrkalj-1,2013-14,Lehigh,G,23,1,376,34,91,.374,4,19,.211,30,72,.417,5,6,.833,2,44,46,14,4,4,21,28,103,2.2
7765,Shavar Newkirk\shavar-newkirk-1,2014-15,Saint Joseph's,G,31,0,622,34,121,.281,28,89,.315,6,32,.188,29,51,.569,9,43,52,71,22,5,44,37,103,1.9
7766,Allen Roberts\allen-roberts-1,2013-14,Penn State,G,18,0,333,30,86,.349,12,26,.462,18,60,.300,25,33,.758,9,40,49,18,4,3,11,25,103,3.8
7767,Mustafa Lawrence\mustafa-lawrence-1,2017-18,Missouri State,G,22,10,273,33,88,.375,9,26,.346,24,62,.387,13,17,.765,5,19,24,20,13,0,13,31,103,2.9
7768,Lorenzen Wright Jr.\lorenzen-wrightjr-1,2016-17,Robert Morris,G,30,0,361,33,97,.340,4,15,.267,29,82,.354,8,13,.615,2,14,16,6,7,0,20,38,103,0.9
7769,Bryson Lockley\bryson-lockley-1,2017-18,Kennesaw State,G,28,2,475,33,78,.423,32,74,.432,1,4,.250,36,59,.610,38,56,94,26,11,22,32,65,103,2.9
7770,Carlbe Ervin II\carlbe-ervinii-1,2015-16,Kansas State,G,33,5,504,36,94,.383,31,66,.470,5,28,.179,26,34,.765,25,39,64,49,16,1,31,44,103,2.4
7771,Jamel Fuentes\jamel-fuentes-1,2014-15,Norfolk State,G,33,31,832,35,106,.330,35,98,.357,0,8,.000,33,51,.647,16,78,94,138,33,3,66,88,103,3.1
7772,Geno Thorpe\geno-thorpe-1,2013-14,Penn State,G,32,3,379,31,57,.544,28,47,.596,3,10,.300,38,55,.691,13,39,52,17,16,0,20,42,103,2.5
7773,Jake Killingsworth\jake-killingsworth-1,2016-17,Columbia,G,24,13,383,39,98,.398,23,49,.469,16,49,.327,9,13,.692,25,32,57,26,10,2,16,28,103,3.2
7774,DeVince Boykins\devince-boykins-1,2014-15,Marshall,G,30,2,463,41,88,.466,33,70,.471,8,18,.444,13,37,.351,16,30,46,42,15,1,44,31,103,1.9
7775,Aaron Jordan\aaron-jordan-1,2015-16,Illinois,G,30,5,350,31,95,.326,9,31,.290,22,64,.344,19,23,.826,5,23,28,14,12,3,7,47,103,1.9
7776,Latin Davis\latin-davis-1,2015-16,Youngstown State,G,32,0,417,37,97,.381,27,65,.415,10,32,.313,19,30,.633,12,46,58,40,19,0,22,34,103,2.5
7777,Maleke Haynes\maleke-haynes-1,2015-16,Pacific,G,28,1,491,33,107,.308,22,62,.355,11,45,.244,26,44,.591,5,36,41,69,15,4,46,53,103,1.7
7778,Corey Spence\corey-spence-1,2013-14,Northern Colorado,G,31,9,512,38,106,.358,36,92,.391,2,14,.143,25,41,.610,6,38,44,60,10,0,48,58,103,1.1
7779,Justin Colvin\justin-colvin-1,2013-14,Alabama A&M,G,30,0,299,34,95,.358,16,38,.421,18,57,.316,17,27,.630,8,13,21,12,8,0,21,21,103,1.4
7780,Edward Simpson\edward-simpson-1,2014-15,Middle Tennessee,G,35,9,524,36,96,.375,13,36,.361,23,60,.383,8,17,.471,5,39,44,25,13,3,18,34,103,1.8
7781,Jaryd Eustace\jaryd-eustace-1,2014-15,Miami (OH),G,28,1,322,32,106,.302,7,25,.280,25,81,.309,14,23,.609,6,43,49,4,5,1,16,21,103,1.4
7782,Jeff White\jeff-white-1,2014-15,Loyola (IL),G,35,10,686,35,97,.361,27,69,.391,8,28,.286,25,32,.781,7,49,56,82,31,2,42,48,103,2.7
7783,Omari Lawrence\omari-lawrence-1,2013-14,Kansas State,G,33,1,423,38,90,.422,34,66,.515,4,24,.167,23,38,.605,15,45,60,29,21,7,23,59,103,2.2
7784,Dontaveon Robinson\dontaveon-robinson-1,2013-14,Jackson State,G,31,19,619,43,123,.350,43,122,.352,0,1,.000,17,25,.680,31,28,59,22,16,4,28,87,103,1.0
7785,Darraja Parnell\darraja-parnell-1,2017-18,Central Arkansas,G,32,1,303,37,88,.420,30,70,.429,7,18,.389,22,33,.667,18,44,62,31,15,1,33,44,103,2.0
7786,Broderick Newbill\broderick-newbill-1,2015-16,Missouri-Kansas City,G,17,0,288,35,75,.467,32,61,.525,3,14,.214,30,42,.714,20,36,56,7,6,7,13,18,103,4.7
7787,Denzel Brito\denzel-brito-1,2013-14,Loyola (MD),G,28,10,581,26,94,.277,17,46,.370,9,48,.188,42,54,.778,7,57,64,54,18,1,25,27,103,3.1
7788,Josh Langford\josh-langford-1,2014-15,Southeast Missouri State,G,22,1,322,37,92,.402,33,79,.418,4,13,.308,24,34,.706,15,25,40,6,9,6,26,54,102,1.6
7789,Ashley Williams\ashley-williams-1,2016-17,Western Carolina,G,20,3,266,31,86,.360,19,49,.388,12,37,.324,28,41,.683,11,13,24,8,6,4,21,20,102,2.3
7790,Lemmie Howard\lemmie-howard-1,2017-18,Jackson State,G,28,6,363,43,95,.453,33,63,.524,10,32,.313,6,10,.600,27,49,76,7,9,8,13,53,102,2.5
7791,Dan Peera\dan-peera-1,2014-15,Rice,G,32,1,516,38,70,.543,14,23,.609,24,47,.511,2,10,.200,6,42,48,32,15,0,24,61,102,2.2
7792,Jaylen Stowe\jaylen-stowe-1,2017-18,Mercer,G,34,0,441,37,80,.463,36,71,.507,1,9,.111,27,46,.587,26,73,99,17,20,3,29,61,102,2.2
7793,Anders Broman\anders-broman-1,2013-14,South Dakota State,G,26,5,372,32,92,.348,17,43,.395,15,49,.306,23,29,.793,4,21,25,27,5,2,16,39,102,2.0
7794,Steven Whitley\steven-whitley-1,2015-16,Robert Morris,G,31,9,519,38,95,.400,32,62,.516,6,33,.182,20,37,.541,8,47,55,37,24,3,43,52,102,1.7
7795,Cameron Morse\cameron-morse-1,2014-15,Youngstown State,G,17,2,265,31,73,.425,18,35,.514,13,38,.342,27,36,.750,4,17,21,22,13,1,11,19,102,4.6
7796,Zach Rufer\zach-rufer-1,2014-15,Lafayette,G,33,2,478,35,72,.486,14,27,.519,21,45,.467,11,17,.647,14,45,59,34,21,4,9,53,102,3.1
7797,Kikko Haydar\kikko-haydar-1,2013-14,Arkansas,G,34,4,417,29,74,.392,2,11,.182,27,63,.429,17,21,.810,12,31,43,27,20,0,15,68,102,2.2
7798,Jose Long\jose-long-1,2013-14,Alabama A&M,G,30,7,530,32,81,.395,28,63,.444,4,18,.222,34,67,.507,33,69,102,19,12,6,16,65,102,2.5
7799,Desure Buie\desure-buie-1,2015-16,Hofstra,G,34,0,427,37,114,.325,26,65,.400,11,49,.224,17,25,.680,5,28,33,49,27,3,27,44,102,1.9
7800,Mark Blackmon\mark-blackmon-1,2014-15,Maryland-Eastern Shore,G,33,0,280,32,70,.457,24,46,.522,8,24,.333,30,39,.769,9,18,27,11,22,0,12,38,102,2.3
7801,Zach Glotta\zach-glotta-1,2015-16,Austin Peay,G,33,8,489,34,86,.395,7,13,.538,27,73,.370,7,9,.778,4,30,34,39,16,0,23,51,102,2.0
7802,James Currington\james-currington-1,2015-16,Southeastern Louisiana,G,18,5,380,46,92,.500,46,92,.500,0,0,,10,23,.435,32,58,90,16,20,8,32,47,102,4.3
7803,Jalon Gates\jalon-gates-1,2016-17,Houston Baptist,G,21,3,225,30,94,.319,6,13,.462,24,81,.296,18,21,.857,3,8,11,7,5,2,7,18,102,2.3
7804,Armani Moore\armani-moore-1,2013-14,Tennessee,G,33,0,425,39,83,.470,32,57,.561,7,26,.269,17,29,.586,25,48,73,22,15,20,9,46,102,3.1
7805,Eli Wright\eli-wright-1,2017-18,Mississippi State,G,34,0,469,41,102,.402,35,74,.473,6,28,.214,14,22,.636,27,47,74,30,9,8,21,41,102,2.2
7806,Christian James\christian-james-1,2015-16,Oklahoma,G,35,0,333,29,68,.426,12,34,.353,17,34,.500,27,35,.771,14,46,60,19,12,3,25,34,102,2.1
7807,Casey Jones\casey-jones-1,2015-16,Chattanooga,G,8,7,237,41,83,.494,38,72,.528,3,11,.273,16,22,.727,20,32,52,31,4,9,25,15,101,10.2
7808,Marquise Moore\marquise-moore-1,2013-14,George Mason,G,26,19,577,36,89,.404,36,89,.404,0,0,,29,37,.784,12,50,62,69,14,16,40,51,101,3.3
7809,Clayton Hughes\clayton-hughes-1,2017-18,Indiana State,G,29,7,481,36,78,.462,22,33,.667,14,45,.311,15,20,.750,9,25,34,25,15,5,34,46,101,1.9
7810,Gunnar Olafsson\gunnar-olafsson-1,2015-16,St. Francis (NY),G,27,23,581,38,97,.392,19,33,.576,19,64,.297,6,10,.600,20,34,54,17,14,3,23,56,101,2.0
7811,Ahmad Caver\ahmad-caver-1,2015-16,Old Dominion,G,38,0,585,35,113,.310,22,65,.338,13,48,.271,18,36,.500,8,59,67,67,23,13,32,53,101,2.0
7812,Thomas Allen\thomas-allen-1,2017-18,Nebraska,G,32,0,318,34,86,.395,17,38,.447,17,48,.354,16,20,.800,5,26,31,17,7,0,20,8,101,1.9
7813,Tyree Crump\tyree-crump-1,2016-17,Georgia,G,28,1,207,33,95,.347,14,37,.378,19,58,.328,16,18,.889,3,16,19,13,3,0,14,11,101,1.7
7814,Jared Nickens\jared-nickens-1,2016-17,Maryland,G,33,1,337,32,98,.327,5,19,.263,27,79,.342,10,12,.833,6,23,29,8,4,2,13,27,101,1.3
7815,Andrew Fleming\andrew-fleming-2,2017-18,Lipscomb,G,32,1,267,29,93,.312,22,56,.393,7,37,.189,36,51,.706,14,26,40,18,6,1,34,33,101,1.0
7816,Raul Frias\raul-frias-1,2017-18,Long Island University,G,34,0,357,35,96,.365,10,19,.526,25,77,.325,6,8,.750,12,33,45,13,7,3,10,23,101,1.9
7817,McKay Cannon\mckay-cannon-1,2017-18,Brigham Young,G,29,0,536,33,79,.418,18,33,.545,15,46,.326,20,25,.800,5,29,34,42,27,1,21,41,101,3.1
7818,Josh Stamps\josh-stamps-1,2017-18,Florida International,G,12,4,235,35,93,.376,18,40,.450,17,53,.321,14,21,.667,6,16,22,8,7,1,11,20,101,4.2
7819,Zach Gengler\zach-gengler-1,2014-15,Portland State,G,22,13,415,35,88,.398,20,43,.465,15,45,.333,16,20,.800,6,49,55,31,13,0,15,48,101,3.2
7820,Quinton Ray\quinton-ray-1,2013-14,Campbell,G,32,32,802,36,117,.308,26,68,.382,10,49,.204,19,23,.826,13,48,61,89,19,1,51,57,101,2.0
7821,Tim Jacobs\tim-jacobs-1,2014-15,New Mexico,G,29,2,604,38,80,.475,36,59,.610,2,21,.095,23,42,.548,5,67,72,87,15,1,32,30,101,3.8
7822,Kajon Mack\kajon-mack-1,2014-15,Tulane,G,31,1,439,39,93,.419,31,58,.534,8,35,.229,15,20,.750,8,64,72,22,15,6,30,44,101,2.0
7823,Georgios Angelou\georgios-angelou-1,2015-16,Saint Francis (PA),G,28,0,394,30,63,.476,3,6,.500,27,57,.474,14,14,1.000,4,25,29,13,5,1,15,29,101,2.4
7824,Cheddi Mosely\cheddi-mosley-1,2016-17,Boston University,G,11,6,253,35,87,.402,12,21,.571,23,66,.348,8,13,.615,4,19,23,17,8,3,19,21,101,5.0
7825,Dionte Ferguson\dionte-ferguson-1,2013-14,South Alabama,G,27,1,342,33,64,.516,33,64,.516,0,0,,35,66,.530,34,50,84,3,8,15,20,43,101,2.9
7826,C.J. Rivers\cj-rivers-1,2014-15,Drake,G,29,17,516,40,80,.500,32,60,.533,8,20,.400,13,20,.650,10,61,71,39,15,0,31,31,101,2.8
7827,Kyson Rawls\kyson-rawls-1,2017-18,Morgan State,G,19,6,232,31,73,.425,6,20,.300,25,53,.472,14,19,.737,5,10,15,20,12,1,17,16,101,3.7
7828,Andrew Dakich\andrew-dakich-1,2017-18,Ohio State,G,34,1,646,36,76,.474,21,37,.568,15,39,.385,14,18,.778,13,49,62,72,32,1,37,40,101,3.4
7829,Pervis Louder\pervis-louder-1,2017-18,Air Force,G,16,5,291,35,92,.380,27,55,.491,8,37,.216,23,35,.657,10,29,39,28,8,3,22,37,101,3.4
7830,Keith Williams\keith-williams-10,2017-18,Cincinnati,G,33,0,326,40,104,.385,36,77,.468,4,27,.148,17,32,.531,15,25,40,14,15,5,27,23,101,1.5
7831,Cam Delaney\cam-delaney-1,2016-17,Sam Houston State,G,22,0,216,31,75,.413,10,23,.435,21,52,.404,17,23,.739,5,37,42,12,16,1,14,21,100,3.4
7832,Bobby Jones\bobby-jones-5,2013-14,Tennessee-Martin,G,27,2,251,32,95,.337,9,27,.333,23,68,.338,13,23,.565,10,18,28,4,11,3,8,36,100,1.8
7833,Quamauri Hardy\quamauri-hardy-1,2017-18,Arkansas-Pine Bluff,G,34,0,549,38,100,.380,31,80,.388,7,20,.350,17,27,.630,15,23,38,45,33,0,36,61,100,1.8
7834,Aaron Valdes\aaron-valdes-1,2013-14,Hawaii,G,31,3,282,41,78,.526,37,66,.561,4,12,.333,14,28,.500,23,39,62,10,9,6,13,33,100,2.5
7835,Will Adams\will-adams-2,2015-16,Presbyterian,G,27,12,391,33,100,.330,10,22,.455,23,78,.295,11,14,.786,12,29,41,15,9,2,15,23,100,2.1
7836,Bryan Trimble Jr.\bryan-trimblejr-1,2017-18,St. John's (NY),G,32,0,555,34,95,.358,8,14,.571,26,81,.321,6,7,.857,4,33,37,13,8,2,5,52,100,1.6
7837,James Ford\james-ford-1,2013-14,Quinnipiac,G,23,1,275,31,72,.431,13,27,.481,18,45,.400,20,22,.909,14,35,49,8,1,5,13,37,100,2.8
7838,James Washington\james-washington-2,2016-17,American,G,26,12,449,36,93,.387,25,50,.500,11,43,.256,17,23,.739,3,48,51,20,14,3,17,33,100,2.4
7839,Egor Koulechov\egor-koulechov-1,2013-14,Arizona State,G,27,7,377,35,80,.438,24,47,.511,11,33,.333,19,28,.679,23,53,76,16,10,6,21,35,100,2.8
7840,Teraes Clemmons\teraes-clemmons-1,2013-14,Jacksonville State,G,24,0,313,36,82,.439,30,63,.476,6,19,.316,22,26,.846,18,32,50,18,9,2,17,50,100,2.7
7841,Shaun Johnson\shaun-johnson-1,2013-14,McNeese State,G,28,0,276,33,105,.314,8,25,.320,25,80,.313,9,10,.900,12,18,30,14,12,0,9,26,100,2.0
7842,Devon Begley\devon-begley-1,2014-15,Northeastern,G,34,0,451,36,85,.424,21,55,.382,15,30,.500,13,15,.867,6,44,50,32,18,2,35,43,100,1.8
7843,Steven Jones\steven-jones-1,2014-15,UC-Riverside,G,18,13,455,35,83,.422,26,57,.456,9,26,.346,21,29,.724,8,34,42,57,14,1,38,51,100,3.6
7844,Dylan Miller\dylan-miller-1,2016-17,North Dakota State,G,29,20,312,43,78,.551,43,76,.566,0,2,.000,14,18,.778,23,34,57,7,5,19,8,36,100,3.0
7845,Malik Massey\malik-massey-1,2017-18,North Carolina-Greensboro,G,27,0,383,34,88,.386,21,45,.467,13,43,.302,19,25,.760,1,21,22,31,17,0,24,35,100,2.1
7846,Kye de Laveaga\kye-de-laveaga-1,2016-17,Northern Arizona,G,27,18,387,33,90,.367,2,11,.182,31,79,.392,3,6,.500,4,18,22,17,10,0,18,30,100,1.8
7847,Deontae North\deontae-north-1,2014-15,Cal State Long Beach,G,29,0,370,28,94,.298,16,51,.314,12,43,.279,32,41,.780,11,32,43,11,17,6,35,41,100,1.3
7848,Keaton Van Soelen\keaton-vansoelen-1,2017-18,Air Force,G,28,12,515,37,90,.411,31,54,.574,6,36,.167,20,30,.667,29,50,79,32,12,11,21,31,100,3.3
7849,Kwei Lartey\kwei-lartey-1,2017-18,North Carolina A&T,G,31,15,429,37,104,.356,20,43,.465,17,61,.279,9,17,.529,9,37,46,40,12,4,33,42,100,1.6
7850,Jordan McNeil\jordan-mcneil-1,2015-16,Towson,G,33,2,330,36,92,.391,20,41,.488,16,51,.314,12,23,.522,13,18,31,23,11,1,24,35,100,1.5
7851,Devocio Butler\devocio-butler-1,2016-17,Colorado State,G,17,0,309,32,79,.405,21,45,.467,11,34,.324,25,27,.926,13,28,41,15,16,1,16,19,100,4.6
7852,Silas Melson\silas-melson-1,2014-15,Gonzaga,G,31,0,297,38,91,.418,21,41,.512,17,50,.340,7,15,.467,5,18,23,10,16,2,12,27,100,1.9
7853,Dominique Dunning\dominique-dunning-1,2015-16,UC-Irvine,G,35,28,574,33,86,.384,26,69,.377,7,17,.412,27,47,.574,19,74,93,39,20,1,21,50,100,2.5
7854,Khari Holloway\khari-holloway-1,2016-17,Portland State,G,27,0,246,29,64,.453,19,38,.500,10,26,.385,32,36,.889,4,13,17,22,8,0,14,10,100,2.9
7855,A.J. Harris\aj-harris-2,2015-16,Ohio State,G,35,4,479,32,99,.323,16,50,.320,16,49,.327,19,28,.679,2,33,35,59,12,1,36,40,99,1.5
7856,Caleb Donnelly\caleb-donnelly-1,2014-15,Northeastern,G,31,0,251,31,62,.500,4,11,.364,27,51,.529,10,16,.625,5,21,26,5,1,0,7,15,99,2.2
7857,Amaad Wainright\amaad-wainright-1,2017-18,Kansas State,G,36,0,470,38,85,.447,26,46,.565,12,39,.308,11,26,.423,26,57,83,18,21,4,17,51,99,2.3
7858,Kenneth Ogbe\kenneth-ogbe-1,2014-15,Utah,G,22,5,288,30,70,.429,15,30,.500,15,40,.375,24,35,.686,4,27,31,12,5,1,18,24,99,2.5
7859,Adrian Rich\adrian-rich-1,2015-16,Virginia Military Institute,G,30,2,586,39,100,.390,34,75,.453,5,25,.200,16,25,.640,4,31,35,45,20,3,48,37,99,1.5
7860,Kylan Phillips\kylan-phillips-1,2017-18,Mississippi Valley State,G,23,13,483,39,117,.333,33,95,.347,6,22,.273,15,22,.682,12,46,58,31,18,0,22,40,99,2.3
7861,Anthony Monaco\anthony-monaco-1,2014-15,Northern Kentucky,G,22,8,425,32,95,.337,12,36,.333,20,59,.339,15,17,.882,4,48,52,21,10,3,30,52,99,1.7
7862,Shyquan Gibbs\shyquan-gibbs-1,2016-17,NJIT,G,30,13,623,35,95,.368,24,58,.414,11,37,.297,18,27,.667,6,28,34,49,22,1,30,44,99,2.2
7863,Deleon Brown\deleon-brown-1,2016-17,Colorado,G,31,3,371,32,87,.368,16,36,.444,16,51,.314,19,27,.704,8,14,22,19,11,3,17,30,99,1.8
7864,Cole Martinez\cole-martinez-1,2013-14,Texas A&M-Corpus Christi,G,32,0,279,31,79,.392,12,25,.480,19,54,.352,18,22,.818,6,18,24,20,7,2,5,37,99,2.1
7865,Breon Key\breon-key-1,2013-14,Hampton,G,17,0,296,30,53,.566,23,35,.657,7,18,.389,32,42,.762,13,17,30,21,11,2,16,49,99,4.4
7866,Elijah Landrum\elijah-landrum-1,2017-18,Southern Methodist,G,32,10,565,35,122,.287,16,45,.356,19,77,.247,10,16,.625,11,40,51,34,25,3,17,43,99,1.9
7867,Nych Smith\nych-smith-1,2017-18,Winthrop,G,14,1,264,32,84,.381,26,65,.400,6,19,.316,29,42,.690,0,23,23,30,16,1,21,19,99,4.6
7868,Russell Wilson\russell-wilson-2,2013-14,Samford,G,33,6,525,36,85,.424,36,78,.462,0,7,.000,27,56,.482,10,35,45,76,21,2,70,75,99,1.1
7869,R.J. McCray\rj-mccray-1,2013-14,Louisiana-Monroe,G,23,2,356,34,85,.400,20,50,.400,14,35,.400,17,23,.739,6,20,26,23,15,4,22,24,99,2.7
7870,Martez Harrison\martez-harrison-1,2016-17,Missouri-Kansas City,G,6,6,183,35,66,.530,28,50,.560,7,16,.438,22,26,.846,4,13,17,24,14,1,19,17,99,12.9
7871,Jordan Giusti\jordan-giusti-1,2013-14,Saint Mary's (CA),G,33,15,607,30,82,.366,14,35,.400,16,47,.340,23,36,.639,14,41,55,41,25,4,25,71,99,2.2
7872,Parker Jackson-Cartwright\parker-jackson-cartwright-1,2014-15,Arizona,G,34,0,328,34,75,.453,25,52,.481,9,23,.391,22,34,.647,6,41,47,60,11,1,23,33,99,2.6
7873,Biggie Minnis\deshon-minnis-1,2013-14,Rhode Island,G,21,11,439,35,78,.449,28,64,.438,7,14,.500,21,39,.538,12,37,49,52,15,2,43,55,98,2.7
7874,Aaron Korn\aaron-korn-1,2014-15,Lipscomb,G,30,2,442,31,90,.344,15,39,.385,16,51,.314,20,27,.741,8,66,74,18,8,1,20,37,98,1.9
7875,Cameron Posey\cameron-posey-1,2017-18,Arkansas-Pine Bluff,G,33,23,572,30,94,.319,18,55,.327,12,39,.308,26,32,.813,14,33,47,31,20,2,53,46,98,1.0
7876,Adam Pickett\adam-pickett-1,2016-17,Winthrop,G,31,1,256,33,68,.485,28,48,.583,5,20,.250,27,36,.750,8,36,44,18,23,6,26,45,98,2.3
7877,Marvin Smith\marvin-smith-2,2014-15,North Carolina-Greensboro,G,21,10,379,34,117,.291,19,72,.264,15,45,.333,15,26,.577,26,33,59,9,8,4,15,54,98,1.6
7878,Nick Masterson\nick-masterson-1,2014-15,Kennesaw State,G,27,4,362,33,88,.375,6,12,.500,27,76,.355,5,6,.833,10,10,20,16,7,5,18,28,98,1.9
7879,Allante Holston\allante-holston-1,2016-17,North Texas,G,30,8,537,36,85,.424,36,79,.456,0,6,.000,26,40,.650,14,62,76,27,15,6,32,42,98,2.2
7880,Xavier Adams\xavier-adams-1,2014-15,New Mexico,G,30,11,357,35,77,.455,26,47,.553,9,30,.300,19,38,.500,20,37,57,18,9,9,24,40,98,2.1
7881,Damon Wilson\damon-wilson-1,2015-16,Pittsburgh,G,30,0,324,29,84,.345,20,57,.351,9,27,.333,31,44,.705,4,29,33,43,8,2,21,30,98,2.1
7882,Jason Boswell\jason-boswell-1,2013-14,Florida International,G,31,11,553,31,73,.425,26,51,.510,5,22,.227,31,37,.838,7,29,36,56,13,3,48,55,98,1.8
7883,Will Goff\will-goff-1,2016-17,Boston University,G,28,1,402,30,77,.390,3,11,.273,27,66,.409,11,14,.786,6,34,40,17,10,2,21,24,98,2.2
7884,Kealen Washington-Ives\kealen-washington-ives-1,2017-18,Rider,G,32,2,445,35,96,.365,19,43,.442,16,53,.302,12,23,.522,8,27,35,46,14,0,29,52,98,1.6
7885,Demarcus Holland\demarcus-holland-1,2015-16,Texas,G,32,18,459,36,83,.434,28,56,.500,8,27,.296,18,39,.462,26,30,56,13,14,3,20,44,98,1.9
7886,Marcus Wallace\marcus-wallace-3,2016-17,Arkansas-Pine Bluff,G,24,1,337,33,75,.440,21,45,.467,12,30,.400,20,27,.741,12,14,26,14,9,0,36,28,98,1.7
7887,Augustine Ene\augustine-ene-1,2017-18,Incarnate Word,G,25,6,312,33,86,.384,26,62,.419,7,24,.292,25,31,.806,15,29,44,23,17,7,29,30,98,2.6
7888,Skyler Flatten\skyler-flatten-1,2014-15,South Dakota State,G,31,0,304,34,98,.347,19,45,.422,15,53,.283,15,22,.682,9,23,32,14,7,7,21,14,98,1.6
7889,Keon Clergeot\keon-clergeot-1,2016-17,Memphis,G,26,2,257,27,74,.365,14,32,.438,13,42,.310,31,40,.775,9,21,30,10,5,0,18,27,98,1.9
7890,Roddy Peters\roddy-peters-1,2015-16,South Florida,G,10,8,266,37,90,.411,35,76,.461,2,14,.143,22,35,.629,6,27,33,35,10,1,39,26,98,4.3
7891,Marquel Willis\marquel-willis-1,2014-15,Morehead State,G,23,0,236,27,70,.386,18,41,.439,9,29,.310,35,43,.814,10,23,33,9,2,1,16,27,98,2.3
7892,B.J. Glasford\bj-glasford-1,2014-15,Stetson,G,30,3,492,35,121,.289,21,64,.328,14,57,.246,14,23,.609,4,37,41,33,15,2,31,50,98,0.9
7893,Malcolm Duvivier\malcolm-duvivier-1,2013-14,Oregon State,G,32,0,366,36,73,.493,22,42,.524,14,31,.452,12,21,.571,5,17,22,14,3,1,24,41,98,1.2
7894,Jaquan McKennon\jaquan-mckennon-1,2016-17,Maine,G,24,0,309,38,97,.392,35,76,.461,3,21,.143,19,32,.594,10,24,34,58,7,2,36,33,98,2.3
7895,Jason Massey\jason-massey-1,2017-18,Brown,G,27,1,348,41,69,.594,40,66,.606,1,3,.333,15,23,.652,16,55,71,14,7,2,24,45,98,2.5
7896,Isiah Brown\isiah-brown-2,2017-18,Northwestern,G,25,0,270,32,81,.395,25,55,.455,7,26,.269,27,31,.871,5,17,22,30,9,0,25,38,98,2.0
7897,Jalan West\jalan-west-1,2017-18,Northwestern State,G,8,7,231,30,71,.423,6,21,.286,24,50,.480,14,15,.933,5,23,28,38,13,0,12,8,98,11.8
7898,Gary Ricks\gary-ricks-1,2013-14,Drake,G,9,8,247,32,65,.492,14,25,.560,18,40,.450,16,18,.889,0,30,30,29,12,2,8,15,98,10.4
7899,Justin Jenifer\justin-jenifer-1,2016-17,Cincinnati,G,35,0,445,37,89,.416,20,45,.444,17,44,.386,7,14,.500,8,26,34,68,16,0,16,32,98,2.7
7900,Garet Beal\garet-beal-1,2014-15,Maine,G,15,12,373,27,85,.318,14,42,.333,13,43,.302,30,41,.732,22,44,66,26,14,2,25,46,97,4.2
7901,Van Green\van-green-1,2014-15,Rice,G,32,9,452,36,99,.364,26,64,.406,10,35,.286,15,24,.625,15,54,69,14,14,3,32,37,97,1.4
7902,Ajon Efferson\ajon-efferson-1,2014-15,Cal State Northridge,G,26,0,291,35,96,.365,12,36,.333,23,60,.383,4,7,.571,2,13,15,16,4,0,16,20,97,1.5
7903,Timmy Rose\timmy-rose-1,2015-16,Binghamton,G,30,2,414,36,90,.400,25,49,.510,11,41,.268,14,29,.483,6,36,42,46,13,0,29,34,97,2.0
7904,Stanford Robinson\stanford-robinson-1,2014-15,Indiana,G,32,1,366,33,100,.330,33,90,.367,0,10,.000,31,53,.585,22,38,60,39,17,7,30,57,97,1.7
7905,Denzel Johnson\denzel-johnson-1,2013-14,Santa Clara,G,23,1,299,35,97,.361,31,77,.403,4,20,.200,23,34,.676,14,21,35,15,16,0,18,20,97,2.4
7906,Derek Brown\derek-brown-5,2017-18,Portland State,G,19,0,223,37,71,.521,33,55,.600,4,16,.250,19,30,.633,13,21,34,22,12,1,22,45,97,3.2
7907,Tyler Davis\tyler-davis-3,2013-14,Alabama A&M,G,29,16,432,32,78,.410,15,32,.469,17,46,.370,16,25,.640,5,12,17,14,14,0,12,31,97,2.0
7908,LaQuentin Collins\laquentin-collins-1,2017-18,Southern,G,32,8,363,27,79,.342,12,38,.316,15,41,.366,28,41,.683,12,39,51,25,10,5,29,26,97,1.8
7909,Payten Ricks\payten-ricks-1,2016-17,Abilene Christian,G,28,5,374,28,78,.359,19,42,.452,9,36,.250,32,45,.711,2,26,28,34,20,0,36,33,97,1.9
7910,Devin Liggeons\devin-liggeons-1,2016-17,Wagner,G,27,2,363,29,75,.387,19,36,.528,10,39,.256,29,39,.744,16,45,61,6,13,7,34,51,97,1.6
7911,Tyler Blount\tyler-blount-1,2016-17,Texas State,G,35,1,323,35,92,.380,13,29,.448,22,63,.349,5,5,1.000,1,22,23,16,4,0,8,15,97,1.6
7912,JoJo Fallas\jojo-fallas-1,2014-15,Cornell,G,30,0,358,33,92,.359,7,16,.438,26,76,.342,5,7,.714,5,24,29,16,13,1,14,30,97,1.8
7913,Dinero Mercurius\dinero-mercurius-1,2014-15,South Florida,G,29,3,404,33,84,.393,25,45,.556,8,39,.205,23,28,.821,16,39,55,21,11,0,15,54,97,2.1
7914,Darnell Foreman\darnell-foreman-1,2014-15,Pennsylvania,G,28,16,595,31,95,.326,21,56,.375,10,39,.256,25,33,.758,7,43,50,38,24,7,43,45,97,1.9
7915,Tashawn Desir\tashwan-desir-1,2014-15,Florida International,G,30,22,533,33,98,.337,22,62,.355,11,36,.306,20,30,.667,5,49,54,62,31,0,56,61,97,1.7
7916,Chris Quayle\chris-quayle-1,2017-18,North Dakota State,G,32,6,483,34,89,.382,13,32,.406,21,57,.368,8,9,.889,7,51,58,26,7,3,22,30,97,1.9
7917,Kylan Phillips\kylan-phillips-1,2016-17,Mississippi Valley State,G,27,16,634,34,118,.288,21,64,.328,13,54,.241,16,26,.615,6,45,51,52,26,1,32,44,97,2.0
7918,Isaiah Hobbs\isaiah-hobbs-1,2014-15,Texas-Rio Grande Valley,G,30,5,400,30,72,.417,30,57,.526,0,15,.000,37,60,.617,16,34,50,12,15,9,33,52,97,1.6
7919,Aaron Cook\aaron-cook-2,2016-17,Southern Illinois,G,32,0,338,27,81,.333,22,54,.407,5,27,.185,38,49,.776,7,19,26,30,31,8,27,28,97,2.4
7920,Devon Goodman\devon-goodman-1,2017-18,Pennsylvania,G,25,0,351,36,95,.379,26,55,.473,10,40,.250,14,26,.538,5,29,34,37,15,2,23,37,96,2.2
7921,Montana Byrd\montana-byrd-1,2014-15,Chicago State,G,28,7,328,31,103,.301,6,22,.273,25,81,.309,9,12,.750,10,26,36,8,11,2,19,30,96,1.3
7922,LeRon Barnes\leron-barnes-1,2013-14,Houston,G,30,15,388,35,89,.393,31,77,.403,4,12,.333,22,33,.667,19,56,75,13,9,13,12,59,96,2.2
7923,Reggie Reid\reggie-reid-1,2016-17,Florida Gulf Coast,G,33,3,457,37,101,.366,24,48,.500,13,53,.245,9,14,.643,2,34,36,65,21,1,32,34,96,2.2
7924,Chance McSpadden\chance-mcspadden-1,2017-18,Central Florida,G,18,3,303,35,94,.372,28,61,.459,7,33,.212,19,25,.760,14,39,53,10,13,2,30,16,96,2.7
7925,Larry Wideman\larry-wideman-1,2015-16,Furman,G,34,3,450,35,88,.398,19,30,.633,16,58,.276,10,18,.556,20,61,81,22,12,7,20,32,96,2.3
7926,Dennis Ashley\dennis-ashley-1,2016-17,Maine,G,30,0,329,30,105,.286,8,29,.276,22,76,.289,14,22,.636,3,16,19,25,4,0,10,25,96,1.3
7927,Von Julien\von-julien-1,2015-16,Tulane,G,31,15,588,37,104,.356,24,56,.429,13,48,.271,9,13,.692,5,36,41,67,16,0,33,49,96,2.0
7928,Eric Johnson\eric-johnson-4,2015-16,Boston University,G,23,8,396,30,77,.390,11,33,.333,19,44,.432,17,23,.739,3,20,23,44,22,2,21,37,96,3.4
7929,Austin White\austin-white-1,2017-18,High Point,G,30,1,516,37,101,.366,37,93,.398,0,8,.000,22,31,.710,7,28,35,18,23,2,15,53,96,1.7
7930,Tyrei Randall\tyrei-randall-1,2017-18,Rider,G,32,0,243,29,70,.414,9,23,.391,20,47,.426,18,26,.692,4,31,35,5,12,8,12,29,96,2.0
7931,Isiah Graves\isiah-graves-1,2016-17,Morgan State,G,29,0,305,29,87,.333,22,57,.386,7,30,.233,31,44,.705,8,26,34,33,19,4,29,41,96,1.9
7932,Marcus Love\marcus-love-1,2013-14,Jackson State,G,29,8,445,31,99,.313,22,56,.393,9,43,.209,25,41,.610,19,27,46,22,6,1,26,61,96,0.9
7933,Will Johnston\will-johnston-1,2013-14,Virginia Tech,G,30,10,598,29,82,.354,2,7,.286,27,75,.360,11,17,.647,5,57,62,20,10,1,14,39,96,2.1
7934,Demetrius Dyson\demetrius-dyson-1,2014-15,Massachusetts,G,29,0,310,31,97,.320,17,40,.425,14,57,.246,20,35,.571,26,32,58,14,9,3,11,31,96,2.1
7935,C.J. Siples\cj-siples-1,2017-18,Air Force,G,30,12,421,38,97,.392,28,48,.583,10,49,.204,10,18,.556,8,32,40,45,28,5,28,47,96,2.4
7936,Kendall Knorr\kendall-knorr-1,2015-16,Navy,G,32,32,446,37,103,.359,20,40,.500,17,63,.270,5,5,1.000,10,50,60,35,20,1,18,47,96,2.2
7937,Shomari Triggs\shomari-triggs-1,2014-15,Coppin State,G,26,0,323,33,108,.306,20,52,.385,13,56,.232,17,27,.630,8,21,29,18,15,2,25,31,96,1.3
7938,Cameron Smith\cameron-smith-1,2015-16,Dartmouth,G,27,17,376,28,77,.364,25,64,.391,3,13,.231,37,53,.698,11,27,38,25,16,3,16,47,96,2.4
7939,Chase Cormier\chase-comier-1,2016-17,Grambling,G,29,29,714,29,100,.290,17,61,.279,12,39,.308,26,44,.591,15,43,58,71,26,0,40,71,96,2.1
7940,Keaton Moffitt\keaton-moffitt-1,2014-15,South Dakota State,G,29,5,457,31,71,.437,29,64,.453,2,7,.286,32,46,.696,21,55,76,41,23,4,24,43,96,3.4
7941,Pat McNamara\pat-mcnamara-1,2015-16,New Hampshire,G,24,0,247,32,75,.427,2,9,.222,30,66,.455,2,2,1.000,1,7,8,10,8,0,5,13,96,2.7
7942,Zach Rufer\zach-rufer-1,2013-14,Lafayette,G,26,0,404,33,92,.359,11,30,.367,22,62,.355,8,19,.421,8,43,51,15,26,0,10,49,96,2.5
7943,Malcolm Bernard\malcolm-bernard-1,2013-14,Charleston Southern,G,28,6,407,26,71,.366,21,51,.412,5,20,.250,39,65,.600,36,62,98,36,18,6,23,42,96,3.5
7944,Malik Gill\malik-gill-1,2015-16,Dartmouth,G,24,5,419,29,88,.330,18,47,.383,11,41,.268,27,45,.600,3,29,32,66,38,1,48,40,96,2.9
7945,Nazareth Mitrou-Long\nazareth-mitrou-long-1,2015-16,Iowa State,G,8,8,253,37,87,.425,21,32,.656,16,55,.291,6,10,.600,4,19,23,15,5,2,17,16,96,6.3
7946,Derryck Thornton\derryck-thornton-1,2017-18,Southern California,G,25,1,356,33,91,.363,26,69,.377,7,22,.318,23,27,.852,3,33,36,31,18,4,34,22,96,2.2
7947,Wil Bathurst\will-bathurst-1,2015-16,Cornell,G,25,0,371,38,104,.365,30,74,.405,8,30,.267,12,24,.500,10,49,59,12,12,9,32,44,96,1.3
7948,Devin Coleman\devin-coleman-1,2014-15,Temple,G,27,0,309,37,105,.352,19,44,.432,18,61,.295,4,14,.286,14,49,63,19,11,2,15,18,96,2.3
7949,Dean Danos\dean-danos-1,2015-16,Northern Kentucky,G,29,6,377,29,64,.453,7,18,.389,22,46,.478,16,24,.667,4,39,43,41,11,0,32,44,96,2.2
7950,Dederick Lee\dederick-lee-1,2016-17,South Alabama,G,32,28,592,28,89,.315,6,23,.261,22,66,.333,18,30,.600,6,50,56,81,28,6,42,55,96,2.6
7951,Troy Stancil\troy-stancil-1,2015-16,Jackson State,G,33,6,322,34,97,.351,16,30,.533,18,67,.269,10,19,.526,11,23,34,5,9,5,14,38,96,1.2
7952,Ethan Alvano\ethan-alvano-1,2014-15,Eastern Michigan,G,28,17,405,20,85,.235,12,44,.273,8,41,.195,47,56,.839,8,31,39,50,23,2,24,23,95,2.9
7953,Payton Hulsey\payton-hulsey-1,2013-14,Western Kentucky,G,31,8,418,26,64,.406,21,49,.429,5,15,.333,38,55,.691,26,59,85,46,18,3,38,41,95,2.8
7954,Anthony Wright\anthony-wright-2,2016-17,Cleveland State,G,28,3,364,39,80,.488,33,61,.541,6,19,.316,11,17,.647,28,54,82,19,18,8,23,33,95,3.2
7955,Qiydar Davis\qiydar-davis-1,2014-15,Louisiana Tech,G,29,0,292,38,88,.432,34,74,.459,4,14,.286,15,26,.577,29,35,64,5,13,6,17,49,95,2.0
7956,Dusan Majstorovic\dusan-majstorovic-1,2017-18,Maine,G,24,7,380,33,108,.306,20,49,.408,13,59,.220,16,20,.800,17,39,56,15,14,4,20,35,95,2.0
7957,Sam Cunliffe\sam-cunliffe-1,2016-17,Arizona State,G,10,10,254,31,89,.348,16,52,.308,15,37,.405,18,29,.621,6,42,48,14,5,3,18,26,95,4.6
7958,Jaleni Neely\jaleni-neely-1,2014-15,Northern Arizona,G,12,9,365,26,86,.302,8,35,.229,18,51,.353,25,29,.862,9,24,33,34,10,1,26,29,95,4.5
7959,Hunter Rhodes\hunter-rhodes-1,2017-18,Northern Iowa,G,23,6,393,28,78,.359,14,34,.412,14,44,.318,25,27,.926,2,35,37,30,8,0,7,31,95,3.1
7960,Lanerryl Johnson\lanerryl-johnson-1,2015-16,Cal State Fullerton,G,10,3,202,37,94,.394,28,62,.452,9,32,.281,12,16,.750,3,15,18,13,2,0,17,11,95,3.9
7961,Jacob Ledoux\jacob-ledoux-1,2016-17,McNeese State,G,24,0,240,38,85,.447,37,63,.587,1,22,.045,18,28,.643,13,27,40,10,8,0,27,32,95,1.6
7962,Samson Usilo\samson-usilo-1,2016-17,Manhattan,G,30,14,405,35,99,.354,34,91,.374,1,8,.125,24,51,.471,35,62,97,10,14,10,34,45,95,1.6
7963,Jordan Baker\jordan-baker-2,2014-15,San Jose State,G,9,8,291,35,99,.354,26,68,.382,9,31,.290,16,24,.667,9,31,40,37,9,3,32,21,95,5.4
7964,Matt Zignorski\matt-zignorski-1,2017-18,Holy Cross,G,28,13,475,31,80,.388,12,28,.429,19,52,.365,14,18,.778,1,26,27,30,9,3,11,28,95,2.4
7965,C.J. Wiggins\cj-wiggins-1,2015-16,North Carolina Central,G,23,11,333,35,91,.385,32,85,.376,3,6,.500,22,36,.611,5,21,26,51,3,0,22,17,95,2.6
7966,Marcel Davis\marcel-davis-1,2013-14,Utah State,G,27,11,459,33,80,.413,30,70,.429,3,10,.300,26,38,.684,9,35,44,74,16,1,27,38,95,3.4
7967,Rogers Printup\rogers-printup-1,2017-18,UC-Davis,G,25,1,344,33,84,.393,10,18,.556,23,66,.348,6,6,1.000,2,32,34,8,8,5,12,37,95,2.0
7968,Keon Hill\keon-hill-1,2015-16,Howard,G,32,3,413,36,112,.321,19,60,.317,17,52,.327,6,10,.600,6,18,24,36,7,1,39,35,95,0.6
7969,Scott Meredith\scott-meredith-1,2016-17,Saint Francis (PA),G,27,2,262,30,81,.370,4,11,.364,26,70,.371,9,10,.900,1,24,25,14,11,0,11,18,95,2.2
7970,Chazz Patterson\chazz-patterson-1,2014-15,Saint Peter's,G,33,7,556,25,80,.313,8,25,.320,17,55,.309,28,38,.737,7,55,62,24,22,3,27,53,95,1.8
7971,Austin Pauga\austin-pauga-1,2016-17,Northern Illinois,G,30,1,399,32,86,.372,4,8,.500,28,78,.359,3,4,.750,12,15,27,13,10,1,5,25,95,2.2
7972,DaJuan Smith\dajuan-smith-1,2014-15,UC-Santa Barbara,G,30,7,419,38,84,.452,36,77,.468,2,7,.286,17,29,.586,14,47,61,45,12,3,24,28,95,2.7
7973,Kameron Mitchell\kameron-mitchell-1,2016-17,Stony Brook,G,32,23,555,29,76,.382,18,37,.486,11,39,.282,26,38,.684,5,41,46,30,21,4,29,73,95,1.6
7974,Marco Porcher Jimenez\marco-porcher-1,2014-15,Florida International,G,28,1,380,34,93,.366,10,21,.476,24,72,.333,3,5,.600,3,32,35,11,6,1,16,27,95,1.5
7975,Eric Childress\eric-childress-1,2014-15,UC-Santa Barbara,G,33,8,602,30,83,.361,23,57,.404,7,26,.269,28,41,.683,14,63,77,70,23,3,42,62,95,2.4
7976,Davion Mintz\davion-mintz-1,2016-17,Creighton,G,29,12,354,30,78,.385,21,53,.396,9,25,.360,26,33,.788,1,31,32,52,15,4,34,35,95,2.3
7977,Jordan Griffin\jordan-griffin-2,2016-17,Cal State Long Beach,G,32,5,340,37,109,.339,17,37,.459,20,72,.278,1,2,.500,4,22,26,10,9,1,11,13,95,1.3
7978,Brailen Neely\brailen-neely-1,2017-18,Oakland,G,24,14,511,29,68,.426,22,44,.500,7,24,.292,30,35,.857,6,38,44,133,27,2,51,37,95,5.3
7979,Devin Peterson\devin-peterson-1,2014-15,Western Carolina,G,32,2,413,34,86,.395,26,61,.426,8,25,.320,19,32,.594,11,22,33,29,16,4,27,46,95,1.6
7980,Jordan Chatman\jordan-chatman-1,2015-16,Brigham Young,G,36,0,359,35,92,.380,17,39,.436,18,53,.340,7,10,.700,3,32,35,27,4,5,20,36,95,1.3
7981,Jaleni Neely\jaleni-neely-1,2015-16,Northern Arizona,G,9,8,278,26,76,.342,6,20,.300,20,56,.357,23,29,.793,3,22,25,19,14,1,11,21,95,7.5
7982,Markell Henderson\markell-henderson-1,2016-17,Tennessee Tech,G,20,7,226,35,87,.402,21,36,.583,14,51,.275,11,15,.733,5,13,18,7,7,7,7,26,95,2.7
7983,Jalen Rhea\jalen-rhea-1,2016-17,American,G,24,4,342,31,84,.369,3,7,.429,28,77,.364,5,7,.714,10,11,21,5,8,4,8,32,95,2.2
7984,Buay Tuach\buay-tuach-1,2015-16,Loyola Marymount,G,26,11,324,32,92,.348,15,40,.375,17,52,.327,14,21,.667,12,30,42,24,14,4,10,31,95,2.7
7985,Roland Nyama\roland-nyama-1,2015-16,Stony Brook,G,31,1,305,30,71,.423,15,32,.469,15,39,.385,20,26,.769,10,36,46,13,5,6,13,38,95,2.0
7986,JayQuan McCloud\jayquan-mccloud-1,2015-16,Milwaukee,G,18,0,247,33,83,.398,24,54,.444,9,29,.310,20,25,.800,13,18,31,15,8,5,16,27,95,3.2
7987,Charles Falden\charles-falden-1,2017-18,Winthrop,G,26,1,294,36,79,.456,19,48,.396,17,31,.548,6,9,.667,14,27,41,14,12,0,25,28,95,2.2
7988,Javares Brent\javeres-brent-1,2016-17,Jackson State,G,26,5,390,32,97,.330,3,13,.231,29,84,.345,1,3,.333,7,38,45,15,9,3,13,27,94,2.0
7989,Luka Vulikic\luka-vulikic-1,2016-17,Eastern Washington,G,32,20,513,35,81,.432,31,68,.456,4,13,.308,20,36,.556,23,66,89,23,13,8,29,43,94,2.2
7990,Christian Sanders\christian-sanders-1,2016-17,Stanford,G,31,17,532,29,71,.408,18,48,.375,11,23,.478,25,38,.658,3,57,60,103,14,3,55,54,94,2.6
7991,Naiel Smith\naiel-smith-1,2015-16,Ball State,G,35,18,664,36,108,.333,25,68,.368,11,40,.275,11,25,.440,6,78,84,95,38,4,59,86,94,2.0
7992,Jordan Foster\jordan-foster-1,2013-14,Western Illinois,G,30,11,476,32,84,.381,19,50,.380,13,34,.382,17,23,.739,3,34,37,49,15,1,38,52,94,1.6
7993,Ronnye Beamon\ronnye-beamon-1,2015-16,Morehead State,G,37,1,409,30,74,.405,25,61,.410,5,13,.385,29,51,.569,23,32,55,14,20,7,23,73,94,1.4
7994,Bryson Scott\bryson-scott-1,2014-15,Purdue,G,25,1,268,30,78,.385,29,70,.414,1,8,.125,33,46,.717,7,33,40,29,18,3,27,32,94,2.5
7995,Deriece Parks\deriece-parks-1,2016-17,Western Carolina,G,10,9,251,34,95,.358,16,35,.457,18,60,.300,8,9,.889,11,19,30,20,8,2,25,16,94,4.6
7996,Ben Vozzola\ben-vozzola-1,2013-14,Cal State Northridge,G,33,0,316,34,94,.362,16,44,.364,18,50,.360,8,8,1.000,4,30,34,32,9,0,31,32,94,1.2
7997,Jaylan Robertson\jaylan-robertson-1,2016-17,Coastal Carolina,G,26,2,356,35,90,.389,22,53,.415,13,37,.351,11,19,.579,5,26,31,30,17,1,30,31,94,1.9
7998,Jalen Rhea\jalen-rhea-1,2015-16,American,G,22,1,366,29,86,.337,7,21,.333,22,65,.338,14,21,.667,14,13,27,9,11,0,9,35,94,2.3
7999,Nassir Barrino\nassir-barrino-1,2016-17,San Diego,G,30,14,536,38,99,.384,38,93,.409,0,6,.000,18,42,.429,12,54,66,37,18,0,33,56,94,1.4
8000,Darius Thompson\darius-thompson-1,2013-14,Tennessee,G,37,10,621,32,84,.381,24,43,.558,8,41,.195,22,30,.733,11,62,73,87,36,8,34,56,94,3.2
8001,Jordon King\jordon-king-1,2016-17,Purdue-Fort Wayne,G,23,0,205,35,78,.449,23,38,.605,12,40,.300,12,14,.857,7,23,30,14,5,3,13,26,94,2.5
8002,Janai Raynor Powell\janai-raynorpowell-1,2016-17,South Carolina State,G,31,9,524,34,86,.395,21,46,.457,13,40,.325,13,19,.684,11,56,67,53,19,3,49,45,94,2.0
8003,Austin Ajukwa\austin-ajukwa-1,2014-15,Clemson,G,30,0,363,35,98,.357,24,58,.414,11,40,.275,13,20,.650,17,38,55,12,19,5,20,46,94,1.7
8004,John Marshall\john-marshall-1,2014-15,Southern Utah,G,29,10,447,28,65,.431,27,54,.500,1,11,.091,37,50,.740,6,25,31,54,14,3,34,59,94,2.2
8005,D'Mitrik Trice\dmitrik-trice-1,2017-18,Wisconsin,G,10,10,315,35,92,.380,23,52,.442,12,40,.300,12,17,.706,2,18,20,23,6,1,13,13,94,5.3
8006,Davon Hayes\davon-hayes-1,2014-15,Southern Mississippi,G,22,5,307,29,79,.367,15,41,.366,14,38,.368,22,33,.667,5,25,30,16,8,2,28,25,94,1.8
8007,Jade' Smith\jade-smith-1,2017-18,Pepperdine,G,24,6,399,38,102,.373,37,81,.457,1,21,.048,17,30,.567,17,45,62,29,22,6,21,48,94,2.7
8008,Anthony Monaco\anthony-monaco-1,2013-14,Northern Kentucky,G,30,16,629,24,73,.329,17,33,.515,7,40,.175,39,46,.848,15,71,86,40,15,4,33,76,94,2.1
8009,Jimmy Barton\jimmy-barton-1,2013-14,Houston Baptist,G,31,12,516,34,98,.347,20,48,.417,14,50,.280,12,18,.667,11,24,35,57,15,0,43,46,94,1.5
8010,James Bolden\james-bolden-1,2016-17,West Virginia,G,27,0,156,32,69,.464,10,20,.500,22,49,.449,8,14,.571,7,14,21,8,8,1,9,21,94,2.3
8011,Zach Lamb\zachary-lamb-1,2013-14,Cal State Bakersfield,G,25,3,260,32,90,.356,23,64,.359,9,26,.346,21,24,.875,4,19,23,26,8,1,13,28,94,2.2
8012,Ben Emelogu\ben-emelogu-1,2014-15,Southern Methodist,G,34,4,516,31,112,.277,15,52,.288,16,60,.267,16,22,.727,7,55,62,34,20,7,29,45,94,1.4
8013,Joe Crisman\joe-crisman-1,2014-15,Loyola (IL),G,37,21,626,34,78,.436,26,53,.491,8,25,.320,18,32,.563,16,71,87,49,32,7,39,31,94,2.7
8014,Devin Wilson\devin-wilson-2,2017-18,Virginia Tech,G,33,14,540,35,66,.530,31,49,.633,4,17,.235,20,41,.488,8,55,63,56,15,2,19,55,94,2.7
8015,John Azzinaro\john-azzinaro-1,2013-14,Bucknell,G,28,0,359,33,98,.337,17,50,.340,16,48,.333,12,17,.706,5,20,25,25,10,0,14,45,94,1.5
8016,Richie Mitchell\richie-mitchell-1,2016-17,Marist,G,29,1,336,30,96,.313,21,63,.333,9,33,.273,25,26,.962,4,29,33,26,13,0,24,29,94,1.6
8017,Isaac White\isaac-white-1,2016-17,Massachusetts-Lowell,G,10,9,275,30,66,.455,12,15,.800,18,51,.353,16,17,.941,1,16,17,21,1,0,19,19,94,5.4
8018,Costa Anderson\costa-anderson-1,2017-18,Albany (NY),G,29,1,325,32,90,.356,9,22,.409,23,68,.338,7,9,.778,5,21,26,21,8,0,10,9,94,2.1
8019,Connor Brooks\connor-brooks-1,2013-14,Stephen F. Austin,G,35,0,364,36,85,.424,26,54,.481,10,31,.323,12,16,.750,14,19,33,35,9,1,23,34,94,1.7
8020,Randy Onwuasor\randy-onwuasor-1,2013-14,Texas Tech,G,32,0,403,32,89,.360,29,69,.420,3,20,.150,27,42,.643,15,27,42,40,19,2,44,57,94,1.2
8021,Jake Holtzmann\jake-holtzmann-1,2017-18,Denver,G,26,1,366,28,73,.384,8,21,.381,20,52,.385,18,21,.857,7,33,40,29,5,2,26,22,94,2.3
8022,Kanayo Obi-Rapu\kanayo-obi-rapu-1,2017-18,East Tennessee State,G,28,1,279,27,82,.329,6,18,.333,21,64,.328,19,22,.864,8,26,34,15,7,2,8,30,94,2.1
8023,Trey Pinkney\trey-pinkney-1,2015-16,Stephen F. Austin,G,34,34,889,27,59,.458,20,36,.556,7,23,.304,32,47,.681,10,52,62,126,52,1,28,77,93,4.7
8024,Carlbe Ervin II\carlbe-ervinii-1,2016-17,Kansas State,G,35,0,497,33,68,.485,24,45,.533,9,23,.391,18,25,.720,24,64,88,49,22,7,36,57,93,2.7
8025,Justin Seymour\justin-seymour-1,2016-17,Georgia State,G,14,7,254,33,83,.398,18,39,.462,15,44,.341,12,16,.750,8,20,28,15,6,0,18,23,93,3.4
8026,A.J. Astroth\aj-astroth-1,2014-15,Towson,G,28,16,446,31,79,.392,21,43,.488,10,36,.278,21,38,.553,30,45,75,9,13,2,19,49,93,2.1
8027,Zach Fong\zach-fong-1,2015-16,Navy,G,27,0,273,29,89,.326,5,18,.278,24,71,.338,11,13,.846,4,22,26,12,5,1,7,24,93,1.8
8028,Petey McClain\petey-mcclain-1,2015-16,East Tennessee State,G,36,31,717,34,84,.405,27,53,.509,7,31,.226,18,30,.600,17,68,85,94,34,3,48,79,93,2.7
8029,Winfield Willis\winfield-willis-1,2015-16,NJIT,G,9,9,248,30,71,.423,18,37,.486,12,34,.353,21,22,.955,9,19,28,24,8,1,14,18,93,7.9
8030,David Nickelberry\david-nickelberry-1,2017-18,Memphis,G,33,0,360,38,92,.413,30,60,.500,8,32,.250,9,16,.563,13,43,56,31,12,5,31,27,93,1.8
8031,Matt Hunter\matt-hunter-1,2013-14,Central Connecticut State,G,10,7,289,39,92,.424,36,78,.462,3,14,.214,12,21,.571,19,44,63,13,18,13,26,24,93,6.8
8032,Robert Lewis\robert-lewis-5,2017-18,Texas Southern,G,16,6,310,31,77,.403,14,33,.424,17,44,.386,14,24,.583,2,31,33,11,3,3,12,23,93,3.1
8033,JaQuel Richmond\jaquel-richmond-1,2014-15,Middle Tennessee,G,27,13,451,32,108,.296,17,71,.239,15,37,.405,14,17,.824,3,32,35,60,12,0,45,42,93,1.2
8034,Jeremiah Usiosefe\jeremiah-usiosefe-1,2017-18,Western Illinois,G,15,15,356,27,60,.450,11,18,.611,16,42,.381,23,26,.885,3,60,63,24,6,4,16,26,93,5.3
8035,Jordan Robertson\jordan-robertson-2,2016-17,Colgate,G,28,6,352,33,91,.363,23,55,.418,10,36,.278,17,27,.630,11,23,34,12,3,8,23,33,93,1.2
8036,John Azzinaro\john-azzinaro-1,2016-17,Bucknell,G,31,1,250,32,83,.386,8,25,.320,24,58,.414,5,8,.625,1,17,18,6,8,0,15,20,93,1.3
8037,Denzel Gregg\denzel-gregg-1,2014-15,St. Bonaventure,G,25,6,434,40,97,.412,40,91,.440,0,6,.000,13,30,.433,34,46,80,23,17,23,34,56,93,2.6
8038,Shirmane Thomas\shirmane-thomas-1,2014-15,Tennessee Tech,G,27,24,529,34,111,.306,34,87,.391,0,24,.000,25,44,.568,8,47,55,66,19,14,58,56,93,1.3
8039,Justin McCloud\justin-mccloud-1,2014-15,Illinois State,G,30,0,351,30,81,.370,1,6,.167,29,75,.387,4,5,.800,3,28,31,16,8,1,10,15,93,2.1
8040,Manuale Watkins\manuale-watkins-1,2014-15,Arkansas,G,36,0,502,38,68,.559,38,61,.623,0,7,.000,17,24,.708,17,56,73,39,37,0,28,54,93,2.8
8041,Kevion Nolan\kevion-nolan-1,2017-18,Samford,G,29,1,371,34,87,.391,14,26,.538,20,61,.328,5,7,.714,5,25,30,27,20,4,10,28,93,2.6
8042,Aaron Robinson\aaron-robinson-2,2017-18,Quinnipiac,G,30,0,467,34,82,.415,10,14,.714,24,68,.353,1,6,.167,15,58,73,14,14,1,8,35,93,2.6
8043,Matt O'Boyle\matt-oboyle-1,2015-16,Appalachian State,G,31,1,371,30,95,.316,9,20,.450,21,75,.280,12,25,.480,22,47,69,13,3,3,16,41,93,1.4
8044,Ronnie Harrell\ronnie-harrell-1,2015-16,Creighton,G,29,0,296,30,84,.357,20,54,.370,10,30,.333,23,37,.622,19,57,76,28,11,1,25,32,93,2.2
8045,Terrence Lewis\terrence-lewis-2,2017-18,Iowa State,G,27,1,297,32,105,.305,15,46,.326,17,59,.288,12,18,.667,16,20,36,9,9,7,14,34,93,1.5
8046,Tony Chennault\tony-chennault-1,2013-14,Villanova,G,34,3,487,28,72,.389,28,69,.406,0,3,.000,37,49,.755,10,37,47,62,21,2,33,56,93,2.3
8047,D'Juan Miller\djuan-miller-1,2014-15,Illinois-Chicago,G,20,15,514,35,115,.304,28,87,.322,7,28,.250,16,27,.593,13,40,53,80,22,2,43,40,93,3.2
8048,Alex Watson\alex-watson-2,2017-18,Sacred Heart,G,26,6,404,33,86,.384,20,42,.476,13,44,.295,14,19,.737,7,31,38,21,13,5,25,41,93,1.8
8049,Darian Adams\darian-adams-1,2017-18,Troy,G,32,0,496,31,90,.344,21,47,.447,10,43,.233,21,36,.583,12,47,59,35,11,3,27,39,93,1.7
8050,Steven Wronkoski\steven-wronkoski-1,2014-15,Louisiana,G,36,0,418,31,75,.413,13,22,.591,18,53,.340,13,19,.684,18,43,61,26,7,1,17,31,93,2.0
8051,Daniel Dixon\daniel-dixon-1,2013-14,William & Mary,G,26,0,332,30,78,.385,5,13,.385,25,65,.385,7,11,.636,5,36,41,18,11,7,12,39,92,2.4
8052,Jeff White\jeff-white-1,2015-16,Loyola (IL),G,31,7,615,40,95,.421,35,68,.515,5,27,.185,7,13,.538,5,53,58,57,26,0,32,49,92,2.3
8053,Aaron Hines\aaron-hines-1,2015-16,Saint Louis,G,23,15,395,34,117,.291,29,83,.349,5,34,.147,19,26,.731,4,32,36,47,13,0,22,42,92,1.8
8054,Chad Culbreath\chad-culbreath-1,2015-16,Murray State,G,23,1,254,35,92,.380,23,49,.469,12,43,.279,10,18,.556,7,20,27,32,16,0,24,38,92,2.1
8055,Jaylen Fornes\jaylen-fornes-1,2016-17,North Carolina-Wilmington,G,30,4,240,28,68,.412,10,28,.357,18,40,.450,18,32,.563,12,18,30,18,8,1,14,33,92,1.9
8056,Cory Cardwell\cory-cardwell-1,2015-16,Utah Valley,G,27,1,319,30,79,.380,7,14,.500,23,65,.354,9,11,.818,2,28,30,26,9,2,9,34,92,2.4
8057,Armani Chaney\armani-chaney-1,2015-16,Tennessee State,G,23,0,297,33,85,.388,27,64,.422,6,21,.286,20,27,.741,5,22,27,33,17,1,26,31,92,2.4
8058,Ian Sistare\ian-sistare-1,2017-18,Dartmouth,G,27,0,363,30,83,.361,13,31,.419,17,52,.327,15,23,.652,9,39,48,24,3,2,25,20,92,1.8
8059,Sam Daly\sam-daly-1,2013-14,Grand Canyon,G,13,11,372,31,72,.431,28,54,.519,3,18,.167,27,44,.614,6,38,44,54,10,3,37,41,92,4.6
8060,Jalen Little\jalen-little-1,2014-15,Abilene Christian,G,31,30,803,27,96,.281,15,58,.259,12,38,.316,26,33,.788,6,59,65,112,29,0,50,63,92,2.8
8061,Nemanja Zarkovic\nemanja-zarkovic-1,2015-16,Fordham,G,31,1,559,32,102,.314,12,32,.375,20,70,.286,8,12,.667,14,34,48,42,16,1,17,73,92,1.7
8062,Geno Luzcando\geno-luzcando-1,2014-15,Idaho State,G,30,1,469,32,88,.364,20,45,.444,12,43,.279,16,33,.485,6,39,45,44,36,1,42,66,92,1.7
8063,Malik Morgan\malik-morgan-1,2013-14,Louisiana State,G,21,6,326,32,88,.364,23,52,.442,9,36,.250,19,37,.514,28,38,66,23,17,6,17,39,92,3.4
8064,Jamar Redmond\jamar-redmond-1,2014-15,Morgan State,G,26,1,244,31,97,.320,11,28,.393,20,69,.290,10,21,.476,13,11,24,6,6,1,11,33,92,1.2
8065,Hudson Price\hudson-price-1,2017-18,Charlotte,G,9,9,258,32,51,.627,21,30,.700,11,21,.524,17,22,.773,6,37,43,9,9,1,14,24,92,8.3
8066,Tray Hollowell\tray-hollowell-1,2017-18,Wofford,G,29,0,266,32,79,.405,11,21,.524,21,58,.362,7,8,.875,1,24,25,21,6,0,27,16,92,1.5
8067,Jack Montague\jack-montague-1,2013-14,Yale,G,26,0,305,31,65,.477,9,21,.429,22,44,.500,8,14,.571,8,16,24,35,7,1,35,23,92,2.1
8068,Jalin Hart\jalin-hart-1,2017-18,Incarnate Word,G,11,9,312,32,94,.340,23,61,.377,9,33,.273,19,31,.613,5,21,26,43,14,5,37,23,92,4.1
8069,Fred Richardson\fred-richardson-1,2015-16,Colorado State,G,26,5,370,28,78,.359,17,37,.459,11,41,.268,25,35,.714,21,48,69,18,5,1,16,41,92,2.3
8070,Mar'Qywell Jackson\marqywell-jackson-1,2015-16,Duquesne,G,25,0,263,29,80,.363,10,24,.417,19,56,.339,15,24,.625,14,37,51,9,4,3,12,39,92,2.0
8071,Jeremy Adams\jeremy-adams-2,2013-14,Grand Canyon,G,16,7,300,25,79,.316,24,67,.358,1,12,.083,41,61,.672,20,22,42,10,6,1,15,38,92,2.7
8072,Marcus Merriweather\marcus-merriweather-1,2014-15,Alabama A&M,G,26,1,253,27,86,.314,15,52,.288,12,34,.353,25,36,.694,5,16,21,17,4,1,23,25,91,1.1
8073,A.J. Lapray\aj-lapray-1,2017-18,Rice,G,10,2,211,31,75,.413,7,19,.368,24,56,.429,5,5,1.000,4,29,33,8,10,0,15,18,91,5.6
8074,Ryan Bernstein\ryan-bernstein-1,2015-16,Maine,G,24,5,432,36,97,.371,23,55,.418,13,42,.310,6,15,.400,16,29,45,47,16,2,35,35,91,2.3
8075,Austin Tilghman\austin-tilghman-1,2014-15,Monmouth,G,33,0,495,24,67,.358,18,51,.353,6,16,.375,37,60,.617,11,56,67,53,17,1,49,38,91,1.8
8076,Emmanuel Toney\emmanuel-toney-1,2014-15,Texas A&M-Corpus Christi,G,34,25,656,31,71,.437,26,50,.520,5,21,.238,24,32,.750,30,38,68,27,32,2,24,58,91,2.6
8077,Quevyn Winters\quevyn-winters-1,2014-15,Washington,G,27,1,299,33,111,.297,16,42,.381,17,69,.246,8,10,.800,10,26,36,19,8,1,23,27,91,1.1
8078,Rashad Lewis\rashad-lewis-1,2016-17,Mercer,G,32,2,400,29,103,.282,11,34,.324,18,69,.261,15,21,.714,7,34,41,70,23,0,23,46,91,2.3
8079,Markese McGuire\markese-mcguire-1,2013-14,Illinois-Chicago,G,29,3,349,31,95,.326,21,67,.313,10,28,.357,19,35,.543,5,26,31,7,8,0,21,19,91,0.9
8080,David-Lee Jones Jr.\david-lee-jonesjr-1,2017-18,Georgia Southern,G,30,3,303,33,90,.367,23,53,.434,10,37,.270,15,20,.750,4,19,23,21,11,1,28,39,91,1.0
8081,Atif Russell\atif-russell-1,2013-14,Pepperdine,G,26,4,311,33,75,.440,30,62,.484,3,13,.231,22,31,.710,15,36,51,16,14,3,19,34,91,2.5
8082,De'Riante Jenkins\deriante-jenkins-1,2016-17,Virginia Commonwealth,G,21,0,259,33,66,.500,18,33,.545,15,33,.455,10,16,.625,8,27,35,11,7,3,12,21,91,3.1
8083,Rhett Harrelson\rhett-harrelson-1,2013-14,Western Carolina,G,34,0,296,24,68,.353,5,19,.263,19,49,.388,24,25,.960,3,22,25,21,4,0,20,21,91,1.5
8084,Erik Johansson\erik-johansson-1,2016-17,Loyola Marymount,G,26,7,277,29,80,.363,2,6,.333,27,74,.365,6,8,.750,2,12,14,14,4,1,11,12,91,1.9
8085,Robert Thomas\robert-thomas-1,2015-16,Southern Mississippi,G,29,0,390,24,65,.369,6,19,.316,18,46,.391,25,34,.735,4,31,35,33,10,0,30,35,91,1.8
8086,Marcel Thompson\marcel-thompson-1,2016-17,Grambling,G,30,0,259,33,85,.388,12,22,.545,21,63,.333,4,9,.444,4,12,16,7,4,1,11,27,91,1.2
8087,Kaleb Johnson\kaleb-johnson-1,2015-16,Georgetown,G,32,1,350,29,50,.580,22,37,.595,7,13,.538,26,50,.520,17,38,55,16,11,4,20,63,91,1.9
8088,Antonio Gillespie\antonio-gillespie-1,2015-16,Morgan State,G,24,2,327,33,119,.277,20,61,.328,13,58,.224,12,24,.500,9,12,21,18,8,0,12,24,91,1.0
8089,Nick Griffin\nick-griffin-1,2014-15,George Washington,G,35,0,276,31,95,.326,7,29,.241,24,66,.364,5,6,.833,8,22,30,7,5,2,11,22,91,1.1
8090,JaJuan Johnson\jajuan-johnson-2,2013-14,Marquette,G,21,3,283,35,79,.443,26,48,.542,9,31,.290,12,15,.800,3,20,23,21,9,2,10,15,91,3.1
8091,Chinedu Amajoyi\chinedu-amajoyi-1,2013-14,Louisiana-Monroe,G,22,14,381,25,69,.362,10,29,.345,15,40,.375,26,36,.722,10,57,67,12,9,2,19,17,91,3.0
8092,C.J. Siples\cj-siples-1,2016-17,Air Force,G,30,8,442,29,92,.315,18,54,.333,11,38,.289,22,42,.524,8,51,59,40,22,6,25,43,91,2.1
8093,Ivan Benkovic\ivan-benkovic-1,2014-15,Charlotte,G,27,0,277,28,73,.384,3,6,.500,25,67,.373,10,13,.769,7,20,27,12,5,1,12,40,91,1.7
8094,Kendal Yancy\kendal-yancy-1,2015-16,Texas,G,30,15,323,35,76,.461,24,49,.490,11,27,.407,10,23,.435,16,38,54,13,9,0,9,28,91,2.2
8095,Jordan McKenzie\jordan-mckenzie-1,2017-18,Stony Brook,G,28,17,466,37,100,.370,30,59,.508,7,41,.171,10,14,.714,4,31,35,64,17,2,30,51,91,2.1
8096,Zach Horstman\zach-horstman-1,2013-14,South Dakota State,G,29,2,344,32,77,.416,25,45,.556,7,32,.219,20,29,.690,12,41,53,13,3,2,13,28,91,1.9
8097,Justin Jenkins\justin-jenkins-1,2013-14,Fairfield,G,22,14,315,34,98,.347,23,64,.359,11,34,.324,12,18,.667,4,31,35,25,6,0,34,28,91,1.1
8098,Dion Wade\dion-wade-1,2013-14,Auburn,G,30,0,328,29,92,.315,6,15,.400,23,77,.299,10,17,.588,10,30,40,15,17,8,8,52,91,1.9
8099,Josh Heath\josh-heath-2,2015-16,Georgia Tech,G,34,21,599,31,81,.383,26,64,.406,5,17,.294,24,30,.800,11,26,37,95,19,2,30,55,91,2.8
8100,Isaiah Zierden\isaiah-zierden-1,2013-14,Creighton,G,28,0,304,32,82,.390,16,33,.485,16,49,.327,10,13,.769,1,20,21,26,3,0,4,21,90,2.1
8101,Jeremy Johnson\jeremy-johnson-3,2017-18,Milwaukee,G,18,10,345,35,96,.365,18,33,.545,17,63,.270,3,6,.500,7,37,44,15,11,5,8,38,90,3.0
8102,Clay Wilson\clay-wilson-1,2013-14,Princeton,G,20,0,199,29,67,.433,10,15,.667,19,52,.365,13,17,.765,1,18,19,6,2,0,5,15,90,2.7
8103,Jamal Ferguson\jamal-ferguson-1,2014-15,North Carolina Central,G,33,1,283,34,74,.459,34,72,.472,0,2,.000,22,33,.667,7,24,31,15,10,3,22,30,90,1.5
8104,Tobias Howard\tobias-howard-1,2016-17,Western Kentucky,G,30,4,479,34,90,.378,21,36,.583,13,54,.241,9,12,.750,11,31,42,38,10,2,34,32,90,1.6
8105,Stevie Repichowski\stevie-repichowski-1,2013-14,Tulsa,G,27,0,197,26,78,.333,3,14,.214,23,64,.359,15,19,.789,5,5,10,4,5,2,4,17,90,1.8
8106,Miles Lester\miles-lester-1,2017-18,Rice,G,29,5,361,25,78,.321,5,25,.200,20,53,.377,20,27,.741,4,32,36,46,8,0,32,18,90,1.9
8107,Erik Johansson\erik-johansson-1,2017-18,Loyola Marymount,G,30,15,357,31,82,.378,8,14,.571,23,68,.338,5,8,.625,2,17,19,11,7,0,12,20,90,1.5
8108,Daniel Peace\daniel-peace-1,2016-17,Troy,G,37,3,542,24,62,.387,23,54,.426,1,8,.125,41,67,.612,11,36,47,81,40,0,54,76,90,2.1
8109,Gabe Snider\gabe-snider-1,2013-14,Illinois-Chicago,G,25,8,332,34,79,.430,12,28,.429,22,51,.431,0,0,,8,23,31,7,7,4,13,32,90,2.0
8110,Jamaree Bouyea\jamaree-bouyea-1,2017-18,San Francisco,G,36,10,480,33,101,.327,24,62,.387,9,39,.231,15,22,.682,9,51,60,33,25,10,28,41,90,1.7
8111,Cameron Satterwhite\cameron-satterwhite-1,2016-17,Loyola (IL),G,30,0,387,34,84,.405,23,44,.523,11,40,.275,11,15,.733,3,36,39,18,18,4,23,36,90,1.7
8112,Tre O'Neal\tre-oneal-1,2015-16,Nicholls State,G,34,9,526,25,74,.338,15,41,.366,10,33,.303,30,49,.612,10,27,37,43,20,1,47,31,90,1.4
8113,Keenan Palmore\keenan-palmore-1,2014-15,Old Dominion,G,35,0,385,36,77,.468,36,73,.493,0,4,.000,18,31,.581,9,43,52,35,13,0,34,57,90,1.3
8114,Chauncey Collins\chauncey-collins-1,2014-15,Texas Christian,G,26,0,242,25,82,.305,8,20,.400,17,62,.274,23,32,.719,5,16,21,23,4,1,16,32,90,1.5
8115,Ryan Fazekas\ryan-fazekas-1,2016-17,Providence,G,30,7,353,31,80,.388,9,21,.429,22,59,.373,6,9,.667,0,33,33,9,11,2,5,28,90,1.9
8116,Austin Vereen\austin-vereen-1,2015-16,Virginia Military Institute,G,28,8,445,28,80,.350,14,34,.412,14,46,.304,20,28,.714,11,35,46,16,13,6,25,52,90,1.5
8117,John Burke\john-burke-3,2013-14,Missouri-Kansas City,G,29,3,246,31,61,.508,25,41,.610,6,20,.300,22,27,.815,7,14,21,9,10,0,20,34,90,1.7
8118,Nemanja Zarkovic\nemanja-zarkovic-1,2014-15,Fordham,G,27,7,366,32,87,.368,14,35,.400,18,52,.346,8,15,.533,9,14,23,29,8,1,33,40,90,1.1
8119,Jared Brandon\jared-brandon-1,2013-14,Cal State Fullerton,G,25,8,338,34,104,.327,33,90,.367,1,14,.071,21,36,.583,23,27,50,22,12,1,20,26,90,1.9
8120,Amadi Udenyi\amadi-udenyi-1,2017-18,Pepperdine,G,28,16,617,33,116,.284,26,66,.394,7,50,.140,17,28,.607,5,42,47,95,16,1,52,36,90,1.8
8121,Louie Pillari\louie-pillari-1,2016-17,Monmouth,G,29,0,237,29,66,.439,18,39,.462,11,27,.407,21,30,.700,9,17,26,10,3,5,9,15,90,2.1
8122,Jahmel Taylor\jahmel-taylor-1,2015-16,Fresno State,G,19,1,261,27,65,.415,3,7,.429,24,58,.414,12,16,.750,9,20,29,17,10,1,6,27,90,3.8
8123,Garrett Collins\garrett-collins-1,2017-18,North Carolina-Greensboro,G,33,2,232,31,70,.443,12,13,.923,19,57,.333,9,10,.900,13,26,39,4,7,3,7,19,90,2.0
8124,Chandler Hutchison\chandler-hutchison-1,2014-15,Boise State,G,29,18,358,31,87,.356,27,73,.370,4,14,.286,24,37,.649,22,35,57,23,14,4,15,42,90,2.2
8125,Luka Vasic\luka-vasic-1,2017-18,Charlotte,G,24,9,405,28,73,.384,12,33,.364,16,40,.400,18,32,.563,8,55,63,21,9,0,25,41,90,2.0
8126,Jordan Whitfield\jordan-whitfield-1,2017-18,Campbell,G,29,3,492,33,79,.418,18,35,.514,15,44,.341,9,11,.818,12,37,49,39,12,1,27,45,90,2.1
8127,Solomon Poole\solomon-poole-1,2013-14,Georgia Tech,G,14,5,245,33,85,.388,13,28,.464,20,57,.351,3,5,.600,3,12,15,29,3,2,27,23,89,2.6
8128,Zach Gengler\zach-gengler-1,2013-14,Portland State,G,30,2,300,33,69,.478,22,46,.478,11,23,.478,12,16,.750,4,28,32,20,18,2,15,44,89,2.1
8129,Brandon Randolph\brandon-randolph-1,2013-14,Xavier,G,34,6,451,35,99,.354,30,73,.411,5,26,.192,14,22,.636,10,34,44,43,11,0,24,38,89,1.5
8130,Dreon Barlett\dreon-barlett-1,2014-15,Sacramento State,G,33,0,333,30,59,.508,11,18,.611,19,41,.463,10,15,.667,6,37,43,11,2,2,12,33,89,1.8
8131,Malik Gill\malik-gill-1,2013-14,Dartmouth,G,20,2,274,26,72,.361,17,46,.370,9,26,.346,28,44,.636,3,27,30,45,32,1,30,31,89,3.7
8132,Latin Davis\latin-davis-1,2016-17,Youngstown State,G,31,4,378,31,83,.373,23,61,.377,8,22,.364,19,24,.792,16,44,60,32,12,1,27,28,89,2.0
8133,Maurice Dunlap\maurice-dunlap-1,2017-18,Jacksonville State,G,32,4,371,28,95,.295,5,18,.278,23,77,.299,10,13,.769,1,30,31,34,6,0,12,16,89,1.7
8134,Aaron Thomas\aaron-thomas-3,2014-15,Florida State,G,6,5,170,32,70,.457,28,53,.528,4,17,.235,21,29,.724,0,21,21,13,8,0,16,14,89,8.6
8135,Danny Upchurch\danny-upchurch-1,2015-16,Charleston Southern,G,30,5,363,28,93,.301,8,21,.381,20,72,.278,13,23,.565,4,38,42,41,8,1,39,31,89,1.0
8136,John Crosby\john-crosby-1,2016-17,Dayton,G,32,0,424,33,99,.333,22,76,.289,11,23,.478,12,27,.444,9,53,62,39,12,1,34,35,89,1.3
8137,Greg Andrade\greg-andrade-1,2014-15,Central Connecticut State,G,30,12,553,29,77,.377,18,43,.419,11,34,.324,20,32,.625,20,59,79,17,12,13,17,33,89,2.5
8138,Haralds Karlis\haralds-karlis-1,2014-15,Seton Hall,G,27,4,335,28,61,.459,11,17,.647,17,44,.386,16,24,.667,9,9,18,13,8,1,24,31,89,1.7
8139,Greg Parham\greg-parham-1,2017-18,Virginia Military Institute,G,29,1,338,32,90,.356,23,46,.500,9,44,.205,16,19,.842,3,28,31,38,14,1,25,23,89,1.9
8140,Derrick Brooks\derrick-brooks-1,2017-18,Wofford,G,25,15,479,24,64,.375,19,51,.373,5,13,.385,36,46,.783,21,89,110,34,6,5,35,40,89,2.9
8141,Jawad Adekoya\jawad-adekova-1,2014-15,Chicago State,G,19,1,235,25,89,.281,8,28,.286,17,61,.279,22,28,.786,5,20,25,7,14,2,12,24,89,2.2
8142,Rohan Brown\rohan-brown-1,2015-16,La Salle,G,23,9,421,35,60,.583,29,42,.690,6,18,.333,13,25,.520,31,52,83,17,13,5,23,35,89,3.7
8143,Jarvis Davis\jarvis-davis-1,2013-14,Gardner-Webb,G,21,0,220,27,66,.409,16,32,.500,11,34,.324,24,27,.889,5,15,20,8,7,1,10,25,89,2.6
8144,Kiefer Douse\kiefer-douse-1,2015-16,Canisius,G,28,6,346,37,96,.385,33,70,.471,4,26,.154,11,20,.550,16,35,51,28,11,0,21,47,89,1.6
8145,Danny Berger\danny-berger-1,2013-14,Utah State,G,28,0,328,32,80,.400,25,50,.500,7,30,.233,18,23,.783,12,42,54,21,5,4,22,31,89,1.9
8146,Dalan Ancrum\dalan-ancrum-1,2014-15,Western Illinois,G,25,0,286,31,92,.337,18,58,.310,13,34,.382,14,21,.667,12,27,39,8,5,7,20,35,89,1.3
8147,K.J. Bluford\kj-bluford-1,2015-16,Eastern Kentucky,G,13,0,178,29,79,.367,3,5,.600,26,74,.351,5,10,.500,4,11,15,7,6,2,8,25,89,3.4
8148,Jason Williams\jason-williams-10,2017-18,East Tennessee State,G,32,3,347,30,67,.448,6,17,.353,24,50,.480,5,11,.455,7,16,23,42,12,2,31,27,89,2.0
8149,Carlton Lowe\carlton-lowe-1,2016-17,Grambling,G,31,0,215,30,68,.441,19,34,.559,11,34,.324,18,27,.667,9,10,19,7,1,0,11,35,89,1.3
8150,Austin Williams\austin-williams-1,2016-17,North Carolina A&T,G,32,9,376,32,72,.444,28,56,.500,4,16,.250,21,46,.457,8,39,47,47,20,4,40,40,89,1.8
8151,Eric Green\eric-green-1,2015-16,Holy Cross,G,19,6,327,40,85,.471,38,80,.475,2,5,.400,6,18,.333,14,30,44,9,12,2,9,13,88,3.4
8152,Makale Foreman\makale-foreman-1,2016-17,Chattanooga,G,28,1,319,30,88,.341,4,8,.500,26,80,.325,2,4,.500,3,9,12,7,6,0,11,23,88,1.2
8153,Francis Kiapway\francis-kiapway-1,2017-18,Ball State,G,25,11,429,25,98,.255,2,14,.143,23,84,.274,15,18,.833,3,27,30,18,6,3,17,31,88,1.2
8154,Mario Dunn\mario-dunn-1,2015-16,Montana,G,21,2,361,37,80,.463,30,55,.545,7,25,.280,7,12,.583,6,35,41,27,8,2,25,42,88,2.2
8155,Richard Lee\richard-lee-1,2017-18,Southern,G,25,1,228,32,90,.356,14,32,.438,18,58,.310,6,8,.750,3,17,20,7,4,0,6,17,88,1.6
8156,Dustin Hobaugh\dustin-hobaugh-1,2014-15,North Dakota,G,30,2,438,26,67,.388,14,33,.424,12,34,.353,24,35,.686,26,46,72,11,14,4,13,46,88,2.4
8157,Marshawn Wilson\marshawn-wilson-1,2016-17,Northern Illinois,G,18,0,259,28,79,.354,18,45,.400,10,34,.294,22,33,.667,11,26,37,22,8,3,16,18,88,3.2
8158,Chris Palombizio\chris-palombizio-1,2017-18,Oakland,G,33,3,397,29,95,.305,17,45,.378,12,50,.240,18,32,.563,19,44,63,11,8,2,9,31,88,1.5
8159,Bryan Alberts\bryan-alberts-1,2015-16,Gonzaga,G,34,10,387,30,76,.395,7,19,.368,23,57,.404,5,6,.833,9,34,43,9,7,2,7,32,88,1.7
8160,Isaac McGlone\isaac-mcglone-1,2013-14,Eastern Kentucky,G,33,0,349,27,53,.509,9,13,.692,18,40,.450,16,23,.696,2,17,19,18,21,0,8,34,88,2.3
8161,Sean Hoggs\sean-hoggs-1,2017-18,Maryland-Eastern Shore,G,32,4,442,29,95,.305,7,21,.333,22,74,.297,8,13,.615,8,33,41,14,7,1,18,20,88,1.2
8162,Jeremiah Usiosefe\jeremiah-usiosefe-1,2016-17,Western Illinois,G,25,4,425,33,78,.423,21,32,.656,12,46,.261,10,18,.556,13,47,60,14,8,3,13,30,88,2.5
8163,John Moran\john-moran-1,2016-17,Drexel,G,31,5,413,25,91,.275,0,12,.000,25,79,.316,13,21,.619,10,22,32,29,11,1,35,45,88,0.8
8164,Damon Collins\damon-collins-1,2013-14,Howard,G,33,9,600,25,91,.275,25,78,.321,0,13,.000,38,66,.576,13,51,64,26,23,0,67,57,88,0.0
8165,Trevis Jackson\trevis-jackson-1,2016-17,Sacramento State,G,31,0,564,27,58,.466,13,18,.722,14,40,.350,20,27,.741,12,49,61,53,14,1,25,49,88,2.8
8166,Michael Orris\michael-orris-1,2015-16,Northern Illinois,G,33,22,716,36,130,.277,31,89,.348,5,41,.122,11,21,.524,8,39,47,98,24,1,47,65,88,1.4
8167,Devon Oakley\devon-oakley-1,2016-17,Hampton,G,26,4,392,30,64,.469,29,56,.518,1,8,.125,27,39,.692,5,68,73,32,22,8,25,31,88,3.3
8168,Charles Ruise Jr.\charles-ruisejr-1,2015-16,Purdue-Fort Wayne,G,31,0,284,35,99,.354,26,64,.406,9,35,.257,9,14,.643,5,31,36,15,6,3,9,40,88,1.2
8169,Keandre Fair\keandre-fair-1,2017-18,Coppin State,G,27,9,387,29,87,.333,4,11,.364,25,76,.329,5,8,.625,1,29,30,18,21,0,9,25,88,2.3
8170,Shaquille White-Miller\shaquille-white-miller-1,2013-14,Texas-Arlington,G,30,17,784,25,100,.250,10,43,.233,15,57,.263,23,38,.605,9,43,52,126,16,0,67,54,88,1.9
8171,Osborn Blount\osborn-blount-1,2016-17,North Florida,G,32,1,295,29,95,.305,12,38,.316,17,57,.298,13,19,.684,6,17,23,18,11,2,17,24,88,1.2
8172,Juwan Parker\juwan-parker-1,2014-15,Georgia,G,18,14,364,28,73,.384,23,49,.469,5,24,.208,27,36,.750,16,51,67,15,11,2,21,31,88,3.4
8173,Chris Sarbaugh\chris-sarbaugh-1,2013-14,San Diego,G,34,0,532,35,78,.449,35,71,.493,0,7,.000,18,34,.529,9,39,48,43,13,4,32,59,88,1.5
8174,Chase Freeman\chase-freeman-1,2017-18,Wagner,G,32,11,409,24,56,.429,14,25,.560,10,31,.323,30,36,.833,7,31,38,32,11,1,18,36,88,2.2
8175,Patrick Ingram\patrick-ingram-1,2015-16,Idaho,G,25,0,325,30,69,.435,30,68,.441,0,1,.000,28,43,.651,5,32,37,36,12,3,42,40,88,1.6
8176,Adam Pickett\adam-pickett-1,2015-16,Winthrop,G,30,0,210,33,57,.579,31,47,.660,2,10,.200,20,24,.833,11,26,37,9,13,6,17,32,88,2.3
8177,Camron Justice\camron-justice-1,2015-16,Vanderbilt,G,26,0,257,31,75,.413,10,21,.476,21,54,.389,5,6,.833,2,25,27,9,9,0,14,28,88,1.8
8178,Graham Woodward\graham-woodward-1,2013-14,Penn State,G,31,6,389,30,82,.366,7,23,.304,23,59,.390,5,12,.417,5,24,29,15,5,1,15,43,88,1.1
8179,Kevin Scott\kevin-scott-2,2017-18,Texas Southern,G,7,7,232,32,85,.376,22,50,.440,10,35,.286,14,18,.778,8,20,28,21,9,5,15,23,88,7.8
8180,Doug Chappell\doug-chappell-1,2013-14,Fairfield,G,21,6,310,25,80,.313,7,32,.219,18,48,.375,20,33,.606,6,27,33,14,7,0,28,40,88,1.0
8181,Francisco Amiel\francisco-amiel-1,2017-18,Colgate,G,33,13,651,29,95,.305,13,41,.317,16,54,.296,14,17,.824,8,44,52,55,34,5,33,43,88,2.3
8182,Devon Begley\devon-begley-1,2015-16,Northeastern,G,30,2,378,28,97,.289,17,53,.321,11,44,.250,21,30,.700,7,28,35,33,12,3,29,46,88,1.0
8183,Nate Jones\nate-jones-1,2016-17,Bucknell,G,26,12,432,28,66,.424,10,20,.500,18,46,.391,13,21,.619,16,36,52,20,13,1,21,29,87,2.5
8184,Chris Sarbaugh\chris-sarbaugh-1,2014-15,San Diego,G,27,8,413,30,72,.417,20,48,.417,10,24,.417,17,21,.810,10,43,53,28,14,2,21,44,87,2.3
8185,Nick Severado\nick-severado-1,2016-17,Florida A&M,G,28,7,463,35,90,.389,35,88,.398,0,2,.000,17,30,.567,33,62,95,8,18,27,31,49,87,2.4
8186,Grant Prusator\grant-prusator-1,2014-15,Indiana State,G,29,1,243,28,65,.431,3,7,.429,25,58,.431,6,9,.667,4,15,19,6,7,0,6,23,87,1.9
8187,Trey Washington\trey-washington-1,2013-14,Wyoming,G,29,0,281,27,69,.391,10,18,.556,17,51,.333,16,27,.593,1,24,25,19,2,0,17,23,87,1.5
8188,Jordan Hill\jordan-hill-2,2015-16,Wisconsin,G,30,1,467,33,87,.379,16,36,.444,17,51,.333,4,6,.667,14,28,42,24,9,1,19,44,87,1.6
8189,Kenneth Ogbe\kenneth-ogbe-1,2013-14,Utah,G,30,0,280,26,61,.426,10,27,.370,16,34,.471,19,25,.760,4,28,32,15,7,1,11,33,87,1.9
8190,Jesse Pritchard\jesse-pritchard-1,2013-14,Yale,G,33,4,441,26,84,.310,2,12,.167,24,72,.333,11,14,.786,11,34,45,13,8,7,13,40,87,1.5
8191,John Azzinaro\john-azzinaro-1,2015-16,Bucknell,G,29,0,310,30,78,.385,12,31,.387,18,47,.383,9,17,.529,2,31,33,12,13,1,16,32,87,1.6
8192,Bobby Conley\bobby-conley-1,2015-16,Texas State,G,31,2,442,31,97,.320,20,60,.333,11,37,.297,14,25,.560,10,44,54,38,10,7,20,29,87,1.8
8193,J.R. Sims\jr-sims-1,2013-14,Eastern Michigan,G,25,1,331,28,87,.322,20,43,.465,8,44,.182,23,29,.793,13,25,38,10,18,1,14,30,87,2.0
8194,Dennis Green\dennis-green-1,2013-14,Eastern Illinois,G,16,2,219,25,67,.373,24,58,.414,1,9,.111,36,53,.679,11,23,34,15,8,1,20,23,87,3.0
8195,Randy Haynes\randy-haynes-1,2016-17,Old Dominion,G,28,0,309,33,111,.297,22,69,.319,11,42,.262,10,16,.625,13,28,41,16,13,5,18,31,87,1.2
8196,Nate Frye\nate-frye-1,2013-14,New Orleans,G,25,0,265,25,62,.403,14,40,.350,11,22,.500,26,35,.743,10,14,24,32,15,2,28,36,87,2.3
8197,Eric Bowles\eric-bowles-1,2016-17,Central Connecticut State,G,22,6,508,28,73,.384,22,55,.400,6,18,.333,25,32,.781,15,38,53,65,31,1,41,58,87,3.6
8198,Sean Grennan\sean-grennan-1,2013-14,Fairfield,G,21,10,420,24,85,.282,9,32,.281,15,53,.283,24,29,.828,7,25,32,29,5,0,32,33,87,1.3
8199,Avery Lomax\avery-lomax-1,2015-16,Prairie View,G,30,18,745,26,113,.230,25,88,.284,1,25,.040,34,46,.739,14,59,73,60,42,0,55,76,87,1.3
8200,Raekwon Miller\raekwon-miller-1,2015-16,North Carolina-Asheville,G,18,0,216,27,74,.365,9,18,.500,18,56,.321,15,25,.600,6,14,20,16,16,2,12,24,87,3.2
8201,Cameron Monroe\cameron-monroe-1,2014-15,Southern,G,32,3,334,29,76,.382,23,50,.460,6,26,.231,23,33,.697,10,35,45,13,19,5,34,51,87,1.1
8202,Corey Daugherty\corey-daugherty-1,2015-16,Brown,G,16,1,279,32,97,.330,18,34,.529,14,63,.222,9,14,.643,7,18,25,23,13,0,16,38,87,2.4
8203,Thomas Dziagwa\thomas-dziagwa-1,2016-17,Oklahoma State,G,26,0,176,27,65,.415,4,12,.333,23,53,.434,10,10,1.000,6,9,15,13,9,0,7,21,87,2.4
8204,Jordan Fox\jordan-fox-1,2015-16,Army,G,33,3,403,31,75,.413,23,48,.479,8,27,.296,17,21,.810,7,30,37,74,15,2,38,46,87,2.2
8205,Carlton Lowe\carlton-lowe-1,2015-16,Grambling,G,28,2,218,28,64,.438,17,25,.680,11,39,.282,20,26,.769,14,17,31,7,4,0,6,32,87,2.0
8206,Billy Jackson\billy-jackson-1,2014-15,Mississippi Valley State,G,32,4,441,28,101,.277,22,63,.349,6,38,.158,25,41,.610,16,22,38,24,17,1,36,45,87,0.6
8207,Pat Moore\pat-moore-2,2014-15,Colgate,G,25,0,331,29,77,.377,3,9,.333,26,68,.382,3,6,.500,3,18,21,19,3,1,11,17,87,2.0
8208,Kyle Ahrens\kyle-ahrens-1,2016-17,Michigan State,G,34,4,278,30,70,.429,15,25,.600,15,45,.333,12,16,.750,6,33,39,8,1,0,9,46,87,1.2
8209,Austin Karrer\austin-karrer-1,2017-18,Texas-San Antonio,G,35,16,635,27,74,.365,10,24,.417,17,50,.340,16,22,.727,28,88,116,34,21,1,15,65,87,2.7
8210,Dominique Matthews\dominique-matthews-1,2015-16,Illinois-Chicago,G,9,8,204,30,88,.341,21,62,.339,9,26,.346,18,31,.581,6,19,25,19,3,0,18,26,87,3.3
8211,Stacy Beckton\stacy-beckton-1,2017-18,American,G,20,2,365,31,105,.295,21,56,.375,10,49,.204,15,21,.714,13,29,42,17,9,11,26,34,87,1.5
8212,Nevin Johnson\nevin-johnson-1,2014-15,Texas Southern,G,32,7,384,24,72,.333,14,32,.438,10,40,.250,29,38,.763,17,39,56,21,8,2,21,36,87,1.7
8213,Arthur Edwards\arthur-edwards-1,2014-15,New Mexico,G,22,2,263,26,72,.361,18,36,.500,8,36,.222,26,39,.667,12,32,44,17,11,4,31,37,86,1.8
8214,Isaac Bonton\isaac-bonton-1,2017-18,Montana State,G,11,0,205,31,86,.360,23,64,.359,8,22,.364,16,21,.762,4,27,31,15,9,2,25,30,86,2.8
8215,Steve Johnston\steve-johnston-1,2013-14,Fairfield,G,15,0,265,23,62,.371,1,5,.200,22,57,.386,18,26,.692,7,18,25,14,8,0,7,32,86,3.8
8216,Jake Spurgeon\jake-spurgeon-1,2015-16,Seattle,G,23,12,339,30,92,.326,11,21,.524,19,71,.268,7,14,.500,10,20,30,10,7,2,10,37,86,1.5
8217,Terrell Thompson\terrell-thompson-1,2015-16,Austin Peay,G,24,21,557,29,90,.322,23,69,.333,6,21,.286,22,34,.647,9,32,41,55,18,2,39,58,86,1.7
8218,Montana Mayfield\montana-mayfield-1,2013-14,NJIT,G,19,0,316,26,62,.419,15,33,.455,11,29,.379,23,27,.852,4,26,30,44,6,0,29,33,86,3.0
8219,Dejuan McGaughy\dejuan-mcgaughy-1,2013-14,High Point,G,18,10,398,33,87,.379,26,66,.394,7,21,.333,13,20,.650,4,28,32,40,8,1,26,21,86,2.7
8220,Jiday Ugbaja\jidbay-ugbaja-1,2015-16,Sacramento State,G,30,4,290,31,72,.431,26,54,.481,5,18,.278,19,28,.679,10,14,24,25,14,0,22,48,86,1.5
8221,Bobby Jackson\bobby-jackson-5,2017-18,Grambling,G,28,0,297,32,71,.451,30,61,.492,2,10,.200,20,40,.500,25,40,65,4,2,6,15,35,86,1.8
8222,Jeffrey Carroll\jeffrey-carroll-2,2014-15,Oklahoma State,G,22,9,250,32,82,.390,15,25,.600,17,57,.298,5,7,.714,9,31,40,7,5,5,6,16,86,2.6
8223,Deshaun Morman\deshaun-morman-1,2014-15,Cincinnati,G,24,0,241,28,74,.378,24,61,.393,4,13,.308,26,40,.650,10,11,21,17,12,2,20,36,86,1.7
8224,Kurt Hall\kurt-hall-1,2014-15,Toledo,G,32,0,208,25,53,.472,24,51,.471,1,2,.500,35,42,.833,27,21,48,4,2,0,14,29,86,1.9
8225,Trey Washington III\trey-washingtoniii-1,2015-16,Wyoming,G,27,5,515,28,86,.326,15,30,.500,13,56,.232,17,25,.680,6,51,57,35,13,0,19,44,86,2.0
8226,James Williams\james-williams-7,2013-14,Texas-San Antonio,G,26,8,308,31,98,.316,11,21,.524,20,77,.260,4,10,.400,3,21,24,13,4,1,17,38,86,0.7
8227,Warren Sledge\warren-sledge-1,2014-15,Citadel,G,28,11,594,27,73,.370,16,45,.356,11,28,.393,21,29,.724,8,35,43,85,17,3,40,37,86,2.9
8228,Sam Finley\sam-finley-1,2015-16,Mississippi,G,17,3,214,27,76,.355,25,58,.431,2,18,.111,30,45,.667,5,24,29,9,9,1,15,16,86,2.5
8229,Montaque Gill-Caesar\montaque-gill-caesar-1,2016-17,San Diego State,G,26,2,320,28,100,.280,23,64,.359,5,36,.139,25,33,.758,15,31,46,6,9,2,23,25,86,1.0
8230,David Beatty\david-beatty-1,2017-18,South Carolina,G,29,0,342,30,118,.254,20,65,.308,10,53,.189,16,22,.727,7,21,28,24,12,2,23,41,86,0.5
8231,Dezmond James\dezmond-james-1,2015-16,Air Force,G,32,2,396,30,95,.316,24,62,.387,6,33,.182,20,34,.588,8,36,44,25,9,1,21,30,86,1.1
8232,Justin Mazzulla\justin-mazzulla-1,2017-18,George Washington,G,33,11,565,30,68,.441,24,48,.500,6,20,.300,20,45,.444,23,48,71,67,18,3,41,53,86,2.3
8233,Tony Hicks\tony-hicks-1,2016-17,Louisville,G,23,1,231,32,81,.395,27,61,.443,5,20,.250,17,27,.630,2,22,24,19,10,1,21,16,86,1.9
8234,Bosko Kostur\bosco-kostur-1,2015-16,Bryant,G,20,4,299,32,95,.337,24,51,.471,8,44,.182,14,19,.737,12,32,44,7,9,3,24,45,86,1.1
8235,Carlton Lowe\carlton-lowe-1,2014-15,Grambling,G,27,2,198,25,64,.391,14,33,.424,11,31,.355,25,41,.610,17,23,40,3,1,2,17,36,86,1.4
8236,Anthony Boswell\anthony-boswell-1,2016-17,Florida International,G,28,13,504,30,94,.319,16,44,.364,14,50,.280,12,14,.857,12,38,50,13,8,5,21,43,86,1.2
8237,J.D. Tisdale\jd-tisdale-1,2015-16,Bowling Green State,G,33,0,340,28,67,.418,27,61,.443,1,6,.167,29,42,.690,20,31,51,14,19,8,28,47,86,1.7
8238,Jay Parker\jay-parker-1,2013-14,Illinois-Chicago,G,23,9,425,25,77,.325,23,58,.397,2,19,.105,33,43,.767,5,41,46,62,22,3,44,48,85,2.5
8239,Decardo Day\decardo-day-1,2016-17,Southern Utah,G,27,1,328,23,79,.291,19,56,.339,4,23,.174,35,50,.700,2,29,31,19,5,0,32,60,85,0.2
8240,Lourawls Nairn\lourawls-tum-tum-nairn-1,2014-15,Michigan State,G,39,17,758,28,88,.318,25,78,.321,3,10,.300,26,48,.542,6,56,62,94,11,1,36,83,85,1.4
8241,Thurgood Wynn\thurgood-wynn-1,2013-14,Navy,G,23,4,249,25,62,.403,19,47,.404,6,15,.400,29,51,.569,7,24,31,12,16,1,10,30,85,2.5
8242,Dylan Miller\dylan-miller-1,2015-16,North Dakota State,G,31,24,288,41,77,.532,41,76,.539,0,1,.000,3,7,.429,25,34,59,9,8,11,11,33,85,2.3
8243,Miles Overton\miles-overton-1,2013-14,Wake Forest,G,29,0,257,26,75,.347,11,30,.367,15,45,.333,18,31,.581,7,14,21,20,8,1,15,33,85,1.4
8244,Stacey Poole\stacey-poole-1,2013-14,Georgia Tech,G,25,0,210,30,69,.435,25,52,.481,5,17,.294,20,31,.645,6,19,25,9,6,1,15,22,85,1.7
8245,Rashawn Green\rashawn-green-1,2015-16,Alabama A&M,G,19,15,248,30,72,.417,8,15,.533,22,57,.386,3,6,.500,3,15,18,9,5,0,9,26,85,2.3
8246,Dakarai Allen\dakarai-allen-1,2014-15,San Diego State,G,33,0,396,30,73,.411,28,63,.444,2,10,.200,23,34,.676,19,37,56,14,19,8,21,58,85,1.7
8247,Stevie Clark\stevie-clark-1,2013-14,Oklahoma State,G,16,0,256,24,61,.393,6,17,.353,18,44,.409,19,30,.633,6,17,23,43,15,1,23,36,85,4.1
8248,Marcus Dickinson\marcus-dickinson-1,2016-17,Boise State,G,26,0,276,28,60,.467,17,35,.486,11,25,.440,18,23,.783,5,26,31,21,6,0,13,25,85,2.4
8249,Shawn Roundtree\shawn-roundtree-1,2014-15,Missouri State,G,31,2,536,31,107,.290,24,63,.381,7,44,.159,16,27,.593,4,42,46,44,9,0,40,39,85,0.6
8250,Isaiah Tripp\isaiah-tripp-1,2015-16,Abilene Christian,G,29,1,312,27,56,.482,18,32,.563,9,24,.375,22,27,.815,9,18,27,17,7,0,14,36,85,2.0
8251,Isaiah Felder\isaiah-felder-1,2015-16,Savannah State,G,32,9,347,28,80,.350,10,26,.385,18,54,.333,11,15,.733,6,23,29,25,15,0,37,26,85,1.1
8252,Zaynah Robinson\zaynah-robinson-1,2014-15,Norfolk State,G,33,1,426,35,88,.398,29,57,.509,6,31,.194,9,16,.563,0,39,39,39,19,0,25,28,85,1.7
8253,Davon Bell\davon-bell-1,2014-15,Presbyterian,G,29,14,597,29,88,.330,27,71,.380,2,17,.118,25,40,.625,12,49,61,83,23,1,54,51,85,2.1
8254,Jaylen Shaw\jaylen-shaw-1,2013-14,South Carolina,G,28,0,271,25,61,.410,10,23,.435,15,38,.395,20,23,.870,1,14,15,30,6,1,20,33,85,1.8
8255,Brian Carey\brian-carey-1,2017-18,Texas Southern,G,29,7,509,26,71,.366,17,45,.378,9,26,.346,24,38,.632,5,34,39,45,17,0,42,39,85,1.5
8256,Chase Flint\chase-flint-1,2013-14,Loyola Marymount,G,19,6,424,31,68,.456,18,30,.600,13,38,.342,10,15,.667,12,41,53,40,17,4,18,42,85,4.3
8257,DeVon Walker\devon-walker-1,2013-14,Florida,G,35,7,423,25,81,.309,6,18,.333,19,63,.302,16,24,.667,11,32,43,19,13,13,20,30,85,1.6
8258,Malcolm Canada\malcolm-canada-1,2013-14,Auburn,G,30,0,353,24,67,.358,23,59,.390,1,8,.125,36,45,.800,11,40,51,29,20,2,28,43,85,2.0
8259,Brynton Lemar\brynton-lemar-1,2014-15,UC-Davis,G,32,4,436,25,77,.325,13,44,.295,12,33,.364,23,36,.639,4,35,39,29,10,1,42,55,85,0.5
8260,Isaiah Gurley\isiah-gurley-1,2015-16,Canisius,G,30,0,284,25,77,.325,9,27,.333,16,50,.320,19,25,.760,17,40,57,13,7,2,17,26,85,1.8
8261,Christian Terrell\christian-terrell-2,2017-18,UC-Santa Barbara,G,30,4,533,34,75,.453,29,55,.527,5,20,.250,12,19,.632,23,71,94,53,19,6,30,54,85,3.0
8262,Aldonis Foote\aldonis-foote-1,2015-16,Middle Tennessee,G,29,0,253,34,70,.486,30,59,.508,4,11,.364,13,23,.565,17,45,62,13,11,1,15,47,85,2.0
8263,Rickey McGill\rickey-mcgill-1,2015-16,Iona,G,30,0,314,35,75,.467,28,50,.560,7,25,.280,8,11,.727,5,39,44,22,22,2,19,35,85,2.2
8264,Chris Collins\chris-collins-2,2013-14,Cal State Fullerton,G,28,4,401,28,70,.400,28,69,.406,0,1,.000,28,50,.560,15,31,46,32,6,0,31,50,84,1.2
8265,Maverick Ahanmisi\maverick-ahanmisi-1,2013-14,Minnesota,G,28,0,269,26,66,.394,15,38,.395,11,28,.393,21,31,.677,5,27,32,21,8,1,17,28,84,1.8
8266,DeAndre McIntyre\deandre-mcintyre-1,2013-14,Arkansas-Pine Bluff,G,16,0,290,35,77,.455,32,57,.561,3,20,.150,11,17,.647,11,28,39,7,13,1,20,25,84,2.9
8267,Jachai Simmons\jachai-simmons-1,2017-18,New Mexico,G,25,11,341,33,81,.407,19,38,.500,14,43,.326,4,8,.500,14,27,41,18,18,7,14,29,84,2.7
8268,D.J. Griggs\dj-griggs-1,2013-14,Long Island University,G,23,0,280,25,69,.362,14,36,.389,11,33,.333,23,29,.793,5,14,19,11,7,1,15,28,84,1.7
8269,Anthony Johnson\anthony-johnson-8,2013-14,Northern Colorado,G,24,0,194,29,63,.460,15,32,.469,14,31,.452,12,18,.667,8,13,21,3,6,1,16,23,84,1.8
8270,Chris Bowling\chris-bowling-1,2016-17,Northern Arizona,G,30,12,433,29,115,.252,16,53,.302,13,62,.210,13,18,.722,23,35,58,17,9,5,25,41,84,0.8
8271,Darrick Wood\darrick-wood-1,2016-17,DePaul,G,19,0,193,32,75,.427,24,51,.471,8,24,.333,12,23,.522,8,18,26,13,4,1,15,23,84,2.1
8272,Ismael Sanogo\ismael-sanogo-1,2016-17,Seton Hall,G,28,19,624,32,73,.438,31,70,.443,1,3,.333,19,38,.500,47,109,156,21,25,18,32,64,84,3.5
8273,Zach Glotta\zach-glotta-1,2016-17,Austin Peay,G,30,7,368,29,83,.349,6,19,.316,23,64,.359,3,5,.600,5,14,19,26,9,0,13,19,84,1.7
8274,Kendall Knorr\kendall-knorr-1,2014-15,Navy,G,20,16,433,27,69,.391,17,36,.472,10,33,.303,20,24,.833,12,50,62,31,10,0,11,29,84,3.9
8275,Alex Ramon\alex-ramon-1,2014-15,Colgate,G,31,0,388,31,52,.596,19,31,.613,12,21,.571,10,15,.667,9,33,42,25,18,0,21,49,84,2.2
8276,Koh Flippin\koh-flippin-1,2017-18,UC-Riverside,G,25,3,342,26,82,.317,11,29,.379,15,53,.283,17,25,.680,13,28,41,29,32,5,14,35,84,3.2
8277,Avi Toomer\avi-toomer-1,2017-18,Bucknell,G,18,10,358,28,70,.400,10,24,.417,18,46,.391,10,12,.833,13,28,41,18,12,2,12,59,84,3.0
8278,Hallice Cooke\hallice-cooke-1,2015-16,Iowa State,G,32,0,349,29,72,.403,10,20,.500,19,52,.365,7,11,.636,2,30,32,28,10,4,18,36,84,1.7
8279,Jordan Giddings\jordan-giddings-1,2016-17,Prairie View,G,29,0,267,27,63,.429,23,52,.442,4,11,.364,26,34,.765,9,13,22,11,3,0,20,42,84,1.1
8280,Cam Miller\cam-miller-1,2016-17,Lipscomb,G,25,0,383,30,68,.441,24,47,.511,6,21,.286,18,24,.750,12,32,44,29,15,1,19,29,84,2.8
8281,Tre Evans\tre-evans-1,2017-18,Fordham,G,13,12,335,29,79,.367,24,50,.480,5,29,.172,21,31,.677,0,31,31,27,11,0,16,34,84,3.5
8282,Savonte Frazier\savonte-frazier-1,2016-17,Tennessee Tech,G,32,7,443,24,73,.329,19,52,.365,5,21,.238,31,46,.674,10,62,72,65,8,3,39,37,84,2.0
8283,D'Andre Bullard\dandre-bullard-1,2013-14,Florida A&M,G,32,11,452,31,100,.310,25,68,.368,6,32,.188,16,24,.667,17,55,72,45,11,3,23,38,84,1.8
8284,Gary Akbar\gary-akbar-1,2014-15,Kent State,G,32,7,429,31,68,.456,31,68,.456,0,0,,22,50,.440,34,50,84,27,13,8,38,68,84,1.5
8285,Aaron Jackson\aaron-jackson-2,2015-16,Akron,G,29,6,285,27,67,.403,16,31,.516,11,36,.306,19,27,.704,16,18,34,11,6,3,11,41,84,1.7
8286,Jonathan Wiley\jonathan-wiley-1,2016-17,Southern Illinois,G,31,1,316,30,68,.441,30,66,.455,0,2,.000,24,31,.774,23,41,64,10,10,2,26,53,84,1.5
8287,Carlton Brundidge\carlton-brundidge-1,2014-15,Detroit Mercy,G,33,1,353,31,83,.373,26,66,.394,5,17,.294,17,27,.630,14,28,42,33,29,0,19,28,84,2.3
8288,Kodi Justice\kodi-justice-1,2014-15,Arizona State,G,18,7,229,28,66,.424,11,29,.379,17,37,.459,10,12,.833,6,16,22,28,5,2,19,22,83,3.0
8289,Erik Nakken\erik-nakken-1,2015-16,Idaho State,G,28,0,362,28,76,.368,3,4,.750,25,72,.347,2,4,.500,1,27,28,3,3,1,10,20,83,1.3
8290,Lance Whitaker\lance-whitaker-1,2014-15,Illinois-Chicago,G,29,7,532,28,83,.337,22,57,.386,6,26,.231,21,41,.512,16,42,58,31,16,2,24,53,83,1.6
8291,Jerran Foster\jerran-foster-1,2015-16,Florida A&M,G,28,13,420,29,85,.341,10,26,.385,19,59,.322,6,13,.462,2,27,29,35,8,2,26,25,83,1.4
8292,Brandon Goodwin\brandon-goodwin-1,2013-14,Central Florida,G,28,9,412,25,63,.397,21,45,.467,4,18,.222,29,49,.592,14,39,53,49,13,1,30,29,83,2.5
8293,Jamaya Burr\jamaya-burr-1,2013-14,McNeese State,G,28,4,330,19,61,.311,16,42,.381,3,19,.158,42,66,.636,7,18,25,29,5,0,25,21,83,1.4
8294,Tyrie Jackson\tyrie-jackson-1,2017-18,Virginia Tech,G,28,0,201,25,58,.431,19,34,.559,6,24,.250,27,37,.730,12,30,42,11,7,1,15,22,83,2.1
8295,Marco Banegas-Flores\marco-banegas-flores-1,2013-14,Northeastern,G,29,8,466,24,74,.324,16,51,.314,8,23,.348,27,42,.643,8,34,42,38,19,0,38,32,83,1.6
8296,Tim Broom\tim-broom-1,2015-16,Citadel,G,32,1,348,28,67,.418,19,41,.463,9,26,.346,18,31,.581,25,16,41,52,17,0,36,81,83,1.5
8297,Reveal Chukwujekwu\reveal-chukwujekwu-1,2013-14,Houston Baptist,G,24,6,365,28,84,.333,25,67,.373,3,17,.176,24,45,.533,24,60,84,23,12,2,30,42,83,1.9
8298,Devonne Pinkard\devonne-pinkard-1,2013-14,Delaware,G,34,6,601,26,89,.292,6,24,.250,20,65,.308,11,14,.786,26,50,76,18,10,7,15,72,83,1.4
8299,Jeremiah Bozeman\jeremiah-bozeman-1,2017-18,Jackson State,G,32,11,514,23,54,.426,18,41,.439,5,13,.385,32,43,.744,22,33,55,20,17,1,24,54,83,1.9
8300,Khalid Nwandu\khalid-nwandu-1,2015-16,Mount St. Mary's,G,28,12,426,29,62,.468,29,60,.483,0,2,.000,25,39,.641,17,42,59,36,30,2,32,56,83,2.6
8301,Alani Moore\alani-moore-1,2017-18,Temple,G,27,0,350,29,91,.319,14,32,.438,15,59,.254,10,18,.556,11,19,30,26,25,1,14,26,83,2.2
8302,McKay LaSalle\mckay-lasalle-1,2013-14,Cal State Long Beach,G,30,6,305,27,78,.346,3,8,.375,24,70,.343,5,6,.833,2,24,26,10,7,0,13,37,83,1.1
8303,Justin Massey\justin-massey-1,2015-16,Brown,G,9,9,197,28,67,.418,13,21,.619,15,46,.326,12,16,.750,2,25,27,3,6,0,10,21,83,4.9
8304,Curtis Oakley\curtis-oakley-1,2014-15,Bryant,G,27,3,276,30,79,.380,17,41,.415,13,38,.342,10,15,.667,6,31,37,12,6,0,14,33,83,1.4
8305,Aaron Nettles\aaron-nettles-1,2017-18,Seattle,G,32,2,244,25,60,.417,5,8,.625,20,52,.385,13,17,.765,4,17,21,9,6,0,10,21,83,1.6
8306,Bakari Turner\bakari-turner-1,2013-14,Morehead State,G,8,0,157,25,67,.373,19,35,.543,6,32,.188,27,47,.574,8,8,16,5,6,1,9,19,83,5.0
8307,Darryl Stewart\darryl-stewart-1,2017-18,New Hampshire,G,23,8,310,31,95,.326,19,45,.422,12,50,.240,9,16,.563,7,19,26,28,8,1,29,32,83,1.0
8308,Josh Brown\josh-brown-3,2013-14,Temple,G,31,2,658,32,101,.317,30,93,.323,2,8,.250,17,28,.607,15,48,63,51,27,13,32,55,83,2.0
8309,Mark Hughes\mark-hughes-1,2016-17,Wright State,G,26,0,477,30,83,.361,17,38,.447,13,45,.289,10,19,.526,18,50,68,38,17,5,30,39,83,2.4
8310,Preston Parks\preston-parks-1,2017-18,Citadel,G,6,6,162,29,70,.414,15,35,.429,14,35,.400,11,11,1.000,6,13,19,25,14,2,10,13,83,11.9
8311,Ben Grace\ben-grace-1,2014-15,Maryland-Baltimore County,G,23,5,397,24,66,.364,4,11,.364,20,55,.364,15,16,.938,3,28,31,10,9,0,12,20,83,2.3
8312,Nikola Djogo\nikola-djogo-1,2017-18,Notre Dame,G,32,3,503,29,102,.284,15,44,.341,14,58,.241,11,21,.524,17,54,71,23,8,7,15,34,83,1.5
8313,Djordjije Mumin\djordjije-mumin-1,2017-18,Central Florida,G,29,21,338,27,75,.360,1,8,.125,26,67,.388,3,4,.750,5,17,22,5,2,0,9,22,83,1.3
8314,Anthony Evans\anthony-evans-3,2013-14,Alcorn State,G,29,11,461,30,88,.341,25,65,.385,5,23,.217,18,26,.692,12,31,43,50,18,0,20,35,83,2.3
8315,Khalid Lewis\khalid-lewis-1,2013-14,La Salle,G,28,0,394,27,103,.262,21,74,.284,6,29,.207,23,29,.793,10,22,32,26,16,0,33,55,83,0.4
8316,Tim Quarterman\tim-quarterman-1,2013-14,Louisiana State,G,33,3,404,28,106,.264,18,58,.310,10,48,.208,17,31,.548,18,43,61,49,24,8,35,51,83,1.5
8317,Ebuka Anyaorah\ebuka-anyaorah-2,2013-14,North Carolina Central,G,27,4,233,25,48,.521,20,35,.571,5,13,.385,28,38,.737,8,20,28,7,4,7,20,22,83,1.9
8318,Brendyn Taylor\brendyn-taylor-1,2015-16,Santa Clara,G,24,1,350,27,67,.403,20,44,.455,7,23,.304,22,45,.489,8,42,50,27,10,2,20,49,83,1.9
8319,Milos Jovic\milos-jovic-1,2016-17,Miami (OH),G,29,6,418,34,78,.436,23,49,.469,11,29,.379,4,15,.267,6,26,32,33,16,5,39,30,83,1.4
8320,McKay Cannon\mckay-cannon-1,2016-17,Weber State,G,32,7,440,24,66,.364,8,17,.471,16,49,.327,19,25,.760,5,33,38,49,9,2,17,41,83,2.1
8321,Zach Dickerson\zach-dickerson-1,2013-14,Eastern Illinois,G,28,9,529,30,69,.435,22,41,.537,8,28,.286,15,20,.750,2,32,34,37,5,3,31,52,83,1.3
8322,Joel Hernandez\joel-hernandez-1,2013-14,Long Island University,G,17,0,221,33,80,.413,27,59,.458,6,21,.286,10,24,.417,14,31,45,8,4,1,15,21,82,2.3
8323,JC Bonny\jc-bonny-1,2013-14,Troy,G,27,3,303,23,60,.383,15,30,.500,8,30,.267,28,39,.718,8,18,26,8,5,0,26,22,82,1.2
8324,Dave Sobolewski\dave-sobolewski-1,2014-15,Northwestern,G,31,2,337,22,56,.393,6,11,.545,16,45,.356,22,26,.846,3,21,24,22,9,1,9,43,82,1.8
8325,Maliek White\maliek-white-1,2016-17,Providence,G,33,0,379,32,84,.381,20,47,.426,12,37,.324,6,11,.545,5,28,33,44,20,2,32,35,82,1.6
8326,Shawn Hopkins\shawn-hopkins-1,2017-18,Troy,G,26,11,277,30,69,.435,18,31,.581,12,38,.316,10,14,.714,11,29,40,16,6,5,15,25,82,2.2
8327,Marcus Neely\marcus-neely-1,2016-17,Florida Atlantic,G,30,2,473,35,96,.365,35,85,.412,0,11,.000,12,21,.571,23,69,92,24,9,5,13,45,82,2.0
8328,Jackson Donahue\jackson-donahue-1,2017-18,Pennsylvania,G,23,0,241,28,72,.389,7,15,.467,21,57,.368,5,12,.417,6,16,22,11,4,0,11,17,82,1.9
8329,Jimond Ivey\jimond-ivey-1,2015-16,Akron,G,32,0,274,29,72,.403,24,49,.490,5,23,.217,19,33,.576,11,41,52,21,9,3,18,29,82,1.7
8330,C.J. Davis\cj-davis-1,2015-16,Columbia,G,32,0,328,26,78,.333,12,33,.364,14,45,.311,16,22,.727,6,49,55,34,7,3,17,37,82,1.7
8331,Eric Johnson\eric-johnson-4,2017-18,Boston University,G,29,4,501,20,67,.299,7,26,.269,13,41,.317,29,38,.763,4,44,48,59,16,2,24,31,82,2.7
8332,Eric Smith\eric-smith--1,2013-14,Coastal Carolina,G,33,7,382,27,80,.338,16,40,.400,11,40,.275,17,25,.680,4,23,27,22,14,1,20,19,82,1.4
8333,Frank Bartley\frank-bartley-1,2014-15,Brigham Young,G,33,0,307,24,63,.381,17,39,.436,7,24,.292,27,44,.614,10,49,59,39,15,11,21,23,82,2.5
8334,Joseph Gripper\joseph-gripper-1,2016-17,Coppin State,G,31,9,376,25,77,.325,25,68,.368,0,9,.000,32,54,.593,8,26,34,49,22,3,44,47,82,1.2
8335,Rodney Culver\rodney-culver-1,2016-17,Ohio,G,31,1,316,30,67,.448,25,53,.472,5,14,.357,17,31,.548,10,35,45,17,9,6,35,37,82,1.1
8336,C.J. Davis\cj-davis-1,2016-17,Columbia,G,24,0,261,32,72,.444,23,46,.500,9,26,.346,9,15,.600,4,26,30,32,17,0,24,31,82,2.3
8337,Sarju Patel\sarju-patel-1,2017-18,Virginia Military Institute,G,30,0,326,27,79,.342,10,34,.294,17,45,.378,11,15,.733,6,30,36,14,3,1,23,20,82,1.1
8338,Musa Jallow\musa-jallow-1,2017-18,Ohio State,G,33,10,462,31,79,.392,20,35,.571,11,44,.250,9,14,.643,15,33,48,27,17,4,29,50,82,1.4
8339,Darryl Marshall\darryl-marshall-1,2013-14,Mississippi Valley State,G,25,13,321,25,72,.347,15,38,.395,10,34,.294,22,32,.688,3,7,10,34,13,0,25,30,82,1.7
8340,E.J. Boyce\ej-boyce-1,2016-17,San Jose State,G,21,2,272,26,66,.394,3,7,.429,23,59,.390,7,8,.875,0,12,12,13,8,1,10,14,82,2.5
8341,DaJuan Smith\dajuan-smith-1,2015-16,UC-Santa Barbara,G,32,2,367,33,82,.402,31,72,.431,2,10,.200,14,22,.636,20,44,64,22,12,1,18,20,82,2.0
8342,Ryan Pearson\ryan-pearson-2,2017-18,Navy,G,30,0,215,28,71,.394,10,24,.417,18,47,.383,8,10,.800,2,13,15,8,3,0,8,16,82,1.4
8343,Kenny Aninye\kenny-aninye-1,2017-18,Stetson,G,31,0,346,30,75,.400,17,41,.415,13,34,.382,9,10,.900,5,22,27,28,13,1,17,38,82,1.7
8344,Keon Hill\keon-hill-1,2013-14,Howard,G,33,6,416,28,107,.262,11,47,.234,17,60,.283,9,18,.500,6,13,19,55,6,1,39,28,82,0.5
8345,Christian Hairston\christian-hairston-1,2016-17,Elon,G,32,4,314,33,76,.434,33,76,.434,0,0,,15,30,.500,23,60,83,12,3,2,28,33,81,1.3
8346,Jalen Jackson\jalen-jackson-2,2016-17,Tennessee-Martin,G,28,2,256,21,59,.356,7,27,.259,14,32,.438,25,34,.735,4,20,24,34,17,2,25,22,81,2.2
8347,Dallas Cameron\dallas-cameron-1,2013-14,Stephen F. Austin,G,34,0,416,29,72,.403,24,45,.533,5,27,.185,18,26,.692,12,13,25,43,10,3,24,48,81,1.5
8348,D.J. Fenner\dj-fenner-1,2013-14,Nevada,G,32,1,453,33,95,.347,33,86,.384,0,9,.000,15,27,.556,15,44,59,18,21,6,20,50,81,1.4
8349,Steven Jones\steven-jones-1,2015-16,UC-Riverside,G,31,16,507,32,92,.348,22,55,.400,10,37,.270,7,20,.350,10,41,51,43,12,1,18,72,81,1.3
8350,Keith Charleston\keith-charleston-1,2015-16,Southeastern Louisiana,G,10,9,239,33,51,.647,32,50,.640,1,1,1.000,14,25,.560,15,41,56,10,6,1,24,24,81,5.7
8351,D.J. Peterson\dj-peterson-1,2014-15,La Salle,G,30,12,709,29,72,.403,18,27,.667,11,45,.244,12,15,.800,17,71,88,49,25,5,23,52,81,3.1
8352,Corey Arentsen\corey-arentsen-1,2013-14,Austin Peay,G,27,3,273,26,81,.321,4,13,.308,22,68,.324,7,8,.875,12,31,43,20,10,2,9,18,81,2.3
8353,Kobe Gantz\kobe-gantz-1,2017-18,Delaware State,G,6,5,183,23,58,.397,15,39,.385,8,19,.421,27,36,.750,9,22,31,20,16,0,15,16,81,11.3
8354,Max Hooper\max-hooper-1,2013-14,St. John's (NY),G,25,1,225,27,65,.415,2,3,.667,25,62,.403,2,4,.500,1,13,14,8,3,0,2,15,81,2.0
8355,Jake Lindsey\jake-lindsey-1,2015-16,Baylor,G,34,0,431,31,77,.403,27,60,.450,4,17,.235,15,22,.682,9,41,50,68,16,5,24,56,81,2.2
8356,Tavian Pomlee\tavian-pomlee-1,2013-14,South Dakota,G,24,0,239,29,71,.408,16,27,.593,13,44,.295,10,12,.833,22,23,45,8,16,2,19,34,81,2.3
8357,Martavious Newby\martavious-newby-1,2013-14,Mississippi,G,25,13,383,27,49,.551,20,35,.571,7,14,.500,20,32,.625,22,58,80,26,22,5,18,42,81,3.8
8358,Justin Cousin\justin-cousin-1,2017-18,Radford,G,35,8,364,26,94,.277,3,18,.167,23,76,.303,6,8,.750,5,26,31,13,3,1,14,30,81,0.7
8359,Steve Rennard\steve-rennard-1,2013-14,Pennsylvania,G,22,11,424,24,64,.375,10,16,.625,14,48,.292,19,25,.760,5,29,34,37,10,0,26,45,81,2.2
8360,Justin McKie\justin-mckie-1,2014-15,South Carolina,G,25,0,282,26,67,.388,15,31,.484,11,36,.306,18,23,.783,11,33,44,8,9,3,11,20,81,2.3
8361,Austin Karrer\austin-karrer-1,2016-17,Texas-San Antonio,G,33,1,631,25,69,.362,15,32,.469,10,37,.270,21,28,.750,33,96,129,28,20,3,14,52,81,3.0
8362,Dion Wade\dion-wade-1,2016-17,Miami (OH),G,24,8,430,28,70,.400,16,34,.471,12,36,.333,13,21,.619,25,71,96,15,16,10,19,56,81,3.0
8363,Darian Harris\darian-harris-1,2014-15,Oral Roberts,G,32,12,436,25,83,.301,3,10,.300,22,73,.301,9,17,.529,14,48,62,26,18,6,17,36,81,2.0
8364,Jonathan Williams\jonathan-williams-3,2014-15,Virginia Commonwealth,G,35,1,361,28,80,.350,28,77,.364,0,3,.000,25,51,.490,2,18,20,46,23,1,29,41,81,1.2
8365,Emerson Murray\emerson-murray-1,2014-15,Seattle,G,33,17,873,25,64,.391,16,35,.457,9,29,.310,22,42,.524,11,104,115,101,42,1,57,70,81,3.2
8366,Cainan McClelland\cainan-mcclelland-1,2017-18,Texas Southern,G,32,11,414,24,69,.348,8,22,.364,16,47,.340,17,24,.708,4,26,30,20,7,0,15,23,81,1.5
8367,Joe Kuligoski\joe-kuligoski-1,2015-16,Eastern Illinois,G,29,9,401,31,71,.437,24,41,.585,7,30,.233,12,18,.667,26,50,76,17,12,5,11,55,81,2.4
8368,Anthony Johnson\anthony-johnson-8,2014-15,Northern Colorado,G,23,0,191,28,51,.549,12,21,.571,16,30,.533,9,12,.750,5,15,20,10,7,1,5,24,81,2.8
8369,Sekou Harris\sekou-harris-1,2014-15,South Dakota,G,22,5,318,30,77,.390,21,51,.412,9,26,.346,12,17,.706,6,28,34,34,10,2,30,26,81,2.0
8370,Scott Kingsley\scott-kingsley-1,2013-14,Fairleigh Dickinson,G,30,0,223,27,74,.365,13,35,.371,14,39,.359,13,14,.929,2,22,24,5,3,0,9,20,81,1.2
8371,D'Angelo Richardson\dangelo-richardson-1,2016-17,Southern Mississippi,G,28,1,419,26,91,.286,15,51,.294,11,40,.275,18,26,.692,9,30,39,44,14,0,35,29,81,1.4
8372,Julion Pearre\julion-pearre-1,2017-18,Utah State,G,17,6,276,25,65,.385,11,30,.367,14,35,.400,17,20,.850,2,23,25,18,11,2,18,21,81,3.0
8373,Auston Evans\auston-evans-1,2016-17,Lafayette,G,29,9,482,33,96,.344,32,78,.410,1,18,.056,13,36,.361,9,41,50,25,27,8,37,50,80,1.0
8374,Auston Evans\auston-evans-1,2015-16,Lafayette,G,27,0,306,30,57,.526,30,52,.577,0,5,.000,20,38,.526,8,27,35,12,13,7,23,40,80,1.7
8375,K.J. Davis\kj-davis-1,2017-18,East Carolina,G,26,1,277,30,91,.330,17,38,.447,13,53,.245,7,18,.389,15,44,59,8,9,10,16,23,80,1.7
8376,Kievyn Lila-St. Rose\kievyn-lila-st-rose-1,2013-14,Norfolk State,G,27,10,323,28,81,.346,14,38,.368,14,43,.326,10,14,.714,20,31,51,5,6,3,19,30,80,1.4
8377,Marquel Ingram\marquel-ingram-1,2015-16,Bethune-Cookman,G,27,2,347,25,77,.325,11,30,.367,14,47,.298,16,18,.889,11,34,45,21,8,0,25,35,80,1.4
8378,Sheldon Eberhardt\sheldon-eberhardt-1,2016-17,Elon,G,16,2,288,32,66,.485,20,29,.690,12,37,.324,4,11,.364,11,32,43,34,9,6,16,31,80,4.4
8379,Bailey Walker\bailey-walker-1,2015-16,Northwestern State,G,27,1,308,26,65,.400,12,37,.324,14,28,.500,14,19,.737,5,17,22,39,11,1,43,36,80,1.2
8380,Lawson Korita\lawson-korita-1,2017-18,Tulsa,G,29,17,389,29,71,.408,14,27,.519,15,44,.341,7,9,.778,10,33,43,18,7,0,13,20,80,2.0
8381,Kaza Keane\kaza-keane-1,2013-14,Illinois State,G,34,0,409,24,78,.308,16,52,.308,8,26,.308,24,45,.533,11,35,46,61,10,1,56,54,80,0.6
8382,Robbie Berwick\robbie-berwick-1,2014-15,Florida State,G,33,3,361,26,89,.292,7,26,.269,19,63,.302,9,17,.529,9,25,34,22,12,1,18,42,80,1.0
8383,Aleksandar Isailovic\aleksandar-isailovic-1,2013-14,St. Francis (NY),G,25,2,357,28,90,.311,11,24,.458,17,66,.258,7,10,.700,11,32,43,7,17,6,15,31,80,1.7
8384,Edward Simpson\edward-simpson-1,2017-18,Middle Tennessee,G,33,16,595,27,75,.360,4,12,.333,23,63,.365,3,4,.750,5,48,53,47,13,1,20,46,80,1.9
8385,Josh Jones\josh-jones-4,2014-15,Richmond,G,34,0,339,27,71,.380,11,19,.579,16,52,.308,10,16,.625,13,23,36,21,4,3,10,36,80,1.5
8386,Curtis Haywood II\curtis-haywoodii-1,2017-18,Georgia Tech,G,15,7,364,24,62,.387,7,16,.438,17,46,.370,15,18,.833,8,35,43,35,13,5,17,32,80,4.8
8387,Donnell Minton\donnell-minton-1,2013-14,Lamar,G,23,2,367,23,82,.280,22,78,.282,1,4,.250,33,47,.702,6,29,35,23,15,7,30,28,80,1.5
8388,Tre Harris\tre-harris-1,2014-15,Kansas State,G,21,1,211,28,56,.500,8,12,.667,20,44,.455,4,8,.500,3,15,18,11,5,0,7,24,80,2.5
8389,Steve Frankoski\steve-frankoski-1,2013-14,Columbia,G,14,0,196,28,71,.394,9,19,.474,19,52,.365,5,6,.833,1,12,13,9,6,0,0,16,80,3.7
8390,Colin Slater\colin-slater-1,2017-18,Tulane,G,30,3,311,26,76,.342,16,35,.457,10,41,.244,18,22,.818,3,20,23,29,9,2,20,28,80,1.4
8391,Matt Lindsey\matt-lindsey-1,2017-18,Coastal Carolina,G,17,13,352,25,81,.309,7,26,.269,18,55,.327,12,17,.706,5,26,31,16,15,1,19,20,80,2.5
8392,Lenny Antwi\lenny-antwi-1,2013-14,North Dakota,G,26,1,266,24,76,.316,8,27,.296,16,49,.327,16,18,.889,2,19,21,17,4,1,8,22,80,1.6
8393,Tyree Bynum\tyree-bynum-1,2016-17,Texas Southern,G,32,5,331,27,79,.342,10,27,.370,17,52,.327,9,14,.643,5,9,14,11,5,0,12,15,80,1.1
8394,Aaron Jackson\aaron-jackson-2,2014-15,Akron,G,29,1,269,28,85,.329,11,30,.367,17,55,.309,7,19,.368,14,30,44,5,8,1,15,35,80,1.0
8395,Muhammad Abdul-Aleem\muhammad-abdul-aleem-1,2013-14,Florida A&M,G,19,0,202,26,71,.366,21,54,.389,5,17,.294,23,37,.622,13,34,47,9,11,1,24,23,80,2.1
8396,Jamaal Robateau\jamaal-robateau-1,2015-16,Gardner-Webb,G,25,0,274,27,84,.321,16,30,.533,11,54,.204,15,22,.682,11,42,53,17,12,1,18,15,80,2.0
8397,Christian Williams\christian-williams-1,2016-17,Iowa,G,34,6,435,32,92,.348,30,79,.380,2,13,.154,14,27,.519,10,44,54,53,26,1,30,29,80,1.9
8398,Mo Williams\mo-williams-2,2014-15,Army,G,30,4,616,24,75,.320,12,30,.400,12,45,.267,20,33,.606,8,15,23,22,23,4,18,63,80,1.3
8399,P.J. Hardy\pj-hardy-1,2017-18,Louisiana,G,26,0,232,26,74,.351,8,22,.364,18,52,.346,10,14,.714,6,25,31,22,8,2,14,27,80,1.9
8400,Jalen Variste\jalen-variste-1,2015-16,Tennessee-Martin,G,28,2,383,31,78,.397,29,70,.414,2,8,.250,16,28,.571,4,39,43,36,22,0,14,34,80,2.4
8401,Seth Fuller\seth-fuller-1,2017-18,Elon,G,31,2,310,26,82,.317,6,19,.316,20,63,.317,8,11,.727,6,27,33,26,11,0,29,27,80,1.1
8402,Alex Etherington\alex-etherington-1,2014-15,Indiana State,G,26,0,383,27,75,.360,11,20,.550,16,55,.291,9,15,.600,7,29,36,14,16,1,21,51,79,1.3
8403,Michael Flowers\michael-flowers-2,2017-18,Western Michigan,G,23,0,199,23,50,.460,11,25,.440,12,25,.480,21,30,.700,5,19,24,11,5,0,13,17,79,2.2
8404,Malik Maitland\malik-maitland-1,2016-17,Morehead State,G,9,8,228,30,77,.390,19,48,.396,11,29,.379,8,11,.727,3,13,16,34,19,0,19,20,79,6.4
8405,Jermaine Edmonds\jermaine-edmonds-1,2014-15,Montana,G,9,4,225,28,68,.412,15,27,.556,13,41,.317,10,15,.667,1,28,29,12,10,3,9,17,79,6.0
8406,Dwight Ramos\dwight-ramos-1,2016-17,Cal State Fullerton,G,24,4,203,28,78,.359,15,34,.441,13,44,.295,10,21,.476,7,10,17,5,4,6,6,32,79,1.3
8407,Zach Kocur\zach-kocur-1,2013-14,Air Force,G,27,1,261,24,56,.429,12,23,.522,12,33,.364,19,24,.792,5,28,33,19,7,0,17,26,79,1.9
8408,Khari Holloway\khari-holloway-1,2015-16,Portland State,G,25,7,331,25,74,.338,12,35,.343,13,39,.333,16,19,.842,5,25,30,22,8,0,17,36,79,1.6
8409,Shaquille Walters\shaquille-walters-1,2017-18,Santa Clara,G,21,0,311,31,67,.463,24,45,.533,7,22,.318,10,18,.556,2,35,37,15,4,3,17,25,79,2.0
8410,Shaq Carr\shaq-carr-1,2017-18,Grand Canyon,G,18,2,286,27,53,.509,24,45,.533,3,8,.375,22,24,.917,7,24,31,48,5,4,33,27,79,3.4
8411,Gabe Snider\gabe-snider-1,2014-15,Illinois-Chicago,G,24,4,222,27,81,.333,4,21,.190,23,60,.383,2,4,.500,7,13,20,11,6,0,4,19,79,1.8
8412,Shaq Preston\shaq-preston-1,2016-17,Prairie View,G,27,6,293,30,72,.417,25,58,.431,5,14,.357,14,26,.538,12,28,40,16,10,8,25,45,79,1.3
8413,Lucas Eitel\lucas-eitel-1,2013-14,Indiana State,G,34,1,371,26,67,.388,5,10,.500,21,57,.368,6,11,.545,8,29,37,20,11,6,18,34,79,1.5
8414,DJ Sylvester\dj-sylvester-1,2015-16,UC-Riverside,G,23,0,230,24,54,.444,10,17,.588,14,37,.378,17,24,.708,5,22,27,19,4,3,11,22,79,2.5
8415,Jachai Taylor\jachai-taylor-1,2016-17,Murray State,G,20,1,183,31,74,.419,22,41,.537,9,33,.273,8,17,.471,9,17,26,3,4,1,11,10,79,2.0
8416,Lourawls Nairn\lourawls-tum-tum-nairn-1,2015-16,Michigan State,G,28,18,523,33,87,.379,30,71,.423,3,16,.188,10,23,.435,3,28,31,92,8,1,26,41,79,2.4
8417,Hudson Price\hudson-price-1,2014-15,Texas Christian,G,28,0,256,27,67,.403,14,34,.412,13,33,.394,12,19,.632,9,23,32,20,2,2,19,31,79,1.4
8418,Drew Edwards\drew-edwards-1,2015-16,Providence,G,33,0,342,26,79,.329,16,43,.372,10,36,.278,17,28,.607,17,35,52,23,12,4,7,43,79,1.8
8419,Jeremiah Martin\jeremiah-martin-1,2015-16,Memphis,G,29,5,399,26,78,.333,20,58,.345,6,20,.300,21,33,.636,11,20,31,34,24,7,18,37,79,2.2
8420,Brian Greene\brian-greene-3,2016-17,Chicago State,G,25,7,408,28,81,.346,17,49,.347,11,32,.344,12,17,.706,11,29,40,32,13,5,22,30,79,2.1
8421,Haiishen McIntyre\haiishen-mcintyre-1,2013-14,High Point,G,24,0,252,27,55,.491,26,50,.520,1,5,.200,24,36,.667,5,23,28,29,12,3,20,19,79,2.7
8422,Jure Gunjima\jure-gunjima-1,2014-15,Purdue-Fort Wayne,G,30,0,243,33,71,.465,25,39,.641,8,32,.250,5,7,.714,10,40,50,13,5,3,14,20,79,1.8
8423,Lawson Korita\lawson-korita-1,2016-17,Tulsa,G,28,5,356,25,91,.275,9,30,.300,16,61,.262,13,15,.867,5,38,43,19,4,0,17,23,79,1.1
8424,Viont'e Daniels\vionte-daniels-1,2016-17,Washington State,G,27,0,463,28,70,.400,11,23,.478,17,47,.362,6,12,.500,8,24,32,35,11,2,11,33,79,2.4
8425,Montana Byrd\montana-byrd-1,2015-16,Chicago State,G,29,7,310,27,97,.278,14,38,.368,13,59,.220,12,15,.800,19,34,53,10,10,3,17,50,79,0.9
8426,Colin Hale\colin-hale-1,2017-18,Texas A&M-Corpus Christi,G,29,6,457,34,88,.386,25,51,.490,9,37,.243,2,6,.333,9,39,48,27,15,1,35,35,79,1.1
8427,Desmond Lee\desmond-lee-1,2014-15,North Carolina State,G,28,0,217,20,57,.351,19,46,.413,1,11,.091,38,47,.809,12,17,29,13,9,0,16,31,79,1.7
8428,KJ Robinson\kj-robinson-1,2016-17,Omaha,G,31,0,271,27,71,.380,14,40,.350,13,31,.419,11,12,.917,3,9,12,22,8,0,24,18,78,1.2
8429,D'Andre Johnson\dandre-johnson-1,2014-15,Florida Atlantic,G,21,0,273,29,69,.420,19,41,.463,10,28,.357,10,17,.588,4,27,31,22,12,0,22,27,78,2.1
8430,Taelin Webb\taelin-webb-1,2014-15,Cal State Northridge,G,30,1,457,27,86,.314,19,64,.297,8,22,.364,16,25,.640,6,24,30,52,12,6,43,40,78,1.0
8431,Alex Bran\alex-bran-1,2013-14,Chattanooga,G,24,0,261,29,73,.397,12,25,.480,17,48,.354,3,4,.750,6,13,19,7,10,1,18,25,78,1.4
8432,Charles Ruise Jr.\charles-ruisejr-1,2016-17,Purdue-Fort Wayne,G,25,0,197,29,67,.433,25,45,.556,4,22,.182,16,21,.762,8,29,37,12,3,0,15,21,78,1.7
8433,Terrence Durham\terrence-durham-2,2015-16,Tennessee-Martin,G,31,26,486,25,68,.368,15,32,.469,10,36,.278,18,32,.563,9,41,50,61,17,0,33,50,78,1.9
8434,Kameron Chatman\kameron-chatman-1,2015-16,Michigan,G,28,2,201,29,76,.382,20,42,.476,9,34,.265,11,15,.733,16,22,38,14,6,4,7,22,78,2.0
8435,Challe Barton\challe-barton-1,2013-14,Oregon State,G,26,14,402,24,58,.414,14,30,.467,10,28,.357,20,21,.952,0,28,28,31,9,0,29,38,78,1.6
8436,Stephane Manga\stephane-manga-1,2013-14,Seton Hall,G,26,3,234,29,55,.527,28,53,.528,1,2,.500,19,36,.528,12,36,48,12,5,3,21,36,78,1.7
8437,Tyler Williams\tyler-williams-2,2014-15,Brown,G,30,3,414,27,94,.287,17,42,.405,10,52,.192,14,21,.667,4,20,24,33,7,0,33,50,78,0.2
8438,Jamari Wheeler\jamari-wheeler-1,2017-18,Penn State,G,39,3,562,31,89,.348,27,61,.443,4,28,.143,12,27,.444,30,42,72,56,52,3,36,68,78,2.2
8439,DeAndre McIntyre\deandre-mcintyre-1,2014-15,Arkansas-Pine Bluff,G,27,6,479,25,71,.352,15,41,.366,10,30,.333,18,30,.600,15,43,58,16,21,6,36,49,78,1.4
8440,Jimmy Paige\jimmy-paige-1,2014-15,Siena,G,29,6,314,24,50,.480,24,42,.571,0,8,.000,30,40,.750,35,33,68,7,6,5,12,28,78,2.6
8441,Jalen Weber\jalen-weber-1,2016-17,Houston Baptist,G,29,0,348,24,69,.348,15,40,.375,9,29,.310,21,29,.724,4,18,22,36,12,0,30,46,78,1.1
8442,Anthony Clemmons\anthony-clemmons-1,2013-14,Iowa,G,32,0,363,24,47,.511,18,31,.581,6,16,.375,24,39,.615,7,34,41,54,11,4,29,34,78,2.3
8443,Taylor Perry\taylor-perry-1,2014-15,Western Michigan,G,32,7,417,29,61,.475,18,36,.500,11,25,.440,9,17,.529,24,45,69,31,15,5,22,30,78,2.5
8444,Benny Parker\benny-parker-1,2013-14,Nebraska,G,32,2,477,32,67,.478,32,62,.516,0,5,.000,14,16,.875,2,31,33,29,30,1,13,49,78,2.3
8445,Mark Carbone\mark-carbone-1,2016-17,San Diego,G,28,2,400,24,87,.276,5,18,.278,19,69,.275,11,12,.917,6,25,31,22,10,1,22,63,78,0.6
8446,Jamaal David\jamaal-david-1,2017-18,Charleston Southern,G,21,5,313,24,59,.407,14,30,.467,10,29,.345,20,29,.690,17,37,54,26,7,7,31,25,78,2.6
8447,Mike Balogun\mike-balogun-1,2013-14,Southern Illinois,G,26,0,214,24,68,.353,7,11,.636,17,57,.298,13,15,.867,2,12,14,10,4,0,5,15,78,1.7
8448,Micah Goss\micah-goss-1,2016-17,Norfolk State,G,30,8,375,28,91,.308,15,40,.375,13,51,.255,9,14,.643,18,14,32,9,5,0,13,44,78,0.7
8449,Tevin Caldwell\tevin-caldwell-1,2015-16,Texas-El Paso,G,28,4,319,29,46,.630,29,45,.644,0,1,.000,20,24,.833,22,38,60,18,13,4,12,37,78,3.0
8450,Darius Moore\darius-moore-1,2015-16,Presbyterian,G,29,13,437,30,102,.294,14,49,.286,16,53,.302,2,6,.333,7,33,40,58,16,3,42,48,78,1.0
8451,Carlos Hines\carlos-hines-2,2017-18,Northern Arizona,G,21,0,205,22,69,.319,11,33,.333,11,36,.306,22,31,.710,5,18,23,12,3,5,24,16,77,1.3
8452,J.R. Lyle\jr-lyle-1,2013-14,Milwaukee,G,29,2,262,31,75,.413,23,42,.548,8,33,.242,7,17,.412,7,13,20,19,21,0,13,34,77,1.7
8453,Nai Carlisle\nai-carlisle-1,2017-18,San Jose State,G,19,2,331,26,61,.426,21,49,.429,5,12,.417,20,27,.741,7,28,35,36,9,0,22,34,77,2.8
8454,Stefan Gonzalez\stefan-gonzalez-1,2016-17,Saint Mary's (CA),G,28,0,175,27,58,.466,9,13,.692,18,45,.400,5,9,.556,1,19,20,11,1,0,10,14,77,1.6
8455,Nate Jones\nate-jones-1,2015-16,Bucknell,G,28,1,325,25,58,.431,10,18,.556,15,40,.375,12,20,.600,4,34,38,20,6,1,13,35,77,1.8
8456,Brandon Armstrong\brandon-armstrong-2,2016-17,South Dakota,G,33,0,325,26,105,.248,12,49,.245,14,56,.250,11,15,.733,5,25,30,7,5,0,3,17,77,0.7
8457,Jubril Adekoya\jubril-adekoya-1,2016-17,Valparaiso,G,9,8,260,26,58,.448,19,44,.432,7,14,.500,18,24,.750,11,35,46,6,11,5,22,33,77,5.1
8458,Jamal Wright\jamal-wright-1,2017-18,High Point,G,24,0,296,23,59,.390,19,39,.487,4,20,.200,27,38,.711,2,24,26,34,23,2,31,30,77,2.3
8459,Darnell Taylor\darnell-taylor-1,2014-15,Fresno State,G,32,4,485,31,76,.408,24,48,.500,7,28,.250,8,19,.421,18,54,72,43,19,2,21,48,77,2.2
8460,Christian Burton\christian-burton-1,2014-15,Virginia Military Institute,G,28,6,265,25,74,.338,9,21,.429,16,53,.302,11,17,.647,14,21,35,23,17,0,21,31,77,1.7
8461,Rob Johnson\rob-johnson-3,2017-18,Citadel,G,25,1,256,29,59,.492,28,50,.560,1,9,.111,18,33,.545,28,43,71,12,10,13,20,42,77,2.6
8462,Jarvis Pugh\jarvis-pugh-1,2017-18,Santa Clara,G,30,7,355,26,78,.333,14,35,.400,12,43,.279,13,27,.481,14,45,59,19,7,6,17,51,77,1.3
8463,Jordan Watkins\jordan-watkins-1,2016-17,Davidson,G,29,1,410,23,78,.295,5,17,.294,18,61,.295,13,17,.765,9,31,40,24,9,0,13,32,77,1.6
8464,Justin Edmonds\justin-edmonds-1,2015-16,Marshall,G,27,3,236,25,77,.325,6,17,.353,19,60,.317,8,21,.381,5,19,24,22,7,0,24,28,77,0.9
8465,Paris Davis\paris-davis-1,2015-16,Southern Utah,G,23,0,193,26,55,.473,26,55,.473,0,0,,25,39,.641,10,22,32,4,5,1,19,32,77,1.5
8466,Brock Stull\brock-stull-1,2015-16,Milwaukee,G,30,0,273,27,61,.443,20,36,.556,7,25,.280,16,22,.727,13,39,52,21,7,3,13,25,77,2.1
8467,Donovan Kates\donovan-kates-1,2013-14,Manhattan,G,33,0,462,18,71,.254,6,24,.250,12,47,.255,29,36,.806,14,36,50,19,12,1,32,35,77,1.0
8468,Tra'von Joseph\travon-joseph-1,2013-14,Northwestern State,G,31,2,351,29,65,.446,25,47,.532,4,18,.222,15,22,.682,17,36,53,14,14,9,17,47,77,1.8
8469,Donte Fitzpatrick-Dorsey\donte-fitzpatrick-dorsey-1,2015-16,Mississippi,G,21,1,255,25,52,.481,23,46,.500,2,6,.333,25,35,.714,9,16,25,20,12,0,26,31,77,2.2
8470,Roosevelt Scott\roosevelt-scott-1,2014-15,Arizona State,G,20,5,243,27,61,.443,24,45,.533,3,16,.188,20,31,.645,9,33,42,11,12,0,23,32,77,2.0
8471,Isaiah Gurley\isiah-gurley-1,2017-18,Texas State,G,22,0,250,24,72,.333,15,39,.385,9,33,.273,20,27,.741,4,26,30,14,7,2,12,19,77,1.9
8472,Davonta Jordan\davonta-jordan-1,2016-17,Buffalo,G,31,5,447,32,87,.368,30,70,.429,2,17,.118,10,30,.333,14,43,57,80,21,4,48,58,76,1.7
8473,John Pettway\john-pettway-1,2017-18,South Alabama,G,24,0,231,28,61,.459,27,60,.450,1,1,1.000,19,27,.704,4,23,27,21,7,2,25,28,76,1.6
8474,Ibn Muhammad\ibn-muhammad-1,2014-15,Iona,G,35,5,637,25,57,.439,12,22,.545,13,35,.371,13,20,.650,3,45,48,65,16,0,29,49,76,2.1
8475,Malik Pugh\malik-pugh-1,2014-15,North Carolina-Wilmington,G,27,0,251,31,69,.449,27,49,.551,4,20,.200,10,26,.385,5,10,15,31,11,0,29,17,76,1.4
8476,Obi Emegano\obi-emegano-2,2013-14,Oral Roberts,G,4,4,112,21,32,.656,17,26,.654,4,6,.667,30,38,.789,3,13,16,8,2,0,8,4,76,15.7
8477,Willy Nunez Jr.\willy-nunezjr-1,2017-18,Florida International,G,7,0,160,28,72,.389,13,28,.464,15,44,.341,5,14,.357,5,10,15,5,3,1,5,10,76,5.4
8478,Nat Dixon\nat-dixon-1,2016-17,Chattanooga,G,30,1,474,25,60,.417,19,42,.452,6,18,.333,20,36,.556,13,40,53,19,19,6,19,62,76,1.7
8479,Carlin Dupree\carlin-dupree-1,2013-14,North Dakota State,G,25,0,195,28,51,.549,24,39,.615,4,12,.333,16,27,.593,8,25,33,11,6,3,20,19,76,1.9
8480,David Rivers\david-rivers-2,2013-14,Nebraska,G,25,14,499,27,57,.474,26,54,.481,1,3,.333,21,33,.636,25,48,73,10,25,13,13,51,76,3.3
8481,Chancellor Ellis\chancellor-ellis-1,2016-17,New Mexico State,G,19,0,156,23,71,.324,2,5,.400,21,66,.318,9,10,.900,4,6,10,2,0,2,8,14,76,1.5
8482,Nate Darling\nate-darling-1,2016-17,Alabama-Birmingham,G,30,1,281,28,57,.491,10,18,.556,18,39,.462,2,4,.500,1,15,16,16,2,1,15,17,76,1.5
8483,Ryan Schwieger\ryan-schwieger-1,2017-18,Princeton,G,27,1,344,28,71,.394,23,48,.479,5,23,.217,15,22,.682,11,35,46,12,13,4,26,33,76,1.4
8484,Shemiye McLendon\shemiye-mclendon-1,2013-14,South Florida,G,26,16,515,33,94,.351,33,80,.413,0,14,.000,10,17,.588,6,34,40,51,18,3,37,47,76,1.3
8485,Mark Matthews\mark-matthews-2,2015-16,North Carolina-Wilmington,G,23,0,204,28,68,.412,20,40,.500,8,28,.286,12,17,.706,12,25,37,13,10,1,11,14,76,2.5
8486,Andrew Brown\andrew-brown-3,2015-16,Furman,G,23,2,255,25,66,.379,9,22,.409,16,44,.364,10,15,.667,12,38,50,14,7,3,9,12,76,2.7
8487,Zach Butler\zach-butler-1,2017-18,Ohio,G,30,0,400,30,84,.357,26,64,.406,4,20,.200,12,17,.706,0,45,45,29,14,1,34,31,76,1.0
8488,Isaiah Tripp\isaiah-tripp-1,2017-18,Abilene Christian,G,27,5,324,26,70,.371,13,33,.394,13,37,.351,11,16,.688,4,23,27,23,16,1,15,24,76,2.0
8489,Ka'Darryl Bell\kadarryl-bell-1,2015-16,Bradley,G,22,4,338,27,80,.338,21,50,.420,6,30,.200,16,22,.727,4,17,21,13,15,2,36,49,76,0.3
8490,John Crosby\john-crosby-1,2015-16,Dayton,G,32,0,291,29,88,.330,23,66,.348,6,22,.273,12,24,.500,4,40,44,30,4,1,25,33,76,0.7
8491,Johnnie Shuler\johnnie-shuler-1,2016-17,La Salle,G,27,1,349,24,59,.407,7,17,.412,17,42,.405,11,16,.688,7,27,34,26,11,0,21,30,76,1.9
8492,Haboubacar Mutombo\haboubacar-mutombo-1,2017-18,Western Carolina,G,30,8,399,33,104,.317,27,77,.351,6,27,.222,4,13,.308,32,39,71,15,9,2,15,18,76,1.5
8493,K.J. Smith\kj-smith-1,2016-17,Pacific,G,24,3,312,28,76,.368,20,40,.500,8,36,.222,12,24,.500,4,15,19,19,8,3,11,14,76,1.8
8494,Devon Thomas\devon-thomas-1,2015-16,Texas Tech,G,32,0,392,30,70,.429,27,55,.491,3,15,.200,13,22,.591,5,34,39,44,16,1,28,33,76,1.7
8495,Charles Standifer\charles-standifer-1,2014-15,UC-Riverside,G,23,1,260,27,84,.321,20,57,.351,7,27,.259,15,25,.600,9,40,49,13,11,4,12,25,76,1.9
8496,Quinn Taylor\quinn-taylor-2,2016-17,Saint Peter's,G,36,0,393,27,57,.474,25,45,.556,2,12,.167,20,27,.741,37,50,87,11,8,6,13,45,76,2.1
8497,Marvin Nesbitt Jr.\marvin-nesbittjr-1,2017-18,Missouri-Kansas City,G,19,3,229,29,64,.453,21,45,.467,8,19,.421,10,14,.714,15,44,59,15,12,5,11,36,76,3.4
8498,Brendan Kilpatrick\brendan-kilpatrick-1,2014-15,Vermont,G,21,3,252,24,62,.387,20,47,.426,4,15,.267,23,34,.676,9,24,33,7,6,6,18,31,75,1.7
8499,Marcus McClary\marcus-mcclary-1,2017-18,Monmouth,G,31,3,405,30,59,.508,28,56,.500,2,3,.667,13,24,.542,14,36,50,10,8,0,14,44,75,1.5
8500,Braxton Huggins\braxton-huggins-1,2014-15,New Mexico State,G,27,0,216,25,74,.338,13,29,.448,12,45,.267,13,15,.867,8,11,19,11,8,3,14,23,75,1.3
8501,Billy Ingram\billy-ingram-1,2013-14,Alabama State,G,25,0,234,28,69,.406,18,32,.563,10,37,.270,9,16,.563,12,17,29,8,6,2,16,29,75,1.4
8502,Jaylen Brantley\jaylen-brantley-1,2015-16,Maryland,G,32,0,259,27,57,.474,15,29,.517,12,28,.429,9,14,.643,4,27,31,18,7,1,9,22,75,1.8
8503,Quinton Thomas\quinton-thomas-1,2014-15,Nicholls State,G,19,1,220,20,47,.426,18,29,.621,2,18,.111,33,53,.623,4,26,30,9,11,6,10,27,75,2.8
8504,Raymon Pratt\raymon-pratt-1,2017-18,North Carolina A&T,G,22,2,174,27,43,.628,26,38,.684,1,5,.200,20,32,.625,12,10,22,4,2,0,12,28,75,2.0
8505,Jacob Ivory\jacob-ivory-1,2014-15,Middle Tennessee,G,22,4,268,20,54,.370,19,44,.432,1,10,.100,34,44,.773,4,18,22,24,4,0,28,26,75,1.4
8506,Raemond Robinson\raemond-robinson-1,2013-14,Citadel,G,26,0,296,23,68,.338,7,22,.318,16,46,.348,13,18,.722,2,35,37,34,11,1,23,36,75,1.7
8507,Kendal Manuel\kendal-manuel-1,2017-18,Oregon State,G,29,0,309,25,62,.403,11,25,.440,14,37,.378,11,18,.611,3,32,35,8,10,2,13,27,75,1.5
8508,Justin Crosgile\justin-crosgile-1,2013-14,Texas-El Paso,G,14,5,294,25,63,.397,10,21,.476,15,42,.357,10,20,.500,2,28,30,23,12,0,22,23,75,3.1
8509,Brady Ellingson\brady-ellingson-1,2015-16,Iowa,G,27,0,247,28,61,.459,16,17,.941,12,44,.273,7,10,.700,2,16,18,12,5,0,11,21,75,1.6
8510,Dalique Mingo\dalique-mingo-1,2016-17,Howard,G,14,8,309,23,64,.359,21,51,.412,2,13,.154,27,41,.659,7,28,35,16,8,0,24,28,75,2.2
8511,Jordan Watkins\jordan-watkins-1,2014-15,Davidson,G,23,0,241,23,53,.434,10,24,.417,13,29,.448,16,23,.696,7,21,28,18,8,1,13,19,75,2.4
8512,Ron Patterson\ron-patterson-1,2014-15,Syracuse,G,29,0,404,31,99,.313,22,47,.468,9,52,.173,4,14,.286,9,17,26,49,20,4,15,32,75,1.9
8513,Malik Pugh\malik-pugh-1,2016-17,Tennessee-Martin,G,28,4,210,24,58,.414,17,36,.472,7,22,.318,20,32,.625,3,17,20,27,6,2,25,25,75,1.3
8514,J.D. Tisdale\jd-tisdale-1,2013-14,Bowling Green State,G,32,2,530,29,92,.315,28,77,.364,1,15,.067,16,45,.356,13,50,63,46,27,4,59,80,75,0.2
8515,Jacque Brown\jacque-brown-1,2017-18,North Carolina-Wilmington,G,29,1,302,28,81,.346,22,56,.393,6,25,.240,13,23,.565,4,17,21,36,15,1,23,24,75,1.4
8516,Isaiah Dennis\isaiah-dennis-1,2014-15,Georgia State,G,28,0,255,31,60,.517,31,59,.525,0,1,.000,13,30,.433,14,20,34,22,16,6,10,29,75,2.4
8517,Greg Jones\greg-jones-10,2017-18,Lipscomb,G,33,0,346,27,91,.297,14,37,.378,13,54,.241,8,10,.800,6,21,27,20,11,4,23,31,75,0.7
8518,Rashawn Browne\rashawn-browne-1,2015-16,New Mexico State,G,34,2,408,20,63,.317,11,30,.367,9,33,.273,26,38,.684,2,40,42,36,9,1,26,33,75,1.3
8519,Luke Eddy\luke-eddy-1,2013-14,Elon,G,22,0,170,18,49,.367,14,36,.389,4,13,.308,35,41,.854,0,10,10,15,11,0,22,17,75,1.9
8520,James Miller\james-miller-2,2015-16,Howard,G,5,5,138,29,58,.500,24,43,.558,5,15,.333,12,14,.857,8,14,22,8,5,3,14,16,75,9.5
8521,Martynas Bareika\martynas-bareika-1,2014-15,Chattanooga,G,21,6,159,25,69,.362,13,26,.500,12,43,.279,13,19,.684,4,14,18,9,2,0,11,15,75,1.6
8522,Emmanuel Chibuogwu\emmanuel-chibuogwu-1,2014-15,Seattle,G,28,9,354,26,51,.510,25,43,.581,1,8,.125,22,48,.458,12,27,39,22,7,3,25,35,75,1.5
8523,Chris Robinson\chris-robinson-2,2017-18,Sacred Heart,G,21,3,301,25,81,.309,16,40,.400,9,41,.220,16,20,.800,21,41,62,17,11,1,17,26,75,2.4
8524,Jesse Love\jesse-love-1,2017-18,Jackson State,G,31,9,578,28,69,.406,16,37,.432,12,32,.375,7,15,.467,16,30,46,26,8,3,16,35,75,1.7
8525,Wade Martin\wade-martin-1,2016-17,Louisiana-Monroe,G,27,4,323,28,84,.333,14,34,.412,14,50,.280,5,6,.833,7,33,40,11,4,2,13,25,75,1.2
8526,Sterling Taplin\sterling-taplin-1,2015-16,Tulsa,G,29,4,283,26,64,.406,14,20,.700,12,44,.273,11,14,.786,1,31,32,21,6,1,16,24,75,1.6
8527,Frederic Dure\frederic-dure-1,2014-15,Arkansas State,G,12,3,222,24,55,.436,9,25,.360,15,30,.500,12,19,.632,2,32,34,13,6,0,21,17,75,3.5
8528,Matt MacDonald\matt-macdonald-1,2016-17,Pennsylvania,G,20,15,451,24,66,.364,12,27,.444,12,39,.308,15,23,.652,13,44,57,35,12,0,15,36,75,3.2
8529,Zion Morgan\zion-morgan-1,2016-17,Nevada-Las Vegas,G,26,5,316,27,62,.435,22,46,.478,5,16,.313,16,32,.500,17,17,34,20,17,2,15,29,75,2.3
8530,Jaron Withers\jaron-withers-1,2016-17,Presbyterian,G,30,2,484,25,77,.325,20,53,.377,5,24,.208,20,34,.588,5,40,45,37,11,1,37,43,75,0.8
8531,Tre Brown\tre-brown-1,2017-18,Coastal Carolina,G,30,2,326,29,69,.420,18,42,.429,11,27,.407,6,7,.857,0,22,22,43,10,0,26,42,75,1.4
8532,Koh Flippin\koh-flippin-1,2016-17,UC-Riverside,G,20,5,202,22,53,.415,5,14,.357,17,39,.436,14,18,.778,4,18,22,13,9,3,7,27,75,2.8
8533,Jamal Ferguson\jamal-ferguson-1,2015-16,North Carolina Central,G,17,15,281,33,79,.418,32,77,.416,1,2,.500,8,14,.571,13,19,32,13,8,3,16,30,75,2.1
8534,Jarrin Randall\jarrin-randall-1,2016-17,Western Michigan,G,32,0,303,27,88,.307,14,35,.400,13,53,.245,7,10,.700,0,9,9,19,4,0,26,27,74,0.2
8535,Nathan Cayo\nathan-cayo-1,2017-18,Richmond,G,32,2,405,29,66,.439,29,56,.518,0,10,.000,16,27,.593,20,35,55,12,11,12,17,58,74,1.5
8536,Matt Turner\matt-turner-2,2017-18,Santa Clara,G,18,0,218,23,77,.299,5,24,.208,18,53,.340,10,18,.556,3,7,10,14,1,2,8,28,74,1.3
8537,Dreon Barlett\dreon-barlett-1,2013-14,Sacramento State,G,30,0,306,25,70,.357,9,29,.310,16,41,.390,8,10,.800,5,29,34,8,6,0,10,35,74,1.1
8538,Jaylan McGill\jaylan-mcgill-1,2017-18,Charlotte,G,28,1,360,24,71,.338,3,12,.250,21,59,.356,5,5,1.000,1,13,14,14,7,0,12,25,74,1.2
8539,Tyler Williams\tyler-williams-3,2015-16,San Diego,G,30,3,537,23,78,.295,15,44,.341,8,34,.235,20,36,.556,14,55,69,45,18,3,35,57,74,1.4
8540,Martez Cameron\martez-cameron-1,2015-16,Morgan State,G,31,13,560,22,91,.242,15,72,.208,7,19,.368,23,39,.590,15,32,47,66,22,0,46,49,74,1.1
8541,Darryl Smith\darryl-smith-1,2014-15,Cornell,G,30,2,478,25,67,.373,17,36,.472,8,31,.258,16,21,.762,4,49,53,20,13,3,20,39,74,1.5
8542,Chidozie Omile\chidozie-omile-1,2015-16,Alabama State,G,25,10,305,28,89,.315,21,58,.362,7,31,.226,11,22,.500,14,37,51,13,9,6,19,40,74,1.1
8543,John Guerra\john-guerra-1,2017-18,North Carolina Central,G,23,14,275,22,61,.361,14,37,.378,8,24,.333,22,29,.759,16,20,36,14,9,0,10,25,74,2.3
8544,R.J. Curington\rj-curington-1,2016-17,DePaul,G,19,0,180,26,54,.481,21,32,.656,5,22,.227,17,21,.810,17,20,37,11,7,3,15,19,74,3.0
8545,Isaiah Felder\isaiah-felder-1,2017-18,Savannah State,G,27,4,233,23,93,.247,2,9,.222,21,84,.250,7,9,.778,7,15,22,21,12,1,10,22,74,1.3
8546,Jayde Dawson\jayde-dawson-1,2013-14,Fairleigh Dickinson,G,29,0,219,26,79,.329,19,45,.422,7,34,.206,15,26,.577,7,23,30,15,8,0,23,33,74,0.6
8547,Qiydar Davis\qiydar-davis-1,2015-16,Louisiana Tech,G,7,5,164,24,55,.436,22,50,.440,2,5,.400,24,28,.857,18,29,47,10,8,6,6,19,74,10.1
8548,Hunter Rhodes\hunter-rhodes-1,2016-17,Northern Iowa,G,21,0,274,22,57,.386,5,17,.294,17,40,.425,13,15,.867,1,22,23,18,8,1,5,17,74,2.8
8549,Khalid Nwandu\khalid-nwandu-1,2013-14,Mount St. Mary's,G,30,10,453,21,52,.404,19,46,.413,2,6,.333,30,54,.556,9,43,52,35,24,1,42,66,74,1.2
8550,Musa Abdul-Aleem\musa-abdul-aleem-1,2013-14,South Florida,G,18,3,232,25,85,.294,9,18,.500,16,67,.239,8,11,.727,3,24,27,8,7,1,8,17,74,1.7
8551,Chase Flint\chase-flint-1,2014-15,Loyola Marymount,G,31,21,651,26,81,.321,15,43,.349,11,38,.289,11,17,.647,12,49,61,113,40,0,46,55,74,3.2
8552,Jaron Withers\jaron-withers-1,2017-18,Presbyterian,G,31,9,505,26,70,.371,24,62,.387,2,8,.250,20,36,.556,21,56,77,26,12,1,33,60,74,1.1
8553,Pat Moore\pat-moore-2,2013-14,Colgate,G,9,9,189,23,52,.442,2,5,.400,21,47,.447,7,8,.875,0,13,13,7,0,0,8,9,74,4.8
8554,Darian Harris\darian-harris-1,2016-17,Oral Roberts,G,28,2,448,24,55,.436,9,18,.500,15,37,.405,11,13,.846,10,59,69,38,6,5,13,48,74,2.6
8555,Prince Cooper\prince-cooper-1,2016-17,Louisiana-Monroe,G,19,1,207,33,59,.559,28,48,.583,5,11,.455,3,13,.231,8,20,28,16,6,2,19,8,74,2.6
8556,Anthony Brown\anthony-brown-12,2015-16,Green Bay,G,29,5,324,22,53,.415,16,41,.390,6,12,.500,24,36,.667,5,32,37,19,15,0,19,32,74,1.7
8557,David Robertson\david-robertson-1,2015-16,North Carolina-Asheville,G,15,15,322,26,93,.280,14,37,.378,12,56,.214,10,13,.769,7,15,22,25,2,1,12,19,74,1.9
8558,Kadeem Smithen\kadeem-smithen-1,2016-17,Siena,G,34,10,469,19,56,.339,13,31,.419,6,25,.240,30,35,.857,18,30,48,28,14,7,25,54,74,1.6
8559,Emmanuel Tselentakis\emmanuel-tselentakis-1,2015-16,NJIT,G,34,27,547,28,70,.400,16,35,.457,12,35,.343,6,12,.500,37,69,106,49,16,9,23,65,74,2.6
8560,K.J. Gilmore\kj-gilmore-1,2017-18,Little Rock,G,27,8,334,31,99,.313,28,82,.341,3,17,.176,9,10,.900,9,20,29,26,5,2,24,25,74,0.7
8561,Trey Touchet\trey-touchet-1,2015-16,Texas-El Paso,G,30,2,298,25,67,.373,15,28,.536,10,39,.256,14,18,.778,2,19,21,23,6,2,15,22,74,1.4
8562,Jan Svandrlik\jan-svandrlik-1,2016-17,Iona,G,31,3,272,22,47,.468,3,9,.333,19,38,.500,11,12,.917,12,49,61,6,7,5,8,31,74,2.2
8563,Keon Burns\keon-burns-1,2015-16,New Hampshire,G,29,7,366,22,71,.310,5,20,.250,17,51,.333,13,19,.684,8,36,44,20,5,0,11,29,74,1.5
8564,Remy Roberts-Burnett\remy-roberts-brunett-1,2013-14,Western Illinois,G,15,10,340,33,89,.371,33,84,.393,0,5,.000,8,17,.471,2,22,24,21,12,4,14,14,74,2.6
8565,Rahim Williams\rahim-williams-1,2016-17,Youngstown State,G,21,10,352,26,73,.356,20,47,.426,6,26,.231,16,24,.667,9,33,42,15,8,13,25,17,74,2.0
8566,Ian Baker\ian-baker-1,2013-14,New Mexico State,G,19,0,272,25,58,.431,15,28,.536,10,30,.333,14,24,.583,6,15,21,21,9,0,15,20,74,2.6
8567,Osa Izevbuwa\osa-izevbuwa-1,2015-16,NJIT,G,34,0,348,27,82,.329,16,35,.457,11,47,.234,9,15,.600,16,31,47,18,10,0,15,26,74,1.3
8568,Munis Tutu\munis-tutu-1,2016-17,Loyola Marymount,G,30,1,401,27,76,.355,18,41,.439,9,35,.257,11,18,.611,10,28,38,45,25,5,35,37,74,1.8
8569,Dominique Williams\dominique-williams-2,2013-14,Florida International,G,25,1,395,29,81,.358,23,60,.383,6,21,.286,10,15,.667,25,44,69,6,11,6,9,29,74,2.3
8570,Jaquan Lynch\jaquan-lynch-1,2015-16,Arkansas-Pine Bluff,G,17,0,269,24,68,.353,7,23,.304,17,45,.378,9,10,.900,7,16,23,18,11,0,15,9,74,3.0
8571,George Matthews\george-matthews-1,2013-14,Texas-San Antonio,G,20,0,237,28,67,.418,20,34,.588,8,33,.242,10,17,.588,18,32,50,8,7,4,18,26,74,2.2
8572,Ben Perez\ben-perez-1,2015-16,San Diego State,G,26,0,249,27,80,.338,11,20,.550,16,60,.267,3,4,.750,6,14,20,5,10,5,11,17,73,1.3
8573,Justin Mitchell\justin-mitchell-1,2015-16,Wright State,G,23,2,299,31,69,.449,31,66,.470,0,3,.000,11,16,.688,15,38,53,27,22,1,16,34,73,3.0
8574,Bradley George\bradley-george-1,2016-17,Denver,G,30,0,289,27,52,.519,17,32,.531,10,20,.500,9,14,.643,8,17,25,25,5,2,30,26,73,1.3
8575,Lane Severyn\lane-severyn-1,2016-17,South Dakota State,G,25,10,400,25,70,.357,9,14,.643,16,56,.286,7,15,.467,21,39,60,16,15,3,11,54,73,2.1
8576,Rashaad Richardson\rashaad-richardson-1,2013-14,Georgia State,G,26,2,280,27,75,.360,9,19,.474,18,56,.321,1,3,.333,7,23,30,5,15,0,7,23,73,1.7
8577,Brady Ellingson\brady-ellingson-1,2017-18,Iowa,G,26,1,285,28,68,.412,13,30,.433,15,38,.395,2,5,.400,0,17,17,28,7,2,15,8,73,1.9
8578,Tristan Thomas\tristan-thomas-1,2014-15,South Carolina Upstate,G,23,1,154,24,56,.429,1,3,.333,23,53,.434,2,4,.500,5,6,11,15,8,1,8,18,73,2.3
8579,Andrew Robinson\andrew-robinson-1,2016-17,Quinnipiac,G,16,1,193,25,68,.368,8,22,.364,17,46,.370,6,8,.750,10,16,26,4,4,1,7,9,73,2.7
8580,Marcus Fillyaw\marcus-fillyaw-1,2013-14,Southern Illinois,G,21,16,470,28,64,.438,19,34,.559,9,30,.300,8,11,.727,8,31,39,48,24,2,29,40,73,3.2
8581,Diontae Jones\diontae-jones-1,2016-17,Grambling,G,29,5,318,30,78,.385,30,74,.405,0,4,.000,13,16,.813,24,34,58,13,22,3,30,70,73,1.1
8582,Wendell Mitchell\wendell-mitchell-1,2016-17,Baylor,G,25,0,219,25,62,.403,16,31,.516,9,31,.290,14,19,.737,2,16,18,17,6,2,23,30,73,1.1
8583,Reggie Kissoonlal\reginald-kissoonlal-1,2015-16,Northwestern State,G,22,0,176,22,63,.349,7,14,.500,15,49,.306,14,18,.778,7,23,30,7,4,10,19,47,73,1.2
8584,Dakarai Allen\dakarai-allen-1,2013-14,San Diego State,G,29,1,306,25,60,.417,25,60,.417,0,0,,23,43,.535,15,19,34,11,18,10,14,44,73,1.7
8585,Darryl Smith\darryl-smith-1,2016-17,Cornell,G,18,1,296,28,53,.528,19,31,.613,9,22,.409,8,16,.500,14,35,49,14,6,8,9,18,73,3.9
8586,Raymond Taylor\raymond-taylor-1,2013-14,Florida International,G,6,6,197,24,67,.358,16,45,.356,8,22,.364,17,23,.739,4,12,16,37,6,0,13,11,73,9.0
8587,C.J. Williams\cj-williams-3,2015-16,Stephen F. Austin,G,31,0,299,27,62,.435,27,61,.443,0,1,.000,19,38,.500,22,61,83,31,8,1,28,45,73,1.6
8588,Ray Rodriguez\ray-rodriguez-2,2015-16,Florida International,G,20,4,295,24,67,.358,6,13,.462,18,54,.333,7,10,.700,2,25,27,24,8,0,22,22,73,1.9
8589,Landon Goesling\landon-goesling-1,2014-15,Appalachian State,G,29,0,300,24,73,.329,18,44,.409,6,29,.207,19,30,.633,12,24,36,18,5,0,24,29,73,0.9
8590,Aric Dickerson\aric-dickerson-1,2014-15,Delaware State,G,31,5,343,26,92,.283,9,26,.346,17,66,.258,4,6,.667,2,18,20,8,10,1,25,29,73,0.2
8591,Taqwain Drummond\taqwain-drummond-1,2017-18,Coppin State,G,20,13,417,23,91,.253,11,47,.234,12,44,.273,15,20,.750,8,41,49,11,11,2,19,38,73,1.0
8592,Jorden Kite\jorden-kite-1,2017-18,Incarnate Word,G,23,3,280,24,62,.387,6,10,.600,18,52,.346,7,9,.778,1,26,27,15,6,0,15,26,73,1.7
8593,Caleb Crayton\caleb-crayton-1,2014-15,Houston Baptist,G,20,2,222,28,65,.431,26,48,.542,2,17,.118,15,21,.714,17,30,47,12,5,4,19,37,73,2.0
8594,Malik Crowfield\malik-crowfield-1,2016-17,Virginia Commonwealth,G,34,4,341,25,66,.379,4,7,.571,21,59,.356,2,3,.667,9,16,25,12,8,4,11,31,73,1.3
8595,Pervis Louder\pervis-louder-1,2015-16,Air Force,G,18,2,210,23,56,.411,18,41,.439,5,15,.333,22,31,.710,13,22,35,9,9,0,17,31,73,2.3
8596,Isaiah Washington\isaiah-washington-1,2015-16,Penn State,G,27,0,339,19,81,.235,8,25,.320,11,56,.196,24,35,.686,13,36,49,7,7,4,19,38,73,0.7
8597,Tre Campbell\tre-campbell-1,2016-17,Georgetown,G,21,0,294,24,62,.387,12,27,.444,12,35,.343,13,21,.619,3,23,26,28,12,0,19,17,73,2.4
8598,Marlin Davis\marlin-davis-1,2017-18,Texas State,G,16,16,429,28,70,.400,26,56,.464,2,14,.143,15,31,.484,3,30,33,56,13,1,30,29,73,3.2
8599,Keith Pinckney\keith-pinckney-1,2014-15,Tulane,G,31,0,291,31,74,.419,30,63,.476,1,11,.091,10,21,.476,2,15,17,20,12,0,30,18,73,0.8
8600,Cullen VanLeer\cullen-vanleer-1,2017-18,Missouri,G,31,13,442,27,74,.365,8,10,.800,19,64,.297,0,7,.000,2,41,43,30,13,0,21,28,73,1.4
8601,Jordan Shepherd\jordan-shepherd-1,2017-18,Oklahoma,G,31,0,352,22,56,.393,16,37,.432,6,19,.316,22,30,.733,2,20,22,37,13,4,26,37,72,1.5
8602,Chris Jones\chris-jones-5,2013-14,Pittsburgh,G,30,0,222,24,54,.444,20,37,.541,4,17,.235,20,25,.800,11,15,26,7,3,1,8,27,72,1.5
8603,Jaylen Shead\jaylen-snead-1,2016-17,Cal Poly,G,9,9,247,28,65,.431,24,48,.500,4,17,.235,12,22,.545,11,29,40,47,9,1,20,16,72,7.4
8604,Elijah Watson\elijah-watson-1,2014-15,Texas-Rio Grande Valley,G,29,14,581,24,61,.393,24,52,.462,0,9,.000,24,51,.471,10,37,47,89,19,1,48,66,72,1.9
8605,John Kiser\john-kiser-1,2017-18,Valparaiso,G,26,3,472,19,48,.396,10,22,.455,9,26,.346,25,33,.758,27,69,96,23,12,6,12,45,72,3.3
8606,Richie Spiller\richie-spiller-1,2013-14,Florida A&M,G,29,5,331,22,73,.301,12,45,.267,10,28,.357,18,30,.600,11,21,32,33,22,5,37,56,72,1.0
8607,Shunn Buchanan\shunn-buchanan-1,2017-18,New Mexico State,G,34,4,491,23,87,.264,12,52,.231,11,35,.314,15,23,.652,6,53,59,55,12,1,33,39,72,1.2
8608,Chris Whitehead\chris-whitehead-1,2013-14,Fordham,G,29,5,343,28,55,.509,28,54,.519,0,1,.000,16,28,.571,16,21,37,29,16,4,19,36,72,2.2
8609,Jamal Lewis\jamal-lewis-1,2013-14,Pennsylvania,G,26,8,447,22,62,.355,11,29,.379,11,33,.333,17,25,.680,4,33,37,44,15,1,30,46,72,1.7
8610,Sviatoslav Mykhailiuk\sviatoslav-mykhailiuk-1,2014-15,Kansas,G,26,6,291,26,85,.306,11,33,.333,15,52,.288,5,6,.833,8,23,31,17,8,1,15,17,72,1.3
8611,Corey Heyward\corey-heyward-1,2016-17,Georgia Tech,G,37,24,621,21,70,.300,11,37,.297,10,33,.303,20,32,.625,17,50,67,38,20,2,18,55,72,1.7
8612,Wes VanBeck\wes-vanbeck-1,2015-16,Houston,G,20,0,158,22,47,.468,12,21,.571,10,26,.385,18,24,.750,8,18,26,9,6,2,9,16,72,2.7
8613,Chad Johnson\chad-johnson-3,2013-14,Colgate,G,27,11,341,28,65,.431,19,32,.594,9,33,.273,7,11,.636,3,31,34,21,5,1,18,33,72,1.4
8614,Kaleb Johnson\kaleb-johnson-1,2016-17,Georgetown,G,31,2,333,23,52,.442,20,40,.500,3,12,.250,23,44,.523,22,38,60,13,11,3,13,41,72,1.8
8615,Spencer Rivers\spencer-rivers-1,2016-17,UC-Irvine,G,34,0,317,26,75,.347,13,31,.419,13,44,.295,7,13,.538,3,32,35,29,8,1,23,32,72,1.0
8616,Terrell Lewis\terrell-lewis-1,2017-18,Eastern Illinois,G,8,8,283,23,63,.365,5,16,.313,18,47,.383,8,12,.667,5,14,19,38,15,0,15,19,72,7.8
8617,Mark Crowe\mark-crowe-1,2017-18,Cal Poly,G,31,15,549,26,84,.310,13,32,.406,13,52,.250,7,13,.538,22,56,78,27,18,8,17,62,72,1.7
8618,Damari Parris\damari-parris-1,2016-17,Western Kentucky,G,24,0,258,24,71,.338,17,50,.340,7,21,.333,17,21,.810,5,14,19,18,5,1,15,20,72,1.4
8619,Matt Farrell\matt-farrell-1,2015-16,Notre Dame,G,28,4,374,23,63,.365,12,29,.414,11,34,.324,15,17,.882,6,15,21,45,5,0,17,25,72,1.9
8620,Terrence Samuel\terrence-samuel-1,2013-14,Connecticut,G,30,0,270,24,43,.558,24,42,.571,0,1,.000,24,34,.706,3,24,27,24,12,0,18,14,72,2.1
8621,Perrion Callandret\perrion-callandret-1,2013-14,Idaho,G,29,0,364,25,79,.316,21,54,.389,4,25,.160,18,29,.621,14,35,49,19,14,3,27,39,72,1.0
8622,Troy Simmons\troy-simmons-1,2013-14,Bethune-Cookman,G,30,22,704,22,79,.278,18,59,.305,4,20,.200,24,31,.774,5,27,32,73,20,2,58,65,72,0.8
8623,Joshua Batson\joshua-batson-1,2016-17,Chicago State,G,30,17,521,22,94,.234,17,65,.262,5,29,.172,23,40,.575,18,41,59,45,30,0,39,66,72,1.0
8624,Matt Beachler\matt-beachler-1,2017-18,Central Michigan,G,34,0,311,24,74,.324,8,14,.571,16,60,.267,8,14,.571,3,29,32,15,12,3,9,24,72,1.3
8625,Charles Hill\charles-hill-1,2013-14,Texas Christian,G,14,2,234,25,70,.357,18,47,.383,7,23,.304,15,24,.625,11,23,34,20,10,2,15,31,72,3.0
8626,Isaac Belton\isaac-belton-1,2013-14,Longwood,G,29,0,225,16,67,.239,11,38,.289,5,29,.172,35,47,.745,5,27,32,7,8,0,11,35,72,0.9
8627,Warren Sledge\warren-sledge-1,2013-14,Citadel,G,27,1,384,23,62,.371,14,41,.341,9,21,.429,17,25,.680,2,25,27,49,5,1,24,31,72,1.7
8628,Rondale Watson\rondale-watson-1,2015-16,Wake Forest,G,23,0,343,24,62,.387,15,32,.469,9,30,.300,15,27,.556,5,32,37,22,13,2,16,30,72,2.1
8629,Zak Showalter\zak-showalter-1,2014-15,Wisconsin,G,35,0,265,23,53,.434,21,39,.538,2,14,.143,24,27,.889,18,27,45,16,10,4,5,38,72,1.9
8630,P.J. Thompson\pj-thompson-1,2014-15,Purdue,G,30,1,407,24,72,.333,10,23,.435,14,49,.286,10,13,.769,10,18,28,33,21,1,19,39,72,1.8
8631,Willie Conner\willie-conner-1,2013-14,Florida A&M,G,27,0,292,23,77,.299,23,59,.390,0,18,.000,26,45,.578,17,21,38,11,7,0,25,33,72,0.5
8632,Lazar Nikolic\lazar-nikolic-1,2017-18,Colorado,G,31,9,480,27,71,.380,19,37,.514,8,34,.235,10,21,.476,11,61,72,30,9,5,28,59,72,1.2
8633,Michael Almonacy\michael-almonacy-1,2016-17,Stony Brook,G,31,1,291,26,77,.338,19,42,.452,7,35,.200,12,17,.706,9,18,27,33,14,1,13,28,71,1.6
8634,Avery Lomax\avery-lomax-1,2016-17,Prairie View,G,32,0,355,20,57,.351,20,51,.392,0,6,.000,31,43,.721,7,18,25,42,7,0,19,32,71,1.5
8635,Tony Jackson\tony-jackson-7,2017-18,Missouri-Kansas City,G,20,3,265,24,64,.375,8,16,.500,16,48,.333,7,12,.583,9,24,33,8,10,6,10,36,71,2.1
8636,Jalon Pipkins\jalon-pipkins-1,2017-18,Cal State Northridge,G,23,0,272,23,59,.390,15,41,.366,8,18,.444,17,19,.895,4,18,22,11,8,2,17,16,71,1.7
8637,Travis Hester\travis-hester-1,2014-15,Saint Peter's,G,20,1,165,21,54,.389,0,3,.000,21,51,.412,8,8,1.000,3,13,16,11,1,1,13,9,71,2.0
8638,Robbie Lemons\robbie-lemons-1,2013-14,Stanford,G,35,1,440,24,69,.348,10,24,.417,14,45,.311,9,14,.643,11,26,37,12,14,1,8,36,71,1.3
8639,Aaron Korn\aaron-korn-1,2015-16,Lipscomb,G,27,0,336,30,66,.455,22,42,.524,8,24,.333,3,9,.333,9,53,62,12,8,1,14,21,71,1.9
8640,Andrew Platek\andrew-platek-1,2017-18,North Carolina,G,35,0,264,27,55,.491,17,28,.607,10,27,.370,7,10,.700,15,24,39,18,3,2,10,21,71,1.7
8641,Davon Bell\davon-bell-1,2015-16,Presbyterian,G,26,5,403,25,65,.385,24,56,.429,1,9,.111,20,26,.769,4,30,34,37,15,4,28,47,71,1.6
8642,Ryan McMahon\ryan-mcmahon-1,2016-17,Louisville,G,28,0,176,20,60,.333,1,8,.125,19,52,.365,12,14,.857,2,12,14,17,6,2,10,30,71,1.4
8643,Jaiveon Eaves\jaiveon-eaves-1,2016-17,Evansville,G,24,0,233,25,80,.313,15,38,.395,10,42,.238,11,19,.579,5,35,40,15,3,0,12,14,71,1.3
8644,Caleb Chowbay\caleb-chowbay-1,2014-15,Belmont,G,28,0,236,25,52,.481,17,35,.486,8,17,.471,13,16,.813,2,26,28,23,7,0,24,19,71,1.6
8645,Jeff Powers\jeff-powers-1,2013-14,University of California,G,22,0,169,24,58,.414,6,19,.316,18,39,.462,5,5,1.000,1,9,10,8,1,0,4,12,71,1.9
8646,Jamaal Robateau\jamaal-robateau-1,2017-18,Gardner-Webb,G,18,4,329,25,85,.294,13,39,.333,12,46,.261,9,13,.692,6,51,57,15,11,5,13,23,71,2.3
8647,Keon Hill\keon-hill-1,2014-15,Howard,G,32,2,317,24,69,.348,18,47,.383,6,22,.273,17,23,.739,1,13,14,38,8,0,27,16,71,1.1
8648,Ahmad Gilbert\ahmad-gilbert-1,2015-16,Minnesota,G,21,6,295,28,91,.308,18,47,.383,10,44,.227,5,11,.455,9,31,40,17,13,3,13,25,71,1.7
8649,Jamir Andrews\jamir-andrews-1,2015-16,Albany (NY),G,23,0,160,19,56,.339,9,21,.429,10,35,.286,23,25,.920,2,15,17,8,7,0,13,19,71,1.6
8650,Sam Cassell\sam-cassell-2,2014-15,Connecticut,G,18,2,271,21,76,.276,8,27,.296,13,49,.265,16,20,.800,4,20,24,17,9,0,7,17,71,2.3
8651,Drew Rackley\drew-rackley-1,2016-17,North Carolina-Asheville,G,22,0,213,23,54,.426,7,18,.389,16,36,.444,9,13,.692,2,17,19,12,11,0,14,18,71,2.1
8652,Cade Crosland\cade-crosland-1,2017-18,Tennessee Tech,G,29,0,247,25,57,.439,7,10,.700,18,47,.383,3,7,.429,11,16,27,20,7,0,11,19,71,1.9
8653,Jeremy Miller\jeremy-miller-2,2017-18,Northeastern,G,28,0,242,25,52,.481,21,32,.656,4,20,.200,17,23,.739,15,39,54,10,6,5,10,37,71,2.0
8654,Duke Douglas\duke-douglas-1,2016-17,Denver,G,27,1,257,28,56,.500,27,52,.519,1,4,.250,14,18,.778,12,21,33,13,5,9,12,31,71,1.9
8655,Dre'Sean Looney\dresean-looney-1,2014-15,Jackson State,G,19,0,265,24,70,.343,15,37,.405,9,33,.273,14,16,.875,5,15,20,25,8,0,23,34,71,1.5
8656,Corey Hilliard\corey-hilliard-1,2014-15,San Francisco,G,25,2,300,27,78,.346,18,48,.375,9,30,.300,8,17,.471,5,17,22,20,10,1,13,28,71,1.3
8657,Shaun Smith\shaun-smith-2,2013-14,Alcorn State,G,10,9,237,21,78,.269,16,47,.340,5,31,.161,23,28,.821,6,14,20,10,6,0,16,5,70,2.5
8658,Rex Pflueger\rex-pfleuger-1,2015-16,Notre Dame,G,30,1,399,21,55,.382,13,30,.433,8,25,.320,20,21,.952,10,30,40,32,18,7,10,40,70,2.5
8659,Xavier Hallinan\xavier-hallinan-1,2016-17,Portland,G,9,6,213,27,59,.458,21,44,.477,6,15,.400,10,14,.714,1,15,16,12,13,0,22,13,70,4.1
8660,Tyrell Gumbs-Frater\tyrell-gumbs-frater-1,2017-18,Coastal Carolina,G,14,1,162,21,48,.438,3,10,.300,18,38,.474,10,14,.714,7,18,25,8,3,3,9,9,70,3.7
8661,T.J. Taylor\tj-taylor-1,2015-16,UC-Santa Barbara,G,33,0,436,27,86,.314,11,34,.324,16,52,.308,0,1,.000,5,21,26,52,6,0,26,29,70,1.1
8662,Josh Davis\josh-davis-7,2015-16,Western Michigan,G,25,0,270,20,75,.267,7,21,.333,13,54,.241,17,30,.567,3,33,36,8,12,3,24,38,70,0.5
8663,Tavon Sledge\tavon-sledge-1,2013-14,Iona,G,28,2,271,25,51,.490,21,42,.500,4,9,.444,16,23,.696,8,16,24,32,5,0,8,26,70,2.2
8664,Malik Albert\malik-albert-1,2015-16,Creighton,G,27,0,220,26,59,.441,25,45,.556,1,14,.071,17,24,.708,4,24,28,27,12,4,18,10,70,2.1
8665,Wabissa Bede\wabissa-bede-1,2017-18,Virginia Tech,G,28,0,232,25,51,.490,16,34,.471,9,17,.529,11,18,.611,4,20,24,23,7,3,9,27,70,2.0
8666,Korey Thieleke\korey-thieleke-1,2013-14,Portland,G,31,1,364,25,58,.431,22,51,.431,3,7,.429,17,24,.708,19,44,63,21,20,14,18,58,70,2.1
8667,Kyle Davis\kyle-davis-3,2013-14,Dayton,G,35,1,240,26,58,.448,23,40,.575,3,18,.167,15,24,.625,6,19,25,20,17,3,13,51,70,1.3
8668,Mack Foster\mack-foster-1,2015-16,Louisiana-Monroe,G,32,0,385,25,66,.379,19,33,.576,6,33,.182,14,19,.737,13,23,36,20,17,0,13,47,70,1.5
8669,Jordan Ford\jordan-ford-1,2016-17,Saint Mary's (CA),G,29,0,167,21,54,.389,11,26,.423,10,28,.357,18,22,.818,4,12,16,19,4,0,8,10,70,1.7
8670,Tyson Batiste\tyson-batiste-1,2017-18,Central Connecticut State,G,25,6,481,29,64,.453,20,42,.476,9,22,.409,3,18,.167,5,53,58,45,14,2,29,45,70,2.0
8671,Sam Norton\sam-norton-1,2017-18,Loyola (MD),G,26,10,457,22,53,.415,18,45,.400,4,8,.500,22,29,.759,22,57,79,23,11,4,14,59,70,2.5
8672,Shawn Olden\shawn-olden-1,2015-16,Pepperdine,G,9,0,184,23,50,.460,10,21,.476,13,29,.448,11,15,.733,2,17,19,7,8,2,10,16,70,5.2
8673,Matthew Owies\matthew-owies-1,2016-17,Hawaii,G,27,0,312,24,72,.333,14,34,.412,10,38,.263,12,16,.750,6,18,24,24,12,1,21,24,70,1.3
8674,Brandon Burnett\brandon-burnett-1,2013-14,Indiana State,G,33,0,233,21,54,.389,14,27,.519,7,27,.259,21,25,.840,15,29,44,9,1,1,15,31,70,1.2
8675,Tyler Wilson\tyler-wilson-1,2016-17,Manhattan,G,32,6,689,21,67,.313,20,60,.333,1,7,.143,27,38,.711,7,30,37,56,23,1,59,71,70,0.5
8676,Glenn Baral\glenn-baral-1,2013-14,Stetson,G,28,0,320,25,90,.278,8,27,.296,17,63,.270,3,5,.600,4,21,25,12,11,1,10,25,70,0.9
8677,Sheldon Blackwell\sheldon-blackwell-1,2014-15,Cal State Fullerton,G,31,5,529,22,67,.328,20,58,.345,2,9,.222,24,40,.600,14,52,66,36,18,0,24,32,70,1.8
8678,Brandon Robinson\brandon-robinson-2,2016-17,North Carolina,G,36,0,281,22,64,.344,15,34,.441,7,30,.233,19,29,.655,11,32,43,28,10,3,14,31,70,1.5
8679,Donnell Gresham Jr.\donnell-greshamjr-1,2015-16,Northeastern,G,19,6,333,18,56,.321,3,20,.150,15,36,.417,19,28,.679,10,31,41,24,11,0,15,25,70,2.8
8680,Malik Montoya\malik-montoya-1,2015-16,Seattle,G,13,0,263,27,57,.474,18,37,.486,9,20,.450,7,12,.583,6,22,28,23,19,0,14,13,70,5.0
8681,Rusty Reigel\rusty-reigel-1,2015-16,Davidson,G,31,12,495,24,65,.369,14,28,.500,10,37,.270,12,17,.706,9,50,59,31,2,2,15,48,70,1.4
8682,Monty Boykins\monty-boykins-1,2013-14,Lafayette,G,21,2,224,23,70,.329,14,36,.389,9,34,.265,15,27,.556,4,21,25,9,5,2,19,15,70,1.1
8683,Greg King\greg-king-1,2015-16,Eastern Kentucky,G,23,2,215,29,62,.468,29,62,.468,0,0,,11,30,.367,19,42,61,7,3,7,29,37,69,1.1
8684,Christen Cunningham\christian-cunningham-1,2017-18,Samford,G,9,9,260,30,67,.448,27,50,.540,3,17,.176,6,7,.857,7,19,26,36,5,1,23,4,69,5.6
8685,Nate Jones\nate-jones-1,2017-18,Bucknell,G,32,3,365,22,69,.319,6,12,.500,16,57,.281,9,17,.529,11,34,45,20,8,1,7,29,69,1.5
8686,Aldonis Foote\aldonis-foote-1,2016-17,Middle Tennessee,G,31,2,255,28,69,.406,27,64,.422,1,5,.200,12,22,.545,18,23,41,19,7,1,15,42,69,1.2
8687,Ronnie Stacy\ronnie-stacy-1,2016-17,Oregon State,G,31,8,402,26,68,.382,24,58,.414,2,10,.200,15,26,.577,8,41,49,28,15,1,40,44,69,0.7
8688,Stevie Repichowski\stevie-repichowski-1,2017-18,Nicholls State,G,23,0,191,23,56,.411,3,7,.429,20,49,.408,3,4,.750,3,12,15,2,6,0,4,21,69,1.7
8689,Jorge Perez-Laham\jorge-perez-laham-1,2015-16,High Point,G,24,4,375,27,72,.375,15,41,.366,12,31,.387,3,7,.429,8,33,41,47,12,3,19,31,69,2.5
8690,Hayward Register\hayward-register-1,2013-14,Louisiana,G,27,0,165,24,70,.343,5,14,.357,19,56,.339,2,2,1.000,5,9,14,4,5,0,4,16,69,1.2
8691,Devonte Hampton\devonte-hampton-1,2014-15,Alcorn State,G,20,1,345,25,79,.316,13,31,.419,12,48,.250,7,11,.636,8,33,41,28,13,3,21,30,69,2.0
8692,Kylia Sykes\kylia-sykes-1,2017-18,North Carolina-Greensboro,G,35,0,352,27,50,.540,20,28,.714,7,22,.318,8,13,.615,21,24,45,21,20,9,20,53,69,1.8
8693,Tyler Wilson\tyler-wilson-1,2013-14,Manhattan,G,33,4,411,21,55,.382,20,53,.377,1,2,.500,26,46,.565,6,29,35,51,31,1,36,78,69,1.3
8694,Erik Nakken\erik-nakken-1,2016-17,Idaho State,G,30,1,381,22,58,.379,1,1,1.000,21,57,.368,4,6,.667,3,24,27,7,5,1,17,35,69,0.8
8695,Robert Cartwright\robert-cartwright-1,2014-15,Stanford,G,36,1,399,23,64,.359,11,28,.393,12,36,.333,11,17,.647,6,28,34,24,9,1,13,38,69,1.2
8696,Asad Lamot\asad-lamot-1,2014-15,North Carolina-Greensboro,G,30,0,343,24,56,.429,10,20,.500,14,36,.389,7,12,.583,6,24,30,18,10,2,13,45,69,1.4
8697,Matt Marseille\matt-marseille-1,2013-14,Tennessee Tech,G,22,4,227,24,57,.421,24,56,.429,0,1,.000,21,30,.700,21,38,59,6,5,4,16,39,69,1.9
8698,Darryl Hicks\darryl-hicks-1,2015-16,Boston College,G,24,4,349,27,78,.346,15,37,.405,12,41,.293,3,7,.429,10,15,25,19,11,2,23,26,69,1.1
8699,Collin Stewart\collin-stewart-1,2013-14,Monmouth,G,27,0,202,23,75,.307,12,31,.387,11,44,.250,12,20,.600,4,14,18,8,5,3,23,31,69,0.3
8700,R.J. Curington\rj-curington-1,2013-14,DePaul,G,17,3,155,25,69,.362,15,35,.429,10,34,.294,9,12,.750,12,8,20,5,2,0,8,21,69,1.7
8701,Teyvon Myers\teyvon-myers-1,2015-16,West Virginia,G,29,4,249,21,59,.356,12,30,.400,9,29,.310,18,23,.783,4,18,22,15,7,0,16,23,69,1.2
8702,Aaron Morgan\aaron-morgan-2,2013-14,Maryland-Baltimore County,G,20,2,316,17,60,.283,6,23,.261,11,37,.297,24,31,.774,6,21,27,27,17,1,20,51,69,1.9
8703,Iakeem Alston\iakeem-alston-1,2014-15,St. Bonaventure,G,29,5,307,24,67,.358,23,60,.383,1,7,.143,20,39,.513,5,24,29,42,19,0,30,26,69,1.5
8704,Yunus Hopkinson\yunus-hopkinson-1,2014-15,St. Francis (NY),G,27,0,286,21,85,.247,12,33,.364,9,52,.173,18,21,.857,2,15,17,18,10,0,17,34,69,0.5
8705,Sean McDermott\sean-mcdermott-1,2016-17,Butler,G,30,2,322,22,53,.415,7,11,.636,15,42,.357,10,15,.667,12,31,43,9,6,6,10,42,69,1.5
8706,Bryce Dulin\bryce-dulin-1,2015-16,Navy,G,31,0,328,21,68,.309,13,31,.419,8,37,.216,19,32,.594,14,31,45,21,5,0,20,48,69,0.8
8707,Chance Murray\chance-murray-1,2014-15,Arizona State,G,29,0,249,22,55,.400,19,44,.432,3,11,.273,22,34,.647,3,27,30,31,4,4,20,22,69,1.5
8708,Dylan Alexander\dylan-alexander-1,2013-14,San Jose State,G,27,1,218,25,60,.417,13,23,.565,12,37,.324,7,12,.583,3,27,30,15,5,0,8,33,69,1.5
8709,Jalen Rhea\jalen-rhea-1,2014-15,American,G,26,0,207,24,46,.522,11,14,.786,13,32,.406,8,10,.800,16,8,24,3,3,0,6,17,69,2.0
8710,Josue Salaam\josue-salaam-1,2016-17,Bethune-Cookman,G,21,7,250,24,75,.320,6,16,.375,18,59,.305,3,3,1.000,10,23,33,11,9,3,8,23,69,2.0
8711,Pervis Louder\pervis-louder-1,2016-17,Air Force,G,24,1,202,22,58,.379,15,40,.375,7,18,.389,18,35,.514,6,19,25,13,6,2,21,29,69,1.0
8712,Jordan Gaither\jordan-gaither-1,2013-14,Tennessee State,G,23,1,311,24,73,.329,12,25,.480,12,48,.250,9,16,.563,9,19,28,15,6,1,16,25,69,1.2
8713,Jared Klein\jared-klein-1,2015-16,Western Michigan,G,30,1,356,22,61,.361,3,9,.333,19,52,.365,6,9,.667,2,26,28,18,13,0,9,21,69,1.7
8714,K.J. Lee\kj-lee-2,2015-16,Marist,G,28,2,332,25,62,.403,18,45,.400,7,17,.412,12,15,.800,8,35,43,23,4,5,18,25,69,1.6
8715,Tyree Bynum\tyree-bynum-1,2015-16,Texas Southern,G,26,2,354,25,57,.439,10,17,.588,15,40,.375,4,7,.571,4,19,23,8,6,0,9,13,69,1.7
8716,J.J. Cravatta\jj-cravatta-1,2013-14,Northern Illinois,G,29,0,200,19,63,.302,4,14,.286,15,49,.306,16,19,.842,9,14,23,5,6,1,6,14,69,1.4
8717,Malcolm Allen\malcolm-allen-1,2015-16,Stanford,G,28,2,358,28,61,.459,22,43,.512,6,18,.333,6,14,.429,2,20,22,33,12,1,32,22,68,1.3
8718,Jaevin Cumberland\jaevin-cumberland-1,2016-17,Oakland,G,25,0,170,17,45,.378,4,14,.286,13,31,.419,21,27,.778,2,9,11,7,5,1,7,14,68,1.7
8719,Steven Beo\steven-beo-1,2016-17,Brigham Young,G,31,0,356,25,65,.385,16,34,.471,9,31,.290,9,21,.429,9,31,40,27,11,0,16,36,68,1.4
8720,Jeremy Purvis\jeremy-purvis-1,2014-15,Austin Peay,G,22,9,387,21,66,.318,3,8,.375,18,58,.310,8,11,.727,4,21,25,37,16,0,13,24,68,2.6
8721,Chris Palombizio\chris-palombizio-1,2016-17,Oakland,G,29,0,230,20,60,.333,9,24,.375,11,36,.306,17,24,.708,11,28,39,7,7,1,6,15,68,1.7
8722,Isaac Cohen\isaac-cohen-1,2015-16,Columbia,G,23,18,519,33,58,.569,31,53,.585,2,5,.400,0,3,.000,42,62,104,66,12,7,21,42,68,4.9
8723,Marcus Stroman\marcus-stroman-1,2015-16,South Carolina,G,29,0,426,14,54,.259,9,45,.200,5,9,.556,35,53,.660,17,40,57,38,18,4,31,44,68,1.8
8724,Tyler Streeter\tyler-streeter-1,2015-16,Morgan State,G,25,0,191,23,50,.460,17,28,.607,6,22,.273,16,16,1.000,21,14,35,3,7,1,9,20,68,2.2
8725,Lance Potier\lance-potier-1,2014-15,McNeese State,G,27,0,264,27,68,.397,19,39,.487,8,29,.276,6,11,.545,18,33,51,7,7,10,18,29,68,1.5
8726,Jalon Plummer\jalon-plummer-1,2014-15,Youngstown State,G,17,11,336,23,77,.299,15,38,.395,8,39,.205,14,22,.636,13,28,41,16,9,1,18,33,68,1.6
8727,Kijana Love\kijana-love-1,2016-17,New Hampshire,G,23,0,214,24,63,.381,14,39,.359,10,24,.417,10,13,.769,1,15,16,6,8,1,18,25,68,1.0
8728,Colton Ray-St Cyr\colton-ray-st-cyr-1,2014-15,Coastal Carolina,G,34,0,280,26,72,.361,16,30,.533,10,42,.238,6,15,.400,27,46,73,14,19,6,16,32,68,1.8
8729,Will Darley\will-darley-1,2013-14,Maryland-Baltimore County,G,24,2,340,25,67,.373,18,32,.563,7,35,.200,11,15,.733,14,19,33,16,6,1,19,21,68,1.5
8730,Drew Bender\drew-bender-1,2013-14,Rice,G,26,1,278,25,78,.321,16,33,.485,9,45,.200,9,16,.563,3,34,37,19,9,3,24,34,68,0.8
8731,Robert Knar\robert-knar-1,2017-18,Missouri-Kansas City,G,27,1,254,24,51,.471,18,36,.500,6,15,.400,14,17,.824,2,32,34,21,6,0,8,5,68,2.3
8732,Jamal Williams\jamal-williams-2,2013-14,Texas Tech,G,28,1,312,21,72,.292,13,33,.394,8,39,.205,18,25,.720,6,23,29,26,10,1,22,32,68,1.0
8733,Corey Edwards\corey-edwards-1,2013-14,George Mason,G,25,12,337,19,64,.297,10,31,.323,9,33,.273,21,26,.808,4,35,39,34,11,0,25,36,68,1.5
8734,Cody Wichmann\cody-wichmann-1,2013-14,Milwaukee,G,28,0,191,25,54,.463,13,18,.722,12,36,.333,6,8,.750,4,9,13,7,3,1,3,12,68,1.6
8735,Allen Dickerson\allen-dickerson-1,2013-14,Radford,G,31,1,282,23,53,.434,9,14,.643,14,39,.359,8,15,.533,6,19,25,13,11,1,13,27,68,1.4
8736,Karl Madison\karl-madison-1,2013-14,Drake,G,31,2,497,19,65,.292,13,41,.317,6,24,.250,24,36,.667,1,33,34,60,21,1,31,43,68,1.7
8737,Iziahiah Sweeney\iziahiah-sweeney-1,2014-15,Portland State,G,25,2,302,29,77,.377,25,57,.439,4,20,.200,6,11,.545,7,13,20,18,8,6,9,29,68,1.5
8738,Aleksa Nikolic\aleksa-nikolic-1,2016-17,Marshall,G,25,3,347,30,61,.492,26,48,.542,4,13,.308,4,7,.571,14,53,67,29,14,5,18,26,68,2.8
8739,Jeffery Lewis\jeffery-lewis-1,2017-18,Mississippi Valley State,G,24,5,283,25,89,.281,9,24,.375,16,65,.246,2,4,.500,8,22,30,12,6,0,22,22,68,0.4
8740,Maceo Jack\maceo-jack-1,2017-18,George Washington,G,24,0,198,24,53,.453,13,26,.500,11,27,.407,9,11,.818,6,14,20,8,3,4,16,20,68,1.5
8741,Cameron Michael\cameron-michael-1,2015-16,Northern Colorado,G,4,4,135,23,53,.434,16,32,.500,7,21,.333,14,15,.933,2,22,24,8,2,0,9,11,67,10.2
8742,Drew Edwards\drew-edwards-1,2017-18,Providence,G,33,0,335,22,66,.333,18,40,.450,4,26,.154,19,23,.826,14,35,49,14,16,2,17,38,67,1.3
8743,Rahamanh Katumbusi II\rahamanh-katumbusiii-1,2015-16,Alcorn State,G,27,0,258,19,69,.275,8,35,.229,11,34,.324,18,25,.720,1,12,13,4,10,0,18,20,67,0.5
8744,Samuta Avea\samuta-avea-1,2017-18,Hawaii,G,27,1,205,28,62,.452,23,40,.575,5,22,.227,6,10,.600,13,32,45,9,4,1,16,19,67,1.5
8745,Derrick Brooks\derrick-brooks-1,2015-16,Wofford,G,32,0,379,21,58,.362,15,40,.375,6,18,.333,19,23,.826,2,40,42,38,20,2,30,44,67,1.5
8746,Trevor John\trevor-john-1,2017-18,Cal Poly,G,23,0,206,21,48,.438,2,6,.333,19,42,.452,6,6,1.000,4,10,14,11,4,0,4,12,67,2.2
8747,Akim Mitchell\akim-mitchell-1,2015-16,Hampton,G,30,10,324,18,56,.321,15,39,.385,3,17,.176,28,35,.800,19,38,57,14,7,1,12,33,67,1.6
8748,Ronnie Harrell\ronnie-harrell-1,2016-17,Creighton,G,26,0,189,23,47,.489,20,35,.571,3,12,.250,18,28,.643,16,33,49,19,6,3,9,14,67,2.6
8749,Isaac Belton\isaac-belton-1,2015-16,Longwood,G,24,0,191,21,60,.350,10,24,.417,11,36,.306,14,19,.737,6,21,27,5,10,1,11,25,67,1.5
8750,Ryan Johnson\ryan-johnson-1,2017-18,Mercer,G,29,0,226,18,41,.439,12,22,.545,6,19,.316,25,40,.625,13,27,40,12,10,3,15,26,67,1.8
8751,Kendall Griffin\kendall-griffin-1,2014-15,Wright State,G,8,5,170,17,34,.500,7,11,.636,10,23,.435,23,28,.821,4,16,20,12,8,9,15,16,67,7.1
8752,Nick Rogers\nick-rogers-2,2015-16,Toledo,G,31,0,282,15,55,.273,8,29,.276,7,26,.269,30,44,.682,2,22,24,36,7,1,14,41,67,1.3
8753,Daniel Dingle\daniel-dingle-1,2013-14,Temple,G,10,2,203,22,48,.458,15,27,.556,7,21,.333,16,30,.533,9,14,23,19,3,11,9,24,67,5.3
8754,George Matthews\george-matthews-1,2015-16,Texas-San Antonio,G,10,0,116,26,58,.448,16,29,.552,10,29,.345,5,5,1.000,12,22,34,4,6,6,16,19,67,4.1
8755,Duke Douglas\duke-douglas-1,2015-16,Denver,G,29,1,286,28,55,.509,24,42,.571,4,13,.308,7,11,.636,10,42,52,13,3,8,7,45,67,1.7
8756,Joshua Batson\joshua-batson-1,2015-16,Chicago State,G,31,21,551,24,92,.261,19,64,.297,5,28,.179,14,28,.500,19,43,62,49,19,2,25,60,67,1.2
8757,Armani Collins\armani-collins-1,2015-16,Portland State,G,13,2,148,23,66,.348,6,13,.462,17,53,.321,4,11,.364,3,20,23,3,0,3,4,11,67,2.4
8758,Victor Robbins\victor-robbins-1,2013-14,Oregon State,G,23,11,247,21,59,.356,17,44,.386,4,15,.267,21,33,.636,11,23,34,18,11,3,13,14,67,2.2
8759,Travon Landry\travon-landry-1,2013-14,New Mexico State,G,32,0,349,15,45,.333,12,30,.400,3,15,.200,34,54,.630,4,22,26,29,7,0,20,20,67,1.3
8760,Conner Frankamp\conner-frankamp-1,2013-14,Kansas,G,27,0,225,22,64,.344,7,16,.438,15,48,.313,8,10,.800,2,14,16,15,4,2,3,17,67,1.6
8761,Adam Weir\adam-weir-1,2014-15,Canisius,G,33,0,359,22,94,.234,7,32,.219,15,62,.242,8,12,.667,13,27,40,24,10,5,12,47,67,0.8
8762,Kent Auslander\kent-auslander-1,2017-18,Coppin State,G,17,0,400,22,84,.262,11,29,.379,11,55,.200,12,20,.600,3,38,41,15,4,4,33,31,67,0.0
8763,Derrick Brooks\derrick-brooks-1,2016-17,Wofford,G,27,0,286,23,44,.523,16,29,.552,7,15,.467,14,27,.519,3,31,34,22,11,2,22,27,67,1.7
8764,Michael Bolden\michael-bolden-1,2013-14,Cal Poly,G,25,4,343,24,68,.353,7,24,.292,17,44,.386,2,5,.400,15,21,36,13,7,4,8,23,67,1.9
8765,Lamin Fulton\lamin-fulton-1,2013-14,Green Bay,G,29,5,311,20,58,.345,8,16,.500,12,42,.286,14,16,.875,2,9,11,24,8,0,24,38,66,0.8
8766,Trevon Ary-Turner\trevon-ary-turner-1,2017-18,Weber State,G,18,0,185,23,48,.479,10,17,.588,13,31,.419,7,11,.636,0,16,16,12,1,1,13,24,66,1.8
8767,Brannen Greene\brannen-greene-1,2013-14,Kansas,G,28,0,183,20,52,.385,10,22,.455,10,30,.333,16,19,.842,6,22,28,10,6,0,15,26,66,1.2
8768,Robert Champion\robert-champion-1,2013-14,Holy Cross,G,25,0,244,23,71,.324,7,12,.583,16,59,.271,4,11,.364,6,17,23,6,5,2,8,16,66,1.1
8769,Juwan Williams\juwan-williams-1,2015-16,Weber State,G,20,0,168,21,45,.467,16,34,.471,5,11,.455,19,25,.760,8,24,32,2,2,5,10,28,66,2.0
8770,Ashton Spears\ashton-spears-1,2016-17,Jacksonville State,G,26,1,217,22,53,.415,13,23,.565,9,30,.300,13,23,.565,9,15,24,15,13,1,12,23,66,1.8
8771,Isaiah Tripp\isaiah-tripp-1,2014-15,Abilene Christian,G,29,0,209,23,52,.442,18,42,.429,5,10,.500,15,25,.600,13,20,33,11,6,0,10,33,66,1.4
8772,Kofi Andoh\kofi-andoh-1,2013-14,Howard,G,32,6,403,16,47,.340,15,43,.349,1,4,.250,33,49,.673,6,26,32,13,12,1,22,35,66,1.0
8773,Agunwa Okolie\agunwa-okolie-1,2013-14,Harvard,G,25,0,225,25,44,.568,24,42,.571,1,2,.500,15,29,.517,13,27,40,7,7,3,15,22,66,1.9
8774,Malik Metoyer\malik-metoyer-1,2015-16,Northwestern State,G,28,6,240,22,52,.423,16,27,.593,6,25,.240,16,24,.667,12,28,40,12,6,5,18,30,66,1.4
8775,Tre Hansbrough\tre-hansbrough-1,2015-16,Tennessee Tech,G,22,0,184,20,47,.426,14,27,.519,6,20,.300,20,27,.741,2,22,24,21,4,1,10,17,66,2.2
8776,Najee Pritchett\najee-pritchett-1,2015-16,South Carolina State,G,32,0,259,22,68,.324,10,17,.588,12,51,.235,10,26,.385,13,19,32,10,2,4,4,18,66,1.1
8777,Jack Gordon\jack-gordon-2,2016-17,Cornell,G,24,0,313,20,42,.476,5,10,.500,15,32,.469,11,18,.611,9,22,31,20,7,0,20,35,66,1.7
8778,Mario Dunn\mario-dunn-1,2016-17,Montana,G,25,1,340,23,60,.383,8,23,.348,15,37,.405,5,9,.556,8,25,33,31,13,7,17,34,66,2.1
8779,Carl Brown\carl-brown-7,2017-18,Cal State Northridge,G,17,3,184,23,58,.397,11,27,.407,12,31,.387,8,10,.800,7,16,23,4,3,0,7,29,66,1.8
8780,Charles Burley\charles-burley-1,2014-15,Delaware State,G,33,13,603,16,56,.286,10,36,.278,6,20,.300,28,42,.667,24,53,77,88,21,0,63,60,66,1.7
8781,Jaleel Queary\jaleel-queary-1,2014-15,Jackson State,G,23,18,452,26,66,.394,25,62,.403,1,4,.250,13,32,.406,15,35,50,36,15,4,36,56,66,1.2
8782,Justin Goode\justin-goode-1,2015-16,Rutgers,G,30,2,431,20,55,.364,8,16,.500,12,39,.308,14,17,.824,3,32,35,20,8,1,10,37,66,1.5
8783,Jaron Withers\jaron-withers-1,2015-16,Presbyterian,G,31,8,471,22,79,.278,14,42,.333,8,37,.216,14,28,.500,9,46,55,34,22,2,26,51,66,1.1
8784,Shaun Johnson\shaun-johnson-1,2015-16,McNeese State,G,26,4,278,20,78,.256,5,23,.217,15,55,.273,11,13,.846,6,23,29,21,4,0,11,25,66,1.1
8785,Andre Applewhite\andre-applewhite-1,2013-14,Mississippi State,G,12,5,214,17,41,.415,14,32,.438,3,9,.333,29,43,.674,20,27,47,16,10,1,20,29,66,4.2
8786,William Douglas\william-douglas-1,2017-18,Southern Methodist,G,33,1,478,18,73,.247,6,34,.176,12,39,.308,18,24,.750,25,38,63,31,21,3,33,57,66,1.1
8787,Reggie Kissoonlal\reginald-kissoonlal-1,2016-17,Northwestern State,G,20,2,173,20,54,.370,6,19,.316,14,35,.400,12,16,.750,6,22,28,5,5,4,13,33,66,1.5
8788,Jabril Durham\jabril-durham-1,2014-15,Arkansas,G,36,9,359,20,66,.303,5,24,.208,15,42,.357,11,14,.786,8,19,27,52,10,0,27,39,66,1.2
8789,Taylor Sutlive\taylor-sutlive-1,2013-14,Cal Poly,G,22,0,178,22,48,.458,3,6,.500,19,42,.452,3,3,1.000,2,16,18,4,2,0,6,15,66,1.8
8790,DJ Bryant\dj-bryant-1,2017-18,Texas-Arlington,G,34,8,493,22,53,.415,12,22,.545,10,31,.323,12,20,.600,6,42,48,58,22,1,24,43,66,2.2
8791,Devin Wilson\devin-wilson-2,2015-16,Virginia Tech,G,32,8,687,22,63,.349,17,44,.386,5,19,.263,17,30,.567,5,52,57,70,24,1,32,72,66,1.8
8792,Carmelo Betancourt\carmelo-betancourt-1,2013-14,Akron,G,32,17,540,22,64,.344,15,37,.405,7,27,.259,15,24,.625,6,29,35,72,24,1,48,54,66,1.4
8793,Undra Mitchem\undra-mitchem-1,2014-15,Jacksonville State,G,15,9,222,25,74,.338,12,27,.444,13,47,.277,3,6,.500,5,15,20,16,12,2,10,28,66,2.3
8794,Steve Dulley\steve-dulley-1,2017-18,Missouri-Kansas City,G,25,0,196,21,64,.328,11,28,.393,10,36,.278,14,27,.519,12,19,31,3,4,2,10,26,66,1.0
8795,Donovan Theme-Love\donovan-theme-love-1,2017-18,Wofford,G,34,4,419,19,59,.322,4,15,.267,15,44,.341,13,21,.619,0,51,51,63,20,2,31,48,66,1.8
8796,Karl Harris\karl-harris-1,2015-16,La Salle,G,25,0,268,24,74,.324,12,32,.375,12,42,.286,6,13,.462,6,28,34,8,3,4,9,30,66,1.0
8797,Cameron Monroe\cameron-monroe-1,2013-14,Southern,G,28,8,273,25,59,.424,23,53,.434,2,6,.333,14,30,.467,8,13,21,17,8,1,27,40,66,0.6
8798,Lonnie Grayson\lonnie-grayson-1,2017-18,Army,G,22,0,204,21,65,.323,8,25,.320,13,40,.325,11,12,.917,2,20,22,7,5,3,16,23,66,1.0
8799,Justin Jenifer\justin-jenifer-1,2015-16,Cincinnati,G,27,0,232,21,58,.362,11,28,.393,10,30,.333,14,20,.700,2,16,18,34,14,0,17,18,66,1.9
8800,Fred Richardson\fred-richardson-1,2014-15,Colorado State,G,22,0,256,21,55,.382,12,28,.429,9,27,.333,14,14,1.000,11,27,38,7,5,0,12,18,65,1.9
8801,Isaiah Felder\isaiah-felder-1,2016-17,Savannah State,G,28,0,200,22,77,.286,3,12,.250,19,65,.292,2,3,.667,7,13,20,10,11,0,16,15,65,0.9
8802,Carlos Johnson\carlos-johnson-1,2017-18,Washington,G,17,0,144,25,44,.568,23,38,.605,2,6,.333,13,22,.591,6,18,24,3,3,1,12,21,65,2.1
8803,Emmanuel Tselentakis\emmanuel-tselentakis-1,2013-14,NJIT,G,26,5,354,23,64,.359,12,31,.387,11,33,.333,8,12,.667,10,38,48,23,13,8,17,38,65,1.9
8804,DJ Mlachnik\dj-mlachnik-1,2014-15,Massachusetts-Lowell,G,25,5,228,23,52,.442,5,12,.417,18,40,.450,1,3,.333,6,18,24,6,7,0,5,18,65,1.8
8805,Erten Gazi\erten-gazi-1,2015-16,DePaul,G,30,5,439,25,56,.446,21,33,.636,4,23,.174,11,16,.688,10,28,38,35,8,2,30,55,65,1.0
8806,Quinton Thomas\quinton-thomas-1,2017-18,Southeastern Louisiana,G,28,0,264,19,50,.380,12,19,.632,7,31,.226,20,27,.741,6,32,38,12,7,3,17,29,65,1.3
8807,TJ Lang\tj-lang-1,2014-15,Auburn,G,27,6,372,20,57,.351,6,15,.400,14,42,.333,11,20,.550,12,23,35,12,5,2,13,47,65,1.0
8808,Khaliq Ghani\khaliq-ghani-1,2015-16,Yale,G,25,0,284,22,64,.344,7,18,.389,15,46,.326,6,8,.750,4,36,40,10,8,5,11,26,65,1.6
8809,Malik Ellison\malik-ellison-12,2017-18,Eastern Michigan,G,32,13,419,22,78,.282,12,38,.316,10,40,.250,11,20,.550,7,16,23,44,18,0,30,18,65,1.2
8810,Jaaron Simmons\jaaron-simmons-1,2013-14,Houston,G,32,1,353,20,59,.339,19,51,.373,1,8,.125,24,34,.706,1,19,20,37,9,0,28,38,65,0.8
8811,Tyrone Wooten\tyrone-wooten-1,2015-16,Louisiana,G,24,1,175,23,56,.411,20,39,.513,3,17,.176,16,26,.615,8,27,35,16,7,3,18,20,65,1.6
8812,Nizar Kapic\nizar-kapic-1,2013-14,Rice,G,25,1,280,23,73,.315,10,31,.323,13,42,.310,6,10,.600,5,21,26,11,6,2,12,30,65,0.9
8813,Richard Morrow\richard-morrow-1,2013-14,Florida Atlantic,G,26,4,263,26,65,.400,25,62,.403,1,3,.333,12,23,.522,15,42,57,10,1,2,22,46,65,0.7
8814,Michael Brown\michael-brown-1,2013-14,Navy,G,28,0,285,23,61,.377,17,45,.378,6,16,.375,13,21,.619,23,22,45,9,4,1,14,34,65,1.2
8815,Kaleb Joseph\kaleb-joseph-1,2017-18,Creighton,G,15,0,116,19,33,.576,14,22,.636,5,11,.455,22,27,.815,3,13,16,21,4,0,10,10,65,3.9
8816,Joel Davis\joel-davis-1,2015-16,Cornell,G,24,1,228,18,56,.321,12,42,.286,6,14,.429,23,36,.639,15,25,40,12,9,9,20,27,65,1.6
8817,Leyton Hammonds\leyton-hammonds-1,2014-15,Oklahoma State,G,28,2,276,24,69,.348,8,21,.381,16,48,.333,1,3,.333,12,15,27,7,5,2,12,41,65,0.8
8818,Taylor McHugh\taylor-mchugh-1,2017-18,Bryant,G,17,8,331,22,64,.344,10,25,.400,12,39,.308,9,12,.750,5,19,24,33,9,1,18,25,65,2.5
8819,Jorge Perez-Laham\jorge-perez-laham-1,2014-15,High Point,G,22,10,312,25,53,.472,15,36,.417,10,17,.588,5,11,.455,4,30,34,44,14,1,22,26,65,2.7
8820,Coleman Edwards\coleman-edwards-1,2015-16,New Orleans,G,29,1,378,21,77,.273,8,31,.258,13,46,.283,10,16,.625,2,28,30,25,11,0,21,57,65,0.4
8821,Jack Shaughnessy\jack-shaughnessy-1,2015-16,Seattle,G,29,10,314,19,66,.288,14,36,.389,5,30,.167,22,34,.647,9,31,40,11,12,0,16,34,65,0.9
8822,Damion Lee\damion-lee-1,2013-14,Drexel,G,5,5,134,20,54,.370,14,32,.438,6,22,.273,19,22,.864,0,21,21,11,3,1,7,17,65,7.6
8823,Malik Rhodes\malik-rhodes-1,2017-18,Memphis,G,26,0,264,18,54,.333,8,17,.471,10,37,.270,19,24,.792,1,9,10,32,4,0,21,22,65,1.2
8824,Ryan Stipanovich\ryan-stipanovich-1,2017-18,Bradley,G,27,0,271,19,39,.487,5,12,.417,14,27,.519,13,13,1.000,15,25,40,17,17,3,22,26,65,2.3
8825,Chandler Savage\chandler-savage-1,2013-14,Arkansas-Pine Bluff,G,31,1,488,23,55,.418,23,48,.479,0,7,.000,19,32,.594,10,46,56,29,29,2,31,44,65,1.7
8826,Brandon Newman\brandon-newman-1,2017-18,Louisiana-Monroe,G,29,0,297,18,51,.353,11,29,.379,7,22,.318,22,27,.815,4,37,41,31,13,2,15,29,65,2.0
8827,Gino Littles\gino-littles-1,2014-15,Texas-San Antonio,G,27,22,640,25,67,.373,20,35,.571,5,32,.156,10,17,.588,13,38,51,57,17,0,24,37,65,2.4
8828,Ja'Donta Blakley\jadonta-blakely-1,2015-16,Prairie View,G,28,10,413,25,65,.385,21,56,.375,4,9,.444,11,21,.524,14,45,59,36,32,7,22,71,65,2.2
8829,Danny Upchurch\danny-upchurch-1,2014-15,Charleston Southern,G,30,0,343,18,83,.217,7,25,.280,11,58,.190,18,27,.667,4,14,18,37,12,1,26,38,65,0.5
8830,Jan Grzelinski\jan-grzelinski-1,2014-15,Canisius,G,32,25,501,25,84,.298,16,47,.340,9,37,.243,6,10,.600,8,11,19,60,11,0,42,32,65,0.7
8831,Brandon Regis\brandon-regis-1,2013-14,McNeese State,G,30,8,279,23,69,.333,18,38,.474,5,31,.161,14,19,.737,12,19,31,24,8,2,19,25,65,1.2
8832,Nick Davis\nick-davis-2,2015-16,South Alabama,G,25,0,327,24,58,.414,18,34,.529,6,24,.250,11,21,.524,22,69,91,8,8,10,15,50,65,2.1
8833,J.J. Butler\jj-butler-1,2013-14,Lipscomb,G,30,4,402,27,58,.466,23,39,.590,4,19,.211,7,18,.389,8,21,29,40,14,2,31,47,65,1.2
8834,Vontay Ott\vontay-ott-1,2017-18,Northwestern State,G,27,2,263,25,83,.301,17,48,.354,8,35,.229,6,17,.353,14,31,45,11,9,1,27,25,64,0.4
8835,Major Canady\major-canady-1,2013-14,Drexel,G,30,14,479,21,63,.333,18,49,.367,3,14,.214,19,33,.576,5,46,51,27,12,1,17,52,64,1.1
8836,Justin Roberts\justin-roberts-1,2017-18,Toledo,G,32,1,284,18,43,.419,3,11,.273,15,32,.469,13,17,.765,1,20,21,28,1,0,8,26,64,1.5
8837,Tyler Streeter\tyler-streeter-1,2017-18,Morgan State,G,18,1,105,25,46,.543,16,26,.615,9,20,.450,5,7,.714,9,7,16,4,3,0,11,6,64,2.3
8838,Derrico Peck\derrico-peck-1,2013-14,Northeastern,G,28,3,349,27,52,.519,26,48,.542,1,4,.250,9,26,.346,14,23,37,13,7,10,25,51,64,0.9
8839,Julian Eleby\julian-eleby-1,2013-14,Virginia Military Institute,G,25,1,203,20,58,.345,12,26,.462,8,32,.250,16,20,.800,17,33,50,12,11,7,16,12,64,2.2
8840,Costa Anderson\costa-anderson-1,2016-17,Albany (NY),G,28,0,210,21,50,.420,9,17,.529,12,33,.364,10,10,1.000,3,14,17,18,7,0,5,10,64,1.9
8841,Chris Darrington\chris-darrington-1,2017-18,Tennessee,G,25,0,209,19,52,.365,13,33,.394,6,19,.316,20,26,.769,3,12,15,19,7,1,14,17,64,1.5
8842,Bryce Dulin\bryce-dulin-1,2014-15,Navy,G,23,0,244,20,57,.351,7,19,.368,13,38,.342,11,16,.688,10,17,27,9,5,2,13,24,64,1.4
8843,Ty Cockfield\ty-cockfield-1,2015-16,Stetson,G,9,0,149,24,62,.387,18,40,.450,6,22,.273,10,12,.833,5,12,17,8,5,2,13,6,64,3.7
8844,Keon Burns\keon-burns-1,2017-18,New Hampshire,G,22,2,217,21,50,.420,2,10,.200,19,40,.475,3,4,.750,5,26,31,8,3,1,11,17,64,1.8
8845,Baryn Houston\baryn-houston-1,2014-15,Alabama A&M,G,28,1,297,22,76,.289,14,38,.368,8,38,.211,12,20,.600,15,33,48,5,4,1,5,31,64,1.0
8846,Christian Terrell\christian-terrell-2,2016-17,UC-Santa Barbara,G,27,17,496,26,97,.268,23,63,.365,3,34,.088,9,21,.429,20,59,79,33,16,3,29,43,64,1.1
8847,Darrian Traylor\darrian-traylor-1,2017-18,UC-Irvine,G,28,0,204,19,52,.365,6,14,.429,13,38,.342,13,21,.619,8,28,36,8,5,0,13,15,64,1.3
8848,Kevin Franceschi\kevin-franceschi-1,2014-15,Missouri-Kansas City,G,25,0,211,20,56,.357,16,41,.390,4,15,.267,20,25,.800,9,7,16,9,3,0,26,21,64,0.6
8849,Jerron Wilbut\jerron-wilbut-1,2016-17,Cal State Northridge,G,22,0,191,22,71,.310,14,33,.424,8,38,.211,12,20,.600,5,22,27,8,2,1,19,26,64,0.4
8850,Brandon Gfeller\brandon-gfeller-1,2013-14,Montana,G,27,2,299,22,64,.344,5,11,.455,17,53,.321,3,5,.600,7,15,22,7,9,1,11,37,64,0.9
8851,Alex Paquin\alex-paquin-1,2016-17,American,G,25,0,265,23,45,.511,16,29,.552,7,16,.438,11,20,.550,8,23,31,13,6,0,13,30,64,1.6
8852,Cordarius Samples\cordarius-samples-1,2013-14,Mississippi Valley State,G,22,7,213,21,45,.467,17,33,.515,4,12,.333,18,27,.667,2,21,23,27,8,1,28,30,64,1.5
8853,Rahjan Muhammad\rahjan-muhammad-1,2013-14,Chicago State,G,11,9,261,21,58,.362,9,21,.429,12,37,.324,10,13,.769,7,20,27,11,11,1,10,14,64,4.1
8854,Khari Harley\khari-harley-1,2015-16,Ohio,G,20,9,284,19,54,.352,13,32,.406,6,22,.273,20,29,.690,7,21,28,9,9,4,13,26,64,1.8
8855,Christion Thompson\christion-thompson-1,2016-17,Rhode Island,G,26,0,268,20,58,.345,10,20,.500,10,38,.263,14,22,.636,13,28,41,12,16,9,8,50,64,1.9
8856,Jimmy Marshall\jimmy-marshall-1,2016-17,Northeastern,G,29,3,298,23,56,.411,10,17,.588,13,39,.333,5,9,.556,7,27,34,4,7,3,12,20,64,1.3
8857,Nick Doyle\nick-doyle-1,2013-14,Delaware State,G,27,1,271,26,74,.351,22,53,.415,4,21,.190,8,14,.571,3,18,21,23,2,0,19,17,64,0.7
8858,Karl Madison\karl-madison-1,2014-15,Drake,G,28,14,595,18,57,.316,13,43,.302,5,14,.357,23,35,.657,8,35,43,73,15,0,40,43,64,1.8
8859,Isaiah Wright\isaiah-wright-1,2014-15,Utah,G,33,0,416,17,46,.370,4,13,.308,13,33,.394,17,22,.773,3,23,26,57,3,3,27,39,64,1.5
8860,Josh Steel\josh-steel-1,2015-16,Duquesne,G,29,1,233,22,48,.458,7,19,.368,15,29,.517,5,8,.625,5,19,24,20,7,0,14,31,64,1.4
8861,Mike Laster\mike-laster-1,2015-16,Ohio,G,33,0,309,25,57,.439,24,49,.490,1,8,.125,13,18,.722,13,16,29,4,2,0,17,28,64,0.7
8862,Jake Babic\jake-babic-1,2015-16,Appalachian State,G,31,0,359,19,75,.253,4,28,.143,15,47,.319,10,17,.588,10,34,44,44,5,3,30,38,63,0.8
8863,Cazmon Hayes\cazmon-hayes-1,2013-14,Delaware,G,32,0,313,20,54,.370,15,29,.517,5,25,.200,18,28,.643,13,23,36,6,3,2,8,41,63,0.9
8864,Jalek Felton\jalek-felton-1,2017-18,North Carolina,G,22,1,213,24,62,.387,13,27,.481,11,35,.314,4,6,.667,2,18,20,35,8,2,24,11,63,1.9
8865,Devonte Banner\devonte-banner-1,2015-16,Norfolk State,G,29,2,221,23,53,.434,9,17,.529,14,36,.389,3,13,.231,9,21,30,18,8,0,10,23,63,1.6
8866,Connor Brooks\connor-brooks-1,2014-15,Stephen F. Austin,G,28,1,267,21,48,.438,15,29,.517,6,19,.316,15,23,.652,11,17,28,20,16,2,20,24,63,1.8
8867,Gerad Davis\gerad-davis-1,2016-17,Northern Colorado,G,9,0,123,21,43,.488,20,39,.513,1,4,.250,20,28,.714,11,24,35,8,1,0,11,20,63,4.5
8868,Austin Donaldson\austin-donaldson-1,2016-17,Georgia State,G,28,1,294,25,71,.352,21,57,.368,4,14,.286,9,19,.474,9,25,34,40,23,1,27,37,63,1.5
8869,Dylan Miller\dylan-miller-1,2017-18,North Dakota State,G,22,4,211,25,50,.500,21,37,.568,4,13,.308,9,13,.692,13,22,35,9,4,6,12,34,63,1.9
8870,Evan Hinson\evan-hinson-1,2017-18,South Carolina,G,23,17,232,20,57,.351,12,35,.343,8,22,.364,15,28,.536,5,25,30,7,6,4,18,32,63,0.9
8871,Tyrik Edwards\tyrik-edwards-1,2017-18,Jacksonville State,G,32,3,332,21,56,.375,19,48,.396,2,8,.250,19,31,.613,8,40,48,31,7,4,25,11,63,1.5
8872,Trey Touchet\trey-touchet-1,2017-18,Texas-El Paso,G,27,4,297,23,56,.411,17,32,.531,6,24,.250,11,16,.688,4,25,29,19,5,0,18,16,63,1.3
8873,Daniel Levitt\daniel-levitt-1,2015-16,Cleveland State,G,14,0,193,19,55,.345,3,9,.333,16,46,.348,9,10,.900,6,8,14,3,5,0,3,10,63,2.7
8874,Cameron McGee\cameron-mcgee-1,2016-17,Lamar,G,18,0,127,16,44,.364,9,23,.391,7,21,.333,24,32,.750,3,9,12,23,8,0,8,15,63,2.8
8875,Kyler Erickson\kyler-erickson-1,2014-15,Omaha,G,22,0,309,14,39,.359,7,18,.389,7,21,.333,28,38,.737,3,26,29,14,10,1,10,19,63,2.3
8876,Dylen Setzekorn\dylen-setzekorn-1,2013-14,Citadel,G,14,0,180,24,75,.320,15,43,.349,9,32,.281,6,12,.500,14,17,31,8,5,2,14,21,63,1.6
8877,Shizz Alston Jr.\shawn-alston-1,2015-16,Temple,G,31,3,310,23,74,.311,10,26,.385,13,48,.271,4,8,.500,4,25,29,18,3,1,11,28,63,0.7
8878,Jordan Harris\jordan-harris-4,2017-18,Georgia,G,18,0,285,21,52,.404,15,30,.500,6,22,.273,15,23,.652,5,32,37,15,8,3,15,29,63,2.2
8879,Tyler Jenkins\tyler-jenkins-1,2015-16,Lehigh,G,32,0,275,23,56,.411,11,24,.458,12,32,.375,5,8,.625,5,14,19,25,12,0,29,43,63,0.7
8880,Dominick Scelfo\dominick-scelfo-1,2013-14,Cornell,G,23,1,345,19,78,.244,4,13,.308,15,65,.231,10,20,.500,2,17,19,22,6,0,8,28,63,0.9
8881,Jaron Withers\jaron-withers-1,2014-15,Presbyterian,G,32,9,416,22,60,.367,20,49,.408,2,11,.182,17,28,.607,4,25,29,16,15,5,20,40,63,0.9
8882,Drake Green\drake-green-1,2014-15,Abilene Christian,G,28,0,243,25,79,.316,21,61,.344,4,18,.222,9,16,.563,4,18,22,13,7,2,13,28,63,0.6
8883,Jordan Hunter\jordan-hunter-1,2015-16,New Mexico,G,28,1,251,23,53,.434,13,29,.448,10,24,.417,7,10,.700,3,23,26,31,14,0,26,22,63,1.6
8884,Royce Williams\royce-williams-1,2013-14,Weber State,G,25,0,231,20,48,.417,6,13,.462,14,35,.400,9,12,.750,1,22,23,16,2,2,10,25,63,1.5
8885,Ahmad Fields\ahmad-fields-1,2013-14,Utah,G,19,0,143,19,40,.475,15,30,.500,4,10,.400,21,35,.600,7,33,40,10,3,1,10,14,63,2.5
8886,James Beck\james-beck-1,2017-18,Oakland,G,19,7,287,24,70,.343,24,66,.364,0,4,.000,15,24,.625,20,49,69,9,3,4,16,35,63,1.6
8887,Dion Wiley\dion-wiley-1,2016-17,Maryland,G,20,0,205,19,59,.322,4,19,.211,15,40,.375,10,14,.714,10,19,29,11,4,4,12,21,63,1.7
8888,C.J. Ford\cj-ford-1,2013-14,Murray State,G,32,0,279,23,55,.418,23,44,.523,0,11,.000,17,31,.548,4,26,30,25,6,0,14,39,63,1.0
8889,Brendon Ganaway\brendon-ganaway-1,2016-17,Southern,G,33,1,308,17,45,.378,13,33,.394,4,12,.333,24,32,.750,6,12,18,36,10,0,26,34,62,1.1
8890,Ben Marcus\ben-marcus-1,2016-17,Little Rock,G,25,0,191,27,47,.574,27,47,.574,0,0,,8,18,.444,14,24,38,0,8,7,8,37,62,1.7
8891,Jamal Lewis\jamal-lewis-1,2015-16,Pennsylvania,G,25,1,229,22,64,.344,21,45,.467,1,19,.053,17,24,.708,4,11,15,22,7,0,18,19,62,1.0
8892,Emmanuel Matey\emmanuel-matey-1,2014-15,Morgan State,G,29,0,398,19,49,.388,19,47,.404,0,2,.000,24,46,.522,7,28,35,73,14,0,33,36,62,2.0
8893,Jabari Sandifer\jabari-sandifer-1,2016-17,Western Illinois,G,11,10,251,18,56,.321,13,35,.371,5,21,.238,21,34,.618,2,27,29,30,10,1,24,28,62,2.8
8894,Stephon Whyatt\stephon-whyatt-1,2014-15,Saint Francis (PA),G,23,2,250,22,52,.423,16,31,.516,6,21,.286,12,18,.667,4,19,23,19,11,3,20,26,62,1.6
8895,Rickey Scott\rickey-scott-1,2013-14,Arkansas,G,23,5,198,21,53,.396,19,41,.463,2,12,.167,18,37,.486,8,20,28,25,4,0,11,19,62,1.7
8896,Anders Haas\anders-haas-1,2013-14,Albany (NY),G,21,0,134,18,53,.340,3,9,.333,15,44,.341,11,13,.846,2,10,12,5,1,0,8,11,62,1.3
8897,Eric James\eric-james-2,2016-17,Duquesne,G,27,0,251,20,65,.308,14,42,.333,6,23,.261,16,27,.593,28,31,59,15,13,6,17,30,62,1.8
8898,Khari Harley\khari-harley-1,2014-15,Ohio,G,24,4,400,18,50,.360,10,25,.400,8,25,.320,18,20,.900,10,25,35,21,8,5,18,42,62,1.6
8899,Ahmad Frost\ahmad-frost-1,2015-16,Maryland-Eastern Shore,G,20,14,353,19,47,.404,7,17,.412,12,30,.400,12,15,.800,4,25,29,36,7,1,19,40,62,2.2
8900,Daniel Grieves\daniel-grieves-1,2015-16,Southeastern Louisiana,G,13,6,186,21,51,.412,12,20,.600,9,31,.290,11,16,.688,8,16,24,12,5,4,8,33,62,2.9
8901,Michael Chambers\michael-chambers-3,2016-17,Maryland-Eastern Shore,G,24,0,245,21,56,.375,15,25,.600,6,31,.194,14,21,.667,5,30,35,14,5,1,18,31,62,1.1
8902,Tim Henderson\tim-henderson-2,2013-14,Louisville,G,34,1,223,22,51,.431,8,12,.667,14,39,.359,4,6,.667,6,20,26,17,9,0,4,22,62,1.5
8903,Christian Bentley\christian-bentley-1,2017-18,Siena,G,29,11,328,20,43,.465,13,29,.448,7,14,.500,15,23,.652,17,25,42,16,10,1,16,29,62,1.7
8904,Jalen Bradley\jalen-bradley-1,2013-14,Omaha,G,13,0,118,24,48,.500,16,28,.571,8,20,.400,6,7,.857,5,7,12,12,6,0,5,5,62,3.9
8905,Jonathan Mitchell\jonathan-mitchell-2,2017-18,Delaware State,G,9,2,156,20,42,.476,18,36,.500,2,6,.333,20,30,.667,10,10,20,19,6,3,12,8,62,5.9
8906,Jared Dimakos\jared-dimakos-1,2013-14,Chicago State,G,27,1,256,25,50,.500,22,33,.667,3,17,.176,9,24,.375,8,16,24,6,6,1,10,36,62,1.0
8907,Elisha Boone\elisha-boone-1,2014-15,Saint Peter's,G,22,0,216,27,66,.409,24,59,.407,3,7,.429,5,22,.227,16,21,37,4,5,5,14,14,62,1.3
8908,Kameron Murrell\kameron-murrell-1,2015-16,George Mason,G,32,2,372,17,91,.187,2,24,.083,15,67,.224,13,16,.813,10,30,40,9,5,3,16,26,62,0.2
8909,Jerran Foster\jerran-foster-1,2014-15,Florida A&M,G,28,5,438,20,92,.217,12,54,.222,8,38,.211,14,28,.500,4,28,32,29,12,0,43,34,62,-0.5
8910,Tyler Washington\tyler-washington-1,2013-14,Northwestern State,G,22,3,284,20,61,.328,11,29,.379,9,32,.281,13,21,.619,10,10,20,24,6,1,12,30,62,1.5
8911,Larry Austin\larry-austin-1,2015-16,Xavier,G,34,0,334,21,52,.404,21,51,.412,0,1,.000,20,32,.625,8,30,38,39,19,0,26,40,62,1.4
8912,Jaylon Tate\jaylon-tate-1,2016-17,Illinois,G,26,7,408,18,47,.383,16,36,.444,2,11,.182,24,35,.686,8,26,34,73,12,2,32,30,62,2.5
8913,Jordan Dembley\jordan-dembley-1,2014-15,Liberty,G,25,10,364,19,42,.452,12,24,.500,7,18,.389,17,25,.680,8,21,29,42,6,2,25,22,62,2.1
8914,Max Martino\max-martino-1,2013-14,Northern Iowa,G,27,0,262,22,52,.423,6,13,.462,16,39,.410,2,5,.400,8,29,37,5,11,1,10,43,62,1.3
8915,Josh James\josh-james-2,2014-15,Monmouth,G,13,11,305,22,69,.319,17,54,.315,5,15,.333,13,18,.722,7,25,32,16,5,0,22,20,62,1.5
8916,Austin White\austin-white-1,2014-15,High Point,G,27,0,210,19,51,.373,17,37,.459,2,14,.143,22,34,.647,4,16,20,12,3,0,9,15,62,1.2
8917,Luke Moyer\luke-moyer-1,2014-15,Campbell,G,19,2,187,20,50,.400,2,6,.333,18,44,.409,4,5,.800,4,7,11,10,3,0,14,16,62,1.5
8918,John Swinton\john-swinton-1,2014-15,Wofford,G,32,5,358,18,43,.419,14,29,.483,4,14,.286,22,25,.880,5,24,29,36,10,2,12,37,62,1.8
8919,Grant Vermeer\grant-vermeer-1,2013-14,Navy,G,22,1,212,23,60,.383,9,17,.529,14,43,.326,2,2,1.000,10,19,29,15,7,0,9,17,62,2.0
8920,Reilly Walsh\reilly-walsh-1,2016-17,NJIT,G,21,0,306,22,50,.440,12,27,.444,10,23,.435,8,12,.667,12,19,31,20,13,3,21,39,62,1.9
8921,Cameron Satterwhite\cameron-satterwhite-1,2017-18,Loyola (IL),G,35,0,363,18,54,.333,14,35,.400,4,19,.211,21,32,.656,4,53,57,31,2,4,31,26,61,0.9
8922,Dominique Hawkins\dominique-hawkins-1,2015-16,Kentucky,G,27,0,249,17,46,.370,9,17,.529,8,29,.276,19,25,.760,13,9,22,13,6,3,6,30,61,1.6
8923,Jordan Berry\jordan-berry-1,2017-18,Jackson State,G,24,1,228,21,77,.273,5,23,.217,16,54,.296,3,4,.750,8,13,21,8,8,1,12,21,61,0.8
8924,Dejuan Clayton\dejuan-clayton-1,2017-18,Coppin State,G,6,6,179,21,63,.333,12,35,.343,9,28,.321,10,15,.667,2,9,11,11,6,1,11,12,61,4.3
8925,Ray Chen\ray-chen-1,2016-17,Liberty,G,35,0,248,15,35,.429,7,14,.500,8,21,.381,23,26,.885,3,27,30,19,7,0,15,25,61,1.3
8926,Will Johnston\will-johnston-1,2014-15,Virginia Tech,G,25,10,278,20,55,.364,3,9,.333,17,46,.370,4,5,.800,7,18,25,8,3,1,2,22,61,1.6
8927,Isaiah Wright\isaiah-wright-1,2015-16,Utah,G,29,1,375,20,52,.385,8,18,.444,12,34,.353,9,13,.692,0,30,30,43,6,4,24,34,61,1.4
8928,Hudson Price\hudson-price-1,2013-14,Texas Christian,G,25,8,386,15,62,.242,8,34,.235,7,28,.250,24,31,.774,10,41,51,13,11,8,18,47,61,1.2
8929,Marcus Wallace\marcus-wallace-1,2015-16,Southeast Missouri State,G,8,2,201,25,60,.417,20,41,.488,5,19,.263,6,18,.333,10,20,30,25,8,1,18,16,61,4.9
8930,Casey Wells\casey-wells-1,2015-16,Savannah State,G,22,9,268,20,76,.263,4,11,.364,16,65,.246,5,7,.714,4,9,13,10,11,1,19,15,61,0.6
8931,Jahmal McMurray\jahmal-mcmurray-1,2016-17,South Florida,G,3,1,106,22,51,.431,12,31,.387,10,20,.500,7,10,.700,2,6,8,6,1,0,14,3,61,8.7
8932,Michael Zeno\michael-zeno-1,2014-15,New Orleans,G,28,9,297,22,53,.415,21,49,.429,1,4,.250,16,34,.471,18,26,44,6,10,11,34,43,61,0.6
8933,Marquel McKinney\marquel-mckinney-1,2014-15,Sam Houston State,G,35,1,453,21,63,.333,10,22,.455,11,41,.268,8,19,.421,25,54,79,22,6,0,22,56,61,0.9
8934,Robert Hubbs\robert-hubbs-1,2013-14,Tennessee,G,12,0,219,23,75,.307,14,43,.326,9,32,.281,6,9,.667,9,9,18,8,2,4,7,17,61,1.8
8935,Charles Matthews\charles-matthews-1,2015-16,Kentucky,G,36,3,370,23,52,.442,22,48,.458,1,4,.250,14,34,.412,32,27,59,13,15,6,19,33,61,1.5
8936,Spencer Turner\spencer-turner-1,2014-15,Belmont,G,23,3,211,21,63,.333,4,6,.667,17,57,.298,2,3,.667,5,15,20,12,2,0,11,14,61,1.2
8937,Anthony Dallier\anthony-dallier-1,2014-15,Yale,G,27,0,292,20,56,.357,14,32,.438,6,24,.250,15,21,.714,16,33,49,26,5,4,15,23,61,1.9
8938,D.J. Williams\dj-williams-1,2015-16,Illinois,G,29,3,319,24,60,.400,22,48,.458,2,12,.167,11,19,.579,16,25,41,10,7,4,22,27,61,1.0
8939,Shawn Olden\shawn-olden-1,2017-18,Texas Christian,G,29,0,340,19,54,.352,2,8,.250,17,46,.370,6,8,.750,3,19,22,21,12,1,13,35,61,1.3
8940,Greg Lee\greg-lee-1,2017-18,Cal State Bakersfield,G,28,1,246,25,61,.410,15,31,.484,10,30,.333,1,4,.250,12,38,50,10,5,0,19,32,61,1.0
8941,Alex Brown\alex-brown-2,2016-17,Norfolk State,G,26,1,248,24,70,.343,14,35,.400,10,35,.286,3,6,.500,5,24,29,10,1,2,21,19,61,0.5
8942,Shakaris Laney\sharkaris-laney-1,2017-18,Central Connecticut State,G,22,6,356,23,64,.359,15,35,.429,8,29,.276,7,11,.636,7,24,31,24,9,3,23,30,61,1.3
8943,Brandon Robinson\brandon-robinson-2,2017-18,North Carolina,G,35,0,302,21,56,.375,12,33,.364,9,23,.391,10,14,.714,20,28,48,22,6,5,16,45,61,1.2
8944,Zach Chionuma\zach-chionuma-1,2014-15,Bryant,G,14,0,126,23,60,.383,16,32,.500,7,28,.250,8,18,.444,4,10,14,0,5,0,4,11,61,1.9
8945,Chris Sullivan\chris-sullivan-1,2017-18,Brown,G,27,0,279,19,52,.365,7,14,.500,12,38,.316,11,11,1.000,12,17,29,5,11,1,6,31,61,1.6
8946,Dorian Pickens\dorian-pickens-1,2014-15,Stanford,G,31,1,267,17,48,.354,8,23,.348,9,25,.360,18,26,.692,18,13,31,17,6,1,14,20,61,1.4
8947,Marquill Smith\marquill-smith-1,2016-17,San Francisco,G,19,0,104,17,40,.425,3,8,.375,14,32,.438,13,16,.813,1,13,14,6,2,3,8,7,61,2.1
8948,Jiday Ugbaja\jidbay-ugbaja-1,2016-17,Sacramento State,G,24,0,170,19,49,.388,13,32,.406,6,17,.353,17,23,.739,5,21,26,10,4,0,9,30,61,1.3
8949,Ishmail Wainright\ish-wainright-1,2013-14,Baylor,G,32,7,291,21,48,.438,18,38,.474,3,10,.300,16,32,.500,20,27,47,34,9,1,25,46,61,1.3
8950,Seventh Woods\seventh-woods-1,2016-17,North Carolina,G,40,0,309,17,60,.283,15,49,.306,2,11,.182,25,41,.610,6,49,55,49,21,2,42,28,61,1.0
8951,James Reese\james-reese-1,2017-18,Buffalo,G,25,3,195,19,60,.317,11,19,.579,8,41,.195,15,16,.938,6,16,22,17,8,4,11,33,61,1.3
8952,C.J. Rivers\cj-rivers-1,2015-16,Drake,G,17,11,338,26,48,.542,22,39,.564,4,9,.444,5,11,.455,9,53,62,33,9,0,18,22,61,3.7
8953,Djimon Henson\djimon-henson-1,2016-17,Morehead State,G,22,0,174,22,72,.306,11,30,.367,11,42,.262,6,10,.600,6,9,15,11,6,4,4,7,61,1.6
8954,Jacoby Davis\jacoby-davis-1,2013-14,Mississippi State,G,28,0,316,20,74,.270,3,21,.143,17,53,.321,4,5,.800,8,26,34,19,9,0,17,30,61,0.8
8955,Pat McNamara\pat-mcnamara-1,2017-18,Fairleigh Dickinson,G,29,0,326,21,60,.350,6,13,.462,15,47,.319,4,8,.500,6,19,25,15,12,2,13,13,61,1.4
8956,Christian Turner\christian-turner-1,2017-18,Gardner-Webb,G,28,28,578,19,55,.345,13,32,.406,6,23,.261,17,32,.531,7,43,50,60,28,1,41,55,61,1.8
8957,Glen Burns\glen-burns-1,2016-17,Chicago State,G,12,8,266,15,44,.341,10,32,.313,5,12,.417,26,39,.667,4,22,26,38,13,1,23,17,61,4.2
8958,Dalvin Roberts\dalvin-roberts-1,2014-15,Florida A&M,G,19,2,288,13,51,.255,6,19,.316,7,32,.219,28,45,.622,3,14,17,16,5,3,17,35,61,0.9
8959,Julian Harrell\julian-harrell-1,2013-14,Pennsylvania,G,12,4,222,24,61,.393,18,43,.419,6,18,.333,7,18,.389,3,33,36,22,5,7,17,27,61,2.8
8960,Devin Wilson\devin-wilson-1,2013-14,North Florida,G,26,0,318,18,66,.273,10,26,.385,8,40,.200,16,27,.593,3,27,30,34,16,0,21,22,60,1.4
8961,Khalil Gracey\khalil-gracey-1,2017-18,Morgan State,G,22,0,174,22,57,.386,15,36,.417,7,21,.333,9,16,.563,8,15,23,13,7,1,13,17,60,1.5
8962,Brian Carey\brian-carey-1,2015-16,Texas Southern,G,23,2,317,14,55,.255,9,39,.231,5,16,.313,27,36,.750,2,22,24,37,8,0,23,22,60,1.5
8963,Matthew Johnson\matthew-johnson-2,2016-17,Southern Utah,G,20,0,175,19,42,.452,5,13,.385,14,29,.483,8,13,.615,4,16,20,3,3,1,6,28,60,1.6
8964,Kelton Ford\kelton-ford-1,2015-16,Troy,G,22,0,235,20,63,.317,16,38,.421,4,25,.160,16,28,.571,4,20,24,20,16,1,16,33,60,1.3
8965,Torrey Mayo\torrey-mayo-1,2017-18,Southern,G,30,6,472,19,58,.328,14,39,.359,5,19,.263,17,32,.531,6,31,37,45,15,2,35,60,60,0.8
8966,Michael Williams\michael-williams-6,2016-17,Texas Christian,G,28,0,229,19,55,.345,5,17,.294,14,38,.368,8,8,1.000,1,21,22,15,8,0,13,9,60,1.4
8967,Tyler Streeter\tyler-streeter-1,2016-17,Morgan State,G,14,4,132,26,53,.491,22,39,.564,4,14,.286,4,7,.571,10,10,20,3,0,1,3,12,60,2.7
8968,Patrick Strzala\patrick-strzala-1,2017-18,Manhattan,G,27,0,215,18,55,.327,1,11,.091,17,44,.386,7,7,1.000,3,12,15,9,7,0,12,25,60,1.0
8969,Jerron Martin\jerron-martin-1,2015-16,Texas Southern,G,21,3,204,22,52,.423,10,17,.588,12,35,.343,4,7,.571,3,16,19,21,4,0,16,12,60,1.7
8970,Cole Martinez\cole-martinez-1,2014-15,Texas A&M-Corpus Christi,G,28,0,177,17,51,.333,4,9,.444,13,42,.310,13,13,1.000,4,11,15,1,7,1,12,20,60,0.9
8971,D.J. Davis\dejon-dj-davis-1,2014-15,South Dakota,G,32,0,299,22,62,.355,18,47,.383,4,15,.267,12,22,.545,25,30,55,14,13,1,15,31,60,1.4
8972,Jimmy Marshall\jimmy-marshall-1,2015-16,Northeastern,G,22,4,212,20,50,.400,7,14,.500,13,36,.361,7,10,.700,5,34,39,13,8,1,10,18,60,2.1
8973,Lourawls Nairn\lourawls-tum-tum-nairn-1,2017-18,Michigan State,G,35,1,583,27,54,.500,22,38,.579,5,16,.313,1,5,.200,0,32,32,102,8,2,29,34,60,2.3
8974,Kolbe Caldwell\kolbe-caldwell-1,2017-18,Utah,G,27,4,306,22,65,.338,11,26,.423,11,39,.282,5,7,.714,5,20,25,15,5,1,23,28,60,0.5
8975,Hunter Ware\hunter-ware-1,2016-17,Bryant,G,31,2,348,22,69,.319,17,39,.436,5,30,.167,11,12,.917,6,44,50,25,14,1,20,49,60,1.0
8976,Marcus Washington\marcus-washington-1,2015-16,Louisiana-Monroe,G,20,0,199,19,50,.380,14,30,.467,5,20,.250,17,26,.654,4,21,25,14,6,2,10,32,60,1.6
8977,Jacob Ivory\jacob-ivory-1,2015-16,Middle Tennessee,G,16,11,257,14,41,.341,13,34,.382,1,7,.143,31,34,.912,2,23,25,28,11,1,16,27,60,3.0
8978,Clint Nwosuh\clint-nwosuh-1,2015-16,Idaho State,G,14,5,213,19,57,.333,5,16,.313,14,41,.341,8,8,1.000,3,11,14,14,6,0,11,13,60,2.3
8979,Jaylon Tate\jaylon-tate-1,2013-14,Illinois,G,33,0,402,20,76,.263,19,53,.358,1,23,.043,19,29,.655,4,26,30,64,14,3,30,31,60,1.2
8980,Justin Jenkins\justin-jenkins-1,2017-18,Gardner-Webb,G,19,0,154,20,48,.417,13,21,.619,7,27,.259,13,17,.765,3,10,13,7,4,3,7,10,60,2.0
8981,Joey Getz\joey-getz-1,2013-14,Maryland-Baltimore County,G,17,6,332,22,82,.268,19,62,.306,3,20,.150,13,23,.565,8,25,33,30,17,1,22,14,60,1.9
8982,Kendall Small\kendall-small-1,2015-16,Oregon,G,36,0,281,18,45,.400,17,37,.459,1,8,.125,23,37,.622,1,25,26,23,19,1,16,38,60,1.2
8983,Jake Toolson\jake-toolson-1,2014-15,Brigham Young,G,26,0,202,21,50,.420,5,10,.500,16,40,.400,2,2,1.000,3,34,37,12,7,0,6,18,60,1.8
8984,Nych Smith\nych-smith-1,2015-16,Fordham,G,19,0,194,21,49,.429,13,23,.565,8,26,.308,9,12,.750,0,13,13,18,8,2,8,12,59,2.4
8985,Nahjee Matlock\nahjee-matlock-1,2015-16,Montana State,G,30,0,311,19,73,.260,11,45,.244,8,28,.286,13,20,.650,15,29,44,30,4,2,33,31,59,0.4
8986,Gunnar Olafsson\gunnar-olafsson-1,2017-18,St. Francis (NY),G,18,2,190,28,48,.583,27,43,.628,1,5,.200,2,4,.500,17,22,39,6,3,0,8,20,59,2.5
8987,Jabbar Singleton\jabbar-singleton-1,2014-15,Oral Roberts,G,33,4,408,16,51,.314,7,21,.333,9,30,.300,18,29,.621,3,21,24,32,6,1,26,23,59,0.8
8988,Zach McCormick\zach-mccormick-1,2015-16,Miami (OH),G,16,4,259,22,67,.328,15,37,.405,7,30,.233,8,13,.615,6,15,21,11,4,1,6,24,59,1.5
8989,David Levitch\david-levitch-1,2016-17,Louisville,G,32,3,296,20,54,.370,7,20,.350,13,34,.382,6,13,.462,11,27,38,29,10,0,7,32,59,1.6
8990,Brandone Francis\brandone-francis-1,2015-16,Florida,G,29,2,313,21,104,.202,11,45,.244,10,59,.169,7,13,.538,7,22,29,15,10,0,10,25,59,0.1
8991,Markese McGuire\markese-mcguire-1,2015-16,Illinois-Chicago,G,27,0,234,17,60,.283,12,41,.293,5,19,.263,20,30,.667,10,20,30,15,7,6,17,18,59,1.1
8992,Demarius Smith\demarius-smith-1,2014-15,Austin Peay,G,16,10,322,21,68,.309,20,54,.370,1,14,.071,16,33,.485,7,23,30,41,14,3,51,37,59,0.2
8993,Patrick Cole\patrick-cole-1,2014-15,Siena,G,7,1,122,21,50,.420,19,39,.487,2,11,.182,15,19,.789,3,16,19,13,4,0,13,20,59,4.3
8994,Caleb Tanner\caleb-tanner-1,2015-16,Radford,G,20,0,126,20,59,.339,2,10,.200,18,49,.367,1,2,.500,0,4,4,5,1,1,4,4,59,1.3
8995,Donovan Theme-Love\donovan-theme-love-1,2016-17,Wofford,G,22,0,219,21,43,.488,13,18,.722,8,25,.320,9,11,.818,0,31,31,31,8,1,19,22,59,2.2
8996,Tyron Bain\tyron-bain-1,2013-14,Grambling,G,26,2,225,17,52,.327,16,41,.390,1,11,.091,24,34,.706,11,17,28,13,10,0,25,24,59,0.9
8997,Nathan Dodge\nathan-dodge-1,2014-15,Army,G,21,0,165,20,46,.435,4,4,1.000,16,42,.381,3,5,.600,2,15,17,7,10,0,10,12,59,1.9
8998,Chris Williams\chris-williams-14,2016-17,Central Connecticut State,G,22,1,205,22,56,.393,15,28,.536,7,28,.250,8,10,.800,6,7,13,3,5,1,9,16,59,1.2
8999,John Ogwuche\john-ogwuche-1,2016-17,New Hampshire,G,19,4,207,18,54,.333,11,26,.423,7,28,.250,16,22,.727,8,22,30,6,10,3,9,16,59,2.1
9000,Zavier Simpson\zavier-simpson-1,2016-17,Michigan,G,38,0,332,16,43,.372,11,24,.458,5,19,.263,22,31,.710,4,20,24,37,21,2,19,47,59,1.3
9001,Maurice Smith\maurice-smith-1,2017-18,Western Carolina,G,29,0,276,21,60,.350,16,47,.340,5,13,.385,12,26,.462,30,51,81,16,13,5,29,32,59,1.4
9002,Joshua Batson\joshua-batson-1,2014-15,Chicago State,G,29,14,320,20,77,.260,14,51,.275,6,26,.231,13,25,.520,11,17,28,26,23,1,28,43,59,0.6
9003,Nate Garvey\nate-garvey-1,2017-18,Howard,G,30,0,190,19,66,.288,6,18,.333,13,48,.271,8,13,.615,2,11,13,12,6,3,8,14,59,0.9
9004,Miles Simelton\miles-simelton-1,2013-14,Lehigh,G,32,0,280,25,69,.362,21,52,.404,4,17,.235,5,8,.625,5,14,19,21,8,2,20,23,59,0.7
9005,Jonathan Milligan\jonathan-milligan-1,2016-17,Pittsburgh,G,27,1,227,18,63,.286,2,13,.154,16,50,.320,7,8,.875,2,6,8,15,1,1,13,20,59,0.6
9006,Marcellous Bell\marcellous-bell-1,2013-14,Jacksonville,G,12,3,95,18,44,.409,6,12,.500,12,32,.375,11,14,.786,4,7,11,3,1,0,3,3,59,3.2
9007,Ty Taylor II\ty-taylorii-1,2015-16,Wichita State,G,20,0,153,21,72,.292,11,40,.275,10,32,.313,7,8,.875,5,12,17,11,7,0,10,17,59,1.1
9008,Garet Beal\garet-beal-1,2015-16,Maine,G,11,7,220,18,49,.367,7,9,.778,11,40,.275,12,15,.800,2,17,19,13,3,1,21,29,59,1.6
9009,Nick Hamilton\nick-hamilton-1,2017-18,University of California,G,31,7,443,19,55,.345,15,41,.366,4,14,.286,17,25,.680,23,35,58,22,15,1,31,55,59,1.0
9010,Xavier Adams\xavier-adams-1,2016-17,New Mexico,G,15,0,186,15,34,.441,15,29,.517,0,5,.000,29,36,.806,10,24,34,3,12,1,11,22,59,3.2
9011,Milton Washington\milton-washington-1,2014-15,Army,G,17,3,199,24,50,.480,22,45,.489,2,5,.400,9,14,.643,8,12,20,22,7,2,17,21,59,2.3
9012,Eric Jamison\eric-jamison-1,2016-17,Gardner-Webb,G,21,0,152,23,50,.460,14,23,.609,9,27,.333,4,9,.444,7,21,28,7,4,2,9,11,59,1.9
9013,Jamie Batish\jamie-batish-1,2015-16,Western Illinois,G,22,0,247,20,56,.357,1,5,.200,19,51,.373,0,2,.000,0,13,13,5,5,1,1,15,59,1.5
9014,Julian Clarke\julian-clarke-1,2013-14,Santa Clara,G,18,1,148,18,42,.429,7,18,.389,11,24,.458,11,16,.688,2,7,9,7,1,2,2,16,58,2.0
9015,Sir Washington\sir-washington-1,2014-15,Eastern Washington,G,22,1,218,17,42,.405,13,28,.464,4,14,.286,20,24,.833,3,27,30,9,11,1,9,39,58,1.7
9016,R.J. Curington\rj-curington-1,2015-16,DePaul,G,23,0,191,20,53,.377,9,17,.529,11,36,.306,7,9,.778,18,7,25,5,3,3,15,23,58,1.2
9017,Rashad Andrews\rashad-andrews-1,2016-17,Southern,G,28,13,287,21,57,.368,15,38,.395,6,19,.316,10,12,.833,13,34,47,9,7,3,14,35,58,1.2
9018,Luiz Bidart\luiz-bidart-1,2013-14,Seattle,G,29,0,322,17,58,.293,3,8,.375,14,50,.280,10,14,.714,9,33,42,17,10,0,12,47,58,1.0
9019,Miles Seward\miles-seward-1,2015-16,Northern Colorado,G,18,1,136,18,40,.450,9,17,.529,9,23,.391,13,14,.929,4,11,15,5,3,0,12,12,58,1.8
9020,Ibi Watson\ibi-watson-1,2017-18,Michigan,G,26,0,136,21,54,.389,11,23,.478,10,31,.323,6,11,.545,11,10,21,8,7,1,4,6,58,1.7
9021,Kevin Seymour\kevin-seymour-1,2016-17,Central Connecticut State,G,23,1,243,25,70,.357,22,57,.386,3,13,.231,5,8,.625,3,20,23,22,7,0,14,7,58,1.4
9022,B.J. Maxwell\bj-maxwell-1,2016-17,Abilene Christian,G,17,0,179,23,46,.500,12,24,.500,11,22,.500,1,1,1.000,13,19,32,10,5,3,12,30,58,2.3
9023,Kevin Kaspar\kevin-kaspar-1,2013-14,Western Kentucky,G,16,0,240,19,52,.365,6,14,.429,13,38,.342,7,10,.700,3,24,27,22,4,0,10,17,58,2.5
9024,JoJo McGlaston\jojo-mcglaston-1,2017-18,Bradley,G,9,0,185,19,53,.358,15,31,.484,4,22,.182,16,25,.640,10,25,35,10,11,3,17,11,58,4.2
9025,K.C. Goodwin\kc-goodwin-1,2014-15,Southern Illinois,G,23,6,418,16,63,.254,4,26,.154,12,37,.324,14,21,.667,5,33,38,21,14,0,33,46,58,0.4
9026,Ayodeji Egbeyemi\ayodeji-egbeyemi-1,2013-14,Loyola Marymount,G,8,8,195,23,51,.451,21,42,.500,2,9,.222,10,14,.714,14,18,32,11,4,2,13,17,58,4.8
9027,Larry Austin\larry-austin-1,2017-18,Vanderbilt,G,23,3,254,22,53,.415,21,49,.429,1,4,.250,13,23,.565,10,23,33,24,4,1,15,27,58,1.5
9028,Tyler Clement\tyler-clement-1,2017-18,Creighton,G,21,0,174,20,44,.455,7,10,.700,13,34,.382,5,5,1.000,4,16,20,20,2,2,7,25,58,2.1
9029,Luke Neff\luke-neff-1,2017-18,Denver,G,23,0,166,20,42,.476,5,5,1.000,15,37,.405,3,4,.750,1,15,16,10,0,0,7,7,58,1.7
9030,Parker Van Dyke\parker-vandyke-1,2013-14,Utah,G,23,0,226,21,47,.447,12,20,.600,9,27,.333,7,7,1.000,3,13,16,23,4,2,10,11,58,2.0
9031,Tre'Shaun Fletcher\treshaun-fletcher-1,2013-14,Colorado,G,20,0,193,20,50,.400,15,23,.652,5,27,.185,13,19,.684,12,19,31,5,4,4,9,28,58,1.6
9032,Ethan Alvano\ethan-alvano-1,2015-16,Eastern Michigan,G,21,0,179,16,56,.286,15,38,.395,1,18,.056,25,34,.735,3,13,16,17,16,0,11,21,58,1.7
9033,Drew Parker\drew-parker-1,2013-14,North Carolina-Greensboro,G,32,26,582,18,57,.316,7,17,.412,11,40,.275,11,14,.786,4,51,55,71,13,0,29,33,58,2.0
9034,Mike Nwabuzor\mike-nwabuzor-1,2016-17,Texas-Rio Grande Valley,G,30,1,271,18,62,.290,13,42,.310,5,20,.250,17,24,.708,6,34,40,19,12,2,22,31,58,0.9
9035,Austin Cox\austin-cox-1,2015-16,Arkansas-Pine Bluff,G,28,1,275,22,46,.478,14,26,.538,8,20,.400,6,11,.545,12,38,50,9,15,2,18,22,58,1.7
9036,Phil Bledsoe\phil-bledsoe-1,2017-18,Marshall,G,19,0,139,24,53,.453,19,34,.559,5,19,.263,5,6,.833,13,19,32,2,1,1,6,23,58,1.7
9037,Tim Hasbargen\tim-hasbargen-1,2015-16,Cleveland State,G,22,0,205,19,44,.432,10,21,.476,9,23,.391,11,16,.688,9,19,28,6,8,1,13,16,58,1.7
9038,Jonathan Allen\jonathan-allen-1,2016-17,Pepperdine,G,30,9,400,21,50,.420,11,23,.478,10,27,.370,6,13,.462,12,44,56,15,13,3,20,57,58,1.1
9039,Joey Frenchwood\joseph-frenchwood-1,2014-15,Montana State,G,24,9,284,21,63,.333,8,25,.320,13,38,.342,3,5,.600,1,21,22,21,9,2,30,41,58,0.3
9040,Stephon Sharp\stephon-sharp-1,2015-16,Minnesota,G,15,4,186,19,50,.380,14,33,.424,5,17,.294,15,20,.750,8,6,14,10,1,3,16,15,58,1.6
9041,A'Torey Everett\atorey-everett-1,2016-17,Tennessee State,G,24,1,233,17,44,.386,13,37,.351,4,7,.571,20,25,.800,3,18,21,17,2,1,19,33,58,0.9
9042,Matthew Grant\matthew-grant-1,2015-16,Detroit Mercy,G,26,3,331,17,63,.270,9,29,.310,8,34,.235,16,19,.842,3,31,34,23,9,4,12,32,58,1.3
9043,Carlton Hurst\carlton-hurst-1,2014-15,Colorado State,G,31,1,283,24,47,.511,23,43,.535,1,4,.250,8,16,.500,14,31,45,7,6,5,9,31,57,1.4
9044,Tristan Jarrett\tristan-jarrett-1,2017-18,Kennesaw State,G,12,0,149,21,69,.304,14,39,.359,7,30,.233,8,13,.615,8,19,27,8,4,3,22,10,57,1.0
9045,Deris Duncan\deris-duncan-1,2017-18,Texas State,G,29,0,202,18,45,.400,11,24,.458,7,21,.333,14,17,.824,11,22,33,8,3,1,13,12,57,1.3
9046,Jared Printy\jared-printy-1,2017-18,Western Michigan,G,29,0,229,17,40,.425,4,6,.667,13,34,.382,10,11,.909,1,14,15,9,1,0,5,18,57,1.2
9047,DeVantae Price\devantae-price-1,2017-18,Eastern Illinois,G,20,1,187,17,41,.415,16,38,.421,1,3,.333,22,32,.688,18,23,41,8,7,0,14,18,57,2.1
9048,Rohan Brown\rohan-brown-1,2013-14,La Salle,G,29,0,275,20,50,.400,19,38,.500,1,12,.083,16,24,.667,29,39,68,4,7,5,11,21,57,1.8
9049,Walter Davis\walter-davis-3,2013-14,Florida A&M,G,32,7,482,24,42,.571,24,42,.571,0,0,,9,21,.429,32,65,97,21,9,23,19,49,57,2.4
9050,Luka Vulikic\luka-vulikic-1,2017-18,Eastern Washington,G,9,8,206,25,55,.455,25,50,.500,0,5,.000,7,15,.467,7,22,29,20,6,2,14,16,57,4.2
9051,Josh Davis\josh-davis-7,2016-17,Western Michigan,G,28,3,273,20,69,.290,14,33,.424,6,36,.167,11,23,.478,5,27,32,17,14,4,15,28,57,0.9
9052,Jonathan Sanks\jonathan-sanks-1,2015-16,Georgia Southern,G,19,0,128,18,42,.429,12,20,.600,6,22,.273,15,23,.652,2,8,10,5,3,1,7,22,57,1.4
9053,Derek Reese\derek-reese-1,2013-14,Tennessee,G,24,0,261,19,57,.333,9,21,.429,10,36,.278,9,13,.692,19,53,72,7,5,11,11,38,57,1.8
9054,Stefan Borovac\stefan-borovac-1,2016-17,Massachusetts-Lowell,G,25,10,247,18,52,.346,15,38,.395,3,14,.214,18,31,.581,14,39,53,16,4,3,26,40,57,0.8
9055,Jerami Grace\jerami-grace-1,2016-17,Murray State,G,26,1,219,18,66,.273,6,19,.316,12,47,.255,9,13,.692,8,21,29,9,8,1,11,33,57,0.7
9056,Ky're Allison\kyre-allison-1,2016-17,Marshall,G,23,0,194,21,56,.375,11,25,.440,10,31,.323,5,7,.714,3,14,17,17,6,1,21,44,57,0.5
9057,Carrington Ward\carrington-ward-1,2016-17,Norfolk State,G,15,3,246,19,55,.345,15,37,.405,4,18,.222,15,19,.789,2,27,29,17,6,5,19,24,57,1.8
9058,Devonte Banner\devonte-banner-1,2014-15,Norfolk State,G,24,1,221,18,50,.360,7,22,.318,11,28,.393,10,18,.556,4,14,18,16,7,2,13,25,57,1.2
9059,Ricky Johnson\ricky-johnson-1,2013-14,Bethune-Cookman,G,6,4,129,17,47,.362,12,32,.375,5,15,.333,18,25,.720,2,12,14,15,6,0,17,12,57,4.6
9060,Kai Healy\kai-healy-1,2014-15,Santa Clara,G,22,1,230,20,38,.526,12,20,.600,8,18,.444,9,11,.818,6,14,20,4,7,1,12,22,57,1.6
9061,K'ja Johnson\kja-johnson-1,2016-17,Florida A&M,G,10,7,252,23,44,.523,15,27,.556,8,17,.471,3,6,.500,3,28,31,30,17,3,20,27,57,5.4
9062,DeOndre Haynes\deondre-haynes-1,2014-15,Tennessee Tech,G,27,3,289,20,63,.317,19,52,.365,1,11,.091,16,25,.640,5,28,33,32,9,1,26,14,57,1.1
9063,Dwight Smith\dwight-smith-1,2013-14,Colorado State,G,18,1,242,21,48,.438,17,31,.548,4,17,.235,11,18,.611,19,23,42,12,5,4,9,50,57,2.0
9064,Naiel Smith\naiel-smith-1,2013-14,Texas State,G,31,3,442,22,62,.355,14,35,.400,8,27,.296,5,10,.500,1,44,45,39,26,2,31,62,57,1.1
9065,Jonathan Guevara\jonathan-guevara-1,2017-18,Cal State Northridge,G,25,1,391,19,61,.311,13,41,.317,6,20,.300,13,25,.520,1,27,28,28,7,1,21,34,57,0.7
9066,Anthony Mathis\anthony-mathis-1,2015-16,New Mexico,G,25,0,165,17,44,.386,5,10,.500,12,34,.353,11,12,.917,2,11,13,9,7,0,12,25,57,1.1
9067,Mark Cornelius\mark-cornelius-1,2014-15,Massachusetts-Lowell,G,25,13,313,21,67,.313,15,42,.357,6,25,.240,9,14,.643,11,25,36,21,10,0,21,29,57,1.0
9068,Austin Ajukwa\austin-ajukwa-1,2013-14,Clemson,G,25,0,190,18,45,.400,9,24,.375,9,21,.429,12,20,.600,6,19,25,6,9,3,9,25,57,1.4
9069,Jared Samuelson\jared-samuelson-12,2016-17,North Dakota State,G,28,0,187,18,51,.353,2,8,.250,16,43,.372,4,4,1.000,1,12,13,15,2,0,5,12,56,1.2
9070,Adam Thoseby\adam-thoseby-1,2014-15,South Dakota,G,25,0,143,19,58,.328,13,32,.406,6,26,.231,12,17,.706,3,18,21,5,2,0,6,14,56,0.9
9071,Emmanuel Chibuogwu\emmanuel-chibuogwu-1,2013-14,Seattle,G,18,0,288,20,58,.345,13,33,.394,7,25,.280,9,20,.450,24,26,50,11,9,0,19,33,56,1.6
9072,Zaquavian Smith\zaquavian-smith-1,2017-18,Nicholls State,G,6,4,133,18,52,.346,6,16,.375,12,36,.333,8,11,.727,4,18,22,3,5,0,5,16,56,4.9
9073,L.J. McIntosh\lj-mcintosh-1,2013-14,Texas-Rio Grande Valley,G,25,1,246,19,73,.260,8,21,.381,11,52,.212,7,11,.636,1,15,16,16,12,2,12,24,56,0.8
9074,Zach En'Wezoh\zach-enwezoh-1,2013-14,Columbia,G,28,0,204,26,50,.520,26,50,.520,0,0,,4,13,.308,11,27,38,10,6,6,24,44,56,0.7
9075,Sam Dowd\sam-dowd-1,2017-18,Idaho State,G,29,8,271,16,41,.390,11,24,.458,5,17,.294,19,29,.655,5,13,18,25,5,0,24,17,56,1.0
9076,Denzel Keyes\denzel-keyes-1,2013-14,North Carolina A&T,G,25,7,267,21,53,.396,18,41,.439,3,12,.250,11,24,.458,15,28,43,3,7,3,14,37,56,0.9
9077,Tyson Cunningham\tyson-cunningham-1,2013-14,Mississippi State,G,32,0,240,18,44,.409,10,19,.526,8,25,.320,12,15,.800,3,14,17,13,9,0,18,24,56,0.9
9078,Emmanuel Akot\emmanuel-akot-1,2017-18,Arizona,G,31,4,321,21,54,.389,12,30,.400,9,24,.375,5,11,.455,11,23,34,26,6,3,19,26,56,1.2
9079,Jamal Dantzler\jamal-dantzler-1,2013-14,Texas-Rio Grande Valley,G,26,3,220,20,39,.513,19,34,.559,1,5,.200,15,33,.455,13,24,37,13,6,3,21,28,56,1.2
9080,Cortez Edwards\cortez-edwards-1,2015-16,Southern Mississippi,G,29,1,417,20,68,.294,15,42,.357,5,26,.192,11,12,.917,8,46,54,44,16,3,27,24,56,1.6
9081,Peyton Woods\peyton-woods-1,2015-16,Chattanooga,G,19,0,129,17,34,.500,3,4,.750,14,30,.467,8,9,.889,7,9,16,4,5,0,4,18,56,2.3
9082,Christian Kessee\christian-kessee-1,2016-17,Memphis,G,29,0,218,18,57,.316,8,15,.533,10,42,.238,10,12,.833,2,17,19,22,3,0,10,26,56,0.9
9083,Christian Turner\christian-turner-1,2016-17,Gardner-Webb,G,31,1,368,21,47,.447,19,40,.475,2,7,.286,12,15,.800,0,32,32,62,22,0,24,41,56,2.1
9084,Oliver Wells\oliver-wells-1,2013-14,Central Arkansas,G,10,6,179,22,50,.440,13,31,.419,9,19,.474,3,3,1.000,3,19,22,10,7,0,11,18,56,3.3
9085,Tre O'Neal\tre-oneal-1,2016-17,Nicholls State,G,18,11,270,19,59,.322,15,39,.385,4,20,.200,14,22,.636,6,16,22,23,6,0,20,22,56,1.2
9086,Elijah Clarance\elijah-clarance-1,2017-18,Illinois State,G,21,0,233,16,66,.242,14,43,.326,2,23,.087,22,31,.710,3,19,22,27,10,1,32,29,56,0.3
9087,Paul McCoy\paul-mccoy-1,2013-14,Saint Mary's (CA),G,30,2,265,18,39,.462,17,32,.531,1,7,.143,19,27,.704,6,26,32,17,10,0,21,31,56,1.1
9088,Justin Simon\justin-simon-2,2015-16,Arizona,G,24,0,180,23,46,.500,22,43,.512,1,3,.333,9,21,.429,7,22,29,8,7,6,14,22,56,1.4
9089,Matt Jones\matt-jones-3,2013-14,Duke,G,32,4,235,15,51,.294,12,30,.400,3,21,.143,23,41,.561,11,16,27,5,11,1,4,24,56,1.0
9090,Taylor Johnson\taylor-johnson-2,2014-15,Dartmouth,G,23,3,195,15,38,.395,8,17,.471,7,21,.333,19,24,.792,6,13,19,8,5,0,16,22,56,1.2
9091,Chier Maker\chier-maker-1,2016-17,Portland,G,19,2,279,16,56,.286,11,40,.275,5,16,.313,19,25,.760,17,33,50,6,4,1,12,27,56,1.5
9092,Jontray Harris\jontray-harris-1,2016-17,Oral Roberts,G,18,1,171,19,41,.463,9,12,.750,10,29,.345,8,17,.471,4,23,27,8,2,1,8,11,56,2.1
9093,Eli Brooks\eli-brooks-1,2017-18,Michigan,G,31,12,311,19,63,.302,9,22,.409,10,41,.244,8,13,.615,9,24,33,30,12,3,13,16,56,1.5
9094,Houston Smith\houston-smith-1,2016-17,Bethune-Cookman,G,27,2,383,23,46,.500,23,44,.523,0,2,.000,10,20,.500,26,32,58,12,10,9,22,48,56,1.5
9095,Nick Griffin\nick-griffin-1,2013-14,George Washington,G,31,1,149,21,43,.488,7,14,.500,14,29,.483,0,2,.000,4,10,14,3,2,0,7,17,56,1.0
9096,Parker Chitty\parker-chitty-1,2016-17,Eastern Kentucky,G,30,4,348,17,63,.270,9,16,.563,8,47,.170,14,22,.636,2,38,40,35,10,2,27,54,56,0.5
9097,Nehemiah Mack\nehemiah-mack-1,2017-18,Manhattan,G,30,4,442,19,47,.404,9,17,.529,10,30,.333,8,13,.615,9,17,26,38,22,0,21,66,56,1.4
9098,Mairega Clarke\mairega-clarke-1,2015-16,Texas-Arlington,G,18,0,128,20,37,.541,15,27,.556,5,10,.500,11,16,.688,3,8,11,8,8,10,14,14,56,2.3
9099,Garrett Gilkeson\garrett-gilkeson-1,2016-17,Virginia Military Institute,G,29,0,356,19,83,.229,8,30,.267,11,53,.208,7,10,.700,20,33,53,25,6,4,26,34,56,0.5
9100,Malik Gray\malik-gray-1,2014-15,Norfolk State,G,20,0,172,18,47,.383,4,12,.333,14,35,.400,6,16,.375,3,20,23,4,5,3,11,32,56,1.0
9101,Jake Straughan\jake-straughan-1,2015-16,Idaho,G,16,0,100,17,34,.500,1,1,1.000,16,33,.485,5,7,.714,0,5,5,6,1,0,3,10,55,2.3
9102,Jalen James\jalen-james-1,2014-15,San Jose State,G,8,8,201,20,47,.426,15,29,.517,5,18,.278,10,14,.714,5,26,31,17,4,1,20,11,55,4.0
9103,K.J. Malveau\kj-malveau-1,2015-16,Texas State,G,31,0,250,16,52,.308,5,18,.278,11,34,.324,12,15,.800,1,21,22,17,8,0,23,18,55,0.7
9104,Jaylon Tate\jaylon-tate-1,2015-16,Illinois,G,30,15,524,18,49,.367,16,38,.421,2,11,.182,17,27,.630,1,38,39,75,12,3,24,39,55,2.1
9105,Janeil Jenkins\janeil-jenkins-1,2014-15,Presbyterian,G,27,8,297,19,35,.543,14,23,.609,5,12,.417,12,22,.545,0,19,19,30,10,0,26,24,55,1.3
9106,Jack Shaughnessy\jack-shaughnessy-1,2016-17,Seattle,G,27,1,295,14,34,.412,10,16,.625,4,18,.222,23,30,.767,3,29,32,30,11,0,23,27,55,1.6
9107,JoJo McGlaston\jojo-mcglaston-1,2013-14,Utah State,G,24,0,198,21,61,.344,12,40,.300,9,21,.429,4,10,.400,0,12,12,13,2,5,11,19,55,0.7
9108,Landon Drew\landon-drew-1,2015-16,Cal State Northridge,G,15,6,309,22,54,.407,11,26,.423,11,28,.393,0,1,.000,5,14,19,26,8,2,25,27,55,1.7
9109,Nick Malonga\nick-malonga-1,2016-17,North Florida,G,24,9,274,16,62,.258,7,19,.368,9,43,.209,14,17,.824,9,29,38,16,6,1,19,38,55,0.6
9110,Marcus Allen\marcus-allen-2,2013-14,Stanford,G,33,0,286,23,63,.365,20,46,.435,3,17,.176,6,16,.375,18,18,36,17,12,2,10,24,55,1.2
9111,Wally Ellenson\wally-ellenson-1,2015-16,Marquette,G,29,1,254,20,51,.392,15,31,.484,5,20,.250,10,18,.556,19,46,65,10,10,4,8,39,55,1.6
9112,Destin Barnes\destin-barnes-1,2016-17,Boston University,G,10,2,150,19,44,.432,9,19,.474,10,25,.400,7,10,.700,7,13,20,10,8,3,9,20,55,4.0
9113,Brandon Ford\brandon-ford-2,2014-15,Howard,G,18,1,195,21,44,.477,17,29,.586,4,15,.267,9,11,.818,2,7,9,6,9,0,11,10,55,1.9
9114,Kendall Jackson\kendall-jackson-1,2014-15,Columbia,G,22,0,203,17,35,.486,7,10,.700,10,25,.400,11,13,.846,2,12,14,10,8,0,11,22,55,1.7
9115,Zach Fong\zach-fong-1,2016-17,Navy,G,21,1,165,19,60,.317,5,9,.556,14,51,.275,3,6,.500,2,15,17,12,3,1,8,16,55,1.1
9116,Johnny Griffin\johnny-griffin-1,2013-14,Chicago State,G,31,2,342,20,44,.455,20,43,.465,0,1,.000,15,26,.577,22,21,43,11,13,10,5,57,55,1.6
9117,Stan Scott\stan-scott-1,2017-18,Oakland,G,23,9,230,20,43,.465,20,43,.465,0,0,,15,21,.714,11,29,40,24,10,5,27,26,55,1.7
9118,D'Marnier Cunningham\dmarnier-cunningham-1,2014-15,Memphis,G,20,0,217,22,59,.373,19,49,.388,3,10,.300,8,11,.727,3,12,15,33,15,4,22,22,55,1.9
9119,Gabe Hadley\gabe-hadley-1,2017-18,New Mexico State,G,22,0,138,19,49,.388,3,8,.375,16,41,.390,1,2,.500,1,10,11,4,2,1,4,2,55,1.5
9120,Delundre Dixon\delundre-dixon-1,2015-16,Chicago State,G,25,4,299,13,36,.361,11,26,.423,2,10,.200,27,37,.730,13,20,33,17,11,5,18,30,55,1.7
9121,Austin Pauga\austin-pauga-1,2015-16,Northern Illinois,G,20,0,179,20,40,.500,6,9,.667,14,31,.452,1,2,.500,4,7,11,7,10,2,7,10,55,2.2
9122,Anthony Collins\anthony-collins-1,2013-14,South Florida,G,8,7,251,11,38,.289,4,20,.200,7,18,.389,26,34,.765,3,10,13,47,12,2,28,21,55,5.6
9123,Ty Hudson\ty-hudson-1,2015-16,Clemson,G,23,0,174,19,54,.352,7,19,.368,12,35,.343,5,11,.455,0,9,9,11,5,0,4,19,55,1.1
9124,Eric James\eric-james-2,2017-18,Duquesne,G,30,2,207,19,54,.352,10,19,.526,9,35,.257,8,15,.533,14,26,40,6,8,3,11,17,55,1.2
9125,Ryan Hill\ryan-hill-1,2013-14,Bucknell,G,25,4,350,15,46,.326,13,42,.310,2,4,.500,23,30,.767,6,35,41,40,11,0,29,35,55,1.5
9126,Jalyn Pennie\jalyn-penne-1,2014-15,New Mexico State,G,25,1,227,25,50,.500,25,47,.532,0,3,.000,5,19,.263,27,41,68,3,2,13,19,25,55,1.6
9127,Mairega Clarke\mairega-clarke-1,2017-18,Texas-Arlington,G,28,1,333,16,47,.340,9,27,.333,7,20,.350,15,22,.682,5,27,32,11,10,9,22,36,54,0.9
9128,Jonathan Dalton\jonathan-dalton-1,2016-17,Southeast Missouri State,G,31,1,388,20,61,.328,15,40,.375,5,21,.238,9,14,.643,6,19,25,41,11,0,32,34,54,0.7
9129,Johnnie Shuler\johnnie-shuler-1,2017-18,La Salle,G,28,2,330,16,59,.271,6,19,.316,10,40,.250,12,17,.706,5,28,33,36,9,0,19,23,54,1.3
9130,Devin Coleman\devin-coleman-1,2013-14,Clemson,G,10,1,110,19,41,.463,10,20,.500,9,21,.429,7,8,.875,0,12,12,2,3,1,5,4,54,3.5
9131,Chase Harler\chase-harler-1,2017-18,West Virginia,G,33,2,339,18,59,.305,6,20,.300,12,39,.308,6,7,.857,7,15,22,25,13,3,8,33,54,1.2
9132,Anthony Dallier\anthony-dallier-1,2013-14,Yale,G,26,1,302,17,61,.279,11,31,.355,6,30,.200,14,23,.609,6,32,38,18,4,1,6,25,54,1.1
9133,Craig Brown\craig-brown-1,2014-15,Kent State,G,33,7,361,17,75,.227,12,50,.240,5,25,.200,15,23,.652,28,31,59,8,4,2,19,50,54,0.2
9134,George Papas\george-papas-1,2017-18,Monmouth,G,19,1,177,16,43,.372,3,9,.333,13,34,.382,9,11,.818,1,15,16,10,7,0,12,11,54,1.7
9135,Alterique Gilbert\alterique-gilbert-1,2017-18,Connecticut,G,6,6,167,19,60,.317,14,38,.368,5,22,.227,11,20,.550,1,23,24,17,7,2,9,8,54,5.3
9136,Travon Landry\travon-landry-1,2014-15,New Mexico State,G,27,2,322,16,46,.348,15,40,.375,1,6,.167,21,29,.724,1,34,35,25,7,1,17,25,54,1.3
9137,John Swinton\john-swinton-1,2013-14,Wofford,G,31,5,353,17,38,.447,11,21,.524,6,17,.353,14,19,.737,8,27,35,31,12,3,11,35,54,1.8
9138,Tyvoris Soloman\tyvoris-soloman-1,2014-15,South Carolina State,G,29,7,538,16,52,.308,10,34,.294,6,18,.333,16,27,.593,18,47,65,80,25,1,37,52,54,2.4
9139,Tyler Madison\tyler-madison-1,2015-16,Alabama-Birmingham,G,32,1,225,20,54,.370,19,50,.380,1,4,.250,13,19,.684,18,15,33,14,5,3,16,33,54,0.8
9140,Michael Grant\michael-grant-2,2014-15,Abilene Christian,G,25,0,216,15,44,.341,15,43,.349,0,1,.000,24,37,.649,13,21,34,4,17,1,15,34,54,1.3
9141,Jerrelle DeBerry\jerrelle-deberry-1,2016-17,Kent State,G,11,0,109,16,37,.432,4,9,.444,12,28,.429,10,11,.909,4,8,12,1,3,0,6,7,54,3.1
9142,Todd Johnson\todd-johnson-1,2015-16,Northern Kentucky,G,20,1,254,18,47,.383,6,11,.545,12,36,.333,6,10,.600,4,17,21,29,11,1,13,27,54,2.1
9143,Dimitri Floras\dimitri-floras-1,2014-15,Quinnipiac,G,26,0,297,17,72,.236,7,31,.226,10,41,.244,10,15,.667,17,26,43,28,8,0,15,33,54,1.1
9144,Jalyn Pennie\jalyn-penne-1,2016-17,New Mexico State,G,27,9,241,23,53,.434,19,33,.576,4,20,.200,4,13,.308,24,26,50,6,2,6,16,21,54,1.2
9145,Deion Lavender\deion-lavender-1,2017-18,Alabama-Birmingham,G,19,0,212,22,40,.550,22,38,.579,0,2,.000,10,18,.556,4,32,36,27,5,0,14,10,54,2.6
9146,Tyren Harrison\tyren-harrison-1,2017-18,New Orleans,G,26,3,250,22,37,.595,19,28,.679,3,9,.333,7,15,.467,15,31,46,20,7,7,23,24,54,1.8
9147,Ashtyn Bradley\ashtyn-bradley-1,2016-17,Long Island University,G,21,0,113,17,53,.321,2,5,.400,15,48,.313,5,7,.714,7,7,14,1,3,3,2,8,54,1.5
9148,Austin Mills\austin-mills-1,2013-14,Pepperdine,G,22,0,202,17,51,.333,11,19,.579,6,32,.188,14,23,.609,2,16,18,16,6,4,16,28,54,0.9
9149,Stephane Manga\stephane-manga-1,2014-15,Seton Hall,G,21,9,258,22,57,.386,20,47,.426,2,10,.200,8,16,.500,7,25,32,6,8,6,24,30,54,0.6
9150,Cavit Havsa\cavit-havsa-1,2016-17,Fordham,G,19,1,267,22,46,.478,14,22,.636,8,24,.333,2,4,.500,1,17,18,25,14,2,19,21,54,2.2
9151,Andrew Petcash\andrew-petcash-1,2017-18,Boston University,G,25,0,219,19,45,.422,10,21,.476,9,24,.375,7,10,.700,7,13,20,11,9,1,14,15,54,1.4
9152,Terry Larrier\terry-larrier-1,2016-17,Connecticut,G,4,4,106,21,43,.488,17,30,.567,4,13,.308,8,13,.615,6,14,20,7,1,2,8,6,54,8.9
9153,Nourse Fox\nourse-fox-1,2016-17,Navy,G,32,0,347,19,56,.339,10,26,.385,9,30,.300,7,12,.583,4,27,31,34,10,0,31,27,54,0.7
9154,Walter Jones\walter-jones-1,2016-17,Texas-Rio Grande Valley,G,30,4,330,23,60,.383,20,46,.435,3,14,.214,5,10,.500,24,42,66,19,14,3,26,71,54,0.8
9155,Dau Jok\dau-jok-2,2013-14,Pennsylvania,G,26,3,231,18,60,.300,5,11,.455,13,49,.265,5,7,.714,11,21,32,5,4,1,11,29,54,0.7
9156,Dazon Ingram\dazon-ingram-1,2015-16,Alabama,G,7,7,179,20,37,.541,19,35,.543,1,2,.500,13,22,.591,6,35,41,23,8,3,24,24,54,5.7
9157,Jelani Currie\jelani-currie-1,2013-14,Texas A&M-Corpus Christi,G,26,6,219,16,39,.410,11,27,.407,5,12,.417,17,28,.607,10,16,26,9,5,1,8,29,54,1.3
9158,Isiah Deas\isiah-deas-1,2016-17,La Salle,G,17,2,168,18,49,.367,11,25,.440,7,24,.292,11,18,.611,2,16,18,10,3,1,8,12,54,1.7
9159,Brandon Chauca\brandon-chauca-1,2014-15,University of California,G,22,0,210,19,47,.404,7,16,.438,12,31,.387,3,6,.500,0,14,14,15,2,0,19,21,53,0.7
9160,Ot Elmore\ot-elmore-1,2015-16,Texas-Rio Grande Valley,G,20,1,293,16,53,.302,3,12,.250,13,41,.317,8,10,.800,5,24,29,22,6,2,10,17,53,1.9
9161,Todd Eaglin\todd-eaglin-1,2014-15,North Texas,G,28,6,383,18,44,.409,9,18,.500,9,26,.346,8,12,.667,4,30,34,32,15,3,32,41,53,1.1
9162,Lynrick Moxey\lynrick-moxey-1,2017-18,Western Illinois,G,16,0,117,20,29,.690,18,27,.667,2,2,1.000,11,19,.579,4,27,31,9,6,1,3,2,53,3.6
9163,Charlie Jones\charlie-jones-2,2013-14,American,G,26,2,349,19,46,.413,13,27,.481,6,19,.316,9,17,.529,15,31,46,22,9,6,15,35,53,1.7
9164,Casey Roberts\casey-roberts-1,2013-14,Liberty,G,29,4,157,18,43,.419,5,12,.417,13,31,.419,4,8,.500,3,21,24,10,4,0,3,20,53,1.3
9165,Blake Harris\blake-harris-1,2017-18,Missouri,G,14,9,195,22,54,.407,22,47,.468,0,7,.000,9,13,.692,6,28,34,44,14,0,24,20,53,3.4
9166,Jordan Shea\jordan-shea-1,2016-17,Massachusetts-Lowell,G,23,1,256,20,44,.455,14,27,.519,6,17,.353,7,9,.778,4,23,27,13,4,3,14,35,53,1.1
9167,Robert Thomas\robert-thomas-1,2016-17,Southern Mississippi,G,26,0,212,16,41,.390,7,14,.500,9,27,.333,12,14,.857,4,18,22,13,4,0,12,17,53,1.2
9168,Sheriff Drammeh\sheriff-drammeh-1,2015-16,Hawaii,G,32,2,428,17,48,.354,8,19,.421,9,29,.310,10,19,.526,4,29,33,15,9,0,10,49,53,0.8
9169,Tim Abruzzo\tim-abruzzo-1,2013-14,Navy,G,13,0,168,19,55,.345,6,19,.316,13,36,.361,2,5,.400,12,18,30,9,7,1,9,7,53,2.8
9170,John Ross Glover\john-ross-glover-1,2015-16,Lehigh,G,31,2,227,21,54,.389,15,39,.385,6,15,.400,5,8,.625,14,23,37,9,5,3,17,19,53,0.9
9171,Gary Chivichyan\gary-chivichyan-1,2016-17,Idaho State,G,7,5,146,19,45,.422,4,8,.500,15,37,.405,0,0,,0,9,9,2,1,0,3,7,53,4.1
9172,Clyde Trapp\clyde-trapp-1,2017-18,Clemson,G,29,0,228,16,41,.390,9,20,.450,7,21,.333,14,19,.737,1,18,19,17,2,2,15,25,53,0.9
9173,Renard Suggs\renard-suggs-1,2017-18,Omaha,G,17,1,188,18,61,.295,3,13,.231,15,48,.313,2,2,1.000,2,17,19,11,1,0,10,14,53,1.0
9174,Jason Massey\jason-massey-1,2014-15,Brown,G,30,3,292,22,47,.468,21,45,.467,1,2,.500,8,20,.400,16,17,33,16,5,2,11,31,53,1.2
9175,Charles Glover\charles-glover-1,2014-15,Mount St. Mary's,G,27,17,397,14,55,.255,7,23,.304,7,32,.219,18,22,.818,3,23,26,27,14,2,24,53,53,0.6
9176,Ty Graves\ty-graves-1,2016-17,Boston College,G,11,3,207,19,50,.380,7,17,.412,12,33,.364,3,5,.600,0,10,10,18,0,2,18,15,53,1.6
9177,R.J. Curington\rj-curington-1,2014-15,DePaul,G,21,0,123,18,38,.474,11,23,.478,7,15,.467,10,13,.769,4,10,14,5,4,2,9,20,53,1.4
9178,Josh Hearlihy\josh-hearlihy-1,2016-17,Vermont,G,27,0,268,19,44,.432,13,25,.520,6,19,.316,9,16,.563,5,34,39,15,5,1,20,22,53,1.0
9179,Trinson White\trinson-white-1,2014-15,Milwaukee,G,19,6,254,13,43,.302,11,38,.289,2,5,.400,25,36,.694,16,20,36,13,5,3,16,16,53,1.8
9180,Brian Patrick\brian-patrick-1,2016-17,Kansas State,G,23,0,124,19,40,.475,7,12,.583,12,28,.429,3,7,.429,2,7,9,2,3,2,4,8,53,1.4
9181,Malik Marquetti\malik-marquetti-1,2015-16,Southern California,G,27,0,198,18,48,.375,13,28,.464,5,20,.250,12,19,.632,11,18,29,12,9,5,6,20,53,1.6
9182,Dominic Early\dominic-early-1,2013-14,Furman,G,12,1,140,18,43,.419,16,28,.571,2,15,.133,15,24,.625,7,18,25,7,9,1,2,15,53,3.6
9183,Tony Nixon\tony-nixon-1,2013-14,Loyola (IL),G,22,1,170,19,39,.487,7,11,.636,12,28,.429,3,6,.500,8,7,15,0,3,1,6,17,53,1.4
9184,Wil Bathurst\wil-bathurst-1,2014-15,Cornell,G,22,0,156,18,46,.391,13,32,.406,5,14,.357,12,27,.444,7,26,33,4,7,2,8,17,53,1.4
9185,Jordan Hill\jordan-hill-2,2016-17,Wisconsin,G,35,0,356,19,54,.352,10,19,.526,9,35,.257,6,9,.667,7,31,38,16,6,1,9,26,53,1.0
9186,Junior Lomomba\junior-lomomba-1,2014-15,Providence,G,31,13,344,15,46,.326,13,35,.371,2,11,.182,21,32,.656,11,26,37,13,8,1,13,27,53,1.0
9187,Jevon Thomas\jevon-thomas-1,2013-14,Kansas State,G,21,0,342,17,69,.246,15,57,.263,2,12,.167,17,49,.347,12,30,42,55,12,0,22,39,53,1.4
9188,Kevin Canevari\kevin-canevari-1,2013-14,Mercer,G,36,1,323,17,41,.415,6,19,.316,11,22,.500,8,8,1.000,3,16,19,60,15,0,20,22,53,1.8
9189,Ghassan Nehme\ghasson-nehme-1,2016-17,Fairleigh Dickinson,G,11,8,188,17,65,.262,3,21,.143,14,44,.318,4,5,.800,5,23,28,12,6,0,13,25,52,1.3
9190,Johnnie Shuler\johnnie-shuler-1,2014-15,La Salle,G,23,0,142,15,41,.366,3,8,.375,12,33,.364,10,17,.588,6,10,16,6,2,0,12,13,52,1.0
9191,Robbie Berwick\robbie-berwick-1,2017-18,Colorado State,G,21,0,203,17,45,.378,9,21,.429,8,24,.333,10,14,.714,4,8,12,17,6,0,7,19,52,1.6
9192,Corey Henderson\corey-henderson-1,2014-15,Wichita State,G,28,0,191,18,62,.290,6,24,.250,12,38,.316,4,8,.500,3,8,11,6,5,1,7,17,52,0.5
9193,Petar Torlak\petar-torlak-1,2013-14,East Carolina,G,22,1,149,18,41,.439,6,15,.400,12,26,.462,4,9,.444,1,12,13,8,3,0,9,11,52,1.3
9194,Thomas Akyazili\thomas-akyazili-1,2016-17,Colorado,G,30,1,313,19,65,.292,18,44,.409,1,21,.048,13,23,.565,8,22,30,39,10,3,26,41,52,0.6
9195,Rico Sanders\rico-sanders-1,2013-14,Jacksonville State,G,14,0,142,20,57,.351,10,25,.400,10,32,.313,2,3,.667,2,6,8,3,6,0,4,16,52,1.5
9196,Frank Howard\franklin-howard-1,2015-16,Syracuse,G,32,0,335,18,63,.286,16,43,.372,2,20,.100,14,28,.500,10,33,43,56,17,4,28,39,52,1.3
9197,Alex Bran\alex-bran-1,2015-16,Chattanooga,G,18,0,92,19,36,.528,5,7,.714,14,29,.483,0,0,,1,8,9,9,4,2,7,6,52,2.2
9198,Devin Foster\devin-foster-1,2014-15,Penn State,G,19,0,243,19,33,.576,17,28,.607,2,5,.400,12,19,.632,14,24,38,11,6,1,15,21,52,2.2
9199,Craig Randall\craig-randall-1,2015-16,Memphis,G,24,5,181,20,72,.278,12,29,.414,8,43,.186,4,8,.500,6,25,31,11,6,3,18,16,52,0.5
9200,Austin Karrer\austin-karrer-1,2015-16,Texas-San Antonio,G,32,13,547,18,49,.367,15,26,.577,3,23,.130,13,31,.419,20,36,56,25,21,7,26,69,52,1.0
9201,Trae Bryant\trae-bryant-1,2015-16,North Carolina-Asheville,G,22,0,234,18,60,.300,10,24,.417,8,36,.222,8,10,.800,4,24,28,13,8,3,20,21,52,0.8
9202,David Carr\david-carr-1,2013-14,Portland,G,24,4,276,16,50,.320,13,32,.406,3,18,.167,17,28,.607,3,22,25,39,5,2,13,20,52,1.7
9203,Jared Hamilton\jared-hamilton-1,2017-18,Georgia Southern,G,8,0,151,20,56,.357,20,54,.370,0,2,.000,12,17,.706,9,11,20,6,8,1,9,10,52,3.5
9204,Ishmail Jabbie\ishmail-jabbie-1,2015-16,Maryland-Baltimore County,G,19,0,143,16,34,.471,13,27,.481,3,7,.429,17,23,.739,6,9,15,7,6,0,8,17,52,1.9
9205,Dylon Maggio\dylon-maggio-1,2014-15,Southeastern Louisiana,G,26,3,249,19,45,.422,7,22,.318,12,23,.522,2,5,.400,4,19,23,7,8,4,24,31,52,0.6
9206,Ali Barnes\ali-barnes-1,2015-16,Miami (OH),G,14,1,195,17,48,.354,6,15,.400,11,33,.333,7,8,.875,1,11,12,5,4,0,10,23,52,1.2
9207,Martin Dixon-Green\martin-dixon-green-1,2016-17,Canisius,G,22,1,172,17,49,.347,11,31,.355,6,18,.333,12,18,.667,16,27,43,5,4,2,14,25,52,1.2
9208,Cody Doolin\cody-doolin-1,2013-14,San Francisco,G,4,4,129,19,36,.528,13,22,.591,6,14,.429,8,10,.800,1,4,5,28,7,1,6,7,52,13.5
9209,Terry Harris\terry-harris-1,2014-15,Houston Baptist,G,20,0,163,17,53,.321,11,30,.367,6,23,.261,12,17,.706,10,18,28,6,5,2,9,18,52,1.3
9210,Jordan Ash\jordan-ash-1,2017-18,Northwestern,G,25,4,319,19,52,.365,8,18,.444,11,34,.324,3,5,.600,3,26,29,18,14,0,13,25,52,1.4
9211,Dezmyn Trent\dezmyn-trent-1,2013-14,Boise State,G,20,0,116,19,48,.396,12,28,.429,7,20,.350,7,15,.467,10,21,31,4,4,2,9,17,52,1.4
9212,Kobe King\kobe-king-1,2017-18,Wisconsin,G,10,0,190,21,46,.457,14,25,.560,7,21,.333,3,3,1.000,8,6,14,6,2,2,3,10,52,3.6
9213,Jacobby Bledsoe\jacobby-bledsoe-1,2013-14,Missouri-Kansas City,G,23,2,390,17,66,.258,9,20,.450,8,46,.174,10,16,.625,3,28,31,30,24,0,18,40,52,1.4
9214,Ja'cor Nelson\jacor-nelson-1,2017-18,Campbell,G,28,0,243,21,49,.429,21,41,.512,0,8,.000,10,22,.455,10,26,36,12,13,6,25,31,52,0.9
9215,Denzel Gregg\denzel-gregg-1,2013-14,St. Bonaventure,G,26,0,209,19,43,.442,19,40,.475,0,3,.000,14,23,.609,15,34,49,10,7,16,13,25,52,1.9
9216,Quinten Payne\quinten-payne-1,2013-14,Ball State,G,29,2,346,19,64,.297,11,21,.524,8,43,.186,6,9,.667,1,16,17,20,9,2,21,31,52,0.3
9217,Joe Garza\joe-garza-1,2016-17,New Mexico State,G,30,0,212,14,35,.400,4,10,.400,10,25,.400,14,14,1.000,1,16,17,14,4,0,11,19,52,1.1
9218,James Fives\james-fives-1,2015-16,Loyola (MD),G,28,0,309,12,50,.240,9,29,.310,3,21,.143,25,40,.625,15,27,42,7,11,1,15,55,52,0.5
9219,Travis Jorgenson\travis-jorgenson-1,2015-16,Georgia Tech,G,28,1,330,20,58,.345,11,22,.500,9,36,.250,3,8,.375,2,22,24,58,8,0,18,18,52,1.7
9220,T.J. Taylor\tj-taylor-1,2014-15,UC-Santa Barbara,G,32,0,293,16,45,.356,3,10,.300,13,35,.371,7,8,.875,3,12,15,40,7,0,13,21,52,1.4
9221,DaShawn Gomez\dashawn-gomez-2,2013-14,Iona,G,25,2,224,16,42,.381,4,10,.400,12,32,.375,8,12,.667,0,21,21,29,5,0,7,18,52,1.8
9222,Chance Murray\chance-murray-1,2013-14,Arizona State,G,22,0,173,16,44,.364,9,26,.346,7,18,.389,13,17,.765,5,29,34,13,2,2,9,15,52,1.6
9223,Deshaun Thrower\deshaun-thrower-1,2015-16,Stony Brook,G,27,0,232,18,68,.265,15,38,.395,3,30,.100,13,15,.867,3,15,18,13,5,1,6,20,52,0.7
9224,Dontaveon Robinson\dontaveon-robinson-1,2016-17,Jackson State,G,30,7,302,23,60,.383,23,57,.404,0,3,.000,6,12,.500,22,27,49,10,10,3,6,54,52,1.1
9225,Steve Rogers\steve-rogers-1,2017-18,Alabama State,G,20,1,218,14,56,.250,3,24,.125,11,32,.344,13,16,.813,3,13,16,9,6,1,6,18,52,1.2
9226,Taylor McHugh\taylor-mchugh-1,2016-17,Bryant,G,29,1,389,17,64,.266,5,28,.179,12,36,.333,6,10,.600,8,30,38,49,7,0,28,29,52,1.0
9227,Elijah Davis\elijah-davis-1,2016-17,Wagner,G,19,8,238,22,57,.386,18,44,.409,4,13,.308,4,9,.444,13,23,36,9,5,3,20,24,52,1.0
9228,Nick Severado\nick-severado-1,2015-16,Florida A&M,G,19,3,325,18,58,.310,17,54,.315,1,4,.250,15,30,.500,23,31,54,10,9,8,20,23,52,1.6
9229,Drake Green\drake-green-1,2015-16,Abilene Christian,G,29,3,293,20,80,.250,15,46,.326,5,34,.147,7,10,.700,12,29,41,8,10,5,14,44,52,0.3
9230,Brandon Hayman\brandon-hayman-1,2014-15,Samford,G,29,5,192,26,50,.520,26,50,.520,0,0,,0,6,.000,17,28,45,9,10,3,14,31,52,1.3
9231,Kyle Toth\kyle-toth-1,2014-15,Cal Poly,G,11,4,207,18,42,.429,3,6,.500,15,36,.417,0,3,.000,2,21,23,7,2,1,1,10,51,3.4
9232,Ben Robertson\ben-robertson-1,2017-18,Bucknell,G,30,0,210,21,40,.525,18,26,.692,3,14,.214,6,16,.375,12,28,40,10,3,2,11,23,51,1.2
9233,Sean Brennan\sean-brennan-1,2013-14,North Florida,G,18,0,125,13,30,.433,3,12,.250,10,18,.556,15,25,.600,1,9,10,16,6,2,15,13,51,1.8
9234,Taishaun Johnson\taishaun-johnson-1,2015-16,South Alabama,G,5,0,93,17,44,.386,17,32,.531,0,12,.000,17,23,.739,6,10,16,10,1,0,9,7,51,5.6
9235,Cullen Neal\cullen-neal-1,2014-15,New Mexico,G,3,3,89,13,35,.371,5,19,.263,8,16,.500,17,20,.850,0,4,4,11,2,0,7,7,51,10.5
9236,Lionel Ellison III\lionel-ellisoniii-1,2015-16,Fresno State,G,31,0,433,10,45,.222,7,27,.259,3,18,.167,28,42,.667,9,40,49,34,17,2,18,49,51,1.3
9237,Terrell Hales\terrell-hales-1,2015-16,Cleveland State,G,32,29,681,21,56,.375,20,43,.465,1,13,.077,8,19,.421,29,45,74,42,33,2,37,70,51,1.5
9238,Dylan Alderson\dylan-alderson-1,2017-18,Toledo,G,33,0,340,19,45,.422,11,23,.478,8,22,.364,5,9,.556,9,40,49,20,9,0,19,21,51,1.2
9239,Max Joseph\max-joseph-1,2014-15,Valparaiso,G,28,0,306,16,37,.432,12,25,.480,4,12,.333,15,28,.536,9,19,28,31,8,3,27,31,51,1.1
9240,C.J. Foster\cj-foster-1,2014-15,Arkansas State,G,22,9,312,15,51,.294,12,35,.343,3,16,.188,18,28,.643,13,10,23,14,3,1,18,30,51,0.6
9241,Isaiah Maston\isaiah-maston-1,2013-14,South Alabama,G,28,0,257,18,44,.409,4,9,.444,14,35,.400,1,2,.500,6,19,25,9,1,3,8,30,51,0.9
9242,Taj Owens\taj-owens-1,2014-15,Radford,G,27,0,220,17,40,.425,15,34,.441,2,6,.333,15,18,.833,5,14,19,28,8,0,13,22,51,1.6
9243,Albert Odero\albert-odero-1,2017-18,Binghamton,G,15,1,144,17,50,.340,15,36,.417,2,14,.143,15,24,.625,14,5,19,9,5,3,10,18,51,1.8
9244,Eric Monroe\eric-monroe-1,2016-17,Yale,G,25,0,209,17,33,.515,4,6,.667,13,27,.481,4,4,1.000,0,24,24,13,6,1,13,14,51,1.6
9245,Glenn Sanabria\glenn-sanabria-1,2015-16,St. Francis (NY),G,6,6,145,17,52,.327,7,22,.318,10,30,.333,7,10,.700,2,5,7,19,7,1,10,16,51,4.6
9246,Tevin Findlay\tevin-findlay-1,2013-14,Green Bay,G,25,1,201,20,41,.488,20,37,.541,0,4,.000,11,20,.550,2,16,18,16,9,1,11,17,51,1.4
9247,Kahlil Dukes\kahlil-dukes-1,2013-14,Southern California,G,19,2,121,17,48,.354,6,17,.353,11,31,.355,6,7,.857,2,4,6,6,3,0,7,11,51,1.2
9248,Deonte Burton\deonte-burton-2,2014-15,Marquette,G,8,0,129,17,36,.472,13,26,.500,4,10,.400,13,17,.765,5,6,11,2,10,3,11,16,51,4.1
9249,Haralds Karlis\haralds-karlis-1,2013-14,Seton Hall,G,28,10,368,14,43,.326,5,12,.417,9,31,.290,14,20,.700,9,33,42,19,11,2,19,37,51,1.2
9250,Arell Hennings\arell-hennings-1,2016-17,UC-Davis,G,27,0,224,16,48,.333,11,29,.379,5,19,.263,14,19,.737,4,13,17,27,8,0,22,17,51,1.0
9251,Andrew Robinson\andrew-robinson-1,2015-16,Quinnipiac,G,24,0,180,18,67,.269,4,8,.500,14,59,.237,1,2,.500,11,13,24,3,3,0,6,16,51,0.6
9252,Emmanuel Tselentakis\emmanuel-tselentakis-1,2014-15,NJIT,G,33,16,409,21,61,.344,17,34,.500,4,27,.148,5,8,.625,22,47,69,26,22,8,17,29,51,1.9
9253,C.J. Jones\cj-jones-3,2016-17,Arkansas,G,21,0,127,17,36,.472,5,12,.417,12,24,.500,5,7,.714,0,13,13,6,1,5,4,11,51,1.7
9254,John Rinaldi\john-rinaldi-1,2016-17,Binghamton,G,32,2,406,21,46,.457,21,43,.488,0,3,.000,9,16,.563,22,63,85,39,13,1,19,57,51,1.8
9255,Devin Wilson\devin-wilson-1,2014-15,North Florida,G,32,0,256,13,28,.464,5,14,.357,8,14,.571,17,24,.708,3,18,21,35,12,0,23,19,51,1.5
9256,Cameron Fowler\cameron-fowler-1,2013-14,Niagara,G,30,9,431,22,78,.282,19,58,.328,3,20,.150,4,14,.286,20,30,50,34,21,0,30,68,51,0.4
9257,Saleik Edwards\saleik-edwards-1,2017-18,Delaware State,G,25,1,196,18,63,.286,14,34,.412,4,29,.138,11,15,.733,7,11,18,5,8,0,11,20,51,0.5
9258,Zach Reichle\zach-reichle-1,2017-18,Oregon State,G,30,0,262,16,52,.308,4,17,.235,12,35,.343,7,10,.700,12,27,39,16,9,0,22,31,51,0.7
9259,Chris Clement\chris-clement-1,2013-14,Princeton,G,19,0,264,15,42,.357,6,16,.375,9,26,.346,12,12,1.000,3,20,23,13,14,1,9,31,51,2.0
9260,T.J. Johnson\tj-johnson-2,2013-14,South Alabama,G,20,0,190,19,47,.404,11,25,.440,8,22,.364,5,7,.714,3,21,24,9,4,2,9,15,51,1.5
9261,A.J. Hess\aj-hess-1,2015-16,Southern Utah,G,6,4,126,19,38,.500,10,16,.625,9,22,.409,3,4,.750,0,10,10,6,2,0,6,13,50,4.8
9262,Clay Byrd\clay-byrd-1,2015-16,North Carolina-Greensboro,G,6,5,147,16,36,.444,0,0,,16,36,.444,2,2,1.000,0,16,16,2,2,0,6,12,50,4.8
9263,Isaiah Banks\isaiah-banks-1,2017-18,Florida International,G,21,0,170,19,41,.463,14,23,.609,5,18,.278,7,13,.538,9,17,26,6,9,3,9,16,50,1.8
9264,Freddie Wilson\freddie-wilson-1,2013-14,Drexel,G,19,0,209,20,64,.313,12,28,.429,8,36,.222,2,3,.667,6,15,21,16,5,1,12,15,50,1.1
9265,Marquis Godwin\marquis-godwin-1,2017-18,Old Dominion,G,18,1,91,15,39,.385,1,4,.250,14,35,.400,6,6,1.000,0,14,14,1,0,1,3,8,50,1.6
9266,Chris Atkinson\chris-atkinson-1,2016-17,Canisius,G,22,0,198,16,45,.356,2,12,.167,14,33,.424,4,5,.800,2,14,16,24,8,1,11,22,50,1.6
9267,Eric McGill\eric-mcgill-1,2017-18,Southern Illinois,G,10,0,192,18,51,.353,8,23,.348,10,28,.357,4,10,.400,5,22,27,13,15,1,16,15,50,3.2
9268,Ria'n Holland\rian-holland-1,2014-15,Wichita State,G,27,0,229,17,53,.321,5,18,.278,12,35,.343,4,4,1.000,8,12,20,10,6,1,7,27,50,0.9
9269,Aaron Morgan\aaron-morgan-2,2014-15,Maryland-Baltimore County,G,10,8,219,13,46,.283,2,12,.167,11,34,.324,13,21,.619,5,3,8,13,6,0,21,29,50,0.7
9270,Wil Bathurst\wil-bathurst-1,2017-18,Cornell,G,7,7,172,19,49,.388,16,32,.500,3,17,.176,9,13,.692,5,20,25,22,3,5,13,10,50,5.2
9271,Daniel Dzierzawski\daniel-dzierzawski-1,2016-17,Toledo,G,7,1,109,18,42,.429,17,36,.472,1,6,.167,13,15,.867,1,13,14,11,2,0,17,9,50,3.0
9272,Terrence Phillips\terrence-phillips-1,2017-18,Missouri,G,20,0,212,15,33,.455,8,13,.615,7,20,.350,13,16,.813,7,22,29,37,5,0,22,39,50,1.8
9273,Alex Barcello\alex-barcello-1,2017-18,Arizona,G,21,0,202,18,46,.391,10,20,.500,8,26,.308,6,8,.750,3,19,22,19,3,0,8,26,50,1.4
9274,Malik Benlevi\malik-benlevi-1,2015-16,Georgia State,G,28,2,232,19,63,.302,15,38,.395,4,25,.160,8,17,.471,12,17,29,6,6,3,10,28,50,0.5
9275,Theo Johnson\theo-johnson-1,2013-14,College of Charleston,G,30,0,275,17,48,.354,14,28,.500,3,20,.150,13,19,.684,16,30,46,14,2,8,12,27,50,1.2
9276,Trevon Woods\trevon-woods-1,2014-15,Long Island University,G,22,0,158,18,58,.310,10,28,.357,8,30,.267,6,7,.857,11,21,32,4,1,3,13,16,50,0.8
9277,Bryan Knapp\bryan-knapp-1,2017-18,Cornell,G,16,0,146,19,47,.404,14,36,.389,5,11,.455,7,10,.700,3,4,7,6,4,0,13,13,50,1.1
9278,Austin Rogers\austin-rogers-1,2017-18,Alabama State,G,21,7,235,19,45,.422,13,30,.433,6,15,.400,6,11,.545,15,22,37,14,3,2,14,37,50,1.3
9279,Shawn Hopkins\shawn-hopkins-1,2016-17,Troy,G,19,2,113,18,42,.429,8,13,.615,10,29,.345,4,5,.800,10,20,30,5,2,2,7,16,50,1.8
9280,Nick Davis\nick-davis-2,2016-17,South Alabama,G,23,0,230,18,36,.500,14,22,.636,4,14,.286,10,13,.769,13,38,51,4,10,12,14,37,50,1.9
9281,Maurice White\maurice-white-1,2014-15,Siena,G,23,0,225,14,75,.187,14,72,.194,0,3,.000,22,34,.647,15,23,38,5,9,3,19,25,50,0.1
9282,Jaaron Simmons\jaaron-simmons-1,2017-18,Michigan,G,33,0,264,18,44,.409,12,26,.462,6,18,.333,8,14,.571,4,20,24,35,2,0,21,26,50,0.8
9283,Chris Longoria\chris-longoria-1,2013-14,Samford,G,13,4,164,21,51,.412,20,36,.556,1,15,.067,7,15,.467,2,18,20,13,7,1,8,12,50,2.3
9284,Rod Henry-Hayes\rod-henry-hayes-1,2017-18,Northern Illinois,G,24,0,210,17,38,.447,7,9,.778,10,29,.345,6,8,.750,5,12,17,15,4,2,5,21,50,1.6
9285,Manroop Clair\manroop-clair-1,2014-15,Seattle,G,16,0,143,14,53,.264,2,10,.200,12,43,.279,10,13,.769,4,7,11,5,4,0,9,14,50,0.9
9286,Trent Perry\trent-perry-1,2014-15,Eastern Michigan,G,21,0,160,18,46,.391,5,11,.455,13,35,.371,1,3,.333,2,7,9,6,3,0,3,6,50,1.4
9287,Daniel Levitt\daniel-levitt-1,2016-17,Cleveland State,G,21,0,136,15,48,.313,3,10,.300,12,38,.316,8,12,.667,9,5,14,3,5,0,3,13,50,1.3
9288,Jack Lopez\jack-lopez-1,2014-15,Montana,G,31,0,322,18,45,.400,9,19,.474,9,26,.346,5,12,.417,10,41,51,11,12,8,9,38,50,1.4
9289,Chase Connor\chase-connor-1,2014-15,West Virginia,G,23,0,122,17,45,.378,2,2,1.000,15,43,.349,0,0,,1,3,4,2,11,0,3,14,49,1.3
9290,Viont'e Daniels\vionte-daniels-1,2015-16,Washington State,G,20,3,213,18,48,.375,5,14,.357,13,34,.382,0,1,.000,6,12,18,14,7,1,12,12,49,1.5
9291,Asa Duvall\asa-duvall-1,2014-15,Lipscomb,G,28,0,214,15,47,.319,7,14,.500,8,33,.242,11,18,.611,2,11,13,10,2,0,8,11,49,0.7
9292,DeOndre Haynes\deondre-haynes-1,2013-14,Tennessee Tech,G,15,0,133,17,39,.436,17,37,.459,0,2,.000,15,21,.714,3,11,14,10,10,3,14,12,49,2.1
9293,Brandon Burnett\brandon-burnett-1,2015-16,Indiana State,G,30,1,294,18,58,.310,11,26,.423,7,32,.219,6,12,.500,10,30,40,11,11,1,25,39,49,0.3
9294,Taylor Stafford\taylor-stafford-1,2014-15,Evansville,G,29,0,192,16,43,.372,6,13,.462,10,30,.333,7,10,.700,4,14,18,13,4,0,3,12,49,1.3
9295,Aaron Augustin\aaron-augustin-1,2016-17,Stephen F. Austin,G,33,4,419,17,54,.315,12,34,.353,5,20,.250,10,23,.435,7,22,29,54,19,0,36,45,49,0.8
9296,Isaiah Salafia\isaiah-salafia-1,2013-14,Yale,G,26,3,252,14,50,.280,4,19,.211,10,31,.323,11,16,.688,0,15,15,13,7,0,21,35,49,0.1
9297,Kyle Carey\kyle-carey-1,2016-17,Northern Colorado,G,21,0,181,16,54,.296,12,33,.364,4,21,.190,13,21,.619,5,23,28,5,4,1,12,22,49,0.6
9298,Christopher Miller\christopher-miller-1,2013-14,Northern Arizona,G,21,0,194,17,51,.333,10,31,.323,7,20,.350,8,14,.571,6,13,19,2,4,5,10,17,49,0.9
9299,Max Livingston\max-livingston-1,2015-16,Portland,G,23,3,192,17,46,.370,5,9,.556,12,37,.324,3,5,.600,5,14,19,17,7,1,4,18,49,1.7
9300,Vangelis Bebis\vangelis-bebis-1,2014-15,Iona,G,27,6,233,17,52,.327,4,8,.500,13,44,.295,2,2,1.000,2,18,20,8,8,3,7,24,49,0.9
9301,Aarias Austin\aarias-austin-1,2015-16,Northern Iowa,G,9,0,120,17,43,.395,7,17,.412,10,26,.385,5,5,1.000,0,16,16,7,2,0,8,7,49,3.0
9302,Quinton Ray\quinton-ray-1,2014-15,Campbell,G,32,19,530,19,57,.333,16,37,.432,3,20,.150,8,12,.667,14,46,60,55,18,0,24,29,49,1.9
9303,Daquan Cook\daquan-cook-2,2013-14,Nevada-Las Vegas,G,28,2,237,16,55,.291,5,23,.217,11,32,.344,6,8,.750,2,14,16,20,2,2,14,27,49,0.5
9304,Sam Daly\sam-daly-1,2014-15,Grand Canyon,G,21,4,292,18,38,.474,15,28,.536,3,10,.300,10,18,.556,8,19,27,37,11,2,33,29,49,1.5
9305,Trell Thompson\trell-thompson-2,2017-18,Morehead State,G,14,0,164,19,53,.358,11,23,.478,8,30,.267,3,5,.600,10,17,27,6,6,1,11,13,49,1.8
9306,Duke Douglas\duke-douglas-1,2014-15,Denver,G,23,2,240,21,47,.447,21,39,.538,0,8,.000,7,18,.389,7,15,22,8,4,8,17,32,49,0.6
9307,Keshon Montague\keshon-montague-1,2016-17,Pacific,G,19,7,255,17,49,.347,6,16,.375,11,33,.333,4,6,.667,2,14,16,20,4,1,13,29,49,1.1
9308,Jurmelle Hall\jurmelle-hall-1,2014-15,Mississippi Valley State,G,18,4,173,17,56,.304,6,16,.375,11,40,.275,4,6,.667,9,19,28,7,7,2,10,23,49,1.2
9309,Jafar Kinsey\jafar-kinsey-1,2017-18,North Dakota,G,26,3,261,17,59,.288,13,26,.500,4,33,.121,11,21,.524,7,20,27,11,6,1,13,24,49,0.5
9310,Daquein McNeil\daquein-mcneil-1,2013-14,Minnesota,G,30,0,292,18,48,.375,13,31,.419,5,17,.294,8,13,.615,5,27,32,12,11,1,13,32,49,0.9
9311,Chris Nsenki\chris-nsenki-1,2013-14,Southern Utah,G,24,8,282,18,72,.250,14,49,.286,4,23,.174,9,10,.900,4,11,15,13,6,2,18,27,49,0.0
9312,Sid Tomes\sid-tomes-1,2016-17,Air Force,G,17,5,181,16,46,.348,6,15,.400,10,31,.323,7,8,.875,0,19,19,14,7,0,6,15,49,2.0
9313,Demonte Ojinnaka\demonte-ojinnaka-1,2017-18,Indiana State,G,27,2,282,17,60,.283,4,21,.190,13,39,.333,2,3,.667,2,21,23,10,2,2,11,32,49,0.3
9314,Aaron Jackson\aaron-jackson-2,2017-18,East Carolina,G,24,8,353,17,55,.309,10,27,.370,7,28,.250,8,14,.571,16,34,50,8,7,1,19,38,49,0.6
9315,Raquan Wilkins\raquan-wilkins-1,2016-17,East Carolina,G,27,1,211,16,55,.291,11,31,.355,5,24,.208,12,16,.750,13,27,40,4,7,1,14,17,49,0.8
9316,Mike Crawford\mike-crawford-1,2013-14,Saint Louis,G,24,0,180,17,43,.395,8,22,.364,9,21,.429,5,7,.714,1,13,14,10,4,0,11,17,48,0.9
9317,Keilan Blanks\keilan-blanks-1,2013-14,Lamar,G,14,7,214,12,48,.250,7,31,.226,5,17,.294,19,25,.760,6,12,18,26,6,2,22,21,48,1.4
9318,Kevin McKay\kevin-mckay-1,2016-17,Central Michigan,G,28,0,118,16,24,.667,16,24,.667,0,0,,16,31,.516,17,24,41,3,6,0,2,13,48,1.8
9319,Tristan Thomas\tristan-thomas-1,2015-16,South Carolina Upstate,G,20,1,205,16,48,.333,1,6,.167,15,42,.357,1,3,.333,1,12,13,21,12,0,9,18,48,1.7
9320,John Dawson\john-dawson-1,2013-14,Marquette,G,24,0,245,16,50,.320,9,24,.375,7,26,.269,9,11,.818,1,25,26,25,3,1,17,39,48,0.6
9321,Yunus Hopkinson\yunus-hopkinson-1,2013-14,St. Francis (NY),G,19,2,184,17,52,.327,12,30,.400,5,22,.227,9,14,.643,3,13,16,19,7,0,18,16,48,1.0
9322,Ray Dorsey\ray-dorsey-1,2013-14,Texas State,G,23,1,260,16,43,.372,8,23,.348,8,20,.400,8,15,.533,4,16,20,21,9,0,15,15,48,1.4
9323,Jon'te Dotson\jonte-dotson-1,2015-16,Northern Colorado,G,17,8,289,15,36,.417,9,15,.600,6,21,.286,12,17,.706,8,29,37,5,7,3,27,41,48,0.6
9324,Kahari Beaufort\kahari-beaufort-1,2017-18,Tennessee-Martin,G,14,2,165,19,47,.404,15,29,.517,4,18,.222,6,8,.750,7,11,18,10,8,2,11,23,48,1.9
9325,Noah Allen\noah-allen-1,2014-15,UCLA,G,36,0,412,15,54,.278,11,29,.379,4,25,.160,14,27,.519,19,45,64,33,6,2,20,37,48,0.9
9326,Lane Severyn\lane-severyn-1,2015-16,South Dakota State,G,27,0,273,17,42,.405,9,13,.692,8,29,.276,6,8,.750,15,37,52,14,4,3,15,38,48,1.2
9327,Joe Kilgore\joe-kilgore-1,2014-15,Texas A&M-Corpus Christi,G,24,0,193,19,49,.388,16,33,.485,3,16,.188,7,12,.583,6,15,21,4,6,3,9,21,48,0.9
9328,Asante Gist\asante-gist-1,2017-18,Eastern Kentucky,G,6,5,165,17,55,.309,10,37,.270,7,18,.389,7,15,.467,1,17,18,16,3,0,11,16,48,2.6
9329,Jonathan Jean\jonathan-jean-2,2016-17,Furman,G,30,1,320,18,43,.419,15,32,.469,3,11,.273,9,15,.600,3,34,37,40,19,0,24,37,48,1.4
9330,Jalen Seegars\jalen-seegars-1,2017-18,North Carolina-Asheville,G,19,6,227,15,36,.417,10,19,.526,5,17,.294,13,22,.591,4,18,22,11,6,7,16,37,48,1.1
9331,Michael Almonacy\michael-almonacy-1,2017-18,Stony Brook,G,20,0,184,14,42,.333,5,20,.250,9,22,.409,11,12,.917,8,26,34,23,9,0,9,25,48,2.2
9332,C.J. Reese\cj-reese-1,2013-14,Southeast Missouri State,G,21,1,238,19,41,.463,18,40,.450,1,1,1.000,9,16,.563,4,10,14,39,5,1,30,21,48,1.2
9333,Thierno Niang\thierno-niang-1,2013-14,Milwaukee,G,20,4,243,19,41,.463,16,32,.500,3,9,.333,7,10,.700,3,33,36,16,9,0,23,39,48,1.0
9334,Brandon Randolph\brandon-randolph-1,2014-15,Xavier,G,23,0,224,20,44,.455,14,33,.424,6,11,.545,2,6,.333,4,19,23,25,7,1,12,13,48,1.7
9335,Isaiah Brown\isaiah-brown-1,2016-17,Northern Iowa,G,25,2,270,16,66,.242,7,25,.280,9,41,.220,7,8,.875,7,24,31,5,4,0,11,25,48,0.3
9336,Davon Bell\davon-bell-1,2016-17,Presbyterian,G,7,6,184,15,37,.405,13,28,.464,2,9,.222,16,20,.800,1,12,13,24,9,0,10,17,48,5.7
9337,Aaron Bodager\aaron-bodager-1,2014-15,North Florida,G,21,0,181,16,48,.333,3,4,.750,13,44,.295,3,4,.750,2,15,17,10,5,0,8,10,48,1.3
9338,Tommy McDonnell\tommy-mcdonnell-1,2014-15,New Hampshire,G,32,12,329,21,38,.553,20,36,.556,1,2,.500,5,14,.357,22,57,79,20,15,2,15,39,48,1.8
9339,Morris Dunnigan\morris-dunnigan-1,2016-17,Houston,G,20,0,125,18,51,.353,14,33,.424,4,18,.222,8,13,.615,3,14,17,2,4,0,4,12,48,1.0
9340,Everett Duncan\everett-duncan-1,2015-16,Vermont,G,27,0,185,15,40,.375,3,4,.750,12,36,.333,6,7,.857,10,24,34,6,5,1,6,26,48,1.2
9341,Travis Trim\travis-trim-1,2014-15,Maryland-Eastern Shore,G,29,1,351,21,53,.396,18,45,.400,3,8,.375,3,11,.273,10,29,39,39,21,1,31,59,48,0.9
9342,De'Angelo Bruster\deangelo-bruster-1,2015-16,Western Illinois,G,26,3,296,14,44,.318,6,22,.273,8,22,.364,12,17,.706,9,26,35,33,10,0,26,34,48,1.1
9343,Leyton Hammonds\leyton-hammonds-1,2013-14,Oklahoma State,G,31,0,230,17,54,.315,9,19,.474,8,35,.229,6,18,.333,11,26,37,6,7,1,9,47,48,0.4
9344,Andre Adams\andre-adams-1,2013-14,Prairie View,G,31,8,374,15,45,.333,13,32,.406,2,13,.154,16,21,.762,1,20,21,35,23,0,33,42,48,0.8
9345,David Kachelries\david-kachelries-1,2017-18,NJIT,G,14,0,100,21,36,.583,18,26,.692,3,10,.300,2,4,.500,6,3,9,8,7,2,7,13,47,2.6
9346,Donald Gipson\donald-gipson-1,2017-18,Loyola Marymount,G,17,1,152,18,64,.281,11,30,.367,7,34,.206,4,4,1.000,6,14,20,10,9,0,12,25,47,0.7
9347,Daijon Macklien\daijon-macklien-1,2014-15,Arkansas State,G,23,0,281,18,41,.439,13,28,.464,5,13,.385,6,9,.667,3,18,21,18,6,0,24,21,47,0.8
9348,Wes VanBeck\wes-vanbeck-1,2014-15,Houston,G,17,0,142,15,36,.417,3,11,.273,12,25,.480,5,6,.833,6,15,21,8,0,0,15,16,47,1.2
9349,Peyton Woods\peyton-woods-1,2016-17,Chattanooga,G,12,0,132,14,50,.280,1,3,.333,13,47,.277,6,7,.857,4,4,8,3,3,0,3,14,47,1.5
9350,Cameron Reynolds\cameron-reynolds-1,2014-15,Tulane,G,9,0,119,21,47,.447,16,30,.533,5,17,.294,0,4,.000,8,18,26,11,4,0,6,16,47,3.5
9351,Nelson Maxwell\nelson-maxwell-1,2016-17,Cleveland State,G,26,0,184,19,40,.475,14,31,.452,5,9,.556,4,6,.667,2,14,16,8,9,0,19,28,47,0.6
9352,Petey McClain\petey-mcclain-1,2014-15,East Tennessee State,G,30,23,629,16,42,.381,13,28,.464,3,14,.214,12,22,.545,9,54,63,127,30,0,41,53,47,3.3
9353,Devin Gage\devin-gage-1,2017-18,DePaul,G,8,8,192,18,51,.353,17,46,.370,1,5,.200,10,15,.667,2,14,16,22,10,1,17,16,47,3.1
9354,Preston Mattingly\preston-mattingly-1,2014-15,Lamar,G,23,8,287,16,43,.372,16,39,.410,0,4,.000,15,33,.455,12,23,35,18,8,1,13,26,47,1.3
9355,Karl Madison\karl-madison-1,2015-16,Drake,G,30,7,433,19,57,.333,16,43,.372,3,14,.214,6,8,.750,4,21,25,49,5,0,38,45,47,0.2
9356,Corey Redman\corey-redman-1,2015-16,Central Michigan,G,25,0,105,15,30,.500,0,3,.000,15,27,.556,2,4,.500,13,15,28,2,2,1,2,17,47,1.6
9357,Grant Leach\grant-leach-1,2015-16,Missouri-Kansas City,G,24,1,241,15,42,.357,3,7,.429,12,35,.343,5,6,.833,2,12,14,11,3,0,9,25,47,0.8
9358,Haroldas Saprykinas\haroldas-saprykinas-1,2015-16,UC-Irvine,G,29,0,116,15,41,.366,3,9,.333,12,32,.375,5,9,.556,7,10,17,2,2,0,5,7,47,0.9
9359,Donovan Sims\donovan-sims-1,2017-18,Middle Tennessee,G,28,4,260,16,31,.516,8,13,.615,8,18,.444,7,8,.875,1,29,30,39,12,3,18,19,47,2.0
9360,Alex Allbery\alex-allbery-1,2017-18,Omaha,G,26,1,217,19,41,.463,13,27,.481,6,14,.429,3,5,.600,10,14,24,8,11,1,14,19,47,1.2
9361,Greg Mortimer\greg-mortimer-1,2013-14,South Carolina State,G,17,0,175,17,58,.293,13,42,.310,4,16,.250,9,20,.450,13,10,23,12,6,2,11,12,47,1.2
9362,Desjuan Newton\desjuan-newton-1,2013-14,Robert Morris,G,12,0,165,17,41,.415,9,22,.409,8,19,.421,5,9,.556,11,18,29,15,6,2,7,22,47,3.2
9363,Andre Ferguson\andre-ferguson-1,2016-17,Portland,G,19,7,262,13,46,.283,7,29,.241,6,17,.353,15,25,.600,3,22,25,23,5,0,23,32,47,0.5
9364,Justin Wertner\justin-wertner-1,2017-18,UC-Irvine,G,20,0,139,14,38,.368,4,14,.286,10,24,.417,9,9,1.000,10,9,19,6,4,1,3,12,47,1.8
9365,Tyler Davis\tyler-davis-3,2015-16,Alabama A&M,G,21,0,275,16,50,.320,5,8,.625,11,42,.262,4,7,.571,9,9,18,7,10,0,7,19,47,1.3
9366,C.J. Keyser\cj-keyser-1,2016-17,Wichita State,G,25,0,120,17,40,.425,14,29,.483,3,11,.273,10,14,.714,7,10,17,8,2,2,15,22,47,0.7
9367,JJ Caldwell\jj-caldwell-1,2017-18,Texas A&M,G,16,5,256,16,42,.381,14,35,.400,2,7,.286,13,18,.722,8,23,31,41,12,2,21,20,47,3.0
9368,Kory Holden\kory-holden-1,2017-18,South Carolina,G,14,0,152,17,52,.327,13,35,.371,4,17,.235,9,15,.600,5,13,18,21,1,1,21,15,47,0.8
9369,DeVonte Smith\devonte-smith-1,2014-15,Little Rock,G,21,8,458,17,38,.447,14,28,.500,3,10,.300,10,26,.385,15,39,54,38,17,1,16,35,47,2.7
9370,Terry Harris\terry-harris-1,2015-16,Houston Baptist,G,9,0,112,15,35,.429,14,27,.519,1,8,.125,16,24,.667,6,13,19,2,2,1,6,12,47,3.0
9371,Brandon Austin\brandon-austin-1,2015-16,Alabama,G,30,0,268,18,59,.305,10,19,.526,8,40,.200,2,4,.500,7,20,27,2,3,4,6,17,46,0.5
9372,Marquel McKinney\marquel-mckinney-1,2013-14,Sam Houston State,G,27,0,241,13,34,.382,8,18,.444,5,16,.313,15,24,.625,11,16,27,12,7,0,7,25,46,1.3
9373,Spike Albrecht\spike-albrecht-1,2016-17,Purdue,G,28,0,350,11,41,.268,5,15,.333,6,26,.231,18,19,.947,11,30,41,36,11,1,9,25,46,2.0
9374,C.J. Seaforth\cj-seaforth-1,2017-18,Iona,G,20,0,143,16,35,.457,5,9,.556,11,26,.423,3,5,.600,2,11,13,12,2,0,13,21,46,1.0
9375,Kamron Reaves\kamron-reaves-1,2017-18,Florida A&M,G,13,3,237,15,55,.273,9,27,.333,6,28,.214,10,16,.625,6,20,26,20,3,0,31,31,46,-0.4
9376,Malcolm Brent\malcolm-brent-1,2015-16,Maryland-Baltimore County,G,20,6,210,15,61,.246,8,18,.444,7,43,.163,9,15,.600,4,25,29,6,6,1,7,20,46,0.7
9377,Moe McDonald\moe-mcdonald-1,2014-15,Texas-Rio Grande Valley,G,26,4,325,13,46,.283,7,17,.412,6,29,.207,14,23,.609,1,24,25,24,6,1,16,21,46,0.9
9378,Lincoln Davis\lincoln-davis-1,2013-14,Fairfield,G,18,5,228,15,52,.288,9,30,.300,6,22,.273,10,13,.769,3,18,21,17,5,1,14,18,46,1.0
9379,Eron Gordon\eron-gordon-1,2017-18,Seton Hall,G,30,1,247,17,38,.447,11,21,.524,6,17,.353,6,15,.400,5,19,24,23,4,0,12,25,46,1.0
9380,Simon Krajcovic\simon-krajcovic-1,2014-15,Loyola Marymount,G,17,8,256,18,41,.439,14,29,.483,4,12,.333,6,12,.500,8,20,28,36,13,0,30,27,46,1.8
9381,Danny Cohen\danny-cohen-1,2015-16,New Orleans,G,26,3,200,14,45,.311,4,19,.211,10,26,.385,8,9,.889,10,14,24,5,1,0,8,16,46,0.8
9382,Bryan Gee\bryan-gee-1,2016-17,Longwood,G,19,8,339,12,33,.364,10,28,.357,2,5,.400,20,28,.714,6,28,34,33,6,0,27,24,46,1.6
9383,Danny Mahoney\danny-mahoney-1,2014-15,San Jose State,G,25,3,328,17,71,.239,11,27,.407,6,44,.136,6,6,1.000,5,19,24,28,6,0,29,21,46,0.0
9384,Josh Elbaum\josh-elbaum-1,2013-14,Vermont,G,33,1,361,17,24,.708,16,23,.696,1,1,1.000,11,22,.500,9,28,37,38,30,1,20,32,46,2.1
9385,McKay Anderson\mckay-anderson-1,2013-14,Southern Utah,G,23,1,220,18,42,.429,9,23,.391,9,19,.474,1,2,.500,11,16,27,11,5,1,10,18,46,1.4
9386,Tyler Madison\tyler-madison-1,2013-14,Alabama-Birmingham,G,19,0,154,15,37,.405,14,28,.500,1,9,.111,15,29,.517,23,18,41,5,4,4,6,19,46,2.0
9387,Craig Bowman\craig-bowman-1,2017-18,Florida A&M,G,22,0,212,17,56,.304,11,27,.407,6,29,.207,6,15,.400,2,23,25,25,11,0,20,23,46,0.8
9388,Devonte Hall\devonte-hall-1,2017-18,Northwestern State,G,8,8,189,14,49,.286,7,23,.304,7,26,.269,11,17,.647,5,18,23,18,8,0,10,18,46,3.4
9389,Jonathan Bryant II\jonathan-bryantii-1,2017-18,Chattanooga,G,24,0,215,18,47,.383,17,37,.459,1,10,.100,9,16,.563,12,20,32,5,4,0,12,16,46,0.9
9390,Justin Smith\justin-smith-2,2013-14,Idaho State,G,26,1,231,14,46,.304,8,27,.296,6,19,.316,12,17,.706,11,21,32,0,4,2,8,26,46,0.7
9391,Charles Foster\charles-foster-1,2015-16,East Carolina,G,21,0,116,17,39,.436,8,12,.667,9,27,.333,3,6,.500,1,7,8,6,1,0,13,12,46,0.7
9392,James Fives\james-fives-1,2017-18,Loyola (MD),G,9,6,204,13,39,.333,4,14,.286,9,25,.360,11,18,.611,7,28,35,5,3,1,11,21,46,2.5
9393,Justin Benton\justin-benton-1,2016-17,Southern Illinois-Edwardsville,G,27,0,384,16,66,.242,11,36,.306,5,30,.167,9,13,.692,7,19,26,41,4,3,28,48,46,0.1
9394,Hayes Garrity\hayes-garrity-1,2016-17,Idaho State,G,11,1,191,15,51,.294,7,23,.304,8,28,.286,8,9,.889,3,17,20,9,8,0,16,11,46,1.5
9395,Andrew Ramirez\andrew-ramirez-1,2017-18,Hartford,G,28,0,199,17,43,.395,13,29,.448,4,14,.286,8,17,.471,2,18,20,12,11,0,15,20,46,0.8
9396,Malique Trent\malique-trent-1,2016-17,Texas Christian,G,12,3,148,15,42,.357,13,25,.520,2,17,.118,14,21,.667,2,12,14,12,11,1,15,17,46,1.9
9397,Madison Williams\madison-williams-1,2016-17,Illinois State,G,28,0,300,18,59,.305,17,40,.425,1,19,.053,9,21,.429,0,27,27,18,14,1,19,32,46,0.4
9398,Dominique Street\dominique-street-1,2014-15,Jackson State,G,10,4,152,14,63,.222,2,13,.154,12,50,.240,6,7,.857,5,13,18,4,3,1,5,11,46,1.2
9399,Rashad Jackson\rashad-jackson-1,2017-18,Portland,G,15,0,118,13,38,.342,8,24,.333,5,14,.357,15,19,.789,2,8,10,5,7,1,8,18,46,1.5
9400,Jax Levitch\jax-levitch-1,2016-17,Purdue-Fort Wayne,G,25,0,246,16,29,.552,3,5,.600,13,24,.542,1,3,.333,11,25,36,11,9,3,9,20,46,1.9
9401,Oliver Tot\oliver-tot-1,2017-18,William & Mary,G,31,1,347,14,31,.452,10,21,.476,4,10,.400,14,18,.778,7,25,32,42,10,6,20,46,46,1.5
9402,B.J. Miller\bj-miller-2,2016-17,Troy,G,36,0,327,17,48,.354,13,26,.500,4,22,.182,8,15,.533,4,35,39,29,14,3,20,25,46,1.0
9403,Burton Sampson\burton-sampson-1,2017-18,Belmont,G,31,0,303,12,35,.343,9,17,.529,3,18,.167,19,23,.826,9,18,27,17,2,3,16,31,46,0.8
9404,Christian Hairston\christian-hairston-1,2013-14,Elon,G,26,0,146,18,37,.486,17,30,.567,1,7,.143,9,12,.750,9,32,41,5,2,1,10,15,46,1.2
9405,Rodney Simeon\rodney-simeon-1,2014-15,Tennessee State,G,21,6,232,14,65,.215,1,13,.077,13,52,.250,5,6,.833,5,21,26,4,2,1,15,22,46,-0.1
9406,Nate Johnson\nate-johnson-6,2017-18,Gardner-Webb,G,12,0,136,17,51,.333,11,17,.647,6,34,.176,5,10,.500,3,13,16,15,6,5,14,6,45,2.0
9407,Prince Cooper\prince-cooper-1,2015-16,Louisiana-Monroe,G,18,1,145,16,34,.471,16,33,.485,0,1,.000,13,18,.722,5,20,25,7,0,0,14,12,45,1.2
9408,Valerio Altheimer\valerio-altheimer-1,2014-15,Grambling,G,26,2,230,17,48,.354,15,35,.429,2,13,.154,9,19,.474,13,21,34,4,5,2,16,28,45,0.4
9409,Raeford Worsham\raeford-worsham-1,2013-14,Arkansas State,G,7,0,97,13,26,.500,11,21,.524,2,5,.400,17,24,.708,6,10,16,3,6,4,3,14,45,5.5
9410,William Jackson II\william-jacksonii-1,2015-16,Georgia,G,31,0,225,13,46,.283,3,16,.188,10,30,.333,9,12,.750,6,11,17,18,12,6,18,22,45,0.8
9411,John Kiser\john-kiser-1,2016-17,Valparaiso,G,24,1,247,18,32,.563,17,23,.739,1,9,.111,8,10,.800,17,36,53,16,4,6,6,27,45,2.3
9412,Tyree Griffin\tyree-griffin-1,2014-15,Oklahoma State,G,32,1,330,12,40,.300,8,24,.333,4,16,.250,17,23,.739,9,37,46,34,11,1,22,31,45,1.2
9413,C.J. Wiggins\cj-wiggins-1,2016-17,North Carolina Central,G,24,0,154,13,39,.333,11,30,.367,2,9,.222,17,23,.739,4,9,13,22,5,0,13,12,45,1.2
9414,Tyler Clement\tyler-clement-1,2016-17,Creighton,G,28,0,264,17,35,.486,10,16,.625,7,19,.368,4,7,.571,1,28,29,38,8,1,25,36,45,1.1
9415,Christian Carlyle\christian-carlyle-1,2016-17,Florida Gulf Coast,G,20,0,186,16,30,.533,14,24,.583,2,6,.333,11,17,.647,9,12,21,18,8,2,4,15,45,2.5
9416,Doug Brooks\doug-brooks-1,2013-14,Virginia Commonwealth,G,24,0,102,14,55,.255,3,16,.188,11,39,.282,6,8,.750,7,8,15,3,6,2,3,17,45,0.8
9417,Keljin Blevins\keljin-blevins-1,2014-15,Southern Mississippi,G,25,13,397,15,56,.268,11,25,.440,4,31,.129,11,21,.524,8,36,44,21,8,3,28,32,45,0.3
9418,Billy Brown\billy-brown-1,2016-17,North Dakota,G,23,0,211,14,48,.292,6,15,.400,8,33,.242,9,9,1.000,4,19,23,10,7,0,10,18,45,1.0
9419,Treyvon Francis\treyvon-francis-1,2014-15,Savannah State,G,30,15,483,17,78,.218,13,39,.333,4,39,.103,7,15,.467,12,31,43,20,30,5,35,38,45,0.3
9420,Brevin Pritzl\brevin-pritzl-1,2016-17,Wisconsin,G,24,0,207,13,38,.342,8,17,.471,5,21,.238,14,19,.737,14,12,26,2,7,0,5,18,45,1.3
9421,Brandon Kamga\brandon-kamga-1,2015-16,Northeastern,G,15,0,101,16,35,.457,11,26,.423,5,9,.556,8,16,.500,7,10,17,4,4,0,5,11,45,1.9
9422,Earl McLaurin\earl-mclaurin-1,2013-14,Navy,G,28,17,400,11,38,.289,4,20,.200,7,18,.389,16,27,.593,6,32,38,47,16,2,28,33,45,1.5
9423,Gunnar Olafsson\gunnar-olafsson-1,2014-15,St. Francis (NY),G,28,4,311,15,48,.313,4,6,.667,11,42,.262,4,6,.667,10,23,33,4,6,3,17,27,45,0.5
9424,Leo Vincent\leo-vincent-1,2013-14,Sacred Heart,G,7,0,100,16,41,.390,10,18,.556,6,23,.261,7,7,1.000,2,9,11,0,5,0,8,16,45,2.5
9425,Devin Joint\devin-joint-1,2014-15,South Carolina State,G,28,11,366,20,48,.417,20,47,.426,0,1,.000,5,15,.333,31,49,80,15,11,5,20,52,45,1.3
9426,Christian Adams\christian-adams-1,2017-18,Coastal Carolina,G,25,12,373,14,47,.298,10,31,.323,4,16,.250,13,17,.765,4,39,43,16,7,4,30,43,45,0.2
9427,Austin Carroll\austin-carroll-1,2013-14,American,G,25,0,169,14,38,.368,2,4,.500,12,34,.353,5,7,.714,2,15,17,9,3,0,7,20,45,0.9
9428,D'Erryl Williams\derryl-williams-1,2016-17,San Diego State,G,28,1,331,18,46,.391,15,37,.405,3,9,.333,6,11,.545,11,41,52,31,14,0,19,26,45,1.6
9429,Spencer Turner\spencer-turner-1,2013-14,Belmont,G,27,0,145,15,39,.385,1,4,.250,14,35,.400,1,3,.333,3,10,13,15,3,0,6,11,45,1.2
9430,John Schurman\john-schurman-1,2016-17,Binghamton,G,15,0,101,16,35,.457,3,8,.375,13,27,.481,0,4,.000,4,16,20,3,1,1,3,8,45,2.0
9431,Keon Burns\keon-burns-1,2016-17,New Hampshire,G,27,0,372,16,55,.291,7,17,.412,9,38,.237,4,5,.800,7,35,42,18,5,0,16,19,45,0.8
9432,Tommy McDonnell\tommy-mcdonnell-1,2013-14,New Hampshire,G,29,7,420,14,48,.292,11,38,.289,3,10,.300,14,18,.778,35,65,100,24,16,0,29,35,45,1.7
9433,Derrick Brooks\derrick-brooks-1,2014-15,Wofford,G,32,0,304,18,50,.360,16,39,.410,2,11,.182,7,18,.389,1,30,31,23,8,3,28,25,45,0.3
9434,Connor Wheeler\connor-wheeler-1,2015-16,Southern Illinois-Edwardsville,G,22,0,251,14,63,.222,6,24,.250,8,39,.205,9,13,.692,3,21,24,22,9,1,12,33,45,0.6
9435,Noah Springwater\noah-springwater-1,2014-15,Columbia,G,23,0,176,11,29,.379,0,0,,11,29,.379,12,14,.857,0,12,12,4,10,4,4,25,45,1.5
9436,Jason Williams\jason-williams-10,2016-17,East Tennessee State,G,23,1,214,12,41,.293,4,16,.250,8,25,.320,13,16,.813,1,21,22,30,9,0,23,20,45,1.1
9437,Kadavion Evans\kadavion-evans-1,2016-17,Louisiana,G,15,0,162,15,46,.326,6,12,.500,9,34,.265,6,7,.857,2,10,12,27,7,1,9,22,45,2.1
9438,Khaliq Ghani\khaliq-ghani-1,2014-15,Yale,G,21,0,146,13,23,.565,5,8,.625,8,15,.533,11,14,.786,5,12,17,8,3,3,9,15,45,1.7
9439,Valerio Altheimer\valerio-altheimer-1,2015-16,Grambling,G,26,0,167,18,36,.500,18,34,.529,0,2,.000,9,19,.474,17,31,48,6,9,1,4,18,45,1.8
9440,Joe Kuligoski\joe-kuligoski-1,2016-17,Eastern Illinois,G,25,2,172,16,42,.381,9,18,.500,7,24,.292,6,10,.600,7,16,23,16,3,4,11,29,45,1.0
9441,Matthew Cotton\matthew-cotton-1,2015-16,Alabama A&M,G,26,5,186,12,33,.364,7,17,.412,5,16,.313,15,20,.750,8,14,22,20,4,0,15,11,44,1.2
9442,Jordan Capps\jordan-capps-1,2016-17,Southeastern Louisiana,G,2,2,57,17,23,.739,16,21,.762,1,2,.500,9,17,.529,3,14,17,2,1,0,6,5,44,16.1
9443,Elliott Pitts\elliott-pitts-1,2013-14,Arizona,G,24,0,201,15,35,.429,4,7,.571,11,28,.393,3,8,.375,7,17,24,6,4,0,6,20,44,1.2
9444,Jordin Mayes\jordin-mayes-1,2013-14,Arizona,G,34,1,195,15,45,.333,12,30,.400,3,15,.200,11,17,.647,5,12,17,18,9,0,13,23,44,0.7
9445,Jake Holtzmann\jake-holtzmann-1,2015-16,Denver,G,24,0,219,12,40,.300,7,17,.412,5,23,.217,15,19,.789,7,17,24,18,3,1,14,20,44,1.0
9446,Giovanni Smith\giovanni-smith-1,2013-14,Jacksonville State,G,21,4,192,13,34,.382,1,6,.167,12,28,.429,6,8,.750,0,12,12,8,3,0,3,13,44,1.4
9447,Chase Cormier\chase-comier-1,2015-16,Grambling,G,27,23,510,10,40,.250,7,29,.241,3,11,.273,21,43,.488,12,34,46,51,26,0,39,56,44,1.1
9448,Richaud Gittens\richaud-gittens-1,2016-17,Weber State,G,6,0,120,16,35,.457,10,19,.526,6,16,.375,6,8,.750,2,24,26,10,5,0,12,9,44,5.0
9449,Saul Phiri\saul-phiri-1,2016-17,La Salle,G,24,1,150,14,39,.359,6,12,.500,8,27,.296,8,13,.615,7,14,21,4,5,2,7,15,44,1.1
9450,Victor Bermudez\victor-bermudez-1,2014-15,Texas State,G,22,0,151,16,49,.327,5,17,.294,11,32,.344,1,5,.200,3,6,9,11,3,0,8,16,44,0.7
9451,Devontae Morgan\devontae-morgan-1,2015-16,James Madison,G,22,0,173,16,31,.516,15,27,.556,1,4,.250,11,31,.355,6,17,23,19,8,4,7,23,44,1.7
9452,Trevor Stumpe\trevor-stumpe-1,2015-16,Wofford,G,17,0,108,16,31,.516,11,16,.688,5,15,.333,7,7,1.000,2,7,9,6,2,0,2,16,44,1.8
9453,Anders Broman\anders-broman-1,2014-15,South Dakota State,G,19,0,114,9,23,.391,5,14,.357,4,9,.444,22,33,.667,1,13,14,7,4,0,5,8,44,1.7
9454,Richard Lee\richard-lee-1,2014-15,Tennessee-Martin,G,25,0,185,16,34,.471,6,13,.462,10,21,.476,2,3,.667,4,8,12,2,2,0,4,15,44,1.0
9455,Jalen Richard\jalen-richard-1,2014-15,Santa Clara,G,29,0,286,15,44,.341,11,25,.440,4,19,.211,10,18,.556,12,31,43,21,7,1,19,24,44,0.9
9456,Christian Benzon\christian-benzon-1,2015-16,Evansville,G,24,0,160,17,33,.515,17,32,.531,0,1,.000,10,20,.500,6,24,30,10,4,2,6,29,44,1.2
9457,Lawrence Cooks\lawrence-cooks-1,2014-15,Hampton,G,20,0,169,17,52,.327,13,30,.433,4,22,.182,6,10,.600,6,20,26,5,8,0,12,15,44,0.8
9458,Josh Heath\josh-heath-2,2013-14,South Florida,G,17,4,340,16,47,.340,14,38,.368,2,9,.222,10,13,.769,7,17,24,62,12,2,27,22,44,2.8
9459,John Schurman\john-schurman-1,2015-16,Binghamton,G,24,0,175,16,62,.258,4,9,.444,12,53,.226,0,1,.000,7,15,22,2,3,1,3,11,44,0.6
9460,Rene Castro\rene-castro-1,2015-16,Duquesne,G,17,0,130,15,48,.313,11,28,.393,4,20,.200,10,16,.625,3,7,10,10,2,0,15,12,44,0.4
9461,Michael Corchiani\michael-corchiani-1,2016-17,Southeastern Louisiana,G,30,0,267,12,33,.364,2,8,.250,10,25,.400,10,17,.588,3,26,29,25,16,0,21,46,44,0.9
9462,Ameer Jackson\ameer-jackson-1,2015-16,Sam Houston State,G,4,1,99,12,37,.324,6,20,.300,6,17,.353,14,25,.560,3,5,8,6,0,1,6,9,44,4.4
9463,Stefan Cvrkalj\stefan-cvrkalj-1,2014-15,Lehigh,G,25,1,216,16,61,.262,5,13,.385,11,48,.229,1,3,.333,9,24,33,11,5,1,4,23,44,0.8
9464,Jarvis Pugh\jarvis-pugh-1,2015-16,Santa Clara,G,10,2,215,18,41,.439,18,40,.450,0,1,.000,8,17,.471,13,35,48,9,8,2,12,37,44,2.7
9465,Tyler Maye\tyler-maye-1,2017-18,Virginia Commonwealth,G,32,0,238,17,46,.370,15,39,.385,2,7,.286,8,15,.533,3,13,16,16,11,1,16,26,44,0.6
9466,Kamil Williams\kamil-williams-1,2016-17,Savannah State,G,13,0,126,13,54,.241,4,11,.364,9,43,.209,9,12,.750,4,16,20,7,7,0,7,14,44,1.3
9467,Cam Delaney\cam-delaney-1,2014-15,Denver,G,18,6,244,15,46,.326,10,23,.435,5,23,.217,9,14,.643,6,24,30,14,12,1,4,31,44,1.9
9468,Keierre Richards\keierre-richards-1,2014-15,Savannah State,G,17,12,343,15,55,.273,14,42,.333,1,13,.077,13,18,.722,5,20,25,14,9,1,23,34,44,0.1
9469,Austin Grandstaff\austin-grandstaff-1,2015-16,Ohio State,G,10,0,115,16,41,.390,4,5,.800,12,36,.333,0,0,,0,3,3,0,3,0,6,6,44,1.7
9470,Justin Wright-Foreman\justin-wright-foreman-1,2015-16,Hofstra,G,27,0,110,17,38,.447,13,21,.619,4,17,.235,6,11,.545,1,8,9,4,4,3,7,13,44,0.8
9471,Khari Price\khari-price-1,2016-17,Southern Mississippi,G,5,5,161,13,44,.295,8,22,.364,5,22,.227,13,14,.929,4,11,15,21,4,0,12,18,44,4.7
9472,Christopher Hyder\christopher-hyder-1,2013-14,Southern,G,16,11,411,16,35,.457,16,31,.516,0,4,.000,12,20,.600,9,37,46,85,23,0,20,29,44,5.7
9473,Matt Fox\matt-fox-1,2015-16,Bowling Green State,G,18,1,134,14,35,.400,0,1,.000,14,34,.412,2,2,1.000,3,6,9,0,3,1,2,9,44,1.5
9474,Sam Singer\sam-singer-1,2013-14,University of California,G,32,0,298,15,41,.366,10,25,.400,5,16,.313,9,19,.474,7,20,27,41,11,1,16,30,44,1.3
9475,William Gates\william-gates-2,2016-17,Houston Baptist,G,18,1,151,12,30,.400,9,18,.500,3,12,.250,17,30,.567,3,12,15,5,5,0,11,18,44,1.0
9476,Andrea Bernardi\andrea-bernardi-1,2017-18,Marist,G,20,0,127,10,30,.333,6,14,.429,4,16,.250,20,26,.769,7,11,18,6,8,2,20,17,44,1.0
9477,Dre Wills\dre-willis-1,2013-14,Vermont,G,19,0,126,16,26,.615,15,23,.652,1,3,.333,11,16,.688,9,27,36,5,13,9,9,17,44,2.7
9478,Charles Taylor\charles-taylor-1,2014-15,Maryland-Baltimore County,G,10,0,154,18,47,.383,18,46,.391,0,1,.000,8,13,.615,13,20,33,7,5,2,17,19,44,1.8
9479,Andrew White III\andrew-whiteiii-1,2013-14,Kansas,G,18,0,113,15,34,.441,7,9,.778,8,25,.320,6,12,.500,4,18,22,4,5,3,7,10,44,1.7
9480,Tai Bibbs\tai-bibbs-1,2017-18,Columbia,G,13,0,159,13,39,.333,6,16,.375,7,23,.304,11,16,.688,4,13,17,5,2,0,4,14,44,1.7
9481,Mark Blackmon\mark-blackmon-1,2013-14,Maryland-Eastern Shore,G,15,1,133,13,39,.333,6,19,.316,7,20,.350,11,19,.579,4,4,8,9,9,0,10,21,44,1.3
9482,Nick Colletta\nick-colletta-1,2014-15,Marist,G,18,2,185,16,53,.302,5,10,.500,11,43,.256,1,1,1.000,1,12,13,3,4,2,5,7,44,1.0
9483,Joshua White\joshua-white-1,2015-16,Southern Illinois-Edwardsville,G,11,5,133,17,42,.405,11,18,.611,6,24,.250,3,7,.429,3,8,11,8,4,0,11,10,43,1.6
9484,Stefan Borovac\stefan-borovac-1,2017-18,Massachusetts-Lowell,G,19,0,172,17,31,.548,16,24,.667,1,7,.143,8,21,.381,7,25,32,10,7,2,16,32,43,1.2
9485,Ben Grace\ben-grace-1,2015-16,Maryland-Baltimore County,G,23,0,165,13,29,.448,1,3,.333,12,26,.462,5,6,.833,1,12,13,12,4,0,7,18,43,1.3
9486,Celio Araujo\celio-araujo-1,2017-18,Maine,G,32,18,567,12,44,.273,8,20,.400,4,24,.167,15,19,.789,3,38,41,61,27,2,36,53,43,1.3
9487,Ty Gibson\ty-gibson-1,2015-16,Eastern Washington,G,27,2,186,13,38,.342,3,5,.600,10,33,.303,7,11,.636,5,11,16,13,4,0,6,19,43,1.0
9488,Connor Burchfield\connor-burchfield-1,2014-15,William & Mary,G,18,0,156,15,36,.417,5,9,.556,10,27,.370,3,3,1.000,1,24,25,2,3,0,7,11,43,1.4
9489,Chris Mejia\chris-mejia-1,2016-17,Southeastern Louisiana,G,22,1,136,15,38,.395,2,4,.500,13,34,.382,0,0,,1,6,7,4,1,1,2,19,43,0.9
9490,Preston Mattingly\preston-mattingly-1,2013-14,Lamar,G,19,3,211,16,44,.364,11,24,.458,5,20,.250,6,13,.462,11,21,32,12,3,1,5,22,43,1.5
9491,Emmanuel Toney\emmanuel-toney-1,2017-18,Texas A&M-Corpus Christi,G,6,5,157,16,33,.485,8,16,.500,8,17,.471,3,6,.500,3,11,14,16,5,2,12,11,43,5.3
9492,Marcus Neely\marcus-neely-1,2014-15,North Carolina-Asheville,G,22,6,214,15,39,.385,15,37,.405,0,2,.000,13,20,.650,18,26,44,9,5,9,8,26,43,1.8
9493,Kai Tease\kai-tease-1,2017-18,Howard,G,10,4,121,14,43,.326,3,14,.214,11,29,.379,4,6,.667,3,5,8,4,2,0,10,7,43,1.3
9494,Malachy Onwudiegwu\malachy-onwudiegwu-1,2015-16,Alcorn State,G,25,4,234,13,57,.228,7,28,.250,6,29,.207,11,23,.478,9,9,18,5,3,1,18,25,43,-0.3
9495,Joe Hanstad\joe-hanstad-1,2014-15,Boise State,G,20,4,207,15,42,.357,6,13,.462,9,29,.310,4,7,.571,2,16,18,15,4,1,6,11,43,1.5
9496,Will Goff\will-goff-1,2014-15,Boston University,G,28,2,238,11,27,.407,3,8,.375,8,19,.421,13,14,.929,4,12,16,9,5,0,7,20,43,1.1
9497,Chris Robinson\chris-robinson-2,2014-15,Sacred Heart,G,21,0,143,16,50,.320,14,36,.389,2,14,.143,9,22,.409,13,13,26,2,4,0,4,24,43,0.7
9498,Khalil Small\khalil-small-1,2014-15,Green Bay,G,20,0,134,12,36,.333,9,29,.310,3,7,.429,16,25,.640,10,16,26,6,8,0,9,14,43,1.4
9499,Malick Kone\malick-kone-1,2014-15,Rutgers,G,24,2,278,16,52,.308,12,38,.316,4,14,.286,7,16,.438,15,23,38,15,9,3,16,25,43,0.9
9500,Eric Hester\eric-hester-1,2016-17,Florida,G,18,0,111,15,23,.652,4,4,1.000,11,19,.579,2,4,.500,1,9,10,6,6,0,3,13,43,2.1
9501,Xairius Larry\xairius-larry-1,2016-17,Grambling,G,27,0,123,13,36,.361,2,7,.286,11,29,.379,6,12,.500,4,8,12,6,7,1,6,18,43,0.9
9502,Isaiah Blackmon\isaiah-blackmon-1,2017-18,Saint Francis (PA),G,3,3,84,16,37,.432,13,27,.481,3,10,.300,8,11,.727,3,6,9,3,5,1,4,3,43,9.6
9503,Camryn Crocker\camryn-crocker-1,2014-15,Pennsylvania,G,26,1,281,14,39,.359,7,20,.350,7,19,.368,8,14,.571,6,26,32,23,8,3,18,27,43,1.1
9504,Dalan Ancrum\dalan-ancrum-1,2015-16,Western Illinois,G,14,0,122,16,32,.500,14,21,.667,2,11,.182,9,12,.750,9,15,24,11,5,2,5,15,43,2.8
9505,Gabe DeVoe\gabe-devoe-1,2014-15,Clemson,G,19,0,162,15,56,.268,6,20,.300,9,36,.250,4,7,.571,2,15,17,10,7,0,3,16,43,1.0
9506,Alex Carr\alex-carr-2,2015-16,Utah Valley,G,28,8,296,15,50,.300,3,12,.250,12,38,.316,1,5,.200,4,56,60,9,12,2,18,55,43,0.4
9507,Dimencio Vaughn\dimencio-vaughn-1,2016-17,Rider,G,9,0,128,16,39,.410,14,32,.438,2,7,.286,9,14,.643,13,22,35,1,9,1,15,13,43,2.9
9508,Riley Norris\riley-norris-1,2017-18,Alabama,G,9,3,166,16,37,.432,10,17,.588,6,20,.300,5,8,.625,6,16,22,6,4,0,5,19,43,3.0
9509,Malik Metoyer\malik-metoyer-1,2016-17,Northwestern State,G,10,0,144,12,25,.480,11,22,.500,1,3,.333,18,26,.692,10,27,37,8,6,6,10,13,43,4.3
9510,Evan Wessel\evan-wessel-1,2013-14,Wichita State,G,35,0,433,16,43,.372,13,18,.722,3,25,.120,7,17,.412,29,36,65,9,10,6,13,52,42,0.9
9511,Patrick Triplett\patrick-triplett-1,2014-15,Brown,G,23,0,178,12,47,.255,8,26,.308,4,21,.190,14,20,.700,4,23,27,13,1,3,22,14,42,0.3
9512,Bryan Alberts\bryan-alberts-1,2016-17,Gonzaga,G,23,0,135,15,49,.306,9,20,.450,6,29,.207,6,10,.600,1,12,13,24,9,2,4,11,42,1.5
9513,Chris Sullivan\chris-sullivan-1,2016-17,Brown,G,25,0,203,12,31,.387,0,4,.000,12,27,.444,6,6,1.000,5,22,27,3,9,0,5,18,42,1.4
9514,Alexander Aka Gorski\alexander-aka-gorski-1,2014-15,Wyoming,G,20,0,167,13,42,.310,5,12,.417,8,30,.267,8,16,.500,8,5,13,2,3,0,8,10,42,0.7
9515,Jerry Perry\jerry-perry-1,2017-18,Texas Southern,G,11,5,202,10,28,.357,7,20,.350,3,8,.375,19,26,.731,6,9,15,19,6,0,16,15,42,2.5
9516,Johnny Woodard\johnny-woodard-1,2015-16,Tennessee State,G,7,2,117,13,33,.394,1,4,.250,12,29,.414,4,5,.800,3,12,15,5,1,1,8,10,42,3.2
9517,Ishmail Jabbie\ishmail-jabbie-1,2017-18,Maryland-Baltimore County,G,18,0,124,13,30,.433,7,14,.500,6,16,.375,10,13,.769,7,13,20,6,7,1,13,12,42,1.6
9518,Evann Hall\evann-hall-1,2015-16,Idaho State,G,17,1,165,16,32,.500,16,32,.500,0,0,,10,21,.476,7,32,39,6,4,2,7,17,42,1.9
9519,Giovanni Mack\giovanni-mack-1,2014-15,Texas Southern,G,24,1,223,13,34,.382,6,17,.353,7,17,.412,9,14,.643,3,18,21,14,6,1,8,16,42,1.3
9520,Eli Stalzer\eli-stalzer-1,2013-14,Colorado,G,27,0,225,13,32,.406,8,17,.471,5,15,.333,11,18,.611,6,16,22,8,7,0,11,18,42,0.9
9521,Devon Hall\devon-hall-1,2014-15,Virginia,G,23,1,244,16,40,.400,11,25,.440,5,15,.333,5,11,.455,2,15,17,18,9,1,12,18,42,1.2
9522,Tyler Brimhall\tyler-brimhall-1,2016-17,Idaho,G,18,0,133,13,47,.277,3,13,.231,10,34,.294,6,8,.750,9,11,20,5,6,0,7,12,42,1.2
9523,Ishmail Wainright\ish-wainright-1,2014-15,Baylor,G,31,0,298,11,28,.393,9,18,.500,2,10,.200,18,25,.720,20,34,54,24,6,1,16,33,42,1.4
9524,Colby Leifson\colby-leifson-1,2016-17,Brigham Young,G,26,0,110,14,43,.326,1,4,.250,13,39,.333,1,2,.500,3,5,8,6,2,0,6,16,42,0.6
9525,Desmond Ridenour\desmond-ridenour-1,2014-15,Duquesne,G,21,0,166,14,38,.368,8,21,.381,6,17,.353,8,18,.444,3,12,15,17,9,0,15,22,42,0.9
9526,Mark Blackmon\mark-blackmon-1,2015-16,Maryland-Eastern Shore,G,32,0,301,13,39,.333,7,22,.318,6,17,.353,10,15,.667,11,18,29,16,20,0,15,40,42,1.0
9527,Dashawn McDowell\dashawn-mcdowell-1,2016-17,Southern Methodist,G,29,0,231,14,31,.452,12,27,.444,2,4,.500,12,28,.429,13,16,29,14,6,2,16,25,42,0.8
9528,Trey Patterson\trey-patterson-1,2014-15,Houston Baptist,G,20,0,188,15,27,.556,15,23,.652,0,4,.000,12,23,.522,4,8,12,16,11,0,22,31,42,0.9
9529,Jalen Williams\jalen-williams-12,2016-17,High Point,G,31,2,445,14,64,.219,9,39,.231,5,25,.200,9,20,.450,9,15,24,42,7,1,29,40,42,0.0
9530,Jacob Kurtz\jacob-kurtz-1,2013-14,Florida,G,26,0,219,17,27,.630,17,27,.630,0,0,,8,16,.500,13,25,38,7,6,1,8,14,42,1.6
9531,Kevin Zabo\kevin-zabo-1,2014-15,San Diego State,G,16,0,175,14,39,.359,9,25,.360,5,14,.357,9,16,.563,3,13,16,9,5,0,15,12,42,0.9
9532,Miles Overton\miles-overton-1,2017-18,Drexel,G,10,1,126,14,48,.292,6,17,.353,8,31,.258,6,6,1.000,1,10,11,5,2,1,10,19,42,0.6
9533,Isiah Patterson\isiah-patterson-1,2014-15,Grambling,G,27,0,175,13,40,.325,4,15,.267,9,25,.360,7,10,.700,3,11,14,8,4,0,10,7,42,0.7
9534,Justin Bibbins\justin-bibbins-1,2014-15,Cal State Long Beach,G,33,0,259,12,37,.324,9,16,.563,3,21,.143,15,24,.625,3,12,15,27,5,0,19,27,42,0.5
9535,Brandon Thomas\brandon-thomas-4,2017-18,Hawaii,G,23,1,191,14,46,.304,6,13,.462,8,33,.242,6,13,.462,4,14,18,7,2,1,5,15,42,0.7
9536,J'Mychal Reese\jmychal-reese-1,2013-14,Texas A&M,G,6,0,96,15,32,.469,12,25,.480,3,7,.429,9,13,.692,2,10,12,6,3,2,12,12,42,3.4
9537,Caleb Starks\caleb-starks-1,2017-18,Northwestern State,G,27,3,256,17,56,.304,15,42,.357,2,14,.143,6,11,.545,14,15,29,9,5,0,22,26,42,0.0
9538,Nelson Kaputo\nelson-kaputo-1,2016-17,St. Bonaventure,G,21,2,183,11,29,.379,1,6,.167,10,23,.435,10,13,.769,0,6,6,17,3,0,12,21,42,1.0
9539,Daine Muller\daine-muller-1,2016-17,Oregon State,G,21,1,207,13,28,.464,0,0,,13,28,.464,3,4,.750,1,17,18,18,3,0,9,19,42,1.5
9540,Jaylen Stowe\jaylen-stowe-1,2016-17,Mercer,G,26,0,184,14,32,.438,11,19,.579,3,13,.231,11,15,.733,4,30,34,9,2,1,8,21,42,1.1
9541,Shakaris Laney\sharkaris-laney-1,2014-15,Central Connecticut State,G,24,3,226,15,51,.294,10,24,.417,5,27,.185,7,9,.778,9,14,23,14,6,3,7,20,42,1.0
9542,Shawn Montague\shawn-montague-1,2016-17,Sacred Heart,G,22,0,161,16,31,.516,14,27,.519,2,4,.500,8,21,.381,16,34,50,4,5,0,11,15,42,1.5
9543,Mike Fleming\mike-fleming-1,2013-14,Dartmouth,G,18,0,174,9,33,.273,7,17,.412,2,16,.125,22,26,.846,4,6,10,14,5,0,12,23,42,1.1
9544,Shea Jones\shea-jones-1,2014-15,Jacksonville,G,17,2,209,13,37,.351,2,16,.125,11,21,.524,5,13,.385,6,19,25,14,5,4,18,21,42,1.1
9545,Brian Patrick\brian-patrick-1,2017-18,Kansas State,G,26,0,204,15,47,.319,5,7,.714,10,40,.250,2,2,1.000,5,11,16,10,5,0,6,27,42,0.7
9546,Von Julien\von-julien-1,2016-17,Tulane,G,17,1,204,15,37,.405,6,16,.375,9,21,.429,3,11,.273,4,13,17,22,6,0,9,18,42,1.8
9547,Troy Simmons\troy-simmons-1,2014-15,Bethune-Cookman,G,27,6,369,12,34,.353,9,26,.346,3,8,.375,15,20,.750,2,20,22,32,14,2,27,29,42,1.0
9548,Marquis Nelson\marquis-nelson-1,2014-15,Nicholls State,G,21,3,210,16,46,.348,8,24,.333,8,22,.364,2,8,.250,5,13,18,10,4,2,19,22,42,0.3
9549,David Levitch\david-levitch-1,2015-16,Louisville,G,18,0,127,13,20,.650,5,8,.625,8,12,.667,8,11,.727,4,8,12,9,5,0,5,10,42,2.2
9550,Christian Benzon\christian-benzon-1,2014-15,Evansville,G,31,0,232,12,33,.364,12,30,.400,0,3,.000,18,24,.750,7,29,36,12,5,1,18,22,42,0.7
9551,Anthony Swan\anthony-swan-1,2017-18,Cal State Northridge,G,22,0,206,17,49,.347,9,20,.450,8,29,.276,0,1,.000,5,18,23,17,7,9,7,17,42,1.6
9552,DJ Mlachnik\dj-mlachnik-1,2015-16,Massachusetts-Lowell,G,16,1,109,14,37,.378,6,10,.600,8,27,.296,6,10,.600,0,8,8,4,1,0,4,17,42,1.0
9553,Damarkeo Lyshe\damarkeo-lyshe-1,2013-14,Bowling Green State,G,26,0,175,13,41,.317,6,14,.429,7,27,.259,9,12,.750,6,5,11,11,5,0,9,32,42,0.5
9554,Jalen Ross\jalen-ross-1,2013-14,Eastern Michigan,G,26,1,346,15,61,.246,12,35,.343,3,26,.115,9,23,.391,2,36,38,28,10,0,12,22,42,0.8
9555,JT Gibson\jt-gibson-1,2015-16,Omaha,G,9,1,114,16,37,.432,8,12,.667,8,25,.320,2,2,1.000,4,11,15,8,1,1,5,15,42,2.8
9556,Jakolby Long\jakolby-long-1,2017-18,Iowa State,G,22,0,209,14,40,.350,5,19,.263,9,21,.429,4,8,.500,5,24,29,13,4,0,8,26,41,1.0
9557,Chaz Glotta\chaz-glotta-1,2014-15,Southern Illinois,G,19,0,127,11,38,.289,3,8,.375,8,30,.267,11,13,.846,1,3,4,4,7,0,6,19,41,0.8
9558,Ojai Black\ojai-black-1,2014-15,Texas State,G,31,1,377,12,41,.293,8,27,.296,4,14,.286,13,17,.765,5,23,28,23,11,2,21,32,41,0.7
9559,Aaron Young\aaron-young-2,2016-17,Princeton,G,27,0,123,12,34,.353,0,2,.000,12,32,.375,5,6,.833,3,11,14,3,3,0,1,10,41,1.0
9560,Mike Turner\mike-turner-3,2013-14,Houston Baptist,G,14,0,88,13,29,.448,1,5,.200,12,24,.500,3,4,.750,2,7,9,2,3,2,3,9,41,2.0
9561,Jordan Roland\jordan-roland-1,2015-16,George Washington,G,35,0,163,11,45,.244,9,31,.290,2,14,.143,17,22,.773,5,9,14,5,5,1,5,22,41,0.4
9562,Rahjan Muhammad\rahjan-muhammad-1,2014-15,Chicago State,G,12,0,89,15,37,.405,11,22,.500,4,15,.267,7,9,.778,3,11,14,2,9,0,10,8,41,1.9
9563,Phil Bledsoe\phil-bledsoe-1,2016-17,Marshall,G,16,0,115,11,30,.367,6,19,.316,5,11,.455,14,21,.667,11,21,32,3,3,0,2,10,41,2.2
9564,Haanif Cheatham\haanif-cheatham-1,2017-18,Marquette,G,5,5,131,16,37,.432,11,24,.458,5,13,.385,4,7,.571,2,12,14,7,5,0,8,7,41,4.9
9565,Terry Harris\terry-harris-1,2017-18,Eastern Michigan,G,15,6,161,14,40,.350,5,13,.385,9,27,.333,4,8,.500,4,10,14,6,3,1,5,6,41,1.6
9566,Michael Fleming\michael-fleming-1,2015-16,Dartmouth,G,22,6,269,16,33,.485,9,14,.643,7,19,.368,2,3,.667,6,9,15,15,4,0,19,24,41,0.8
9567,George King\george-king-1,2013-14,Colorado,G,27,0,148,11,39,.282,7,19,.368,4,20,.200,15,23,.652,5,36,41,5,4,1,12,14,41,0.7
9568,Devin Harris\devin-harris-2,2013-14,East Tennessee State,G,18,1,166,15,39,.385,13,31,.419,2,8,.250,9,13,.692,4,25,29,10,8,0,17,10,41,1.2
9569,A.J. Lapray\aj-lapray-1,2015-16,Pepperdine,G,14,0,171,14,37,.378,2,8,.250,12,29,.414,1,2,.500,1,17,18,9,5,1,7,15,41,1.8
9570,Joe Quintana\joe-quintana-1,2017-18,Loyola Marymount,G,21,7,214,15,59,.254,4,21,.190,11,38,.289,0,0,,4,8,12,15,8,1,13,14,41,0.5
9571,Tony Bagtas\tony-bagtas-1,2013-14,Pennsylvania,G,20,6,271,16,45,.356,13,34,.382,3,11,.273,6,8,.750,2,21,23,40,13,1,25,23,41,1.5
9572,Markell Henderson\markell-henderson-1,2015-16,Tennessee Tech,G,21,0,124,16,33,.485,10,17,.588,6,16,.375,3,6,.500,10,20,30,3,4,2,5,15,41,1.6
9573,Brendon Myles\brendon-myles-1,2017-18,Florida A&M,G,34,4,400,17,56,.304,17,52,.327,0,4,.000,7,11,.636,19,42,61,9,13,5,33,36,41,0.2
9574,Deuce Bello\deuce-bello-1,2014-15,Missouri,G,23,3,251,16,42,.381,12,26,.462,4,16,.250,5,15,.333,5,20,25,9,6,5,18,40,41,0.2
9575,Jaylen Hinton\jaylen-hinton-1,2013-14,Georgia State,G,29,0,210,13,32,.406,13,30,.433,0,2,.000,15,27,.556,4,14,18,23,8,2,4,21,41,1.3
9576,Daniel Venzant\daniel-venzant-1,2017-18,Cal State Fullerton,G,24,1,138,17,35,.486,14,23,.609,3,12,.250,4,11,.364,0,14,14,12,3,0,9,14,41,0.9
9577,Nelson Maxwell\nelson-maxwell-1,2015-16,Cleveland State,G,16,0,237,12,34,.353,8,28,.286,4,6,.667,13,16,.813,7,16,23,19,8,2,15,34,41,1.5
9578,Alex Austin\alex-austin-1,2015-16,Illinois,G,31,5,304,14,43,.326,8,15,.533,6,28,.214,7,11,.636,8,35,43,20,13,0,7,34,41,1.2
9579,Aaron Bright\aaron-bright-1,2013-14,Stanford,G,7,0,135,10,28,.357,3,10,.300,7,18,.389,14,19,.737,0,8,8,16,2,0,7,11,41,3.9
9580,Deschon Winston\deschon-winston-1,2017-18,University of California,G,25,2,163,15,50,.300,11,27,.407,4,23,.174,7,9,.778,5,11,16,7,4,0,18,17,41,0.1
9581,Trey Dickerson\trey-dickerson-1,2014-15,Iowa,G,15,0,146,17,49,.347,13,36,.361,4,13,.308,3,10,.300,1,6,7,18,7,0,15,15,41,0.8
9582,Austin Loop\austin-loop-1,2013-14,Marshall,G,13,0,75,13,33,.394,2,3,.667,11,30,.367,4,6,.667,0,3,3,4,2,1,1,12,41,1.8
9583,Jermaine Myers\jermaine-myers-1,2013-14,Fordham,G,25,6,247,13,32,.406,8,15,.533,5,17,.294,10,11,.909,4,11,15,28,8,0,8,20,41,1.6
9584,DeAndray Buckley\deandray-buckley-1,2013-14,Central Michigan,G,20,0,145,10,22,.455,8,15,.533,2,7,.286,19,30,.633,10,19,29,8,3,4,2,21,41,1.9
9585,Mattia Da Campo\mattia-dacampo-1,2017-18,Seattle,G,27,1,198,15,24,.625,11,15,.733,4,9,.444,7,11,.636,16,29,45,17,9,0,7,29,41,1.9
9586,Erik Nakken\erik-nakken-1,2017-18,Idaho State,G,28,2,243,13,40,.325,0,4,.000,13,36,.361,2,3,.667,2,14,16,8,1,1,6,17,41,0.6
9587,Kahlil Dukes\kahlil-dukes-1,2014-15,Southern California,G,20,0,144,16,40,.400,8,21,.381,8,19,.421,1,2,.500,1,4,5,4,1,0,3,11,41,0.9
9588,Eric Anderson\eric-anderson-2,2015-16,Yale,G,21,0,156,16,38,.421,13,29,.448,3,9,.333,6,11,.545,7,20,27,5,5,2,9,14,41,1.2
9589,Ladarius Coleman\ladarius-coleman-1,2015-16,Southeast Missouri State,G,6,0,141,15,40,.375,13,32,.406,2,8,.250,9,12,.750,13,22,35,7,4,0,13,12,41,4.1
9590,Amari Goulbourne\amari-goulbourne-1,2017-18,Alabama A&M,G,10,6,207,14,44,.318,8,27,.296,6,17,.353,6,10,.600,3,17,20,24,7,1,15,21,40,2.2
9591,Tony Kynard\tony-kynard-1,2014-15,Bethune-Cookman,G,11,0,204,15,57,.263,14,46,.304,1,11,.091,9,12,.750,8,8,16,30,12,0,20,24,40,1.5
9592,Tyrin Atwood\tyrin-atwood-1,2016-17,Lamar,G,15,0,97,14,32,.438,14,30,.467,0,2,.000,12,18,.667,6,13,19,4,2,2,3,8,40,1.9
9593,Derrick Green\derrick-green-1,2016-17,Jacksonville State,G,30,0,187,10,35,.286,5,18,.278,5,17,.294,15,28,.536,8,22,30,12,5,1,8,17,40,0.9
9594,Jake Silpe\jake-silpe-1,2017-18,Pennsylvania,G,21,0,159,15,34,.441,8,15,.533,7,19,.368,3,9,.333,4,17,21,14,6,0,3,13,40,1.7
9595,Kellon Thomas\kellon-thomas-1,2014-15,Kent State,G,8,0,138,12,42,.286,10,28,.357,2,14,.143,14,19,.737,0,10,10,10,6,0,10,13,40,1.8
9596,Jordan Jackson\jordan-jackson-3,2017-18,Texas-Rio Grande Valley,G,5,0,71,14,27,.519,13,17,.765,1,10,.100,11,16,.688,5,10,15,3,6,1,5,6,40,6.5
9597,Matt Taylor\matt-taylor-1,2014-15,New Mexico State,G,26,0,220,15,36,.417,14,30,.467,1,6,.167,9,16,.563,16,23,39,14,5,1,16,24,40,1.0
9598,Tre' Ivory\tre-ivory-1,2014-15,Austin Peay,G,21,1,237,13,51,.255,6,31,.194,7,20,.350,7,15,.467,3,14,17,18,8,1,13,21,40,0.6
9599,Tye Wilburn\tye-wilburn-1,2017-18,Wright State,G,20,1,178,12,30,.400,10,25,.400,2,5,.400,14,19,.737,8,29,37,16,18,0,12,15,40,2.4
9600,David Nichols\david-nichols-1,2015-16,Albany (NY),G,15,1,76,13,23,.565,11,17,.647,2,6,.333,12,17,.706,0,7,7,7,1,1,8,8,40,1.6
9601,Dontay Jackson\dontay-jackson-2,2014-15,Jacksonville State,G,28,8,336,14,37,.378,14,32,.438,0,5,.000,12,34,.353,7,40,47,34,16,2,29,35,40,0.9
9602,Amadi Udenyi\amadi-udenyi-1,2016-17,Pepperdine,G,7,6,157,13,34,.382,8,21,.381,5,13,.385,9,14,.643,2,15,17,32,10,0,13,5,40,6.1
9603,Jaevin Cumberland\jaevin-cumberland-1,2015-16,Oakland,G,30,0,162,12,28,.429,6,12,.500,6,16,.375,10,13,.769,5,8,13,9,3,0,7,22,40,0.8
9604,Kyle Koszuta\kyle-koszuta-1,2013-14,Louisiana-Monroe,G,21,0,193,14,46,.304,4,11,.364,10,35,.286,2,6,.333,2,6,8,7,9,0,8,13,40,0.7
9605,Sebastian Suarez\sebastian-suarez-1,2014-15,Portland State,G,14,1,142,14,33,.424,7,16,.438,7,17,.412,5,6,.833,5,9,14,7,6,5,6,8,40,2.4
9606,Taylor Perry\taylor-perry-1,2013-14,Western Michigan,G,33,9,557,13,44,.295,12,31,.387,1,13,.077,13,24,.542,25,81,106,41,16,6,32,58,40,1.4
9607,Pat Welch\pat-welch-1,2017-18,South Carolina Upstate,G,26,0,179,14,46,.304,2,3,.667,12,43,.279,0,2,.000,6,12,18,13,8,2,6,12,40,1.1
9608,Dontaveon Robinson\dontaveon-robinson-1,2015-16,Jackson State,G,34,2,270,15,31,.484,15,31,.484,0,0,,10,15,.667,11,22,33,5,17,5,13,51,40,0.8
9609,Paul Jackson\paul-johnson-3,2014-15,Eastern Kentucky,G,24,2,250,15,40,.375,12,28,.429,3,12,.250,7,15,.467,2,12,14,41,11,0,15,33,40,1.3
9610,Phil Forte\phil-forte-1,2015-16,Oklahoma State,G,3,3,77,11,26,.423,5,10,.500,6,16,.375,12,14,.857,1,3,4,0,1,0,1,1,40,8.9
9611,Robert Mischler\robert-mischler-1,2015-16,Cornell,G,23,2,151,13,23,.565,2,4,.500,11,19,.579,3,4,.750,1,13,14,6,3,1,6,8,40,1.4
9612,Mike McGuirl\mike-mcguirl-1,2017-18,Kansas State,G,12,0,150,13,39,.333,8,18,.444,5,21,.238,9,12,.750,6,12,18,11,3,1,6,10,40,2.2
9613,Corey Romich\corey-romich-1,2017-18,Jacksonville,G,22,3,256,13,42,.310,1,3,.333,12,39,.308,2,3,.667,4,7,11,12,6,0,7,17,40,1.0
9614,Emmanuel Toney\emmanuel-toney-1,2015-16,Texas A&M-Corpus Christi,G,27,1,263,12,26,.462,8,16,.500,4,10,.400,12,17,.706,6,21,27,19,14,2,11,37,40,1.4
9615,Stanley Davis\stanley-davis-1,2016-17,Morgan State,G,22,0,187,15,51,.294,14,41,.341,1,10,.100,9,20,.450,12,23,35,16,9,3,23,18,40,0.6
9616,Justin McKie\justin-mckie-1,2015-16,South Carolina,G,26,0,216,14,47,.298,11,29,.379,3,18,.167,9,14,.643,7,20,27,22,2,2,7,21,40,1.0
9617,Emmanuel Owootoah\emmanuel-owootoah-1,2013-14,Fresno State,G,29,0,285,9,35,.257,4,11,.364,5,24,.208,17,21,.810,5,22,27,34,17,1,19,24,40,1.4
9618,Anthony Oliver II\anthony-oliverii-1,2017-18,Clemson,G,19,0,136,11,35,.314,2,9,.222,9,26,.346,9,11,.818,5,21,26,5,6,0,5,15,40,1.4
9619,Matt O'Reilly\matt-oreilly-1,2017-18,Bucknell,G,19,0,137,13,40,.325,1,1,1.000,12,39,.308,2,2,1.000,3,1,4,3,7,1,9,13,40,0.8
9620,Greg White-Pittman\greg-white-pittman-1,2014-15,North Texas,G,17,5,155,11,36,.306,11,26,.423,0,10,.000,18,31,.581,2,6,8,6,3,0,15,22,40,0.0
9621,Rene Castro\rene-castro-1,2013-14,Butler,G,12,0,104,15,32,.469,12,23,.522,3,9,.333,7,13,.538,2,5,7,4,5,0,4,7,40,2.1
9622,Anthony Mosley\anthony-mosley-1,2014-15,Delaware,G,26,2,224,11,37,.297,10,33,.303,1,4,.250,17,33,.515,6,12,18,36,11,3,23,26,40,1.0
9623,Kevin Alter\kevin-alter-1,2013-14,Navy,G,22,0,161,11,33,.333,1,2,.500,10,31,.323,8,10,.800,0,12,12,13,7,0,10,20,40,1.0
9624,Dawson Verhines\dawson-verhines-1,2013-14,Southern Illinois,G,32,2,343,11,33,.333,7,15,.467,4,18,.222,14,20,.700,11,27,38,17,6,1,9,21,40,1.1
9625,Elijah Staley\elijah-staley-1,2017-18,Morgan State,G,21,7,206,16,34,.471,16,34,.471,0,0,,8,15,.533,24,23,47,12,3,2,15,24,40,1.5
9626,Devorious Brown\devorious-brown-1,2017-18,Florida Atlantic,G,24,0,244,13,43,.302,13,37,.351,0,6,.000,14,19,.737,9,19,28,20,13,0,20,27,40,0.9
9627,Fred Garmon\fred-garmon-1,2013-14,Austin Peay,G,23,3,309,15,44,.341,11,26,.423,4,18,.222,6,14,.429,3,25,28,27,18,0,24,43,40,0.8
9628,Taj Benning\taj-benning-1,2017-18,Fairfield,G,25,0,255,10,31,.323,5,18,.278,5,13,.385,15,20,.750,8,26,34,20,3,5,16,34,40,1.0
9629,Spencer Littleson\spencer-littleson-1,2016-17,Duquesne,G,25,0,209,12,49,.245,2,11,.182,10,38,.263,6,10,.600,6,22,28,17,6,0,7,14,40,1.0
9630,DeVon Walker\devon-walker-1,2015-16,Florida,G,25,4,264,13,57,.228,11,38,.289,2,19,.105,12,25,.480,18,24,42,6,5,6,9,25,40,0.6
9631,Kevin Holland\kevin-holland-1,2014-15,Southern Mississippi,G,29,11,562,15,58,.259,7,16,.438,8,42,.190,2,5,.400,0,42,42,48,18,0,39,24,40,0.7
9632,Jackson Aldridge\jackson-aldridge-1,2013-14,Butler,G,25,0,194,15,44,.341,9,24,.375,6,20,.300,4,12,.333,3,10,13,12,3,0,6,21,40,0.6
9633,Kason Harrell\kason-harrell-1,2015-16,Purdue-Fort Wayne,G,16,0,73,13,26,.500,4,12,.333,9,14,.643,5,6,.833,2,7,9,3,1,1,4,8,40,1.7
9634,DeAndre Love\deandre-love-1,2017-18,Northwestern State,G,11,2,157,17,45,.378,15,39,.385,2,6,.333,4,6,.667,10,17,27,1,2,1,5,9,40,1.9
9635,D.J. Williams\dj-williams-1,2016-17,Illinois,G,17,0,150,17,40,.425,15,30,.500,2,10,.200,3,5,.600,4,11,15,8,1,5,8,6,39,1.3
9636,Chass Bryan\chass-bryan-1,2013-14,Southern California,G,25,3,229,12,39,.308,11,33,.333,1,6,.167,14,25,.560,3,11,14,24,13,2,18,36,39,0.7
9637,Tyler Ptacek\tyler-ptacek-1,2013-14,Evansville,G,22,0,152,11,36,.306,0,9,.000,11,27,.407,6,6,1.000,6,4,10,4,1,0,9,14,39,0.6
9638,Dezmyn Trent\dezmyn-trent-1,2014-15,Boise State,G,11,0,99,13,37,.351,6,16,.375,7,21,.333,6,10,.600,5,19,24,0,2,1,7,5,39,1.8
9639,Telly Davenport\telly-davenport-1,2016-17,Utah Valley,G,19,1,127,15,32,.469,14,23,.609,1,9,.111,8,17,.471,2,21,23,18,4,0,18,15,39,1.0
9640,Jake Toolson\jake-toolson-1,2015-16,Brigham Young,G,10,5,138,15,33,.455,8,14,.571,7,19,.368,2,2,1.000,3,13,16,12,3,0,7,7,39,3.0
9641,Patrick Triplett\patrick-triplett-1,2015-16,Brown,G,15,1,138,13,33,.394,10,22,.455,3,11,.273,10,15,.667,2,13,15,1,5,2,12,30,39,0.5
9642,Aaron Bodager\aaron-bodager-1,2013-14,North Florida,G,12,0,72,13,26,.500,1,2,.500,12,24,.500,1,2,.500,2,3,5,3,0,0,3,8,39,2.0
9643,Jarius Stevens\jarius-stevens-1,2017-18,Purdue-Fort Wayne,G,13,1,86,14,35,.400,13,26,.500,1,9,.111,10,10,1.000,10,11,21,2,3,0,4,3,39,2.3
9644,Rahamanh Katumbusi II\rahamanh-katumbusiii-1,2016-17,Alcorn State,G,13,1,151,14,35,.400,9,19,.474,5,16,.313,6,7,.857,3,15,18,6,4,1,12,11,39,1.4
9645,Sam Cassell\sam-cassell-2,2015-16,Connecticut,G,18,0,117,13,37,.351,3,9,.333,10,28,.357,3,3,1.000,2,5,7,5,2,1,3,7,39,1.2
9646,Darian Harris\darian-harris-1,2015-16,Oral Roberts,G,23,0,186,13,31,.419,3,6,.500,10,25,.400,3,7,.429,4,31,35,16,9,0,13,18,39,1.4
9647,Justice Kithcart\justice-kithcart-1,2016-17,Pittsburgh,G,29,2,385,14,46,.304,10,25,.400,4,21,.190,7,22,.318,5,16,21,34,9,4,18,41,39,0.5
9648,Anthony Strickland\anthony-strickland-1,2013-14,Eastern Michigan,G,27,1,198,13,22,.591,13,22,.591,0,0,,13,23,.565,8,20,28,3,9,2,5,15,39,1.4
9649,Tyler Corley\tyler-corley-1,2014-15,Mississippi Valley State,G,7,2,110,12,43,.279,9,30,.300,3,13,.231,12,18,.667,3,3,6,7,4,0,9,6,39,1.7
9650,Ryan Williams\ryan-williams-7,2013-14,Central Arkansas,G,6,2,90,13,42,.310,6,24,.250,7,18,.389,6,8,.750,4,6,10,6,4,0,10,13,39,1.9
9651,Lagerald Vick\lagerald-vick-1,2015-16,Kansas,G,19,0,91,14,25,.560,6,8,.750,8,17,.471,3,7,.429,1,4,5,8,3,1,6,6,39,1.5
9652,Darian Bryant\darian-bryant-1,2014-15,George Washington,G,32,0,172,14,39,.359,11,29,.379,3,10,.300,8,13,.615,8,17,25,6,3,0,9,16,39,0.6
9653,Terrell Hales\terrell-hales-1,2014-15,Cleveland State,G,32,0,332,12,27,.444,11,21,.524,1,6,.167,14,18,.778,23,25,48,18,24,1,14,34,39,1.8
9654,Juwan Davenport\juwan-davenport-1,2016-17,Coppin State,G,12,1,172,11,26,.423,11,22,.500,0,4,.000,17,28,.607,15,22,37,5,7,0,18,20,39,1.9
9655,Will Ferris\will-ferris-1,2015-16,Eastern Washington,G,29,1,174,11,33,.333,3,9,.333,8,24,.333,9,9,1.000,5,10,15,17,3,1,12,34,39,0.6
9656,Matt O'Boyle\matt-oboyle-1,2016-17,Appalachian State,G,22,1,150,15,29,.517,9,14,.643,6,15,.400,3,7,.429,8,14,22,13,6,1,7,18,39,1.6
9657,Johnathan Burroughs-Cook\johnathan-burroughs-cook-1,2013-14,College of Charleston,G,24,6,163,11,41,.268,5,16,.313,6,25,.240,11,19,.579,6,8,14,7,6,1,8,16,39,0.6
9658,Austin Donaldson\austin-donaldson-1,2015-16,Georgia State,G,17,1,137,15,30,.500,14,26,.538,1,4,.250,8,20,.400,6,14,20,16,10,0,16,20,39,1.5
9659,Turner Botz\turner-botz-1,2014-15,Green Bay,G,29,0,235,11,39,.282,4,11,.364,7,28,.250,10,13,.769,7,15,22,6,1,1,6,20,39,0.6
9660,Lyrik Shreiner\lyrik-shreiner-1,2015-16,Texas Christian,G,22,0,117,12,31,.387,9,17,.529,3,14,.214,12,15,.800,3,10,13,9,3,0,13,18,39,0.7
9661,Kyle McElvain\kyle-mcelvain-1,2013-14,Texas-Arlington,G,24,5,160,13,41,.317,3,8,.375,10,33,.303,2,2,1.000,2,11,13,3,5,0,5,18,38,0.6
9662,Luke Johnson\luke-johnson-3,2017-18,Loyola (MD),G,24,0,220,16,32,.500,12,22,.545,4,10,.400,2,2,1.000,6,16,22,9,4,0,2,14,38,1.4
9663,Trey Brown\trey-brown-2,2014-15,North Carolina A&T,G,11,1,110,15,36,.417,10,17,.588,5,19,.263,3,6,.500,3,7,10,3,3,1,7,14,38,1.4
9664,Joshua Doss\joshua-doss-1,2017-18,South Dakota,G,26,0,153,12,20,.600,11,15,.733,1,5,.200,13,15,.867,9,31,40,6,8,1,8,9,38,1.7
9665,Mike Martin\michael-martin-2,2015-16,Central Arkansas,G,10,0,152,14,41,.341,11,21,.524,3,20,.150,7,12,.583,2,18,20,19,10,0,8,22,38,2.6
9666,Justin Dotson\justin-dotson-1,2014-15,Stephen F. Austin,G,19,0,102,13,33,.394,11,21,.524,2,12,.167,10,17,.588,2,17,19,8,10,3,12,12,38,1.3
9667,Stilman White\stilman-white-1,2016-17,North Carolina,G,27,1,98,10,20,.500,8,16,.500,2,4,.500,16,18,.889,5,6,11,5,3,0,3,9,38,1.2
9668,Corbin Miller\corbin-miller-1,2016-17,Harvard,G,20,2,140,14,45,.311,4,15,.267,10,30,.333,0,0,,0,9,9,3,1,0,3,5,38,0.6
9669,Grant Evans\grant-evans-1,2014-15,Wright State,G,21,0,241,14,57,.246,5,20,.250,9,37,.243,1,4,.250,4,14,18,15,7,0,15,27,38,0.1
9670,Clive Vaughan\clive-vaughan-1,2014-15,Morgan State,G,20,0,123,14,60,.233,5,15,.333,9,45,.200,1,3,.333,5,5,10,1,5,1,5,9,38,0.2
9671,Ausar Madison\ausar-madison-1,2013-14,Howard,G,21,6,276,12,26,.462,11,21,.524,1,5,.200,13,16,.813,7,19,26,34,14,0,32,33,38,1.3
9672,Austin Williams\austin-williams-1,2015-16,North Carolina A&T,G,26,0,188,12,42,.286,11,30,.367,1,12,.083,13,27,.481,4,17,21,21,17,0,24,32,38,0.4
9673,Torloft Thomas\torlorf-thomas-1,2013-14,Georgia Southern,G,27,2,149,11,30,.367,6,12,.500,5,18,.278,11,14,.786,0,7,7,10,7,0,3,19,38,1.0
9674,Christian Benzon\christian-benzon-1,2013-14,Evansville,G,24,0,159,13,27,.481,13,27,.481,0,0,,12,28,.429,8,26,34,3,4,1,7,15,38,1.0
9675,LaQuentin Collins\laquentin-collins-1,2015-16,Southern,G,20,2,147,14,44,.318,11,29,.379,3,15,.200,7,11,.636,5,13,18,9,10,4,11,18,38,1.0
9676,Mark Howell\mark-howell-1,2014-15,Wright State,G,26,0,231,11,38,.289,9,23,.391,2,15,.133,14,17,.824,2,10,12,20,9,0,11,13,38,1.0
9677,Anthony Johnson\anthony-johnson-7,2015-16,Eastern Illinois,G,18,0,133,13,34,.382,9,23,.391,4,11,.364,8,11,.727,2,16,18,6,2,0,4,16,38,1.1
9678,Cahli Thomas\cahli-thomas-1,2015-16,Delaware State,G,23,2,237,10,38,.263,4,11,.364,6,27,.222,12,14,.857,2,18,20,24,5,0,17,20,38,0.8
9679,Djordjije Mumin\djordjije-mumin-1,2016-17,Central Florida,G,26,0,193,13,40,.325,2,7,.286,11,33,.333,1,2,.500,5,23,28,2,4,0,10,17,38,0.5
9680,James Griffin\james-griffin-3,2014-15,Marist,G,19,2,203,12,44,.273,9,17,.529,3,27,.111,11,14,.786,4,20,24,4,5,0,29,24,38,-0.6
9681,Aaron Young\aaron-young-2,2014-15,Princeton,G,15,0,68,12,21,.571,0,0,,12,21,.571,2,2,1.000,0,3,3,2,1,1,4,14,38,1.5
9682,Savonte Frazier\savonte-frazier-1,2015-16,Tennessee Tech,G,16,0,128,11,19,.579,8,13,.615,3,6,.500,13,20,.650,1,20,21,16,5,0,11,14,38,2.0
9683,Trae Bryant\trae-bryant-1,2017-18,Maine,G,7,4,180,11,35,.314,3,9,.333,8,26,.308,8,10,.800,3,21,24,20,2,1,9,10,38,4.2
9684,Aaron Calixte\aaron-calixte-1,2016-17,Maine,G,5,3,105,14,37,.378,9,18,.500,5,19,.263,5,5,1.000,1,3,4,12,3,0,7,6,38,4.3
9685,Scott Kingsley\scott-kingsley-1,2014-15,Fairleigh Dickinson,G,23,0,150,13,45,.289,10,25,.400,3,20,.150,9,15,.600,7,8,15,3,5,0,9,16,38,0.4
9686,Josh Mishler\josh-mishler-1,2016-17,Cal Poly,G,16,0,183,12,36,.333,5,11,.455,7,25,.280,7,11,.636,5,11,16,9,4,0,6,17,38,1.3
9687,Thomas Neff\thomas-neff-1,2017-18,Denver,G,15,0,162,14,31,.452,7,16,.438,7,15,.467,3,3,1.000,4,10,14,11,4,2,13,5,38,1.7
9688,Kris Rolle\chris-rolle-1,2013-14,Saint Peter's,G,26,1,244,13,23,.565,13,23,.565,0,0,,12,23,.522,23,36,59,5,3,11,9,43,38,1.4
9689,Johnny McWilliams\johnny-mcwilliams-1,2017-18,Fresno State,G,24,0,174,13,41,.317,9,27,.333,4,14,.286,8,17,.471,5,8,13,10,7,2,4,18,38,0.9
9690,Kurt Karis\kurt-karis-1,2013-14,Chicago State,G,29,6,260,14,38,.368,14,31,.452,0,7,.000,10,19,.526,9,13,22,21,21,2,19,41,38,0.9
9691,Spencer Krannitz\spencer-krannitz-1,2013-14,Central Michigan,G,25,0,114,14,40,.350,10,16,.625,4,24,.167,6,9,.667,9,9,18,1,1,2,4,13,38,0.7
9692,Armani Branch\armani-branch-1,2014-15,Virginia Military Institute,G,15,0,83,16,44,.364,13,21,.619,3,23,.130,2,7,.286,5,10,15,6,6,5,5,6,37,1.6
9693,Dwight Ramos\dwight-ramos-1,2017-18,Cal State Fullerton,G,18,1,121,14,46,.304,9,23,.391,5,23,.217,4,8,.500,9,9,18,9,4,0,11,13,37,0.7
9694,Andrew Bargmann\andrew-bargmann-1,2016-17,Colgate,G,22,4,182,11,28,.393,5,10,.500,6,18,.333,9,11,.818,2,21,23,10,8,0,10,18,37,1.2
9695,Holden Mobley\holden-mobley-1,2014-15,Belmont,G,33,1,332,10,28,.357,4,10,.400,6,18,.333,11,15,.733,8,19,27,14,8,0,16,40,37,0.5
9696,Deonte Hearns\deonte-hearns-1,2016-17,Grambling,G,8,5,144,14,35,.400,14,33,.424,0,2,.000,9,20,.450,15,12,27,4,4,2,10,20,37,2.3
9697,Earl McLaurin\earl-mclaurin-1,2014-15,Navy,G,26,1,214,11,29,.379,5,12,.417,6,17,.353,9,13,.692,6,18,24,25,10,0,11,18,37,1.5
9698,Nathan Harries\nathan-harries-1,2013-14,Colgate,G,15,0,140,14,33,.424,8,15,.533,6,18,.333,3,4,.750,4,9,13,5,1,0,5,12,37,1.3
9699,Alec Hickman\alec-hickman-1,2017-18,UC-Riverside,G,18,5,207,15,46,.326,8,15,.533,7,31,.226,0,1,.000,5,15,20,8,6,1,2,9,37,1.4
9700,Tyler Hamilton\tyler-hamilton-1,2016-17,Pennsylvania,G,24,0,175,12,36,.333,10,27,.370,2,9,.222,11,17,.647,9,20,29,6,8,2,9,31,37,0.8
9701,Aaron Scott\aaron-scott-4,2013-14,Appalachian State,G,10,0,99,13,26,.500,8,11,.727,5,15,.333,6,10,.600,2,3,5,4,1,0,3,6,37,2.3
9702,Lane Severyn\lane-severyn-1,2014-15,South Dakota State,G,25,0,199,12,39,.308,3,5,.600,9,34,.265,4,8,.500,11,33,44,13,11,3,9,20,37,1.4
9703,Aaron Robinson\aaron-robinson-2,2016-17,Quinnipiac,G,13,0,146,13,42,.310,3,9,.333,10,33,.303,1,2,.500,4,15,19,2,3,0,7,6,37,1.1
9704,Lee Richmond\lee-richmond-1,2017-18,Jacksonville,G,16,0,124,12,22,.545,10,15,.667,2,7,.286,11,13,.846,2,13,15,9,8,0,10,18,37,1.8
9705,Dane Kuiper\dane-kuiper-1,2015-16,New Mexico,G,25,0,207,12,37,.324,6,19,.316,6,18,.333,7,9,.778,3,23,26,20,6,8,9,22,37,1.3
9706,Steven Haney\steven-haney-1,2013-14,Central Florida,G,24,0,114,12,30,.400,2,3,.667,10,27,.370,3,6,.500,0,7,7,3,2,0,4,15,37,0.7
9707,James Foye\james-foye-1,2017-18,Dartmouth,G,25,0,263,12,45,.267,4,8,.500,8,37,.216,5,6,.833,1,22,23,14,7,1,9,22,37,0.7
9708,Larry Lewis Jr.\larry-lewisjr-1,2016-17,Hawaii,G,21,0,136,11,32,.344,11,24,.458,0,8,.000,15,23,.652,7,12,19,3,6,0,6,12,37,1.0
9709,Da'Shawn Robinson\dashawn-robinson-1,2015-16,Louisiana Tech,G,15,2,137,12,37,.324,7,20,.350,5,17,.294,8,15,.533,3,12,15,20,6,0,9,15,37,1.6
9710,Joe Mooney\joe-mooney-1,2016-17,UC-Davis,G,16,0,192,13,48,.271,7,16,.438,6,32,.188,5,6,.833,1,10,11,9,6,0,6,15,37,0.8
9711,Sean Grennan\sean-grennan-1,2015-16,San Francisco,G,23,1,169,11,29,.379,3,5,.600,8,24,.333,7,10,.700,0,11,11,15,4,2,5,20,37,1.1
9712,Chris Collins\chris-collins-4,2016-17,Texas A&M,G,27,7,369,13,43,.302,5,10,.500,8,33,.242,3,7,.429,2,26,28,39,6,2,24,37,37,0.6
9713,Tre' Ivory\tre-ivory-1,2016-17,Austin Peay,G,29,1,270,13,30,.433,11,26,.423,2,4,.500,9,19,.474,5,14,19,29,6,0,8,29,37,1.1
9714,Jake Kuhn\jake-kuhn-1,2017-18,Cornell,G,16,0,88,13,33,.394,6,13,.462,7,20,.350,4,9,.444,5,8,13,3,0,0,5,7,37,1.1
9715,Devonte Fuller\devonte-fuller-1,2017-18,Western Carolina,G,12,1,34,10,22,.455,8,15,.533,2,7,.286,15,16,.938,2,9,11,2,1,0,2,0,37,2.5
9716,Tanner Riley\tanner-riley-1,2013-14,Portland,G,16,1,106,12,37,.324,6,17,.353,6,20,.300,7,7,1.000,2,1,3,8,0,0,5,7,37,1.0
9717,Jefkins Agyeman-Budu\jefkin-agyeman-budu-1,2014-15,Grambling,G,27,1,262,13,53,.245,7,38,.184,6,15,.400,5,13,.385,12,14,26,7,11,1,33,32,37,-0.5
9718,Greg Nelson\greg-nelson-2,2013-14,Florida A&M,G,21,0,128,9,29,.310,2,6,.333,7,23,.304,12,14,.857,5,9,14,2,3,1,8,11,37,0.9
9719,Tyler Hamilton\tyler-hamilton-1,2015-16,Pennsylvania,G,18,1,140,11,37,.297,7,19,.368,4,18,.222,11,15,.733,3,16,19,7,10,1,10,24,37,0.9
9720,Sam Craft\sam-craft-1,2015-16,Memphis,G,17,7,211,14,44,.318,10,29,.345,4,15,.267,5,6,.833,4,16,20,16,6,1,8,23,37,1.2
9721,Kinnon LaRose\kinnon-larose-1,2015-16,Siena,G,29,0,156,12,24,.500,3,4,.750,9,20,.450,4,4,1.000,12,15,27,10,6,3,10,17,37,1.2
9722,Dayon Griffin\dayon-griffin-1,2014-15,Louisiana Tech,G,28,0,183,15,29,.517,10,19,.526,5,10,.500,2,12,.167,3,24,27,5,11,6,14,15,37,1.0
9723,Justin Roberts\justin-roberts-1,2016-17,Toledo,G,30,2,270,13,34,.382,5,11,.455,8,23,.348,3,5,.600,2,14,16,31,9,0,13,43,37,0.8
9724,Andre Chatfield\andre-chatfield-1,2014-15,Harvard,G,21,1,192,12,28,.429,9,14,.643,3,14,.214,9,12,.750,6,19,25,10,12,1,10,15,36,1.6
9725,Jordan Weathers\jordan-weathers-1,2013-14,Norfolk State,G,9,3,201,13,34,.382,11,24,.458,2,10,.200,8,13,.615,9,20,29,12,4,0,9,10,36,3.0
9726,Khalen Pinkett\khaleen-pinkett-1,2017-18,Savannah State,G,24,0,165,12,28,.429,9,21,.429,3,7,.429,9,17,.529,7,14,21,17,12,0,13,29,36,1.1
9727,Charles Hill\charles-hill-1,2014-15,Texas Christian,G,14,0,74,11,38,.289,6,20,.300,5,18,.278,9,16,.563,3,14,17,4,2,3,9,15,36,0.7
9728,Josh Brown\josh-brown-3,2016-17,Temple,G,5,2,102,13,25,.520,11,19,.579,2,6,.333,8,11,.727,3,9,12,10,7,3,3,10,36,7.3
9729,Geno Thorpe\geno-thorpe-1,2017-18,Syracuse,G,6,0,86,14,38,.368,10,24,.417,4,14,.286,4,5,.800,2,3,5,6,6,0,7,7,36,2.9
9730,Alex Carr\alex-carr-2,2014-15,Utah Valley,G,30,2,386,13,55,.236,4,15,.267,9,40,.225,1,4,.250,4,36,40,14,9,2,12,40,36,0.2
9731,Evan Horn\evan-horn-1,2017-18,New Hampshire,G,14,2,141,11,38,.289,6,21,.286,5,17,.294,9,15,.600,4,27,31,9,5,2,15,27,36,0.7
9732,Matt Howard\matt-howard-2,2013-14,Pennsylvania,G,17,0,113,13,27,.481,12,25,.480,1,2,.500,9,19,.474,3,24,27,8,6,3,5,10,36,1.9
9733,Dallas Anglin\dallas-anglin-1,2014-15,Southern Mississippi,G,6,1,99,8,20,.400,2,7,.286,6,13,.462,14,15,.933,0,6,6,9,5,0,3,8,36,5.3
9734,Terence Davis\terence-davis-1,2015-16,Mississippi,G,20,0,132,13,30,.433,10,19,.526,3,11,.273,7,19,.368,6,12,18,6,7,2,5,22,36,1.1
9735,Cameron Johnson\cameron-johnson-4,2014-15,Pittsburgh,G,8,0,115,13,33,.394,5,10,.500,8,23,.348,2,4,.500,2,7,9,4,1,3,4,12,36,2.2
9736,Julius Johnson\julius-johnson-1,2015-16,Richmond,G,26,0,207,13,46,.283,7,13,.538,6,33,.182,4,5,.800,6,16,22,6,1,4,4,30,36,0.4
9737,Reggie Price\reggie-price-1,2013-14,Hampton,G,13,0,102,13,38,.342,4,8,.500,9,30,.300,1,2,.500,4,10,14,0,1,0,5,3,36,1.1
9738,Chivarsky Corbett\chivarsky-corbett-1,2015-16,Delaware,G,4,4,120,14,34,.412,9,13,.692,5,21,.238,3,8,.375,7,16,23,6,3,2,2,8,36,7.2
9739,Josh Ivory\josh-ivory-1,2015-16,Towson,G,31,3,240,12,42,.286,1,4,.250,11,38,.289,1,4,.250,0,9,9,19,5,0,11,27,36,0.3
9740,C.J. Williamson\cj-williamson-1,2015-16,Texas Tech,G,21,0,139,12,41,.293,8,22,.364,4,19,.211,8,14,.571,3,14,17,8,6,1,14,19,36,0.3
9741,Rob Ukawuba\rob-ukawuba-1,2013-14,NJIT,G,10,0,89,13,21,.619,9,15,.600,4,6,.667,6,8,.750,2,10,12,7,5,3,5,9,36,3.4
9742,Chad Donley\chad-donley-1,2014-15,Morehead State,G,15,0,115,11,31,.355,1,5,.200,10,26,.385,4,9,.444,4,10,14,5,0,0,5,14,36,1.0
9743,Chace Franklin\chace-franklin-1,2016-17,Jackson State,G,4,3,93,13,34,.382,11,23,.478,2,11,.182,8,13,.615,5,11,16,7,5,1,3,10,36,6.5
9744,Carter Collins\carter-collins-1,2017-18,Davidson,G,25,0,162,14,38,.368,11,17,.647,3,21,.143,5,10,.500,6,13,19,10,3,1,9,24,36,0.5
9745,Adarius Avery\adarius-avery-1,2017-18,Loyola (IL),G,12,0,94,13,27,.481,13,26,.500,0,1,.000,10,15,.667,8,15,23,4,1,2,7,7,36,2.2
9746,Kendrick Thompson\kendrick-thompson-1,2016-17,Longwood,G,8,3,192,13,42,.310,3,10,.300,10,32,.313,0,2,.000,3,14,17,27,10,2,11,22,36,3.5
9747,Julian Walters\julian-walters-1,2016-17,East Tennessee State,G,9,0,93,11,23,.478,4,7,.571,7,16,.438,7,7,1.000,4,12,16,14,4,0,8,6,36,3.8
9748,Jake Bodway\jake-bodway-1,2016-17,South Florida,G,24,0,248,12,48,.250,8,33,.242,4,15,.267,8,12,.667,7,11,18,17,7,1,15,31,36,0.3
9749,Prince Williams\prince-williams-1,2014-15,East Carolina,G,23,1,233,12,37,.324,11,27,.407,1,10,.100,11,13,.846,4,20,24,22,8,2,17,21,36,1.0
9750,Zjori Bosha\zjori-bosha-1,2015-16,Lamar,G,24,2,191,14,51,.275,10,21,.476,4,30,.133,4,7,.571,15,19,34,9,8,0,10,28,36,0.6
9751,Kedrick Flomo\kedrick-flomo-1,2014-15,Murray State,G,29,0,312,10,53,.189,1,18,.056,9,35,.257,7,10,.700,3,27,30,30,10,4,22,30,36,0.4
9752,Paxton Wilson\paxton-wilson-1,2017-18,Rider,G,23,1,121,10,24,.417,2,3,.667,8,21,.381,8,10,.800,3,9,12,5,3,0,4,11,36,1.1
9753,Indiana Faithfull\indiana-faithfull-1,2013-14,Wofford,G,20,7,256,11,41,.268,10,26,.385,1,15,.067,13,17,.765,2,26,28,38,7,3,21,32,36,1.1
9754,Francisco Amiel\francisco-amiel-1,2015-16,Colgate,G,30,0,277,12,50,.240,5,13,.385,7,37,.189,5,10,.500,8,15,23,25,18,5,16,29,36,0.8
9755,Ny Redding\ny-redding-1,2015-16,Washington State,G,29,5,349,11,37,.297,8,24,.333,3,13,.231,11,15,.733,6,25,31,42,7,0,25,42,36,0.7
9756,Nick Davidson\nick-davidson-1,2016-17,Valparaiso,G,24,3,203,11,36,.306,6,19,.316,5,17,.294,9,12,.750,8,16,24,19,2,1,7,9,36,1.2
9757,Ammanuel Diressa\ammanuel-diressa-1,2013-14,Tennessee Tech,G,15,2,118,12,32,.375,7,11,.636,5,21,.238,7,10,.700,3,11,14,9,4,0,6,11,36,1.5
9758,Quinton Ray\quinton-ray-1,2015-16,Campbell,G,30,10,509,13,39,.333,11,22,.500,2,17,.118,8,16,.500,19,28,47,33,18,3,23,38,36,1.2
9759,Trevon Woods\trevon-woods-1,2015-16,Long Island University,G,14,0,168,13,50,.260,4,14,.286,9,36,.250,1,5,.200,10,13,23,3,4,2,8,27,36,0.3
9760,Miles Overton\miles-overton-1,2014-15,Wake Forest,G,7,0,89,9,28,.321,4,10,.400,5,18,.278,13,15,.867,1,11,12,3,3,1,11,11,36,1.9
9761,Khyan Rayner\khyan-rayner-1,2015-16,Princeton,G,19,0,116,10,32,.313,4,16,.250,6,16,.375,9,14,.643,3,8,11,5,2,0,3,12,35,0.9
9762,Cameron Fowler\cameron-fowler-1,2014-15,Niagara,G,24,9,241,13,38,.342,8,26,.308,5,12,.417,4,12,.333,7,20,27,19,12,0,13,33,35,0.9
9763,Matt Morrison\matt-morrison-1,2013-14,Northern Iowa,G,27,0,177,12,31,.387,5,15,.333,7,16,.438,4,4,1.000,0,9,9,20,6,0,11,17,35,0.9
9764,Anthony Johnson\anthony-johnson-7,2014-15,Eastern Illinois,G,23,0,145,14,23,.609,12,15,.800,2,8,.250,5,12,.417,6,20,26,4,4,0,7,12,35,1.2
9765,Kenzo Nudo\kenzo-nudo-1,2016-17,Grand Canyon,G,9,0,117,13,50,.260,8,23,.348,5,27,.185,4,8,.500,1,11,12,3,2,0,10,7,35,-0.1
9766,Jordan Ash\jordan-ash-1,2015-16,Northwestern,G,27,0,156,12,29,.414,8,14,.571,4,15,.267,7,10,.700,2,14,16,22,2,0,7,17,35,1.0
9767,Justin Lobell\justin-lobell-1,2014-15,Southeastern Louisiana,G,15,7,161,12,27,.444,1,3,.333,11,24,.458,0,0,,3,13,16,4,4,0,4,7,35,1.8
9768,Avery Patterson\avery-patterson-2,2014-15,Western Kentucky,G,20,0,108,12,29,.414,6,10,.600,6,19,.316,5,8,.625,0,12,12,9,5,0,20,11,35,0.4
9769,Aaron O'Neill\aaron-oneill-1,2013-14,Furman,G,25,11,260,11,28,.393,1,4,.250,10,24,.417,3,4,.750,0,20,20,16,1,0,6,26,35,0.8
9770,Rashard Odomes\rashard-odomes-1,2015-16,Oklahoma,G,18,0,109,11,24,.458,10,21,.476,1,3,.333,12,21,.571,5,10,15,6,2,1,12,11,35,0.9
9771,Taylor Echols\taylor-echols-1,2014-15,Georgia,G,25,1,162,11,32,.344,0,1,.000,11,31,.355,2,6,.333,0,13,13,4,3,0,12,15,35,0.3
9772,Tyler Plummer\tyler-plummer-1,2017-18,Wagner,G,18,0,227,13,36,.361,10,24,.417,3,12,.250,6,19,.316,13,15,28,6,7,2,12,21,35,0.9
9773,Oskar Reinfelds\oscars-reinfelds-1,2014-15,Troy,G,9,0,113,11,28,.393,8,17,.471,3,11,.273,10,15,.667,2,8,10,11,4,0,10,10,35,2.1
9774,Jamaal King\jamaal-king-1,2015-16,Saint Francis (PA),G,17,1,152,13,37,.351,7,17,.412,6,20,.300,3,4,.750,4,8,12,10,5,1,8,23,35,0.9
9775,Issac Smith\issac-smith-1,2014-15,Maryland-Eastern Shore,G,28,12,341,10,46,.217,7,30,.233,3,16,.188,12,23,.522,3,19,22,44,10,0,37,24,35,0.2
9776,Justin Williams\justin-williams-4,2017-18,George Washington,G,21,0,127,15,27,.556,14,22,.636,1,5,.200,4,6,.667,10,21,31,2,4,3,4,11,35,1.6
9777,Alex Dubovitskiy\alex-dubovitskiy-1,2017-18,Chicago State,G,24,1,196,12,31,.387,6,10,.600,6,21,.286,5,7,.714,3,17,20,4,5,1,11,36,35,0.3
9778,Tyler Clement\tyler-clement-1,2015-16,Creighton,G,30,0,139,12,29,.414,8,15,.533,4,14,.286,7,12,.583,2,19,21,18,10,0,14,16,35,0.9
9779,Montana Byrd\montana-byrd-1,2016-17,Chicago State,G,14,8,185,12,39,.308,4,15,.267,8,24,.333,3,3,1.000,5,12,17,3,4,2,12,28,35,0.3
9780,Charles Burley\charles-burley-1,2013-14,Delaware State,G,30,5,411,7,26,.269,7,23,.304,0,3,.000,21,31,.677,8,36,44,69,16,0,45,45,35,1.1
9781,Jeremiah Williams\jeremiah-williams-2,2013-14,Canisius,G,17,0,199,13,35,.371,8,21,.381,5,14,.357,4,5,.800,4,9,13,17,6,2,18,34,35,0.5
9782,Malik Amos\malik-amos-1,2015-16,Prairie View,G,17,0,85,11,44,.250,2,10,.200,9,34,.265,4,5,.800,0,0,0,1,2,0,4,4,35,0.3
9783,Therren Shelton-Szmidt\therren-shelton-szmidt-1,2017-18,Middle Tennessee,G,26,0,133,13,39,.333,4,13,.308,9,26,.346,0,1,.000,6,14,20,9,6,0,10,11,35,0.7
9784,Darrion Eastmon\darrion-eastmon-1,2013-14,South Carolina State,G,25,6,257,10,22,.455,7,14,.500,3,8,.375,12,20,.600,5,26,31,35,10,2,32,35,35,0.9
9785,Erik Nakken\erik-nakken-1,2014-15,Idaho State,G,20,0,107,11,32,.344,0,1,.000,11,31,.355,2,4,.500,0,1,1,4,2,1,3,6,35,0.8
9786,Kindon Crowder\kindon-crowder-1,2013-14,Ball State,G,17,1,141,13,36,.361,5,6,.833,8,30,.267,1,4,.250,0,10,10,11,5,1,8,17,35,0.9
9787,Max Joseph\max-joseph-1,2015-16,Valparaiso,G,23,1,178,9,34,.265,7,20,.350,2,14,.143,15,23,.652,8,15,23,18,12,0,10,18,35,1.3
9788,Daniel Cummings\daniel-cummings-1,2017-18,Tennessee State,G,22,5,188,10,29,.345,1,6,.167,9,23,.391,5,6,.833,6,15,21,4,1,0,8,29,34,0.5
9789,Donte Watson\donte-watson-1,2017-18,North Carolina A&T,G,12,2,87,12,30,.400,9,19,.474,3,11,.273,7,9,.778,1,11,12,0,2,2,5,3,34,1.5
9790,Josh Hearlihy\josh-hearlihy-1,2014-15,Tulane,G,22,0,186,13,39,.333,9,25,.360,4,14,.286,4,12,.333,15,18,33,13,6,1,13,22,34,0.8
9791,Marquis Marshall\marquis-marshall-1,2013-14,Towson,G,25,0,105,11,31,.355,5,7,.714,6,24,.250,6,9,.667,1,7,8,2,3,0,3,7,34,0.7
9792,Ryan Burnett\ryan-burnett-1,2014-15,Stony Brook,G,15,5,123,13,32,.406,10,15,.667,3,17,.176,5,8,.625,10,2,12,10,0,0,8,7,34,1.3
9793,Kameron Murrell\kameron-murrell-1,2016-17,George Mason,G,21,1,125,10,38,.263,5,15,.333,5,23,.217,9,12,.750,6,13,19,10,5,0,5,22,34,0.8
9794,Chris Braley\chris-braley-1,2014-15,Stony Brook,G,23,0,211,14,38,.368,10,19,.526,4,19,.211,2,5,.400,12,33,45,11,5,2,13,23,34,1.0
9795,Brandon Maxwell\brandon-maxwell-1,2016-17,Northern Kentucky,G,24,0,201,12,41,.293,5,13,.385,7,28,.250,3,8,.375,2,20,22,10,5,2,26,26,34,-0.3
9796,Marc Seylan\marc-seylan-1,2016-17,Maryland-Eastern Shore,G,30,12,314,13,48,.271,13,40,.325,0,8,.000,8,18,.444,20,35,55,15,6,0,7,27,34,0.8
9797,Traci Carter\traci-carter-1,2016-17,Marquette,G,8,4,130,13,23,.565,10,16,.625,3,7,.429,5,8,.625,3,14,17,29,4,0,11,15,34,4.4
9798,Justin Smith\justin-smith-2,2015-16,Idaho State,G,21,5,159,13,26,.500,12,22,.545,1,4,.250,7,13,.538,10,25,35,7,4,1,11,35,34,0.8
9799,Thaddeus Fauntleroy\thaddeus-fauntleroy-1,2013-14,Mississippi Valley State,G,21,2,163,10,44,.227,9,27,.333,1,17,.059,13,18,.722,4,18,22,24,11,0,20,21,34,0.6
9800,Kerwin Okoro\kerwin-okoro-1,2014-15,Rutgers,G,17,1,124,12,42,.286,8,22,.364,4,20,.200,6,6,1.000,6,9,15,8,2,0,12,13,34,0.4
9801,Eric McClellan\eric-mcclellan-1,2014-15,Gonzaga,G,18,0,145,8,24,.333,5,16,.313,3,8,.375,15,24,.625,4,12,16,14,3,1,4,11,34,1.6
9802,Hayden Hunter\hayden-hunter-1,2014-15,Weber State,G,28,0,387,5,28,.179,1,16,.063,4,12,.333,20,28,.714,6,30,36,59,7,0,35,39,34,0.9
9803,Michael Mayhew\michael-mayhew-1,2016-17,Portland State,G,14,0,90,11,39,.282,3,6,.500,8,33,.242,4,5,.800,5,5,10,5,3,1,2,11,34,1.2
9804,Vince Holmes\vince-holmes-1,2016-17,James Madison,G,25,0,319,9,30,.300,9,24,.375,0,6,.000,16,24,.667,9,30,39,29,6,4,27,46,34,0.5
9805,JaQuel Richmond\jaquel-richmond-1,2017-18,North Carolina-Wilmington,G,6,0,130,13,37,.351,9,24,.375,4,13,.308,4,8,.500,2,6,8,8,2,0,7,14,34,1.7
9806,Christopher Thomas\christopher-thomas-2,2016-17,Alabama A&M,G,9,1,167,13,34,.382,10,22,.455,3,12,.250,5,7,.714,9,12,21,5,2,5,12,16,34,1.7
9807,Oliver Tot\oliver-tot-1,2016-17,William & Mary,G,31,0,312,11,20,.550,10,14,.714,1,6,.167,11,17,.647,4,32,36,38,9,11,19,37,34,1.4
9808,Justin Dotson\justin-dotson-1,2013-14,Stephen F. Austin,G,21,0,99,10,42,.238,5,18,.278,5,24,.208,9,14,.643,10,13,23,4,3,0,9,17,34,0.4
9809,James Washington\james-washington-2,2017-18,American,G,15,0,175,13,38,.342,9,20,.450,4,18,.222,4,7,.571,2,13,15,5,6,1,13,13,34,0.6
9810,Raekwon Harney\raekwon-harney-2,2017-18,North Carolina Central,G,22,0,258,15,48,.313,12,35,.343,3,13,.231,1,6,.167,3,22,25,59,19,0,25,17,34,1.9
9811,Dujuanta Weaver\dujuanta-weaver-1,2015-16,Eastern Kentucky,G,16,0,165,14,33,.424,9,17,.529,5,16,.313,1,2,.500,5,16,21,28,10,0,10,16,34,2.4
9812,Dondre Duffus\dondre-duffus-1,2016-17,Southeast Missouri State,G,5,3,103,13,27,.481,13,26,.500,0,1,.000,8,10,.800,2,9,11,6,7,2,7,9,34,5.1
9813,Henry Taylor\henry-taylor-2,2017-18,Mississippi Valley State,G,31,0,145,11,34,.324,6,12,.500,5,22,.227,7,11,.636,2,17,19,10,6,0,13,24,34,0.3
9814,Brock Miller\brock-miller-1,2017-18,Utah State,G,5,0,83,12,26,.462,3,7,.429,9,19,.474,1,1,1.000,2,5,7,1,1,0,6,12,34,2.9
9815,Ronnie Stacy\ronnie-stacy-1,2017-18,Oregon State,G,20,0,173,13,38,.342,11,32,.344,2,6,.333,6,19,.316,7,17,24,11,2,1,16,36,34,-0.1
9816,Luke Norman\luke-norman-1,2015-16,Eastern Illinois,G,25,1,213,10,21,.476,3,5,.600,7,16,.438,7,11,.636,0,19,19,8,0,0,7,17,34,0.8
9817,Jonathan Jean\jonathan-jean-1,2015-16,Furman,G,21,0,150,13,37,.351,11,26,.423,2,11,.182,6,6,1.000,0,13,13,18,3,0,18,13,34,0.5
9818,Emmanuel Lambright\emmanuel-lambright-1,2017-18,North Florida,G,24,2,226,12,36,.333,7,13,.538,5,23,.217,5,9,.556,6,37,43,8,6,15,15,17,34,1.2
9819,Devonte Boykins\devonte-boykins-1,2014-15,Georgia Southern,G,25,0,154,12,25,.480,7,10,.700,5,15,.333,5,6,.833,3,17,20,15,6,0,7,16,34,1.2
9820,Jamall Gregory\jamall-gregory-1,2015-16,South Carolina,G,20,0,133,12,24,.500,10,18,.556,2,6,.333,8,13,.615,4,15,19,12,6,2,7,23,34,1.3
9821,Harris Brown\harris-brown-1,2015-16,Evansville,G,24,0,187,8,35,.229,3,17,.176,5,18,.278,13,19,.684,2,8,10,17,3,0,12,27,34,0.3
9822,Chad Johnson\chad-johnson-4,2014-15,Lipscomb,G,30,1,253,9,26,.346,4,12,.333,5,14,.357,11,14,.786,2,30,32,21,11,1,14,36,34,0.9
9823,Jeremy Lieberman\jeremy-lieberman-1,2014-15,Wyoming,G,25,0,224,11,41,.268,6,14,.429,5,27,.185,7,10,.700,3,11,14,20,9,1,12,18,34,0.7
9824,Romello Walker\romello-walker-1,2015-16,Binghamton,G,7,2,127,11,42,.262,7,21,.333,4,21,.190,8,11,.727,3,19,22,7,1,3,12,11,34,1.0
9825,Patrick Hendley\patrick-hendley-1,2013-14,Savannah State,G,18,1,126,14,33,.424,11,25,.440,3,8,.375,3,6,.500,3,14,17,9,5,6,10,9,34,1.3
9826,Michael Schlotman\michael-schlotman-1,2014-15,William & Mary,G,24,1,231,8,24,.333,6,21,.286,2,3,.667,16,25,.640,4,10,14,17,7,1,13,24,34,0.8
9827,James Daniel\james-daniel-1,2016-17,Howard,G,2,2,71,11,35,.314,5,14,.357,6,21,.286,6,9,.667,2,3,5,8,3,0,6,2,34,8.4
9828,Matthew Jiles\matthew-jiles-1,2017-18,New Orleans,G,26,3,160,11,33,.333,6,14,.429,5,19,.263,7,13,.538,3,2,5,6,7,1,11,12,34,0.5
9829,DeAndre Harris\deandre-harris-1,2015-16,North Texas,G,4,0,55,10,20,.500,5,9,.556,5,11,.455,9,11,.818,0,13,13,4,2,1,2,9,34,6.8
9830,Marcus Mathieu\marcus-mathieu-1,2014-15,McNeese State,G,28,1,196,11,40,.275,7,22,.318,4,18,.222,8,14,.571,2,7,9,16,3,0,17,26,34,-0.1
9831,Ethan Layer\ethan-layer-1,2013-14,Liberty,G,19,0,155,9,29,.310,2,4,.500,7,25,.280,9,13,.692,1,9,10,9,2,0,11,17,34,0.5
9832,A.J. Davis\aj-davis-2,2013-14,Tennessee,G,25,1,235,14,35,.400,11,27,.407,3,8,.375,2,9,.222,12,27,39,6,5,5,9,34,33,0.7
9833,Jeff Wu\jeff-wu-1,2016-17,Sacramento State,G,13,2,158,13,52,.250,6,17,.353,7,35,.200,0,5,.000,1,8,9,8,5,1,13,15,33,-0.4
9834,Cole Gentry\cole-gentry-1,2016-17,South Dakota State,G,10,4,166,10,33,.303,4,10,.400,6,23,.261,7,10,.700,0,19,19,19,4,0,10,11,33,2.1
9835,Chad Johnson\chad-johnson-4,2013-14,Lipscomb,G,28,0,246,8,20,.400,1,1,1.000,7,19,.368,10,12,.833,7,29,36,19,9,0,13,41,33,1.0
9836,Nick Carlos\nick-carlos-1,2013-14,Central Michigan,G,24,0,108,13,42,.310,6,14,.429,7,28,.250,0,0,,5,4,9,3,3,0,6,11,33,0.3
9837,Austin Vereen\austin-vereen-1,2016-17,Virginia Military Institute,G,27,0,218,11,47,.234,4,15,.267,7,32,.219,4,6,.667,9,21,30,9,3,4,9,32,33,0.2
9838,Tanner Hamilton\tanner-hamilton-1,2016-17,Northwestern State,G,29,0,174,13,29,.448,8,17,.471,5,12,.417,2,7,.286,8,11,19,11,2,2,13,18,33,0.5
9839,Rakiya Battle\rakiya-battle-1,2013-14,Alabama A&M,G,18,0,116,8,29,.276,4,13,.308,4,16,.250,13,23,.565,1,6,7,10,3,1,9,12,33,0.6
9840,Marty Hill\marty-hill-1,2017-18,Evansville,G,9,0,127,13,36,.361,7,25,.280,6,11,.545,1,2,.500,8,15,23,9,3,0,7,7,33,2.5
9841,Chris Thomas\chris-thomas-6,2014-15,Southern,G,21,0,147,13,32,.406,10,21,.476,3,11,.273,4,13,.308,4,17,21,5,2,2,8,22,33,0.5
9842,Eric Weary\eric-weary-1,2015-16,Houston,G,19,1,129,14,41,.341,10,18,.556,4,23,.174,1,3,.333,10,10,20,10,1,0,5,18,33,0.8
9843,Taylor Echols\taylor-echols-1,2013-14,Georgia,G,20,1,123,11,31,.355,0,2,.000,11,29,.379,0,2,.000,1,9,10,8,3,0,9,10,33,0.7
9844,Phillip Johnson\phillip-johnson-2,2014-15,Incarnate Word,G,23,1,237,14,27,.519,14,26,.538,0,1,.000,5,10,.500,5,13,18,5,7,1,6,21,33,1.0
9845,Miguel Cartagena\miguel-cartagena-1,2013-14,George Washington,G,32,1,206,11,49,.224,7,25,.280,4,24,.167,7,13,.538,0,12,12,32,4,0,23,27,33,-0.1
9846,Idris Taqqee\idris-taqqee-1,2014-15,St. Bonaventure,G,27,0,225,12,39,.308,11,24,.458,1,15,.067,8,18,.444,13,22,35,14,8,0,10,29,33,0.7
9847,DaRon Curry\daron-curry-1,2015-16,Fairleigh Dickinson,G,23,0,127,12,27,.444,11,25,.440,1,2,.500,8,12,.667,1,8,9,14,3,0,9,20,33,0.7
9848,Dwayne Pow\dwayne-pow-1,2016-17,Niagara,G,10,6,145,11,29,.379,10,23,.435,1,6,.167,10,14,.714,1,14,15,15,8,0,18,18,33,1.4
9849,Jabbar Washington\jabbar-washington-3,2014-15,Charleston Southern,G,21,0,141,12,34,.353,7,19,.368,5,15,.333,4,10,.400,2,13,15,9,5,2,4,12,33,1.0
9850,Chris Jenkins\chris-jenkins-2,2017-18,NJIT,G,13,0,111,11,38,.289,0,4,.000,11,34,.324,0,0,,1,6,7,5,3,0,4,8,33,1.0
9851,Donnell Gresham Jr.\donnell-greshamjr-1,2016-17,Northeastern,G,4,4,92,8,16,.500,1,4,.250,7,12,.583,10,11,.909,1,10,11,3,0,0,4,11,33,5.5
9852,Khalid Nwandu\khalid-nwandu-1,2016-17,Mount St. Mary's,G,33,2,255,12,26,.462,12,26,.462,0,0,,9,14,.643,7,27,34,25,10,3,23,43,33,0.6
9853,Tre Cobbs\tre-cobbs-1,2017-18,Northern Kentucky,G,15,0,86,10,14,.714,8,10,.800,2,4,.500,11,15,.733,0,5,5,9,2,0,8,15,33,1.4
9854,Quavius Copeland\quavius-copeland-1,2016-17,Middle Tennessee,G,30,0,154,12,26,.462,8,15,.533,4,11,.364,5,8,.625,1,8,9,13,2,1,12,8,33,0.6
9855,Eddie Scott\eddie-scott-2,2017-18,Pennsylvania,G,9,0,100,13,25,.520,11,19,.579,2,6,.333,5,16,.313,10,17,27,2,2,0,7,15,33,2.1
9856,Kurt Karis\kurt-karis-1,2014-15,Chicago State,G,21,7,294,12,43,.279,12,37,.324,0,6,.000,9,14,.643,11,34,45,32,12,0,22,32,33,1.1
9857,Sam Bittner\sam-bittner-1,2016-17,Fresno State,G,26,9,341,12,46,.261,4,13,.308,8,33,.242,1,2,.500,16,31,47,24,11,6,14,45,33,1.0
9858,Steven Shpreyregin\steven-shpreyregin-1,2017-18,Washington State,G,15,1,114,11,33,.333,2,4,.500,9,29,.310,2,3,.667,1,5,6,1,1,0,2,10,33,0.8
9859,Matthew Butler\matthew-butler-1,2014-15,Rhode Island,G,20,0,147,12,34,.353,5,14,.357,7,20,.350,2,2,1.000,1,14,15,6,2,0,13,12,33,0.4
9860,Cordell Veira\cordell-veira-1,2017-18,Florida International,G,30,1,225,11,41,.268,5,23,.217,6,18,.333,5,16,.313,4,26,30,24,6,2,10,18,33,0.7
9861,Will Adams\will-adams-2,2013-14,Presbyterian,G,25,3,273,11,35,.314,2,5,.400,9,30,.300,2,3,.667,2,15,17,16,7,0,9,32,33,0.6
9862,K.J. Maura\kj-maura-1,2014-15,Abilene Christian,G,17,0,195,11,32,.344,5,14,.357,6,18,.333,5,5,1.000,7,17,24,30,9,0,15,15,33,2.0
9863,Zachary Jackson\zachary-jackson-1,2015-16,Alabama A&M,G,22,2,158,13,37,.351,11,26,.423,2,11,.182,5,13,.385,9,10,19,5,7,2,6,18,33,0.8
9864,Tyson Smith\tyson-smith-1,2016-17,Loyola (IL),G,24,0,174,10,36,.278,4,17,.235,6,19,.316,7,9,.778,4,21,25,7,4,2,10,13,33,0.6
9865,Corey Tillery\corey-tillery-1,2017-18,Tennessee Tech,G,18,0,191,12,50,.240,5,17,.294,7,33,.212,2,2,1.000,2,9,11,5,5,0,6,17,33,0.1
9866,Tide Osifeso\tide-osifeso-1,2016-17,UC-Santa Barbara,G,18,0,128,11,42,.262,3,11,.273,8,31,.258,3,4,.750,2,12,14,11,0,0,4,7,33,0.8
9867,Devin Jackson\devin-jackson-1,2017-18,Sam Houston State,G,19,0,108,11,48,.229,0,0,,11,48,.229,0,0,,2,8,10,4,1,0,2,9,33,0.3
9868,Robert Wiley\robert-wiley-1,2014-15,Grambling,G,26,4,261,13,47,.277,12,36,.333,1,11,.091,5,11,.455,5,19,24,9,8,4,30,36,32,-0.6
9869,DeRias Johnson\derias-johnson-1,2017-18,Southern,G,20,5,142,11,54,.204,4,16,.250,7,38,.184,3,4,.750,4,14,18,11,6,1,6,16,32,0.4
9870,Manny Camper\manny-camper-1,2017-18,Siena,G,16,2,109,10,17,.588,9,15,.600,1,2,.500,11,18,.611,6,13,19,2,5,2,5,10,32,1.8
9871,Jeremy Bogus\jeremy-bogus-1,2013-14,Jacksonville,G,14,1,70,10,17,.588,3,5,.600,7,12,.583,5,7,.714,4,2,6,2,2,0,3,8,32,1.7
9872,Brandon Hayman\brandon-hayman-1,2013-14,Samford,G,12,0,80,15,23,.652,15,22,.682,0,1,.000,2,7,.286,10,4,14,2,3,3,2,19,32,2.1
9873,Jonathan Hood\jonathan-hood-1,2014-15,Eastern Kentucky,G,13,0,100,11,37,.297,3,9,.333,8,28,.286,2,2,1.000,3,7,10,6,4,0,3,4,32,1.4
9874,Andrew Garcia\andrew-garcia-2,2017-18,Stony Brook,G,11,0,111,12,33,.364,10,28,.357,2,5,.400,6,16,.375,15,9,24,3,2,1,14,16,32,0.7
9875,Matt Ratto\matthew-ratto-1,2013-14,Cal State Bakersfield,G,18,0,37,10,19,.526,0,1,.000,10,18,.556,2,3,.667,1,3,4,1,2,1,2,8,32,1.2
9876,Juwan Moody\juwan-moody-1,2013-14,North Carolina Central,G,24,0,137,11,31,.355,2,8,.250,9,23,.391,1,3,.333,3,11,14,20,7,0,12,17,32,0.9
9877,Reggie Miller\reggie-miller-3,2017-18,Texas State,G,18,1,129,9,28,.321,5,16,.313,4,12,.333,10,12,.833,4,13,17,16,3,0,13,13,32,1.0
9878,Corey Heyward\corey-heyward-1,2013-14,Georgia Tech,G,32,15,526,10,35,.286,4,21,.190,6,14,.429,6,13,.462,10,39,49,45,22,4,26,59,32,1.1
9879,Jarrod Polson\jarrod-polson-1,2013-14,Kentucky,G,33,1,281,11,36,.306,2,11,.182,9,25,.360,1,3,.333,5,16,21,17,2,2,9,26,32,0.4
9880,Pat Smith\pat-smith-1,2014-15,Cornell,G,12,1,99,11,30,.367,6,13,.462,5,17,.294,5,6,.833,2,5,7,5,1,1,1,9,32,1.5
9881,Burton Sampson\burton-sampson-1,2014-15,Belmont,G,19,0,72,9,20,.450,4,10,.400,5,10,.500,9,11,.818,2,1,3,1,1,0,4,6,32,0.9
9882,Kieran Hayward\kieran-hayward-1,2016-17,Louisiana State,G,26,0,214,10,45,.222,1,14,.071,9,31,.290,3,5,.600,9,20,29,8,4,3,4,31,32,0.4
9883,Joe Kuligoski\joe-kuligoski-1,2014-15,Jacksonville State,G,26,0,252,10,31,.323,7,17,.412,3,14,.214,9,12,.750,22,42,64,9,2,3,7,29,32,1.3
9884,John Robert Simon\john-robert-simon-1,2015-16,Wichita State,G,25,0,116,9,23,.391,3,8,.375,6,15,.400,8,12,.667,3,5,8,18,3,0,7,13,32,1.0
9885,Milos Cabarkapa\milos-cabarkapa-1,2014-15,Central Michigan,G,23,0,97,12,20,.600,12,20,.600,0,0,,8,12,.667,10,17,27,0,0,3,8,15,32,0.9
9886,Keith Frazier\keith-frazier-1,2016-17,North Texas,G,4,0,75,11,31,.355,4,12,.333,7,19,.368,3,5,.600,2,12,14,2,1,1,3,11,32,3.7
9887,Marty Leahy\marty-leahy-1,2016-17,Western Kentucky,G,17,0,168,8,22,.364,2,10,.200,6,12,.500,10,11,.909,4,12,16,5,4,0,6,15,32,1.3
9888,Jalil Abdul-Bassit\jalil-abdul-bassit-1,2013-14,Oregon,G,17,0,106,11,34,.324,4,16,.250,7,18,.389,3,8,.375,1,8,9,4,4,0,5,9,32,0.7
9889,Nick Davidson\nick-davidson-1,2015-16,Valparaiso,G,14,0,77,8,20,.400,5,10,.500,3,10,.300,13,14,.929,1,4,5,6,3,0,1,6,32,1.9
9890,Jared Printy\jared-printy-1,2016-17,Western Michigan,G,18,0,134,9,22,.409,0,4,.000,9,18,.500,5,6,.833,2,13,15,8,3,2,3,5,32,1.7
9891,J.T. Jones\jt-jones-1,2014-15,Southeast Missouri State,G,13,1,101,13,29,.448,9,17,.529,4,12,.333,2,4,.500,9,10,19,7,1,0,8,16,32,1.3
9892,KJ Langston\kj-langston-1,2016-17,Washington State,G,20,0,159,13,47,.277,7,21,.333,6,26,.231,0,1,.000,2,9,11,6,5,0,7,10,32,0.3
9893,Alan Vest\alan-vest-1,2015-16,Wright State,G,21,0,214,11,28,.393,4,10,.400,7,18,.389,3,5,.600,1,14,15,8,2,1,8,15,32,0.7
9894,Jordan Lawson\jordan-lawson-1,2013-14,Delaware State,G,24,10,185,13,27,.481,13,27,.481,0,0,,6,12,.500,21,18,39,2,11,3,7,31,32,1.3
9895,Myles Franklin\myles-franklin-1,2016-17,Idaho,G,20,0,181,8,24,.333,7,14,.500,1,10,.100,15,21,.714,0,18,18,24,4,0,12,8,32,1.4
9896,Tiremone Williams\tiremone-williams-1,2015-16,Louisiana,G,29,3,195,11,30,.367,10,20,.500,1,10,.100,9,16,.563,3,15,18,15,8,1,5,19,32,0.9
9897,Mitchell Deter\mitchell-deter-1,2013-14,Charleston Southern,G,18,0,95,10,24,.417,1,1,1.000,9,23,.391,3,4,.750,1,6,7,5,1,0,4,6,32,1.1
9898,Lew Stallworth\lew-stallworth-1,2014-15,Texas-El Paso,G,19,1,151,9,31,.290,7,21,.333,2,10,.200,12,14,.857,1,12,13,10,2,3,10,11,32,0.7
9899,Kamali Chambers\kamali-chambers-1,2017-18,Boston University,G,20,2,162,11,35,.314,8,22,.364,3,13,.231,7,13,.538,1,8,9,14,4,1,7,16,32,0.7
9900,Mike Turner\mike-turner-3,2014-15,Houston Baptist,G,15,0,80,11,29,.379,4,7,.571,7,22,.318,3,6,.500,2,4,6,4,0,0,8,2,32,0.8
9901,Sam Walters\sam-walters-1,2016-17,UC-Santa Barbara,G,18,0,133,10,25,.400,1,3,.333,9,22,.409,2,2,1.000,0,5,5,7,2,1,4,5,31,1.1
9902,Armani Branch\armani-branch-1,2015-16,Virginia Military Institute,G,16,1,128,10,39,.256,8,22,.364,2,17,.118,9,14,.643,4,20,24,2,3,2,11,9,31,0.4
9903,Chase Winchester\chase-winchester-1,2016-17,Stephen F. Austin,G,12,0,71,7,19,.368,4,9,.444,3,10,.300,14,17,.824,4,8,12,4,2,1,3,14,31,1.8
9904,Calaen Robinson\calaen-robinson-1,2013-14,Arizona State,G,20,0,124,9,28,.321,2,7,.286,7,21,.333,6,6,1.000,1,19,20,21,11,1,8,19,31,1.6
9905,Ronald Whitaker\ronald-whitaker-1,2016-17,Florida International,G,18,0,122,10,35,.286,9,23,.391,1,12,.083,10,14,.714,8,9,17,2,3,0,7,21,31,0.3
9906,Donte Fitzpatrick-Dorsey\donte-fitzpatrick-dorsey-1,2016-17,Mississippi,G,22,2,147,10,27,.370,10,22,.455,0,5,.000,11,12,.917,10,14,24,9,5,1,13,16,31,0.9
9907,Dyrbe Enos\dyrbe-enos--1,2013-14,Hawaii,G,21,0,118,10,29,.345,0,2,.000,10,27,.370,1,2,.500,1,6,7,3,3,1,7,21,31,0.3
9908,Jihar Williams\jihar-williams-1,2017-18,William & Mary,G,15,0,110,10,41,.244,2,10,.200,8,31,.258,3,7,.429,0,9,9,6,6,5,2,8,31,1.1
9909,Dean Danos\dean-danos-1,2014-15,Northern Kentucky,G,19,3,114,8,29,.276,1,5,.200,7,24,.292,8,8,1.000,2,8,10,9,0,1,6,11,31,0.8
9910,Burton Sampson\burton-sampson-1,2016-17,Belmont,G,30,0,327,11,29,.379,6,8,.750,5,21,.238,4,6,.667,10,29,39,14,5,4,15,34,31,0.6
9911,Jason Boswell\jason-boswell-1,2014-15,Florida International,G,29,3,319,11,51,.216,8,31,.258,3,20,.150,6,9,.667,4,18,22,19,10,2,32,38,31,-0.5
9912,Drew Bender\drew-bender-1,2014-15,Northern Colorado,G,9,0,48,10,17,.588,3,3,1.000,7,14,.500,4,4,1.000,1,4,5,3,3,0,1,6,31,3.0
9913,Greg White-Pittman\greg-white-pittman-1,2015-16,North Texas,G,30,0,139,8,23,.348,8,22,.364,0,1,.000,15,35,.429,6,7,13,5,7,0,8,25,31,0.3
9914,Caleb Morris\caleb-morris-1,2016-17,Air Force,G,13,0,97,7,28,.250,6,14,.429,1,14,.071,16,19,.842,3,12,15,7,2,1,5,6,31,1.5
9915,Christian Kessee\christian-kessee-1,2013-14,Coppin State,G,18,0,133,9,34,.265,7,19,.368,2,15,.133,11,13,.846,6,11,17,8,3,0,11,20,31,0.4
9916,Jamil Hood\jamil-hood-1,2014-15,Long Island University,G,24,0,174,10,29,.345,10,21,.476,0,8,.000,11,16,.688,4,22,26,6,4,1,13,19,31,0.4
9917,A.J. Lapray\aj-lapray-1,2014-15,Pepperdine,G,18,4,205,11,43,.256,6,15,.400,5,28,.179,4,7,.571,2,16,18,5,6,4,12,26,31,0.0
9918,Luke Loewe\luke-loewe-1,2017-18,William & Mary,G,27,0,141,10,23,.435,8,16,.500,2,7,.286,9,14,.643,6,8,14,14,2,1,9,17,31,0.7
9919,Eric Wortham\eric-wortham-1,2013-14,Middle Tennessee,G,5,0,75,10,19,.526,6,11,.545,4,8,.500,7,11,.636,2,9,11,4,1,1,4,16,31,3.7
9920,Jordan Walker\jordan-walker-3,2017-18,Seton Hall,G,17,0,123,10,31,.323,4,12,.333,6,19,.316,5,12,.417,2,7,9,15,6,1,12,29,31,0.4
9921,Kyle Ahrens\kyle-ahrens-1,2015-16,Michigan State,G,26,0,86,10,24,.417,6,11,.545,4,13,.308,7,10,.700,8,8,16,7,2,2,9,10,31,0.8
9922,Matt O'Reilly\matt-oreilly-1,2015-16,Bucknell,G,12,0,46,10,20,.500,0,0,,10,20,.500,1,2,.500,0,2,2,1,0,0,0,8,31,1.6
9923,DeAndre Abram\deandre-abram-1,2016-17,George Mason,G,9,1,82,12,26,.462,10,18,.556,2,8,.250,5,7,.714,7,11,18,1,1,3,5,6,31,2.4
9924,Jayvon Brown\jayvon-brown-1,2017-18,UC-Riverside,G,9,1,89,9,26,.346,7,15,.467,2,11,.182,11,15,.733,1,6,7,5,1,0,10,5,31,1.1
9925,Jarrin Randall\jarrin-randall-1,2017-18,Western Michigan,G,24,0,134,10,39,.256,7,18,.389,3,21,.143,8,14,.571,0,5,5,14,9,0,6,14,31,0.6
9926,Jason Hawthorne\jason-hawthorne-1,2013-14,Western Illinois,G,20,3,180,13,33,.394,13,20,.650,0,13,.000,5,11,.455,2,20,22,12,7,1,9,11,31,1.0
9927,Peter Barba\peter-barba-1,2017-18,Columbia,G,12,0,86,11,26,.423,2,5,.400,9,21,.429,0,0,,3,7,10,3,2,0,2,11,31,1.6
9928,Khristian Taylor\khristian-taylor-1,2013-14,Tennessee-Martin,G,22,0,175,12,32,.375,12,30,.400,0,2,.000,7,19,.368,9,13,22,26,9,1,13,18,31,1.2
9929,Oliver Tot\oliver-tot-1,2014-15,William & Mary,G,24,2,222,9,22,.409,7,14,.500,2,8,.250,11,17,.647,5,21,26,27,11,3,21,19,31,1.3
9930,Alterique Gilbert\alterique-gilbert-1,2016-17,Connecticut,G,3,2,87,11,22,.500,9,13,.692,2,9,.222,7,10,.700,1,9,10,6,7,0,4,2,31,9.5
9931,Casey Perrin\casey-perrin-1,2015-16,Campbell,G,9,1,44,10,21,.476,1,2,.500,9,19,.474,2,2,1.000,1,1,2,1,1,0,2,4,31,2.2
9932,Deondre Burns\deondre-burns-1,2015-16,Little Rock,G,18,1,94,9,24,.375,8,14,.571,1,10,.100,12,12,1.000,0,10,10,3,6,1,5,7,31,1.2
9933,Justin McCall\justin-mccall-1,2017-18,Cal State Bakersfield,G,23,0,195,10,28,.357,9,25,.360,1,3,.333,10,18,.556,18,16,34,5,8,4,8,14,31,1.3
9934,George Brock\george-brock-1,2016-17,Southeastern Louisiana,G,15,0,103,11,46,.239,5,22,.227,6,24,.250,3,7,.429,1,3,4,11,2,0,6,11,31,0.2
9935,Case Rada\case-rada-1,2013-14,Sacramento State,G,20,0,85,11,38,.289,3,6,.500,8,32,.250,1,4,.250,2,8,10,3,2,0,2,7,31,0.5
9936,Michael Williams\michael-williams-6,2014-15,Texas Christian,G,17,0,83,11,18,.611,7,11,.636,4,7,.571,5,10,.500,2,9,11,9,1,0,2,5,31,1.7
9937,Guilien Smith\guilien-smith-1,2017-18,Dartmouth,G,3,3,81,10,29,.345,8,20,.400,2,9,.222,9,9,1.000,1,6,7,4,2,0,5,7,31,4.7
9938,C.J. Keyser\cj-keyser-1,2017-18,Wichita State,G,18,0,127,9,24,.375,9,18,.500,0,6,.000,13,15,.867,4,10,14,11,6,2,6,26,31,1.2
9939,Sergio El Darwich\sergio-eldarwich-1,2016-17,South Dakota State,G,12,8,205,12,31,.387,11,28,.393,1,3,.333,6,8,.750,7,29,36,27,4,1,26,11,31,1.7
9940,Rylan Bergersen\rylan-bergersen-1,2017-18,Brigham Young,G,24,0,88,10,19,.526,6,9,.667,4,10,.400,7,8,.875,0,9,9,4,2,1,3,12,31,0.9
9941,Max Twyman\max-twyman-1,2016-17,Hartford,G,25,1,161,11,35,.314,5,8,.625,6,27,.222,3,4,.750,5,11,16,9,3,1,8,21,31,0.4
9942,Montaque Gill-Caesar\montaque-gill-caesar-1,2017-18,San Diego State,G,7,0,78,10,26,.385,6,13,.462,4,13,.308,6,9,.667,4,11,15,4,2,1,9,5,30,2.2
9943,Ronald Whitaker\ronald-whitaker-1,2017-18,Florida International,G,14,0,111,14,27,.519,13,21,.619,1,6,.167,1,4,.250,9,13,22,4,3,3,7,20,30,1.3
9944,David Favorite\david-favorite-1,2015-16,Colgate,G,12,0,110,10,32,.313,0,0,,10,32,.313,0,0,,1,4,5,2,3,0,1,7,30,1.2
9945,Breon Key\breon-key-1,2014-15,Hampton,G,21,0,159,10,20,.500,9,15,.600,1,5,.200,9,14,.643,4,10,14,10,8,0,3,20,30,1.3
9946,Nemanja Zarkovic\nemanja-zarkovic-1,2016-17,Fordham,G,11,0,220,9,29,.310,1,5,.200,8,24,.333,4,6,.667,2,13,15,13,10,0,3,16,30,2.5
9947,Ronnie Suggs\ronnie-suggs-1,2016-17,Bradley,G,16,1,115,10,32,.313,9,17,.529,1,15,.067,9,16,.563,6,22,28,5,4,1,5,11,30,1.2
9948,Jacob Guest\jacob-guest-1,2017-18,Northwestern State,G,22,0,150,10,48,.208,3,12,.250,7,36,.194,3,4,.750,0,14,14,4,3,1,14,10,30,-0.3
9949,Max Tinsley\max-tinsley-1,2016-17,Pacific,G,19,5,201,12,30,.400,8,19,.421,4,11,.364,2,5,.400,10,16,26,13,4,0,7,15,30,1.3
9950,Teris Bourgeois\teris-bourgeois-1,2013-14,New Orleans,G,6,3,150,11,31,.355,9,22,.409,2,9,.222,6,8,.750,5,14,19,10,2,0,8,18,30,2.2
9951,Dajuan Jones\dajuan-jones-1,2017-18,Sam Houston State,G,14,0,91,11,27,.407,8,15,.533,3,12,.250,5,14,.357,1,10,11,16,1,0,13,8,30,0.8
9952,Stephen O'Suji\stephen-osuji-1,2015-16,Houston Baptist,G,15,0,129,12,30,.400,10,24,.417,2,6,.333,4,9,.444,7,12,19,10,5,0,19,10,30,0.6
9953,Alex Copeland\alex-copeland-1,2015-16,Yale,G,14,0,59,11,23,.478,9,20,.450,2,3,.667,6,10,.600,3,6,9,6,3,1,3,5,30,1.7
9954,Haroldas Saprykinas\haroldas-saprykinas-1,2014-15,UC-Irvine,G,16,0,62,8,15,.533,3,6,.500,5,9,.556,9,14,.643,0,4,4,2,0,0,2,3,30,1.3
9955,Rasean Simpson\rasean-simpson-1,2013-14,Morgan State,G,21,3,102,10,28,.357,3,10,.300,7,18,.389,3,6,.500,6,12,18,3,2,3,4,11,30,0.9
9956,Kerwin Okoro\kerwin-okoro-1,2013-14,Rutgers,G,11,0,82,11,22,.500,7,14,.500,4,8,.500,4,5,.800,4,6,10,1,1,0,6,8,30,1.4
9957,Nevell Provo\nevell-provo-1,2016-17,Loyola (MD),G,21,3,193,9,49,.184,2,17,.118,7,32,.219,5,7,.714,5,14,19,13,5,1,11,21,30,0.1
9958,Matty Madigan\matty-madigan-1,2013-14,Brown,G,29,0,296,9,33,.273,5,18,.278,4,15,.267,8,13,.615,2,26,28,19,15,2,14,38,30,0.6
9959,Micah Walker\micah-walker-1,2013-14,New Orleans,G,11,4,119,9,33,.273,4,14,.286,5,19,.263,7,12,.583,5,9,14,2,6,0,10,23,30,0.3
9960,Trent VanHorn\trent-vanhorn-1,2015-16,Wake Forest,G,19,0,234,8,26,.308,7,15,.467,1,11,.091,13,17,.765,3,13,16,8,8,0,10,20,30,0.8
9961,Joe Garza\joe-garza-1,2017-18,New Mexico State,G,19,0,153,8,30,.267,0,2,.000,8,28,.286,6,7,.857,0,8,8,4,1,0,8,16,30,0.2
9962,Shaquiell Mitchell\shaquille-mitchell-1,2013-14,South Carolina State,G,24,2,230,10,40,.250,8,32,.250,2,8,.250,8,22,.364,15,26,41,12,7,1,25,23,30,0.0
9963,Jordan Brown\jordan-brown-1,2014-15,Arkansas-Pine Bluff,G,21,0,156,13,27,.481,13,27,.481,0,0,,4,7,.571,16,17,33,4,3,1,5,15,30,1.3
9964,Mason Alwan\mason-alwan-1,2013-14,Bradley,G,22,1,138,11,21,.524,8,15,.533,3,6,.500,5,7,.714,4,8,12,4,5,0,9,6,30,0.9
9965,Brandon Brady\brandon-brady-1,2017-18,Little Rock,G,14,1,134,11,29,.379,6,9,.667,5,20,.250,3,5,.600,1,10,11,7,2,0,4,8,30,1.2
9966,Eric Stafford\eric-stafford-1,2015-16,Lafayette,G,28,3,296,9,35,.257,6,17,.353,3,18,.167,9,15,.600,4,33,37,23,10,1,18,37,30,0.5
9967,C.J. Anderson\cj-anderson-3,2014-15,Massachusetts,G,29,0,293,10,30,.333,7,17,.412,3,13,.231,7,10,.700,10,31,41,17,9,2,11,41,30,0.8
9968,Nick Kerr\nick-kerr-1,2013-14,San Diego,G,21,0,88,10,26,.385,0,5,.000,10,21,.476,0,0,,0,2,2,3,1,0,6,5,30,0.5
9969,Kye de Laveaga\kye-de-laveaga-1,2015-16,Northern Arizona,G,18,5,161,8,36,.222,0,2,.000,8,34,.235,6,7,.857,0,10,10,14,5,2,5,18,30,0.8
9970,Lasani Johnson\lasani-johnson-1,2015-16,Stephen F. Austin,G,18,0,79,12,27,.444,6,14,.429,6,13,.462,0,1,.000,2,5,7,3,2,1,5,9,30,0.8
9971,Tevin Caldwell\tevin-caldwell-1,2013-14,Texas-El Paso,G,30,1,142,9,18,.500,9,18,.500,0,0,,12,17,.706,7,9,16,8,6,2,2,10,30,1.1
9972,Justin Brown\justin-brown-4,2017-18,North Carolina-Asheville,G,12,1,65,10,20,.500,9,12,.750,1,8,.125,9,9,1.000,3,8,11,2,2,2,5,16,30,1.5
9973,Thomas Nolan\thomas-nolan-1,2016-17,Fairfield,G,16,2,190,11,37,.297,3,9,.333,8,28,.286,0,0,,3,10,13,8,4,1,5,18,30,0.7
9974,Franklin Porter\franklin-porter-1,2015-16,Saint Mary's (CA),G,22,0,65,9,20,.450,5,12,.417,4,8,.500,8,11,.727,7,12,19,1,1,0,3,5,30,1.1
9975,Jalen Rhea\jalen-rhea-1,2013-14,American,G,13,0,55,8,18,.444,1,3,.333,7,15,.467,7,10,.700,3,3,6,1,0,0,1,1,30,1.7
9976,Rashad Jackson\rashad-jackson-1,2015-16,Portland,G,21,4,141,11,47,.234,8,27,.296,3,20,.150,5,11,.455,4,20,24,9,6,1,9,20,30,0.2
9977,Logan Koch\logan-koch-1,2017-18,Eastern Illinois,G,13,1,227,10,35,.286,2,5,.400,8,30,.267,2,2,1.000,0,13,13,14,8,0,11,21,30,0.9
9978,Jaylen Stowe\jaylen-stowe-1,2015-16,Mercer,G,23,0,97,9,28,.321,2,13,.154,7,15,.467,5,10,.500,3,14,17,5,3,0,7,14,30,0.5
9979,Bryan Gee\bryan-gee-1,2015-16,Longwood,G,33,5,497,8,44,.182,6,26,.231,2,18,.111,12,23,.522,5,59,64,58,14,1,33,47,30,0.7
9980,Charlie Byers\charlie-byers-1,2013-14,Kennesaw State,G,25,0,169,14,34,.412,13,31,.419,1,3,.333,1,2,.500,8,8,16,11,4,0,9,18,30,0.6
9981,Marquel Curtis\marquel-curtis-1,2013-14,Tulsa,G,10,1,121,12,37,.324,12,30,.400,0,7,.000,5,11,.455,9,13,22,9,4,2,4,12,29,1.9
9982,Shane Benton\shane-benton-1,2013-14,North Dakota,G,19,1,183,8,25,.320,6,16,.375,2,9,.222,11,20,.550,2,16,18,9,7,0,8,26,29,0.6
9983,Justin Cousin\justin-cousin-1,2013-14,Radford,G,29,0,146,9,27,.333,5,13,.385,4,14,.286,7,13,.538,5,11,16,4,2,0,13,11,29,0.2
9984,Maleke Haynes\maleke-haynes-1,2016-17,Pacific,G,24,6,294,8,38,.211,6,21,.286,2,17,.118,11,14,.786,3,29,32,29,9,1,25,35,29,0.3
9985,Corey Hilliard\corey-hilliard-1,2013-14,San Francisco,G,9,0,106,7,25,.280,4,16,.250,3,9,.333,12,13,.923,2,10,12,4,2,1,12,16,29,0.6
9986,Justin Brickman\justin-brickman-1,2015-16,Bryant,G,19,0,176,9,31,.290,6,22,.273,3,9,.333,8,9,.889,5,16,21,21,11,0,19,20,29,0.9
9987,Caleb Simmons\caleb-simmons-1,2017-18,San Jose State,G,24,1,219,8,29,.276,3,8,.375,5,21,.238,8,10,.800,6,26,32,16,7,0,18,19,29,0.7
9988,Jesse Pistokache\jesse-pistokache-1,2015-16,Richmond,G,15,0,104,11,28,.393,5,10,.500,6,18,.333,1,6,.167,2,3,5,5,0,2,6,10,29,0.6
9989,Luke Norman\luke-norman-1,2014-15,Eastern Illinois,G,21,0,246,11,19,.579,4,5,.800,7,14,.500,0,0,,2,16,18,16,7,1,9,18,29,1.4
9990,Sean O'Brien\sean-obrien-2,2014-15,Colgate,G,32,0,256,10,42,.238,3,10,.300,7,32,.219,2,3,.667,6,24,30,11,7,1,15,35,29,0.0
9991,Jeremiah Ferguson\jeremiah-ferguson-1,2016-17,Youngstown State,G,23,0,92,10,20,.500,8,14,.571,2,6,.333,7,14,.500,1,12,13,13,6,0,11,11,29,0.9
9992,Darrian Traylor\darrian-traylor-1,2016-17,UC-Irvine,G,20,0,66,9,19,.474,2,3,.667,7,16,.438,4,7,.571,2,12,14,7,0,0,3,6,29,1.1
9993,Kamali Chambers\kamali-chambers-1,2016-17,Boston University,G,16,0,87,8,17,.471,5,9,.556,3,8,.375,10,13,.769,3,4,7,4,2,0,4,9,29,1.2
9994,Matt Staubi\matt-staubi-1,2015-16,Loyola (MD),G,19,0,129,9,17,.529,3,7,.429,6,10,.600,5,7,.714,1,5,6,25,5,0,16,11,29,1.3
9995,Jordan Watkins\jordan-watkins-1,2017-18,Davidson,G,16,0,99,10,25,.400,1,3,.333,9,22,.409,0,0,,1,8,9,8,4,0,5,7,29,1.3
9996,Talek Williams\talek-williams-1,2017-18,Central Connecticut State,G,11,2,118,9,26,.346,8,17,.471,1,9,.111,10,13,.769,1,8,9,9,3,1,7,12,29,1.3
9997,Kameron Mitchell\kameron-mitchell-1,2013-14,Stony Brook,G,17,2,143,10,27,.370,2,6,.333,8,21,.381,1,2,.500,3,3,6,6,3,2,9,18,29,0.5
9998,Kevion Stewart\kevion-stewart-1,2017-18,Southern Illinois-Edwardsville,G,17,0,127,8,27,.296,0,4,.000,8,23,.348,5,6,.833,4,14,18,8,3,0,6,13,29,1.0
9999,Drew Hackett\drew-hackett-1,2015-16,Illinois-Chicago,G,21,3,184,8,36,.222,5,14,.357,3,22,.136,10,15,.667,4,13,17,11,6,1,16,18,29,0.1
10000,Ty Solomon\ty-solomon-2,2016-17,South Carolina State,G,15,9,290,8,32,.250,5,15,.333,3,17,.176,10,14,.714,5,24,29,33,10,0,20,27,29,1.4
10001,Dustin Hobaugh\dustin-hobaugh-1,2015-16,North Dakota,G,27,1,175,7,20,.350,7,16,.438,0,4,.000,15,23,.652,11,25,36,3,4,0,10,23,29,0.6
10002,Devin Liggeons\devin-liggeons-1,2015-16,Wagner,G,15,3,73,8,27,.296,6,19,.316,2,8,.250,11,19,.579,11,10,21,2,3,2,3,13,29,1.2
10003,Eli Robison\eli-robison-1,2014-15,Utah Valley,G,21,2,113,9,31,.290,5,16,.313,4,15,.267,7,8,.875,9,12,21,3,2,0,6,5,29,0.8
10004,Dayshawn Watkins\dayshawn-watkins-1,2014-15,Florida State,G,22,0,198,7,25,.280,6,17,.353,1,8,.125,14,21,.667,2,20,22,20,8,0,17,25,29,0.6
10005,Shaun Noriega\shaun-noriega-1,2014-15,Texas-Rio Grande Valley,G,3,3,62,9,20,.450,2,4,.500,7,16,.438,4,5,.800,1,3,4,2,1,0,5,8,29,4.7
10006,Luka Andjusic\luka-andjusic-1,2014-15,South Alabama,G,18,0,140,9,33,.273,1,5,.200,8,28,.286,3,3,1.000,2,16,18,6,2,0,5,11,29,0.7
10007,Taylor Dunn\taylor-dunn-1,2013-14,La Salle,G,23,2,113,9,28,.321,1,2,.500,8,26,.308,3,4,.750,2,10,12,4,0,1,4,12,29,0.5
10008,Major Canady\major-canady-1,2016-17,Drexel,G,21,2,190,9,36,.250,4,14,.286,5,22,.227,6,14,.429,4,19,23,29,5,0,11,18,29,0.9
10009,J.J. Butler\jj-butler-1,2015-16,Lipscomb,G,32,0,278,11,24,.458,8,15,.533,3,9,.333,4,10,.400,5,24,29,30,11,2,26,38,29,0.5
10010,Anthony Mathis\anthony-mathis-1,2016-17,New Mexico,G,10,0,64,10,25,.400,4,6,.667,6,19,.316,3,3,1.000,1,9,10,8,2,0,2,4,29,2.3
10011,Jalen Duke\jalen-duke-1,2017-18,Tennessee State,G,17,0,122,11,20,.550,8,12,.667,3,8,.375,4,8,.500,2,7,9,2,2,3,6,15,29,0.9
10012,Dusan Langura\dusan-langura-1,2015-16,Mississippi Valley State,G,16,1,84,10,31,.323,1,3,.333,9,28,.321,0,0,,1,7,8,0,0,1,2,9,29,0.6
10013,Rohan Brown\rohan-brown-1,2014-15,La Salle,G,28,0,210,11,23,.478,7,11,.636,4,12,.333,3,6,.500,18,26,44,7,6,4,9,9,29,1.3
10014,Felix Balamou\felix-balamou-1,2014-15,St. John's (NY),G,22,3,203,11,36,.306,11,36,.306,0,0,,7,11,.636,14,15,29,4,6,1,14,28,29,0.2
10015,Brandon Price\brandon-price-1,2013-14,Western Kentucky,G,14,1,99,8,20,.400,6,13,.462,2,7,.286,11,14,.786,6,3,9,6,4,0,13,8,29,1.0
10016,Matt Battaglia\matt-battaglia-1,2016-17,Sacramento State,G,20,0,96,9,33,.273,0,5,.000,9,28,.321,2,3,.667,1,7,8,5,2,1,0,7,29,0.8
10017,Jalon Plummer\jalon-plummer-1,2013-14,Youngstown State,G,14,0,68,11,24,.458,9,13,.692,2,11,.182,5,12,.417,8,4,12,3,2,0,5,8,29,1.2
10018,D'Angelo West\dangelo-west-1,2017-18,Southeastern Louisiana,G,19,0,154,9,46,.196,0,6,.000,9,40,.225,2,2,1.000,1,7,8,6,1,0,7,12,29,-0.2
10019,Shaqquan Aaron\shaqquan-aaron-1,2014-15,Louisville,G,23,2,166,11,42,.262,6,19,.316,5,23,.217,2,5,.400,6,11,17,5,3,2,8,11,29,0.3
10020,Nate Hickman\nate-hickman-1,2014-15,Columbia,G,19,0,131,8,33,.242,5,17,.294,3,16,.188,10,13,.769,5,11,16,3,6,3,12,16,29,0.3
10021,Karon Waller\karon-waller-1,2014-15,Binghamton,G,23,0,185,10,33,.303,6,15,.400,4,18,.222,5,9,.556,4,27,31,4,5,0,5,8,29,0.8
10022,Christian Hildebrandt\christian-hildebrandt-1,2013-14,Texas-Rio Grande Valley,G,24,1,139,8,34,.235,2,11,.182,6,23,.261,7,9,.778,5,13,18,9,1,0,4,19,29,0.4
10023,Josh Ivory\josh-ivory-1,2014-15,Towson,G,24,10,271,9,41,.220,2,14,.143,7,27,.259,4,8,.500,1,16,17,31,6,0,20,19,29,0.3
10024,Collin Weaver\collin-weaver-1,2014-15,Oakland,G,17,0,86,10,30,.333,3,5,.600,7,25,.280,2,2,1.000,3,13,16,3,4,0,3,7,29,1.1
10025,Dominique Hawkins\dominique-hawkins-1,2014-15,Kentucky,G,23,9,163,10,35,.286,5,14,.357,5,21,.238,4,10,.400,3,13,16,14,7,1,5,14,29,0.8
10026,Juwan Henderson\juwan-henderson-1,2016-17,Alcorn State,G,29,0,294,9,39,.231,8,24,.333,1,15,.067,10,18,.556,8,20,28,46,19,0,41,34,29,0.4
10027,C.J. Siples\cj-siples-1,2014-15,Air Force,G,18,1,125,10,18,.556,9,15,.600,1,3,.333,8,17,.471,1,10,11,11,5,3,9,15,29,1.1
10028,Charles Harris\charles-harris-2,2013-14,Western Michigan,G,12,0,54,12,19,.632,10,14,.714,2,5,.400,3,7,.429,5,8,13,5,1,1,4,5,29,2.0
10029,Jordan Lester\jordan-lester-1,2015-16,Robert Morris,G,22,2,240,12,36,.333,10,24,.417,2,12,.167,3,4,.750,2,19,21,17,9,0,16,19,29,0.6
10030,Andre Edwards\andre-edwards-1,2017-18,East Tennessee State,G,4,0,60,12,28,.429,8,16,.500,4,12,.333,1,2,.500,4,7,11,3,5,3,2,4,29,6.1
10031,Remy Roberts-Burnett\remy-roberts-brunett-1,2014-15,Western Illinois,G,16,0,177,12,37,.324,10,33,.303,2,4,.500,3,8,.375,2,16,18,11,3,0,9,10,29,0.6
10032,Hunter Ford\hunter-ford-1,2014-15,UC-Santa Barbara,G,13,0,67,10,18,.556,2,2,1.000,8,16,.500,1,2,.500,7,3,10,6,1,1,1,3,29,2.3
10033,Austin Waddoups\austin-waddoups-1,2014-15,Southern Utah,G,16,1,132,10,27,.370,3,11,.273,7,16,.438,2,5,.400,1,13,14,11,0,1,6,18,29,0.8
10034,Tim Jacobs\tim-jacobs-1,2015-16,New Mexico,G,26,0,252,9,19,.474,5,14,.357,4,5,.800,6,9,.667,3,37,40,39,10,1,18,28,28,1.5
10035,Daniel Noe\daniel-noe-1,2014-15,Navy,G,7,3,93,11,34,.324,7,13,.538,4,21,.190,2,3,.667,6,10,16,3,3,1,6,7,28,1.8
10036,Von Washington\von-washington-1,2014-15,Western Michigan,G,14,0,76,10,29,.345,2,5,.400,8,24,.333,0,1,.000,1,6,7,2,3,0,1,4,28,1.1
10037,Hansel Atencia\hansel-atencia-1,2015-16,Liberty,G,19,1,165,8,27,.296,7,21,.333,1,6,.167,11,19,.579,3,12,15,17,4,0,10,22,28,0.6
10038,Malcolm Brent\malcolm-brent-1,2016-17,Maryland-Baltimore County,G,14,0,74,9,24,.375,3,10,.300,6,14,.429,4,5,.800,0,4,4,3,1,0,3,10,28,0.8
10039,Christian David\christian-david-1,2017-18,Butler,G,25,0,139,10,29,.345,7,13,.538,3,16,.188,5,9,.556,5,10,15,9,4,1,8,19,28,0.5
10040,Brian Greene\brian-greene-3,2014-15,Florida Gulf Coast,G,29,0,284,11,57,.193,11,42,.262,0,15,.000,6,9,.667,3,21,24,25,7,1,26,28,28,-0.4
10041,Spencer Sutton\spencer-sutton-1,2017-18,Oral Roberts,G,22,0,127,10,26,.385,3,7,.429,7,19,.368,1,3,.333,4,4,8,9,2,0,13,15,28,0.3
10042,Casdon Jardine\casdon-jardine-1,2017-18,Boise State,G,18,0,78,9,26,.346,6,9,.667,3,17,.176,7,8,.875,14,8,22,2,0,0,3,12,28,1.0
10043,Telvin Marshall\telvin-marshall-1,2014-15,Grambling,G,5,2,97,13,40,.325,13,29,.448,0,11,.000,2,4,.500,4,10,14,2,2,0,4,5,28,1.5
10044,Derrick Cook\derrick-cook-1,2017-18,Northeastern,G,17,0,86,11,23,.478,8,19,.421,3,4,.750,3,6,.500,1,10,11,5,3,0,7,3,28,1.0
10045,Grant Prusator\grant-prusator-1,2015-16,Indiana State,G,27,0,118,9,36,.250,0,3,.000,9,33,.273,1,5,.200,0,10,10,6,1,0,1,12,28,0.3
10046,Brett Bowling\brett-bowling-1,2014-15,Marshall,G,14,0,67,8,27,.296,4,7,.571,4,20,.200,8,10,.800,1,2,3,0,1,0,2,7,28,0.6
10047,PJ Santavenere\pj-santavenere-1,2013-14,St. Francis (NY),G,15,0,104,10,32,.313,5,8,.625,5,24,.208,3,6,.500,4,11,15,1,4,1,2,16,28,0.8
10048,Montenia Nelson\montenia-nelson-1,2017-18,Presbyterian,G,6,2,104,11,24,.458,7,13,.538,4,11,.364,2,5,.400,1,9,10,6,0,0,9,8,28,1.6
10049,Jonathan Thomas\justin-thomas-3,2014-15,Jackson State,G,27,4,252,8,16,.500,8,16,.500,0,0,,12,20,.600,12,18,30,6,6,0,17,67,28,-0.1
10050,Kamali Chambers\kamali-chambers-1,2015-16,Boston University,G,24,0,141,8,21,.381,3,7,.429,5,14,.357,7,11,.636,1,8,9,10,3,0,4,16,28,0.7
10051,Jordan Brown\jordan-brown-1,2013-14,Arkansas-Pine Bluff,G,20,0,132,12,24,.500,12,24,.500,0,0,,4,14,.286,6,13,19,2,4,1,0,8,28,1.2
10052,Chris Braley\chris-braley-1,2013-14,Stony Brook,G,25,0,144,9,26,.346,3,7,.429,6,19,.316,4,6,.667,9,20,29,3,4,0,7,21,28,0.6
10053,Aziz Seck\aziz-seck-1,2016-17,Northern Arizona,G,21,3,151,12,35,.343,12,34,.353,0,1,.000,4,16,.250,12,20,32,2,5,3,8,29,28,0.3
10054,Joel Okafor\joel-okafor-1,2015-16,Bradley,G,26,2,280,10,40,.250,10,28,.357,0,12,.000,8,19,.421,5,25,30,29,9,1,32,41,28,-0.3
10055,Ron Patterson\ron-patterson-1,2013-14,Syracuse,G,10,0,54,11,29,.379,5,10,.500,6,19,.316,0,3,.000,6,1,7,5,4,0,3,4,28,1.8
10056,Wesley Alcegaire\wesley-alcegaire-1,2013-14,Liberty,G,21,0,46,11,18,.611,10,15,.667,1,3,.333,5,9,.556,4,7,11,2,1,0,3,6,28,1.0
10057,Avery Brown\avery-brown-1,2015-16,Green Bay,G,15,0,81,10,29,.345,4,14,.286,6,15,.400,2,8,.250,5,8,13,6,4,0,4,2,28,1.2
10058,Cortlan Henry\cortlan-henry-1,2013-14,Mississippi Valley State,G,24,1,184,10,27,.370,6,18,.333,4,9,.444,4,4,1.000,8,7,15,6,9,0,8,32,28,0.6
10059,Sam Cunliffe\sam-cunliffe-1,2017-18,Kansas,G,15,0,74,12,25,.480,10,17,.588,2,8,.250,2,2,1.000,2,7,9,4,2,1,5,11,28,1.0
10060,Vic Adams\vic-adams-1,2013-14,Saint Peter's,G,5,0,67,9,25,.360,5,10,.500,4,15,.267,6,7,.857,2,4,6,5,5,0,9,5,28,2.8
10061,Brian Coffey II\brian-coffeyii-1,2017-18,North Florida,G,22,1,172,9,32,.281,6,18,.333,3,14,.214,7,9,.778,5,7,12,11,4,0,14,17,28,0.2
10062,Kevin Crawford\kevin-crawford-2,2014-15,North Carolina Central,G,18,0,93,10,15,.667,10,15,.667,0,0,,8,9,.889,1,5,6,24,8,0,6,12,28,2.1
10063,Myles Stewart\myles-stewart-1,2014-15,St. John's (NY),G,20,1,96,10,33,.303,2,6,.333,8,27,.296,0,0,,1,7,8,2,2,3,3,10,28,0.5
10064,Kevin Alter\kevin-alter-1,2014-15,Navy,G,15,1,71,9,19,.474,3,3,1.000,6,16,.375,4,6,.667,0,5,5,5,2,0,1,3,28,1.5
10065,TeMarcus Blanton\temarcus-blanton-1,2016-17,South Carolina,G,21,0,123,10,26,.385,6,14,.429,4,12,.333,4,8,.500,8,14,22,2,6,0,6,10,28,0.9
10066,Oliver Tot\oliver-tot-1,2015-16,William & Mary,G,26,0,171,10,21,.476,6,12,.500,4,9,.444,4,8,.500,2,21,23,22,8,5,12,24,28,1.1
10067,Kameron Mitchell\kameron-mitchell-1,2015-16,Stony Brook,G,26,0,229,10,36,.278,3,15,.200,7,21,.333,1,3,.333,4,11,15,14,9,0,8,22,28,0.5
10068,Jimmy Marshall\jimmy-marshall-1,2013-14,Northeastern,G,22,0,115,9,36,.250,2,7,.286,7,29,.241,3,4,.750,1,9,10,8,6,0,6,11,28,0.5
10069,Chris Avenant\chris-avenant-1,2013-14,Northeastern,G,22,1,122,11,22,.500,5,11,.455,6,11,.545,0,0,,3,6,9,4,3,1,5,27,28,0.5
10070,James Jones\james-jones-5,2016-17,Buffalo,G,14,0,83,10,26,.385,5,11,.455,5,15,.333,3,5,.600,1,4,5,4,0,0,3,8,28,0.8
10071,Isaiah Morton\isaiah-morton-1,2013-14,Marist,G,9,3,192,6,46,.130,1,14,.071,5,32,.156,11,14,.786,2,15,17,21,5,0,15,10,28,0.4
10072,Alyx Foster\alyx-foster-1,2013-14,Portland State,G,31,0,259,8,19,.421,4,10,.400,4,9,.444,8,14,.571,1,34,35,6,6,1,7,46,28,0.4
10073,Josh Thompson\josh-thompson-1,2017-18,Ball State,G,15,0,152,7,20,.350,3,7,.429,4,13,.308,10,12,.833,1,9,10,5,5,0,6,14,28,1.1
10074,Cam Christon\cam-christon-1,2017-18,Boise State,G,14,0,83,9,23,.391,3,7,.429,6,16,.375,4,7,.571,5,12,17,8,1,1,7,8,28,1.3
10075,Nevell Provo\nevell-provo-1,2015-16,Loyola (MD),G,26,0,219,12,28,.429,8,11,.727,4,17,.235,0,1,.000,2,9,11,22,7,1,16,19,28,0.6
10076,Lorenzen Wright Jr.\lorenzen-wrightjr-1,2017-18,Tennessee-Martin,G,18,0,82,9,27,.333,1,3,.333,8,24,.333,2,3,.667,2,8,10,2,3,0,3,5,28,0.9
10077,D'Angelo West\dangelo-west-1,2015-16,Texas State,G,19,0,99,8,30,.267,2,6,.333,6,24,.250,6,8,.750,2,10,12,3,1,1,5,11,28,0.4
10078,Nick Davidson\nick-davidson-1,2014-15,Valparaiso,G,15,1,94,8,22,.364,2,8,.250,6,14,.429,6,6,1.000,3,5,8,6,3,0,6,3,28,1.3
10079,DeMarc Richardson\demarc-richardson-1,2013-14,Tennessee-Martin,G,25,11,255,9,25,.360,9,23,.391,0,2,.000,10,17,.588,6,10,16,35,5,1,21,21,28,0.8
10080,Tyson Jolly\tyson-jolly-1,2017-18,Baylor,G,20,0,178,9,43,.209,7,24,.292,2,19,.105,7,10,.700,9,27,36,17,4,5,14,32,27,0.3
10081,Travis Fields\travis-fields-1,2016-17,Old Dominion,G,28,0,159,12,46,.261,9,29,.310,3,17,.176,0,0,,2,6,8,12,8,0,6,20,27,0.2
10082,Jordan Martin\jordan-martin-1,2015-16,Eastern Michigan,G,16,1,102,9,26,.346,9,25,.360,0,1,.000,9,17,.529,13,19,32,3,5,4,4,19,27,1.4
10083,Maishe Dailey\maishe-dailey-1,2016-17,Iowa,G,12,0,91,10,22,.455,6,10,.600,4,12,.333,3,6,.500,3,16,19,5,4,1,5,6,27,1.8
10084,Mahir Johnson\mahir-johnson-1,2015-16,Delaware State,G,10,0,80,11,26,.423,8,19,.421,3,7,.429,2,3,.667,4,4,8,3,3,0,6,9,27,1.2
10085,Joeviair Kennedy\joeviair-kennedy-1,2016-17,Western Michigan,G,8,0,59,12,24,.500,10,18,.556,2,6,.333,1,1,1.000,4,3,7,2,2,0,2,7,27,2.2
10086,Jose Morales\jose-morales-1,2017-18,Princeton,G,12,0,88,7,20,.350,5,12,.417,2,8,.250,11,12,.917,2,5,7,6,5,2,6,14,27,1.4
10087,Monty Boykins\monty-boykins-1,2017-18,Pittsburgh,G,20,1,113,6,31,.194,2,10,.200,4,21,.190,11,22,.500,0,10,10,2,2,0,7,8,27,0.0
10088,Mitch Roelke\mitch-roelke-1,2013-14,Milwaukee,G,21,0,126,7,19,.368,0,3,.000,7,16,.438,6,8,.750,1,6,7,9,2,0,8,9,27,0.7
10089,Dustin Triano\dustin-triano-1,2015-16,Gonzaga,G,18,0,55,9,15,.600,3,3,1.000,6,12,.500,3,5,.600,4,5,9,6,1,0,2,8,27,1.3
10090,Miles Jackson\miles-jackson-1,2013-14,Hampton,G,21,0,120,10,19,.526,6,11,.545,4,8,.500,3,5,.600,2,15,17,6,3,2,7,9,27,1.0
10091,Benedikt Haid\benedikt-haid-1,2017-18,North Florida,G,13,0,81,9,19,.474,4,4,1.000,5,15,.333,4,4,1.000,4,8,12,1,0,1,5,5,27,1.3
10092,Raine McKeython\raine-mckeython-1,2017-18,Stetson,G,13,0,75,11,35,.314,6,18,.333,5,17,.294,0,0,,2,7,9,2,0,1,5,6,27,0.4
10093,Garrett Collins\garrett-collins-1,2015-16,North Carolina-Greensboro,G,16,0,89,7,16,.438,0,2,.000,7,14,.500,6,6,1.000,4,14,18,2,1,3,2,5,27,1.6
10094,Mladen Djordjevic\mladen-djordjevic-1,2015-16,San Francisco,G,21,0,157,8,25,.320,1,8,.125,7,17,.412,4,7,.571,0,11,11,5,4,1,10,24,27,0.2
10095,Trey Landers\trey-landers-1,2016-17,Dayton,G,9,0,52,11,17,.647,10,14,.714,1,3,.333,4,10,.400,4,9,13,3,3,2,3,17,27,2.1
10096,Mareik Isom\mareik-isom-1,2016-17,Texas,G,15,1,104,10,23,.435,4,6,.667,6,17,.353,1,5,.200,4,14,18,1,2,3,5,21,27,0.8
10097,Dwain Whitfield\dwain-whitfield-1,2015-16,Mississippi Valley State,G,33,9,256,12,29,.414,12,29,.414,0,0,,3,4,.750,21,20,41,5,3,0,9,26,27,0.6
10098,Brian Greene\brian-greene-3,2015-16,Florida Gulf Coast,G,18,3,106,9,21,.429,4,11,.364,5,10,.500,4,7,.571,0,9,9,14,5,1,6,16,27,1.1
10099,Eli Stalzer\eli-stalzer-1,2014-15,Colorado,G,19,0,113,10,27,.370,4,9,.444,6,18,.333,1,3,.333,2,9,11,5,5,1,6,6,27,0.9
10100,Matthew Butler\matthew-butler-1,2013-14,Rhode Island,G,23,0,134,10,30,.333,3,11,.273,7,19,.368,0,0,,1,7,8,6,2,0,5,13,27,0.4
10101,Christian Williams\christian-williams-1,2015-16,Iowa,G,20,0,101,9,28,.321,7,22,.318,2,6,.333,7,9,.778,9,8,17,6,4,0,6,6,27,0.9
10102,Kenny Carpenter\kenny-carpenter-1,2014-15,Cleveland State,G,23,0,159,10,32,.313,8,21,.381,2,11,.182,5,8,.625,12,17,29,12,3,0,13,20,27,0.5
10103,Austin Grandstaff\austin-grandstaff-1,2017-18,DePaul,G,20,0,148,9,47,.191,2,9,.222,7,38,.184,2,4,.500,3,10,13,16,2,1,12,11,27,0.0
10104,Wyatt Lohaus\wyatt-lohaus-1,2016-17,Northern Iowa,G,6,4,143,10,36,.278,6,20,.300,4,16,.250,3,4,.750,4,9,13,2,3,0,3,8,27,1.5
10105,Stephen Edwards\stephen-edwards-1,2014-15,Santa Clara,G,20,0,130,9,26,.346,8,18,.444,1,8,.125,8,14,.571,0,10,10,5,1,0,18,3,27,-0.1
10106,Aaron Young\aaron-young-2,2015-16,Princeton,G,19,0,86,7,17,.412,2,3,.667,5,14,.357,8,11,.727,2,6,8,9,2,0,3,10,27,1.1
10107,Michael Hueitt Jr\michael-hueittjr-1,2017-18,Old Dominion,G,13,0,77,9,22,.409,0,3,.000,9,19,.474,0,0,,5,22,27,7,1,0,2,2,27,2.2
10108,Mahir Johnson\mahir-johnson-1,2016-17,Delaware State,G,6,1,46,12,21,.571,11,20,.550,1,1,1.000,2,3,.667,3,3,6,1,0,0,4,4,27,2.5
10109,Deyshonee Much\deyshonee-much-1,2013-14,Buffalo,G,22,0,145,9,32,.281,4,7,.571,5,25,.200,4,12,.333,4,11,15,8,4,2,6,15,27,0.5
10110,Ron Trapps\ron-trapps-1,2014-15,Coastal Carolina,G,8,0,30,9,20,.450,4,5,.800,5,15,.333,4,6,.667,0,5,5,1,1,0,4,5,27,1.6
10111,Nourse Fox\nourse-fox-1,2017-18,Navy,G,30,4,280,9,33,.273,8,18,.444,1,15,.067,8,10,.800,3,18,21,29,12,0,21,28,27,0.5
10112,Jesse Love\jesse-love-1,2016-17,Jackson State,G,24,4,236,8,22,.364,6,13,.462,2,9,.222,9,16,.563,8,12,20,9,8,0,6,28,27,0.8
10113,Tre Clark\tre-clark-1,2016-17,Furman,G,22,0,173,9,36,.250,9,29,.310,0,7,.000,9,22,.409,10,21,31,17,4,5,20,12,27,0.4
10114,Ladarius Coleman\ladarius-coleman-1,2014-15,Southeast Missouri State,G,10,0,93,7,27,.259,5,19,.263,2,8,.250,11,13,.846,1,15,16,6,1,1,4,6,27,1.5
10115,Reese Morgan\reese-morgan-1,2013-14,Cal Poly,G,9,0,68,6,25,.240,1,4,.250,5,21,.238,10,10,1.000,4,2,6,2,2,2,3,12,27,1.4
10116,Tavarius Shine\tavarius-shine-1,2016-17,Oklahoma State,G,6,1,104,9,22,.409,5,7,.714,4,15,.267,5,10,.500,6,4,10,6,7,3,2,11,27,4.3
10117,Josh Kozinski\josh-kozinski-1,2013-14,Central Michigan,G,9,0,106,9,42,.214,0,0,,9,42,.214,0,0,,2,6,8,3,1,2,1,9,27,0.5
10118,Grant White\grant-white-1,2015-16,Grand Canyon,G,14,1,72,9,29,.310,3,9,.333,6,20,.300,3,6,.500,0,6,6,4,0,1,1,6,27,0.8
10119,Joe Kirby\joe-kirby-1,2017-18,Richmond,G,27,0,167,11,34,.324,6,12,.500,5,22,.227,0,1,.000,5,12,17,9,7,0,4,13,27,0.7
10120,Rene Esparza\rene-esparza-1,2015-16,New Mexico State,G,17,0,113,9,31,.290,4,15,.267,5,16,.313,4,9,.444,1,9,10,9,2,2,10,4,27,0.5
10121,Kyle Copeland\kyle-copeland-1,2017-18,Holy Cross,G,16,1,100,9,23,.391,2,4,.500,7,19,.368,2,4,.500,2,9,11,6,3,0,4,12,27,1.0
10122,Dan Kingma\dan-kingma-1,2014-15,Washington,G,10,0,65,8,18,.444,1,4,.250,7,14,.500,4,7,.571,2,4,6,1,1,0,1,6,27,1.7
10123,Lawrence Brown\lawrence-brown-2,2014-15,Mercer,G,29,0,148,10,22,.455,10,21,.476,0,1,.000,7,11,.636,14,17,31,5,3,6,7,15,27,0.9
10124,Ron Trapps\ron-trapps-1,2013-14,Coastal Carolina,G,10,0,55,8,23,.348,4,7,.571,4,16,.250,7,9,.778,0,3,3,5,3,1,6,6,27,1.3
10125,Patrick Myers\patrick-myers-1,2013-14,South Carolina State,G,17,2,136,7,26,.269,3,15,.200,4,11,.364,8,9,.889,6,11,17,7,2,1,7,16,26,0.7
10126,Michael Benkert\michael-benkert-1,2016-17,Belmont,G,23,0,137,8,27,.296,2,5,.400,6,22,.273,4,6,.667,6,9,15,6,4,1,4,12,26,0.7
10127,Jamie Chapman\jamie-chapman-1,2014-15,Southern Mississippi,G,23,0,274,9,23,.391,7,17,.412,2,6,.333,6,15,.400,16,18,34,21,8,3,13,43,26,0.9
10128,Juwan Henderson\juwan-henderson-1,2014-15,Alcorn State,G,11,5,212,9,46,.196,6,28,.214,3,18,.167,5,6,.833,5,17,22,30,14,1,16,16,26,1.7
10129,Herbert Graham\herbert-graham-1,2013-14,Purdue-Fort Wayne,G,13,0,55,9,20,.450,2,4,.500,7,16,.438,1,3,.333,2,8,10,5,1,1,7,5,26,1.1
10130,Howard Sellars\howard-sellars-1,2013-14,Saint Peter's,G,20,0,145,10,35,.286,9,24,.375,1,11,.091,5,7,.714,2,15,17,5,2,0,5,13,26,0.3
10131,Michael Brown\michael-brown-1,2014-15,Navy,G,21,1,152,10,26,.385,10,23,.435,0,3,.000,6,10,.600,12,8,20,2,5,1,8,25,26,0.5
10132,Jesse Wade\jesse-wade-1,2017-18,Gonzaga,G,19,0,99,9,29,.310,2,4,.500,7,25,.280,1,3,.333,2,5,7,4,6,0,3,4,26,0.8
10133,Josh Conley\josh-conley-1,2016-17,Southern Mississippi,G,16,0,82,10,26,.385,10,24,.417,0,2,.000,6,11,.545,3,11,14,1,5,2,5,12,26,0.8
10134,Michael Briscoe\michael-briscoe-1,2013-14,North Carolina A&T,G,31,1,276,11,37,.297,10,26,.385,1,11,.091,3,11,.273,6,19,25,29,16,1,24,26,26,0.4
10135,Justin Graham\justin-graham-2,2013-14,Hartford,G,31,0,260,5,13,.385,2,7,.286,3,6,.500,13,17,.765,1,29,30,9,5,0,16,33,26,0.3
10136,Landry Shamet\landry-shamet-1,2015-16,Wichita State,G,3,1,53,7,16,.438,4,6,.667,3,10,.300,9,12,.750,3,5,8,5,5,1,2,8,26,8.0
10137,Cameron Craig\cameron-craig-1,2013-14,Southern Illinois-Edwardsville,G,20,0,176,9,29,.310,8,20,.400,1,9,.111,7,9,.778,4,13,17,18,10,1,22,23,26,0.4
10138,Chris Collins\chris-collins-4,2017-18,Texas A&M,G,17,0,120,9,30,.300,4,10,.400,5,20,.250,3,4,.750,3,14,17,2,5,1,3,13,26,0.8
10139,D'Montre Edwards\dmontre-edwards-1,2013-14,Tennessee,G,12,0,72,7,20,.350,3,9,.333,4,11,.364,8,8,1.000,3,14,17,4,4,1,4,8,26,1.8
10140,Nathan Josephs\nathan-josephs-1,2016-17,Texas State,G,12,0,42,8,16,.500,0,3,.000,8,13,.615,2,2,1.000,0,2,2,0,3,1,2,6,26,1.5
10141,De'Vaughn Reid\devaughn-reid-1,2013-14,Holy Cross,G,17,1,123,9,21,.429,6,14,.429,3,7,.429,5,9,.556,1,7,8,6,5,1,6,14,26,0.8
10142,Niko Filipovich\niko-filipovich-1,2015-16,Hawaii,G,22,0,115,6,23,.261,4,6,.667,2,17,.118,12,13,.923,1,10,11,9,6,0,12,17,26,0.4
10143,Chris Rollins\chris-rollins-2,2017-18,Purdue-Fort Wayne,G,11,0,52,12,23,.522,11,16,.688,1,7,.143,1,2,.500,3,2,5,5,2,0,3,3,26,1.7
10144,Jake Bischoff\jake-bischoff-1,2016-17,Miami (OH),G,22,1,162,7,25,.280,4,8,.500,3,17,.176,9,13,.692,0,11,11,16,1,0,8,6,26,0.7
10145,Dantley Walker\dantley-walker-1,2014-15,Nevada-Las Vegas,G,11,0,64,9,24,.375,1,4,.250,8,20,.400,0,0,,0,5,5,1,0,0,0,7,26,1.1
10146,Russell Byrd\russell-byrd-1,2013-14,Michigan State,G,24,0,175,9,27,.333,3,6,.500,6,21,.286,2,6,.333,6,18,24,3,3,5,6,27,26,0.4
10147,Henry Baddley\henry-baddley-1,2016-17,Butler,G,24,0,117,11,25,.440,11,17,.647,0,8,.000,4,9,.444,5,14,19,5,7,2,6,16,26,0.8
10148,Connor Kern\connor-kern-1,2015-16,Arkansas State,G,8,1,87,10,26,.385,4,6,.667,6,20,.300,0,0,,1,5,6,2,3,0,4,13,26,1.2
10149,Marco Anthony\marco-anthony-1,2017-18,Virginia,G,13,0,103,10,28,.357,5,15,.333,5,13,.385,1,3,.333,1,12,13,9,2,2,6,5,26,1.2
10150,Jamal Smith\jamal-smith-2,2016-17,Cal State Fullerton,G,20,1,150,8,21,.381,5,11,.455,3,10,.300,7,18,.389,2,24,26,12,6,0,15,32,26,0.3
10151,Johnny McWilliams\johnny-mcwilliams-1,2016-17,Fresno State,G,22,0,137,7,36,.194,6,21,.286,1,15,.067,11,18,.611,4,6,10,3,5,0,5,19,26,0.0
10152,Joe Kirby\joe-kirby-1,2016-17,Richmond,G,25,1,127,11,26,.423,7,11,.636,4,15,.267,0,0,,15,18,33,5,1,1,8,19,26,0.7
10153,Markus Vallien\markus-vallien-1,2017-18,Saint Francis (PA),G,13,0,53,7,21,.333,4,13,.308,3,8,.375,9,14,.643,0,2,2,3,6,0,5,6,26,1.0
10154,Myles Hamilton\myles-hamilton-1,2015-16,Cleveland State,G,10,0,122,9,26,.346,6,14,.429,3,12,.250,5,6,.833,5,9,14,19,2,2,12,14,26,1.6
10155,Devin Cooper\devin-cooper-1,2016-17,Radford,G,5,3,78,7,19,.368,6,14,.429,1,5,.200,11,13,.846,1,11,12,6,0,0,12,8,26,1.5
10156,Jordan Jackson\jordan-jackson-1,2015-16,Texas Tech,G,23,0,131,12,33,.364,11,23,.478,1,10,.100,1,8,.125,4,13,17,7,2,2,6,9,26,0.4
10157,Grant Vermeer\grant-vermeer-1,2014-15,Navy,G,12,9,128,12,21,.571,12,15,.800,0,6,.000,2,3,.667,6,8,14,10,6,0,12,7,26,1.7
10158,Malik Montoya\malik-montoya-1,2016-17,Seattle,G,8,0,141,9,27,.333,7,13,.538,2,14,.143,6,6,1.000,3,9,12,16,9,0,9,14,26,2.6
10159,Kenneth Ogbe\kenneth-ogbe-1,2015-16,Utah,G,5,2,62,7,17,.412,2,5,.400,5,12,.417,7,8,.875,0,5,5,1,3,0,1,8,26,3.5
10160,Daquon Ervin\daquon-ervin-1,2015-16,Maryland-Baltimore County,G,14,0,218,7,39,.179,6,26,.231,1,13,.077,11,20,.550,3,17,20,17,8,0,7,19,26,0.7
10161,J.T. Thomas\jt-thomas-1,2013-14,Little Rock,G,4,4,99,8,25,.320,8,21,.381,0,4,.000,10,14,.714,1,6,7,5,1,1,3,12,26,2.5
10162,Darius Roy\darius-roy-1,2016-17,Mercer,G,18,0,112,10,33,.303,8,24,.333,2,9,.222,4,8,.500,9,12,21,7,6,0,6,7,26,1.0
10163,Chris Dubose\chris-dubose-2,2017-18,Savannah State,G,15,0,71,8,29,.276,2,4,.500,6,25,.240,4,4,1.000,2,2,4,0,1,1,2,2,26,0.7
10164,Walter Jones\walter-jones-1,2015-16,Texas-Rio Grande Valley,G,20,1,232,8,31,.258,5,18,.278,3,13,.231,7,15,.467,4,30,34,12,8,4,14,34,26,0.4
10165,Abel Porter\abel-porter-1,2017-18,Utah State,G,23,3,171,8,21,.381,6,12,.500,2,9,.222,8,15,.533,1,14,15,15,6,1,9,22,26,0.7
10166,Dederick Lee\dederick-lee-1,2014-15,Oral Roberts,G,20,2,158,7,28,.250,0,2,.000,7,26,.269,5,6,.833,8,8,16,13,3,1,7,15,26,0.8
10167,Jordan Goldwire\jordan-goldwire-1,2017-18,Duke,G,26,0,171,9,28,.321,4,9,.444,5,19,.263,3,4,.750,3,9,12,24,9,0,7,19,26,1.0
10168,Ben Robertson\ben-robertson-1,2016-17,Bucknell,G,27,0,106,10,20,.500,9,18,.500,1,2,.500,5,9,.556,4,5,9,2,3,1,5,14,26,0.5
10169,Malik Carter\malik-carter-1,2015-16,Delaware State,G,9,5,106,9,36,.250,7,24,.292,2,12,.167,6,10,.600,5,10,15,13,4,1,12,12,26,0.7
10170,Desmond Fleming\desmond-fleming-1,2015-16,Cornell,G,16,1,110,12,17,.706,12,16,.750,0,1,.000,2,2,1.000,1,8,9,8,4,1,4,18,26,1.3
10171,Jake Straughan\jake-straughan-1,2016-17,Idaho,G,17,0,82,8,21,.381,0,2,.000,8,19,.421,2,4,.500,0,6,6,2,3,0,2,5,26,0.9
10172,Mike La Tulip\mike-latulip-1,2014-15,Illinois,G,16,0,45,6,13,.462,2,4,.500,4,9,.444,10,10,1.000,0,9,9,0,1,0,1,3,26,1.3
10173,Ryan Bass\ryan-bass-1,2014-15,Dayton,G,8,0,76,9,29,.310,8,22,.364,1,7,.143,6,8,.750,1,8,9,6,1,0,3,9,25,1.2
10174,Jalan West\jalan-west-1,2015-16,Northwestern State,G,1,1,30,8,13,.615,2,3,.667,6,10,.600,3,4,.750,0,3,3,6,0,0,2,3,25,20.6
10175,Ian Langendoerfer\ian-langendoefer-1,2016-17,Loyola (MD),G,25,0,149,8,29,.276,6,16,.375,2,13,.154,7,14,.500,4,7,11,2,1,0,12,11,25,-0.2
10176,Kristinn Palsson\kristinn-palsson-1,2017-18,Marist,G,9,0,125,9,21,.429,2,4,.500,7,17,.412,0,0,,3,20,23,10,2,4,7,7,25,2.7
10177,Xavier Jackson\xavier-jackson-1,2017-18,Virginia Commonwealth,G,20,7,166,8,25,.320,4,12,.333,4,13,.308,5,6,.833,3,15,18,10,3,1,8,10,25,0.8
10178,Mladen Djordjevic\mladen-djordjevic-1,2017-18,San Francisco,G,16,3,138,10,30,.333,8,17,.471,2,13,.154,3,10,.300,3,14,17,17,3,1,12,16,25,0.5
10179,Qiydar Davis\qiydar-davis-1,2016-17,Louisiana Tech,G,5,5,112,8,25,.320,3,10,.300,5,15,.333,4,6,.667,4,10,14,3,4,1,10,11,25,1.6
10180,Grant Leach\grant-leach-1,2016-17,Missouri-Kansas City,G,21,0,127,8,20,.400,2,3,.667,6,17,.353,3,6,.500,0,7,7,3,3,0,1,13,25,0.7
10181,Corey Heyward\corey-heyward-1,2014-15,Georgia Tech,G,19,3,225,8,26,.308,6,15,.400,2,11,.182,7,13,.538,3,11,14,10,10,1,8,29,25,0.6
10182,Josh Perkins\josh-perkins-1,2014-15,Gonzaga,G,5,0,101,9,18,.500,5,8,.625,4,10,.400,3,4,.750,0,5,5,17,4,1,10,7,25,4.2
10183,Noah Allen\noah-allen-1,2015-16,UCLA,G,24,0,154,6,22,.273,4,17,.235,2,5,.400,11,14,.786,3,14,17,10,4,1,5,21,25,0.6
10184,Bosko Kostur\bosco-kostur-1,2013-14,Bryant,G,9,0,83,8,22,.364,6,13,.462,2,9,.222,7,11,.636,5,10,15,1,3,0,10,14,25,0.6
10185,Nathan Laing\nathan-laing-1,2016-17,Central Florida,G,32,5,346,6,38,.158,5,18,.278,1,20,.050,12,18,.667,5,21,26,24,6,0,33,32,25,-0.5
10186,Reggie Kissoonlal\reginald-kissoonlal-1,2014-15,Northwestern State,G,8,0,74,8,34,.235,4,10,.400,4,24,.167,5,7,.714,4,7,11,2,2,9,4,17,25,0.9
10187,Riley Bradshaw\riley-bradshaw-1,2015-16,Montana,G,25,2,156,8,29,.276,4,13,.308,4,16,.250,5,8,.625,0,10,10,10,1,0,7,15,25,0.2
10188,Matt MacDonald\matt-macdonald-1,2017-18,Pennsylvania,G,21,1,106,9,14,.643,8,11,.727,1,3,.333,6,13,.462,8,7,15,5,8,1,3,9,25,1.4
10189,Ahmad Gilbert\ahmad-gilbert-1,2016-17,Minnesota,G,15,0,75,8,27,.296,1,5,.200,7,22,.318,2,4,.500,2,12,14,2,2,2,8,7,25,0.5
10190,Shaun Kirk\shaun-kirk-1,2016-17,North Carolina State,G,14,0,64,9,16,.563,6,6,1.000,3,10,.300,4,5,.800,1,12,13,2,1,1,6,9,25,1.1
10191,Devin Carter\devin-carter-1,2013-14,Kent State,G,13,2,94,8,28,.286,7,18,.389,1,10,.100,8,10,.800,3,9,12,4,3,0,7,10,25,0.6
10192,Zach Farquhar\zach-farquhar-1,2017-18,Liberty,G,18,1,57,8,9,.889,1,1,1.000,7,8,.875,2,3,.667,0,6,6,2,1,0,2,4,25,1.2
10193,Gavin Hoffmann\gavin-hoffmann-1,2013-14,San Francisco,G,22,0,108,7,12,.583,5,8,.625,2,4,.500,9,13,.692,3,9,12,8,4,0,7,15,25,0.9
10194,Malcolm Allen\malcolm-allen-1,2016-17,Stanford,G,13,2,113,9,21,.429,8,15,.533,1,6,.167,6,8,.750,1,9,10,10,6,0,4,8,25,1.7
10195,Joey Naccarato\joey-naccarato-1,2017-18,Massachusetts-Lowell,G,13,0,68,5,15,.333,4,9,.444,1,6,.167,14,19,.737,4,7,11,3,0,0,4,8,25,1.1
10196,Schadrac Casimir\schadrac-casimir-1,2015-16,Iona,G,4,4,97,9,24,.375,4,12,.333,5,12,.417,2,2,1.000,0,7,7,11,4,0,3,3,25,5.4
10197,Jonathan Hood\jonathan-hood-1,2015-16,Eastern Kentucky,G,7,1,60,8,15,.533,2,4,.500,6,11,.545,3,4,.750,0,4,4,0,3,0,1,5,25,2.6
10198,James Long\james-long-1,2016-17,West Virginia,G,13,1,72,8,19,.421,1,4,.250,7,15,.467,2,3,.667,1,2,3,3,8,0,2,7,25,1.6
10199,Sheldon Eberhardt\sheldon-eberhardt-1,2015-16,Elon,G,16,0,98,9,24,.375,4,8,.500,5,16,.313,2,2,1.000,5,8,13,4,4,0,7,10,25,0.8
10200,Evan Maschmeyer\evan-maschmeyer-1,2013-14,Saint Joseph's,G,23,0,122,7,26,.269,4,16,.250,3,10,.300,8,11,.727,4,7,11,8,1,0,13,11,25,0.1
10201,Devontae Morgan\devontae-morgan-1,2013-14,Butler,G,14,0,88,10,23,.435,10,22,.455,0,1,.000,5,11,.455,2,10,12,5,4,1,3,18,25,0.9
10202,Joel Wincowski\joel-wincowski-1,2015-16,Maryland-Baltimore County,G,26,2,271,9,39,.231,4,14,.286,5,25,.200,2,2,1.000,13,17,30,7,7,2,5,18,25,0.6
10203,Dominick Pickett\dominick-pickett-1,2017-18,UC-Riverside,G,20,5,203,10,33,.303,7,19,.368,3,14,.214,2,3,.667,4,15,19,17,6,1,13,17,25,0.6
10204,Edwind McGhee\edwind-mcghee-1,2013-14,DePaul,G,25,5,167,6,25,.240,2,13,.154,4,12,.333,9,12,.750,5,8,13,5,4,4,3,16,25,0.6
10205,Kyler Erickson\kyler-erickson-1,2016-17,Omaha,G,8,0,84,7,16,.438,5,11,.455,2,5,.400,9,12,.750,1,9,10,4,1,0,3,10,25,2.0
10206,Osborn Blount\osborn-blount-1,2015-16,North Florida,G,17,0,64,5,25,.200,3,14,.214,2,11,.182,13,17,.765,2,6,8,5,4,0,7,16,25,0.3
10207,Ashley Williams\ashley-williams-1,2015-16,Western Carolina,G,16,0,117,9,27,.333,8,19,.421,1,8,.125,6,10,.600,7,7,14,6,3,3,3,11,25,1.1
10208,Juan Hood\juan-hood-1,2017-18,Prairie View,G,27,0,83,8,17,.471,8,14,.571,0,3,.000,9,10,.900,2,7,9,8,1,0,3,10,25,0.7
10209,Raekwon Harney\raekwon-harney-1,2013-14,Stetson,G,9,0,110,10,26,.385,6,19,.316,4,7,.571,1,3,.333,1,12,13,11,3,0,13,8,25,1.0
10210,Jake Connor\jake-connor-1,2016-17,Utah,G,14,0,75,9,19,.474,2,2,1.000,7,17,.412,0,1,.000,0,4,4,6,3,0,3,8,25,1.2
10211,Jake Kocher\jake-kocher-1,2015-16,Texas A&M-Corpus Christi,G,12,0,100,9,19,.474,8,14,.571,1,5,.200,6,8,.750,3,17,20,4,7,0,1,13,25,2.1
10212,Clyde Santee\clyde-santee-1,2013-14,Massachusetts,G,15,0,42,9,15,.600,5,6,.833,4,9,.444,3,5,.600,1,6,7,2,1,2,3,5,25,1.2
10213,Alex Paquin\alex-paquin-1,2015-16,American,G,14,5,107,10,22,.455,9,15,.600,1,7,.143,4,6,.667,0,10,10,2,2,0,5,16,25,0.6
10214,Jalen McCallum\jalen-mccallum-1,2014-15,IUPUI,G,11,0,61,9,16,.563,4,6,.667,5,10,.500,2,3,.667,0,1,1,8,7,0,6,15,25,1.6
10215,Jeff Laidig\jeff-laidig-1,2013-14,Belmont,G,36,0,208,6,27,.222,1,5,.200,5,22,.227,8,10,.800,5,19,24,18,4,0,9,33,25,0.3
10216,Courtney Julien\courtney-julien-1,2015-16,Texas State,G,15,0,60,7,19,.368,3,7,.429,4,12,.333,7,8,.875,2,4,6,1,3,1,1,4,25,1.2
10217,Jerome Hairston\jerome-hairston-1,2013-14,Towson,G,5,5,102,10,27,.370,8,15,.533,2,12,.167,3,4,.750,0,4,4,9,4,1,9,12,25,1.6
10218,Eric Bowles\eric-bowles-1,2015-16,Central Connecticut State,G,20,3,258,10,33,.303,7,27,.259,3,6,.500,2,9,.222,1,14,15,27,6,0,23,29,25,-0.1
10219,C.J. Davis\cj-davis-2,2014-15,Tennessee-Martin,G,15,0,37,9,22,.409,3,6,.500,6,16,.375,1,3,.333,1,1,2,1,3,0,0,1,25,1.1
10220,Christien Sager\christien-sager-1,2013-14,Oklahoma State,G,29,0,177,6,15,.400,2,4,.500,4,11,.364,9,17,.529,13,14,27,6,3,2,5,22,25,0.8
10221,Lynrick Moxey\lynrick-moxey-1,2016-17,Western Illinois,G,13,0,84,11,17,.647,11,17,.647,0,0,,3,6,.500,1,7,8,5,3,0,9,7,25,1.1
10222,Asa Duvall\asa-duvall-1,2015-16,Lipscomb,G,25,0,140,9,24,.375,3,8,.375,6,16,.375,1,5,.200,0,14,14,9,4,0,2,7,25,0.8
10223,Will Goff\will-goff-1,2015-16,Boston University,G,7,0,98,9,16,.563,3,4,.750,6,12,.500,1,3,.333,2,9,11,4,0,0,4,4,25,2.6
10224,Chidozie Omile\chidozie-omile-1,2014-15,Alabama State,G,16,3,110,10,33,.303,6,12,.500,4,21,.190,1,2,.500,1,4,5,6,2,0,8,4,25,0.3
10225,Jake Bodway\jake-bodway-1,2015-16,South Florida,G,26,1,236,9,34,.265,9,24,.375,0,10,.000,7,9,.778,11,8,19,11,6,0,12,30,25,0.1
10226,Colin Hale\colin-hale-1,2016-17,Texas A&M-Corpus Christi,G,30,1,163,7,19,.368,4,10,.400,3,9,.333,8,12,.667,2,9,11,11,3,1,10,20,25,0.3
10227,Dominique Hawkins\dominique-hawkins-1,2013-14,Kentucky,G,33,0,283,9,31,.290,7,15,.467,2,16,.125,5,13,.385,7,16,23,12,4,1,6,37,25,0.2
10228,Crandall Head\crandall-head-1,2013-14,Southern Methodist,G,28,1,161,9,35,.257,6,22,.273,3,13,.231,4,7,.571,5,19,24,12,4,1,12,23,25,0.1
10229,Van Rolle\van-rolle-1,2014-15,Coppin State,G,11,0,64,8,22,.364,2,9,.222,6,13,.462,3,9,.333,3,1,4,6,0,0,9,4,25,0.6
10230,Ben Shungu\ben-shungu-1,2017-18,Vermont,G,22,0,137,9,14,.643,8,11,.727,1,3,.333,6,11,.545,3,18,21,12,3,0,9,15,25,0.9
10231,Avery Lomax\avery-lomax-1,2014-15,Prairie View,G,18,0,63,8,18,.444,6,9,.667,2,9,.222,7,12,.583,3,4,7,7,5,0,8,18,25,0.6
10232,Blake Spellman\blake-spellman-1,2016-17,Northern Kentucky,G,11,0,141,8,23,.348,1,2,.500,7,21,.333,2,2,1.000,1,13,14,8,2,0,7,6,25,1.4
10233,Bakari Evelyn\bakari-evelyn-1,2015-16,Nebraska,G,18,0,83,7,23,.304,5,8,.625,2,15,.133,8,8,1.000,2,7,9,4,0,0,8,14,24,0.2
10234,Sherron Dorsey-Walker\sherron-dorsey-walker-1,2013-14,Iowa State,G,20,0,114,8,26,.308,5,11,.455,3,15,.200,5,8,.625,5,7,12,9,4,2,10,9,24,0.6
10235,Eliel Gonzalez\eliel-gonzalez-1,2014-15,Hofstra,G,19,0,78,9,15,.600,9,14,.643,0,1,.000,6,14,.429,1,4,5,5,4,1,13,14,24,0.3
10236,Khari Jabriel Allen\khari-jabrielallen-1,2017-18,Alcorn State,G,5,0,88,8,26,.308,5,17,.294,3,9,.333,5,6,.833,1,4,5,3,0,2,10,9,24,0.1
10237,Henry Bolton\henry-bolton-1,2014-15,Utah State,G,29,0,268,9,25,.360,8,20,.400,1,5,.200,5,9,.556,4,19,23,22,8,3,21,16,24,0.5
10238,Kwe Parker\kwe-parker-1,2016-17,Tennessee,G,25,1,202,10,31,.323,7,18,.389,3,13,.231,1,8,.125,4,17,21,22,6,3,23,30,24,0.0
10239,Morris Marshall\morris-marshall-1,2016-17,Wyoming,G,14,1,87,7,22,.318,4,14,.286,3,8,.375,7,9,.778,4,12,16,4,2,1,3,8,24,1.2
10240,Johnatan Reyes\johnatan-reyes-1,2017-18,Northern Colorado,G,19,0,61,8,17,.471,6,12,.500,2,5,.400,6,8,.750,1,6,7,7,3,0,9,5,24,0.7
10241,Clay Byrd\clay-byrd-1,2013-14,North Carolina-Greensboro,G,11,0,49,8,20,.400,0,0,,8,20,.400,0,0,,0,2,2,1,1,1,1,3,24,1.3
10242,Ibi Watson\ibi-watson-1,2016-17,Michigan,G,19,1,83,10,29,.345,9,11,.818,1,18,.056,3,4,.750,0,8,8,1,2,0,3,5,24,0.4
10243,Turner Botz\turner-botz-1,2013-14,Green Bay,G,15,0,79,8,19,.421,1,4,.250,7,15,.467,1,2,.500,5,14,19,1,2,0,5,8,24,1.0
10244,Scott Spencer\scott-spencer-1,2017-18,Clemson,G,19,0,147,10,40,.250,7,17,.412,3,23,.130,1,2,.500,3,9,12,5,1,1,3,14,24,0.1
10245,Nnamdi Enechionyia\nnamdi-enechionyia-1,2013-14,Samford,G,17,4,118,6,23,.261,3,12,.250,3,11,.273,9,15,.600,7,6,13,4,3,2,6,16,24,0.6
10246,Tye Wilburn\tye-wilburn-1,2016-17,Wright State,G,18,0,142,9,21,.429,8,13,.615,1,8,.125,5,7,.714,3,16,19,14,6,0,12,17,24,0.9
10247,CJ Fisher\cj-fisher-1,2016-17,North Florida,G,19,0,100,7,16,.438,7,16,.438,0,0,,10,23,.435,4,7,11,11,2,0,9,13,24,0.6
10248,Christian Sanders\christian-sanders-1,2014-15,Stanford,G,35,5,272,9,30,.300,5,17,.294,4,13,.308,2,7,.286,5,12,17,24,11,0,15,29,24,0.4
10249,D'Erryl Williams\derryl-williams-1,2015-16,San Diego State,G,20,0,131,8,19,.421,8,16,.500,0,3,.000,8,14,.571,1,12,13,6,6,0,9,17,24,0.5
10250,Jahmel Taylor\jahmel-taylor-1,2013-14,Washington,G,17,0,67,8,21,.381,3,9,.333,5,12,.417,3,4,.750,1,3,4,2,3,0,5,16,24,0.4
10251,Matt Zignorski\matt-zignorski-1,2016-17,Holy Cross,G,27,0,177,8,33,.242,7,20,.350,1,13,.077,7,11,.636,2,9,11,4,4,0,5,15,24,0.1
10252,Mike Ranson\mike-ranson-1,2016-17,Northern Colorado,G,14,0,117,7,25,.280,1,5,.200,6,20,.300,4,5,.800,0,11,11,7,1,0,8,7,24,0.5
10253,Kyle Brown\kyle-brown-2,2017-18,Texas A&M-Corpus Christi,G,22,1,175,8,21,.381,6,19,.316,2,2,1.000,6,13,.462,1,10,11,17,13,0,16,20,24,0.7
10254,James Harrison\james-harrison-1,2015-16,Tennessee-Martin,G,13,0,72,7,23,.304,2,7,.286,5,16,.313,5,8,.625,3,10,13,2,1,0,4,2,24,0.9
10255,Cameron Smith\cameron-smith-1,2017-18,Dartmouth,G,16,1,72,8,18,.444,7,13,.538,1,5,.200,7,11,.636,1,5,6,6,3,0,5,7,24,0.9
10256,David Levitch\david-levitch-1,2014-15,Louisville,G,21,1,101,4,15,.267,0,5,.000,4,10,.400,12,17,.706,4,2,6,6,4,0,5,13,24,0.7
10257,Jon'te Dotson\jonte-dotson-1,2014-15,Northern Colorado,G,17,1,145,8,20,.400,3,8,.375,5,12,.417,3,5,.600,5,4,9,8,6,0,2,10,24,1.3
10258,Malik Hluchoweckyj\malik-hluchoweckyj-1,2016-17,Bowling Green State,G,13,6,123,9,21,.429,5,12,.417,4,9,.444,2,5,.400,4,13,17,6,4,3,7,8,24,1.4
10259,Delveion Jackson\delveion-jackson-1,2017-18,UC-Davis,G,18,0,205,9,33,.273,5,17,.294,4,16,.250,2,7,.286,12,20,32,14,7,1,8,13,24,1.2
10260,Bola Alade\bola-alade-1,2016-17,Texas-San Antonio,G,16,0,92,9,32,.281,7,21,.333,2,11,.182,4,9,.444,6,6,12,4,2,0,5,8,24,0.4
10261,Kareem Wright\kareem-wright-2,2017-18,Grambling,G,21,1,148,9,36,.250,7,19,.368,2,17,.118,4,10,.400,1,11,12,12,7,0,20,22,24,-0.4
10262,Diamante Langston\diamante-langston-1,2016-17,Abilene Christian,G,25,5,199,9,18,.500,9,16,.563,0,2,.000,6,13,.462,0,16,16,16,7,0,19,22,24,0.3
10263,Anthony Swan\anthony-swan-1,2015-16,George Washington,G,38,0,130,10,30,.333,6,20,.300,4,10,.400,0,0,,9,15,24,4,1,6,8,28,24,0.2
10264,Jeffon Powell\jeffon-powell-1,2014-15,Bethune-Cookman,G,22,8,256,7,26,.269,7,21,.333,0,5,.000,10,14,.714,11,26,37,3,2,1,15,38,24,-0.1
10265,Jalen Avery\jalen-avery-1,2015-16,Kent State,G,28,0,239,9,37,.243,6,18,.333,3,19,.158,3,5,.600,2,12,14,27,9,1,12,16,24,0.6
10266,Kaijae Yee-Stephens\kaijae-yee-stephens-1,2017-18,Pepperdine,G,10,0,92,10,25,.400,7,15,.467,3,10,.300,1,3,.333,2,5,7,6,1,0,1,11,24,1.2
10267,Andrew Fleming\andrew-fleming-2,2015-16,Iowa,G,12,0,80,8,22,.364,5,10,.500,3,12,.250,5,10,.500,2,7,9,11,0,1,9,6,24,0.9
10268,Drew Edwards\drew-edwards-1,2016-17,Providence,G,8,0,86,8,19,.421,5,13,.385,3,6,.500,5,10,.500,0,5,5,2,4,1,5,10,24,1.3
10269,Devonte Fuller\devonte-fuller-1,2016-17,Western Carolina,G,14,0,62,7,16,.438,5,11,.455,2,5,.400,8,12,.667,3,8,11,4,2,0,5,5,24,1.2
10270,Rogers Printup\rogers-printup-1,2015-16,UC-Davis,G,22,0,198,8,36,.222,0,2,.000,8,34,.235,0,0,,2,21,23,4,5,3,3,14,24,0.5
10271,Clayton Le Sann\clayton-lesann-1,2016-17,Holy Cross,G,24,0,120,9,27,.333,5,10,.500,4,17,.235,2,4,.500,5,7,12,3,3,0,11,8,24,0.2
10272,Garrett Collins\garrett-collins-1,2016-17,North Carolina-Greensboro,G,15,0,64,8,22,.364,2,3,.667,6,19,.316,2,2,1.000,0,4,4,1,3,1,2,6,24,0.9
10273,Mattia Da Campo\mattia-dacampo-1,2016-17,Seattle,G,16,0,139,9,14,.643,8,11,.727,1,3,.333,5,10,.500,6,11,17,14,3,0,17,19,24,0.7
10274,Michael Benkert\michael-benkert-1,2017-18,Belmont,G,31,0,196,9,41,.220,6,9,.667,3,32,.094,3,4,.750,2,5,7,5,2,0,9,17,24,-0.3
10275,Lexus Williams\lexus-williams-1,2015-16,Valparaiso,G,15,0,92,9,28,.321,6,11,.545,3,17,.176,3,5,.600,3,8,11,6,6,0,4,12,24,0.9
10276,Dwayne Banks\dwayne-banks-1,2017-18,South Carolina State,G,27,1,140,7,21,.333,3,13,.231,4,8,.500,6,6,1.000,6,8,14,18,5,0,24,23,24,0.1
10277,Matt Deady\matt-deady-1,2017-18,Indiana State,G,20,1,151,8,18,.444,8,17,.471,0,1,.000,8,13,.615,8,12,20,5,10,0,8,22,24,0.9
10278,Julian Richardson\julian-richardson-1,2014-15,Niagara,G,11,0,88,7,22,.318,4,9,.444,3,13,.231,7,8,.875,1,4,5,6,2,0,5,5,24,1.1
10279,Dondre Griffin\dondre-griffin-1,2016-17,Murray State,G,15,0,55,10,28,.357,7,13,.538,3,15,.200,1,1,1.000,2,3,5,6,2,0,2,9,24,0.8
10280,Jake Spurgeon\jake-spurgeon-1,2017-18,Seattle,G,21,1,106,7,28,.250,5,7,.714,2,21,.095,8,10,.800,3,12,15,5,0,1,7,14,24,0.2
10281,Nathan Dodge\nathan-dodge-1,2015-16,Army,G,8,0,57,8,18,.444,1,3,.333,7,15,.467,1,1,1.000,0,4,4,1,3,0,3,5,24,1.8
10282,Vonte Carter\vonte-carter-1,2017-18,Portland State,G,9,0,28,10,18,.556,7,12,.583,3,6,.500,1,2,.500,0,5,5,0,4,1,2,3,24,2.0
10283,Jake Fay\jake-fay-1,2013-14,Fordham,G,15,0,87,7,26,.269,0,5,.000,7,21,.333,3,4,.750,5,6,11,2,2,2,5,19,24,0.4
10284,John Robert Simon\john-robert-simon-1,2016-17,Wichita State,G,21,0,92,7,13,.538,2,3,.667,5,10,.500,5,8,.625,2,7,9,10,7,0,4,7,24,1.3
10285,Branden Jenkins\branden-jenkins-1,2016-17,Louisiana State,G,19,2,152,8,40,.200,4,27,.148,4,13,.308,4,11,.364,3,8,11,11,5,1,7,18,24,0.0
10286,John Ross Glover\john-ross-glover-1,2014-15,Lehigh,G,7,0,34,8,16,.500,8,15,.533,0,1,.000,8,12,.667,3,5,8,2,0,1,2,7,24,2.2
10287,Tom Maayan\tom-maayan-1,2013-14,Seton Hall,G,10,1,155,8,22,.364,6,15,.400,2,7,.286,6,12,.500,3,9,12,27,5,0,23,12,24,1.0
10288,Jalen Adams\jalen-adams-1,2014-15,St. Bonaventure,G,14,0,62,8,23,.348,5,12,.417,3,11,.273,5,7,.714,0,1,1,3,3,0,2,6,24,0.8
10289,Brandon Price\brandon-price-1,2014-15,Western Kentucky,G,22,0,109,6,20,.300,3,11,.273,3,9,.333,9,16,.563,3,3,6,16,3,0,9,9,24,0.6
10290,Naasir Williams\naasir-williams-1,2013-14,Vermont,G,18,0,104,8,27,.296,6,16,.375,2,11,.182,6,9,.667,0,7,7,15,2,0,7,13,24,0.5
10291,Je'Quan Perry\jequan-perry-1,2017-18,Florida Atlantic,G,12,0,113,8,26,.308,2,9,.222,6,17,.353,2,3,.667,1,21,22,4,5,0,5,15,24,1.0
10292,Chris Williams\chris-williams-14,2017-18,Central Connecticut State,G,14,0,75,9,27,.333,7,15,.467,2,12,.167,3,3,1.000,3,6,9,1,1,0,4,3,23,0.6
10293,Victor Bermudez\victor-bermudez-1,2013-14,Texas State,G,24,2,196,8,51,.157,4,11,.364,4,40,.100,3,7,.429,2,14,16,15,2,0,9,18,23,-0.4
10294,Ben Grace\ben-grace-1,2016-17,Maryland-Baltimore County,G,12,2,48,7,17,.412,0,0,,7,17,.412,2,4,.500,0,4,4,6,1,0,6,4,23,1.0
10295,Garvey Melmed\garvey-melmed-1,2016-17,Maine,G,14,0,80,8,19,.421,2,4,.500,6,15,.400,1,1,1.000,3,5,8,5,3,0,4,3,23,1.3
10296,Nathan Hawkins\nathan-hawkins-2,2013-14,Nebraska,G,16,0,117,7,30,.233,1,11,.091,6,19,.316,3,6,.500,2,13,15,5,2,0,5,21,23,0.1
10297,Jake Silpe\jake-silpe-1,2016-17,Pennsylvania,G,15,0,106,9,24,.375,6,10,.600,3,14,.214,2,4,.500,2,5,7,12,7,0,8,14,23,0.9
10298,Damon Wilson\damon-wilson-1,2016-17,Pittsburgh,G,29,1,183,8,31,.258,8,19,.421,0,12,.000,7,12,.583,1,13,14,9,1,1,11,21,23,-0.1
10299,Anthanee Doyle\anthanee-doyle-1,2013-14,Chattanooga,G,11,0,72,8,21,.381,4,12,.333,4,9,.444,3,5,.600,2,6,8,6,2,0,4,8,23,1.2
10300,Dee Oldham\dee-oldham-1,2014-15,Tennessee-Martin,G,7,0,117,6,17,.353,3,7,.429,3,10,.300,8,14,.571,3,20,23,11,5,1,5,4,23,3.7
10301,Aaron Jordan\aaron-jordan-1,2016-17,Illinois,G,24,2,165,8,28,.286,2,8,.250,6,20,.300,1,6,.167,6,21,27,5,8,1,4,19,23,0.7
10302,Mike Powell\mike-powell-1,2013-14,Rhode Island,G,9,7,135,6,22,.273,1,8,.125,5,14,.357,6,8,.750,1,13,14,6,2,0,15,14,23,-0.1
10303,Mark Howell\mark-howell-1,2013-14,Wright State,G,20,0,162,8,24,.333,5,14,.357,3,10,.300,4,6,.667,1,15,16,13,13,2,10,17,23,1.0
10304,Chase Harler\chase-harler-1,2016-17,West Virginia,G,16,0,95,8,28,.286,4,15,.267,4,13,.308,3,7,.429,1,5,6,8,6,0,4,11,23,0.7
10305,Anthony Durham\anthony-durham-2,2014-15,Rider,G,23,0,125,10,31,.323,10,24,.417,0,7,.000,3,5,.600,2,5,7,5,5,0,5,7,23,0.4
10306,Marquill Smith\marquill-smith-1,2015-16,San Francisco,G,10,0,70,8,27,.296,5,10,.500,3,17,.176,4,6,.667,3,9,12,2,3,0,2,3,23,1.3
10307,Will DiIorio\will-dilorio-1,2013-14,Washington State,G,29,4,239,8,26,.308,6,15,.400,2,11,.182,5,21,.238,17,24,41,4,6,0,13,28,23,0.2
10308,Dwayne Rose Jr.\dwayne-rosejr-1,2017-18,Toledo,G,13,0,48,5,10,.500,3,6,.500,2,4,.500,11,11,1.000,3,8,11,4,1,2,4,8,23,1.6
10309,Dwight Smith\dwight-smith-1,2014-15,Northern Colorado,G,8,4,161,8,22,.364,6,13,.462,2,9,.222,5,10,.500,1,14,15,12,6,4,11,23,23,1.3
10310,Josh Robinson\josh-robinson-34,2016-17,Southern,G,8,0,79,8,30,.267,1,3,.333,7,27,.259,0,0,,0,7,7,5,3,0,5,10,23,0.6
10311,Tiremone Williams\tiremone-williams-1,2014-15,Louisiana,G,27,1,200,7,22,.318,5,13,.385,2,9,.222,7,13,.538,1,17,18,17,10,0,16,23,23,0.4
10312,Kendall Jackson\kendall-jackson-1,2013-14,Columbia,G,22,0,171,9,36,.250,4,12,.333,5,24,.208,0,0,,2,11,13,9,9,0,9,21,23,0.2
10313,Kenny Williams\kenny-williams-3,2015-16,North Carolina,G,29,0,122,8,22,.364,7,9,.778,1,13,.077,6,6,1.000,4,7,11,6,3,0,1,11,23,0.6
10314,Pat Benzan\pat-benzan-1,2015-16,Holy Cross,G,27,0,155,6,24,.250,6,21,.286,0,3,.000,11,18,.611,6,17,23,12,5,0,7,16,23,0.6
10315,Olivier Cadieux\olivier-cadieux-1,2016-17,Fairfield,G,18,0,136,8,26,.308,5,15,.333,3,11,.273,4,6,.667,2,16,18,4,2,0,11,18,23,0.0
10316,Alex Dubovitskiy\alex-dubovitskiy-1,2016-17,Chicago State,G,22,1,185,8,28,.286,2,7,.286,6,21,.286,1,4,.250,10,6,16,3,5,0,9,27,23,0.1
10317,Eron Gordon\eron-gordon-1,2016-17,Seton Hall,G,18,0,74,10,26,.385,9,15,.600,1,11,.091,2,2,1.000,5,10,15,6,3,0,5,13,23,0.7
10318,Marc-Antoine Bourgault\marc-antoine-bourgault-1,2013-14,St. John's (NY),G,14,0,49,7,12,.583,0,0,,7,12,.583,2,2,1.000,0,4,4,1,1,0,1,5,23,1.2
10319,Jordan Martin\jordan-martin-1,2014-15,Eastern Michigan,G,13,0,74,7,14,.500,6,11,.545,1,3,.333,8,16,.500,8,16,24,1,4,0,4,9,23,1.6
10320,Dustin Clarke\dustin-clarke-1,2015-16,Appalachian State,G,18,1,98,8,27,.296,5,11,.455,3,16,.188,4,4,1.000,5,14,19,6,3,1,6,5,23,0.8
10321,Matt Poplawski\matt-poplawski-1,2014-15,Pennsylvania,G,17,3,99,7,24,.292,3,6,.500,4,18,.222,5,9,.556,0,4,4,5,2,0,6,8,23,0.3
10322,Jordan Ashton\jordan-ashton-1,2015-16,Iowa State,G,24,0,190,9,26,.346,4,8,.500,5,18,.278,0,0,,2,15,17,6,4,0,5,11,23,0.5
10323,Jordan Robertson\jordan-robertson-2,2014-15,Colgate,G,14,0,123,8,25,.320,3,10,.300,5,15,.333,2,3,.667,4,8,12,3,2,3,7,8,23,0.7
10324,Nate Allen\nate-allen-1,2015-16,North Carolina Central,G,16,0,81,9,35,.257,4,11,.364,5,24,.208,0,4,.000,3,4,7,2,2,0,5,11,23,-0.1
10325,Declan Soukup\declan-soukup-1,2013-14,Bryant,G,13,0,98,6,21,.286,4,11,.364,2,10,.200,9,11,.818,1,7,8,11,6,0,8,10,23,1.1
10326,Chad Donley\chad-donley-1,2013-14,Liberty,G,16,0,51,6,19,.316,2,6,.333,4,13,.308,7,9,.778,1,4,5,2,2,0,3,6,23,0.7
10327,Antone Christian\antone-christian-1,2013-14,Northern Illinois,G,10,1,70,7,26,.269,3,10,.300,4,16,.250,5,6,.833,8,2,10,2,0,3,4,4,23,1.1
10328,Anthony Fields\anthony-fields-2,2014-15,Bradley,G,18,1,119,8,24,.333,7,17,.412,1,7,.143,6,10,.600,0,7,7,4,6,0,6,7,23,0.6
10329,Ethan Wilmoth\ethan-wilmoth-1,2014-15,North Carolina-Asheville,G,10,0,95,8,19,.421,4,5,.800,4,14,.286,3,6,.500,1,10,11,9,2,1,3,7,23,1.9
10330,Tyler Loose\tyler-loose-1,2015-16,Northern Colorado,G,28,6,335,6,28,.214,5,24,.208,1,4,.250,10,17,.588,5,37,42,27,17,0,12,37,23,1.0
10331,Andre Chatfield\andre-chatfield-1,2015-16,Harvard,G,21,1,175,9,19,.474,6,10,.600,3,9,.333,2,3,.667,4,18,22,7,6,2,10,21,23,0.7
10332,Terrell Hales\terrell-hales-1,2017-18,Cleveland State,G,25,0,213,9,22,.409,9,19,.474,0,3,.000,5,9,.556,16,18,34,9,14,4,7,32,23,1.2
10333,Caleb Smith\caleb-smith-1,2016-17,Texas A&M,G,14,0,101,9,22,.409,7,14,.500,2,8,.250,3,6,.500,1,11,12,7,3,0,3,7,23,1.2
10334,Edward Stephens\edward-stephens-1,2017-18,Austin Peay,G,9,0,88,8,24,.333,3,8,.375,5,16,.313,2,2,1.000,1,5,6,3,1,0,4,6,23,0.9
10335,Isaac Belton\isaac-belton-1,2014-15,Longwood,G,16,0,48,9,24,.375,6,11,.545,3,13,.231,2,4,.500,3,7,10,2,3,0,3,5,23,0.8
10336,Nazeer Bostick\nazeer-bostick-1,2016-17,Penn State,G,18,0,120,9,29,.310,9,21,.429,0,8,.000,5,5,1.000,2,12,14,6,7,4,9,13,23,0.6
10337,Aher Uguak\aher-uguak-1,2016-17,New Mexico,G,19,2,140,7,20,.350,6,12,.500,1,8,.125,8,15,.533,9,5,14,7,5,1,13,14,23,0.5
10338,Cameron Oluyitan\cameron-oluyitan-1,2016-17,Boise State,G,17,0,129,8,28,.286,4,11,.364,4,17,.235,3,7,.429,13,18,31,4,0,0,7,13,23,0.6
10339,Matthew Cotton\matthew-cotton-1,2014-15,Alabama A&M,G,23,0,161,7,29,.241,3,14,.214,4,15,.267,5,13,.385,4,6,10,11,6,0,14,10,23,0.1
10340,Laquarious Paige\laguarious-paige-1,2015-16,Indiana State,G,30,0,205,9,26,.346,8,16,.500,1,10,.100,4,6,.667,1,13,14,10,8,2,17,29,23,0.0
10341,Trey Phills\trey-phills-1,2015-16,Yale,G,19,0,117,8,31,.258,7,19,.368,1,12,.083,6,8,.750,5,11,16,6,3,5,12,18,23,0.1
10342,Gio McLean\gio-mclean-1,2016-17,Texas Tech,G,9,0,108,7,23,.304,2,4,.500,5,19,.263,4,4,1.000,1,7,8,5,2,0,3,13,23,1.1
10343,Keith Pinckney\keith-pinckney-1,2017-18,Old Dominion,G,20,1,108,9,29,.310,7,21,.333,2,8,.250,3,7,.429,2,5,7,9,4,0,7,10,23,0.3
10344,Payton Hulsey\payton-hulsey-2,2016-17,College of Charleston,G,5,4,133,7,21,.333,6,18,.333,1,3,.333,8,17,.471,8,13,21,6,7,2,2,7,23,5.0
10345,Bishop Mency\bishop-mency-1,2016-17,Rice,G,20,0,76,8,17,.471,3,5,.600,5,12,.417,2,7,.286,3,6,9,3,3,1,2,7,23,0.9
10346,Whitley Carter\whitley-beau-carter-1,2013-14,Savannah State,G,16,1,75,8,19,.421,4,11,.364,4,8,.500,3,4,.750,1,5,6,5,1,0,4,7,23,0.8
10347,Terrence Johnson\terrence-johnson-1,2016-17,James Madison,G,16,0,159,6,24,.250,2,9,.222,4,15,.267,7,12,.583,3,14,17,6,10,3,8,23,23,0.8
10348,Patrick Triplett\patrick-triplett-1,2016-17,Brown,G,25,0,155,6,33,.182,6,17,.353,0,16,.000,10,16,.625,2,13,15,4,8,5,5,25,22,0.1
10349,Ross Cummings\ross-cummings-1,2016-17,Mercer,G,14,0,103,9,28,.321,5,9,.556,4,19,.211,0,0,,5,3,8,7,1,0,5,5,22,0.7
10350,Maurice Smith\maurice-smith-1,2016-17,Western Carolina,G,28,0,201,11,43,.256,11,40,.275,0,3,.000,0,6,.000,16,30,46,13,7,1,17,23,22,0.2
10351,Devyn Wilson\devyn-wilson-1,2017-18,Portland State,G,14,0,88,8,32,.250,5,10,.500,3,22,.136,3,3,1.000,7,7,14,4,5,0,9,16,22,0.2
10352,Devon Carter\devon-carter-1,2016-17,Lehigh,G,19,0,97,7,19,.368,5,9,.556,2,10,.200,6,8,.750,0,4,4,1,5,0,3,8,22,0.6
10353,T.J. Schlundt\tj-schlundt-1,2017-18,Wisconsin,G,24,0,193,8,36,.222,2,9,.222,6,27,.222,0,0,,6,9,15,6,4,2,4,10,22,0.4
10354,J.R. Harris\jr-harris-1,2016-17,Texas-San Antonio,G,7,3,57,8,31,.258,5,14,.357,3,17,.176,3,5,.600,4,5,9,2,2,0,5,3,22,0.6
10355,Seventh Woods\seventh-woods-1,2017-18,North Carolina,G,20,0,140,9,30,.300,9,26,.346,0,4,.000,4,5,.800,1,13,14,20,6,1,12,21,22,0.5
10356,Simeon Henton\simeon-henton-1,2017-18,Chicago State,G,11,0,72,7,15,.467,7,14,.500,0,1,.000,8,13,.615,0,1,1,8,6,0,3,10,22,1.6
10357,Austin Luke\austin-luke-1,2014-15,Belmont,G,30,0,125,4,15,.267,1,7,.143,3,8,.375,11,15,.733,5,17,22,21,2,1,20,8,22,0.5
10358,Donovan Walker\donovan-walker-1,2017-18,Louisiana-Monroe,G,16,0,103,8,29,.276,4,20,.200,4,9,.444,2,3,.667,2,3,5,6,5,0,10,12,22,0.1
10359,Kedren Johnson\kedren-johnson-1,2015-16,Memphis,G,10,2,91,9,21,.429,8,13,.615,1,8,.125,3,4,.750,2,11,13,1,1,0,9,13,22,0.3
10360,Roderick Lawrence\roderick-lawrence-1,2014-15,Mississippi,G,13,0,105,8,26,.308,3,12,.250,5,14,.357,1,3,.333,4,13,17,10,4,1,6,9,22,1.2
10361,Antonin Galaya\antonin-galaya-1,2013-14,North Carolina Central,G,17,0,86,8,36,.222,3,9,.333,5,27,.185,1,1,1.000,5,11,16,2,1,1,2,8,22,0.3
10362,Langston Burnett\langston-burnett-1,2013-14,Wagner,G,20,0,116,7,26,.269,4,11,.364,3,15,.200,5,12,.417,5,13,18,5,3,1,7,12,22,0.3
10363,Noah Knight\noah-knight-1,2015-16,Missouri-Kansas City,G,3,3,61,8,16,.500,6,7,.857,2,9,.222,4,6,.667,3,7,10,2,2,3,2,11,22,5.5
10364,Cory Calvert\cory-calvert-1,2017-18,Utah Valley,G,17,0,143,8,30,.267,6,13,.462,2,17,.118,4,5,.800,3,18,21,20,2,0,12,12,22,0.6
10365,Gerald Williams\gerald-williams-1,2013-14,Tennessee State,G,6,2,86,7,24,.292,7,13,.538,0,11,.000,8,10,.800,0,4,4,2,3,0,1,2,22,1.8
10366,Ian Langendoerfer\ian-langendoefer-1,2017-18,Loyola (MD),G,14,3,131,6,26,.231,3,13,.231,3,13,.231,7,9,.778,8,13,21,7,1,1,11,16,22,0.3
10367,Cory Jacobsen\cory-jacobsen-1,2013-14,South Dakota State,G,16,0,134,8,23,.348,3,5,.600,5,18,.278,1,6,.167,1,12,13,6,2,0,7,7,22,0.5
10368,Michael Carter III\michael-carteriii-1,2017-18,Washington,G,17,0,129,7,28,.250,4,15,.267,3,13,.231,5,8,.625,3,7,10,7,4,3,6,8,22,0.6
10369,Ahmad Abdullah\ahmad-abdullah-1,2013-14,North Carolina A&T,G,18,0,142,7,28,.250,5,15,.333,2,13,.154,6,9,.667,5,10,15,6,6,0,10,5,22,0.5
10370,Christian Adams\christian-adams-1,2015-16,Coastal Carolina,G,14,0,74,8,22,.364,8,21,.381,0,1,.000,6,10,.600,3,4,7,4,2,0,10,6,22,0.3
10371,Marcellous Bell\marcellous-bell-1,2015-16,Jacksonville,G,14,1,86,8,27,.296,3,8,.375,5,19,.263,1,4,.250,5,9,14,5,1,0,4,6,22,0.7
10372,Robert Mansell\robert-mansell-1,2013-14,Binghamton,G,8,4,125,7,32,.219,5,24,.208,2,8,.250,6,12,.500,3,8,11,2,2,0,5,7,22,0.0
10373,Hayes Garrity\hayes-garrity-1,2015-16,Utah Valley,G,3,0,50,7,19,.368,2,9,.222,5,10,.500,3,4,.750,0,3,3,4,1,1,1,2,22,4.9
10374,Daniel Hill\daniel-hill-1,2013-14,Eastern Washington,G,17,1,111,5,17,.294,2,8,.250,3,9,.333,9,15,.600,0,5,5,11,5,0,15,22,22,0.0
10375,Marcus Love\marcus-love-1,2014-15,Jackson State,G,14,0,99,9,27,.333,8,16,.500,1,11,.091,3,5,.600,5,4,9,7,3,0,4,13,22,0.7
10376,Grant Gelon\grant-gelon-1,2016-17,Indiana,G,12,0,39,7,9,.778,4,4,1.000,3,5,.600,5,8,.625,2,3,5,0,1,0,1,6,22,1.4
10377,Richard Feagin\richard-feagin-1,2017-18,Morehead State,G,19,0,133,9,23,.391,5,14,.357,4,9,.444,0,0,,3,19,22,12,3,0,11,8,22,0.8
10378,Zachary Jackson\zachary-jackson-1,2014-15,Alabama A&M,G,5,0,47,8,19,.421,5,9,.556,3,10,.300,3,4,.750,2,4,6,3,0,2,4,6,22,2.2
10379,Varun Ram\varum-ram-1,2015-16,Maryland,G,26,0,119,4,20,.200,1,6,.167,3,14,.214,11,15,.733,2,7,9,7,6,0,7,22,22,0.3
10380,Brendon Gooch\brendon-gooch-1,2017-18,Southern Illinois,G,25,0,138,6,21,.286,1,4,.250,5,17,.294,5,11,.455,9,25,34,5,3,5,4,7,22,1.0
10381,Josh Pierre\josh-pierre-1,2015-16,Arkansas State,G,24,0,286,5,36,.139,0,5,.000,5,31,.161,7,10,.700,5,24,29,4,5,1,4,17,22,0.3
10382,Jackson Aldridge\jackson-aldridge-1,2014-15,Butler,G,19,1,95,8,20,.400,6,10,.600,2,10,.200,4,9,.444,0,2,2,2,2,0,2,8,22,0.4
10383,Noah Springwater\noah-springwater-1,2013-14,Columbia,G,26,0,129,6,23,.261,2,5,.400,4,18,.222,6,6,1.000,2,11,13,4,4,1,3,14,22,0.5
10384,Nick Singleton\nick-singleton-1,2017-18,Mississippi State,G,9,0,25,9,14,.643,5,7,.714,4,7,.571,0,1,.000,2,3,5,1,0,0,2,0,22,1.8
10385,Jeff Laidig\jeff-laidig-1,2014-15,Belmont,G,33,0,229,5,17,.294,0,5,.000,5,12,.417,7,9,.778,12,30,42,6,7,1,8,23,22,0.7
10386,Dawson Verhines\dawson-verhines-1,2014-15,Southern Illinois,G,31,1,223,6,18,.333,2,10,.200,4,8,.500,6,9,.667,6,14,20,7,8,1,13,13,22,0.5
10387,Brion Whitley\brion-whitley-1,2017-18,Murray State,G,15,0,47,7,14,.500,4,4,1.000,3,10,.300,5,9,.556,2,4,6,3,1,0,3,4,22,1.0
10388,Joel Boyce\joel-boyce-1,2017-18,Coppin State,G,6,2,75,10,18,.556,10,16,.625,0,2,.000,2,5,.400,2,10,12,3,4,0,11,8,22,1.4
10389,Zack Dawson\zack-dawson-1,2017-18,Oklahoma State,G,5,0,50,7,17,.412,5,10,.500,2,7,.286,6,9,.667,0,4,4,8,0,0,8,6,22,1.6
10390,Hunter Summy\hunter-summy-1,2015-16,San Diego,G,14,0,72,8,32,.250,3,6,.500,5,26,.192,1,3,.333,2,0,2,5,2,0,3,9,22,0.2
10391,Kevin Harden\kevin-harden-1,2013-14,Purdue-Fort Wayne,G,9,0,95,8,28,.286,2,13,.154,6,15,.400,0,0,,3,7,10,11,3,0,3,9,22,1.5
10392,Trey Lenox\trey-lenox-1,2016-17,Abilene Christian,G,26,0,201,8,28,.286,4,14,.286,4,14,.286,2,3,.667,3,15,18,10,5,1,16,31,22,-0.2
10393,Colton Bishop\colton-bishop-1,2014-15,Loyola (MD),G,28,0,196,7,25,.280,5,16,.313,2,9,.222,6,11,.545,4,12,16,5,4,1,9,19,22,0.1
10394,Thomas Montigel\thomas-montigel-1,2013-14,Texas Christian,G,26,1,194,5,20,.250,5,14,.357,0,6,.000,12,14,.857,13,13,26,2,7,0,4,22,22,0.7
10395,Austin Karrer\austin-karrer-1,2014-15,Texas-San Antonio,G,21,0,147,8,20,.400,5,8,.625,3,12,.250,3,7,.429,5,10,15,5,5,1,5,18,22,0.6
10396,Nick Davidson\nick-davidson-1,2013-14,Valparaiso,G,14,0,67,7,15,.467,5,10,.500,2,5,.400,6,6,1.000,2,6,8,10,3,0,3,1,22,1.7
10397,Ryan Hiepler\ryan-hiepler-1,2015-16,Liberty,G,23,6,261,6,14,.429,2,3,.667,4,11,.364,6,7,.857,3,11,14,13,2,0,8,25,22,0.6
10398,Desure Buie\desure-buie-1,2016-17,Hofstra,G,8,0,122,6,28,.214,3,19,.158,3,9,.333,7,10,.700,2,9,11,17,3,0,5,12,22,1.6
10399,John Rinaldi\john-rinaldi-1,2015-16,Binghamton,G,26,0,177,8,12,.667,8,11,.727,0,1,.000,6,9,.667,9,33,42,12,9,0,12,19,22,1.1
10400,Clayton Le Sann\clayton-lesann-1,2017-18,Holy Cross,G,13,0,91,8,22,.364,3,11,.273,5,11,.455,0,2,.000,6,5,11,6,3,0,2,3,21,1.4
10401,Telly Davenport\telly-davenport-1,2015-16,Utah Valley,G,4,0,76,8,17,.471,7,11,.636,1,6,.167,4,7,.571,0,16,16,10,2,2,11,9,21,2.9
10402,Austin Mills\austin-mills-1,2014-15,Baylor,G,17,0,99,5,14,.357,3,6,.500,2,8,.250,9,10,.900,0,4,4,14,3,0,7,11,21,0.9
10403,Adam Weir\adam-weir-1,2015-16,Canisius,G,19,0,114,7,25,.280,2,4,.500,5,21,.238,2,6,.333,5,3,8,5,6,0,2,13,21,0.6
10404,Josh Rosario\josh-rosario-1,2017-18,Maryland-Baltimore County,G,16,0,73,5,27,.185,2,12,.167,3,15,.200,8,11,.727,1,6,7,9,4,0,10,7,21,0.2
10405,Taishaun Johnson\taishaun-johnson-1,2017-18,Kent State,G,8,0,76,7,23,.304,7,18,.389,0,5,.000,7,12,.583,3,11,14,5,2,1,6,8,21,1.0
10406,Donovan Williams\donovan-williams-1,2013-14,Louisiana,G,12,1,45,7,16,.438,4,7,.571,3,9,.333,4,4,1.000,3,3,6,2,2,1,1,4,21,1.4
10407,Alex Bran\alex-bran-1,2014-15,Chattanooga,G,13,0,76,7,23,.304,4,6,.667,3,17,.176,4,7,.571,1,8,9,1,0,2,3,7,21,0.5
10408,Mike Schroback\mike-schroback-1,2017-18,Fairleigh Dickinson,G,23,1,80,6,19,.316,2,5,.400,4,14,.286,5,6,.833,0,4,4,7,2,0,9,3,21,0.3
10409,Atif Russell\atif-russell-1,2015-16,Pepperdine,G,6,0,55,7,19,.368,6,16,.375,1,3,.333,6,8,.750,2,10,12,4,1,0,1,9,21,2.2
10410,Diogo Brito\diogo-brito-1,2016-17,Utah State,G,18,0,123,9,29,.310,7,15,.467,2,14,.143,1,6,.167,4,14,18,6,8,0,3,9,21,0.8
10411,Kevin Boyle\kevin-boyle-1,2013-14,Florida Gulf Coast,G,20,0,106,4,19,.211,0,4,.000,4,15,.267,9,10,.900,5,6,11,8,5,0,7,20,21,0.5
10412,Scott Mammel\scott-mammel-1,2014-15,Army,G,16,0,93,7,24,.292,4,13,.308,3,11,.273,4,4,1.000,1,6,7,9,3,0,8,17,21,0.3
10413,Justin Jordan\justin-jordan-2,2017-18,North Carolina-Greensboro,G,20,1,167,9,18,.500,9,18,.500,0,0,,3,4,.750,2,19,21,23,7,0,11,15,21,1.2
10414,Xzavier Malone\xzavier-malone-1,2016-17,Rider,G,23,1,111,7,26,.269,5,15,.333,2,11,.182,5,8,.625,5,9,14,3,0,2,4,12,21,0.2
10415,D.J. Ursery\dj-ursery-1,2014-15,Pacific,G,12,0,75,9,23,.391,7,16,.438,2,7,.286,1,2,.500,2,10,12,3,2,0,7,14,21,0.3
10416,Jamal Thomas\jamal-thomas-1,2017-18,Charleston Southern,G,10,1,74,7,21,.333,1,3,.333,6,18,.333,1,2,.500,1,8,9,8,1,2,5,11,21,1.0
10417,Deyshawn Martin\deyshawn-martin-1,2017-18,Austin Peay,G,6,0,62,7,15,.467,5,7,.714,2,8,.250,5,7,.714,2,10,12,3,4,4,6,9,21,2.7
10418,John Sanders\john-sanders-1,2015-16,Mississippi Valley State,G,16,1,132,8,19,.421,5,12,.417,3,7,.429,2,2,1.000,3,7,10,6,3,0,8,17,21,0.5
10419,Melo Eggleston\melo-eggleston-1,2017-18,Wake Forest,G,21,0,105,7,20,.350,7,17,.412,0,3,.000,7,13,.538,6,18,24,4,3,2,4,12,21,0.7
10420,Rendijs Feikners\rendijs-feikners-1,2016-17,Florida Gulf Coast,G,8,0,42,6,9,.667,4,5,.800,2,4,.500,7,8,.875,1,4,5,5,1,0,2,4,21,2.4
10421,Frankie Ferrari\frankie-ferrari-1,2014-15,San Francisco,G,16,0,143,8,28,.286,7,14,.500,1,14,.071,4,5,.800,0,19,19,11,2,0,11,21,21,0.0
10422,Tanner Sanders\tanner-sanders-1,2014-15,Oregon State,G,21,1,123,8,22,.364,3,7,.429,5,15,.333,0,0,,3,15,18,7,5,0,8,16,21,0.5
10423,Matt Rosenwinkel\matt-rosenwinkel-1,2013-14,Northern Kentucky,G,15,1,90,7,9,.778,3,3,1.000,4,6,.667,3,5,.600,6,6,12,2,2,0,1,19,21,1.2
10424,Kelvin Henry Jr.\kelvin-henryjr-1,2017-18,McNeese State,G,14,0,95,5,16,.313,5,13,.385,0,3,.000,11,15,.733,2,6,8,9,5,1,8,11,21,0.9
10425,James Gollon\james-gollon-1,2015-16,Ohio,G,20,0,109,6,18,.333,2,7,.286,4,11,.364,5,8,.625,2,12,14,5,2,0,15,11,21,0.0
10426,Tharone Chilton\tharone-chilton-1,2013-14,Middle Tennessee,G,11,0,40,7,12,.583,6,7,.857,1,5,.200,6,7,.857,1,2,3,2,1,0,3,6,21,1.2
10427,Terrence Durham\terrence-durham-2,2014-15,Tennessee-Martin,G,29,0,213,6,25,.240,5,16,.313,1,9,.111,8,13,.615,3,22,25,21,8,1,15,25,21,0.4
10428,Patrick Holloway\patrick-holloway-1,2015-16,George Mason,G,4,0,55,7,23,.304,2,7,.286,5,16,.313,2,3,.667,0,5,5,0,1,1,2,2,21,1.9
10429,Aaron Law\aaron-law-1,2015-16,Coastal Carolina,G,17,1,74,8,22,.364,7,13,.538,1,9,.111,4,4,1.000,1,5,6,4,3,0,3,5,21,0.7
10430,Chasen Wiilliamson\chasen-wiilliamson-1,2013-14,Central Arkansas,G,18,0,106,6,24,.250,5,15,.333,1,9,.111,8,13,.615,7,4,11,6,5,0,4,9,21,0.7
10431,Tate de Laveaga\tate-de-laveaga-1,2014-15,Northern Arizona,G,26,0,138,6,27,.222,5,13,.385,1,14,.071,8,10,.800,5,9,14,4,2,0,9,23,21,-0.1
10432,Nathan Watkins\nathan-watkins-1,2013-14,Vanderbilt,G,9,0,54,5,18,.278,2,3,.667,3,15,.200,8,11,.727,2,6,8,0,0,0,4,3,21,0.8
10433,Trevor John\trevor-john-1,2015-16,Cal Poly,G,18,0,81,7,29,.241,1,2,.500,6,27,.222,1,1,1.000,1,2,3,1,0,0,2,4,21,0.1
10434,Donnie Lewis\donnie-lewis-1,2017-18,Southeast Missouri State,G,31,2,315,5,12,.417,1,3,.333,4,9,.444,7,15,.467,7,17,24,41,9,0,14,37,21,1.0
10435,Randall Smith\randall-smith-1,2014-15,Jacksonville State,G,15,0,86,5,17,.294,3,10,.300,2,7,.286,9,10,.900,1,6,7,6,2,1,11,14,21,0.2
10436,Emmanuel Matey\emmanuel-matey-1,2013-14,Morgan State,G,26,0,197,6,28,.214,4,17,.235,2,11,.182,7,13,.538,5,16,21,18,5,0,24,21,21,-0.2
10437,Curtis Jones\curtis-jones-1,2017-18,Indiana,G,7,0,80,7,26,.269,3,8,.375,4,18,.222,3,4,.750,1,8,9,3,3,2,2,2,21,1.7
10438,Umoja Gibson\umoja-gibson-1,2017-18,North Texas,G,2,2,40,8,21,.381,4,11,.364,4,10,.400,1,2,.500,3,5,8,4,3,1,2,4,21,7.8
10439,Jordan Montgomery\jordan-montgomery-1,2013-14,Kennesaw State,G,20,0,79,6,16,.375,2,6,.333,4,10,.400,5,11,.455,3,10,13,7,5,1,6,11,21,0.8
10440,Ted Bancroft\ted-bancroft-1,2014-15,Providence,G,21,0,90,6,16,.375,1,2,.500,5,14,.357,4,7,.571,4,11,15,3,3,2,3,10,21,0.8
10441,Avery Wilson\avery-wilson-1,2017-18,Boston College,G,14,0,46,8,14,.571,6,11,.545,2,3,.667,3,8,.375,1,2,3,1,3,1,9,3,21,0.6
10442,Francisco Santiago\francisco-santiago-1,2017-18,Youngstown State,G,8,1,100,7,21,.333,2,6,.333,5,15,.333,2,3,.667,2,8,10,9,5,0,6,7,21,1.9
10443,Randell Pickett\randell-pickett-1,2016-17,Maryland-Eastern Shore,G,11,0,62,7,23,.304,3,7,.429,4,16,.250,3,5,.600,3,6,9,0,3,0,0,2,21,1.2
10444,Shyheim Hicks\shyheim-hicks-1,2017-18,Long Island University,G,7,1,55,6,16,.375,2,4,.500,4,12,.333,5,5,1.000,2,4,6,1,0,0,4,11,21,1.0
10445,Mike Robbins\mike-robbins-1,2016-17,Temple,G,15,2,105,7,14,.500,4,5,.800,3,9,.333,4,7,.571,2,8,10,9,3,1,2,19,21,1.1
10446,Mike Schroback\mike-schroback-1,2016-17,Fairleigh Dickinson,G,25,0,131,5,25,.200,1,12,.083,4,13,.308,7,10,.700,2,10,12,9,3,0,11,16,21,0.0
10447,Mandrell Worthy\mandrell-worthy-1,2016-17,Montana State,G,16,0,150,7,27,.259,6,18,.333,1,9,.111,6,11,.545,13,9,22,9,7,4,10,16,21,0.9
10448,Cameron Pappas\cameron-pappas-1,2015-16,Charlotte,G,12,0,64,5,14,.357,3,7,.429,2,7,.286,9,10,.900,0,7,7,3,2,0,3,6,21,1.1
10449,Tre' Ivory\tre-ivory-1,2015-16,Austin Peay,G,30,0,203,6,19,.316,6,15,.400,0,4,.000,9,18,.500,1,14,15,22,8,0,14,25,21,0.4
10450,Gentry Hunt\gentry-hunt-1,2016-17,Chicago State,G,19,1,72,7,19,.368,2,4,.500,5,15,.333,2,2,1.000,3,5,8,2,1,0,5,5,21,0.5
10451,Von Washington\von-washington-1,2013-14,Western Michigan,G,18,0,59,7,21,.333,4,6,.667,3,15,.200,4,8,.500,1,5,6,0,2,0,4,6,21,0.3
10452,Dwain Whitfield\dwain-whitfield-1,2014-15,Mississippi Valley State,G,27,10,254,8,27,.296,8,26,.308,0,1,.000,5,11,.455,19,16,35,10,3,0,10,39,21,0.2
10453,John Moran\john-moran-1,2015-16,Richmond,G,12,0,49,7,18,.389,0,0,,7,18,.389,0,0,,0,4,4,2,2,0,3,5,21,0.9
10454,Jason McMillan\jason-mcmillan-1,2016-17,Western Carolina,G,18,1,97,7,21,.333,1,2,.500,6,19,.316,0,1,.000,1,6,7,3,3,0,4,5,20,0.5
10455,Lance Richard\lance-richard-1,2014-15,Louisiana-Monroe,G,19,0,59,7,26,.269,1,2,.500,6,24,.250,0,0,,1,5,6,1,2,1,2,5,20,0.3
10456,Brandon Davis\brandon-davis-7,2017-18,UC-Santa Barbara,G,28,1,189,7,19,.368,5,13,.385,2,6,.333,4,9,.444,1,16,17,22,7,0,15,22,20,0.4
10457,Jason Morris\jason-morris-1,2013-14,Georgia Tech,G,9,4,103,8,29,.276,5,15,.333,3,14,.214,1,5,.200,4,20,24,3,1,0,7,14,20,0.1
10458,Luke Davis\luke-davis-2,2013-14,Texas-Arlington,G,14,0,86,7,17,.412,1,5,.200,6,12,.500,0,0,,4,4,8,4,1,0,1,10,20,1.0
10459,Junior Searcy\junior-searcy-1,2015-16,Northern Arizona,G,6,0,55,7,12,.583,6,10,.600,1,2,.500,5,6,.833,4,6,10,1,0,1,2,5,20,2.7
10460,Derek Rongstad\derek-rongstad-1,2015-16,Milwaukee,G,11,0,56,7,13,.538,4,8,.500,3,5,.600,3,4,.750,8,4,12,3,4,0,4,5,20,1.8
10461,Demetrius Dyson\demetrius-dyson-1,2013-14,Massachusetts,G,21,0,82,6,21,.286,1,5,.200,5,16,.313,3,5,.600,1,7,8,2,3,0,3,14,20,0.3
10462,Stan Mays\stan-mays-1,2014-15,Texas Tech,G,9,0,35,5,11,.455,1,1,1.000,4,10,.400,6,8,.750,1,2,3,1,0,0,6,2,20,1.0
10463,Jeremiah Jefferson\jeremiah-jefferson-1,2015-16,Weber State,G,7,0,56,8,14,.571,4,5,.800,4,9,.444,0,0,,0,4,4,8,1,1,2,2,20,2.7
10464,Jonathan Jean\jonathan-jean-2,2017-18,Furman,G,16,0,87,7,14,.500,7,9,.778,0,5,.000,6,8,.750,2,8,10,20,2,0,4,11,20,1.5
10465,David Maynard\david-maynard-1,2017-18,Colgate,G,7,0,44,7,9,.778,3,5,.600,4,4,1.000,2,2,1.000,2,4,6,0,2,0,2,3,20,2.6
10466,Jerron Martin\jerron-martin-1,2017-18,Illinois State,G,10,0,110,7,28,.250,4,11,.364,3,17,.176,3,4,.750,1,6,7,11,6,0,7,6,20,1.0
10467,Deshawn Jones\deshawn-jones-1,2016-17,Jacksonville State,G,17,0,110,7,20,.350,7,16,.438,0,4,.000,6,10,.600,1,7,8,8,2,1,14,3,20,0.2
10468,Marcus Graham\marcus-graham-1,2013-14,North Carolina-Wilmington,G,13,1,36,7,21,.333,6,16,.375,1,5,.200,5,6,.833,6,2,8,0,3,0,1,4,20,1.0
10469,Connor Garner\connor-garner-2,2016-17,Utah State,G,6,1,44,7,13,.538,1,1,1.000,6,12,.500,0,0,,2,8,10,4,2,0,4,4,20,2.8
10470,Stephaun Adams\stephaun-adams-1,2017-18,Tennessee Tech,G,9,0,121,5,22,.227,4,14,.286,1,8,.125,9,14,.643,4,17,21,18,8,0,9,18,20,1.9
10471,Marius McAllister\marius-mcallister-1,2017-18,North Carolina Central,G,16,6,140,9,20,.450,9,20,.450,0,0,,2,4,.500,8,22,30,15,5,2,8,10,20,1.6
10472,J.T. Escobar\jt-escobar-1,2015-16,Mississippi,G,17,0,82,7,22,.318,4,8,.500,3,14,.214,3,5,.600,0,2,2,7,1,0,8,8,20,0.1
10473,Treaven Duffy\treaven-duffy-1,2013-14,Saint Mary's (CA),G,8,0,30,4,6,.667,3,5,.600,1,1,1.000,11,16,.688,1,6,7,2,2,0,4,1,20,2.1
10474,Deris Duncan\deris-duncan-1,2016-17,Texas State,G,20,0,111,7,26,.269,5,15,.333,2,11,.182,4,6,.667,5,10,15,4,5,2,2,5,20,0.8
10475,Maurice Dunlap\maurice-dunlap-1,2014-15,Mississippi State,G,7,0,72,6,22,.273,3,8,.375,3,14,.214,5,6,.833,1,3,4,1,2,0,3,11,20,0.5
10476,Luqman Lundy\luqman-lundy-1,2017-18,Bradley,G,25,0,138,6,27,.222,4,15,.267,2,12,.167,6,10,.600,3,12,15,11,11,2,10,14,20,0.5
10477,Kyle Brown\kyle-brown-1,2017-18,Cornell,G,21,1,76,7,22,.318,3,6,.500,4,16,.250,2,5,.400,3,6,9,1,3,3,4,12,20,0.3
10478,Hayden Hoerdemann\hayden-hoerdemann-1,2013-14,Western Michigan,G,11,0,44,5,14,.357,4,7,.571,1,7,.143,9,12,.750,3,0,3,5,3,0,1,3,20,1.6
10479,Maxwell Lenox\maxwell-lenox-1,2014-15,Army,G,7,0,81,9,22,.409,8,17,.471,1,5,.200,1,4,.250,5,10,15,15,5,0,10,12,20,2.0
10480,Matty Smith\matty-smith-1,2016-17,Central Michigan,G,32,0,130,9,21,.429,9,15,.600,0,6,.000,2,5,.400,3,10,13,14,5,1,8,20,20,0.4
10481,Viko Noma'aea\viko-nomaaea-1,2013-14,Utah State,G,14,0,75,7,19,.368,2,5,.400,5,14,.357,1,1,1.000,2,2,4,3,1,0,1,12,20,0.6
10482,Devearl Ramsey\devearl-ramsey-1,2016-17,Nevada,G,26,2,214,5,28,.179,3,15,.200,2,13,.154,8,11,.727,4,24,28,26,2,0,4,25,20,0.7
10483,Jamere Dismukes\jamere-dismukes-1,2013-14,Chicago State,G,4,4,65,4,13,.308,2,5,.400,2,8,.250,10,12,.833,0,8,8,10,4,0,5,3,20,4.7
10484,Justin Brown\justin-brown-4,2016-17,North Carolina-Asheville,G,11,0,34,7,14,.500,5,6,.833,2,8,.250,4,5,.800,1,3,4,1,3,1,4,5,20,1.1
10485,Jacob Hazzard\jacob-hazzard-1,2013-14,Arizona,G,13,0,29,8,17,.471,4,8,.500,4,9,.444,0,0,,0,3,3,3,2,0,4,2,20,0.9
10486,Stevie Repichowski\stevie-repichowski-1,2014-15,Tulsa,G,22,0,98,5,27,.185,0,3,.000,5,24,.208,5,6,.833,0,8,8,0,1,0,5,7,20,-0.1
10487,Pedro Maciel\pedro-maciel-2,2013-14,Nicholls State,G,24,1,236,7,21,.333,4,5,.800,3,16,.188,3,4,.750,2,14,16,27,7,0,14,47,20,0.3
10488,Patrick Rooks\patrick-rooks-1,2014-15,Clemson,G,13,0,52,6,22,.273,0,3,.000,6,19,.316,2,5,.400,0,3,3,6,3,0,0,6,20,0.9
10489,Conrad Chambers\conrad-chambers-1,2014-15,Morgan State,G,14,0,65,6,22,.273,3,13,.231,3,9,.333,5,8,.625,3,4,7,9,0,0,10,10,20,0.1
10490,Jordan Scurry\jordan-scurry-1,2017-18,Creighton,G,17,0,57,8,22,.364,4,6,.667,4,16,.250,0,0,,3,10,13,3,1,0,4,4,20,0.6
10491,Brendyn Taylor\brendyn-taylor-1,2013-14,Southern California,G,18,1,89,8,24,.333,4,9,.444,4,15,.267,0,1,.000,4,9,13,3,6,1,2,7,20,0.9
10492,Christian Burton\christian-burton-1,2013-14,Virginia Military Institute,G,10,0,56,6,15,.400,4,6,.667,2,9,.222,6,8,.750,2,1,3,3,3,1,5,6,20,1.1
10493,Kobe Paras\kobe-paras-1,2016-17,Creighton,G,15,0,70,8,23,.348,6,13,.462,2,10,.200,2,7,.286,4,10,14,3,2,1,4,11,20,0.5
10494,Garvey Melmed\garvey-melmed-1,2014-15,Maine,G,29,11,330,7,35,.200,2,5,.400,5,30,.167,1,6,.167,7,21,28,10,4,0,9,23,20,0.0
10495,DeAngelo Stewart\deangelo-stewart-1,2013-14,Alabama State,G,9,0,72,7,25,.280,3,9,.333,4,16,.250,2,3,.667,4,6,10,5,4,1,1,6,20,1.6
10496,Stephen Wilson\stephen-wilson-1,2013-14,Savannah State,G,18,0,100,6,24,.250,3,12,.250,3,12,.250,5,9,.556,1,4,5,7,2,0,12,16,20,-0.3
10497,Charles Taylor\charles-taylor-1,2017-18,Jackson State,G,10,0,128,7,24,.292,7,24,.292,0,0,,5,6,.833,8,20,28,5,9,3,12,21,19,1.0
10498,Shakaris Laney\sharkaris-laney-1,2015-16,Central Connecticut State,G,12,0,69,6,22,.273,4,11,.364,2,11,.182,5,9,.556,3,7,10,1,3,0,7,7,19,0.2
10499,Donovan Williams\donovan-williams-1,2014-15,Louisiana,G,6,1,42,7,18,.389,3,7,.429,4,11,.364,1,4,.250,3,2,5,2,5,1,2,4,19,2.4
10500,DJ Bryant\dj-bryant-1,2016-17,Texas-Arlington,G,36,3,293,6,22,.273,5,11,.455,1,11,.091,6,7,.857,2,16,18,36,11,0,32,35,19,0.1
10501,Morris Marshall\morris-marshall-1,2015-16,Wyoming,G,9,0,39,8,14,.571,6,9,.667,2,5,.400,1,1,1.000,2,5,7,0,0,0,3,4,19,1.2
10502,Dezmond McDaniel\dezmond-mcdaniel-1,2016-17,Oral Roberts,G,17,0,109,7,23,.304,3,15,.200,4,8,.500,1,2,.500,0,12,12,10,3,0,3,5,19,0.8
10503,Matthew Grant\matthew-grant-1,2016-17,Detroit Mercy,G,4,3,99,6,22,.273,2,11,.182,4,11,.364,3,3,1.000,1,11,12,4,1,0,4,5,19,2.0
10504,D'Erryl Williams\derryl-williams-1,2014-15,San Diego State,G,17,0,129,8,14,.571,6,11,.545,2,3,.667,1,2,.500,3,9,12,7,10,0,8,12,19,1.1
10505,Jibri Bryan\jibri-bryan-1,2015-16,Mercer,G,6,1,65,6,13,.462,5,7,.714,1,6,.167,6,9,.667,4,12,16,4,2,0,4,4,19,2.8
10506,Torin Childs-Harris\torin-childs-harris-1,2013-14,Morgan State,G,12,0,75,7,20,.350,4,6,.667,3,14,.214,2,5,.400,0,5,5,1,5,1,8,9,19,0.2
10507,Justin McFadden\justin-mcfadden-1,2016-17,Binghamton,G,6,0,54,6,8,.750,4,6,.667,2,2,1.000,5,7,.714,4,7,11,7,0,1,5,4,19,3.2
10508,Kellen Blake\kellen-blake-1,2017-18,Winthrop,G,16,1,31,8,16,.500,5,7,.714,3,9,.333,0,2,.000,2,2,4,1,1,0,2,1,19,0.7
10509,Travis Ingram\travis-ingram-1,2017-18,Towson,G,13,0,105,8,20,.400,6,14,.429,2,6,.333,1,2,.500,11,11,22,9,2,0,4,7,19,1.6
10510,Nathan Townsen Jr.\nathan-townsenjr-1,2017-18,Chicago State,G,12,0,76,5,15,.333,4,12,.333,1,3,.333,8,10,.800,1,3,4,10,4,0,12,9,19,0.6
10511,Deon Baker\deon-baker-1,2017-18,Saint Francis (PA),G,12,1,51,9,19,.474,9,19,.474,0,0,,1,1,1.000,5,6,11,2,2,0,5,4,19,1.0
10512,Nick Weiler-Babb\nick-weiler-babb-1,2014-15,Arkansas,G,26,0,125,7,22,.318,4,13,.308,3,9,.333,2,2,1.000,6,14,20,14,5,3,5,7,19,0.9
10513,Jared Dimakos\jared-dimakos-1,2015-16,Chicago State,G,4,2,55,8,15,.533,7,11,.636,1,4,.250,2,5,.400,3,9,12,7,2,1,1,10,19,4.5
10514,Cortell Busby\cortell-busby-1,2013-14,IUPUI,G,16,0,94,5,18,.278,5,15,.333,0,3,.000,9,11,.818,1,7,8,8,2,0,9,7,19,0.4
10515,Dalique Mingo\dalique-mingo-1,2014-15,Howard,G,13,0,54,7,20,.350,2,7,.286,5,13,.385,0,0,,3,3,6,2,1,0,5,7,19,0.4
10516,Jaron Martin\jaron-martin-1,2013-14,UC-Irvine,G,15,0,83,6,23,.261,2,12,.167,4,11,.364,3,5,.600,2,5,7,10,4,0,6,3,19,0.7
10517,Christian Harrison\christian-harrison-1,2014-15,Troy,G,22,0,116,6,14,.429,5,11,.455,1,3,.333,6,10,.600,10,13,23,2,6,3,4,14,19,0.9
10518,Brandon Johnson\brandon-johnson-5,2015-16,Boston University,G,13,0,32,7,14,.500,3,4,.750,4,10,.400,1,1,1.000,2,3,5,2,0,0,3,4,19,0.9
10519,Courtney Austin\courtney-austin-1,2015-16,Texas-Arlington,G,15,1,74,6,17,.353,4,9,.444,2,8,.250,5,8,.625,4,6,10,8,5,0,7,14,19,0.7
10520,Howard Washington\howard-washington-1,2017-18,Syracuse,G,18,0,110,5,17,.294,3,5,.600,2,12,.167,7,10,.700,0,15,15,10,6,1,7,5,19,1.0
10521,Larry Haley\larry-haley-1,2014-15,Delaware State,G,5,0,32,6,17,.353,3,5,.600,3,12,.250,4,4,1.000,1,3,4,1,0,0,1,4,19,1.8
10522,Shawn Willett\shawn-willett-1,2015-16,Alcorn State,G,18,0,104,6,31,.194,5,19,.263,1,12,.083,6,12,.500,10,4,14,7,4,0,10,18,19,-0.2
10523,Jaxon Holden\jaxon-holden-1,2014-15,Stephen F. Austin,G,17,0,67,4,14,.286,0,5,.000,4,9,.444,7,7,1.000,0,3,3,1,1,0,4,12,19,0.3
10524,A.J. Astroth\aj-astroth-1,2017-18,Hampton,G,6,1,69,7,17,.412,7,15,.467,0,2,.000,5,6,.833,5,16,21,3,2,3,3,10,19,2.8
10525,Jared Ravenscraft\jared-ravenscraft-1,2015-16,Morehead State,G,7,1,35,7,10,.700,4,5,.800,3,5,.600,2,3,.667,3,2,5,7,5,0,1,0,19,3.7
10526,Shaq Preston\shaq-preston-1,2014-15,Chattanooga,G,8,0,64,6,26,.231,5,22,.227,1,4,.250,6,12,.500,4,7,11,5,4,1,11,10,19,-0.1
10527,Charles Glover\charles-glover-1,2016-17,Mount St. Mary's,G,27,1,125,7,19,.368,7,15,.467,0,4,.000,5,8,.625,2,13,15,6,4,0,7,19,19,0.2
10528,Kennedy McKinney\kennedy-mckinney-1,2017-18,Arkansas-Pine Bluff,G,17,2,96,9,25,.360,9,19,.474,0,6,.000,1,2,.500,2,8,10,8,10,1,9,9,19,0.7
10529,Josh Steel\josh-steel-1,2016-17,Duquesne,G,2,0,45,6,12,.500,1,1,1.000,5,11,.455,2,2,1.000,0,4,4,1,1,0,3,8,19,4.9
10530,K.J. Bluford\kj-bluford-1,2013-14,Iowa State,G,7,0,38,7,22,.318,2,4,.500,5,18,.278,0,0,,1,0,1,3,1,0,1,7,19,0.9
10531,J.T. Flowers\jt-flowers-1,2013-14,Yale,G,10,0,63,7,18,.389,4,11,.364,3,7,.429,2,8,.250,3,7,10,1,1,1,1,2,19,1.2
10532,Andre Adams\andre-adams-1,2016-17,Arizona State,G,14,0,80,9,12,.750,9,12,.750,0,0,,1,6,.167,9,9,18,2,1,5,3,17,19,1.2
10533,Deriece Parks\deriece-parks-1,2015-16,Western Carolina,G,9,4,99,6,31,.194,4,10,.400,2,21,.095,5,8,.625,6,7,13,8,5,1,3,4,19,1.3
10534,Ryker Pierce\ryker-pierce-1,2017-18,UC-Riverside,G,13,0,92,4,24,.167,1,6,.167,3,18,.167,8,10,.800,3,3,6,2,4,0,2,13,19,0.3
10535,Quinton Ray\quinton-ray-1,2016-17,Campbell,G,23,2,228,6,18,.333,5,13,.385,1,5,.200,6,12,.500,5,17,22,22,9,0,22,21,19,0.4
10536,Rasool Hinson\rasool-hinson-1,2016-17,Coppin State,G,13,0,88,7,23,.304,6,19,.316,1,4,.250,4,8,.500,7,6,13,4,6,0,9,11,19,0.5
10537,Brady Schuck\brady-schuck-1,2017-18,Furman,G,13,0,40,6,10,.600,5,6,.833,1,4,.250,6,8,.750,0,6,6,1,1,0,2,1,19,1.1
10538,Sam Bittner\sam-bittner-1,2015-16,Fresno State,G,17,4,165,6,16,.375,1,2,.500,5,14,.357,2,5,.400,2,15,17,5,3,1,1,19,19,0.8
10539,Gerald Smith\gerald-smith-1,2016-17,Samford,G,23,0,110,8,18,.444,6,13,.462,2,5,.400,1,3,.333,2,9,11,2,1,1,2,16,19,0.3
10540,Jamar Redmond\jamar-redmond-1,2015-16,Morgan State,G,15,5,107,5,25,.200,1,7,.143,4,18,.222,5,8,.625,1,8,9,3,2,0,9,28,19,-0.7
10541,Maxwell Lenox\maxwell-lenox-1,2013-14,Army,G,11,0,66,6,12,.500,4,6,.667,2,6,.333,5,7,.714,3,3,6,12,2,0,7,11,19,1.3
10542,Malik Burnett\malik-burnett-1,2017-18,Troy,G,16,1,91,8,21,.381,6,13,.462,2,8,.250,1,7,.143,0,12,12,12,3,1,10,9,19,0.5
10543,Nick Parker\nick-parker-1,2017-18,Campbell,G,8,1,47,6,17,.353,2,5,.400,4,12,.333,2,2,1.000,1,11,12,6,0,1,3,3,18,1.7
10544,Darnell Rogers\darnell-rogers-1,2017-18,Florida Gulf Coast,G,20,0,127,6,24,.250,2,8,.250,4,16,.250,2,4,.500,2,3,5,8,5,0,12,9,18,0.0
10545,Aitor Zubizarreta\aitor-zubizarreta-1,2014-15,Portland,G,25,1,148,7,20,.350,6,10,.600,1,10,.100,3,5,.600,4,10,14,17,10,0,14,26,18,0.4
10546,Chris Sullivan\chris-sullivan-1,2015-16,Brown,G,22,0,72,7,19,.368,3,6,.500,4,13,.308,0,0,,3,4,7,3,3,0,3,13,18,0.4
10547,Jordan Reed\jordan-reed-1,2014-15,Binghamton,G,5,1,53,6,21,.286,6,19,.316,0,2,.000,6,7,.857,6,11,17,2,5,3,8,6,18,2.2
10548,Ryan Strollo\ryan-strollo-1,2017-18,Youngstown State,G,13,0,63,6,21,.286,0,2,.000,6,19,.316,0,1,.000,2,6,8,2,2,0,3,2,18,0.6
10549,Austin Ruder\austin-ruder-1,2015-16,Missouri State,G,5,0,78,6,22,.273,1,6,.167,5,16,.313,1,1,1.000,0,7,7,1,1,0,2,7,18,0.8
10550,Marshall Graves\marshall-graves-1,2017-18,Louisiana State,G,14,0,72,7,19,.368,3,5,.600,4,14,.286,0,0,,1,4,5,9,0,0,3,5,18,0.8
10551,Ty Solomon\ty-solomon-2,2017-18,South Carolina State,G,8,8,165,5,16,.313,4,12,.333,1,4,.250,7,10,.700,3,11,14,24,10,0,11,16,18,2.8
10552,Alex Ramon\alex-ramon-1,2013-14,Colgate,G,16,0,119,7,19,.368,5,7,.714,2,12,.167,2,3,.667,1,8,9,6,3,0,9,9,18,0.3
10553,Jonathan Wiley\jonathan-wiley-1,2014-15,Texas State,G,9,0,45,6,10,.600,6,10,.600,0,0,,6,10,.600,7,6,13,0,0,1,0,5,18,1.9
10554,Novian Cherry\novian-cherry-1,2015-16,Savannah State,G,12,0,95,7,20,.350,7,19,.368,0,1,.000,4,8,.500,6,5,11,1,2,1,10,9,18,0.1
10555,Trevis Jackson\trevis-jackson-1,2015-16,Sacramento State,G,31,0,169,4,12,.333,4,6,.667,0,6,.000,10,14,.714,4,8,12,16,2,0,9,15,18,0.4
10556,Jeff Lowery\jeff-lowery-1,2013-14,Grand Canyon,G,4,2,66,8,17,.471,7,16,.438,1,1,1.000,1,2,.500,1,4,5,10,3,0,10,13,18,1.4
10557,Ahmad Fields\ahmad-fields-1,2015-16,Drexel,G,3,1,47,6,21,.286,4,16,.250,2,5,.400,4,6,.667,3,13,16,1,0,0,4,12,18,0.9
10558,Charles O'Bannon Jr.\charles-obannonjr-1,2017-18,Southern California,G,14,0,72,5,23,.217,4,15,.267,1,8,.125,7,7,1.000,1,8,9,2,4,0,2,10,18,0.5
10559,J'Breun Sprinkle\jbreun-sprinkle-1,2015-16,Arkansas-Pine Bluff,G,18,0,191,8,14,.571,7,12,.583,1,2,.500,1,4,.250,5,6,11,9,10,0,16,11,18,0.6
10560,Jose Morales\jose-morales-1,2016-17,Princeton,G,16,0,64,8,19,.421,8,15,.533,0,4,.000,2,3,.667,0,7,7,8,2,0,8,7,18,0.4
10561,Aaron Washington\aaron-washington-2,2013-14,Missouri-Kansas City,G,7,2,146,8,24,.333,8,22,.364,0,2,.000,2,4,.500,3,9,12,13,7,0,4,17,18,2.0
10562,Caleb Woods\caleb-woods-1,2014-15,Southeast Missouri State,G,5,0,21,6,14,.429,2,5,.400,4,9,.444,2,4,.500,2,1,3,3,1,0,0,1,18,2.8
10563,Damion Rashford\damion-rashford-1,2013-14,Loyola (MD),G,22,0,115,7,33,.212,5,23,.217,2,10,.200,2,8,.250,5,11,16,2,2,2,8,14,18,-0.3
10564,Avery Johnson\avery-johnson-3,2014-15,Texas A&M,G,13,0,56,7,20,.350,6,14,.429,1,6,.167,3,5,.600,0,3,3,1,0,0,2,8,18,0.2
10565,Matt Hayes\matt-hayes-1,2015-16,Loyola Marymount,G,14,0,86,5,20,.250,0,1,.000,5,19,.263,3,4,.750,0,2,2,5,2,0,3,8,18,0.4
10566,Erten Gazi\erten-gazi-1,2016-17,DePaul,G,13,0,55,6,9,.667,4,5,.800,2,4,.500,4,4,1.000,3,8,11,2,1,0,3,1,18,1.4
10567,Matty Smith\matty-smith-1,2017-18,Central Michigan,G,26,0,196,8,27,.296,7,21,.333,1,6,.167,1,5,.200,3,13,16,32,5,1,19,26,18,0.2
10568,Greg Alexander\greg-alexander-1,2013-14,East Carolina,G,8,0,38,6,11,.545,3,4,.750,3,7,.429,3,5,.600,2,3,5,2,0,1,0,3,18,1.9
10569,Andrew Houts\andrew-houts-1,2013-14,Chattanooga,G,10,0,35,6,13,.462,5,8,.625,1,5,.200,5,6,.833,4,5,9,5,2,0,5,5,18,1.4
10570,Jake Showalter\jake-showalter-1,2014-15,North Dakota State,G,13,0,38,6,12,.500,2,2,1.000,4,10,.400,2,2,1.000,1,5,6,0,0,0,2,2,18,0.9
10571,Jared Ravenscraft\jared-ravenscraft-1,2014-15,Morehead State,G,7,0,27,6,9,.667,1,1,1.000,5,8,.625,1,2,.500,1,2,3,2,0,0,1,5,18,1.9
10572,Grayson Murphy\grayson-murphy-1,2017-18,Belmont,G,4,0,50,9,20,.450,9,14,.643,0,6,.000,0,1,.000,0,6,6,7,2,0,4,5,18,2.5
10573,Herbert Graham\herbert-graham-1,2014-15,Purdue-Fort Wayne,G,6,0,63,7,17,.412,4,6,.667,3,11,.273,1,2,.500,1,14,15,0,4,2,2,10,18,2.1
10574,Linwood Ross\linwood-ross-1,2013-14,IUPUI,G,13,0,39,6,19,.316,5,14,.357,1,5,.200,5,8,.625,0,6,6,0,0,1,1,1,18,0.5
10575,Trent Perry\trent-perry-1,2015-16,Eastern Michigan,G,19,0,126,6,35,.171,2,7,.286,4,28,.143,2,4,.500,1,5,6,4,3,0,2,10,18,-0.2
10576,Acoydan McCarthy\acoydan-mccarthy-1,2017-18,Austin Peay,G,23,0,107,7,21,.333,6,17,.353,1,4,.250,3,9,.333,1,11,12,5,2,1,6,8,18,0.2
10577,New Williams\new-williams-1,2015-16,Auburn,G,21,0,134,6,26,.231,2,8,.250,4,18,.222,2,8,.250,4,13,17,5,3,1,6,17,18,0.0
10578,C.J. Foster\cj-foster-1,2017-18,Arkansas State,G,8,2,111,5,16,.313,2,5,.400,3,11,.273,5,10,.500,1,11,12,6,0,1,11,14,18,-0.1
10579,Ot Elmore\ot-elmore-1,2017-18,Marshall,G,11,1,87,6,22,.273,0,1,.000,6,21,.286,0,0,,2,4,6,9,0,0,2,10,18,0.7
10580,Rondale Watson\rondale-watson-1,2014-15,Wake Forest,G,12,0,77,5,20,.250,1,8,.125,4,12,.333,4,7,.571,1,8,9,4,3,0,3,9,18,0.6
10581,Josiah Moore\josiah-moore-1,2015-16,Tennessee Tech,G,4,1,63,6,19,.316,4,11,.364,2,8,.250,4,7,.571,2,10,12,1,1,0,4,4,18,1.6
10582,Jason Whitens\jason-whitens-1,2017-18,Western Michigan,G,16,0,95,6,14,.429,3,9,.333,3,5,.600,3,5,.600,7,8,15,4,3,3,4,13,18,1.0
10583,Jeremy Campbell\jeremy-campbell-1,2013-14,Southeastern Louisiana,G,7,1,68,6,17,.353,6,17,.353,0,0,,6,8,.750,3,9,12,2,4,2,2,6,18,2.1
10584,Derrick Richardson\derrick-richardson-2,2013-14,Central Michigan,G,27,0,142,5,18,.278,5,14,.357,0,4,.000,8,12,.667,14,11,25,2,7,0,4,18,18,0.6
10585,Niko Filipovich\niko-filipovich-1,2014-15,Hawaii,G,20,0,91,5,17,.294,3,5,.600,2,12,.167,6,6,1.000,2,5,7,5,3,0,7,14,18,0.2
10586,Jacob Hazzard\jacob-hazzard-1,2015-16,Arizona,G,7,0,26,6,10,.600,2,4,.500,4,6,.667,2,2,1.000,0,1,1,2,0,0,1,4,18,1.8
10587,Matt Panaggio\matt-panaggio-1,2014-15,Mercer,G,29,0,149,6,18,.333,4,13,.308,2,5,.400,4,7,.571,7,16,23,9,4,0,13,13,18,0.3
10588,John Caprio\john-caprio-1,2013-14,Georgetown,G,23,0,93,6,16,.375,6,14,.429,0,2,.000,5,12,.417,7,15,22,8,2,6,6,20,17,0.5
10589,Thaddeus Rideau\thaddeus-rideau-1,2013-14,Alabama-Birmingham,G,10,0,66,6,21,.286,1,4,.250,5,17,.294,0,0,,1,9,10,2,3,1,2,7,17,0.8
10590,Joel Hernandez\joel-hernandez-1,2016-17,Long Island University,G,1,1,23,8,12,.667,7,9,.778,1,3,.333,0,0,,2,3,5,1,2,2,3,2,17,14.4
10591,Aubrey McRae\aubrey-mcrae-1,2015-16,Georgia Southern,G,11,0,38,8,21,.381,7,10,.700,1,11,.091,0,2,.000,3,2,5,2,7,0,1,11,17,0.9
10592,Reed Westbrook\reed-westbrook-1,2013-14,Stephen F. Austin,G,16,0,44,4,17,.235,2,5,.400,2,12,.167,7,8,.875,2,4,6,3,2,0,2,5,17,0.6
10593,David Bloom\david-bloom-1,2017-18,Texas A&M-Corpus Christi,G,20,1,143,2,14,.143,1,6,.167,1,8,.125,12,15,.800,3,8,11,11,2,2,7,12,17,0.5
10594,Maurice Taylor\maurice-taylor-3,2014-15,Bethune-Cookman,G,13,0,114,7,26,.269,6,24,.250,1,2,.500,2,4,.500,5,16,21,1,1,1,7,8,17,0.1
10595,Aamahd Walker\aamahd-walker-1,2013-14,UC-Santa Barbara,G,15,0,63,6,15,.400,5,11,.455,1,4,.250,4,8,.500,4,7,11,2,4,1,5,7,17,0.7
10596,Tyler Clement\tyler-clement-1,2014-15,Creighton,G,26,0,145,5,23,.217,1,7,.143,4,16,.250,3,7,.429,1,12,13,13,2,0,11,15,17,0.0
10597,Prince Cooper\prince-cooper-1,2014-15,Louisiana-Monroe,G,19,0,119,8,18,.444,8,18,.444,0,0,,1,9,.111,7,13,20,9,3,1,9,6,17,0.6
10598,Souf Mensah\souf-mensah-1,2017-18,Rutgers,G,27,1,181,6,22,.273,6,22,.273,0,0,,5,19,.263,7,15,22,13,4,1,17,27,17,-0.2
10599,Olivier-Paul Betu\olivier-paul-betu-1,2013-14,UC-Davis,G,23,2,164,5,13,.385,5,7,.714,0,6,.000,7,12,.583,3,14,17,19,6,0,10,19,17,0.7
10600,Tre Green\tre-green-1,2014-15,Albany (NY),G,12,0,54,5,16,.313,3,11,.273,2,5,.400,5,7,.714,0,6,6,2,3,0,6,4,17,0.5
10601,Larry Austin\larry-austin-1,2014-15,Xavier,G,26,1,111,7,14,.500,7,14,.500,0,0,,3,4,.750,1,10,11,6,5,0,11,15,17,0.2
10602,Tripp Davis\tripp-davis-1,2017-18,Tennessee State,G,18,0,132,3,16,.188,3,9,.333,0,7,.000,11,16,.688,3,18,21,10,13,1,8,20,17,1.0
10603,Malek Harwell\malek-harwell-1,2017-18,Boise State,G,16,0,60,4,20,.200,2,7,.286,2,13,.154,7,11,.636,0,7,7,5,1,1,4,13,17,0.1
10604,Maurice O'Field\maurice-ofield-1,2017-18,Nicholls State,G,4,0,39,6,7,.857,3,3,1.000,3,4,.750,2,6,.333,2,9,11,0,1,1,2,5,17,3.7
10605,Holden Mobley\holden-mobley-1,2013-14,Belmont,G,33,0,240,6,12,.500,4,7,.571,2,5,.400,3,8,.375,11,15,26,13,8,0,11,28,17,0.5
10606,Ambrose Mosley\ambrose-mosley-1,2015-16,Old Dominion,G,5,0,92,6,24,.250,2,5,.400,4,19,.211,1,2,.500,3,18,21,4,2,0,7,12,17,0.5
10607,JC Cavin\jc-cavin-1,2017-18,Charleston Southern,G,9,1,58,6,14,.429,4,7,.571,2,7,.286,3,5,.600,0,0,0,4,2,0,3,11,17,0.7
10608,DeAndre Barber\deandre-barber-1,2014-15,High Point,G,19,0,172,6,14,.429,4,8,.500,2,6,.333,3,6,.500,0,10,10,15,4,0,7,20,17,0.6
10609,Trey Stacey\trey-stacey-1,2015-16,Wright State,G,14,0,33,6,10,.600,1,1,1.000,5,9,.556,0,0,,1,4,5,2,1,0,1,2,17,1.1
10610,P.J. Hardwick\pj-hardwick-1,2015-16,Arkansas State,G,7,1,142,4,18,.222,3,15,.200,1,3,.333,8,12,.667,3,14,17,19,7,0,10,12,17,2.3
10611,Jack Lopez\jack-lopez-1,2013-14,Montana,G,16,0,89,4,14,.286,2,5,.400,2,9,.222,7,9,.778,4,8,12,2,0,1,2,9,17,0.6
10612,Tyree Bynum\tyree-bynum-1,2014-15,Texas Southern,G,11,0,96,7,24,.292,4,12,.333,3,12,.250,0,0,,0,8,8,2,1,0,5,3,17,0.1
10613,Kyle McLeroy\kyle-mcleroy-1,2014-15,Sam Houston State,G,14,0,40,4,11,.364,1,2,.500,3,9,.333,6,6,1.000,0,2,2,4,1,0,4,3,17,0.7
10614,Matt Staubi\matt-staubi-1,2016-17,Loyola (MD),G,25,0,210,5,35,.143,1,13,.077,4,22,.182,3,4,.750,0,15,15,27,8,0,23,15,17,-0.1
10615,Kyle Brown\kyle-brown-2,2016-17,Texas A&M-Corpus Christi,G,27,0,155,2,9,.222,2,8,.250,0,1,.000,13,20,.650,4,6,10,10,7,0,19,19,17,0.0
10616,Cameron Gottfried\cameron-gottfried-1,2015-16,Siena,G,22,0,63,6,7,.857,4,4,1.000,2,3,.667,3,4,.750,2,12,14,3,1,0,7,8,17,0.5
10617,Aubrey McRae\aubrey-mcrae-1,2016-17,Georgia Southern,G,11,0,36,5,21,.238,0,5,.000,5,16,.313,2,3,.667,1,2,3,1,4,0,2,4,17,0.6
10618,J.T. Jones\jt-jones-1,2015-16,Southeast Missouri State,G,5,3,68,5,19,.263,2,9,.222,3,10,.300,4,6,.667,1,11,12,6,3,0,3,10,17,1.8
10619,Dondre Duffus\dondre-duffus-1,2017-18,Southeast Missouri State,G,3,0,43,5,10,.500,3,7,.429,2,3,.667,5,6,.833,0,5,5,3,3,0,6,9,17,2.9
10620,Rashaan Surles\rashaan-surles-1,2013-14,Prairie View,G,19,1,137,7,23,.304,6,14,.429,1,9,.111,2,3,.667,4,8,12,5,2,1,9,18,17,-0.1
10621,Jacob Broussard\jacob-broussard-1,2017-18,Louisiana,G,18,1,63,5,14,.357,0,1,.000,5,13,.385,2,2,1.000,0,4,4,7,4,0,6,8,17,0.6
10622,Bruce Ellington\bruce-ellington-1,2013-14,South Carolina,G,3,2,69,6,21,.286,3,8,.375,3,13,.231,2,2,1.000,2,2,4,5,3,2,4,8,17,2.5
10623,Travis Jorgenson\travis-jorgenson-1,2013-14,Georgia Tech,G,4,0,78,5,16,.313,3,11,.273,2,5,.400,5,6,.833,1,7,8,10,5,0,9,2,17,3.1
10624,Josh Jones\josh-jones-4,2013-14,Richmond,G,22,0,77,6,14,.429,2,4,.500,4,10,.400,1,4,.250,3,4,7,2,1,2,4,15,17,0.3
10625,A.J. Lynch\aj-lynch-1,2015-16,North Carolina Central,G,7,3,102,5,32,.156,3,16,.188,2,16,.125,5,8,.625,6,10,16,10,6,1,8,7,17,0.8
10626,Josh Williams\josh-williams-66,2017-18,South Dakota,G,12,0,42,7,11,.636,4,5,.800,3,6,.500,0,0,,0,2,2,2,0,0,2,1,17,1.0
10627,Landon Kirkwood\landon-kirkwood-1,2017-18,Cal State Fullerton,G,11,0,51,7,13,.538,4,6,.667,3,7,.429,0,0,,3,4,7,3,2,0,2,5,17,1.3
10628,Phil Booth\phil-booth-1,2016-17,Villanova,G,3,3,72,5,19,.263,2,9,.222,3,10,.300,4,4,1.000,1,4,5,6,1,0,6,3,17,1.9
10629,William Gates\william-gates-2,2014-15,Furman,G,7,1,91,7,22,.318,4,9,.444,3,13,.231,0,1,.000,0,4,4,6,0,0,2,6,17,0.7
10630,Jake Connor\jake-connor-1,2015-16,Utah,G,6,0,28,7,9,.778,4,4,1.000,3,5,.600,0,0,,0,1,1,4,1,0,1,4,17,2.5
10631,Jeremiah Livingston\jeremiah-livingston-1,2017-18,Saint Peter's,G,19,0,168,6,30,.200,4,19,.211,2,11,.182,3,5,.600,7,7,14,12,9,1,12,12,17,0.3
10632,Davon Dillard\davon-dillard-1,2017-18,Oklahoma State,G,4,0,33,6,10,.600,5,8,.625,1,2,.500,4,4,1.000,3,2,5,0,0,0,3,3,17,2.7
10633,Jason Richardson\jason-richardson-2,2016-17,Cal State Northridge,G,5,0,38,6,11,.545,6,11,.545,0,0,,5,7,.714,1,1,2,3,3,0,3,9,17,2.1
10634,Carlos Taylor\carlos-taylor-2,2013-14,Massachusetts-Lowell,G,9,0,47,6,22,.273,1,6,.167,5,16,.313,0,0,,3,4,7,0,0,0,4,1,17,0.3
10635,Zach Young\zach-young-1,2016-17,Nicholls State,G,19,0,92,2,16,.125,1,6,.167,1,10,.100,12,14,.857,2,4,6,7,2,0,6,12,17,0.2
10636,Jake Connor\jake-connor-1,2017-18,Utah,G,16,0,83,5,23,.217,0,2,.000,5,21,.238,2,5,.400,2,4,6,3,0,2,1,6,17,0.3
10637,Nick Powell\nick-powell-1,2017-18,North Carolina-Wilmington,G,19,1,142,6,31,.194,2,11,.182,4,20,.200,1,2,.500,8,10,18,4,3,0,5,7,17,0.2
10638,Isaac Letoa\isaac-letoa-1,2017-18,Dartmouth,G,16,0,109,6,18,.333,6,14,.429,0,4,.000,5,10,.500,1,8,9,14,6,1,10,3,17,0.8
10639,Randy Miller Jr.\randy-millerjr-1,2016-17,Mount St. Mary's,G,12,0,63,4,12,.333,1,4,.250,3,8,.375,5,6,.833,0,2,2,2,2,0,7,7,16,0.3
10640,Da'Shawn Robinson\dashawn-robinson-1,2017-18,Lamar,G,11,0,72,6,20,.300,4,8,.500,2,12,.167,2,4,.500,1,8,9,7,4,2,1,9,16,1.1
10641,Corey Redman\corey-redman-1,2017-18,Central Michigan,G,34,0,119,6,19,.316,2,5,.400,4,14,.286,0,0,,5,9,14,3,6,0,3,20,16,0.2
10642,Tyquon Jordan\tyquon-jordan-1,2017-18,Houston Baptist,G,7,0,25,5,9,.556,3,4,.750,2,5,.400,4,8,.500,3,2,5,1,1,1,3,5,16,1.5
10643,Cartree Pettis\cartree-pettis-1,2015-16,Jacksonville,G,25,0,206,5,11,.455,4,10,.400,1,1,1.000,5,10,.500,1,17,18,28,7,7,13,25,16,0.9
10644,Javaris Jenkins\javaris-jenkins-1,2013-14,Savannah State,G,9,0,104,7,16,.438,6,11,.545,1,5,.200,1,4,.250,7,10,17,1,3,1,7,8,16,0.9
10645,Elliott Pitts\elliott-pitts-1,2015-16,Arizona,G,7,2,149,7,26,.269,5,10,.500,2,16,.125,0,2,.000,8,8,16,13,8,0,11,21,16,0.8
10646,Trey Lenox\trey-lenox-1,2017-18,Abilene Christian,G,29,2,171,7,20,.350,7,15,.467,0,5,.000,2,5,.400,3,19,22,9,13,0,10,27,16,0.3
10647,Devin Waddell\devin-waddell-1,2014-15,Auburn,G,27,1,204,6,18,.333,5,13,.385,1,5,.200,3,6,.500,10,22,32,4,0,4,1,32,16,0.4
10648,Austin Starr\austin-starr-1,2015-16,Nevada-Las Vegas,G,13,0,85,4,19,.211,0,0,,4,19,.211,4,6,.667,2,1,3,2,2,0,2,15,16,0.0
10649,Lawson Schaffer\lawson-schaffer-1,2016-17,Alabama,G,15,0,28,4,10,.400,0,2,.000,4,8,.500,4,4,1.000,1,3,4,5,3,0,1,1,16,1.2
10650,Tom Wilson\tom-wilson-1,2016-17,Southern Methodist,G,10,0,61,5,16,.313,0,1,.000,5,15,.333,1,4,.250,1,9,10,5,1,0,6,3,16,0.6
10651,Jalen Palm\jalen-palm-1,2013-14,Monmouth,G,17,0,70,4,17,.235,2,9,.222,2,8,.250,6,10,.600,1,6,7,6,3,0,1,11,16,0.5
10652,Adam McDermott\adam-mcdermott-1,2017-18,Northern Iowa,G,8,0,78,5,14,.357,0,2,.000,5,12,.417,1,1,1.000,0,7,7,4,4,0,2,3,16,1.7
10653,Devon Carter\devon-carter-1,2014-15,Lehigh,G,17,0,73,5,16,.313,3,9,.333,2,7,.286,4,4,1.000,2,9,11,5,3,0,1,6,16,0.8
10654,Matt Rosenwinkel\matt-rosenwinkel-1,2015-16,Northern Kentucky,G,24,0,239,4,24,.167,1,3,.333,3,21,.143,5,6,.833,3,18,21,4,6,0,5,24,16,0.1
10655,Kaleb Joseph\kaleb-joseph-1,2015-16,Syracuse,G,18,0,114,5,28,.179,3,15,.200,2,13,.154,4,5,.800,5,5,10,12,8,1,6,10,16,0.6
10656,John Matt Merritt\johnmatt-merritt-1,2017-18,Lipscomb,G,13,0,54,6,12,.500,3,6,.500,3,6,.500,1,2,.500,2,3,5,3,1,0,2,8,16,0.8
10657,Landon Russell\landon-russell-1,2014-15,Yale,G,6,0,35,6,13,.462,4,6,.667,2,7,.286,2,2,1.000,1,3,4,2,0,0,1,1,16,1.8
10658,Wally Ellenson\wally-ellenson-1,2013-14,Minnesota,G,9,0,62,7,22,.318,5,13,.385,2,9,.222,0,1,.000,4,8,12,2,1,0,3,10,16,0.4
10659,Jordan Scurry\jordan-scurry-1,2016-17,Creighton,G,11,0,31,6,12,.500,2,2,1.000,4,10,.400,0,0,,0,4,4,4,1,0,0,3,16,1.3
10660,Max Tinsley\max-tinsley-1,2017-18,Pacific,G,15,0,75,6,8,.750,4,5,.800,2,3,.667,2,2,1.000,2,4,6,3,4,1,2,10,16,1.1
10661,Kyle Dobbins\kyle-dobbins-1,2015-16,Texas A&M,G,15,0,28,4,7,.571,4,7,.571,0,0,,8,15,.533,2,1,3,5,1,0,6,2,16,0.6
10662,Tyler Pate\tyler-pate-1,2013-14,Florida Atlantic,G,16,0,75,5,19,.263,2,4,.500,3,15,.200,3,5,.600,3,8,11,4,2,0,4,10,16,0.3
10663,Michael Saxton\michael-saxton-1,2015-16,Florida State,G,11,1,30,6,15,.400,2,5,.400,4,10,.400,0,0,,4,6,10,0,1,0,1,1,16,1.1
10664,Daniel Pillari\daniel-pillari-1,2016-17,Monmouth,G,15,0,43,4,15,.267,3,6,.500,1,9,.111,7,9,.778,2,3,5,1,2,0,5,9,16,0.2
10665,Anthony Johnson\anthony-johnson-7,2013-14,Eastern Illinois,G,27,0,121,5,18,.278,3,12,.250,2,6,.333,4,4,1.000,1,9,10,7,1,0,12,21,16,-0.2
10666,Dustin Hobaugh\dustin-hobaugh-1,2013-14,North Dakota,G,11,0,71,6,8,.750,2,2,1.000,4,6,.667,0,0,,3,8,11,3,3,1,4,11,16,1.3
10667,Perrion Callandret\perrion-callandret-1,2016-17,Idaho,G,2,2,60,5,21,.238,2,10,.200,3,11,.273,3,4,.750,0,9,9,7,0,0,1,3,16,4.2
10668,David Levitch\david-levitch-1,2013-14,Louisville,G,18,0,47,4,15,.267,1,7,.143,3,8,.375,5,8,.625,0,6,6,3,1,0,3,7,16,0.3
10669,Dee Giger\dee-giger-1,2013-14,Harvard,G,11,1,53,7,19,.368,5,9,.556,2,10,.200,0,0,,1,4,5,3,6,1,5,8,16,0.7
10670,Jaquori McLaughlin\jaquori-mclaughlin-1,2017-18,Oregon State,G,6,5,156,5,21,.238,5,11,.455,0,10,.000,6,6,1.000,2,14,16,22,9,3,14,18,16,2.4
10671,Coleman Edwards\coleman-edwards-1,2016-17,New Orleans,G,12,0,42,6,13,.462,2,3,.667,4,10,.400,0,0,,0,5,5,4,2,1,2,7,16,1.0
10672,Dan Kingma\dan-kingma-1,2016-17,Washington,G,19,0,119,5,17,.294,1,4,.250,4,13,.308,2,6,.333,1,9,10,9,3,0,8,16,16,0.1
10673,Bobby Perez\bobby-perez-1,2017-18,Wofford,G,11,1,60,6,10,.600,2,5,.400,4,5,.800,0,0,,0,0,0,6,2,0,6,4,16,0.9
10674,Al Burge\al-burge-1,2015-16,Longwood,G,14,0,32,7,13,.538,7,11,.636,0,2,.000,2,2,1.000,5,3,8,1,2,1,2,5,16,1.0
10675,Trey Stacey\trey-stacey-1,2016-17,Wright State,G,9,0,29,5,7,.714,1,1,1.000,4,6,.667,2,2,1.000,0,2,2,1,1,0,3,3,16,1.2
10676,Shane Benton\shane-benton-1,2014-15,North Dakota,G,11,0,73,5,13,.385,3,5,.600,2,8,.250,4,5,.800,1,7,8,2,1,0,1,16,16,0.6
10677,Stephen Spurlock\stephen-spurlock-1,2014-15,Maryland-Eastern Shore,G,18,1,83,6,12,.500,6,12,.500,0,0,,4,6,.667,7,10,17,2,1,1,1,7,16,0.9
10678,Brendon Ganaway\brendon-ganaway-1,2017-18,Southern,G,6,0,52,4,8,.500,1,3,.333,3,5,.600,5,5,1.000,1,0,1,5,0,0,3,5,16,1.9
10679,Jalen Johnson\jalen-johnson-1,2017-18,Tennessee,G,13,0,66,6,11,.545,3,5,.600,3,6,.500,1,2,.500,3,7,10,5,2,2,2,0,16,1.5
10680,Dexter Gooding\dexter-gooding-1,2017-18,High Point,G,14,0,49,6,21,.286,2,3,.667,4,18,.222,0,1,.000,0,9,9,3,5,2,3,2,16,0.8
10681,Bailey Walker\bailey-walker-1,2016-17,Northwestern State,G,28,0,281,5,24,.208,0,8,.000,5,16,.313,1,2,.500,6,6,12,14,9,0,22,27,16,-0.3
10682,Donald Moore\donald-moore-2,2013-14,Eastern Illinois,G,12,0,75,4,17,.235,2,10,.200,2,7,.286,6,9,.667,1,3,4,2,1,0,6,9,16,-0.1
10683,Chad Sherwood\chad-sherwood-1,2014-15,Idaho,G,6,0,49,5,14,.357,0,3,.000,5,11,.455,1,2,.500,0,4,4,2,1,1,2,9,16,1.1
10684,Tanner Sanders\tanner-sanders-1,2016-17,Oregon State,G,29,0,249,7,32,.219,5,10,.500,2,22,.091,0,2,.000,6,25,31,12,10,4,10,19,16,0.4
10685,Evan Maschmeyer\evan-maschmeyer-1,2014-15,Saint Joseph's,G,22,0,121,7,25,.280,6,14,.429,1,11,.091,1,2,.500,1,5,6,7,3,1,9,9,16,0.0
10686,Joe Kuligoski\joe-kuligoski-1,2013-14,Jacksonville State,G,9,3,108,6,15,.400,4,8,.500,2,7,.286,2,7,.286,9,11,20,8,4,2,6,14,16,1.7
10687,Kobie Eubanks\kobie-eubanks-1,2016-17,Texas A&M,G,16,0,117,7,29,.241,5,8,.625,2,21,.095,0,5,.000,6,9,15,2,0,1,8,9,16,-0.4
10688,Marcus Graves\marcus-graves-1,2014-15,Sacramento State,G,13,0,69,6,22,.273,2,9,.222,4,13,.308,0,1,.000,0,4,4,4,3,0,5,11,16,0.0
10689,Robert Mischler\robert-mischler-1,2014-15,Cornell,G,11,0,45,5,7,.714,2,2,1.000,3,5,.600,3,6,.500,0,2,2,1,1,0,0,3,16,1.2
10690,Nourse Fox\nourse-fox-1,2015-16,Navy,G,32,0,270,7,29,.241,5,13,.385,2,16,.125,0,1,.000,4,19,23,30,7,0,18,43,16,0.0
10691,Alan Vest\alan-vest-1,2016-17,Wright State,G,20,0,139,5,17,.294,2,11,.182,3,6,.500,3,4,.750,2,13,15,10,5,0,4,4,16,0.9
10692,Christian Gore\christian-gore-1,2014-15,Texas Christian,G,17,0,75,5,12,.417,1,2,.500,4,10,.400,2,3,.667,0,8,8,1,2,1,7,8,16,0.3
10693,Lance Richard\lance-richard-1,2017-18,Louisiana-Monroe,G,12,1,51,5,14,.357,0,1,.000,5,13,.385,0,0,,0,1,1,4,2,0,1,0,15,0.9
10694,Angelo Davis\angelo-davis-1,2013-14,Savannah State,G,16,1,52,2,8,.250,2,7,.286,0,1,.000,11,12,.917,1,1,2,3,2,0,6,8,15,0.4
10695,Thomas Greer\thomas-greer-1,2013-14,Austin Peay,G,10,0,43,4,8,.500,3,5,.600,1,3,.333,6,14,.429,0,7,7,0,3,0,5,8,15,0.5
10696,Kendall Jackson\kendall-jackson-1,2015-16,Columbia,G,10,0,52,5,13,.385,2,4,.500,3,9,.333,2,4,.500,1,1,2,3,1,0,3,13,15,0.3
10697,Aaron Williams\aaron-williams-6,2015-16,Western Carolina,G,5,0,18,4,5,.800,2,2,1.000,2,3,.667,5,5,1.000,1,1,2,0,0,0,0,0,15,2.8
10698,Donovan Greer\donovan-greer-1,2016-17,NJIT,G,4,0,41,5,19,.263,1,3,.333,4,16,.250,1,2,.500,0,3,3,3,2,0,3,4,15,0.9
10699,Quincy Drye\quincy-drye-1,2014-15,High Point,G,5,1,20,5,9,.556,5,9,.556,0,0,,5,6,.833,1,3,4,1,2,0,0,2,15,2.8
10700,Cheddi Mosely\cheddi-mosley-1,2017-18,Boston University,G,2,0,31,5,9,.556,2,5,.400,3,4,.750,2,2,1.000,0,6,6,1,1,0,2,3,15,5.5
10701,Jeff Van Dyke\jeff-van-dyke-1,2013-14,Pepperdine,G,18,1,116,5,21,.238,0,1,.000,5,20,.250,0,0,,2,5,7,4,4,0,6,20,15,-0.1
10702,Kyle Gonzalez\kyle-gonzalez-1,2015-16,Radford,G,12,1,50,5,8,.625,4,4,1.000,1,4,.250,4,7,.571,4,7,11,3,2,2,5,6,15,1.1
10703,Jason Houle\jason-houle-1,2016-17,Army,G,9,0,48,5,20,.250,0,2,.000,5,18,.278,0,0,,1,2,3,1,1,0,2,4,15,0.3
10704,Malik Hluchoweckyj\malik-hluchoweckyj-1,2015-16,Bowling Green State,G,9,0,45,6,12,.500,5,6,.833,1,6,.167,2,2,1.000,3,2,5,3,4,0,2,4,15,1.6
10705,Jamar Pope\jamar-pope-1,2014-15,Alabama State,G,10,0,57,5,10,.500,3,5,.600,2,5,.400,3,4,.750,1,6,7,2,4,0,2,4,15,1.4
10706,Dustin Triano\dustin-triano-1,2016-17,Gonzaga,G,25,0,75,5,10,.500,0,0,,5,10,.500,0,0,,2,9,11,1,2,0,0,7,15,0.6
10707,Jon Hood\jon-hood-1,2013-14,Kentucky,G,13,1,47,4,13,.308,1,3,.333,3,10,.300,4,4,1.000,1,3,4,5,2,0,4,5,15,0.7
10708,Brandon Neel\brandon-neel-1,2015-16,Wright State,G,5,0,58,6,19,.316,6,15,.400,0,4,.000,3,4,.750,4,3,7,1,4,3,2,4,15,2.1
10709,Ty Lazenby\ty-lazenby-1,2017-18,Oklahoma,G,26,0,131,6,20,.300,4,11,.364,2,9,.222,1,2,.500,4,12,16,4,5,0,8,19,15,0.1
10710,Myles Franklin\myles-franklin-2,2017-18,Northeastern,G,16,0,58,5,13,.385,3,5,.600,2,8,.250,3,6,.500,0,6,6,3,1,0,3,7,15,0.4
10711,Zach McCormick\zach-mccormick-1,2016-17,Miami (OH),G,5,0,56,6,15,.400,4,10,.400,2,5,.400,1,1,1.000,2,3,5,4,1,0,6,8,15,0.8
10712,Josh Morgan\josh-morgan-1,2013-14,Colorado State,G,13,0,31,6,13,.462,3,5,.600,3,8,.375,0,2,.000,0,0,0,2,2,0,2,3,15,0.6
10713,Donte DiVincenzo\donte-divincenzo-1,2015-16,Villanova,G,9,1,74,6,21,.286,3,4,.750,3,17,.176,0,0,,10,6,16,4,4,0,7,10,15,0.8
10714,Scott Mammel\scott-mammel-1,2015-16,Army,G,12,0,70,4,14,.286,3,8,.375,1,6,.167,6,6,1.000,2,7,9,9,2,0,6,7,15,0.8
10715,Tyree Bynum\tyree-bynum-1,2013-14,Texas Southern,G,16,1,77,5,20,.250,3,10,.300,2,10,.200,3,4,.750,1,5,6,5,4,0,4,6,15,0.4
10716,Mike Washington\mike-washington-2,2015-16,Princeton,G,17,1,62,7,17,.412,6,11,.545,1,6,.167,0,0,,0,12,12,5,0,0,6,2,15,0.4
10717,Brian Ishola\brian-ishola-1,2014-15,North Dakota State,G,14,0,95,3,9,.333,3,9,.333,0,0,,9,12,.750,3,7,10,1,0,0,2,12,15,0.5
10718,Cory Jacobsen\cory-jacobsen-1,2014-15,South Dakota State,G,12,0,41,5,10,.500,1,1,1.000,4,9,.444,1,1,1.000,0,3,3,2,0,0,1,6,15,0.7
10719,Keshawn Liggins\keshawn-liggins-1,2016-17,Idaho State,G,15,2,94,6,12,.500,6,11,.545,0,1,.000,3,8,.375,11,10,21,3,4,0,1,11,15,1.2
10720,Justin Turner\justin-turner-1,2016-17,Bowling Green State,G,4,0,53,5,12,.417,3,8,.375,2,4,.500,3,4,.750,0,4,4,1,1,0,3,6,15,1.4
10721,Trey Ford\trey-ford-1,2017-18,Appalachian State,G,6,0,20,4,5,.800,1,1,1.000,3,4,.750,4,5,.800,1,4,5,1,1,0,2,2,15,2.3
10722,Zach Durkee\zach-durkee-1,2016-17,Charleston Southern,G,5,1,20,6,10,.600,4,7,.571,2,3,.667,1,1,1.000,1,1,2,3,1,1,1,1,15,2.8
10723,Liam McManimon\liam-mcmanimon-1,2014-15,Mount St. Mary's,G,11,0,24,5,16,.313,1,2,.500,4,14,.286,1,2,.500,1,1,2,1,1,0,1,2,15,0.6
10724,Jonathan Holmes\jonathan-holmes-3,2017-18,Arkansas,G,11,0,18,6,15,.400,4,9,.444,2,6,.333,1,2,.500,2,1,3,1,1,0,2,1,15,0.7
10725,Austin Cox\austin-cox-1,2014-15,Arkansas-Pine Bluff,G,14,0,62,5,11,.455,5,8,.625,0,3,.000,5,6,.833,4,7,11,1,4,1,5,1,15,1.0
10726,Barry Cheaney\barry-cheaney-1,2014-15,Nevada-Las Vegas,G,8,0,26,6,12,.500,4,6,.667,2,6,.333,1,1,1.000,0,1,1,0,1,0,2,2,15,0.9
10727,Stanley Umude\stanley-umude-1,2017-18,South Dakota,G,14,0,47,4,14,.286,4,11,.364,0,3,.000,7,10,.700,0,7,7,2,1,2,6,3,15,0.3
10728,Daniel Collie\daniel-collie-1,2015-16,Wright State,G,17,3,84,5,17,.294,2,6,.333,3,11,.273,2,3,.667,0,2,2,6,2,1,1,8,15,0.5
10729,Ross Owens\ross-owens-1,2017-18,Missouri State,G,13,0,78,6,22,.273,3,3,1.000,3,19,.158,0,0,,1,6,7,2,2,1,7,7,15,-0.1
10730,Kevin Ware\kevin-ware-1,2013-14,Louisville,G,9,0,53,6,16,.375,6,14,.429,0,2,.000,3,6,.500,1,4,5,3,3,1,6,7,15,0.4
10731,Johnnie Vassar\johnnie-vassar-1,2014-15,Northwestern,G,18,0,70,7,19,.368,6,14,.429,1,5,.200,0,3,.000,2,5,7,8,2,0,7,13,15,0.1
10732,Jerron Washington\jerron-washington-1,2014-15,Little Rock,G,22,3,126,5,23,.217,5,21,.238,0,2,.000,5,10,.500,1,16,17,3,4,1,7,12,15,0.0
10733,Garrett Collins\garrett-collins-1,2014-15,North Carolina-Greensboro,G,9,0,28,5,7,.714,0,1,.000,5,6,.833,0,0,,0,1,1,3,1,0,0,2,15,1.6
10734,Tevin Moore\tevin-moore-1,2013-14,Mississippi State,G,13,0,52,5,15,.333,3,7,.429,2,8,.250,3,8,.375,1,5,6,0,0,0,3,2,15,0.2
10735,Jachai Taylor\jachai-taylor-1,2017-18,Murray State,G,16,0,87,6,19,.316,3,8,.375,3,11,.273,0,2,.000,1,9,10,0,1,1,2,11,15,0.1
10736,Corey Barnes\corey-barnes-2,2014-15,Alcorn State,G,7,0,42,5,16,.313,1,3,.333,4,13,.308,1,4,.250,0,2,2,0,1,0,5,8,15,-0.3
10737,Daniel Pillari\daniel-pillari-1,2015-16,Monmouth,G,22,0,35,3,13,.231,1,5,.200,2,8,.250,7,11,.636,0,4,4,1,1,0,3,5,15,0.2
10738,Jay Henderson\jay-henderson-2,2016-17,Louisville,G,17,0,35,5,16,.313,4,8,.500,1,8,.125,4,4,1.000,0,3,3,3,3,0,1,6,15,0.5
10739,Arthur Wade\arthur-wade-1,2014-15,Alabama A&M,G,11,0,84,6,14,.429,4,8,.500,2,6,.333,1,5,.200,3,5,8,2,6,0,2,8,15,1.1
10740,Carlin Bremner\carlin-bremner-1,2013-14,Winthrop,G,11,0,52,6,16,.375,5,10,.500,1,6,.167,2,2,1.000,1,1,2,0,3,0,4,5,15,0.4
10741,Reese Mona\reese-mona-1,2017-18,Maryland,G,12,0,45,4,6,.667,4,5,.800,0,1,.000,7,9,.778,3,2,5,0,3,0,2,6,15,1.1
10742,Deion Clark\deion-clark-1,2014-15,Old Dominion,G,20,0,70,5,15,.333,5,11,.455,0,4,.000,5,7,.714,5,6,11,1,2,0,2,3,15,0.5
10743,Lassi Nikkarinen\lassi-nikkarinen-1,2017-18,Montana State,G,23,0,169,4,13,.308,1,5,.200,3,8,.375,4,5,.800,1,12,13,13,6,0,8,21,15,0.4
10744,Eric Anderson\eric-anderson-2,2014-15,Yale,G,7,0,43,5,9,.556,4,6,.667,1,3,.333,4,10,.400,1,6,7,1,2,1,0,5,15,1.7
10745,Kris Dunn\kris-dunn-1,2013-14,Providence,G,4,0,106,6,19,.316,6,17,.353,0,2,.000,3,3,1.000,1,9,10,20,7,1,14,9,15,2.9
10746,Garvey Melmed\garvey-melmed-1,2017-18,Maine,G,15,1,63,5,16,.313,2,2,1.000,3,14,.214,2,2,1.000,2,5,7,5,3,0,2,5,15,0.7
10747,Grayson Clark\grayson-clark-1,2014-15,Georgia Southern,G,6,0,32,5,12,.417,2,5,.400,3,7,.429,2,4,.500,4,7,11,0,0,0,2,3,15,1.6
10748,Joe Burton\joe-burton-2,2014-15,Oklahoma State,G,9,0,32,5,15,.333,4,8,.500,1,7,.143,4,7,.571,4,1,5,0,0,0,2,3,15,0.6
10749,Domas Budrys\domas-budrys-1,2014-15,Austin Peay,G,14,0,59,5,16,.313,1,3,.333,4,13,.308,1,5,.200,1,3,4,0,1,0,3,6,15,0.1
10750,Jordan Ash\jordan-ash-1,2016-17,Northwestern,G,26,0,104,5,21,.238,0,5,.000,5,16,.313,0,0,,1,11,12,10,5,1,5,10,15,0.4
10751,Jake Dadika\jake-dadika-1,2017-18,Rutgers,G,17,1,105,5,15,.333,3,7,.429,2,8,.250,3,8,.375,0,6,6,5,2,0,2,6,15,0.4
10752,Whitley Carter\whitley-beau-carter-1,2014-15,Savannah State,G,26,1,131,4,18,.222,1,6,.167,3,12,.250,4,4,1.000,3,7,10,9,4,0,9,16,15,0.1
10753,Denarius Odell\denarius-odell-1,2013-14,Alcorn State,G,5,0,34,6,14,.429,5,12,.417,1,2,.500,2,7,.286,0,4,4,4,3,0,3,6,15,1.4
10754,Christian White\christian-white-1,2013-14,Monmouth,G,16,0,68,5,22,.227,3,8,.375,2,14,.143,3,7,.429,2,6,8,5,1,0,5,13,15,-0.2
10755,Evan Garrison\evan-garrison-1,2015-16,Portland State,G,18,0,119,6,17,.353,5,12,.417,1,5,.200,2,2,1.000,0,4,4,8,2,0,4,16,15,0.2
10756,Skyler Nash\skyler-nash-1,2017-18,Vermont,G,9,0,69,5,15,.333,0,3,.000,5,12,.417,0,0,,0,5,5,3,0,0,4,3,15,0.5
10757,Tommy Matthews\tommy-matthews-1,2014-15,Eastern Kentucky,G,33,0,171,4,18,.222,3,10,.300,1,8,.125,6,8,.750,3,19,22,10,15,2,9,47,15,0.2
10758,Romone Saunders\romone-saunders--1,2016-17,Wagner,G,1,1,27,5,11,.455,2,4,.500,3,7,.429,2,2,1.000,0,2,2,2,0,0,2,2,15,8.5
10759,Devin Cooper\devin-cooper-1,2015-16,Radford,G,13,0,47,6,17,.353,4,9,.444,2,8,.250,1,1,1.000,1,1,2,2,1,0,2,9,15,0.3
10760,Max Tinsley\max-tinsley-1,2015-16,Pacific,G,5,0,20,7,12,.583,6,8,.750,1,4,.250,0,0,,1,2,3,0,1,0,0,1,15,2.3
10761,Dylan Brewster\dylan-brewster-1,2016-17,Chattanooga,G,7,0,33,5,10,.500,0,0,,5,10,.500,0,0,,3,2,5,3,0,0,1,3,15,1.8
10762,Nourse Fox\nourse-fox-1,2014-15,Navy,G,11,1,82,5,15,.333,2,7,.286,3,8,.375,2,4,.500,0,5,5,8,3,0,4,9,15,0.7
10763,Spike Albrecht\spike-albrecht-1,2015-16,Michigan,G,9,0,73,4,11,.364,2,4,.500,2,7,.286,5,7,.714,1,5,6,11,3,0,1,2,15,2.1
10764,Dominique Shaw\dominique-shaw-1,2015-16,Prairie View,G,8,0,59,4,16,.250,4,13,.308,0,3,.000,7,13,.538,4,5,9,2,4,0,1,8,15,1.1
10765,Ganlandou Cisse\ganlandou-cisse-1,2016-17,Long Island University,G,8,0,43,6,7,.857,6,7,.857,0,0,,3,9,.333,3,9,12,1,1,2,2,11,15,1.5
10766,Chinedu Amajoyi\chinedu-amajoyi-1,2014-15,Louisiana-Monroe,G,22,2,134,6,22,.273,5,12,.417,1,10,.100,2,2,1.000,2,14,16,13,1,0,7,12,15,0.3
10767,Max Twyman\max-twyman-1,2017-18,Hartford,G,24,0,174,5,21,.238,1,5,.200,4,16,.250,1,4,.250,5,12,17,5,1,0,4,13,15,0.1
10768,Will Adams\will-adams-2,2014-15,Presbyterian,G,21,0,88,4,18,.222,0,4,.000,4,14,.286,2,2,1.000,1,6,7,1,3,1,8,12,14,-0.1
10769,LeSean Brown\lesean-brown-1,2017-18,Air Force,G,14,0,44,3,10,.300,3,6,.500,0,4,.000,8,13,.615,2,1,3,3,0,0,1,3,14,0.6
10770,Nevell Provo\nevell-provo-1,2017-18,Loyola (MD),G,12,1,89,5,25,.200,1,4,.250,4,21,.190,0,0,,1,7,8,3,3,0,3,11,14,-0.1
10771,Phillip Johnson\phillip-johnson-2,2015-16,Incarnate Word,G,26,0,129,4,16,.250,2,9,.222,2,7,.286,4,6,.667,2,7,9,5,0,1,3,9,14,0.2
10772,David Mason\david-mason-1,2013-14,Oral Roberts,G,10,1,58,6,13,.462,5,10,.500,1,3,.333,1,2,.500,3,5,8,14,2,0,7,5,14,1.3
10773,Ricky Council II\ricky-councilii-1,2015-16,Providence,G,14,0,46,4,19,.211,1,1,1.000,3,18,.167,3,3,1.000,0,6,6,1,2,2,4,3,14,0.2
10774,Michael Schlotman\michael-schlotman-1,2016-17,William & Mary,G,12,1,57,4,5,.800,4,5,.800,0,0,,6,8,.750,4,9,13,10,5,2,3,1,14,2.2
10775,John Reese\john-reese-1,2013-14,New Orleans,G,16,1,45,5,13,.385,2,4,.500,3,9,.333,1,2,.500,2,4,6,5,1,0,3,1,14,0.6
10776,Khalil Batie\khalil-batie-1,2014-15,Rutgers,G,15,0,48,5,17,.294,1,8,.125,4,9,.444,0,0,,2,6,8,2,2,0,2,3,14,0.5
10777,Marc Seylan\marc-seylan-1,2015-16,Maryland-Eastern Shore,G,15,6,141,6,22,.273,6,15,.400,0,7,.000,2,3,.667,5,12,17,9,6,0,15,10,14,0.1
10778,Will Holifield\will-holifield-1,2013-14,Southeast Missouri State,G,9,0,38,5,11,.455,1,2,.500,4,9,.444,0,0,,0,2,2,1,1,0,1,5,14,0.8
10779,Trey Knight III\trey-knightiii-1,2016-17,Indiana State,G,18,0,144,5,18,.278,3,11,.273,2,7,.286,2,4,.500,2,12,14,10,8,1,5,24,14,0.5
10780,Austin Harriott\austin-harriott-1,2016-17,Loyola (MD),G,16,0,96,5,13,.385,5,11,.455,0,2,.000,4,7,.571,7,9,16,0,3,0,4,21,14,0.2
10781,Justin Jenkins\justin-jenkins-1,2016-17,Gardner-Webb,G,10,0,44,4,12,.333,1,5,.200,3,7,.429,3,4,.750,0,4,4,3,3,2,1,1,14,1.3
10782,Mark Hall\mark-hall-2,2014-15,Illinois State,G,9,0,57,6,16,.375,6,11,.545,0,5,.000,2,2,1.000,1,4,5,8,0,0,4,4,14,0.8
10783,Chris Tang\chris-tang-1,2014-15,UC-Riverside,G,10,0,39,6,11,.545,4,7,.571,2,4,.500,0,2,.000,2,6,8,3,0,0,1,4,14,1.1
10784,Kendall Jackson\kendall-jackson-1,2016-17,Columbia,G,13,2,82,4,9,.444,3,5,.600,1,4,.250,5,7,.714,0,8,8,10,5,1,7,13,14,0.9
10785,Jamison Glover\jamison-glover-1,2014-15,William & Mary,G,5,0,16,2,6,.333,2,6,.333,0,0,,10,13,.769,3,3,6,1,1,0,2,1,14,2.3
10786,Tyler Jenkins\tyler-jenkins-1,2014-15,Lehigh,G,5,0,23,3,5,.600,1,2,.500,2,3,.667,6,7,.857,0,3,3,5,2,0,2,2,14,3.0
10787,Caleb Woods\caleb-woods-1,2013-14,Southeast Missouri State,G,9,0,43,5,12,.417,5,11,.455,0,1,.000,4,6,.667,1,3,4,1,2,0,1,6,14,0.9
10788,Chauncey Orr\chauncey-orr-1,2013-14,Bowling Green State,G,1,1,12,5,6,.833,3,3,1.000,2,3,.667,2,2,1.000,0,2,2,0,0,0,0,0,14,12.4
10789,Georgios Angelou\georgios-angelou-1,2013-14,Saint Francis (PA),G,14,0,85,4,15,.267,0,1,.000,4,14,.286,2,3,.667,0,7,7,4,2,1,4,3,14,0.5
10790,Cory Cardwell\cory-cardwell-1,2014-15,Utah Valley,G,14,1,73,4,16,.250,2,2,1.000,2,14,.143,4,4,1.000,0,6,6,7,1,0,5,12,14,0.2
10791,Bryce Moragne\bryce-moragne-1,2017-18,Florida A&M,G,18,0,64,4,11,.364,3,9,.333,1,2,.500,5,6,.833,5,3,8,4,2,0,2,9,14,0.6
10792,John Green\john-green-3,2013-14,UC-Santa Barbara,G,3,0,33,6,16,.375,6,13,.462,0,3,.000,2,3,.667,5,3,8,1,0,1,5,8,14,0.8
10793,Devorious Brown\devorious-brown-1,2016-17,Florida Atlantic,G,10,0,82,6,18,.333,6,15,.400,0,3,.000,2,5,.400,5,9,14,6,5,1,11,6,14,0.5
10794,Demonte Ojinnaka\demonte-ojinnaka-1,2016-17,Indiana State,G,9,0,63,5,16,.313,2,5,.400,3,11,.273,1,3,.333,1,7,8,1,1,0,3,6,14,0.3
10795,Justice Montgomery\justice-montgomery-1,2013-14,American,G,21,0,145,4,22,.182,3,15,.200,1,7,.143,5,15,.333,2,5,7,15,4,0,16,22,14,-0.5
10796,Joel Davis\joel-davis-1,2016-17,Cornell,G,8,0,36,4,11,.364,2,6,.333,2,5,.400,4,6,.667,4,2,6,0,0,1,0,4,14,1.2
10797,Marquell Fraser\marquell-fraser-1,2016-17,Virginia Commonwealth,G,16,0,58,4,7,.571,4,6,.667,0,1,.000,6,7,.857,1,4,5,2,1,0,5,9,14,0.4
10798,John Robert Simon\john-robert-simon-1,2013-14,Wichita State,G,25,0,66,1,9,.111,0,3,.000,1,6,.167,11,17,.647,1,7,8,3,1,0,7,9,14,0.0
10799,Arthur Edwards\arthur-edwards-1,2013-14,New Mexico,G,15,0,120,5,28,.179,4,10,.400,1,18,.056,3,4,.750,4,4,8,3,4,4,5,21,14,-0.3
10800,Jerald Gillens-Butler\jerald-gillens-butler-1,2017-18,Butler,G,12,0,61,3,16,.188,1,7,.143,2,9,.222,6,8,.750,3,3,6,2,0,0,4,7,14,0.1
10801,CJ Jones\cj-jones-2,2013-14,Manhattan,G,8,5,89,4,21,.190,2,9,.222,2,12,.167,4,6,.667,3,6,9,9,2,0,6,10,14,0.3
10802,Ed Carter III\ed-carteriii-1,2016-17,Detroit Mercy,G,20,0,104,4,30,.133,2,13,.154,2,17,.118,4,5,.800,3,11,14,14,4,0,8,12,14,0.0
10803,Andrew Riley\andrew-riley-1,2016-17,Arkansas State,G,12,0,23,5,7,.714,3,3,1.000,2,4,.500,2,2,1.000,1,1,2,1,2,0,0,3,14,1.1
10804,Matt Farrell\matt-farrell-1,2014-15,Notre Dame,G,15,0,62,3,13,.231,2,7,.286,1,6,.167,7,8,.875,0,6,6,7,2,0,3,3,14,0.7
10805,Callum Long\callum-long-1,2013-14,Air Force,G,7,0,76,4,10,.400,2,3,.667,2,7,.286,4,5,.800,1,7,8,6,1,1,11,11,14,0.2
10806,BJ Edwards\bj-edwards-1,2014-15,Jacksonville,G,27,15,342,5,40,.125,5,38,.132,0,2,.000,4,10,.400,5,18,23,32,9,4,18,30,14,0.0
10807,Taylor Brown\taylor-brown-2,2013-14,Utah Valley,G,23,0,129,5,16,.313,1,2,.500,4,14,.286,0,0,,3,3,6,6,2,0,3,13,14,0.3
10808,John Middleton\john-middleton-1,2015-16,Utah State,G,8,0,49,4,13,.308,3,9,.333,1,4,.250,5,8,.625,1,3,4,0,2,0,1,5,14,0.7
10809,J.D. Tisdale\jd-tisdale-1,2014-15,Bowling Green State,G,17,0,110,3,15,.200,2,7,.286,1,8,.125,7,11,.636,6,16,22,7,1,2,8,9,14,0.5
10810,Michael Donovan\michael-donovan-1,2014-15,Virginia Military Institute,G,12,1,57,4,12,.333,0,1,.000,4,11,.364,2,2,1.000,4,7,11,2,0,0,2,8,14,0.7
10811,Riley Welch\riley-welch-1,2017-18,UC-Irvine,G,27,0,141,4,13,.308,2,5,.400,2,8,.250,4,5,.800,2,12,14,15,2,0,7,22,14,0.3
10812,Mike Robinson\mike-robinson-4,2015-16,Miami (FL),G,9,0,14,5,9,.556,1,2,.500,4,7,.571,0,0,,0,1,1,0,0,0,0,3,14,1.0
10813,Andrew Dakich\andrew-dakich-1,2015-16,Michigan,G,24,0,110,5,12,.417,4,6,.667,1,6,.167,3,3,1.000,3,13,16,14,6,0,8,11,14,0.7
10814,Darien Jackson\darien-jackson-1,2017-18,Tulsa,G,18,1,91,7,20,.350,7,16,.438,0,4,.000,0,3,.000,4,4,8,3,5,0,7,18,14,-0.1
10815,Thomas Ryan\thomas-ryan-1,2016-17,Yale,G,6,0,31,4,12,.333,2,4,.500,2,8,.250,4,5,.800,1,3,4,0,2,0,1,3,14,1.4
10816,Matthew Johnson\matthew-johnson-2,2017-18,Southern Utah,G,15,0,96,4,18,.222,1,5,.200,3,13,.231,3,4,.750,2,6,8,6,4,0,2,11,14,0.5
10817,Thomas Ryan\thomas-ryan-1,2017-18,Yale,G,10,0,51,5,12,.417,4,5,.800,1,7,.143,3,4,.750,0,2,2,2,3,3,4,10,14,0.6
10818,Kyle Denning\kyle-denning-1,2013-14,Iowa,G,10,0,43,6,11,.545,4,4,1.000,2,7,.286,0,0,,0,3,3,4,1,0,1,1,14,1.2
10819,Joey Miller\joey-miller-1,2013-14,Illinois-Chicago,G,7,0,50,5,15,.333,3,7,.429,2,8,.250,2,4,.500,1,2,3,4,1,0,6,4,14,0.3
10820,Christian Adams\christian-adams-1,2016-17,Coastal Carolina,G,13,0,89,6,23,.261,6,19,.316,0,4,.000,2,6,.333,2,7,9,7,8,0,6,11,14,0.4
10821,Radin Hughes\radin-hughes-1,2014-15,South Carolina State,G,15,0,83,5,17,.294,5,16,.313,0,1,.000,4,9,.444,4,5,9,7,2,0,11,10,14,-0.1
10822,Ernie Duncan\ernie-duncan-1,2014-15,Vermont,G,4,4,56,4,13,.308,0,2,.000,4,11,.364,2,2,1.000,0,6,6,10,0,0,5,3,14,2.3
10823,Tavis Gibson\travis-gibson-1,2014-15,Alcorn State,G,24,0,127,4,30,.133,0,2,.000,4,28,.143,2,3,.667,0,5,5,6,7,0,9,6,14,-0.2
10824,Martin Shaw\martin-shaw-1,2015-16,Old Dominion,G,15,1,54,4,16,.250,4,10,.400,0,6,.000,6,6,1.000,0,2,2,2,2,1,5,16,14,-0.2
10825,Michael Onyebalu\michael-onyebalu-1,2016-17,UC-Davis,G,23,0,84,5,12,.417,3,4,.750,2,8,.250,2,4,.500,1,8,9,2,1,0,3,10,14,0.2
10826,Brandon Thompson\brandon-thompson-2,2014-15,Citadel,G,10,0,36,5,10,.500,1,3,.333,4,7,.571,0,0,,0,1,1,2,0,0,1,4,14,0.8
10827,DeAndre Barber\deandre-barber-1,2015-16,High Point,G,20,0,121,5,11,.455,2,5,.400,3,6,.500,1,2,.500,0,7,7,11,2,0,4,11,14,0.6
10828,Teven Jones\teven-jones-1,2013-14,Virginia,G,29,0,126,4,24,.167,4,17,.235,0,7,.000,6,16,.375,2,3,5,8,4,0,1,12,14,0.0
10829,Lucas Antunez\lucas-antunez-1,2016-17,Toledo,G,17,0,89,2,12,.167,1,6,.167,1,6,.167,9,10,.900,1,4,5,10,1,0,8,16,14,0.1
10830,Jamil Jackson\jamil-jackson-1,2017-18,Southern Utah,G,5,0,71,6,14,.429,6,11,.545,0,3,.000,2,2,1.000,1,1,2,5,2,1,3,9,14,1.4
10831,Phillip Johnson\phillip-johnson-2,2013-14,Incarnate Word,G,22,1,79,6,16,.375,6,16,.375,0,0,,2,2,1.000,2,2,4,3,0,1,3,6,14,0.2
10832,Jamison Glover\jamison-glover-1,2016-17,William & Mary,G,9,0,17,6,6,1.000,6,6,1.000,0,0,,2,4,.500,1,1,2,0,0,0,1,3,14,1.1
10833,Hunter Summy\hunter-summy-1,2017-18,San Diego,G,10,0,77,5,12,.417,1,2,.500,4,10,.400,0,0,,0,1,1,3,2,0,3,4,14,0.7
10834,Jake McDowell\jake-mcdowell-1,2015-16,Memphis,G,24,2,129,6,12,.500,6,12,.500,0,0,,2,5,.400,3,6,9,4,3,0,5,21,14,0.1
10835,Kaleb Mallory\kaleb-mallory-1,2014-15,Ball State,G,13,2,108,5,16,.313,4,11,.364,1,5,.200,3,7,.429,0,4,4,13,5,1,6,7,14,0.8
10836,Evan Richard\evan-richard-1,2013-14,Milwaukee,G,15,0,67,4,14,.286,2,9,.222,2,5,.400,4,4,1.000,3,2,5,1,1,1,2,1,14,0.6
10837,Reed McConnell\reed-mcconnell-1,2013-14,UC-Irvine,G,12,0,52,5,12,.417,3,5,.600,2,7,.286,1,1,1.000,2,3,5,4,5,0,0,4,13,1.3
10838,Jake Newman\jake-newman-1,2013-14,Lafayette,G,16,0,91,5,12,.417,3,7,.429,2,5,.400,1,2,.500,1,5,6,7,0,0,7,10,13,0.1
10839,Ashwell Boyd\ashwell-boyd-1,2013-14,Delaware State,G,9,1,32,5,10,.500,5,10,.500,0,0,,3,5,.600,3,2,5,1,2,0,2,11,13,0.7
10840,Zach Chionuma\zach-chionuma-1,2015-16,Bryant,G,8,1,49,5,21,.238,2,8,.250,3,13,.231,0,0,,0,7,7,1,0,0,2,9,13,-0.3
10841,Daquein McNeil\daquein-mcneil-1,2014-15,Minnesota,G,4,0,75,5,19,.263,4,12,.333,1,7,.143,2,8,.250,5,8,13,10,3,0,3,12,13,1.9
10842,Tarik Clement\tarik-clement-1,2017-18,South Carolina State,G,13,0,52,5,11,.455,5,9,.556,0,2,.000,3,4,.750,1,5,6,2,1,0,3,5,13,0.5
10843,Clayton Custer\clayton-custer-1,2014-15,Iowa State,G,12,0,69,3,15,.200,0,5,.000,3,10,.300,4,4,1.000,1,4,5,8,4,0,3,6,13,0.8
10844,Cam Delaney\cam-delaney-1,2015-16,Sam Houston State,G,2,0,30,5,8,.625,3,4,.750,2,4,.500,1,2,.500,0,3,3,4,1,0,2,2,13,5.5
10845,Montraz Oliver\montraz-oliver-1,2017-18,Maryland-Eastern Shore,G,15,1,66,5,23,.217,3,14,.214,2,9,.222,1,2,.500,4,8,12,1,0,1,3,5,13,0.0
10846,Nathan Priddy\nathan-priddy-1,2017-18,Elon,G,7,0,33,5,10,.500,2,5,.400,3,5,.600,0,0,,1,0,1,2,0,0,5,5,13,0.4
10847,Christian Popoola\christian-popoola-1,2017-18,Utah,G,17,0,99,4,17,.235,4,12,.333,0,5,.000,5,6,.833,0,13,13,2,2,0,8,13,13,-0.2
10848,Eric Anderson\eric-anderson-2,2016-17,Yale,G,11,0,96,6,16,.375,6,13,.462,0,3,.000,1,4,.250,7,13,20,1,2,2,5,3,13,0.9
10849,Joseph Battle\battle-joseph-1,2016-17,Tulsa,G,13,0,51,5,15,.333,4,12,.333,1,3,.333,2,2,1.000,3,6,9,0,0,0,3,7,13,0.2
10850,Ibrahima Sankare\ibrahima-sankare-1,2017-18,Grand Canyon,G,9,0,34,4,8,.500,4,8,.500,0,0,,5,7,.714,2,6,8,1,5,1,3,4,13,1.5
10851,Justice Obasohan\justice-obasohan-1,2017-18,East Carolina,G,8,0,71,5,14,.357,5,13,.385,0,1,.000,3,4,.750,1,8,9,2,3,9,5,9,13,1.3
10852,Mohamed Abuarisha\mohamed-abuarisha-1,2017-18,Jacksonville State,G,17,0,53,5,20,.250,2,8,.250,3,12,.250,0,0,,2,6,8,3,1,0,8,3,13,-0.1
10853,Juwan Henderson\juwan-henderson-1,2017-18,Alcorn State,G,6,0,48,5,12,.417,4,8,.500,1,4,.250,2,3,.667,2,2,4,9,3,0,7,6,13,1.4
10854,David Trimble\david-trimble-1,2013-14,Seattle,G,11,0,44,5,12,.417,5,12,.417,0,0,,3,8,.375,4,4,8,8,3,0,4,3,13,1.1
10855,Blake Provost\blake-provost-1,2013-14,Texas-Rio Grande Valley,G,24,1,146,4,19,.211,2,6,.333,2,13,.154,3,4,.750,0,11,11,6,7,0,8,12,13,0.1
10856,Baryn Houston\baryn-houston-1,2013-14,Alabama A&M,G,11,0,40,4,18,.222,2,9,.222,2,9,.222,3,5,.600,5,5,10,0,2,1,0,4,13,0.7
10857,Therone Tillett\therone-tillett-1,2013-14,San Diego,G,5,0,8,5,6,.833,2,2,1.000,3,4,.750,0,0,,0,0,0,0,0,0,0,1,13,2.1
10858,Tab Hamilton\tabarris-hamilton-1,2014-15,Appalachian State,G,4,0,72,5,20,.250,3,11,.273,2,9,.222,1,4,.250,0,6,6,4,0,1,4,12,13,-0.9
10859,Alex Allbery\alex-allbery-1,2016-17,Omaha,G,10,0,46,4,10,.400,1,5,.200,3,5,.600,2,2,1.000,1,4,5,0,0,0,2,2,13,0.7
10860,Marquis Nelson\marquis-nelson-1,2015-16,Nicholls State,G,17,0,84,5,19,.263,2,8,.250,3,11,.273,0,0,,2,8,10,2,3,0,6,7,13,0.1
10861,Matt Hancock\matt-hancock-1,2013-14,Lamar,G,11,0,100,4,16,.250,1,2,.500,3,14,.214,2,3,.667,3,9,12,4,1,0,2,11,13,0.5
10862,Cam Miller\cam-miller-1,2013-14,Lipscomb,G,18,0,99,3,9,.333,1,3,.333,2,6,.333,5,8,.625,5,5,10,8,1,3,4,12,13,0.6
10863,Brady Ellingson\brady-ellingson-1,2014-15,Iowa,G,7,0,32,4,8,.500,0,2,.000,4,6,.667,1,2,.500,0,0,0,4,1,0,1,1,13,1.6
10864,Josh Williams\josh-williams-6,2015-16,Rider,G,9,0,41,5,15,.333,5,12,.417,0,3,.000,3,7,.429,1,9,10,1,1,2,5,5,13,0.3
10865,Eric Anderson\eric-anderson-2,2017-18,Yale,G,11,1,64,3,12,.250,2,9,.222,1,3,.333,6,8,.750,4,8,12,5,1,2,2,4,13,1.1
10866,Joshea Singleton\joshea-singleton-1,2013-14,Bucknell,G,11,0,71,3,15,.200,3,13,.231,0,2,.000,7,13,.538,3,3,6,3,0,1,6,11,13,-0.3
10867,Dalton Dry\dalton-dry-1,2017-18,Texas Christian,G,9,0,23,2,7,.286,0,2,.000,2,5,.400,7,10,.700,0,4,4,0,1,0,0,2,13,1.0
10868,Eric Johnson\eric-johnson-4,2014-15,Boston University,G,12,2,110,4,14,.286,3,7,.429,1,7,.143,4,9,.444,0,7,7,6,4,0,8,7,13,0.2
10869,Isaac Lang\isaac-lang-1,2013-14,Central Florida,G,14,1,38,5,12,.417,2,2,1.000,3,10,.300,0,1,.000,1,2,3,0,0,0,1,2,13,0.4
10870,John Robert Simon\john-robert-simon-1,2014-15,Wichita State,G,14,0,49,5,11,.455,4,7,.571,1,4,.250,2,2,1.000,2,5,7,5,4,0,5,6,13,0.7
10871,Miles Wentzien\miles-wentzien-1,2017-18,Northern Iowa,G,5,0,55,5,15,.333,3,9,.333,2,6,.333,1,1,1.000,1,4,5,6,3,0,7,2,13,1.2
10872,Mike Harrell\mike-harrell-1,2013-14,Southern,G,18,0,225,5,22,.227,5,21,.238,0,1,.000,3,9,.333,1,20,21,28,10,1,16,27,13,0.4
10873,Dadrian Harris\dadrian-harris-1,2013-14,Northwestern State,G,18,0,85,4,20,.200,3,10,.300,1,10,.100,4,6,.667,5,5,10,6,2,0,8,15,13,-0.2
10874,Christien Sager\christien-sager-1,2014-15,Oklahoma State,G,23,1,98,3,15,.200,0,1,.000,3,14,.214,4,9,.444,3,9,12,4,4,0,2,12,13,0.3
10875,Mitchell Hill\mitchell-hill-1,2013-14,Tennessee Tech,G,8,1,64,3,15,.200,2,6,.333,1,9,.111,6,8,.750,1,2,3,4,2,0,5,1,13,0.5
10876,Jonathan Milligan\jonathan-milligan-1,2015-16,Pittsburgh,G,4,0,39,4,7,.571,1,3,.333,3,4,.750,2,2,1.000,0,1,1,3,0,0,2,7,13,1.8
10877,Jacob Redding\jacob-redding-1,2017-18,Louisville,G,6,0,13,4,4,1.000,1,1,1.000,3,3,1.000,2,2,1.000,0,0,0,0,0,0,0,0,13,2.0
10878,Kye de Laveaga\kye-de-laveaga-1,2017-18,Northern Arizona,G,13,1,65,2,12,.167,0,0,,2,12,.167,7,8,.875,0,2,2,2,2,0,1,8,13,0.4
10879,Tim Hasbargen\tim-hasbargen-1,2016-17,Cleveland State,G,14,0,46,4,11,.364,2,2,1.000,2,9,.222,3,3,1.000,2,3,5,4,1,0,2,2,13,0.7
10880,Tanner Wozniak\tanner-wozniak-1,2014-15,Kennesaw State,G,21,0,135,4,15,.267,0,1,.000,4,14,.286,1,2,.500,1,9,10,4,2,0,11,12,13,-0.2
10881,D'Erryl Williams\derryl-williams-1,2013-14,San Diego State,G,20,0,126,4,12,.333,3,11,.273,1,1,1.000,4,9,.444,3,8,11,8,0,2,3,17,13,0.3
10882,Jarred Jones\jarred-jones-1,2014-15,Loyola (MD),G,2,2,40,4,12,.333,4,12,.333,0,0,,5,9,.556,4,11,15,3,2,3,10,6,13,2.3
10883,Desmond Ross\desmond-ross-1,2013-14,Cal State Long Beach,G,15,0,69,5,17,.294,4,10,.400,1,7,.143,2,3,.667,4,6,10,2,0,1,3,7,13,0.2
10884,Mike Schroback\mike-schroback-1,2014-15,Fairleigh Dickinson,G,20,0,63,5,12,.417,2,5,.400,3,7,.429,0,1,.000,0,0,0,4,2,0,3,1,13,0.4
10885,Malek Harwell\malek-harwell-1,2016-17,Boise State,G,9,0,39,3,15,.200,2,6,.333,1,9,.111,6,8,.750,3,5,8,0,0,0,6,6,13,-0.2
10886,Jared Walker\jared-walker-1,2014-15,Wichita State,G,11,0,37,4,8,.500,1,3,.333,3,5,.600,2,2,1.000,1,5,6,3,0,0,2,5,13,0.8
10887,Malcolm Allen\malcolm-allen-1,2013-14,Stanford,G,16,0,74,5,9,.556,5,8,.625,0,1,.000,3,5,.600,1,2,3,1,1,0,1,5,13,0.5
10888,Tahj Shamsid-Deen\tahj-shamsid-deen-1,2015-16,Auburn,G,5,0,58,5,17,.294,3,9,.333,2,8,.250,1,3,.333,0,6,6,8,3,0,2,2,13,2.0
10889,Marius McAllister\marius-mcallister-1,2015-16,North Carolina Central,G,15,0,61,4,9,.444,4,8,.500,0,1,.000,5,8,.625,6,6,12,4,5,1,3,7,13,1.1
10890,Aaron Tyser\aaron-tyser-1,2013-14,Wyoming,G,10,0,13,5,7,.714,2,3,.667,3,4,.750,0,0,,0,7,7,1,0,0,2,0,13,1.1
10891,Jafar Kinsey\jafar-kinsey-1,2014-15,Robert Morris,G,11,0,157,5,23,.217,2,10,.200,3,13,.231,0,4,.000,2,10,12,10,3,0,13,18,13,-0.8
10892,B.J. Stith\bj-stith-1,2014-15,Virginia,G,13,0,63,5,13,.385,4,7,.571,1,6,.167,2,3,.667,0,8,8,4,2,0,3,2,13,0.7
10893,Will Dunn\will-dunn-2,2013-14,Purdue-Fort Wayne,G,15,0,51,5,10,.500,5,8,.625,0,2,.000,3,10,.300,0,2,2,0,0,0,2,3,13,0.2
10894,Anthony Gaston\anthony-gaston-1,2016-17,Grambling,G,10,0,50,4,17,.235,4,14,.286,0,3,.000,5,10,.500,2,8,10,3,4,1,2,5,13,0.7
10895,Zieyik Estime\zieyik-estime-1,2013-14,Norfolk State,G,9,0,39,5,15,.333,2,3,.667,3,12,.250,0,0,,2,2,4,0,0,0,3,4,13,0.2
10896,Marcus White\marcus-white-4,2014-15,Illinois-Chicago,G,15,1,68,4,12,.333,2,6,.333,2,6,.333,3,7,.429,1,5,6,5,4,0,1,0,13,0.9
10897,Auraum Nuiriankh\auraum-nuiriankh-1,2013-14,Buffalo,G,21,1,116,3,14,.214,1,5,.200,2,9,.222,5,8,.625,5,16,21,3,2,2,5,26,13,0.1
10898,Robert Knar\robert-knar-1,2015-16,Northern Iowa,G,13,0,36,4,14,.286,2,4,.500,2,10,.200,3,4,.750,0,7,7,0,0,0,0,2,13,0.4
10899,John Hubler\john-hubler-1,2015-16,IUPUI,G,13,0,65,4,14,.286,0,3,.000,4,11,.364,1,3,.333,0,3,3,0,1,2,4,6,13,0.1
10900,Jairus Lyles\jairus-lyles-1,2013-14,Virginia Commonwealth,G,22,0,58,2,20,.100,1,12,.083,1,8,.125,8,12,.667,1,4,5,5,5,0,4,9,13,0.0
10901,Jordan McRae\jordan-mcrae-2,2017-18,Binghamton,G,7,1,30,6,9,.667,6,9,.667,0,0,,1,1,1.000,0,3,3,0,2,1,1,2,13,1.6
10902,Brenden Glapion\brenden-glapion-1,2014-15,University of California,G,10,0,19,3,6,.500,3,6,.500,0,0,,7,9,.778,1,0,1,1,0,0,0,3,13,0.9
10903,Tommy McCarthy\tommy-mccarthy-1,2016-17,Harvard,G,18,0,105,4,22,.182,1,6,.167,3,16,.188,1,2,.500,0,11,11,10,3,0,10,21,12,-0.4
10904,Jake Pemberton\jake-pemberton-1,2014-15,Denver,G,17,0,126,5,21,.238,3,10,.300,2,11,.182,0,0,,2,8,10,8,2,0,5,19,12,-0.1
10905,Tim Cameron\tim-cameron-1,2016-17,Texas-El Paso,G,8,0,29,3,10,.300,2,7,.286,1,3,.333,5,7,.714,3,5,8,1,0,0,2,4,12,0.8
10906,TeMarcus Blanton\temarcus-blanton-1,2015-16,South Carolina,G,8,0,32,3,8,.375,1,4,.250,2,4,.500,4,4,1.000,2,3,5,2,2,0,1,4,12,1.3
10907,Terrell Hales\terrell-hales-1,2016-17,Cleveland State,G,25,1,222,4,11,.364,3,8,.375,1,3,.333,3,4,.750,18,25,43,18,21,3,14,24,12,1.5
10908,Nick Cunningham\nick-cunningham-1,2015-16,Siena,G,10,0,15,1,2,.500,1,2,.500,0,0,,10,12,.833,1,0,1,2,1,0,2,2,12,1.1
10909,Aaron Washington\aaron-washington-3,2016-17,Citadel,G,4,0,20,4,9,.444,2,5,.400,2,4,.500,2,4,.500,0,3,3,2,2,0,1,4,12,2.1
10910,Jordan Coblin\jordan-coblin-1,2017-18,Purdue-Fort Wayne,G,7,0,25,4,7,.571,3,5,.600,1,2,.500,3,3,1.000,0,2,2,2,1,0,2,6,12,1.0
10911,Arturs Bremers\arturs-bremers-1,2015-16,North Carolina A&T,G,22,1,118,4,22,.182,0,1,.000,4,21,.190,0,0,,3,11,14,6,0,0,4,12,12,0.0
10912,Cayne Edwards\cayne-edwards-1,2015-16,Army,G,9,0,47,3,7,.429,2,3,.667,1,4,.250,5,8,.625,3,14,17,3,2,1,5,5,12,1.2
10913,Adam Glenville\adam-glenville-1,2015-16,Oral Roberts,G,4,0,22,4,9,.444,2,4,.500,2,5,.400,2,2,1.000,1,4,5,3,0,0,2,0,12,2.3
10914,Lance Richard\lance-richard-1,2015-16,Louisiana-Monroe,G,12,0,33,4,12,.333,0,0,,4,12,.333,0,0,,0,0,0,1,2,0,3,2,12,0.3
10915,Chris Teahan\chris-teahan-1,2017-18,Kansas,G,11,0,25,4,11,.364,2,3,.667,2,8,.250,2,2,1.000,2,5,7,1,0,0,3,2,12,0.5
10916,Kevin Kerley\kevin-kerley-1,2017-18,Appalachian State,G,6,0,20,3,4,.750,0,1,.000,3,3,1.000,3,6,.500,0,0,0,5,1,0,2,2,12,1.8
10917,Taj Owens\taj-owens-1,2013-14,Radford,G,14,0,59,3,13,.231,3,11,.273,0,2,.000,6,8,.750,4,5,9,7,1,2,2,13,12,0.6
10918,Pat Branin\pat-branin-1,2014-15,College of Charleston,G,22,1,102,4,14,.286,1,2,.500,3,12,.250,1,2,.500,0,6,6,5,1,0,4,15,12,0.0
10919,Jordan Forehand\jordan-forehand-1,2017-18,Saint Francis (PA),G,8,0,24,3,7,.429,2,5,.400,1,2,.500,5,10,.500,2,2,4,3,2,0,1,2,12,1.3
10920,Blake Williams\blake-williams-2,2013-14,Fresno State,G,13,0,30,5,9,.556,3,3,1.000,2,6,.333,0,2,.000,2,6,8,1,0,0,3,1,12,0.6
10921,Trevor Dunbar\trevor-dunbar-1,2014-15,Washington State,G,16,0,157,5,22,.227,3,16,.188,2,6,.333,0,2,.000,1,6,7,24,4,0,17,12,12,0.0
10922,Nicholas Barnes\nicholas-barnes-1,2015-16,Alabama State,G,8,0,57,4,13,.308,0,2,.000,4,11,.364,0,2,.000,2,0,2,0,1,0,3,6,12,0.1
10923,Janeau Joubert\janeau-joubert-1,2016-17,Central Michigan,G,12,0,31,3,12,.250,3,9,.333,0,3,.000,6,8,.750,2,3,5,2,2,0,0,2,12,0.7
10924,Marley Biyendolo\marley-biyendolo-1,2014-15,Pepperdine,G,21,0,102,5,14,.357,4,11,.364,1,3,.333,1,4,.250,1,5,6,9,5,1,12,13,12,0.0
10925,Ali Farhat\ali-farhat-1,2013-14,Eastern Michigan,G,12,0,29,5,17,.294,4,10,.400,1,7,.143,1,2,.500,2,4,6,2,3,1,0,3,12,0.7
10926,Dion Watson\dion-watson-1,2013-14,Grambling,G,14,3,46,4,23,.174,3,11,.273,1,12,.083,3,4,.750,4,2,6,1,2,0,1,4,12,0.0
10927,Kevon Tucker\kevon-tucker-1,2016-17,Wofford,G,15,0,80,3,17,.176,2,9,.222,1,8,.125,5,6,.833,0,5,5,6,7,0,5,7,12,0.4
10928,Alex Dragicevich\alex-dragicevich-1,2014-15,Boston College,G,18,1,91,4,10,.400,0,2,.000,4,8,.500,0,0,,2,7,9,3,2,2,3,6,12,0.6
10929,Dillon Reppart\dillon-reppart-1,2016-17,East Tennessee State,G,8,0,14,3,5,.600,1,2,.500,2,3,.667,4,6,.667,1,1,2,1,1,0,1,0,12,1.3
10930,Curtis McRoy\curtis-mcroy-1,2015-16,Delaware,G,27,3,166,4,18,.222,0,1,.000,4,17,.235,0,0,,0,16,16,6,4,0,6,23,12,0.0
10931,Quinton Adlesh\quinton-adlesh-1,2015-16,Columbia,G,4,0,15,4,7,.571,2,2,1.000,2,5,.400,2,3,.667,1,4,5,3,0,0,0,0,12,3.1
10932,Evan Moorman\evan-moorman-1,2016-17,Little Rock,G,5,0,19,4,9,.444,0,0,,4,9,.444,0,0,,0,2,2,1,1,0,0,1,12,1.8
10933,Venjie Wallis\venjie-wallis-1,2016-17,New Orleans,G,5,0,17,4,6,.667,3,4,.750,1,2,.500,3,4,.750,0,3,3,2,3,0,1,2,12,2.5
10934,Stephen Toyra\stephen-toyra-1,2013-14,Purdue,G,8,0,30,4,12,.333,4,8,.500,0,4,.000,4,4,1.000,2,1,3,0,2,0,3,5,12,0.5
10935,Daniel Norl\daniel-norl-1,2014-15,Eastern Kentucky,G,11,0,74,5,17,.294,5,12,.417,0,5,.000,2,2,1.000,3,3,6,8,3,0,3,8,12,0.7
10936,Elias Harden\elias-harden-1,2017-18,Xavier,G,18,0,101,4,17,.235,3,9,.333,1,8,.125,3,4,.750,0,3,3,7,2,0,6,8,12,0.0
10937,Jacob Guest\jacob-guest-1,2016-17,Northwestern State,G,11,0,39,4,10,.400,3,3,1.000,1,7,.143,3,4,.750,1,5,6,1,2,0,4,0,12,0.6
10938,Jamison Glover\jamison-glover-1,2015-16,William & Mary,G,9,0,19,5,9,.556,3,6,.500,2,3,.667,0,2,.000,0,1,1,1,0,0,1,2,12,0.7
10939,Eugene Marshall III\eugene-marshalliii-1,2017-18,Hampton,G,9,0,35,4,14,.286,3,4,.750,1,10,.100,3,4,.750,1,5,6,3,1,0,1,6,12,0.6
10940,A.C. Reid\ac-reid-1,2017-18,Tennessee State,G,10,1,102,4,28,.143,0,0,,4,28,.143,0,0,,0,7,7,4,2,1,3,7,12,-0.4
10941,Shawn Christian Jr.\shawn-christianjr-1,2017-18,Cleveland State,G,11,0,45,4,18,.222,0,3,.000,4,15,.267,0,0,,1,2,3,1,1,0,0,4,12,0.2
10942,Burton Sampson\burton-sampson-1,2015-16,Belmont,G,14,0,102,4,6,.667,2,3,.667,2,3,.667,2,4,.500,1,2,3,6,7,0,7,11,12,0.7
10943,Cameron Reed\cameron-reed-1,2016-17,New Orleans,G,15,1,69,3,17,.176,1,4,.250,2,13,.154,4,6,.667,2,3,5,3,0,1,8,14,12,-0.5
10944,Nick Parker\nick-parker-1,2016-17,Campbell,G,7,0,16,5,9,.556,3,5,.600,2,4,.500,0,0,,2,1,3,4,2,0,1,5,12,1.6
10945,Maurice O'Field\maurice-ofield-1,2015-16,Arizona State,G,23,0,148,5,21,.238,4,12,.333,1,9,.111,1,2,.500,5,13,18,4,1,1,7,14,12,-0.1
10946,Tanner Plemmons\tanner-plemmons-1,2013-14,Stetson,G,8,0,25,4,9,.444,0,0,,4,9,.444,0,0,,1,1,2,0,0,0,2,3,12,0.6
10947,Mychal Mulder\mychal-mulder-1,2015-16,Kentucky,G,24,0,90,4,20,.200,2,8,.250,2,12,.167,2,2,1.000,9,18,27,8,1,0,2,6,12,0.6
10948,Chase Connor\chase-connor-1,2013-14,West Virginia,G,12,0,52,4,13,.308,0,1,.000,4,12,.333,0,0,,0,4,4,4,1,0,1,6,12,0.5
10949,Kellen Blake\kellen-blake-1,2016-17,Winthrop,G,12,0,25,5,11,.455,4,8,.500,1,3,.333,1,2,.500,4,2,6,4,0,0,1,1,12,0.9
10950,Jordan Faciane\jordan-faciane-1,2014-15,Campbell,G,5,0,24,4,10,.400,3,3,1.000,1,7,.143,3,3,1.000,1,9,10,4,0,0,2,2,12,2.0
10951,Dalton Soffer\dalton-soffer-1,2015-16,Seton Hall,G,14,0,25,4,9,.444,0,0,,4,9,.444,0,0,,0,3,3,1,1,0,0,2,12,0.7
10952,Reed Farley\reed-farley-1,2017-18,Harvard,G,10,2,101,4,24,.167,0,4,.000,4,20,.200,0,0,,8,5,13,4,4,0,4,11,12,0.2
10953,Destin Barnes\destin-barnes-1,2017-18,Boston University,G,2,0,33,4,15,.267,2,6,.333,2,9,.222,2,2,1.000,2,6,8,3,0,0,0,4,12,3.4
10954,Jay Green\jay-green-2,2017-18,Nevada-Las Vegas,G,15,0,62,5,14,.357,4,9,.444,1,5,.200,1,2,.500,3,1,4,3,1,0,5,12,12,0.0
10955,Patrick Wallace\patrick-wallace-1,2013-14,North Carolina State,G,6,0,14,4,9,.444,0,0,,4,9,.444,0,0,,0,1,1,1,0,0,0,3,12,1.2
10956,Andrew Riley\andrew-riley-1,2017-18,Arkansas State,G,7,2,18,5,11,.455,3,6,.500,2,5,.400,0,0,,2,1,3,2,0,0,0,2,12,1.2
10957,Daniel Nyman\daniel-nyman-1,2017-18,Utah Valley,G,13,0,51,3,9,.333,1,3,.333,2,6,.333,4,4,1.000,0,4,4,2,2,0,2,1,12,0.7
10958,Kevin Shaw\kevin-shaw-1,2013-14,Georgia State,G,11,0,25,4,10,.400,0,0,,4,10,.400,0,0,,0,1,1,1,0,0,1,0,12,0.6
10959,Derrell Joubert\derrell-joubert-1,2014-15,McNeese State,G,8,0,17,4,9,.444,0,1,.000,4,8,.500,0,0,,0,3,3,0,0,0,0,2,12,0.9
10960,Deon Baker\dion-baker-1,2016-17,Saint Francis (PA),G,8,0,19,5,9,.556,5,9,.556,0,0,,2,2,1.000,0,3,3,1,2,0,1,0,12,1.3
10961,Christian Juzang\christian-juzang-1,2016-17,Harvard,G,12,0,92,4,22,.182,3,6,.500,1,16,.063,3,4,.750,1,10,11,7,2,1,5,10,12,0.0
10962,Phillip Johnson\phillip-johnson-2,2016-17,Incarnate Word,G,22,0,92,4,9,.444,3,4,.750,1,5,.200,3,5,.600,1,12,13,2,3,1,11,10,12,0.0
10963,Ryan Pearson\ryan-pearson-2,2015-16,Navy,G,14,0,49,4,14,.286,1,2,.500,3,12,.250,1,3,.333,2,1,3,0,1,1,5,6,12,-0.1
10964,Antanee Pinkard\antanee-pinkard-1,2017-18,James Madison,G,9,0,62,4,13,.308,4,12,.333,0,1,.000,4,11,.364,5,5,10,3,1,0,5,9,12,0.1
10965,Joe Hanstad\joe-hanstad-1,2013-14,Boise State,G,15,0,84,2,7,.286,1,3,.333,1,4,.250,7,8,.875,0,6,6,4,1,0,2,7,12,0.6
10966,Kobie Eubanks\kobie-eubanks-1,2015-16,Texas A&M,G,8,0,36,4,12,.333,0,1,.000,4,11,.364,0,0,,2,8,10,3,3,0,1,2,12,1.5
10967,John Schurman\john-schurman-1,2017-18,Binghamton,G,9,1,61,4,17,.235,1,4,.250,3,13,.231,1,2,.500,3,9,12,3,2,0,1,3,12,0.9
10968,Brandon Boyd\brandon-boyd-1,2015-16,Idaho State,G,5,0,32,3,10,.300,1,6,.167,2,4,.500,4,5,.800,1,3,4,3,3,0,2,9,12,1.4
10969,Dusan Majstorovic\dusan-majstorovic-1,2015-16,La Salle,G,15,0,85,4,15,.267,2,2,1.000,2,13,.154,2,2,1.000,1,12,13,4,1,2,3,8,12,0.4
10970,Myles Davis\myles-davis-2,2014-15,Central Florida,G,18,1,73,5,10,.500,3,4,.750,2,6,.333,0,1,.000,0,6,6,4,4,3,4,16,12,0.4
10971,Kellen Blake\kellen-blake-1,2015-16,Winthrop,G,9,0,21,5,8,.625,3,4,.750,2,4,.500,0,1,.000,1,0,1,0,1,0,1,1,12,0.9
10972,Keondre Dew\keondre-dew-1,2016-17,Oregon State,G,6,0,70,5,19,.263,5,19,.263,0,0,,2,6,.333,6,13,19,4,3,1,12,11,12,-0.5
10973,Jeff Martin\jeff-martin-2,2014-15,Murray State,G,10,0,24,3,12,.250,1,5,.200,2,7,.286,4,6,.667,0,3,3,1,1,0,0,1,12,0.6
10974,Ted Bancroft\ted-bancroft-1,2013-14,Providence,G,30,0,158,4,13,.308,3,4,.750,1,9,.111,3,8,.375,4,16,20,3,9,0,3,24,12,0.3
10975,Nick Hough\nick-hough-1,2017-18,Appalachian State,G,6,0,21,5,8,.625,3,4,.750,2,4,.500,0,0,,2,3,5,1,3,0,3,2,12,1.8
10976,Isaiah Washington\isaiah-washington-1,2016-17,Penn State,G,17,0,85,3,14,.214,0,2,.000,3,12,.250,3,4,.750,0,5,5,2,1,0,5,12,12,-0.2
10977,De'Vaughn Reid\devaughn-reid-1,2014-15,Holy Cross,G,16,0,109,4,20,.200,4,16,.250,0,4,.000,4,5,.800,1,10,11,10,1,0,11,5,12,-0.1
10978,Camron Justice\camron-justice-1,2016-17,Vanderbilt,G,7,0,65,4,16,.250,3,8,.375,1,8,.125,3,6,.500,0,6,6,7,3,0,4,5,12,0.7
10979,Philip Flory\philip-flory-1,2017-18,Seton Hall,G,23,0,57,2,10,.200,0,4,.000,2,6,.333,6,6,1.000,0,6,6,2,0,1,3,5,12,0.2
10980,Geno West\geno-west-1,2017-18,Idaho,G,10,0,44,3,12,.250,2,5,.400,1,7,.143,5,6,.833,2,2,4,5,0,0,1,6,12,0.7
10981,Elijah Lee\elijah-lee-1,2017-18,Pepperdine,G,11,0,83,4,11,.364,1,6,.167,3,5,.600,1,6,.167,0,8,8,4,3,0,8,6,12,0.2
10982,Josh Pierre\josh-pierre-1,2013-14,Arkansas State,G,8,0,21,3,10,.300,1,1,1.000,2,9,.222,4,6,.667,1,2,3,0,2,0,1,0,12,1.0
10983,Stefan Zecevic\stefan-zecevic-1,2013-14,Bradley,G,22,0,78,5,12,.417,5,11,.455,0,1,.000,2,10,.200,4,10,14,2,0,4,8,8,12,0.1
10984,Ryan Hiepler\ryan-hiepler-1,2016-17,Liberty,G,17,0,62,4,9,.444,1,2,.500,3,7,.429,0,0,,1,5,6,5,2,0,2,9,11,0.5
10985,James West IV\james-westiv-1,2017-18,Mount St. Mary's,G,9,0,48,3,9,.333,0,2,.000,3,7,.429,2,2,1.000,1,3,4,3,2,1,4,5,11,0.7
10986,Kendal Shell\kendal-shell-1,2014-15,Minnesota,G,14,1,45,4,10,.400,2,5,.400,2,5,.400,1,2,.500,0,3,3,5,1,0,2,2,11,0.6
10987,Keon Burns\keon-burns-1,2014-15,New Hampshire,G,7,0,14,3,5,.600,1,2,.500,2,3,.667,3,4,.750,0,1,1,0,0,0,2,2,11,0.8
10988,Maxx Bleecher\maxx-bleecher-1,2016-17,Florida Gulf Coast,G,6,0,14,5,6,.833,4,5,.800,1,1,1.000,0,0,,1,9,10,1,1,0,1,2,11,2.0
10989,Kevin Harden\kevin-harden-1,2014-15,Purdue-Fort Wayne,G,7,0,50,3,13,.231,0,1,.000,3,12,.250,2,2,1.000,2,5,7,3,2,0,1,0,11,1.3
10990,Chris Lewis\chris-lewis-3,2013-14,Delaware State,G,5,0,28,3,5,.600,1,2,.500,2,3,.667,3,5,.600,0,0,0,4,2,0,3,3,11,1.7
10991,Mike La Tulip\mike-latulip-1,2013-14,Illinois,G,12,0,44,3,9,.333,0,0,,3,9,.333,2,4,.500,0,3,3,2,1,0,1,7,11,0.4
10992,James Stokes\james-stokes-1,2017-18,Alcorn State,G,12,0,53,5,13,.385,5,13,.385,0,0,,1,5,.200,1,8,9,2,5,1,1,7,11,0.7
10993,Alec Wulff\alec-wulff-1,2017-18,UCLA,G,10,0,24,3,6,.500,0,1,.000,3,5,.600,2,2,1.000,0,0,0,2,1,0,1,1,11,0.9
10994,LeSean Brown\lesean-brown-1,2016-17,Air Force,G,13,0,51,4,8,.500,3,6,.500,1,2,.500,2,7,.286,1,10,11,4,2,0,1,2,11,0.9
10995,Imani Miller\imani-miller-1,2016-17,Hampton,G,18,4,161,3,8,.375,2,7,.286,1,1,1.000,4,8,.500,3,9,12,16,5,0,10,15,11,0.6
10996,Blake McDonald\blake-mcdonald-1,2013-14,Texas A&M,G,21,1,132,3,9,.333,1,6,.167,2,3,.667,3,4,.750,1,6,7,15,3,0,6,13,11,0.5
10997,Max Keenan\max-keenan-1,2013-14,Tulane,G,17,1,52,2,6,.333,0,2,.000,2,4,.500,5,8,.625,0,4,4,0,1,0,5,4,11,0.1
10998,Kadeem Smithen\kadeem-smithen-1,2014-15,Richmond,G,23,0,82,4,13,.308,2,6,.333,2,7,.286,1,3,.333,1,7,8,5,3,0,1,11,11,0.3
10999,Bitumba Baruti\bitumba-baruti-1,2016-17,Washington,G,17,0,71,4,14,.286,4,8,.500,0,6,.000,3,3,1.000,4,3,7,2,2,0,5,12,11,0.0
11000,Leo Svete\leo-svete-1,2015-16,IUPUI,G,6,0,41,4,13,.308,1,3,.333,3,10,.300,0,1,.000,1,4,5,0,0,0,0,4,11,0.6
11001,Joshua Doss\joshua-doss-1,2016-17,South Dakota,G,7,0,39,4,6,.667,3,5,.600,1,1,1.000,2,4,.500,3,3,6,1,0,1,1,1,11,1.5
11002,Riley Court\riley-court-1,2017-18,Weber State,G,12,0,61,5,14,.357,4,8,.500,1,6,.167,0,1,.000,1,10,11,8,2,0,4,10,11,0.5
11003,Evan Anderson\evan-anderson-2,2015-16,Houston Baptist,G,7,0,21,3,6,.500,2,4,.500,1,2,.500,4,6,.667,2,4,6,3,0,1,4,2,11,1.1
11004,Josh Burnett\josh-burnett-1,2016-17,Kennesaw State,G,11,0,103,5,22,.227,5,18,.278,0,4,.000,1,2,.500,3,16,19,7,5,1,9,9,11,0.2
11005,Harrison Niego\harrison-niego-1,2015-16,Indiana,G,23,0,110,4,13,.308,2,5,.400,2,8,.250,1,3,.333,5,10,15,6,7,0,4,17,11,0.4
11006,Aaron Siler\aaron-siler-1,2013-14,Eastern Illinois,G,11,0,40,3,9,.333,0,2,.000,3,7,.429,2,3,.667,0,2,2,3,2,0,2,3,11,0.6
11007,Anson Moye\anson-moye-1,2016-17,Cal State Long Beach,G,29,6,170,4,16,.250,2,6,.333,2,10,.200,1,4,.250,2,12,14,9,5,1,5,19,11,0.2
11008,Nino Jackson\nino-jackson-1,2013-14,Loyola Marymount,G,4,0,41,4,18,.222,3,11,.273,1,7,.143,2,3,.667,1,7,8,4,4,1,3,8,11,0.9
11009,Jamelle Christian\jamelle-christian-1,2016-17,Delaware State,G,11,0,81,4,14,.286,3,7,.429,1,7,.143,2,7,.286,4,8,12,12,4,0,6,7,11,0.9
11010,Connor Van Brocklin\connor-van-brocklin-1,2013-14,Utah,G,7,0,17,3,5,.600,0,1,.000,3,4,.750,2,2,1.000,0,1,1,1,1,0,0,4,11,1.3
11011,Zach Yoshor\zach-yoshor-1,2014-15,Harvard,G,9,0,17,4,8,.500,1,4,.250,3,4,.750,0,0,,1,3,4,0,0,0,1,2,11,0.8
11012,Tanner Johnson\tanner-johnson-1,2016-17,Bryant,G,8,0,23,4,15,.267,1,2,.500,3,13,.231,0,0,,1,3,4,0,0,0,0,2,11,0.4
11013,Tommy Matthews\tommy-matthews-1,2015-16,Eastern Kentucky,G,23,1,36,4,11,.364,1,5,.200,3,6,.500,0,1,.000,5,8,13,3,1,0,2,11,11,0.3
11014,Dominic Ezeani\dominic-ezeani-1,2017-18,Longwood,G,21,0,53,4,8,.500,4,7,.571,0,1,.000,3,9,.333,0,5,5,5,4,0,3,4,11,0.4
11015,Shaun Kirk\shaun-kirk-1,2017-18,North Carolina State,G,5,0,55,5,15,.333,5,12,.417,0,3,.000,1,2,.500,4,10,14,3,2,1,2,6,11,1.7
11016,Keith Benford\keith-benford-1,2013-14,Texas-San Antonio,G,5,0,11,4,6,.667,1,2,.500,3,4,.750,0,0,,1,1,2,0,0,0,0,1,11,1.8
11017,Ashley Williams\ashley-williams-1,2014-15,Western Carolina,G,16,0,68,4,11,.364,2,5,.400,2,6,.333,1,2,.500,3,4,7,2,4,1,2,8,11,0.5
11018,Chauncey Orr\chauncey-orr-1,2014-15,Bowling Green State,G,5,4,57,5,12,.417,4,7,.571,1,5,.200,0,1,.000,5,4,9,3,1,1,2,2,11,2.0
11019,Phillip McGloin\phillip-mcgloin-1,2015-16,Vanderbilt,G,10,0,18,3,9,.333,1,3,.333,2,6,.333,3,4,.750,0,4,4,0,0,0,0,2,11,0.6
11020,Christian Willis\christian-willis-1,2016-17,Arkansas State,G,10,0,43,4,10,.400,2,4,.500,2,6,.333,1,3,.333,1,4,5,2,1,0,7,7,11,-0.1
11021,D.J. Heath\dj-heath-1,2017-18,Canisius,G,20,0,104,4,17,.235,3,7,.429,1,10,.100,2,5,.400,2,6,8,4,2,0,6,13,11,-0.2
11022,Shane Rector\shane-rector-1,2013-14,Missouri,G,24,0,105,0,10,.000,0,8,.000,0,2,.000,11,15,.733,5,8,13,3,3,0,10,17,11,-0.1
11023,Danny Cohen\danny-cohen-1,2016-17,New Orleans,G,11,0,33,4,8,.500,3,4,.750,1,4,.250,2,2,1.000,1,7,8,1,1,1,8,3,11,0.3
11024,Matthew Jiles\matthew-jiles-1,2015-16,New Orleans,G,18,0,73,4,14,.286,3,7,.429,1,7,.143,2,2,1.000,7,8,15,3,6,0,6,11,11,0.4
11025,Robert Mischler\robert-mischler-1,2013-14,Cornell,G,19,0,62,4,10,.400,1,1,1.000,3,9,.333,0,0,,2,2,4,2,1,0,3,5,11,0.3
11026,Jeremiah Taylor\jeremiah-taylor-1,2017-18,Louisiana Tech,G,8,0,26,4,12,.333,1,3,.333,3,9,.333,0,0,,0,5,5,2,0,0,1,2,11,0.7
11027,DeMarcus Threatt\demarcus-threatt-1,2014-15,Fairfield,G,4,0,21,3,5,.600,2,4,.500,1,1,1.000,4,7,.571,1,0,1,3,0,0,1,2,11,2.1
11028,Myles Tate\myles-tate-1,2014-15,George Mason,G,13,0,72,4,13,.308,1,6,.167,3,7,.429,0,0,,6,8,14,6,3,0,6,16,11,0.4
11029,Riley Dearring\riley-dearring-1,2014-15,Wisconsin,G,15,0,39,4,10,.400,1,3,.333,3,7,.429,0,1,.000,0,4,4,1,1,0,6,5,11,0.0
11030,Matt Hancock\matt-hancock-1,2014-15,Lamar,G,12,0,55,5,10,.500,4,4,1.000,1,6,.167,0,0,,2,4,6,5,0,0,2,6,11,0.6
11031,Teo Davidian\teo-davidian-1,2017-18,UC-Irvine,G,10,1,16,3,12,.250,2,9,.222,1,3,.333,4,6,.667,3,2,5,3,1,0,1,1,11,0.7
11032,Cannon Broussard\cannon-broussard-1,2017-18,Lamar,G,5,0,15,3,9,.333,0,3,.000,3,6,.500,2,2,1.000,0,0,0,0,1,0,1,1,11,1.1
11033,Collin Huun\collin-huun-1,2017-18,Seattle,G,6,0,14,4,7,.571,1,1,1.000,3,6,.500,0,2,.000,0,3,3,0,0,1,1,0,11,1.3
11034,Khalid McCaskill\khalid-mccaskill-1,2014-15,Lehigh,G,7,1,38,5,13,.385,4,9,.444,1,4,.250,0,1,.000,1,7,8,1,1,1,3,6,11,0.5
11035,Des Curry\des-curry-1,2017-18,Jacksonville State,G,17,1,58,5,15,.333,5,11,.455,0,4,.000,1,2,.500,0,1,1,2,1,0,2,2,11,0.1
11036,Michael Schlotman\michael-schlotman-1,2015-16,William & Mary,G,18,0,130,3,13,.231,2,9,.222,1,4,.250,4,8,.500,3,14,17,17,3,2,9,17,11,0.5
11037,Kortrijk Miles\kortrijk-miles-1,2017-18,New Mexico State,G,14,0,32,4,5,.800,4,4,1.000,0,1,.000,3,5,.600,2,5,7,2,0,0,4,7,11,0.4
11038,Terrance LeFlore\terrance-leflore-1,2014-15,Alabama State,G,5,0,46,4,11,.364,3,8,.375,1,3,.333,2,2,1.000,2,2,4,7,1,1,4,8,11,1.3
11039,Baryn Houston\baryn-houston-1,2015-16,Alabama A&M,G,14,0,78,4,14,.286,1,6,.167,3,8,.375,0,1,.000,1,9,10,4,3,0,3,8,11,0.4
11040,Kyle Massie\kyle-massie-1,2015-16,Texas-San Antonio,G,8,0,26,4,8,.500,2,2,1.000,2,6,.333,1,2,.500,1,1,2,2,0,0,1,4,11,0.8
11041,Sean Lloyd\sean-lloyd-1,2015-16,Southern Illinois,G,13,0,38,3,10,.300,2,8,.250,1,2,.500,4,8,.500,4,5,9,1,2,1,2,4,11,0.6
11042,Danny Rubin\danny-rubin-1,2013-14,Boston College,G,16,1,52,3,13,.231,0,3,.000,3,10,.300,2,2,1.000,3,1,4,1,0,0,0,8,11,0.2
11043,Ryan Burnett\ryan-burnett-1,2013-14,Stony Brook,G,14,0,51,4,15,.267,1,7,.143,3,8,.375,0,0,,1,2,3,0,0,0,0,9,11,0.0
11044,Corey Mendez\corey-mendez-1,2014-15,Stetson,G,9,0,82,3,18,.167,0,3,.000,3,15,.200,2,2,1.000,0,5,5,6,0,1,8,10,11,-0.7
11045,Drew Absher\drew-absher-1,2013-14,Virginia Military Institute,G,8,1,57,3,11,.273,1,4,.250,2,7,.286,3,5,.600,0,5,5,11,0,0,6,5,11,0.6
11046,Jacob Broussard\jacob-broussard-1,2016-17,Louisiana,G,10,0,30,4,11,.364,1,2,.500,3,9,.333,0,0,,1,1,2,0,1,0,1,2,11,0.5
11047,Evans Ganapamo\evans-ganapamo-1,2013-14,New Orleans,G,12,0,37,3,13,.231,2,7,.286,1,6,.167,4,7,.571,2,4,6,0,1,0,6,3,11,-0.1
11048,Jiday Ugbaja\jidbay-ugbaja-1,2017-18,Sacramento State,G,6,0,48,5,12,.417,4,11,.364,1,1,1.000,0,0,,1,8,9,11,2,0,5,8,11,1.5
11049,Grant Troutt\grant-troutt-1,2015-16,UC-Santa Barbara,G,11,0,46,4,12,.333,1,3,.333,3,9,.333,0,0,,2,0,2,4,2,0,3,2,11,0.6
11050,Zach Hopewell\zach-hopewell-1,2017-18,Murray State,G,13,0,27,3,9,.333,1,4,.250,2,5,.400,3,9,.333,1,1,2,4,0,0,2,4,11,0.3
11051,Zach Buscher\zach-buscher-1,2017-18,Hawaii,G,10,0,16,3,6,.500,3,4,.750,0,2,.000,5,6,.833,1,4,5,0,1,0,6,1,11,0.4
11052,Khristian Taylor\khristian-taylor-1,2014-15,Tennessee-Martin,G,16,0,43,4,8,.500,2,4,.500,2,4,.500,1,2,.500,1,13,14,3,1,0,1,2,11,0.8
11053,Ben Mammel\ben-mammel-1,2016-17,Army,G,2,0,10,4,7,.571,1,2,.500,3,5,.600,0,0,,1,2,3,1,1,0,2,1,11,4.2
11054,Ashtyn Bradley\ashtyn-bradley-1,2017-18,Long Island University,G,9,0,26,3,15,.200,0,0,,3,15,.200,2,2,1.000,0,4,4,0,1,0,0,1,11,0.4
11055,Jake McDowell\jake-mcdowell-1,2016-17,Memphis,G,15,1,108,5,12,.417,5,11,.455,0,1,.000,1,3,.333,11,8,19,2,5,1,1,12,11,1.0
11056,Zach Farquhar\zach-farquhar-1,2016-17,Liberty,G,16,0,28,3,5,.600,1,1,1.000,2,4,.500,3,4,.750,0,3,3,1,1,0,0,1,11,0.7
11057,Travis Trim\travis-trim-1,2013-14,Maryland-Eastern Shore,G,19,0,84,3,8,.375,2,7,.286,1,1,1.000,4,8,.500,3,12,15,13,6,0,7,13,11,0.7
11058,Jake Killingsworth\jake-killingsworth-1,2017-18,Columbia,G,2,0,13,4,6,.667,1,1,1.000,3,5,.600,0,0,,2,2,4,0,0,0,2,3,11,3.6
11059,Kellen Blake\kellen-blake-1,2014-15,Winthrop,G,8,0,14,3,6,.500,2,3,.667,1,3,.333,4,5,.800,1,1,2,0,2,0,0,0,11,1.3
11060,Jakolby Long\jakolby-long-1,2016-17,Iowa State,G,8,0,40,4,17,.235,1,11,.091,3,6,.500,0,1,.000,3,7,10,1,1,0,1,1,11,0.6
11061,Mario Soto\mario-soto-1,2016-17,Eastern Washington,G,20,0,78,3,18,.167,0,3,.000,3,15,.200,2,2,1.000,0,5,5,6,2,0,2,11,11,0.0
11062,Tyler Jones\tyler-jones-56,2017-18,Fairleigh Dickinson,G,18,0,83,3,19,.158,1,4,.250,2,15,.133,3,4,.750,2,3,5,3,5,0,1,13,11,0.1
11063,Stetson Moore\stetson-moore-1,2015-16,East Tennessee State,G,10,0,36,4,12,.333,1,2,.500,3,10,.300,0,0,,1,1,2,2,2,0,0,7,11,0.6
11064,Devon Pekas\devon-pekas-2,2016-17,North Dakota,G,11,0,39,3,7,.429,0,0,,3,7,.429,2,4,.500,1,7,8,3,1,1,2,6,11,0.8
11065,Aaron O'Neill\aaron-oneill-1,2014-15,Furman,G,15,1,85,4,9,.444,2,2,1.000,2,7,.286,1,2,.500,0,5,5,0,4,0,1,12,11,0.4
11066,Michael Volovic\michael-volovic-1,2013-14,Butler,G,4,0,10,4,6,.667,3,3,1.000,1,3,.333,2,3,.667,0,2,2,1,0,0,0,1,11,2.2
11067,DeVantae Price\devantae-price-1,2016-17,Eastern Illinois,G,7,0,26,4,8,.500,4,8,.500,0,0,,3,9,.333,3,8,11,2,2,1,3,6,11,1.1
11068,Ryan Maas\ryan-maas-1,2017-18,Western Illinois,G,6,0,39,4,11,.364,1,3,.333,3,8,.375,0,0,,1,3,4,1,0,0,2,2,11,0.7
11069,Drew Davis\drew-davis-2,2016-17,Mississippi State,G,6,0,12,4,8,.500,1,4,.250,3,4,.750,0,0,,1,0,1,2,1,0,2,0,11,1.4
11070,Devin Newsome\devin-newsome-1,2014-15,Omaha,G,27,2,173,4,19,.211,2,9,.222,2,10,.200,1,5,.200,4,9,13,16,6,0,5,13,11,0.4
11071,Shamiek Sheppard\shamiek-sheppard-1,2014-15,South Carolina,G,7,0,48,5,18,.278,4,17,.235,1,1,1.000,0,2,.000,6,3,9,1,5,4,2,6,11,1.3
11072,Ron Mvouika\ron-mvouika-1,2014-15,Missouri State,G,2,0,20,4,9,.444,3,6,.500,1,3,.333,2,4,.500,0,4,4,1,2,0,3,0,11,3.2
11073,Matt Chastain\matt-chastain-1,2016-17,Loyola (IL),G,3,0,38,5,9,.556,4,6,.667,1,3,.333,0,2,.000,3,6,9,0,1,2,3,3,11,2.7
11074,Khyan Rayner\khyan-rayner-1,2014-15,Princeton,G,18,0,60,3,9,.333,2,2,1.000,1,7,.143,4,10,.400,0,3,3,3,3,0,4,10,11,0.1
11075,Thomas Blake\thomas-blake-1,2016-17,North Dakota,G,14,0,39,4,13,.308,3,4,.750,1,9,.111,2,2,1.000,4,10,14,5,3,0,3,2,11,0.9
11076,Jaekwon Carliyle\jaekwon-carliyle-1,2017-18,Hampton,G,5,2,66,2,19,.105,2,11,.182,0,8,.000,7,10,.700,2,7,9,9,6,0,9,11,11,-0.1
11077,Brandon Channer\brandon-channer-1,2013-14,Rider,G,15,0,35,3,10,.300,2,6,.333,1,4,.250,4,8,.500,1,4,5,2,0,0,5,3,11,0.0
11078,Breamon Richard\breamon-richard-1,2017-18,Cal State Long Beach,G,13,0,69,0,10,.000,0,5,.000,0,5,.000,11,12,.917,0,3,3,4,2,0,3,13,11,0.1
11079,Noah Allen\noah-allen-1,2013-14,UCLA,G,11,0,38,4,7,.571,4,5,.800,0,2,.000,3,7,.429,1,6,7,1,0,0,1,6,11,0.5
11080,Brady Moses\brady-moses-1,2017-18,Stetson,G,6,0,13,3,5,.600,0,0,,3,5,.600,2,2,1.000,1,2,3,0,0,0,1,1,11,1.4
11081,Kyle Stroder\kyle-stroder-1,2013-14,Southeast Missouri State,G,8,0,20,4,8,.500,1,4,.250,3,4,.750,0,2,.000,3,4,7,0,0,0,1,3,11,0.9
11082,Joey Lane\joey-lane-1,2017-18,Ohio State,G,10,0,28,3,11,.273,1,4,.250,2,7,.286,3,4,.750,0,4,4,2,1,0,2,4,11,0.4
11083,Alan Vest\alan-vest-1,2017-18,Wright State,G,14,0,70,4,13,.308,3,8,.375,1,5,.200,2,2,1.000,3,10,13,4,1,0,4,4,11,0.5
11084,Matt Maloney\matt-maloney-2,2015-16,Manhattan,G,19,0,81,3,12,.250,1,2,.500,2,10,.200,2,4,.500,1,5,6,0,2,1,4,18,10,-0.2
11085,Ryann Green\ryann-green-1,2013-14,Georgia State,G,24,0,116,3,10,.300,3,4,.750,0,6,.000,4,6,.667,2,12,14,5,8,0,3,12,10,0.5
11086,Cedric Hankerson\cedric-hankerson-1,2015-16,Boston University,G,1,0,12,2,7,.286,0,2,.000,2,5,.400,4,4,1.000,0,3,3,0,1,0,0,3,10,6.6
11087,Dan Kingma\dan-kingma-1,2017-18,Washington,G,8,1,38,3,7,.429,1,3,.333,2,4,.500,2,4,.500,1,1,2,4,1,0,2,3,10,0.9
11088,Austin Mills\austin-mills-1,2015-16,Baylor,G,10,0,34,3,9,.333,1,2,.500,2,7,.286,2,2,1.000,0,2,2,7,1,1,3,0,10,0.9
11089,Devin Epps\devin-epps-1,2014-15,South Alabama,G,12,0,25,3,4,.750,0,1,.000,3,3,1.000,1,3,.333,0,2,2,1,0,0,3,6,10,0.3
11090,Patrick Keim\patrick-keim-1,2015-16,Auburn,G,23,0,150,2,14,.143,0,3,.000,2,11,.182,4,9,.444,2,10,12,5,4,0,10,19,10,-0.3
11091,Michael Klebon\michael-klebon-1,2017-18,Saint Francis (PA),G,9,0,33,3,7,.429,1,1,1.000,2,6,.333,2,2,1.000,0,8,8,0,0,1,1,3,10,0.8
11092,Brian Carey\brian-carey-1,2016-17,Texas Southern,G,1,1,34,3,10,.300,1,3,.333,2,7,.286,2,2,1.000,1,1,2,4,2,0,4,1,10,5.6
11093,Garrett Kingman\garrett-kingman-1,2017-18,Idaho,G,12,0,56,3,10,.300,2,5,.400,1,5,.200,3,4,.750,9,6,15,2,1,1,2,2,10,1.0
11094,Drake Thomas\drake-thomas-1,2013-14,Southern Utah,G,18,1,94,4,18,.222,3,12,.250,1,6,.167,1,2,.500,0,4,4,10,2,0,3,11,10,0.1
11095,William Gates\william-gates-2,2015-16,Houston Baptist,G,3,0,38,4,12,.333,3,7,.429,1,5,.200,1,2,.500,0,2,2,1,1,0,4,1,10,0.2
11096,Chris Clover\chris-clover-1,2015-16,Saint Joseph's,G,21,0,65,2,22,.091,0,9,.000,2,13,.154,4,6,.667,0,4,4,1,1,0,4,10,10,-0.5
11097,Garvey Melmed\garvey-melmed-1,2015-16,Maine,G,14,0,43,3,10,.300,0,0,,3,10,.300,1,2,.500,1,3,4,1,0,0,2,9,10,0.0
11098,Josh Parrish\josh-parrish-1,2016-17,Texas Christian,G,12,0,48,4,9,.444,3,6,.500,1,3,.333,1,2,.500,2,4,6,3,2,0,2,4,10,0.7
11099,Shaun Kirk\shaun-kirk-1,2015-16,North Carolina State,G,14,0,57,4,13,.308,3,7,.429,1,6,.167,1,2,.500,2,6,8,0,2,1,5,12,10,-0.1
11100,Myles Tate\myles-tate-1,2015-16,George Mason,G,15,0,67,2,10,.200,1,6,.167,1,4,.250,5,6,.833,0,6,6,3,3,0,4,6,10,0.3
11101,Chuck Smith\chuck-smith-1,2016-17,Howard,G,19,1,79,4,12,.333,4,9,.444,0,3,.000,2,5,.400,3,4,7,12,1,0,8,14,10,0.1
11102,Tyler Self\tyler-self-1,2016-17,Kansas,G,13,1,28,3,10,.300,1,4,.250,2,6,.333,2,2,1.000,1,2,3,5,0,0,7,2,10,0.1
11103,Quincy Tillinghast\quincy-tillinghast-1,2014-15,Delaware State,G,7,0,32,3,11,.273,1,2,.500,2,9,.222,2,3,.667,1,3,4,5,1,0,4,1,10,0.7
11104,Sheldon Lowman\sheldon-lowman-1,2013-14,Central Michigan,G,6,0,20,4,5,.800,4,5,.800,0,0,,2,3,.667,0,4,4,1,2,0,1,1,10,1.7
11105,J'Breun Sprinkle\jbreun-sprinkle-1,2017-18,Arkansas-Pine Bluff,G,17,0,96,4,9,.444,3,7,.429,1,2,.500,1,3,.333,1,2,3,7,3,0,4,6,10,0.4
11106,Michael Adams\michael-adams-2,2015-16,North Carolina-Greensboro,G,10,1,18,3,6,.500,1,1,1.000,2,5,.400,2,2,1.000,2,1,3,2,0,1,1,1,10,0.9
11107,Austin Witherill\austin-witherill-1,2017-18,Arizona State,G,15,1,40,3,6,.500,0,0,,3,6,.500,1,2,.500,1,4,5,0,0,0,0,0,10,0.6
11108,Calvin Anderson\calvin-anderson-1,2017-18,Louisiana-Monroe,G,7,0,53,3,15,.200,2,6,.333,1,9,.111,3,4,.750,1,12,13,2,0,0,4,3,10,0.1
11109,Austin Williams\austin-williams-1,2017-18,North Carolina A&T,G,10,2,43,4,10,.400,2,6,.333,2,4,.500,0,3,.000,0,2,2,7,6,0,4,7,10,0.8
11110,Brian Smith\brian-smith-9,2017-18,Portland,G,6,0,28,4,11,.364,2,5,.400,2,6,.333,0,1,.000,0,2,2,4,0,0,2,4,10,0.6
11111,Ty Hudson\ty-hudson-1,2016-17,Clemson,G,18,0,93,4,21,.190,2,8,.250,2,13,.154,0,0,,1,3,4,6,2,0,7,8,10,-0.3
11112,Lamarr Kimble\lamarr-kimble-1,2017-18,Saint Joseph's,G,1,1,30,4,11,.364,2,7,.286,2,4,.500,0,1,.000,0,1,1,2,0,0,0,2,10,4.4
11113,Manroop Clair\manroop-clair-1,2016-17,Seattle,G,3,0,21,4,11,.364,2,3,.667,2,8,.250,0,0,,1,7,8,4,1,0,2,2,10,2.6
11114,Stephen Spurlock\stephen-spurlock-1,2015-16,Maryland-Eastern Shore,G,14,3,70,4,17,.235,4,15,.267,0,2,.000,2,4,.500,5,9,14,1,1,0,3,8,10,0.0
11115,Javaka Thompson\javaka-thompson-1,2016-17,Illinois State,G,18,1,44,4,13,.308,3,6,.500,1,7,.143,1,2,.500,1,7,8,0,0,1,1,3,10,0.2
11116,Max Livingston\max-livingston-1,2014-15,Portland,G,12,0,52,3,11,.273,1,3,.333,2,8,.250,2,2,1.000,0,2,2,4,1,0,1,3,10,0.5
11117,Trevor Spoja\trevor-spoja-1,2016-17,Montana,G,8,0,20,3,7,.429,1,2,.500,2,5,.400,2,4,.500,0,0,0,1,0,0,1,3,10,0.5
11118,Mckay Johnson\mckay-johnson-1,2017-18,Utah Valley,G,15,0,60,3,7,.429,2,5,.400,1,2,.500,3,7,.429,3,8,11,6,0,0,6,4,10,0.4
11119,Brian Ishola\brian-ishola-1,2015-16,North Dakota State,G,19,1,95,5,11,.455,5,10,.500,0,1,.000,0,0,,5,9,14,3,3,1,6,15,10,0.2
11120,Courtney Julien\courtney-julien-1,2016-17,Texas State,G,18,0,71,3,17,.176,1,9,.111,2,8,.250,2,4,.500,1,9,10,6,1,2,4,6,10,0.1
11121,Mason Aucoin\mason-aucoin-1,2017-18,Louisiana,G,12,0,38,3,9,.333,1,3,.333,2,6,.333,2,4,.500,1,7,8,1,2,0,4,5,10,0.3
11122,Elijah McGuire\elijah-mcguire-1,2015-16,Louisiana,G,16,0,59,4,14,.286,3,7,.429,1,7,.143,1,5,.200,2,11,13,3,2,0,1,12,10,0.2
11123,Joel Wincowski\joel-wincowski-1,2016-17,Maryland-Baltimore County,G,4,0,29,4,5,.800,2,2,1.000,2,3,.667,0,0,,3,0,3,2,1,1,1,3,10,2.8
11124,Thomas Rogers\thomas-rogers-1,2013-14,Virginia,G,17,0,33,3,6,.500,0,1,.000,3,5,.600,1,2,.500,0,6,6,1,0,0,5,2,10,0.2
11125,Byron Burt\byron-burt-1,2016-17,Loyola (IL),G,5,0,15,4,4,1.000,2,2,1.000,2,2,1.000,0,0,,1,5,6,0,2,0,3,3,10,1.8
11126,Walter King\walter-king-1,2015-16,Maine,G,6,0,39,4,11,.364,4,10,.400,0,1,.000,2,5,.400,1,8,9,3,3,0,2,3,10,1.3
11127,Zach Winter\zach-winter-1,2016-17,Kansas State,G,15,0,34,4,9,.444,2,6,.333,2,3,.667,0,0,,2,2,4,3,3,0,3,1,10,0.6
11128,Joseph Louwagie\joseph-louwagie-1,2013-14,Incarnate Word,G,11,1,45,3,9,.333,3,9,.333,0,0,,4,8,.500,1,5,6,3,2,0,2,3,10,0.6
11129,Jorge Rosa\jorge-rosa-1,2017-18,New Orleans,G,2,1,26,4,9,.444,4,6,.667,0,3,.000,2,2,1.000,2,4,6,4,0,0,0,2,10,5.0
11130,Sam Walters\sam-walters-1,2017-18,UC-Santa Barbara,G,9,0,61,4,12,.333,2,2,1.000,2,10,.200,0,0,,1,7,8,8,2,0,6,5,10,0.6
11131,Justin Peebles-Jennings\justin-peebles-jennings-1,2015-16,Norfolk State,G,14,0,25,3,8,.375,0,0,,3,8,.375,1,2,.500,0,2,2,1,1,0,1,2,10,0.4
11132,Anthony Swan\anthony-swan-1,2014-15,George Washington,G,26,0,46,4,9,.444,2,3,.667,2,6,.333,0,2,.000,1,7,8,0,1,0,3,5,10,0.1
11133,Viko Noma'aea\viko-nomaaea-1,2014-15,Utah State,G,14,0,72,3,16,.188,2,6,.333,1,10,.100,3,4,.750,2,5,7,3,5,0,3,5,10,0.3
11134,Nathan Josephs\nathan-josephs-1,2015-16,Texas State,G,11,0,37,2,12,.167,2,7,.286,0,5,.000,6,8,.750,0,1,1,6,1,0,3,2,10,0.3
11135,Lance Whitaker\lance-whitaker-1,2013-14,Illinois-Chicago,G,3,1,55,4,6,.667,4,6,.667,0,0,,2,2,1.000,1,4,5,5,1,0,2,2,10,3.7
11136,Seth Callahan\seth-callahan-1,2015-16,NJIT,G,5,0,16,4,4,1.000,2,2,1.000,2,2,1.000,0,0,,0,1,1,0,1,0,1,1,10,1.7
11137,Ben Resner\ben-resner-1,2013-14,Stony Brook,G,16,1,51,0,7,.000,0,4,.000,0,3,.000,10,12,.833,1,6,7,7,0,0,13,2,10,-0.1
11138,Grant Pitman\grant-pitman-1,2017-18,Miami (OH),G,6,0,10,3,4,.750,0,1,.000,3,3,1.000,1,2,.500,3,2,5,0,1,0,0,0,10,2.0
11139,Grant Ellis\grant-ellis-1,2013-14,Iona,G,17,0,49,4,14,.286,2,3,.667,2,11,.182,0,0,,1,2,3,2,0,1,1,7,10,0.1
11140,Benedikt Haid\benedikt-haid-1,2016-17,North Florida,G,12,0,46,3,12,.250,0,0,,3,12,.250,1,2,.500,2,6,8,2,1,0,1,1,10,0.6
11141,Francis Edosomwan\francis-edosomwan-1,2013-14,East Carolina,G,10,0,34,3,3,1.000,3,3,1.000,0,0,,4,6,.667,9,9,18,3,2,0,2,5,10,1.7
11142,Cayne Edwards\cayne-edwards-1,2017-18,Army,G,5,0,16,3,4,.750,3,4,.750,0,0,,4,5,.800,2,5,7,1,2,0,1,1,10,2.4
11143,Alijah Bennett\alijah-bennett-1,2014-15,Kennesaw State,G,17,0,66,4,14,.286,4,8,.500,0,6,.000,2,2,1.000,2,7,9,7,0,1,8,7,10,0.0
11144,Khalil Batie\khalil-batie-1,2015-16,Rutgers,G,13,0,65,4,15,.267,2,8,.250,2,7,.286,0,2,.000,2,8,10,5,1,4,1,8,10,0.6
11145,Kris Rolle\chris-rolle-1,2014-15,Saint Peter's,G,19,4,77,4,10,.400,4,10,.400,0,0,,2,10,.200,8,12,20,1,2,0,1,12,10,0.4
11146,Marius McAllister\marius-mcallister-1,2016-17,North Carolina Central,G,8,1,42,4,6,.667,4,5,.800,0,1,.000,2,3,.667,4,4,8,2,1,0,4,5,10,0.9
11147,Riley Bradshaw\riley-bradshaw-1,2013-14,Montana,G,20,0,137,3,13,.231,1,7,.143,2,6,.333,2,2,1.000,2,5,7,2,5,0,4,13,10,0.1
11148,Mason Aucoin\mason-aucoin-1,2016-17,Louisiana,G,8,0,24,3,9,.333,1,2,.500,2,7,.286,2,2,1.000,2,4,6,1,1,0,0,0,10,1.2
11149,Tommy Kuhse\tommy-kuhse-1,2017-18,Saint Mary's (CA),G,24,0,56,4,9,.444,3,7,.429,1,2,.500,1,2,.500,1,6,7,8,1,0,1,8,10,0.4
11150,Kibret Woldemichael\kibret-woldemichael-1,2013-14,San Diego State,G,4,0,18,3,4,.750,0,0,,3,4,.750,1,2,.500,0,1,1,4,0,0,2,0,10,2.3
11151,Jonathan Allen\jonathan-allen-1,2015-16,Pepperdine,G,16,0,121,3,9,.333,1,4,.250,2,5,.400,2,4,.500,4,13,17,5,4,0,4,13,10,0.6
11152,Ben Sanders\ben-sanders-2,2013-14,Grand Canyon,G,6,0,25,4,8,.500,3,6,.500,1,2,.500,1,2,.500,0,3,3,2,0,0,3,4,10,0.6
11153,Mike Podolsky\mike-podolsky-1,2013-14,Youngstown State,G,24,1,100,3,10,.300,0,4,.000,3,6,.500,1,2,.500,3,8,11,4,1,1,3,8,10,0.3
11154,Dexter Gooding\dexter-gooding-1,2015-16,High Point,G,8,0,9,4,6,.667,3,3,1.000,1,3,.333,1,3,.333,0,2,2,0,0,0,0,1,10,0.9
11155,Malcolm Allen\malcolm-allen-1,2017-18,Northern Arizona,G,3,0,31,5,9,.556,5,9,.556,0,0,,0,0,,0,0,0,5,1,0,3,1,10,2.3
11156,Sam Hershberger\sam-hershberger-1,2015-16,Elon,G,9,1,15,2,5,.400,2,3,.667,0,2,.000,6,6,1.000,0,1,1,1,0,0,0,3,10,0.8
11157,Larry Johnson\larry-johnson-6,2014-15,Arkansas-Pine Bluff,G,20,0,58,4,10,.400,2,6,.333,2,4,.500,0,0,,1,2,3,3,2,0,7,7,10,0.0
11158,Zach Buscher\zach-buscher-1,2015-16,Hawaii,G,13,0,39,5,9,.556,5,6,.833,0,3,.000,0,2,.000,0,6,6,4,1,0,2,5,10,0.5
11159,Georgios Angelou\georgios-angelou-1,2014-15,Saint Francis (PA),G,6,0,28,3,6,.500,1,2,.500,2,4,.500,2,2,1.000,0,1,1,1,0,0,3,5,10,0.5
11160,Zack Denny\zack-denny-1,2013-14,Bowling Green State,G,3,0,31,3,8,.375,0,3,.000,3,5,.600,1,4,.250,1,0,1,0,0,0,1,2,10,1.1
11161,D.J. Suter\dj-suter-1,2014-15,Georgia Southern,G,7,0,24,4,9,.444,2,3,.667,2,6,.333,0,0,,1,4,5,1,0,2,0,1,10,1.3
11162,Conner Hall\conner-hall-1,2015-16,Tennessee Tech,G,5,0,25,3,8,.375,0,1,.000,3,7,.429,1,2,.500,1,0,1,0,0,0,3,5,10,0.2
11163,Keondre Dew\keondre-dew-1,2014-15,Tulsa,G,21,0,115,5,24,.208,5,22,.227,0,2,.000,0,1,.000,11,21,32,3,1,0,10,12,10,-0.1
11164,Logan Jackson\logan-jackson-1,2014-15,Appalachian State,G,10,0,53,5,10,.500,5,5,1.000,0,5,.000,0,2,.000,2,1,3,4,0,0,3,8,10,0.3
11165,Eric Stafford\eric-stafford-1,2014-15,Lafayette,G,16,0,60,4,11,.364,2,5,.400,2,6,.333,0,0,,5,3,8,4,2,3,8,8,10,0.3
11166,Payne Andrus\payne-andrus-1,2013-14,Navy,G,13,1,72,5,18,.278,5,13,.385,0,5,.000,0,1,.000,5,6,11,7,2,0,3,9,10,0.4
11167,Brian Rohleder\brian-rohleder-1,2015-16,Kansas State,G,23,0,62,4,10,.400,4,9,.444,0,1,.000,2,6,.333,3,4,7,4,3,1,2,22,10,0.1
11168,Dylan Brewster\dylan-brewster-1,2017-18,Chattanooga,G,6,0,57,3,10,.300,1,1,1.000,2,9,.222,2,4,.500,0,5,5,5,0,0,5,3,10,0.4
11169,Nick Kerr\nick-kerr-1,2015-16,University of California,G,7,0,11,3,6,.500,0,0,,3,6,.500,0,0,,0,1,1,0,0,0,0,1,9,0.8
11170,Cheick Sy-Savane\cheick-sy-savane-1,2017-18,Grand Canyon,G,6,0,14,3,9,.333,0,4,.000,3,5,.600,0,0,,1,0,1,0,0,0,1,4,9,0.3
11171,Mitch McCormick\mitch-mccormick-1,2015-16,Sam Houston State,G,9,0,19,3,10,.300,0,1,.000,3,9,.333,0,1,.000,0,1,1,1,2,0,0,0,9,0.6
11172,Gregory Hayden\gregory-hayden-1,2014-15,Hampton,G,13,0,26,2,8,.250,2,5,.400,0,3,.000,5,9,.556,2,2,4,5,3,0,7,3,9,0.2
11173,Andrew Dotson\andrew-dotson-1,2015-16,New Hampshire,G,6,0,29,3,15,.200,2,9,.222,1,6,.167,2,5,.400,1,0,1,2,1,0,1,1,9,0.0
11174,Keyshawn Evans\keyshawn-evans-1,2015-16,Illinois State,G,10,0,65,3,13,.231,3,9,.333,0,4,.000,3,6,.500,1,4,5,4,2,0,4,1,9,0.2
11175,Mark Plousis\mark-plousis-1,2016-17,Hartford,G,11,0,21,2,4,.500,2,4,.500,0,0,,5,5,1.000,0,2,2,0,1,0,1,0,9,0.7
11176,Tyre Moore\tyre-moore-1,2014-15,Mercer,G,15,0,25,1,4,.250,0,1,.000,1,3,.333,6,8,.750,6,2,8,0,1,0,1,7,9,0.5
11177,Justin McKie\justin-mckie-1,2013-14,South Carolina,G,16,0,80,3,17,.176,2,9,.222,1,8,.125,2,4,.500,4,12,16,5,3,0,5,8,9,0.1
11178,Nick Powell\nick-powell-1,2016-17,North Carolina-Wilmington,G,11,0,27,4,9,.444,3,7,.429,1,2,.500,0,0,,3,2,5,0,0,0,1,6,9,0.3
11179,Travis Valmon\travis-valmon-1,2017-18,Maryland,G,9,0,20,4,7,.571,3,5,.600,1,2,.500,0,1,.000,1,4,5,0,1,0,2,1,9,0.6
11180,Tyler Akers\tyler-akers-1,2013-14,Longwood,G,19,0,26,2,5,.400,1,1,1.000,1,4,.250,4,6,.667,1,4,5,1,0,0,1,3,9,0.3
11181,Dyrbe Enos\dyrbe-enos--1,2015-16,Hawaii,G,14,0,28,3,13,.231,1,3,.333,2,10,.200,1,2,.500,1,4,5,1,2,0,1,2,9,0.3
11182,RJ Nembhard\rj-nembhard-1,2017-18,Texas Christian,G,6,0,33,4,14,.286,4,9,.444,0,5,.000,1,4,.250,2,4,6,5,0,1,5,2,9,0.1
11183,Jason Karys\jason-karys-1,2016-17,Valparaiso,G,11,0,17,2,9,.222,0,1,.000,2,8,.250,3,4,.750,0,1,1,1,1,0,3,1,9,0.2
11184,Rich Audu\rich-audu-1,2013-14,Siena,G,13,0,52,3,10,.300,2,9,.222,1,1,1.000,2,3,.667,1,4,5,2,1,0,5,5,9,0.0
11185,Evan Hinson\evan-hinson-1,2016-17,South Carolina,G,8,0,33,3,8,.375,2,3,.667,1,5,.200,2,2,1.000,2,3,5,1,2,0,0,3,9,1.1
11186,Anthony Fields\anthony-fields-2,2013-14,Bradley,G,26,0,128,4,11,.364,3,7,.429,1,4,.250,0,1,.000,1,7,8,8,3,0,9,24,9,-0.2
11187,Jevon Patton\jevon-patton-1,2013-14,Loyola (MD),G,18,0,101,2,12,.167,2,9,.222,0,3,.000,5,7,.714,4,4,8,17,3,0,9,7,9,0.4
11188,Jaevin Cumberland\jaevin-cumberland-1,2017-18,Oakland,G,8,0,74,2,14,.143,1,7,.143,1,7,.143,4,7,.571,4,6,10,6,2,0,6,7,9,0.1
11189,Matt Rosenwinkel\matt-rosenwinkel-1,2014-15,Northern Kentucky,G,10,0,43,3,11,.273,0,1,.000,3,10,.300,0,0,,2,4,6,1,0,0,1,5,9,0.3
11190,Gavin Hoffmann\gavin-hoffmann-1,2014-15,San Francisco,G,17,1,77,2,7,.286,2,6,.333,0,1,.000,5,8,.625,1,11,12,4,1,0,3,6,9,0.4
11191,Kevin Kangni\kevin-kangni-1,2015-16,James Madison,G,13,0,58,3,19,.158,2,8,.250,1,11,.091,2,3,.667,3,4,7,3,2,2,3,7,9,0.0
11192,Des Curry\des-curry-1,2016-17,Jacksonville State,G,8,0,28,2,7,.286,2,6,.333,0,1,.000,5,7,.714,2,0,2,4,1,0,1,3,9,0.9
11193,Chad Hudson\chad-hudson-1,2017-18,IUPUI,G,8,0,27,2,6,.333,2,3,.667,0,3,.000,5,7,.714,0,1,1,2,0,0,2,7,9,0.2
11194,Nick Dixon\nick-dixon-1,2015-16,Texas-Rio Grande Valley,G,2,1,44,2,14,.143,2,11,.182,0,3,.000,5,9,.556,1,6,7,1,2,0,3,3,9,-0.3
11195,Evan Manning\evan-manning-1,2015-16,Kansas,G,15,1,37,3,6,.500,0,0,,3,6,.500,0,0,,0,4,4,1,4,0,2,6,9,0.5
11196,Nathan Harries\nathan-harries-1,2014-15,Colgate,G,4,0,56,3,10,.300,2,6,.333,1,4,.250,2,2,1.000,0,3,3,2,0,0,1,12,9,-0.1
11197,Larry Haley\larry-haley-1,2013-14,Delaware State,G,11,0,42,3,13,.231,0,4,.000,3,9,.333,0,0,,1,3,4,2,0,0,0,2,9,0.3
11198,Brett Brady\brett-brady-1,2015-16,Colorado,G,10,0,19,3,6,.500,1,2,.500,2,4,.500,1,2,.500,0,5,5,0,2,0,2,1,9,0.7
11199,Trevor Spoja\trevor-spoja-1,2017-18,Montana,G,18,0,56,3,17,.176,1,3,.333,2,14,.143,1,2,.500,1,2,3,3,0,1,3,8,9,-0.2
11200,Anson Moye\anson-moye-1,2013-14,Cal State Long Beach,G,10,1,28,3,7,.429,1,4,.250,2,3,.667,1,2,.500,0,2,2,3,0,0,3,7,9,0.2
11201,Blake Edwards\blake-edwards-1,2016-17,South Carolina Upstate,G,5,0,14,3,6,.500,0,0,,3,6,.500,0,0,,0,1,1,0,1,0,0,1,9,1.4
11202,Tevin Findlay\tevin-findlay-1,2014-15,Green Bay,G,17,0,73,3,15,.200,3,13,.231,0,2,.000,3,3,1.000,3,7,10,10,3,0,3,7,9,0.5
11203,Sean Billerman\sean-billerman-1,2014-15,Army,G,7,3,17,2,7,.286,1,1,1.000,1,6,.167,4,5,.800,0,1,1,2,0,0,0,1,9,0.8
11204,Anfernee Felton\anfernee-felton-1,2016-17,Jackson State,G,20,0,90,2,9,.222,1,4,.250,1,5,.200,4,5,.800,0,7,7,7,2,1,2,10,9,0.3
11205,Andrew Leone\andrew-leone-1,2016-17,Fairfield,G,14,1,25,1,8,.125,0,1,.000,1,7,.143,6,6,1.000,1,1,2,4,0,0,1,2,9,0.4
11206,Quinten Payne\quinten-payne-1,2015-16,Dartmouth,G,14,0,62,4,9,.444,3,4,.750,1,5,.200,0,0,,1,5,6,4,1,1,3,10,9,0.3
11207,Stephen O'Suji\stephen-osuji-1,2017-18,Houston Baptist,G,12,0,52,2,13,.154,2,12,.167,0,1,.000,5,6,.833,2,6,8,7,3,0,4,4,9,0.5
11208,Lance Richard\lance-richard-1,2016-17,Louisiana-Monroe,G,6,0,15,3,6,.500,0,0,,3,6,.500,0,0,,0,3,3,0,0,0,3,0,9,0.7
11209,Steven Bennett\steven-bennett-1,2014-15,Butler,G,9,0,25,3,7,.429,0,1,.000,3,6,.500,0,0,,1,1,2,2,0,0,1,4,9,0.6
11210,Andre Wolford\andre-wolford-1,2015-16,Saint Francis (PA),G,7,0,13,3,5,.600,1,1,1.000,2,4,.500,1,2,.500,1,1,2,0,0,0,1,1,9,0.8
11211,David Bloom\david-bloom-1,2016-17,Texas A&M-Corpus Christi,G,29,0,141,2,15,.133,2,8,.250,0,7,.000,5,6,.833,5,8,13,4,2,1,4,11,9,0.1
11212,Tommy Luce\tommy-luce-1,2017-18,Purdue,G,13,0,35,3,10,.300,3,9,.333,0,1,.000,3,8,.375,2,1,3,8,2,0,7,6,9,0.1
11213,Jabbar Washington\jabbar-washington-3,2015-16,Charleston Southern,G,8,1,34,3,10,.300,3,7,.429,0,3,.000,3,6,.500,1,3,4,8,1,0,6,2,9,0.4
11214,J.T. Trauber\jt-trauber-1,2014-15,Rice,G,6,0,9,3,3,1.000,0,0,,3,3,1.000,0,0,,1,0,1,0,0,0,0,1,9,1.4
11215,Gregory Hayden\gregory-hayden-1,2015-16,Hampton,G,9,0,18,2,6,.333,1,4,.250,1,2,.500,4,10,.400,0,1,1,2,1,0,6,2,9,-0.1
11216,Varun Ram\varum-ram-1,2013-14,Maryland,G,16,1,115,3,14,.214,0,3,.000,3,11,.273,0,2,.000,1,12,13,9,10,0,8,22,9,0.2
11217,De Andre' Austin\deandre-austin-2,2017-18,Bowling Green State,G,6,0,14,3,4,.750,2,3,.667,1,1,1.000,2,2,1.000,0,6,6,1,1,0,0,1,9,1.8
11218,Sheldon Blackwell\sheldon-blackwell-1,2015-16,Cal State Fullerton,G,8,0,117,4,13,.308,4,12,.333,0,1,.000,1,5,.200,3,21,24,13,4,4,5,18,9,1.5
11219,Valerio Altheimer\valerio-altheimer-1,2013-14,Grambling,G,14,1,48,4,8,.500,4,6,.667,0,2,.000,1,2,.500,3,3,6,4,1,1,1,1,9,0.8
11220,Justin Brickman\justin-brickman-1,2013-14,Bryant,G,6,0,22,3,5,.600,3,4,.750,0,1,.000,3,6,.500,1,0,1,1,0,0,3,4,9,0.4
11221,Josh Hearlihy\josh-hearlihy-1,2013-14,Tulane,G,18,0,97,3,13,.231,2,10,.200,1,3,.333,2,2,1.000,1,9,10,6,2,0,4,10,9,0.2
11222,Michael Onyebalu\michael-onyebalu-1,2014-15,UC-Davis,G,4,0,17,4,7,.571,3,5,.600,1,2,.500,0,0,,0,0,0,0,0,0,3,2,9,0.5
11223,Justin Jordan\justin-jordan-2,2016-17,North Carolina-Greensboro,G,6,0,35,3,8,.375,2,6,.333,1,2,.500,2,2,1.000,0,5,5,1,3,0,2,2,9,1.2
11224,Jordan Faciane\jordan-faciane-1,2013-14,Campbell,G,3,0,8,3,4,.750,1,1,1.000,2,3,.667,1,2,.500,0,1,1,0,1,0,1,1,9,2.3
11225,Jack Stensgard\jack-stensgard-1,2017-18,South Dakota,G,13,0,55,3,13,.231,0,6,.000,3,7,.429,0,0,,1,3,4,6,2,0,1,2,9,0.5
11226,Chris Barnes\chris-barnes-2,2016-17,Texas-El Paso,G,16,0,69,4,14,.286,4,10,.400,0,4,.000,1,5,.200,1,10,11,2,2,0,4,7,9,0.0
11227,Montana Mayfield\montana-mayfield-1,2014-15,NJIT,G,5,0,48,3,9,.333,3,6,.500,0,3,.000,3,4,.750,0,4,4,4,0,1,3,4,9,0.7
11228,Billy Ingram\billy-ingram-1,2014-15,Alabama State,G,6,0,25,3,11,.273,0,2,.000,3,9,.333,0,0,,1,3,4,0,0,0,2,5,9,0.0
11229,Colby Long\colby-long-1,2013-14,Southern Illinois,G,10,1,26,3,11,.273,0,2,.000,3,9,.333,0,0,,0,2,2,1,0,0,2,1,9,0.1
11230,Rodney Elliott\rodney-elliott-2,2014-15,Maryland-Baltimore County,G,2,1,21,3,8,.375,1,2,.500,2,6,.333,1,2,.500,0,3,3,3,0,0,2,0,9,2.6
11231,Steven Bennett\steven-bennett-1,2015-16,Butler,G,13,0,50,3,10,.300,0,0,,3,10,.300,0,0,,1,6,7,3,0,0,3,3,9,0.3
11232,Dustin Triano\dustin-triano-1,2014-15,Gonzaga,G,11,0,31,3,6,.500,0,0,,3,6,.500,0,0,,1,3,4,0,1,0,2,4,9,0.5
11233,Dyrbe Enos\dyrbe-enos--1,2014-15,Hawaii,G,18,0,44,3,17,.176,0,3,.000,3,14,.214,0,2,.000,0,1,1,3,1,0,3,2,9,-0.2
11234,Corey Haith\corey-haith-1,2016-17,Tulsa,G,14,0,40,3,7,.429,0,0,,3,7,.429,0,0,,0,4,4,3,2,0,4,8,9,0.2
11235,Jalen Knight\jalen-knight-1,2017-18,Hartford,G,12,0,49,3,6,.500,2,5,.400,1,1,1.000,2,8,.250,0,7,7,3,0,0,5,6,9,0.0
11236,Malcolm Wynter\malcolm-wynter-1,2017-18,Davidson,G,17,0,26,2,6,.333,0,1,.000,2,5,.400,3,4,.750,1,1,2,0,0,0,1,2,9,0.3
11237,Tyler Loose\tyler-loose-1,2016-17,Northern Colorado,G,28,0,215,2,6,.333,2,5,.400,0,1,.000,5,16,.313,1,20,21,27,8,0,14,18,9,0.5
11238,Nick Kerr\nick-kerr-1,2014-15,San Diego,G,6,1,22,3,8,.375,0,2,.000,3,6,.500,0,0,,0,1,1,0,0,0,0,2,9,0.7
11239,Treaven Duffy\treaven-duffy-1,2014-15,Saint Mary's (CA),G,21,2,65,4,14,.286,4,11,.364,0,3,.000,1,4,.250,5,6,11,3,3,0,9,9,9,-0.1
11240,Henry Bolton\henry-bolton-1,2015-16,Utah State,G,9,0,58,3,4,.750,3,3,1.000,0,1,.000,3,4,.750,0,5,5,10,2,1,2,3,9,1.7
11241,Todd Halvorsen\todd-halvorsen-1,2013-14,East Tennessee State,G,9,1,36,3,10,.300,0,2,.000,3,8,.375,0,0,,1,2,3,2,4,0,3,5,9,0.5
11242,Jimmy Marshall\jimmy-marshall-1,2014-15,Northeastern,G,17,0,62,2,13,.154,1,4,.250,1,9,.111,4,5,.800,3,6,9,2,0,0,1,4,9,0.2
11243,Matt Staubi\matt-staubi-1,2017-18,Loyola (MD),G,10,1,49,3,6,.500,2,3,.667,1,3,.333,2,2,1.000,0,2,2,11,2,0,3,5,9,1.1
11244,Jason McMillan\jason-mcmillan-1,2017-18,Western Carolina,G,13,0,39,3,12,.250,0,1,.000,3,11,.273,0,0,,1,2,3,1,1,0,1,2,9,0.2
11245,Jordan Thomas\jordan-thomas-1,2015-16,Northern Illinois,G,7,0,24,3,10,.300,0,2,.000,3,8,.375,0,0,,1,3,4,1,0,0,2,0,9,0.5
11246,Omar Mostafa\omar-mostafa-1,2017-18,William & Mary,G,7,0,17,3,4,.750,2,3,.667,1,1,1.000,2,2,1.000,0,0,0,1,2,0,1,1,9,1.2
11247,Jamion Wright\jamion-wright-1,2017-18,Sacramento State,G,12,0,61,3,11,.273,0,1,.000,3,10,.300,0,0,,1,2,3,1,2,0,6,6,9,-0.2
11248,Kanler Coker\kanler-coker-1,2016-17,North Carolina,G,21,1,29,2,4,.500,2,4,.500,0,0,,5,5,1.000,2,2,4,1,1,0,1,6,9,0.3
11249,Josh Humphrey\josh-humphrey-2,2013-14,Green Bay,G,19,1,132,3,11,.273,3,10,.300,0,1,.000,3,10,.300,5,10,15,6,4,2,8,17,9,0.1
11250,Devon Oakley\devon-oakley-1,2015-16,Hampton,G,14,0,81,2,9,.222,2,8,.250,0,1,.000,5,7,.714,3,10,13,3,2,1,3,10,9,0.4
11251,Karim Mawuenyega\karim-mawuenyega-1,2014-15,South Carolina Upstate,G,3,0,40,3,10,.300,2,4,.500,1,6,.167,2,5,.400,2,3,5,9,7,0,0,2,9,5.6
11252,Ronnye Beamon\ronnye-beamon-1,2013-14,Youngstown State,G,13,0,55,4,12,.333,4,7,.571,0,5,.000,1,5,.200,5,2,7,1,4,1,1,5,9,0.5
11253,Denzel Collins\denzel-collins-1,2014-15,Alabama-Birmingham,G,9,0,27,3,8,.375,2,4,.500,1,4,.250,2,3,.667,0,2,2,3,2,0,2,6,9,0.5
11254,Maleek Catchings\maleek-catchings-1,2017-18,Presbyterian,G,11,0,60,4,12,.333,3,9,.333,1,3,.333,0,0,,5,6,11,0,1,0,1,9,9,0.4
11255,Luke Neff\luke-neff-1,2016-17,Denver,G,8,1,42,2,11,.182,1,2,.500,1,9,.111,4,4,1.000,2,6,8,1,1,0,1,4,9,0.6
11256,Sherron Dorsey-Walker\sherron-dorsey-walker-1,2014-15,Iowa State,G,3,0,39,3,8,.375,2,4,.500,1,4,.250,2,2,1.000,0,4,4,1,1,0,1,0,9,2.2
11257,Beau Gamble\beau-gamble-1,2013-14,Colorado,G,9,0,16,3,7,.429,0,0,,3,7,.429,0,2,.000,0,5,5,6,0,0,3,1,9,0.8
11258,Juwan Wells\juwan-wells-1,2013-14,Radford,G,8,0,22,4,10,.400,4,9,.444,0,1,.000,1,2,.500,4,3,7,2,3,1,3,3,9,1.0
11259,DeQuavious Wagner\dequavious-wagner-1,2013-14,Arkansas,G,8,0,37,3,13,.231,3,8,.375,0,5,.000,3,4,.750,1,1,2,6,2,0,3,5,9,0.4
11260,Daquon Ervin\daquon-ervin-1,2016-17,Maryland-Baltimore County,G,9,0,34,2,6,.333,2,5,.400,0,1,.000,5,8,.625,3,2,5,6,0,0,7,4,9,0.3
11261,Devin Newsome\devin-newsome-1,2015-16,Omaha,G,12,0,61,3,13,.231,1,8,.125,2,5,.400,1,1,1.000,2,7,9,5,0,0,8,4,9,-0.1
11262,Devin Mitchell\devin-mitchell-1,2014-15,Alabama,G,14,1,76,3,23,.130,1,6,.167,2,17,.118,1,2,.500,0,3,3,4,3,1,2,15,9,-0.5
11263,Elijah Holifield\elijah-holifield-1,2016-17,St. John's (NY),G,7,0,13,4,6,.667,3,3,1.000,1,3,.333,0,2,.000,0,1,1,2,3,0,2,4,9,1.0
11264,Juwan Henderson\juwan-henderson-1,2015-16,Alcorn State,G,5,1,49,3,13,.231,2,5,.400,1,8,.125,2,4,.500,1,7,8,4,1,0,5,10,9,-0.4
11265,Brian Bhaskar\brian-bhaskar-1,2013-14,Gonzaga,G,13,0,23,3,5,.600,1,3,.333,2,2,1.000,1,2,.500,0,1,1,0,1,0,1,3,9,0.4
11266,Harrison Taggart\harrison-taggart-1,2013-14,Vermont,G,11,0,56,3,7,.429,2,3,.667,1,4,.250,2,2,1.000,3,5,8,3,3,0,1,6,9,1.0
11267,Khalil Bedart-Ghani\khaliq-bedart-ghani-1,2014-15,San Diego,G,6,0,32,4,8,.500,4,8,.500,0,0,,1,2,.500,0,2,2,0,1,1,1,1,9,0.9
11268,Wade Moody\wade-moody-1,2013-14,North Carolina,G,12,1,25,3,6,.500,0,1,.000,3,5,.600,0,0,,0,0,0,6,0,0,1,3,9,0.7
11269,Keenan Wetzel\keenan-wetzel-1,2013-14,Michigan State,G,12,0,21,4,9,.444,3,6,.500,1,3,.333,0,0,,3,1,4,1,0,0,0,3,9,0.5
11270,DJ Draper\dj-draper-1,2016-17,North Texas,G,16,0,31,3,7,.429,1,2,.500,2,5,.400,1,3,.333,0,3,3,3,3,0,1,1,9,0.6
11271,Ian Spruce\ian-spruce-1,2013-14,Cal State Fullerton,G,7,0,9,3,7,.429,0,0,,3,7,.429,0,0,,0,1,1,0,0,0,0,0,9,0.8
11272,Mike Schroback\mike-schroback-1,2015-16,Fairleigh Dickinson,G,20,0,68,3,16,.188,2,5,.400,1,11,.091,2,5,.400,0,4,4,6,2,0,7,5,9,-0.2
11273,Trey Pettus\trey-pettus-1,2016-17,Butler,G,7,0,24,4,10,.400,4,6,.667,0,4,.000,1,2,.500,0,2,2,3,0,0,2,3,9,0.4
11274,K.J. Bates\kj-bates-1,2015-16,Chattanooga,G,8,0,22,2,6,.333,1,3,.333,1,3,.333,4,7,.571,1,5,6,1,3,0,0,0,9,1.3
11275,Scott Mammel\scott-mammel-1,2013-14,Army,G,11,0,42,3,9,.333,1,1,1.000,2,8,.250,1,1,1.000,2,1,3,2,0,0,4,4,9,0.1
11276,Riley Dearring\riley-dearring-1,2016-17,Cal State Fullerton,G,6,0,26,3,15,.200,2,6,.333,1,9,.111,2,4,.500,1,3,4,1,0,0,2,7,9,-0.6
11277,Mason Schoen\mason-schoen-1,2016-17,Kansas State,G,13,0,22,3,6,.500,0,1,.000,3,5,.600,0,3,.000,0,1,1,2,0,0,1,3,9,0.3
11278,Brandon Wimberly\brandon-wimberly-1,2016-17,Georgia Southern,G,4,0,12,3,4,.750,2,3,.667,1,1,1.000,2,3,.667,1,1,2,0,0,0,0,0,9,2.0
11279,Shawn Roundtree\shawn-roundtree-1,2015-16,Missouri State,G,3,0,35,4,11,.364,3,7,.429,1,4,.250,0,1,.000,1,0,1,1,1,0,2,5,9,0.3
11280,Justice Bartley\justice-bartley-1,2016-17,Virginia,G,10,0,27,4,9,.444,3,4,.750,1,5,.200,0,2,.000,0,7,7,1,0,1,5,5,9,0.0
11281,Aaron Hendricks\aaron-hendricks-1,2014-15,Pacific,G,6,0,22,3,10,.300,0,1,.000,3,9,.333,0,0,,1,2,3,1,1,0,1,1,9,0.8
11282,Kyle Daugherty\kyle-daugherty-1,2015-16,Marist,G,12,0,16,2,7,.286,2,2,1.000,0,5,.000,5,5,1.000,0,1,1,1,0,0,1,4,9,0.3
11283,Jake Dadika\jake-dadika-1,2015-16,Rutgers,G,17,0,81,3,10,.300,2,4,.500,1,6,.167,2,4,.500,0,5,5,6,0,0,5,8,9,0.0
11284,Ausar Madison\ausar-madison-1,2016-17,Howard,G,12,2,131,2,17,.118,2,12,.167,0,5,.000,5,18,.278,3,11,14,11,10,0,11,15,9,-0.1
11285,Zach Radz\zach-radz-1,2016-17,Sacred Heart,G,14,0,81,3,13,.231,0,3,.000,3,10,.300,0,0,,0,7,7,4,2,2,6,4,9,0.1
11286,Charlie Tooley\charlie-tooley-1,2016-17,Nevada,G,15,0,40,3,4,.750,0,0,,3,4,.750,0,0,,3,2,5,0,2,0,1,8,9,0.5
11287,Ismael Sanogo\ismael-sanogo-1,2014-15,Seton Hall,G,18,1,96,3,12,.250,3,10,.300,0,2,.000,3,9,.333,7,11,18,1,4,8,5,17,9,0.3
11288,Brandon Jawato\brandon-jawato-1,2013-14,Hawaii,G,14,0,51,3,11,.273,1,1,1.000,2,10,.200,0,0,,1,1,2,4,3,1,3,4,8,0.3
11289,DeAndre Turner\deandre-turner-1,2016-17,Iona,G,5,0,43,2,11,.182,1,4,.250,1,7,.143,3,6,.500,1,3,4,1,1,1,1,4,8,0.3
11290,George Matthews\george-matthews-1,2014-15,Texas-San Antonio,G,8,0,33,3,9,.333,3,5,.600,0,4,.000,2,2,1.000,2,6,8,0,3,0,5,5,8,0.3
11291,Scott Spencer\scott-spencer-1,2016-17,Clemson,G,7,0,29,4,12,.333,4,10,.400,0,2,.000,0,0,,0,3,3,0,1,0,0,2,8,0.3
11292,Damarkeo Lyshe\damarkeo-lyshe-1,2014-15,Bowling Green State,G,14,2,54,2,11,.182,0,5,.000,2,6,.333,2,4,.500,2,2,4,3,2,0,2,6,8,0.1
11293,Jonathan Bins\jonathan-bins-1,2016-17,Memphis,G,8,0,19,3,8,.375,1,5,.200,2,3,.667,0,0,,1,0,1,5,0,0,1,2,8,0.8
11294,LaMonta Stone II\lamonta-stoneii-1,2015-16,Eastern Michigan,G,6,0,35,3,10,.300,3,7,.429,0,3,.000,2,4,.500,1,2,3,5,3,0,7,3,8,0.2
11295,Josh Jones\josh-jones-4,2015-16,Richmond,G,1,1,38,3,9,.333,3,8,.375,0,1,.000,2,2,1.000,0,2,2,0,2,0,1,3,8,3.3
11296,Bill Clark\bill-clark-2,2013-14,Loyola (IL),G,11,1,27,3,14,.214,1,7,.143,2,7,.286,0,0,,2,3,5,3,1,0,2,3,8,0.1
11297,Sean Locke\sean-locke-1,2015-16,Delaware,G,12,1,26,2,10,.200,0,0,,2,10,.200,2,3,.667,1,3,4,0,1,0,2,3,8,0.1
11298,Sam Worman\sam-worman-1,2015-16,Liberty,G,10,0,29,4,8,.500,4,7,.571,0,1,.000,0,0,,1,2,3,0,4,0,4,7,8,0.3
11299,Trevor John\trevor-john-1,2016-17,Cal Poly,G,14,0,44,2,11,.182,0,2,.000,2,9,.222,2,2,1.000,2,1,3,0,2,0,0,5,8,0.2
11300,Imani Miller\imani-miller-1,2015-16,Hampton,G,24,0,121,2,9,.222,2,9,.222,0,0,,4,8,.500,5,9,14,12,6,0,10,17,8,0.2
11301,Charles Oliver\charles-oliver-2,2014-15,Robert Morris,G,2,0,19,0,7,.000,0,3,.000,0,4,.000,8,10,.800,2,2,4,1,1,0,0,5,8,2.0
11302,Jack Bentz\jack-bentz-1,2013-14,Wyoming,G,18,0,104,3,7,.429,3,7,.429,0,0,,2,4,.500,1,10,11,15,4,0,5,6,8,0.8
11303,Cezanne Carson\cezanne-carson-1,2017-18,Little Rock,G,13,0,76,4,16,.250,4,9,.444,0,7,.000,0,0,,2,9,11,2,1,0,2,0,8,0.2
11304,Tre Houston\tre-houston-1,2017-18,Hampton,G,9,0,24,3,6,.500,3,5,.600,0,1,.000,2,4,.500,1,5,6,1,0,0,2,0,8,0.6
11305,Abdul Dial\abdul-dial-1,2015-16,St. John's (NY),G,6,0,20,3,5,.600,3,5,.600,0,0,,2,2,1.000,1,3,4,2,0,0,0,4,8,1.2
11306,Anias Saunders\anias-saunders-1,2017-18,Radford,G,12,0,16,2,4,.500,0,0,,2,4,.500,2,2,1.000,1,2,3,1,0,0,2,0,8,0.5
11307,Luke Bolster\luke-bolster-1,2017-18,Columbia,G,4,0,25,3,12,.250,1,4,.250,2,8,.250,0,0,,0,3,3,3,0,0,1,1,8,0.6
11308,Crew Ainge\crew-ainge-1,2017-18,Utah State,G,16,0,111,2,18,.111,2,9,.222,0,9,.000,4,7,.571,3,5,8,7,6,0,8,15,8,-0.3
11309,Michael Sohikish\michael-sohikish-1,2017-18,San Diego State,G,11,0,27,3,9,.333,3,5,.600,0,4,.000,2,4,.500,0,2,2,2,2,0,2,3,8,0.3
11310,Ethan Wilmoth\ethan-wilmoth-1,2013-14,North Carolina-Asheville,G,16,0,64,3,9,.333,2,2,1.000,1,7,.143,1,3,.333,2,3,5,1,3,0,3,15,8,-0.1
11311,Johnny Trueblood\johnny-trueblood-1,2015-16,Nebraska,G,10,0,28,2,5,.400,1,4,.250,1,1,1.000,3,6,.500,0,2,2,4,1,0,1,0,8,0.8
11312,Stan Mays\stan-mays-1,2013-14,Texas Tech,G,6,0,14,3,6,.500,1,1,1.000,2,5,.400,0,0,,1,0,1,1,1,0,0,0,8,1.2
11313,Jonathan Wilfong\jonathan-wilfong-1,2015-16,Southern Methodist,G,17,1,59,3,11,.273,1,5,.200,2,6,.333,0,1,.000,1,4,5,2,1,0,3,8,8,0.0
11314,Lawson Schaffer\lawson-schaffer-1,2017-18,Alabama,G,14,0,56,3,11,.273,1,1,1.000,2,10,.200,0,0,,0,0,0,13,5,0,8,7,8,0.3
11315,Makai Mason\makai-mason-1,2017-18,Yale,G,1,0,21,2,6,.333,0,3,.000,2,3,.667,2,5,.400,0,0,0,1,0,0,1,0,8,3.1
11316,Khalil Bedart-Ghani\khaliq-bedart-ghani-1,2015-16,San Diego,G,16,0,59,3,17,.176,3,12,.250,0,5,.000,2,6,.333,8,12,20,3,6,2,7,8,8,0.3
11317,Charlie Tooley\charlie-tooley-1,2017-18,Nevada,G,17,0,17,2,12,.167,0,1,.000,2,11,.182,2,2,1.000,1,0,1,0,1,0,3,6,8,-0.2
11318,Xavier Cochran\xavier-cochran-1,2017-18,Albany (NY),G,13,0,51,3,9,.333,3,7,.429,0,2,.000,2,4,.500,0,3,3,1,1,0,4,6,8,-0.1
11319,Chris Ross\chris-ross-2,2016-17,Citadel,G,2,0,8,3,6,.500,1,2,.500,2,4,.500,0,0,,1,0,1,0,0,0,0,0,8,2.9
11320,Duane Gibson\duane-gibson-1,2015-16,Evansville,G,4,0,57,4,7,.571,4,7,.571,0,0,,0,1,.000,0,7,7,8,2,1,5,12,8,1.2
11321,Lyle Sutton\lyle-sutton-1,2017-18,Idaho State,G,16,0,35,2,9,.222,2,4,.500,0,5,.000,4,8,.500,1,1,2,2,2,0,2,11,8,-0.1
11322,Stephen Toyra\stephen-toyra-1,2015-16,Purdue,G,11,0,26,2,4,.500,2,2,1.000,0,2,.000,4,5,.800,1,3,4,4,0,0,5,5,8,0.3
11323,Kievyn Lila-St. Rose\kievyn-lila-st-rose-1,2014-15,Norfolk State,G,11,0,61,3,11,.273,2,2,1.000,1,9,.111,1,1,1.000,0,9,9,3,2,1,4,7,8,0.2
11324,John Guerra\john-guerra-1,2016-17,North Carolina Central,G,11,0,22,0,1,.000,0,1,.000,0,0,,8,10,.800,4,2,6,1,1,0,1,4,8,0.8
11325,David Travers\david-travers-1,2014-15,Georgia State,G,4,0,20,2,2,1.000,0,0,,2,2,1.000,2,3,.667,0,2,2,1,1,0,2,2,8,1.6
11326,Chris Crawford\chris-crawford-4,2015-16,Oral Roberts,G,5,0,40,3,4,.750,3,3,1.000,0,1,.000,2,3,.667,1,3,4,2,3,0,2,1,8,1.9
11327,Zach Young\zach-young-1,2017-18,Nicholls State,G,15,0,53,1,10,.100,1,5,.200,0,5,.000,6,8,.750,0,5,5,8,4,0,5,5,8,0.3
11328,Hunter Hale\hunter-hale-1,2015-16,Central Michigan,G,11,0,13,3,5,.600,1,1,1.000,2,4,.500,0,0,,0,4,4,1,0,0,1,3,8,0.5
11329,Ryder Bowline\ryder-bowline-1,2013-14,Elon,G,4,0,8,3,5,.600,1,1,1.000,2,4,.500,0,1,.000,0,0,0,0,0,0,1,2,8,0.9
11330,Charles Taylor\charles-taylor-1,2016-17,Jackson State,G,2,0,14,2,2,1.000,2,2,1.000,0,0,,4,4,1.000,1,0,1,1,1,1,1,3,8,4.2
11331,Alec Monson\alec-monson-1,2016-17,Portland,G,6,0,24,3,9,.333,1,4,.250,2,5,.400,0,0,,1,2,3,2,1,0,0,3,8,0.9
11332,Trey Christopher\trey-christopher-1,2017-18,Savannah State,G,4,0,23,3,10,.300,1,5,.200,2,5,.400,0,0,,2,1,3,2,0,0,5,3,8,-0.2
11333,Adam Giles\adam-giles-1,2016-17,Wright State,G,7,0,17,3,6,.500,2,5,.400,1,1,1.000,1,2,.500,0,0,0,0,1,0,2,0,8,0.5
11334,Cameron Smith\cameron-smith-1,2014-15,Dartmouth,G,16,0,53,3,13,.231,2,9,.222,1,4,.250,1,3,.333,1,3,4,2,1,0,2,7,8,-0.1
11335,Christian Pino\christian-pino-1,2016-17,Buffalo,G,7,1,19,2,11,.182,2,6,.333,0,5,.000,4,4,1.000,0,4,4,4,2,0,4,5,8,0.2
11336,Barry Cheaney\barry-cheaney-1,2015-16,Nevada-Las Vegas,G,8,1,48,2,6,.333,1,2,.500,1,4,.250,3,5,.600,0,3,3,2,1,0,0,8,8,0.5
11337,Larry Bush\larry-bush-1,2016-17,Nevada-Las Vegas,G,10,0,38,2,10,.200,0,4,.000,2,6,.333,2,4,.500,0,1,1,1,0,0,1,6,8,-0.1
11338,Patrick Lucas-Perry\patrick-lucas-perry-1,2013-14,Pennsylvania,G,5,0,40,2,11,.182,1,2,.500,1,9,.111,3,4,.750,2,3,5,2,1,0,3,3,8,0.2
11339,Hayes Garrity\hayes-garrity-1,2017-18,Idaho State,G,12,1,43,3,8,.375,1,1,1.000,2,7,.286,0,0,,0,5,5,4,0,0,5,8,8,0.0
11340,Varun Ram\varum-ram-1,2014-15,Maryland,G,21,0,57,0,5,.000,0,1,.000,0,4,.000,8,8,1.000,0,5,5,3,3,0,6,8,8,0.1
11341,Paddy Quinn\paddy-quinn-1,2013-14,Columbia,G,8,0,15,2,2,1.000,2,2,1.000,0,0,,4,4,1.000,0,1,1,0,0,0,1,2,8,0.7
11342,Domas Budrys\domas-budrys-1,2016-17,Austin Peay,G,5,0,28,2,7,.286,0,1,.000,2,6,.333,2,2,1.000,0,1,1,0,2,0,2,3,8,0.6
11343,Desmond Maxwell\desmond-maxwell-1,2013-14,San Diego State,G,4,0,9,3,7,.429,1,3,.333,2,4,.500,0,0,,0,3,3,2,0,1,0,0,8,1.8
11344,Jack Westerfield\jack-westerfield-1,2017-18,Dayton,G,10,0,46,2,9,.222,0,2,.000,2,7,.286,2,2,1.000,1,1,2,0,2,0,0,2,8,0.5
11345,Mateen Hirbod\mateen-hirbod-1,2016-17,Houston,G,8,0,13,2,5,.400,1,2,.500,1,3,.333,3,4,.750,1,0,1,1,0,0,1,1,8,0.6
11346,Dan Peera\dan-peera-1,2013-14,Rice,G,25,0,129,3,13,.231,1,4,.250,2,9,.222,0,2,.000,1,13,14,8,0,0,5,21,8,-0.2
11347,Maurice O'Field\maurice-ofield-1,2016-17,Arizona State,G,10,0,47,4,7,.571,4,6,.667,0,1,.000,0,0,,3,3,6,4,1,0,1,4,8,0.9
11348,Quinn Sterling\quinn-sterling-1,2013-14,Washington,G,7,0,15,1,1,1.000,0,0,,1,1,1.000,5,6,.833,0,3,3,1,1,0,2,1,8,1.1
11349,Josh Bougher\josh-bougher-1,2014-15,Tennessee Tech,G,6,0,22,3,9,.333,2,5,.400,1,4,.250,1,1,1.000,1,3,4,1,1,0,0,2,8,0.9
11350,Ben Marcus\ben-marcus-1,2015-16,Little Rock,G,9,0,16,4,6,.667,4,6,.667,0,0,,0,0,,0,2,2,0,1,2,1,1,8,0.8
11351,Tim Hart\tim-hart-1,2016-17,South Carolina Upstate,G,8,0,60,2,12,.167,0,4,.000,2,8,.250,2,2,1.000,2,2,4,4,4,0,4,5,8,0.4
11352,Michael Simpson\michael-simpson-1,2013-14,Missouri State,G,12,0,43,3,15,.200,1,6,.167,2,9,.222,0,0,,1,2,3,3,1,1,0,2,8,0.3
11353,Luke Walker\luke-walker-1,2016-17,Louisiana Tech,G,14,0,33,4,12,.333,4,12,.333,0,0,,0,2,.000,1,5,6,0,0,0,3,3,8,-0.1
11354,Christian Peevy\christian-peevy-1,2016-17,Incarnate Word,G,3,0,25,3,9,.333,3,9,.333,0,0,,2,2,1.000,3,1,4,1,0,0,5,2,8,0.1
11355,Xzavier Barmore\xzavier-barmore-1,2016-17,Liberty,G,17,0,53,4,16,.250,4,12,.333,0,4,.000,0,0,,1,4,5,11,2,0,4,9,8,0.1
11356,Jordan McRae\jordan-mcrae-2,2016-17,Binghamton,G,15,0,49,4,12,.333,4,12,.333,0,0,,0,0,,3,5,8,2,0,2,2,6,8,0.2
11357,Jared Norsworthy\jared-norsworthy-1,2013-14,Howard,G,16,0,39,2,7,.286,2,5,.400,0,2,.000,4,9,.444,0,6,6,1,2,0,2,1,8,0.3
11358,Matt Erps\matt-erps-1,2017-18,Winthrop,G,15,0,29,2,4,.500,2,4,.500,0,0,,4,4,1.000,1,4,5,5,1,0,8,4,8,0.2
11359,Tyrone Hughes\tyrone-hughes-1,2013-14,West Virginia,G,8,0,21,3,7,.429,3,3,1.000,0,4,.000,2,3,.667,1,0,1,0,1,0,2,4,8,0.3
11360,Kyren Block\kyren-block-1,2016-17,Houston Baptist,G,5,0,20,3,8,.375,3,7,.429,0,1,.000,2,7,.286,8,7,15,1,0,1,1,2,8,1.8
11361,Spencer Rivers\spencer-rivers-1,2015-16,UC-Irvine,G,10,0,18,2,7,.286,0,1,.000,2,6,.333,2,7,.286,0,2,2,1,2,0,3,2,8,0.1
11362,Trey Pettus\trey-pettus-1,2015-16,Butler,G,10,0,41,2,8,.250,0,4,.000,2,4,.500,2,4,.500,1,5,6,6,1,0,0,2,8,0.9
11363,Devon Carter\devon-carter-1,2013-14,Lehigh,G,12,0,30,3,11,.273,3,8,.375,0,3,.000,2,2,1.000,2,6,8,0,0,0,1,3,8,0.2
11364,Charles Rushman\charles-rushman-1,2014-15,Nevada-Las Vegas,G,5,0,16,3,5,.600,3,4,.750,0,1,.000,2,2,1.000,0,1,1,2,1,0,0,3,8,1.4
11365,Robert Cid\robert-cid-1,2014-15,Cal State Northridge,G,10,0,19,2,7,.286,1,3,.333,1,4,.250,3,4,.750,1,1,2,0,1,0,2,5,8,0.2
11366,Malcolm Walters\malcolm-walters-1,2014-15,Akron,G,14,0,59,2,11,.182,1,4,.250,1,7,.143,3,8,.375,1,6,7,5,1,1,8,10,8,-0.4
11367,John Rinaldi\john-rinaldi-1,2014-15,Binghamton,G,19,0,98,2,7,.286,2,7,.286,0,0,,4,7,.571,7,6,13,3,5,1,3,12,8,0.5
11368,Allen Jiles\allen-jiles-1,2013-14,Idaho,G,14,0,74,3,6,.500,3,5,.600,0,1,.000,2,5,.400,4,5,9,5,2,0,8,12,8,0.1
11369,Trevor Osborn\trevor-osborn-1,2016-17,Purdue-Fort Wayne,G,6,0,22,1,8,.125,0,3,.000,1,5,.200,5,6,.833,0,2,2,2,1,0,2,0,8,0.6
11370,Logan Koch\logan-koch-1,2016-17,Eastern Illinois,G,14,0,65,3,17,.176,1,7,.143,2,10,.200,0,0,,0,4,4,11,3,0,5,9,8,0.0
11371,Dillon Reppart\dillon-reppart-1,2017-18,East Tennessee State,G,8,0,31,2,8,.250,0,3,.000,2,5,.400,2,5,.400,5,2,7,3,1,0,1,6,8,0.7
11372,Adrian Autry\adrian-autry-1,2016-17,Syracuse,G,12,0,17,3,9,.333,1,2,.500,2,7,.286,0,1,.000,0,3,3,0,2,0,0,1,8,0.4
11373,Glorind Lisha\glorind-lisha-1,2016-17,Loyola (IL),G,11,0,24,2,10,.200,2,5,.400,0,5,.000,4,5,.800,2,1,3,0,1,0,2,2,8,0.1
11374,Damarcus Croaker\damarcus-croaker-1,2014-15,Texas,G,5,0,47,3,10,.300,1,1,1.000,2,9,.222,0,0,,2,3,5,3,0,0,3,2,8,0.6
11375,Dontelius Ross\dontelius-ross-1,2017-18,Jackson State,G,2,2,44,2,7,.286,0,2,.000,2,5,.400,2,4,.500,0,0,0,5,0,0,3,5,8,0.8
11376,Andrew Bargmann\andrew-bargmann-1,2014-15,Colgate,G,4,0,13,3,5,.600,2,2,1.000,1,3,.333,1,1,1.000,0,1,1,1,2,0,2,0,8,1.7
11377,Eli Sample\eli-sample-1,2016-17,Southeast Missouri State,G,16,0,42,3,8,.375,1,4,.250,2,4,.500,0,0,,0,0,0,3,1,0,4,4,8,0.1
11378,Raul Frias\raul-frias-1,2015-16,Long Island University,G,18,0,86,3,16,.188,1,6,.167,2,10,.200,0,0,,5,6,11,4,3,2,6,10,8,0.0
11379,Grant Gibb\grant-gibb-1,2016-17,Eastern Washington,G,9,0,14,2,3,.667,2,3,.667,0,0,,4,7,.571,1,3,4,0,1,1,2,1,8,0.7
11380,Lawson Schaffer\lawson-schaffer-1,2015-16,Alabama,G,15,0,32,2,10,.200,0,1,.000,2,9,.222,2,4,.500,2,0,2,2,1,0,1,3,8,0.2
11381,Joshua Ko\joshua-ko-1,2017-18,Florida Gulf Coast,G,12,0,27,3,16,.188,1,9,.111,2,7,.286,0,0,,1,6,7,0,2,0,2,0,8,0.0
11382,Bryson Robinson\bryson-robinson-1,2016-17,New Orleans,G,15,0,60,2,9,.222,0,3,.000,2,6,.333,2,4,.500,2,4,6,4,1,0,8,4,8,-0.1
11383,Eric Dadika\eric-dadika-1,2017-18,Rhode Island,G,13,0,25,3,8,.375,1,4,.250,2,4,.500,0,0,,0,2,2,0,1,0,2,2,8,0.2
11384,Jay Jay Davis\jayjay-davis-1,2016-17,Lehigh,G,12,0,30,2,9,.222,2,3,.667,0,6,.000,4,4,1.000,0,3,3,2,2,1,4,2,8,0.2
11385,Daniel Pillari\daniel-pillari-1,2017-18,Monmouth,G,8,1,17,1,2,.500,0,0,,1,2,.500,5,6,.833,0,1,1,2,0,0,2,2,8,0.7
11386,Justin Jordan\justin-jordan-2,2015-16,Milwaukee,G,4,0,63,4,13,.308,4,11,.364,0,2,.000,0,0,,0,5,5,2,1,0,7,3,8,-1.0
11387,Werner Nistler\werner-nistler-1,2015-16,Santa Clara,G,16,1,74,0,8,.000,0,4,.000,0,4,.000,8,10,.800,1,7,8,8,2,0,9,7,8,0.0
11388,Connor McCaffery\connor-mccaffery-1,2017-18,Iowa,G,4,0,53,2,3,.667,1,1,1.000,1,2,.500,3,4,.750,0,4,4,7,2,0,4,2,8,2.4
11389,Georgios Pilitsis\georgios-pilitsis-1,2014-15,Lehigh,G,4,0,14,2,4,.500,0,0,,2,4,.500,2,2,1.000,0,2,2,3,1,1,0,2,8,2.4
11390,Hank Davis\hank-davis-1,2016-17,La Salle,G,7,1,12,1,4,.250,1,2,.500,0,2,.000,6,7,.857,0,0,0,1,0,0,3,1,8,0.4
11391,Staats Battle\staats-battle-1,2014-15,North Carolina State,G,5,0,11,3,8,.375,1,1,1.000,2,7,.286,0,0,,2,1,3,0,0,0,0,3,8,0.8
11392,Daniel Hummer\daniel-hummer-1,2015-16,Air Force,G,10,0,38,2,9,.222,0,1,.000,2,8,.250,2,2,1.000,1,1,2,4,2,0,3,9,8,0.2
11393,Tre Cobbs\tre-cobbs-1,2016-17,Northern Kentucky,G,8,0,15,2,3,.667,1,2,.500,1,1,1.000,3,4,.750,0,0,0,1,1,0,4,5,8,0.3
11394,Earnest Jones\earnest-jones-2,2016-17,South Carolina State,G,15,0,27,2,4,.500,2,3,.667,0,1,.000,4,4,1.000,1,2,3,1,0,0,1,1,8,0.4
11395,Ba'shawn Mickens\bashawn-mickens-1,2014-15,Monmouth,G,12,0,14,3,5,.600,1,1,1.000,2,4,.500,0,0,,0,0,0,1,0,0,1,0,8,0.5
11396,Koh Flippin\koh-flippin-1,2015-16,UC-Riverside,G,4,0,14,3,5,.600,2,3,.667,1,2,.500,1,2,.500,0,1,1,2,4,0,3,3,8,1.7
11397,Scott Adler\scott-adler-1,2013-14,Air Force,G,9,0,32,3,6,.500,3,3,1.000,0,3,.000,2,5,.400,2,3,5,3,0,1,0,1,8,0.9
11398,Josh Webster\josh-webster-1,2017-18,Texas Tech,G,25,0,145,3,20,.150,3,15,.200,0,5,.000,2,6,.333,3,14,17,19,5,0,7,7,8,0.3
11399,Ausar Madison\ausar-madison-1,2014-15,Howard,G,4,0,37,3,7,.429,1,4,.250,2,3,.667,0,1,.000,2,4,6,7,3,0,3,4,8,2.5
11400,Micheal Odiana\micheal-odiana-1,2017-18,Maryland-Eastern Shore,G,18,0,65,3,10,.300,1,3,.333,2,7,.286,0,0,,2,1,3,2,3,0,2,8,8,0.2
11401,Clyde Smith\clyde-smith-1,2013-14,Texas Christian,G,16,0,44,3,6,.500,2,4,.500,1,2,.500,1,2,.500,1,3,4,4,1,1,4,5,8,0.3
11402,Richard Brown\richard-brown-2,2016-17,Army,G,16,1,70,3,8,.375,3,5,.600,0,3,.000,2,4,.500,8,7,15,5,3,1,6,7,8,0.6
11403,Will Macoy\will-macoy-1,2016-17,Auburn,G,4,0,8,3,6,.500,1,1,1.000,2,5,.400,0,0,,0,1,1,0,1,0,0,0,8,1.6
11404,Cameron Smith\cameron-smith-1,2016-17,Dartmouth,G,11,0,39,2,10,.200,1,5,.200,1,5,.200,3,4,.750,0,3,3,3,0,0,3,5,8,-0.1
11405,Sam Hershberger\sam-hershberger-1,2014-15,Elon,G,5,0,15,2,3,.667,1,1,1.000,1,2,.500,3,3,1.000,1,3,4,3,1,0,0,4,8,2.0
11406,Kevin Kaspar\kevin-kaspar-1,2014-15,Western Kentucky,G,4,0,40,2,9,.222,0,2,.000,2,7,.286,2,2,1.000,0,2,2,3,1,0,1,3,8,1.0
11407,Mason Wedel\mason-wedel-1,2014-15,Missouri-Kansas City,G,7,0,55,2,9,.222,0,1,.000,2,8,.250,2,2,1.000,4,1,5,4,4,0,3,6,8,1.0
11408,Tyler Akers\tyler-akers-1,2014-15,Longwood,G,11,1,23,2,6,.333,1,1,1.000,1,5,.200,3,4,.750,1,1,2,1,0,0,3,1,8,0.2
11409,Matt Cullen\matt-cullen-1,2017-18,Navy,G,6,0,21,3,5,.600,1,1,1.000,2,4,.500,0,0,,0,0,0,4,1,0,1,2,8,1.3
11410,Edmond Sumner\edmond-sumner-1,2014-15,Xavier,G,6,0,43,2,10,.200,2,7,.286,0,3,.000,4,6,.667,2,3,5,6,2,0,5,9,8,0.2
11411,Jonathan Wilfong\jonathan-wilfong-1,2016-17,Southern Methodist,G,22,1,73,4,12,.333,4,8,.500,0,4,.000,0,0,,0,9,9,3,1,0,5,8,8,-0.1
11412,Patrick Ramsey\patrick-ramsey-1,2013-14,Marist,G,9,1,17,3,6,.500,1,2,.500,2,4,.500,0,1,.000,1,1,2,0,0,0,0,1,8,0.6
11413,Austin Rogers\austin-rogers-1,2016-17,Alabama State,G,7,2,75,2,13,.154,1,6,.167,1,7,.143,3,3,1.000,2,6,8,5,2,0,4,8,8,0.2
11414,Thorir Thorbjarnarson\thorir-thorbjarnarson-1,2017-18,Nebraska,G,9,0,19,3,7,.429,1,2,.500,2,5,.400,0,0,,1,3,4,3,1,0,1,4,8,0.7
11415,Brad Calipari\brad-calipari-1,2016-17,Kentucky,G,15,0,45,2,13,.154,0,1,.000,2,12,.167,2,5,.400,1,2,3,1,0,1,2,3,8,-0.1
11416,Jack Bentz\jack-bentz-1,2014-15,Wyoming,G,22,1,183,2,18,.111,2,12,.167,0,6,.000,4,6,.667,1,18,19,25,4,0,6,8,8,0.6
11417,Kajon Mack\kajon-mack-1,2015-16,Tulane,G,5,0,51,4,15,.267,4,12,.333,0,3,.000,0,3,.000,0,9,9,7,3,0,3,4,8,0.8
11418,Marlon Stewart\marlon-stewart-1,2015-16,Creighton,G,13,0,40,3,13,.231,2,7,.286,1,6,.167,0,0,,1,2,3,0,0,0,2,1,7,-0.2
11419,James Pyle\james-pyle-1,2016-17,Southern Methodist,G,12,0,17,3,6,.500,2,3,.667,1,3,.333,0,0,,1,3,4,0,1,0,2,1,7,0.4
11420,Steve Leonard\steve-leonard-1,2017-18,Temple,G,5,1,10,2,4,.500,0,1,.000,2,3,.667,1,2,.500,0,2,2,0,0,1,1,0,7,1.0
11421,Nnamdi Van Dulm\nnamdi-vandulm-1,2017-18,North Dakota State,G,6,0,41,3,7,.429,3,6,.500,0,1,.000,1,3,.333,0,10,10,6,1,0,2,1,7,1.4
11422,Jay Parker\jay-parker-1,2014-15,Illinois-Chicago,G,5,1,44,1,10,.100,1,8,.125,0,2,.000,5,6,.833,1,3,4,5,2,0,4,3,7,0.4
11423,Riley McGillan\riley-mcgillan-1,2015-16,Clemson,G,6,0,12,2,4,.500,0,0,,2,4,.500,1,2,.500,0,0,0,1,0,0,1,2,7,0.6
11424,Matt Hein\matt-hein-1,2016-17,Illinois State,G,14,0,30,2,7,.286,1,3,.333,1,4,.250,2,2,1.000,0,3,3,0,1,1,3,5,7,0.0
11425,Jonathan Wilfong\jonathan-wilfong-1,2014-15,Southern Methodist,G,7,0,22,3,6,.500,3,4,.750,0,2,.000,1,2,.500,2,1,3,1,1,0,2,1,7,0.7
11426,Tyre Moore\tyre-moore-1,2015-16,Mercer,G,17,0,29,2,7,.286,1,1,1.000,1,6,.167,2,2,1.000,0,5,5,0,0,0,1,4,7,0.1
11427,Kaelen Malone\kaelen-malone-1,2016-17,Wichita State,G,16,0,33,3,9,.333,3,6,.500,0,3,.000,1,2,.500,2,3,5,3,0,0,2,3,7,0.2
11428,Sina Gbadebo\sina-gbadebo-1,2017-18,Akron,G,17,0,76,3,8,.375,2,3,.667,1,5,.200,0,1,.000,3,4,7,6,0,0,5,7,7,0.1
11429,Tyler Underwood\tyler-underwood-1,2016-17,Oklahoma State,G,11,0,30,2,4,.500,0,0,,2,4,.500,1,2,.500,0,2,2,1,2,1,4,2,7,0.3
11430,L.J. Rose\lj-rose-2,2015-16,Houston,G,2,0,27,2,6,.333,0,1,.000,2,5,.400,1,2,.500,0,2,2,4,0,0,0,2,7,2.9
11431,Torey Burston\torey-burston-1,2014-15,Virginia Commonwealth,G,14,0,35,1,5,.200,0,1,.000,1,4,.250,4,6,.667,0,4,4,6,3,0,0,3,7,0.7
11432,Landon Goesling\landon-goesling-1,2015-16,Appalachian State,G,3,0,20,2,5,.400,2,4,.500,0,1,.000,3,6,.500,0,3,3,0,0,0,2,2,7,0.4
11433,Bassel Harfouch\bassel-harfouch-1,2014-15,Alcorn State,G,7,0,43,3,14,.214,2,5,.400,1,9,.111,0,0,,2,7,9,0,1,0,2,0,7,0.1
11434,Torey Burston\torey-burston-1,2016-17,Virginia Commonwealth,G,10,0,54,2,11,.182,2,9,.222,0,2,.000,3,5,.600,2,6,8,4,2,0,4,3,7,0.2
11435,Brad Woodson\brad-woodson-1,2016-17,Tennessee,G,5,0,14,2,7,.286,1,3,.333,1,4,.250,2,2,1.000,0,0,0,1,1,1,0,1,7,1.0
11436,Jacob Casper\jacob-casper-1,2014-15,North Carolina-Asheville,G,7,0,25,3,5,.600,2,2,1.000,1,3,.333,0,0,,1,3,4,1,0,0,1,1,7,0.8
11437,Curtis Lochner\curtis-lochner-1,2016-17,Delaware,G,10,0,33,2,7,.286,1,3,.333,1,4,.250,2,2,1.000,0,1,1,2,0,0,3,4,7,0.0
11438,Steven Ferrarini\steven-ferrarini-1,2013-14,Creighton,G,7,0,18,2,6,.333,2,3,.667,0,3,.000,3,3,1.000,0,1,1,2,0,0,0,0,7,0.8
11439,Jalen Sanders\jalen-sanders-1,2014-15,Appalachian State,G,7,0,25,3,8,.375,2,5,.400,1,3,.333,0,0,,0,2,2,4,0,0,2,1,7,0.5
11440,Jerrold Smith\jerrold-smith-1,2016-17,UCLA,G,12,0,25,3,11,.273,3,9,.333,0,2,.000,1,2,.500,0,0,0,1,2,0,2,5,7,-0.1
11441,Gregory Hayden\gregory-hayden-1,2013-14,Hampton,G,5,0,13,2,4,.500,1,3,.333,1,1,1.000,2,2,1.000,1,0,1,0,0,0,2,2,7,0.6
11442,Devin Waddell\devin-waddell-1,2016-17,Auburn,G,10,0,75,2,6,.333,0,2,.000,2,4,.500,1,3,.333,1,5,6,3,0,0,3,6,7,0.2
11443,Jay Jay Davis\jayjay-davis-1,2015-16,Lehigh,G,11,0,19,2,7,.286,1,4,.250,1,3,.333,2,2,1.000,1,0,1,4,0,0,0,2,7,0.5
11444,Cole Renninger\cole-renninger-1,2014-15,Lehigh,G,12,0,23,2,9,.222,2,8,.250,0,1,.000,3,5,.600,2,2,4,2,0,0,0,5,7,0.2
11445,Tyrell Mason\tyrell-mason-1,2013-14,Virginia Military Institute,G,9,0,33,2,9,.222,1,5,.200,1,4,.250,2,2,1.000,3,5,8,2,2,0,4,2,7,0.4
11446,Danny Harris\danny-harris-1,2016-17,Bethune-Cookman,G,6,1,21,3,8,.375,3,4,.750,0,4,.000,1,3,.333,0,2,2,1,0,0,3,3,7,-0.2
11447,Kajon Brown\kajon-brown-1,2017-18,Brigham Young,G,9,0,39,2,4,.500,2,3,.667,0,1,.000,3,5,.600,1,0,1,1,2,0,4,8,7,0.0
11448,Zach Dickerson\zach-dickerson-1,2015-16,South Dakota,G,17,0,80,3,11,.273,2,6,.333,1,5,.200,0,0,,2,4,6,8,0,1,2,8,7,0.2
11449,Matt Chism\matt-chism-1,2017-18,Georgia State,G,13,0,19,3,3,1.000,3,3,1.000,0,0,,1,2,.500,0,2,2,1,0,0,1,1,7,0.4
11450,Jamie Chapman\jamie-chapman-1,2013-14,Southern Mississippi,G,14,0,26,1,8,.125,0,3,.000,1,5,.200,4,7,.571,0,2,2,1,3,0,5,4,7,-0.1
11451,Jared Klein\jared-klein-1,2014-15,Western Michigan,G,10,0,53,3,7,.429,3,6,.500,0,1,.000,1,2,.500,0,1,1,1,2,0,0,1,7,0.6
11452,Tanner Tapp\tanner-tapp-1,2015-16,Samford,G,6,0,9,3,6,.500,2,3,.667,1,3,.333,0,0,,0,1,1,2,0,0,1,1,7,0.7
11453,Doug Chappell\doug-chappell-1,2014-15,Fairfield,G,5,0,32,2,13,.154,2,6,.333,0,7,.000,3,8,.375,0,1,1,0,1,0,3,4,7,-1.3
11454,Lance Whitaker\lance-whitaker-1,2016-17,Illinois-Chicago,G,9,2,77,2,11,.182,1,3,.333,1,8,.125,2,3,.667,2,6,8,6,2,0,1,12,7,0.4
11455,Patrick Ryan\patrick-ryan-1,2016-17,Elon,G,4,1,11,2,6,.333,1,2,.500,1,4,.250,2,2,1.000,0,2,2,0,0,0,0,1,7,1.0
11456,Joshua Ko\joshua-ko-1,2013-14,Pittsburgh,G,10,0,12,3,7,.429,2,4,.500,1,3,.333,0,0,,0,0,0,0,0,0,0,0,7,0.3
11457,Michael Gelineau\michael-gelineau-1,2013-14,Massachusetts-Lowell,G,1,0,9,2,6,.333,2,5,.400,0,1,.000,3,3,1.000,0,0,0,0,0,0,0,0,7,3.6
11458,Ge'Lawn Guyn\gelawn-guyn-1,2014-15,Cincinnati,G,2,2,43,3,13,.231,2,7,.286,1,6,.167,0,2,.000,1,3,4,3,0,0,1,4,7,-0.3
11459,Taqqi Muhammad\taqqi-muhammad-1,2016-17,North Carolina-Greensboro,G,4,0,21,2,3,.667,2,2,1.000,0,1,.000,3,4,.750,1,2,3,2,1,0,3,1,7,1.4
11460,Alex Paquin\alex-paquin-1,2014-15,American,G,13,0,48,3,8,.375,2,4,.500,1,4,.250,0,2,.000,1,4,5,0,1,0,5,8,7,-0.3
11461,Luke Adams\luke-adams-1,2014-15,Texas Tech,G,13,1,40,0,5,.000,0,3,.000,0,2,.000,7,9,.778,2,3,5,3,1,0,4,4,7,0.2
11462,John Rinaldi\john-rinaldi-1,2013-14,Binghamton,G,26,0,127,2,4,.500,2,3,.667,0,1,.000,3,8,.375,4,8,12,1,5,1,5,26,7,0.0
11463,Nana Akenten\nana-akenten-1,2017-18,Nebraska,G,7,0,21,2,9,.222,0,1,.000,2,8,.250,1,2,.500,1,1,2,0,0,0,0,0,7,0.3
11464,Matt Risse\matt-risse-1,2015-16,James Madison,G,8,0,19,3,3,1.000,2,2,1.000,1,1,1.000,0,0,,0,2,2,0,0,0,0,3,7,0.7
11465,Joey Lane\joey-lane-1,2016-17,Ohio State,G,4,0,12,2,5,.400,0,1,.000,2,4,.500,1,2,.500,0,2,2,0,1,0,2,0,7,0.9
11466,Zach Young\zach-young-1,2014-15,Nicholls State,G,17,8,180,1,13,.077,1,9,.111,0,4,.000,5,10,.500,2,8,10,19,2,0,14,11,7,-0.2
11467,ZaQwaun Matthews\zaqwaun-matthews-1,2015-16,Chattanooga,G,10,0,36,3,11,.273,2,6,.333,1,5,.200,0,2,.000,2,3,5,8,0,0,3,2,7,0.4
11468,Kyle Denning\kyle-denning-1,2014-15,Iowa,G,9,0,25,3,7,.429,2,2,1.000,1,5,.200,0,0,,1,1,2,1,1,0,1,1,7,0.5
11469,Connor Rufo\connor-rufo-1,2017-18,Delaware,G,13,0,27,2,5,.400,2,4,.500,0,1,.000,3,4,.750,2,4,6,3,0,0,0,4,7,0.5
11470,Jordan Hill\jordan-hill-2,2013-14,Wisconsin,G,11,0,25,1,7,.143,0,3,.000,1,4,.250,4,7,.571,1,2,3,1,0,0,2,5,7,-0.1
11471,Parker Hicks\parker-hicks-1,2017-18,Texas Tech,G,9,0,19,2,3,.667,1,1,1.000,1,2,.500,2,4,.500,0,1,1,1,1,1,1,4,7,0.6
11472,Tourron Whitfield\tourron-whitfield-1,2014-15,Marist,G,15,2,32,1,5,.200,0,1,.000,1,4,.250,4,4,1.000,0,1,1,1,0,0,1,5,7,0.1
11473,Najee Fitzgerald\najee-fitzgerald-1,2017-18,Maryland-Eastern Shore,G,21,3,98,2,5,.400,2,4,.500,0,1,.000,3,5,.600,5,7,12,3,1,0,5,13,7,0.1
11474,Trevis Jackson\trevis-jackson-1,2014-15,Sacramento State,G,12,0,25,2,5,.400,1,3,.333,1,2,.500,2,2,1.000,0,2,2,3,3,0,1,2,7,0.7
11475,Derrick Alston\derrick-alston-2,2017-18,Boise State,G,11,0,26,3,7,.429,2,5,.400,1,2,.500,0,2,.000,1,5,6,2,1,0,3,0,7,0.4
11476,James Boone\james-boone-1,2016-17,Samford,G,6,0,43,2,8,.250,1,3,.333,1,5,.200,2,4,.500,2,3,5,5,2,0,3,4,7,0.8
11477,Taylor Sutlive\taylor-sutlive-1,2016-17,Cal Poly,G,11,0,46,3,10,.300,2,2,1.000,1,8,.125,0,0,,1,9,10,0,0,2,2,7,7,0.1
11478,Brad Woodson\brad-woodson-1,2015-16,Tennessee,G,10,0,63,2,14,.143,1,5,.200,1,9,.111,2,2,1.000,3,5,8,3,1,0,2,6,7,0.0
11479,Eli Robison\eli-robison-1,2013-14,Utah Valley,G,12,0,34,3,9,.333,3,6,.500,0,3,.000,1,3,.333,3,2,5,1,0,1,4,9,7,-0.2
11480,Hunter Reynolds\hunter-reynolds-1,2017-18,Alabama-Birmingham,G,10,0,19,3,3,1.000,2,2,1.000,1,1,1.000,0,0,,1,2,3,2,1,0,1,1,7,0.8
11481,Jace Chacon\jace-chacon-1,2015-16,Air Force,G,4,0,11,3,4,.750,3,3,1.000,0,1,.000,1,1,1.000,0,2,2,0,0,0,1,0,7,1.3
11482,Dalton Dry\dalton-dry-1,2016-17,Texas Christian,G,13,0,27,2,8,.250,0,4,.000,2,4,.500,1,4,.250,1,2,3,2,1,0,1,2,7,0.2
11483,James Long\james-long-1,2014-15,West Virginia,G,10,0,21,3,6,.500,2,3,.667,1,3,.333,0,0,,1,1,2,0,0,0,0,2,7,0.4
11484,Brooks Doyle\brooks-doyle-1,2013-14,Georgia Tech,G,8,0,36,3,9,.333,2,3,.667,1,6,.167,0,0,,0,4,4,3,0,0,2,7,7,0.1
11485,Rem Bakamus\rem-bakamus-1,2015-16,Gonzaga,G,15,0,30,1,5,.200,0,1,.000,1,4,.250,4,6,.667,1,8,9,2,4,0,2,1,7,0.6
11486,Bass Ollie\bass-ollie-1,2017-18,Detroit Mercy,G,6,0,24,2,5,.400,1,4,.250,1,1,1.000,2,4,.500,0,4,4,2,2,0,1,0,7,1.2
11487,Joshua Ko\joshua-ko-1,2016-17,Florida Gulf Coast,G,5,0,19,3,8,.375,2,3,.667,1,5,.200,0,2,.000,0,5,5,5,2,0,2,1,7,1.3
11488,Maverick Smith\maverick-smith-1,2017-18,Tennessee Tech,G,8,0,26,2,5,.400,1,2,.500,1,3,.333,2,2,1.000,0,2,2,1,2,0,0,0,7,1.0
11489,Tyrell Henderson\tyrell-henderson-1,2016-17,Portland State,G,11,0,36,3,13,.231,2,10,.200,1,3,.333,0,0,,2,5,7,3,2,0,2,4,7,0.2
11490,Ryder Bowline\ryder-bowline-1,2014-15,Elon,G,3,0,10,3,5,.600,2,2,1.000,1,3,.333,0,1,.000,1,2,3,0,0,0,1,1,7,1.4
11491,Brandon Danowski\brandon-danowski-1,2017-18,Northern Illinois,G,9,0,16,2,2,1.000,1,1,1.000,1,1,1.000,2,3,.667,0,2,2,1,1,0,3,1,7,0.5
11492,Reed McConnell\reed-mcconnell-1,2014-15,UC-Irvine,G,12,0,44,3,11,.273,2,7,.286,1,4,.250,0,1,.000,0,3,3,3,0,0,1,6,7,0.0
11493,Trevor Glassman\trevor-glassman-1,2014-15,Manhattan,G,11,2,26,2,11,.182,0,0,,2,11,.182,1,2,.500,1,0,1,0,0,0,2,6,7,-0.4
11494,Ron Freeman\ron-freeman-1,2015-16,Kansas State,G,11,0,18,3,12,.250,3,5,.600,0,7,.000,1,2,.500,0,1,1,1,1,1,1,4,7,0.0
11495,Justin Moore\justin-moore-2,2017-18,Georgia Tech,G,8,0,110,3,18,.167,3,14,.214,0,4,.000,1,4,.250,0,7,7,10,4,0,14,11,7,-1.4
11496,Jevon Thomas\jevon-thomas-1,2016-17,Seton Hall,G,10,0,92,2,11,.182,1,8,.125,1,3,.333,2,9,.222,1,9,10,8,11,0,13,17,7,-0.3
11497,Johnathan Walker\johnathan-walker-1,2016-17,Delaware State,G,6,0,18,2,6,.333,2,5,.400,0,1,.000,3,6,.500,1,2,3,1,1,0,1,4,7,0.5
11498,Rob Vozenilek\rob-vozenilek-1,2013-14,Virginia,G,12,0,30,3,6,.500,2,4,.500,1,2,.500,0,1,.000,1,5,6,4,0,1,3,2,7,0.5
11499,Jamal Mitchell\jamal-mitchell-1,2014-15,North Carolina-Greensboro,G,3,0,32,2,5,.400,1,4,.250,1,1,1.000,2,2,1.000,1,0,1,2,0,0,0,5,7,1.5
11500,Bobby Perez\bobby-perez-1,2014-15,Wofford,G,7,0,15,2,4,.500,1,3,.333,1,1,1.000,2,4,.500,0,0,0,0,1,0,3,2,7,0.2
11501,Brandon Johnson\brandon-johnson-5,2016-17,Boston University,G,7,0,26,3,9,.333,2,2,1.000,1,7,.143,0,0,,1,3,4,0,0,0,1,3,7,0.2
11502,Daryl Fowlkes\daryl-fowlkes-1,2014-15,Hofstra,G,8,0,19,2,5,.400,1,4,.250,1,1,1.000,2,2,1.000,0,0,0,1,0,0,1,1,7,0.5
11503,Shavar Reynolds\shavar-reynolds-1,2017-18,Seton Hall,G,19,0,24,2,7,.286,1,5,.200,1,2,.500,2,2,1.000,1,4,5,1,1,0,2,5,7,0.1
11504,Luke Walker\luke-walker-1,2015-16,Louisiana Tech,G,11,0,21,2,7,.286,2,7,.286,0,0,,3,5,.600,1,4,5,1,2,0,1,5,7,0.3
11505,Adonis Saltes\adonis-saltes-1,2016-17,Southern Utah,G,5,0,8,0,2,.000,0,2,.000,0,0,,7,8,.875,2,1,3,0,0,0,3,3,7,0.5
11506,Kibret Woldemichael\kibret-woldemichael-1,2014-15,San Diego State,G,6,0,14,2,3,.667,0,0,,2,3,.667,1,2,.500,1,1,2,0,1,0,3,0,7,0.7
11507,Austin Eastman\austin-eastman-1,2014-15,Utah,G,19,0,40,1,6,.167,0,3,.000,1,3,.333,4,6,.667,2,4,6,0,2,1,3,4,7,0.2
11508,James King\james-king-1,2013-14,Texas A&M-Corpus Christi,G,21,1,105,3,21,.143,2,9,.222,1,12,.083,0,0,,2,6,8,5,1,0,3,21,7,-0.5
11509,Kamau Faines\kamau-faines-1,2014-15,Davidson,G,7,0,8,2,2,1.000,1,1,1.000,1,1,1.000,2,5,.400,0,0,0,0,0,0,1,0,7,0.6
11510,Desmond Fleming\desmond-fleming-1,2016-17,Cornell,G,22,1,86,3,5,.600,3,3,1.000,0,2,.000,1,2,.500,2,12,14,5,2,0,6,10,7,0.2
11511,Brett Bowling\brett-bowling-1,2015-16,Marshall,G,10,0,23,3,10,.300,2,2,1.000,1,8,.125,0,0,,1,1,2,1,0,0,2,3,7,0.0
11512,Tyler Williams\tyler-williams-2,2015-16,Brown,G,7,0,25,1,9,.111,0,6,.000,1,3,.333,4,6,.667,0,2,2,4,2,0,2,4,7,0.3
11513,Jake Bodway\jake-bodway-1,2014-15,South Florida,G,15,0,32,3,7,.429,2,6,.333,1,1,1.000,0,0,,0,0,0,1,1,0,2,4,7,0.1
11514,Jacob Gonzalez\jacob-gonzalez-1,2013-14,Houston Baptist,G,4,0,13,3,6,.500,2,3,.667,1,3,.333,0,0,,1,1,2,1,0,0,1,4,7,0.8
11515,Malcolm McMillan\malcolm-mcmillan-1,2014-15,Central Connecticut State,G,2,2,60,1,15,.067,0,8,.000,1,7,.143,4,4,1.000,1,6,7,7,1,1,5,7,7,-0.9
11516,Rod McReynolds\rod-mcreynolds-1,2013-14,Jacksonville State,G,6,0,22,3,7,.429,2,4,.500,1,3,.333,0,0,,0,0,0,3,1,0,6,2,7,-0.1
11517,Jarett Upchurch\jarett-upchurch-1,2013-14,Arizona State,G,6,0,8,3,3,1.000,2,2,1.000,1,1,1.000,0,0,,1,0,1,0,1,0,0,2,7,1.2
11518,Derek Armstrong\derek-armstrong-1,2015-16,Coppin State,G,10,0,33,3,7,.429,2,3,.667,1,4,.250,0,0,,2,2,4,1,1,0,0,0,7,0.7
11519,Maurice Coleman\maurice-coleman-1,2015-16,Maryland-Eastern Shore,G,10,0,33,1,3,.333,1,1,1.000,0,2,.000,5,6,.833,1,1,2,1,0,0,2,4,7,0.3
11520,Grant Vermeer\grant-vermeer-1,2016-17,Navy,G,7,1,25,3,5,.600,3,5,.600,0,0,,1,3,.333,1,2,3,3,3,0,3,2,7,0.9
11521,Khari Harley\khari-harley-1,2017-18,Little Rock,G,7,0,46,2,15,.133,1,10,.100,1,5,.200,2,3,.667,2,2,4,0,0,0,5,12,7,-1.6
11522,Andrew Bargmann\andrew-bargmann-1,2015-16,Colgate,G,4,0,19,3,5,.600,2,2,1.000,1,3,.333,0,0,,1,1,2,1,0,0,0,1,7,1.5
11523,Shawn Wilson\shawn-wilson-2,2017-18,Eastern Illinois,G,10,0,66,3,6,.500,3,5,.600,0,1,.000,1,3,.333,1,1,2,9,2,0,8,8,7,0.1
11524,Maxwell Lenox\maxwell-lenox-1,2015-16,Army,G,3,1,10,3,4,.750,3,3,1.000,0,1,.000,0,3,.000,0,7,7,0,1,2,0,0,6,2.6
11525,Dylan Livesay\dylan-livesay-1,2014-15,Oregon State,G,18,1,68,2,9,.222,0,2,.000,2,7,.286,0,0,,0,2,2,4,0,0,2,3,6,0.0
11526,Josh Burnett\josh-burnett-1,2015-16,Kennesaw State,G,8,0,17,2,8,.250,0,3,.000,2,5,.400,0,1,.000,1,1,2,0,1,0,1,3,6,0.1
11527,Jacob Van\jacob-van-1,2014-15,Air Force,G,7,0,20,2,5,.400,1,2,.500,1,3,.333,1,2,.500,1,3,4,2,1,0,1,0,6,0.8
11528,Chris Corchiani\chris-corchiani-2,2016-17,North Carolina State,G,5,0,7,2,6,.333,2,6,.333,0,0,,2,2,1.000,0,0,0,2,0,0,2,2,6,0.2
11529,A.J. Edwards\aj-edwards-1,2013-14,Yale,G,5,0,15,2,4,.500,1,1,1.000,1,3,.333,1,2,.500,0,1,1,1,0,0,1,0,6,0.7
11530,Liam McManimon\liam-mcmanimon-1,2013-14,Mount St. Mary's,G,14,1,62,1,9,.111,1,3,.333,0,6,.000,4,4,1.000,0,5,5,6,4,0,5,6,6,0.2
11531,DaRon Curry\daron-curry-1,2016-17,Fairleigh Dickinson,G,9,0,69,3,11,.273,3,6,.500,0,5,.000,0,2,.000,0,6,6,4,0,0,5,5,6,-0.4
11532,Oliver Xu\oliver-xu-1,2015-16,Rice,G,11,0,29,2,6,.333,1,3,.333,1,3,.333,1,2,.500,1,1,2,1,0,0,6,4,6,-0.3
11533,Dominique Bullock\dominique-bullock-1,2016-17,Georgia Southern,G,5,0,12,2,5,.400,0,0,,2,5,.400,0,0,,0,1,1,1,2,0,2,0,6,0.9
11534,Chris Giles\chris-giles-5,2017-18,Oklahoma,G,8,0,15,2,7,.286,2,6,.333,0,1,.000,2,2,1.000,0,0,0,0,1,0,1,1,6,0.2
11535,Robby Dosier\robby-dosier-1,2015-16,Southeast Missouri State,G,15,1,99,2,9,.222,1,3,.333,1,6,.167,1,2,.500,0,10,10,4,1,0,8,11,6,-0.4
11536,Kevin McNair\kevin-mcnair-1,2013-14,Marshall,G,3,0,9,1,2,.500,1,1,1.000,0,1,.000,4,5,.800,1,0,1,0,0,0,0,1,6,1.6
11537,Dillon Avare\dillon-avare-1,2015-16,Louisville,G,7,0,19,2,6,.333,0,1,.000,2,5,.400,0,0,,0,0,0,1,0,0,2,3,6,0.0
11538,Eric Wagenlander\eric-wagenlander-1,2015-16,Wofford,G,7,0,13,2,4,.500,0,0,,2,4,.500,0,0,,0,4,4,1,0,0,1,0,6,0.7
11539,Khalid Campbell\khalid-campbell-1,2016-17,Arkansas-Pine Bluff,G,18,0,66,2,12,.167,2,3,.667,0,9,.000,2,4,.500,4,5,9,2,0,0,3,7,6,-0.1
11540,Kevin Kerley\kevin-kerley-1,2016-17,Appalachian State,G,5,0,21,2,4,.500,1,1,1.000,1,3,.333,1,2,.500,0,2,2,5,1,0,2,1,6,1.3
11541,James Foye\james-foye-1,2016-17,Dartmouth,G,8,0,23,2,7,.286,0,3,.000,2,4,.500,0,0,,0,2,2,0,0,0,0,0,6,0.3
11542,Markos Psimitis\markos-psimitis-1,2017-18,Saint Louis,G,11,0,20,2,5,.400,0,0,,2,5,.400,0,2,.000,1,0,1,1,0,0,1,1,6,0.2
11543,Chandler White\chandler-white-1,2015-16,Toledo,G,8,0,28,3,8,.375,3,8,.375,0,0,,0,0,,2,5,7,0,0,0,6,8,6,-0.6
11544,Carson Fields\carson-fields-1,2013-14,Clemson,G,10,0,23,3,8,.375,3,4,.750,0,4,.000,0,0,,1,1,2,1,0,0,0,0,6,0.3
11545,Jeremiah Davis\jeremiah-davis-1,2013-14,Cincinnati,G,6,0,30,2,4,.500,2,3,.667,0,1,.000,2,2,1.000,2,2,4,2,1,0,1,4,6,1.0
11546,Ryan Staten\ryan-staten-1,2013-14,San Diego State,G,7,0,19,3,7,.429,3,7,.429,0,0,,0,3,.000,3,5,8,1,0,0,0,3,6,0.6
11547,Ford Stuen\ford-stuen-1,2014-15,Oklahoma State,G,5,0,10,2,2,1.000,1,1,1.000,1,1,1.000,1,1,1.000,0,0,0,1,0,0,1,1,6,0.9
11548,Victor Mbachu\victor-mbachu-1,2015-16,Texas-El Paso,G,7,1,16,2,5,.400,2,4,.500,0,1,.000,2,4,.500,0,1,1,0,0,0,1,1,6,0.2
11549,Jacob Gross\jacob-gross-1,2016-17,North Texas,G,14,1,39,2,9,.222,2,5,.400,0,4,.000,2,4,.500,5,1,6,1,1,2,3,3,6,0.2
11550,Grant Gibb\grant-gibb-1,2017-18,Eastern Washington,G,12,0,31,2,9,.222,1,5,.200,1,4,.250,1,2,.500,1,5,6,2,0,1,0,3,6,0.3
11551,Riyan Williams\riyan-williams-1,2015-16,Georgetown,G,23,0,45,2,7,.286,2,4,.500,0,3,.000,2,7,.286,1,4,5,4,3,0,4,18,6,-0.2
11552,Mike Burnett\mike-burnett-1,2013-14,Colorado State,G,7,0,16,1,4,.250,1,4,.250,0,0,,4,4,1.000,2,2,4,0,0,1,0,4,6,0.7
11553,Jack Foley\jack-foley-2,2013-14,South Dakota,G,6,0,35,1,11,.091,0,2,.000,1,9,.111,3,4,.750,0,6,6,1,1,0,3,4,6,-0.5
11554,Rashaun Madison\rashaun-madison-1,2014-15,North Carolina Central,G,6,0,55,2,11,.182,0,3,.000,2,8,.250,0,0,,1,7,8,7,2,0,9,6,6,-0.4
11555,Kyle Brown\kyle-brown-1,2015-16,Cornell,G,12,0,35,2,9,.222,1,1,1.000,1,8,.125,1,2,.500,0,4,4,2,3,0,5,3,6,0.0
11556,Braiten Madrigal\braiten-madrigal-1,2015-16,Boston University,G,1,1,32,3,6,.500,3,6,.500,0,0,,0,0,,3,2,5,2,0,4,3,4,6,5.3
11557,Gerald Smith\gerald-smith-1,2017-18,Samford,G,16,1,83,1,8,.125,0,3,.000,1,5,.200,3,4,.750,0,0,0,4,1,0,2,2,6,0.1
11558,Jerron Martin\jerron-martin-1,2016-17,Texas Southern,G,4,0,15,1,4,.250,1,2,.500,0,2,.000,4,4,1.000,0,2,2,0,0,0,1,3,6,0.5
11559,C.J. Holmes\cj-holmes-1,2014-15,Auburn,G,5,0,6,2,2,1.000,0,0,,2,2,1.000,0,0,,0,0,0,0,0,0,0,0,6,1.1
11560,Jimmy Barton\jimmy-barton-1,2015-16,Missouri,G,12,0,46,2,10,.200,0,2,.000,2,8,.250,0,0,,1,3,4,4,2,0,5,6,6,-0.1
11561,Dan Guest\dan-guest-1,2014-15,Connecticut,G,9,0,20,2,4,.500,2,3,.667,0,1,.000,2,2,1.000,0,1,1,2,0,0,3,3,6,0.2
11562,Demetre Rivers\demetre-rivers-1,2014-15,Mercer,G,21,0,43,1,8,.125,0,3,.000,1,5,.200,3,4,.750,0,1,1,1,1,2,5,7,6,-0.2
11563,Ernest Carter\ernest-carter-1,2014-15,Florida A&M,G,7,0,10,2,5,.400,0,1,.000,2,4,.500,0,0,,0,1,1,0,0,0,0,2,6,0.4
11564,Jacob Talbert\jacob-talbert-1,2015-16,Campbell,G,6,0,17,3,7,.429,3,3,1.000,0,4,.000,0,0,,1,1,2,1,1,0,1,5,6,0.3
11565,Matt Fox\matt-fox-1,2014-15,Bowling Green State,G,15,0,54,2,9,.222,0,1,.000,2,8,.250,0,0,,1,4,5,2,0,0,2,3,6,0.0
11566,Jantzen Raymond\jantzen-colie-raymond-1,2014-15,Charleston Southern,G,7,0,27,2,7,.286,2,5,.400,0,2,.000,2,2,1.000,0,3,3,1,0,0,2,3,6,0.0
11567,Jackie Davis\jackie-davis-1,2014-15,Washington State,G,11,0,56,2,12,.167,2,4,.500,0,8,.000,2,7,.286,1,4,5,0,1,1,6,6,6,-0.8
11568,James Mongomery\james-mongomery-1,2013-14,Northwestern,G,28,4,73,3,9,.333,3,4,.750,0,5,.000,0,0,,0,5,5,2,5,1,0,18,6,0.1
11569,Devin Epps\devin-epps-1,2015-16,South Alabama,G,11,0,25,1,1,1.000,1,1,1.000,0,0,,4,5,.800,0,1,1,2,0,0,2,5,6,0.3
11570,Jalen Duke\jalen-duke-1,2016-17,Tennessee State,G,5,0,24,3,7,.429,3,6,.500,0,1,.000,0,0,,1,0,1,0,3,0,0,0,6,1.2
11571,Jason Martin\jason-martin-1,2014-15,Stephen F. Austin,G,13,0,26,3,6,.500,3,3,1.000,0,3,.000,0,0,,2,3,5,1,0,0,1,2,6,0.3
11572,Kyle Dobbins\kyle-dobbins-1,2013-14,Texas A&M,G,11,0,15,2,6,.333,2,6,.333,0,0,,2,7,.286,0,1,1,2,2,0,2,1,6,0.2
11573,Liam McManimon\liam-mcmanimon-1,2015-16,Mount St. Mary's,G,13,1,28,1,8,.125,0,3,.000,1,5,.200,3,4,.750,2,2,4,1,0,0,1,4,6,0.0
11574,Nick Powell\nick-powell-1,2015-16,North Carolina-Wilmington,G,10,0,17,2,6,.333,2,4,.500,0,2,.000,2,4,.500,0,0,0,1,0,0,3,3,6,-0.2
11575,Richard Romeo\richard-romeo-1,2015-16,West Virginia,G,10,0,21,2,3,.667,2,3,.667,0,0,,2,2,1.000,0,2,2,0,0,0,2,5,6,0.1
11576,Andrew Bargmann\andrew-bargmann-1,2013-14,Colgate,G,8,0,35,2,4,.500,1,1,1.000,1,3,.333,1,2,.500,0,4,4,0,1,0,0,2,6,0.6
11577,Christopher Joyce\christopher-joyce-1,2017-18,Air Force,G,10,0,46,2,13,.154,1,6,.167,1,7,.143,1,4,.250,3,4,7,5,1,0,1,3,6,0.2
11578,Malcolm Laws\malcolm-laws-1,2014-15,Florida Atlantic,G,4,0,11,2,4,.500,1,1,1.000,1,3,.333,1,2,.500,2,1,3,0,0,0,1,1,6,1.0
11579,Juwan Anderson\juwan-anderson-1,2015-16,Nevada,G,23,0,121,2,8,.250,2,5,.400,0,3,.000,2,4,.500,4,5,9,11,7,0,5,19,6,0.3
11580,Anthony Cole\anthony-cole-1,2013-14,Memphis,G,5,0,10,1,3,.333,1,3,.333,0,0,,4,4,1.000,1,1,2,0,0,0,0,0,6,1.1
11581,Kurt Karis\kurt-karis-1,2016-17,Southern California,G,13,0,23,2,3,.667,2,3,.667,0,0,,2,2,1.000,1,0,1,0,0,0,3,5,6,0.0
11582,Andrew Fava\andrew-fava-1,2017-18,Florida,G,7,0,14,3,6,.500,3,4,.750,0,2,.000,0,0,,0,1,1,2,0,0,2,1,6,0.3
11583,Chase Miller\chase-miller-1,2017-18,Middle Tennessee,G,9,0,15,2,9,.222,0,2,.000,2,7,.286,0,2,.000,0,0,0,1,0,0,0,3,6,-0.1
11584,Milos Cabarkapa\milos-cabarkapa-1,2015-16,Central Michigan,G,7,0,15,1,2,.500,1,2,.500,0,0,,4,7,.571,1,4,5,1,0,0,0,2,6,0.8
11585,Aaron Jones\aaron-jones-2,2013-14,Texas-El Paso,G,8,0,48,2,7,.286,2,7,.286,0,0,,2,4,.500,0,1,1,6,1,0,9,7,6,-0.7
11586,Larry Johnson\larry-johnson-6,2015-16,Arkansas-Pine Bluff,G,25,1,99,3,11,.273,3,8,.375,0,3,.000,0,3,.000,4,4,8,3,2,0,12,17,6,-0.5
11587,Mitchell McMullen\mitchell-mcmullen-1,2016-17,Long Island University,G,11,0,47,2,3,.667,0,0,,2,3,.667,0,0,,0,4,4,3,0,0,1,6,6,0.4
11588,Zach Rammelt\zach-rammelt-1,2016-17,North Dakota State,G,9,0,25,2,5,.400,0,1,.000,2,4,.500,0,0,,0,3,3,2,1,0,0,0,6,0.7
11589,Kaleb Castro\kaleb-castro-1,2016-17,Memphis,G,7,0,14,2,4,.500,0,1,.000,2,3,.667,0,0,,0,1,1,0,0,0,1,2,6,0.4
11590,David Molinari\david-molinari-1,2015-16,DePaul,G,17,0,30,0,3,.000,0,2,.000,0,1,.000,6,9,.667,0,2,2,2,0,0,4,5,6,-0.1
11591,James Holder\james-holder-1,2016-17,Georgia Southern,G,5,0,13,2,6,.333,1,3,.333,1,3,.333,1,2,.500,1,2,3,6,2,0,1,0,6,1.7
11592,Kareem South\kareem-south-1,2015-16,Texas A&M-Corpus Christi,G,5,0,36,2,12,.167,2,10,.200,0,2,.000,2,2,1.000,5,0,5,3,0,0,3,6,6,-0.3
11593,Trent VanHorn\trent-vanhorn-1,2016-17,Wake Forest,G,20,1,54,2,5,.400,2,5,.400,0,0,,2,2,1.000,1,4,5,5,0,0,3,10,6,0.1
11594,Trent Gilbert\trent-gilbert-1,2014-15,Louisville,G,4,0,16,2,6,.333,0,1,.000,2,5,.400,0,0,,1,1,2,2,0,0,2,3,6,0.5
11595,Chris Gilbert\chris-gilbert-1,2017-18,Oakland,G,10,0,64,2,11,.182,0,0,,2,11,.182,0,0,,0,3,3,7,1,0,0,3,6,0.5
11596,Aaron Robinson\aaron-robinson-2,2015-16,Quinnipiac,G,8,0,20,2,10,.200,0,2,.000,2,8,.250,0,0,,1,0,1,0,0,0,0,3,6,-0.1
11597,Longi Yiljep\longi-yiljep-1,2014-15,Brown,G,7,2,34,2,7,.286,2,6,.333,0,1,.000,2,2,1.000,1,4,5,0,1,3,3,7,6,0.2
11598,Theo Friedman\theo-friedman-1,2013-14,Oregon,G,11,0,25,1,1,1.000,1,1,1.000,0,0,,4,6,.667,1,0,1,0,1,0,2,4,6,0.3
11599,D'Angelo McBride\dangelo-mcbride-1,2015-16,Bradley,G,7,0,34,0,5,.000,0,3,.000,0,2,.000,6,9,.667,3,3,6,0,1,1,5,2,6,0.0
11600,Cory Dolins\cory-dolins-1,2015-16,DePaul,G,13,0,18,3,5,.600,3,5,.600,0,0,,0,1,.000,2,2,4,0,0,0,0,0,6,0.4
11601,Jason Lee\jason-lee-2,2017-18,St. Bonaventure,G,6,0,12,2,3,.667,0,1,.000,2,2,1.000,0,0,,0,2,2,0,0,0,1,0,6,0.7
11602,Devon Pflueger\devon-pflueger-1,2014-15,Southern California,G,7,0,16,2,6,.333,0,4,.000,2,2,1.000,0,0,,3,4,7,0,0,0,0,5,6,0.6
11603,Ot Elmore\ot-elmore-1,2016-17,Marshall,G,6,0,21,2,12,.167,0,2,.000,2,10,.200,0,0,,0,0,0,0,1,0,0,1,6,-0.2
11604,Brett Brady\brett-brady-1,2013-14,Colorado,G,4,0,10,2,4,.500,0,0,,2,4,.500,0,0,,1,0,1,1,0,0,1,1,6,1.0
11605,Elijah Robertson\elijah-robertson-1,2014-15,Chicago State,G,8,0,26,2,5,.400,2,4,.500,0,1,.000,2,4,.500,1,2,3,1,0,1,2,3,6,0.3
11606,Brady Rudrud\brady-rudrud-1,2016-17,Minnesota,G,5,0,9,2,3,.667,1,2,.500,1,1,1.000,1,2,.500,0,1,1,0,0,0,0,0,6,0.9
11607,Jonathan Wilfong\jonathan-wilfong-1,2013-14,Southern Methodist,G,7,0,11,3,4,.750,3,4,.750,0,0,,0,0,,1,2,3,0,0,0,2,1,6,0.5
11608,Adrian Carrion Armas\adrian-carrion-armas-1,2016-17,Grand Canyon,G,5,0,27,2,3,.667,2,2,1.000,0,1,.000,2,4,.500,0,2,2,3,1,0,2,1,6,1.0
11609,Alec Wulff\alec-wulff-1,2016-17,UCLA,G,11,0,22,2,6,.333,0,0,,2,6,.333,0,0,,0,1,1,1,1,0,0,2,6,0.3
11610,Dan Kingma\dan-kingma-1,2015-16,Washington,G,10,0,30,2,7,.286,2,4,.500,0,3,.000,2,2,1.000,1,3,4,4,0,0,4,3,6,0.1
11611,Xavier Smith\xavier-smith-2,2017-18,Oregon State,G,7,0,17,3,4,.750,3,4,.750,0,0,,0,0,,0,0,0,1,1,0,3,3,6,0.3
11612,Patrick Speller\patrick-speller-1,2015-16,Howard,G,11,0,18,2,4,.500,2,3,.667,0,1,.000,2,4,.500,1,3,4,0,0,0,0,2,6,0.4
11613,Khyan Rayner\khyan-rayner-1,2013-14,Princeton,G,7,0,22,1,5,.200,0,1,.000,1,4,.250,3,4,.750,0,1,1,0,3,1,3,3,6,0.3
11614,Omar Mostafa\omar-mostafa-1,2016-17,William & Mary,G,7,0,10,2,6,.333,0,1,.000,2,5,.400,0,2,.000,0,1,1,2,1,0,1,0,6,0.5
11615,Ian Fox\ian-fox-1,2017-18,Cal State Fullerton,G,5,0,38,2,14,.143,0,3,.000,2,11,.182,0,0,,4,0,4,4,2,1,1,0,6,0.9
11616,Chad Brown\chad-brown-1,2015-16,Central Florida,G,15,0,75,2,11,.182,2,11,.182,0,0,,2,5,.400,10,5,15,0,0,3,1,14,6,0.1
11617,Kevin Crawford\kevin-crawford-2,2015-16,North Carolina Central,G,7,0,15,2,5,.400,2,4,.500,0,1,.000,2,2,1.000,0,0,0,3,1,0,2,1,6,0.6
11618,T.K. Hayes\tk-hayes-1,2014-15,Furman,G,6,0,15,1,4,.250,1,2,.500,0,2,.000,4,4,1.000,0,0,0,2,0,0,3,0,6,0.3
11619,Todd Eaglin\todd-eaglin-1,2015-16,North Texas,G,21,1,70,1,12,.083,1,2,.500,0,10,.000,4,6,.667,1,6,7,3,1,0,3,10,6,-0.2
11620,Patrick Wallace\patrick-wallace-1,2014-15,North Carolina State,G,5,0,11,2,8,.250,1,2,.500,1,6,.167,1,2,.500,1,1,2,1,0,0,1,0,6,0.3
11621,Grant Ellis\grant-ellis-1,2014-15,Iona,G,7,0,26,2,6,.333,0,1,.000,2,5,.400,0,0,,0,3,3,1,0,0,2,4,6,0.1
11622,Anthony Durham\anthony-durham-2,2015-16,Rider,G,5,0,22,2,6,.333,2,6,.333,0,0,,2,2,1.000,0,1,1,0,0,0,1,2,6,0.2
11623,Trey Slate\trey-slate-1,2014-15,Oklahoma,G,8,0,17,2,9,.222,0,2,.000,2,7,.286,0,0,,0,1,1,1,1,0,0,0,6,0.3
11624,Zane Gibson\zane-gibson-1,2013-14,Middle Tennessee,G,19,0,89,1,6,.167,1,3,.333,0,3,.000,4,6,.667,2,2,4,8,2,0,4,6,6,0.2
11625,Lars Espe\lars-espe-1,2017-18,Montana,G,17,0,42,2,6,.333,1,3,.333,1,3,.333,1,5,.200,2,1,3,5,0,1,2,4,6,0.2
11626,Daniel Hill\daniel-hill-1,2014-15,Eastern Washington,G,15,0,49,2,9,.222,2,3,.667,0,6,.000,2,2,1.000,0,3,3,2,2,0,3,7,6,-0.1
11627,Ron Wamer\ron-wamer-1,2013-14,Georgia Tech,G,10,0,33,2,4,.500,2,2,1.000,0,2,.000,2,3,.667,0,4,4,2,0,0,3,1,6,0.3
11628,Quin Barnard\quin-barnard-1,2016-17,Washington,G,9,0,13,2,5,.400,0,0,,2,5,.400,0,0,,1,0,1,2,0,0,1,0,6,0.5
11629,Matt Fraschilla\matt-fraschilla-1,2013-14,Harvard,G,7,0,17,2,3,.667,0,0,,2,3,.667,0,0,,0,0,0,1,2,0,1,1,6,0.9
11630,Onuralp Demirer\onuralp-demirer-1,2016-17,Texas-Rio Grande Valley,G,5,0,9,2,3,.667,2,3,.667,0,0,,2,2,1.000,0,0,0,0,2,0,2,0,6,0.9
11631,Khyan Rayner\khyan-rayner-1,2016-17,Princeton,G,13,1,38,2,5,.400,0,1,.000,2,4,.500,0,0,,0,4,4,2,0,0,1,3,6,0.3
11632,JoJo Fallas\jojo-fallas-1,2013-14,Cornell,G,14,0,56,2,11,.182,2,4,.500,0,7,.000,2,4,.500,1,6,7,1,1,0,6,5,6,-0.4
11633,Chass Bryan\chass-bryan-1,2014-15,Southern California,G,18,0,104,1,16,.063,1,14,.071,0,2,.000,4,8,.500,4,8,12,15,6,1,6,21,6,0.1
11634,LaQuan Wiltshire\laquan-wiltshire-1,2016-17,Alabama A&M,G,7,0,48,1,3,.333,0,2,.000,1,1,1.000,3,5,.600,3,5,8,3,3,0,2,5,6,1.2
11635,Matt Schaffer\matt-schaffer-1,2016-17,Toledo,G,8,0,15,1,3,.333,0,1,.000,1,2,.500,3,3,1.000,0,3,3,0,0,0,0,0,6,0.7
11636,Tim Broom\tim-broom-1,2014-15,Citadel,G,14,0,91,0,11,.000,0,6,.000,0,5,.000,6,14,.429,0,4,4,18,7,0,11,13,6,0.0
11637,Travis Light\travis-light-1,2017-18,Florida State,G,4,0,7,2,6,.333,0,0,,2,6,.333,0,0,,0,1,1,0,0,0,0,0,6,0.7
11638,Shea Jones\shea-jones-1,2015-16,Jacksonville,G,8,0,33,2,9,.222,1,2,.500,1,7,.143,1,2,.500,2,7,9,5,1,0,1,7,6,0.5
11639,Myles Carter\myles-carter-2,2017-18,Delaware State,G,12,0,36,2,9,.222,2,8,.250,0,1,.000,2,2,1.000,1,1,2,1,1,0,11,4,6,-0.8
11640,Zach Buscher\zach-buscher-1,2016-17,Hawaii,G,15,0,47,3,9,.333,3,5,.600,0,4,.000,0,1,.000,1,4,5,1,1,0,3,8,6,-0.1
11641,Cahli Thomas\cahli-thomas-1,2013-14,Delaware State,G,15,0,58,2,8,.250,2,6,.333,0,2,.000,2,5,.400,0,2,2,1,3,0,4,5,6,-0.1
11642,D'Quan Applewhite\dquan-applewhite-1,2017-18,Southern Illinois-Edwardsville,G,4,0,4,1,5,.200,0,1,.000,1,4,.250,3,7,.429,1,1,2,0,0,0,0,1,6,0.5
11643,Brenden Glapion\brenden-glapion-1,2015-16,University of California,G,8,0,17,1,7,.143,1,5,.200,0,2,.000,4,6,.667,0,1,1,1,0,0,2,2,6,-0.1
11644,Kamau Faines\kamau-faines-1,2015-16,Davidson,G,4,0,6,2,4,.500,2,3,.667,0,1,.000,2,3,.667,0,0,0,0,0,0,0,0,6,0.9
11645,Evan Troy\evan-troy-1,2017-18,Brigham Young,G,12,0,18,1,4,.250,1,2,.500,0,2,.000,4,6,.667,0,2,2,2,1,0,0,0,6,0.5
11646,Brandon Jawato\brandon-jawato-1,2014-15,Hawaii,G,6,0,30,1,6,.167,0,1,.000,1,5,.200,3,7,.429,0,3,3,1,1,0,1,5,6,0.0
11647,Clifton Powell\clifton-powell-1,2017-18,UC-Santa Barbara,G,7,0,39,3,11,.273,3,8,.375,0,3,.000,0,2,.000,0,3,3,2,0,1,5,4,6,-0.7
11648,Dom Antonelli\dom-antonelli-1,2016-17,Navy,G,3,0,8,2,4,.500,0,0,,2,4,.500,0,0,,0,2,2,0,0,0,0,0,6,1.5
11649,Devin Waddell\devin-waddell-1,2015-16,Auburn,G,26,1,170,2,14,.143,1,4,.250,1,10,.100,1,2,.500,3,7,10,3,6,0,10,30,6,-0.5
11650,Joe Ajike\joe-ajike-1,2017-18,Rider,G,7,0,11,2,9,.222,1,4,.250,1,5,.200,1,2,.500,1,3,4,0,0,0,3,1,6,-0.2
11651,Abel Porter\abel-porter-1,2016-17,Utah State,G,4,0,24,2,7,.286,1,1,1.000,1,6,.167,1,2,.500,0,1,1,3,2,0,0,0,6,1.5
11652,Trey Knight III\trey-knightiii-1,2017-18,Indiana State,G,9,0,52,1,2,.500,1,2,.500,0,0,,4,7,.571,1,3,4,1,1,1,5,7,6,0.0
11653,Matthew Cioce\matthew-cioce-1,2016-17,Stetson,G,6,0,10,2,4,.500,1,1,1.000,1,3,.333,1,1,1.000,0,0,0,1,0,0,3,0,6,0.3
11654,Matthew Cioce\matthew-cioce-1,2017-18,Stetson,G,5,0,11,2,5,.400,1,1,1.000,1,4,.250,1,4,.250,1,1,2,0,1,0,0,0,6,0.8
11655,Dalton Dry\dalton-dry-1,2015-16,Texas Christian,G,16,0,67,2,8,.250,2,7,.286,0,1,.000,2,6,.333,5,4,9,2,3,0,6,14,6,-0.2
11656,Carter Cagle\carter-cagle-1,2016-17,Georgia State,G,6,0,12,2,5,.400,0,0,,2,5,.400,0,0,,0,2,2,1,0,0,1,1,6,0.5
11657,Tony Larkins\tony-larkins-1,2014-15,Central Michigan,G,7,0,16,3,3,1.000,3,3,1.000,0,0,,0,0,,0,2,2,1,1,0,1,3,6,0.7
11658,Nick Powell\nick-powell-1,2014-15,North Carolina-Wilmington,G,8,0,13,2,6,.333,0,0,,2,6,.333,0,0,,0,1,1,0,0,0,0,1,6,0.3
11659,Charles Harris\charles-harris-2,2014-15,Western Michigan,G,6,0,19,3,8,.375,3,8,.375,0,0,,0,0,,1,2,3,0,0,0,1,1,6,0.3
11660,Kye de Laveaga\kye-de-laveaga-1,2014-15,Northern Arizona,G,4,0,20,2,7,.286,0,1,.000,2,6,.333,0,0,,1,1,2,0,0,0,3,4,6,-0.4
11661,A.J. Rutter\aj-rutter-1,2016-17,Drake,G,6,0,14,2,8,.250,0,1,.000,2,7,.286,0,0,,1,0,1,0,0,0,2,1,6,-0.1
11662,Greg Tarca\greg-tarca-1,2017-18,Quinnipiac,G,4,0,5,3,7,.429,3,5,.600,0,2,.000,0,3,.000,1,0,1,0,0,0,0,0,6,0.5
11663,Anthony Odunsi\anthony-odunsi-1,2013-14,Albany (NY),G,5,0,25,2,5,.400,2,5,.400,0,0,,2,2,1.000,1,1,2,1,1,0,2,3,6,0.6
11664,Donald Gipson\donald-gipson-1,2016-17,Loyola Marymount,G,1,0,13,3,8,.375,3,5,.600,0,3,.000,0,0,,0,0,0,0,0,0,2,1,6,-0.8
11665,Darrion Harris\darrion-harris-1,2013-14,Bradley,G,10,0,22,2,6,.333,2,6,.333,0,0,,2,4,.500,0,1,1,2,0,0,1,0,6,0.3
11666,Justice Bartley\justice-bartley-1,2017-18,Virginia,G,10,0,22,2,5,.400,1,3,.333,1,2,.500,1,2,.500,2,2,4,0,0,0,1,1,6,0.4
11667,Marcus Brock\marcus-brock-1,2014-15,Incarnate Word,G,7,0,9,1,1,1.000,0,0,,1,1,1.000,3,3,1.000,2,1,3,1,0,0,1,0,6,1.0
11668,Scott Meredith\scott-meredith-1,2015-16,Saint Francis (PA),G,13,0,53,2,13,.154,0,0,,2,13,.154,0,0,,2,4,6,2,2,0,2,3,6,0.0
11669,Ethan Haslam\ethan-haslam-1,2016-17,South Alabama,G,7,0,15,2,7,.286,0,0,,2,7,.286,0,0,,0,1,1,0,0,0,1,0,6,0.2
11670,Patrick Ryan\patrick-ryan-1,2015-16,Elon,G,3,0,6,3,3,1.000,3,3,1.000,0,0,,0,0,,0,0,0,0,0,0,2,0,6,1.0
11671,Chris Starkes\chris-starkes-1,2013-14,Incarnate Word,G,11,0,24,2,7,.286,1,2,.500,1,5,.200,1,2,.500,0,3,3,4,1,0,4,1,6,0.2
11672,Charlie Rose\charlie-rose-1,2017-18,Iowa,G,8,0,14,3,6,.500,3,3,1.000,0,3,.000,0,0,,1,2,3,2,0,0,2,1,6,0.4
11673,Broderick Newbill\broderick-newbill-1,2013-14,Fresno State,G,10,0,18,3,5,.600,3,5,.600,0,0,,0,0,,1,1,2,1,0,0,0,0,6,0.5
11674,Jon Siu\jon-siu-1,2017-18,Northern Illinois,G,4,0,12,2,4,.500,0,0,,2,4,.500,0,0,,0,2,2,1,0,0,1,2,6,0.9
11675,Drew Crabtree\drew-crabtree-1,2015-16,Ohio,G,9,0,9,2,4,.500,0,0,,2,4,.500,0,0,,1,2,3,1,0,0,0,1,6,0.6
11676,Evan Moorman\evan-moorman-1,2015-16,Little Rock,G,3,0,12,2,6,.333,0,0,,2,6,.333,0,0,,0,0,0,1,0,0,0,0,6,1.1
11677,Matt Marlin\matt-marlin-1,2015-16,Louisiana,G,9,0,35,2,7,.286,1,3,.333,1,4,.250,1,2,.500,1,0,1,3,2,0,2,2,6,0.4
11678,Zach Durkee\zach-durkee-1,2015-16,Charleston Southern,G,2,0,6,2,2,1.000,2,2,1.000,0,0,,2,3,.667,0,1,1,0,0,0,0,0,6,2.7
11679,Elijah Holifield\elijah-holifield-1,2015-16,St. John's (NY),G,10,0,39,2,12,.167,1,5,.200,1,7,.143,1,2,.500,1,3,4,1,1,0,1,3,6,-0.1
11680,Isiah Wilson\isiah-wilson-1,2013-14,Alabama,G,4,1,11,2,6,.333,2,5,.400,0,1,.000,2,3,.667,1,5,6,1,2,0,0,0,6,1.8
11681,Zach Checkal\zach-checkal-1,2013-14,North Dakota State,G,9,0,28,1,7,.143,0,3,.000,1,4,.250,3,4,.750,1,6,7,0,0,0,1,3,6,0.2
11682,Brennan Corrigan\brennan-corrigan-1,2017-18,Seattle,G,4,0,7,2,5,.400,0,0,,2,5,.400,0,0,,0,0,0,0,0,0,0,0,6,0.8
11683,Conner George\connor-george-1,2017-18,Michigan State,G,16,0,54,3,15,.200,3,7,.429,0,8,.000,0,2,.000,7,11,18,0,3,0,2,6,6,0.2
11684,Shane Benton\shane-benton-1,2015-16,North Dakota,G,9,1,28,1,7,.143,1,6,.167,0,1,.000,4,5,.800,0,3,3,1,0,0,0,2,6,0.2
11685,Keith Oddo\keith-oddo-1,2017-18,Richmond,G,5,0,14,2,2,1.000,1,1,1.000,1,1,1.000,1,2,.500,0,0,0,1,0,0,0,4,6,0.8
11686,Devin Cooper\devin-cooper-1,2017-18,Radford,G,8,0,24,2,8,.250,0,4,.000,2,4,.500,0,0,,0,4,4,2,0,0,1,1,6,0.3
11687,Dwain Whitfield\dwain-whitfield-1,2017-18,Arkansas-Pine Bluff,G,9,0,45,2,5,.400,1,2,.500,1,3,.333,1,2,.500,5,1,6,3,0,0,2,7,6,0.4
11688,Zach Winter\zach-winter-1,2015-16,Kansas State,G,13,0,16,2,9,.222,0,1,.000,2,8,.250,0,0,,0,2,2,0,0,0,1,1,6,0.0
11689,Reggie Patterson\reggie-patterson-2,2015-16,Mississippi State,G,8,0,14,2,5,.400,2,4,.500,0,1,.000,2,3,.667,0,1,1,0,0,0,1,4,6,0.1
11690,Daniel Parke\daniel-parke-1,2015-16,Eastern Kentucky,G,5,0,9,2,3,.667,1,1,1.000,1,2,.500,1,1,1.000,0,0,0,0,1,0,0,1,6,1.1
11691,Conner George\connor-george-1,2016-17,Michigan State,G,10,0,12,1,2,.500,1,1,1.000,0,1,.000,4,6,.667,0,3,3,1,0,0,3,0,6,0.3
11692,Nick Wood\nick-wood-1,2013-14,Tulsa,G,9,0,12,1,3,.333,0,1,.000,1,2,.500,3,3,1.000,1,0,1,0,0,0,1,1,6,0.4
11693,Michael Wearne\michael-wearne-1,2015-16,Eastern Washington,G,1,0,11,3,3,1.000,3,3,1.000,0,0,,0,0,,1,1,2,4,1,0,0,1,6,9.5
11694,A.J. Edwards\aj-edwards-1,2014-15,Yale,G,5,0,29,1,7,.143,0,0,,1,7,.143,3,4,.750,2,3,5,4,0,0,0,4,6,0.9
11695,Daniel Davydov\daniel-davydov-1,2015-16,Portland State,G,3,0,9,2,3,.667,2,3,.667,0,0,,2,2,1.000,1,2,3,0,0,0,0,2,6,1.7
11696,Keith Carroll\keith-carroll-1,2014-15,Hampton,G,12,0,58,2,4,.500,2,4,.500,0,0,,2,4,.500,1,4,5,5,3,0,6,5,6,0.3
11697,TayVaughn Major\tayvaughn-major-1,2016-17,Charleston Southern,G,4,0,16,3,4,.750,3,4,.750,0,0,,0,2,.000,1,3,4,0,1,0,4,2,6,0.4
11698,Steven Bennett\steven-bennett-1,2013-14,Butler,G,3,0,8,2,2,1.000,0,0,,2,2,1.000,0,0,,1,1,2,0,0,0,0,1,6,2.0
11699,Xzaivier James\xzaivier-james-1,2013-14,Northern Colorado,G,10,1,35,2,4,.500,2,2,1.000,0,2,.000,2,5,.400,1,2,3,2,1,0,3,6,6,0.1
11700,Casey Perrin\casey-perrin-1,2013-14,Campbell,G,5,0,8,1,7,.143,1,1,1.000,0,6,.000,4,4,1.000,2,1,3,0,0,0,1,4,6,0.1
11701,Kendall Groom\kendall-groom-1,2013-14,Sacramento State,G,12,0,45,2,9,.222,2,7,.286,0,2,.000,2,2,1.000,2,3,5,7,6,0,1,2,6,1.0
11702,Jamal Gaines\jamal-gaines-1,2016-17,Bethune-Cookman,G,5,1,19,2,5,.400,2,5,.400,0,0,,2,2,1.000,0,1,1,1,0,1,2,2,6,0.4
11703,Adam Sweeney\adam-sweeney-1,2013-14,Gardner-Webb,G,6,0,20,2,11,.182,2,5,.400,0,6,.000,2,2,1.000,0,1,1,0,0,0,1,1,6,-0.3
11704,Addison Hill\addison-hill-1,2016-17,East Carolina,G,5,0,19,3,4,.750,3,4,.750,0,0,,0,0,,0,2,2,0,0,0,3,2,6,0.2
11705,Jonathan Walker\jonathan-walker-2,2015-16,Auburn,G,10,0,19,2,6,.333,0,1,.000,2,5,.400,0,0,,1,2,3,0,0,0,0,0,6,0.4
11706,Cooper Olson\cooper-olson-1,2016-17,Montana State,G,8,0,14,2,3,.667,0,0,,2,3,.667,0,0,,0,1,1,0,0,0,1,3,6,0.4
11707,Alec Wulff\alec-wulff-1,2015-16,UCLA,G,5,0,7,2,2,1.000,0,0,,2,2,1.000,0,0,,0,0,0,1,0,0,0,0,6,1.2
11708,Mehran Nazarian\mehran-nazarian-1,2015-16,Cal State Northridge,G,6,0,17,3,10,.300,3,5,.600,0,5,.000,0,2,.000,0,0,0,0,0,0,0,4,6,-0.4
11709,Jack Biebel\jack-biebel-1,2015-16,Saint Mary's (CA),G,23,0,79,2,5,.400,2,2,1.000,0,3,.000,2,5,.400,1,9,10,17,4,0,5,10,6,0.5
11710,Anson Moye\anson-moye-1,2015-16,Cal State Long Beach,G,16,0,75,3,10,.300,3,4,.750,0,6,.000,0,2,.000,2,4,6,1,2,0,4,4,6,-0.1
11711,Micah Johnson\micah-johnson-1,2017-18,Alabama State,G,7,0,30,3,10,.300,3,8,.375,0,2,.000,0,0,,1,4,5,3,0,0,8,1,6,-0.6
11712,Dalton Soffer\dalton-soffer-1,2016-17,Seton Hall,G,10,0,30,2,12,.167,0,0,,2,12,.167,0,0,,0,2,2,0,1,0,1,2,6,-0.2
11713,Nick Fruscio\nick-fruscio-1,2016-17,Albany (NY),G,8,0,11,2,3,.667,1,2,.500,1,1,1.000,1,2,.500,2,1,3,1,0,0,1,3,6,0.6
11714,Shawn Meyer\shawn-meyer-1,2013-14,Kansas State,G,13,0,16,2,4,.500,2,3,.667,0,1,.000,2,3,.667,2,1,3,1,0,0,1,1,6,0.4
11715,Michael Klebon\michael-klebon-1,2016-17,Saint Francis (PA),G,8,0,23,2,6,.333,0,3,.000,2,3,.667,0,0,,1,3,4,1,0,0,2,0,6,0.4
11716,Manuale Watkins\manuale-watkins-1,2013-14,Arkansas,G,8,0,27,2,3,.667,2,3,.667,0,0,,1,2,.500,1,3,4,1,3,0,2,2,5,0.7
11717,Steven Bennett\steven-bennett-1,2016-17,Butler,G,7,0,29,2,9,.222,1,3,.333,1,6,.167,0,1,.000,0,3,3,3,0,0,2,3,5,-0.2
11718,Galen Campbell\galen-campbell-1,2013-14,Tennessee,G,8,0,12,2,3,.667,2,3,.667,0,0,,1,1,1.000,0,0,0,0,0,0,0,2,5,0.4
11719,Calvin Hoffman\calvin-hoffman-1,2014-15,Liberty,G,18,0,28,1,12,.083,0,4,.000,1,8,.125,2,2,1.000,2,5,7,1,3,0,3,6,5,-0.1
11720,Anthony DeRiggs\anthony-deriggs-1,2014-15,Colgate,G,5,0,10,2,4,.500,1,1,1.000,1,3,.333,0,0,,0,1,1,0,0,0,0,0,5,0.7
11721,David Cunningham\david-cunningham-1,2015-16,Nevada,G,14,0,25,1,3,.333,0,0,,1,3,.333,2,4,.500,0,3,3,3,1,0,2,4,5,0.2
11722,T'ziah Wood-Smith\tziah-wood-smith-1,2013-14,Quinnipiac,G,10,0,19,2,5,.400,2,4,.500,0,1,.000,1,2,.500,3,4,7,0,0,0,2,4,5,0.2
11723,Steve Perpiglia\steve-perpiglia-1,2015-16,Boston College,G,9,1,25,2,7,.286,1,3,.333,1,4,.250,0,1,.000,1,3,4,2,0,0,3,1,5,0.0
11724,Jacob Talbert\jacob-talbert-1,2014-15,Campbell,G,3,0,9,1,4,.250,1,2,.500,0,2,.000,3,4,.750,2,3,5,1,0,0,1,0,5,1.4
11725,Tommy Matthews\tommy-matthews-1,2013-14,Eastern Kentucky,G,10,0,19,1,4,.250,1,3,.333,0,1,.000,3,9,.333,0,2,2,1,2,0,2,3,5,0.0
11726,Hunter Ford\hunter-ford-1,2013-14,UC-Santa Barbara,G,6,0,10,2,3,.667,1,1,1.000,1,2,.500,0,0,,0,2,2,1,0,0,1,1,5,0.6
11727,Deon Wright\deon-wright-1,2017-18,Jacksonville State,G,8,0,10,0,2,.000,0,2,.000,0,0,,5,6,.833,0,0,0,0,0,0,0,1,5,0.4
11728,Grant Ellis\grant-ellis-1,2015-16,Southern,G,1,0,7,2,4,.500,1,2,.500,1,2,.500,0,0,,0,0,0,0,0,0,1,2,5,1.2
11729,Trey Mason\trey-mason-1,2013-14,Arizona,G,10,0,22,2,3,.667,1,2,.500,1,1,1.000,0,0,,0,3,3,3,0,0,2,3,5,0.4
11730,Vince Fritz\vince-fritz-1,2014-15,Sacred Heart,G,6,0,32,2,7,.286,1,1,1.000,1,6,.167,0,0,,0,2,2,1,0,0,2,2,5,-0.1
11731,A.J. Rutter\aj-rutter-1,2015-16,Drake,G,1,0,3,2,2,1.000,1,1,1.000,1,1,1.000,0,0,,0,0,0,0,0,0,0,2,5,3.6
11732,Maxx Bleecher\maxx-bleecher-1,2015-16,Florida Gulf Coast,G,12,0,23,2,5,.400,1,2,.500,1,3,.333,0,0,,1,3,4,2,1,0,3,2,5,0.2
11733,Bryce Thurston\bryce-thurston-1,2016-17,Mount St. Mary's,G,7,0,17,2,5,.400,1,1,1.000,1,4,.250,0,0,,0,2,2,2,0,0,0,4,5,0.4
11734,Caleb Wallingford\caleb-wallingford-1,2015-16,Memphis,G,11,0,30,2,9,.222,2,4,.500,0,5,.000,1,2,.500,2,2,4,3,0,0,2,3,5,0.0
11735,Jon McKeeman\john-mckeeman-1,2013-14,Purdue,G,5,0,10,2,5,.400,1,3,.333,1,2,.500,0,0,,0,4,4,0,0,0,0,0,5,0.7
11736,Jodan Price\jodan-price-1,2016-17,Georgia Tech,G,15,0,43,2,14,.143,1,4,.250,1,10,.100,0,0,,0,7,7,1,1,2,0,0,5,0.1
11737,Christian Clark\christian-clark-2,2016-17,Southern Mississippi,G,9,0,23,2,3,.667,1,1,1.000,1,2,.500,0,1,.000,0,1,1,0,0,0,1,3,5,0.2
11738,Rob Vozenilek\rob-vozenilek-1,2014-15,Virginia,G,11,0,21,2,4,.500,1,1,1.000,1,3,.333,0,0,,0,0,0,1,0,0,1,0,5,0.2
11739,Joshua Mullins\joshua-mullins-1,2016-17,North Carolina A&T,G,13,1,44,1,6,.167,0,3,.000,1,3,.333,2,2,1.000,0,1,1,3,0,0,1,2,5,0.1
11740,Clay Weatherspoon\clay-weatherspoon-1,2017-18,Southern Mississippi,G,14,0,78,1,10,.100,1,6,.167,0,4,.000,3,5,.600,3,8,11,0,1,0,2,8,5,-0.2
11741,Jamal Gaines\jamal-gaines-1,2017-18,Bethune-Cookman,G,10,0,33,2,18,.111,2,11,.182,0,7,.000,1,2,.500,2,1,3,0,1,0,2,4,5,-0.8
11742,Jaylen Franklin\jaylen-franklin-2,2017-18,Massachusetts,G,14,0,40,2,10,.200,1,4,.250,1,6,.167,0,0,,0,3,3,5,2,0,1,8,5,0.1
11743,Thomas Blake\thomas-blake-1,2015-16,North Dakota,G,8,0,22,2,6,.333,1,2,.500,1,4,.250,0,2,.000,1,2,3,2,1,0,3,3,5,0.0
11744,Steven Shpreyregin\steven-shpreyregin-1,2016-17,Washington State,G,7,0,29,2,10,.200,1,2,.500,1,8,.125,0,0,,0,3,3,1,0,0,0,4,5,-0.2
11745,Alek Frascone\alek-frascone-1,2014-15,Oakland,G,10,0,23,2,4,.500,1,3,.333,1,1,1.000,0,0,,0,2,2,1,0,0,4,2,5,-0.1
11746,Jason Crandall\jason-crandall-1,2017-18,Washington,G,3,0,7,2,3,.667,1,2,.500,1,1,1.000,0,0,,2,0,2,1,0,0,0,0,5,1.9
11747,Van Rolle\van-rolle-1,2016-17,Towson,G,5,0,21,1,5,.200,1,3,.333,0,2,.000,3,5,.600,0,1,1,0,1,1,0,1,5,0.5
11748,O.J. Lewis\oj-lewis-1,2015-16,La Salle,G,12,1,24,1,8,.125,0,6,.000,1,2,.500,2,4,.500,1,2,3,1,2,0,1,3,5,0.1
11749,Ferran Bernacer\ferran-bernacer-1,2017-18,Austin Peay,G,7,0,31,2,10,.200,1,2,.500,1,8,.125,0,0,,1,3,4,3,2,0,4,4,5,-0.2
11750,Steve Leonard\steve-leonard-1,2016-17,Temple,G,5,0,18,1,3,.333,1,1,1.000,0,2,.000,3,4,.750,2,2,4,1,0,0,2,5,5,0.3
11751,Austin Eastman\austin-eastman-1,2015-16,Utah,G,11,0,33,1,6,.167,0,0,,1,6,.167,2,2,1.000,1,5,6,5,1,1,2,2,5,0.5
11752,Thomas Sanchez\thomas-sanchez-1,2017-18,Fordham,G,15,0,46,2,8,.250,1,3,.333,1,5,.200,0,0,,0,0,0,0,0,0,1,0,5,-0.1
11753,Jonny David\jonny-david-1,2016-17,Kentucky,G,7,0,11,1,2,.500,0,1,.000,1,1,1.000,2,4,.500,0,0,0,0,0,0,3,0,5,0.0
11754,Justin Cotten\justin-cotten-1,2017-18,Howard,G,14,0,22,2,9,.222,1,4,.250,1,5,.200,0,0,,1,2,3,2,0,0,3,1,5,-0.1
11755,Khari Harley\khari-harley-1,2016-17,Ohio,G,1,0,10,1,1,1.000,1,1,1.000,0,0,,3,4,.750,0,0,0,0,0,0,2,4,5,0.7
11756,Corey Heyward\corey-heyward-1,2015-16,Georgia Tech,G,8,0,22,2,5,.400,1,3,.333,1,2,.500,0,0,,0,1,1,0,1,0,2,1,5,0.2
11757,Victor Mbachu\victor-mbachu-1,2013-14,Texas-El Paso,G,5,0,20,0,2,.000,0,2,.000,0,0,,5,6,.833,0,1,1,2,1,0,1,1,5,0.9
11758,Campbell Donovan\campbell-donovan-1,2017-18,Butler,G,10,0,22,1,5,.200,0,0,,1,5,.200,2,2,1.000,0,0,0,1,1,0,0,0,5,0.4
11759,Jalen McCallum\jalen-mccallum-1,2013-14,IUPUI,G,2,0,4,2,3,.667,1,2,.500,1,1,1.000,0,0,,0,0,0,0,0,0,2,1,5,0.7
11760,Jon McKeeman\john-mckeeman-1,2016-17,Purdue,G,15,0,28,2,5,.400,1,3,.333,1,2,.500,0,0,,1,0,1,0,2,0,2,2,5,0.1
11761,Antonio Evans\antonio-evans-1,2013-14,Southeastern Louisiana,G,7,0,13,2,3,.667,1,2,.500,1,1,1.000,0,0,,0,2,2,2,0,1,0,0,5,0.9
11762,Jeff Martin\jeff-martin-2,2013-14,Murray State,G,8,0,12,2,6,.333,1,4,.250,1,2,.500,0,0,,0,1,1,1,0,0,3,1,5,-0.1
11763,Mike Lecak\mike-lecak-1,2014-15,Pittsburgh,G,9,0,20,1,5,.200,0,2,.000,1,3,.333,2,2,1.000,0,4,4,0,0,0,0,5,5,0.1
11764,Daniel Nwosu\daniel-nwosu-1,2014-15,Montana,G,17,0,44,2,7,.286,1,2,.500,1,5,.200,0,0,,2,1,3,1,1,0,3,9,5,-0.1
11765,JR Mathis\jr-mathis-1,2017-18,Navy,G,5,0,14,2,4,.500,1,2,.500,1,2,.500,0,0,,0,0,0,1,0,0,1,0,5,0.5
11766,Tre McKeithen\tre-mckeithen-1,2016-17,Saint Francis (PA),G,7,0,17,1,5,.200,0,0,,1,5,.200,2,2,1.000,1,4,5,0,0,0,2,2,5,0.1
11767,Matt Schaffer\matt-schaffer-1,2017-18,Toledo,G,6,0,12,2,7,.286,1,2,.500,1,5,.200,0,1,.000,0,0,0,1,0,0,0,1,5,0.1
11768,Eric Lockett\eric-lockett-1,2014-15,George Mason,G,5,0,30,1,4,.250,1,4,.250,0,0,,3,5,.600,1,1,2,2,1,1,3,4,5,0.3
11769,Antwan Scott\antwan-scott-2,2014-15,Colorado State,G,4,0,33,2,7,.286,1,2,.500,1,5,.200,0,0,,0,2,2,6,0,0,3,4,5,0.3
11770,Adam Sweeney\adam-sweeney-1,2014-15,Gardner-Webb,G,7,1,21,2,7,.286,1,4,.250,1,3,.333,0,0,,0,2,2,3,0,0,2,2,5,0.1
11771,Khary Mauras\khary-mauras-1,2016-17,Old Dominion,G,3,0,3,0,0,,0,0,,0,0,,5,6,.833,0,0,0,0,0,0,0,0,5,1.5
11772,Brandon Busuttil\brandon-busuttil-1,2015-16,Bowling Green State,G,7,2,19,2,10,.200,1,3,.333,1,7,.143,0,1,.000,1,2,3,0,0,0,0,2,5,-0.2
11773,Zach Chu\zach-chu-1,2014-15,Richmond,G,3,0,5,1,2,.500,0,0,,1,2,.500,2,2,1.000,0,1,1,0,0,0,0,0,5,1.4
11774,Sinan Saglam\sinan-saglam-1,2016-17,Fordham,G,11,0,28,2,7,.286,2,2,1.000,0,5,.000,1,1,1.000,1,4,5,2,0,1,2,3,5,0.2
11775,Henry Lowe\henry-lowe-1,2013-14,Villanova,G,8,0,13,2,2,1.000,1,1,1.000,1,1,1.000,0,3,.000,0,1,1,0,0,0,3,0,5,0.1
11776,Andrew Sorrells\andrew-sorrells-1,2017-18,Texas Tech,G,11,0,24,1,6,.167,0,3,.000,1,3,.333,2,2,1.000,0,4,4,4,2,0,2,1,5,0.4
11777,Jimmy Stamas\jimmy-stamas-1,2014-15,Milwaukee,G,10,0,25,1,4,.250,0,2,.000,1,2,.500,2,2,1.000,0,0,0,2,2,0,4,3,5,0.1
11778,Theo Friedman\theo-friedman-1,2014-15,Oregon,G,5,0,20,2,5,.400,1,3,.333,1,2,.500,0,0,,1,3,4,3,0,0,0,1,5,1.1
11779,Jordan Sechan\jordan-sechan-1,2017-18,Bucknell,G,14,0,34,2,12,.167,1,3,.333,1,9,.111,0,0,,0,4,4,3,2,0,3,5,5,-0.2
11780,Cole Stockton\cole-stockton-1,2015-16,Auburn,G,8,0,14,1,5,.200,0,2,.000,1,3,.333,2,2,1.000,1,1,2,2,0,0,0,1,5,0.5
11781,Nick Parker\nick-parker-1,2015-16,Campbell,G,5,0,9,2,2,1.000,1,1,1.000,1,1,1.000,0,0,,1,2,3,0,0,0,0,1,5,1.1
11782,C.J. Ward\cj-ward-1,2015-16,Maine,G,6,0,11,2,5,.400,1,1,1.000,1,4,.250,0,0,,1,0,1,2,0,0,0,0,5,0.7
11783,Matt Brown\matt-brown-5,2013-14,Harvard,G,10,0,21,0,0,,0,0,,0,0,,5,6,.833,0,3,3,1,0,0,1,1,5,0.5
11784,Carrington Ward\carrington-ward-1,2014-15,North Texas,G,4,1,30,2,4,.500,2,3,.667,0,1,.000,1,2,.500,0,4,4,2,0,0,4,6,5,-0.3
11785,Derek King\derek-king-1,2017-18,University of California,G,3,0,4,2,3,.667,1,1,1.000,1,2,.500,0,0,,0,2,2,0,0,0,1,0,5,1.1
11786,Ray Jerome\ray-jerome-1,2017-18,Pennsylvania,G,2,0,14,1,4,.250,0,1,.000,1,3,.333,2,2,1.000,0,2,2,4,2,0,0,1,5,3.8
11787,Thomas Ryan\thomas-ryan-1,2015-16,Yale,G,8,0,22,1,7,.143,0,2,.000,1,5,.200,2,3,.667,1,2,3,0,1,0,0,1,5,0.3
11788,Juan Aparicio\juan-aparicio-1,2015-16,Texas A&M,G,13,0,22,2,6,.333,1,3,.333,1,3,.333,0,2,.000,0,0,0,1,0,1,1,4,5,0.0
11789,Gunther Klimes\gunther-klimes-1,2016-17,Army,G,8,0,56,2,11,.182,1,6,.167,1,5,.200,0,0,,2,5,7,5,2,2,4,11,5,-0.1
11790,Ford Stuen\ford-stuen-1,2013-14,Oklahoma State,G,9,0,19,2,5,.400,1,2,.500,1,3,.333,0,0,,0,4,4,2,0,0,1,0,5,0.4
11791,Travis Meeker\travis-meeker-1,2013-14,Northern Arizona,G,20,0,90,1,12,.083,0,4,.000,1,8,.125,2,4,.500,2,6,8,4,0,1,0,4,5,0.1
11792,Asa Duvall\asa-duvall-1,2017-18,Lipscomb,G,10,0,55,1,9,.111,1,3,.333,0,6,.000,3,7,.429,2,6,8,2,2,2,1,3,5,0.3
11793,Brent Carraway\brent-carraway-1,2016-17,Presbyterian,G,3,0,11,2,5,.400,1,3,.333,1,2,.500,0,1,.000,0,1,1,0,0,0,1,0,5,0.4
11794,Hakeem Harris\hakeem-harris-1,2013-14,Seton Hall,G,3,0,26,2,4,.500,1,2,.500,1,2,.500,0,0,,0,2,2,0,2,1,0,3,5,1.7
11795,David Urso\david-urso-1,2016-17,Vermont,G,9,0,39,2,9,.222,1,3,.333,1,6,.167,0,0,,0,3,3,0,1,1,2,1,5,0.0
11796,Raekwon Miller\raekwon-miller-1,2014-15,North Carolina-Asheville,G,7,0,34,2,10,.200,1,5,.200,1,5,.200,0,2,.000,1,2,3,2,3,0,2,3,5,0.1
11797,Casey Woodring\casey-woodring-1,2013-14,Providence,G,7,0,10,2,4,.500,1,1,1.000,1,3,.333,0,0,,1,0,1,0,0,0,0,0,5,0.5
11798,Peyton Smith\peyton-smith-1,2017-18,Texas A&M-Corpus Christi,G,9,0,39,1,6,.167,1,2,.500,0,4,.000,3,4,.750,1,4,5,2,2,0,2,3,5,0.3
11799,Prince Okoroh\prince-okoroh-1,2016-17,Howard,G,3,1,7,1,3,.333,0,1,.000,1,2,.500,2,2,1.000,0,1,1,0,0,0,0,0,5,1.2
11800,Jake McDowell\jake-mcdowell-1,2014-15,Memphis,G,10,1,24,2,8,.250,1,6,.167,1,2,.500,0,0,,0,4,4,1,2,0,2,5,5,0.0
11801,Ryan Carmello\ryan-carmello-1,2017-18,Marist,G,11,0,18,2,4,.500,2,3,.667,0,1,.000,1,7,.143,2,0,2,2,1,0,2,0,5,0.2
11802,Brandon Chauca\brandon-chauca-1,2015-16,University of California,G,9,0,38,1,9,.111,0,1,.000,1,8,.125,2,2,1.000,1,0,1,5,1,0,4,4,5,-0.1
11803,Kyle Massie\kyle-massie-1,2017-18,Texas-San Antonio,G,9,0,20,1,4,.250,1,3,.333,0,1,.000,3,4,.750,0,2,2,3,0,0,0,1,5,0.5
11804,Cam Marotta\cam-marotta-1,2016-17,Marquette,G,9,0,19,1,6,.167,0,3,.000,1,3,.333,2,2,1.000,0,2,2,2,0,0,3,2,5,-0.1
11805,Cory Calvert\cory-calvert-1,2015-16,Brigham Young,G,5,0,26,2,8,.250,1,4,.250,1,4,.250,0,0,,0,5,5,1,0,0,0,2,5,0.3
11806,Fred Wright-Jones\fred-wright-jones-1,2016-17,Michigan,G,13,0,19,1,4,.250,0,2,.000,1,2,.500,2,2,1.000,0,1,1,0,0,0,1,2,5,0.1
11807,Shawn Wilborne\shawn-wilborne-1,2014-15,James Madison,G,3,0,6,2,3,.667,1,1,1.000,1,2,.500,0,0,,1,0,1,0,0,0,1,0,5,1.1
11808,Grayson Clark\grayson-clark-1,2013-14,Georgia Southern,G,11,0,20,2,6,.333,1,5,.200,1,1,1.000,0,0,,1,3,4,1,1,0,1,3,5,0.2
11809,L.J. Thorpe\lj-thorpe-1,2017-18,North Carolina-Asheville,G,1,0,6,1,2,.500,1,1,1.000,0,1,.000,3,4,.750,0,1,1,2,4,0,2,0,5,7.3
11810,Walt McGrory\walt-mcgrory-1,2017-18,Wisconsin,G,9,0,72,0,5,.000,0,2,.000,0,3,.000,5,7,.714,0,8,8,4,4,0,7,5,5,0.1
11811,Corry Long\corry-long-1,2017-18,Stony Brook,G,7,0,23,2,3,.667,1,1,1.000,1,2,.500,0,1,.000,0,1,1,2,2,0,1,3,5,0.7
11812,Michael Stones\michael-stones-1,2015-16,Dartmouth,G,7,0,15,2,5,.400,2,4,.500,0,1,.000,1,4,.250,0,1,1,0,2,0,2,3,5,0.0
11813,Hikeem Stewart\hikeem-stewart-1,2013-14,Washington,G,5,0,22,2,6,.333,1,1,1.000,1,5,.200,0,0,,0,3,3,0,0,0,2,1,5,0.0
11814,Neema Namdar\neema-namdar-1,2016-17,Southern Utah,G,4,0,12,1,4,.250,0,0,,1,4,.250,2,4,.500,1,0,1,0,2,0,0,1,5,1.0
11815,Matt Galloway\matt-galloway-1,2015-16,Virginia Tech,G,7,1,35,2,10,.200,1,2,.500,1,8,.125,0,0,,2,0,2,1,1,0,2,1,5,-0.1
11816,Casey Norris\casey-norris-1,2014-15,Loyola Marymount,G,7,0,47,1,5,.200,0,0,,1,5,.200,2,4,.500,0,3,3,6,6,1,6,7,5,0.6
11817,Dylan Brossman\dylan-brossman-1,2013-14,Boston University,G,9,0,19,1,5,.200,0,1,.000,1,4,.250,2,2,1.000,0,1,1,1,2,0,0,1,5,0.5
11818,Austin Witherill\austin-witherill-1,2015-16,Arizona State,G,13,0,18,1,6,.167,0,1,.000,1,5,.200,2,2,1.000,0,0,0,0,0,0,1,0,5,0.0
11819,Courtney Austin\courtney-austin-1,2014-15,Texas-Arlington,G,13,0,33,2,3,.667,1,1,1.000,1,2,.500,0,0,,0,2,2,1,0,0,1,6,5,0.1
11820,Matt Brown\matt-brown-5,2014-15,Harvard,G,10,0,44,2,10,.200,1,4,.250,1,6,.167,0,1,.000,2,4,6,2,1,0,2,5,5,-0.1
11821,Charles Bohannon\charles-bohannon-1,2017-18,New Orleans,G,12,0,22,2,7,.286,2,3,.667,0,4,.000,1,2,.500,0,2,2,1,0,0,4,1,5,-0.2
11822,Kyle Gonzalez\kyle-gonzalez-1,2014-15,Radford,G,2,0,11,2,2,1.000,1,1,1.000,1,1,1.000,0,0,,0,2,2,1,1,1,1,0,5,3.2
11823,Kaijae Yee-Stephens\kaijae-yee-stephens-1,2016-17,Pepperdine,G,5,0,33,2,8,.250,1,2,.500,1,6,.167,0,0,,2,0,2,0,1,0,0,5,5,0.1
11824,Tyler Simmons\tyler-simmons-1,2014-15,Central Arkansas,G,10,0,14,2,5,.400,1,3,.333,1,2,.500,0,0,,0,1,1,0,0,0,2,1,5,0.0
11825,Xavier Hallinan\xavier-hallinan-1,2015-16,Portland,G,10,0,25,1,5,.200,0,2,.000,1,3,.333,2,4,.500,0,3,3,5,2,0,2,3,5,0.4
11826,Reed Vial\reed-vial-1,2017-18,Louisiana State,G,10,1,24,1,7,.143,0,1,.000,1,6,.167,2,2,1.000,1,1,2,0,0,0,0,2,5,0.1
11827,Quincy Tillinghast\quincy-tillinghast-1,2016-17,Delaware State,G,5,0,24,2,5,.400,1,3,.333,1,2,.500,0,0,,1,1,2,1,1,0,4,3,5,0.0
11828,Evan Manning\evan-manning-1,2014-15,Kansas,G,9,0,27,2,5,.400,1,2,.500,1,3,.333,0,0,,0,2,2,2,3,0,1,3,5,0.6
11829,Dolan Mahoney\dolan-mahoney-1,2015-16,Florida Gulf Coast,G,10,0,20,2,4,.500,1,2,.500,1,2,.500,0,0,,0,1,1,1,2,0,0,1,5,0.6
11830,Andrew Dakich\andrew-dakich-1,2014-15,Michigan,G,13,0,69,2,8,.250,1,5,.200,1,3,.333,0,0,,0,4,4,2,1,0,3,11,5,-0.3
11831,Antonio Bisutti\antonio-bisutti-1,2016-17,Ohio,G,12,0,18,2,2,1.000,1,1,1.000,1,1,1.000,0,0,,2,8,10,1,1,0,2,2,5,0.6
11832,Jake Baughman\jake-baughman-1,2017-18,Loyola (IL),G,8,0,18,1,1,1.000,0,0,,1,1,1.000,2,2,1.000,0,0,0,0,1,0,1,2,5,0.5
11833,Courtney Clyburn\courtney-clyburn-1,2015-16,Marist,G,14,0,24,0,7,.000,0,5,.000,0,2,.000,5,9,.556,2,3,5,2,0,0,2,0,5,0.0
11834,L.J. Singleton\lj-singleton-1,2016-17,Mississippi State,G,7,0,27,2,7,.286,1,3,.333,1,4,.250,0,0,,1,3,4,2,1,1,1,3,5,0.5
11835,Brett Weaver\brett-weaver-1,2016-17,Nicholls State,G,7,0,20,2,11,.182,1,3,.333,1,8,.125,0,1,.000,0,0,0,0,2,0,3,4,5,-0.7
11836,Jared Young\jarrod-young-1,2013-14,Arkansas-Pine Bluff,G,5,0,6,2,2,1.000,2,2,1.000,0,0,,1,3,.333,1,1,2,0,0,0,0,0,5,0.9
11837,Dom Antonelli\dom-antonelli-1,2017-18,Navy,G,8,0,31,2,9,.222,1,3,.333,1,6,.167,0,0,,0,6,6,0,0,0,1,0,5,0.0
11838,Denis Alibegovic\denis-alibegovic-1,2017-18,Georgia State,G,18,0,24,2,13,.154,1,5,.200,1,8,.125,0,0,,0,0,0,1,0,0,1,0,5,-0.2
11839,Kory Alford\kory-alford-1,2013-14,UCLA,G,11,0,17,1,2,.500,1,2,.500,0,0,,3,4,.750,2,1,3,0,0,0,0,3,5,0.4
11840,Dan Chapman\dan-chapman-1,2013-14,Michigan State,G,14,0,21,2,7,.286,1,4,.250,1,3,.333,0,0,,1,1,2,1,0,0,1,2,5,0.1
11841,Dalton Dry\dalton-dry-1,2014-15,Texas Christian,G,10,0,38,2,5,.400,1,3,.333,1,2,.500,0,2,.000,1,5,6,1,2,1,3,5,5,0.2
11842,Karl Moton\karl-moton-1,2013-14,Alabama-Birmingham,G,6,0,8,2,3,.667,1,1,1.000,1,2,.500,0,0,,0,2,2,0,0,0,0,2,5,0.6
11843,Ross Owens\ross-owens-1,2016-17,Missouri State,G,6,0,14,2,6,.333,1,3,.333,1,3,.333,0,0,,2,2,4,1,1,0,0,2,5,0.8
11844,Michael Harper\michael-harper-4,2013-14,Hawaii,G,8,0,31,2,6,.333,1,2,.500,1,4,.250,0,0,,1,4,5,1,1,0,4,6,5,-0.2
11845,Isaac Wulff\isaac-wulff-1,2016-17,UCLA,G,5,0,9,2,2,1.000,2,2,1.000,0,0,,1,2,.500,1,1,2,0,0,0,0,1,5,0.9
11846,Joel Swallow\joel-swallow-1,2017-18,Southern Utah,G,7,0,23,2,6,.333,2,6,.333,0,0,,1,2,.500,2,4,6,0,0,0,1,1,5,0.3
11847,D.C. Davis\dc-davis-1,2017-18,Mississippi,G,5,1,16,1,2,.500,0,0,,1,2,.500,2,4,.500,0,1,1,1,1,0,2,0,5,0.6
11848,Devonte Fuller\devonte-fuller-1,2015-16,Western Carolina,G,2,0,3,2,4,.500,1,3,.333,1,1,1.000,0,0,,2,0,2,0,0,0,1,1,5,1.5
11849,Steven Miro\steven-miro-1,2013-14,Florida International,G,5,0,33,2,2,1.000,1,1,1.000,1,1,1.000,0,0,,0,5,5,2,1,0,4,1,5,0.8
11850,Mike Lukashewich\mike-lukashewich-1,2015-16,Minnesota,G,4,0,26,2,2,1.000,1,1,1.000,1,1,1.000,0,0,,1,2,3,0,1,0,1,2,5,1.2
11851,Ryan McAdoo\ryan-mcadoo-1,2017-18,Florida Gulf Coast,G,14,0,25,1,7,.143,1,5,.200,0,2,.000,3,6,.500,0,3,3,0,2,0,3,0,5,-0.1
11852,Javaka Thompson\javaka-thompson-1,2015-16,Illinois State,G,7,0,10,2,2,1.000,2,2,1.000,0,0,,1,2,.500,0,1,1,1,0,0,1,3,5,0.4
11853,Isaac Gilliam\isaac-gilliam-1,2016-17,Oral Roberts,G,4,0,10,2,7,.286,1,2,.500,1,5,.200,0,0,,0,1,1,0,1,0,3,0,5,-0.2
11854,Charles Simmons\charles-simmons-1,2016-17,Grambling,G,10,0,32,1,6,.167,0,2,.000,1,4,.250,2,4,.500,1,6,7,1,0,0,2,3,5,0.0
11855,Noah Wells\noah-wells-1,2015-16,Western Illinois,G,3,0,9,2,4,.500,1,2,.500,1,2,.500,0,0,,1,4,5,0,1,0,0,0,5,2.0
11856,Jon Fleming\jon-fleming-1,2016-17,Kent State,G,9,1,18,1,4,.250,0,0,,1,4,.250,2,2,1.000,0,0,0,2,0,0,1,2,5,0.2
11857,Mitch McCormick\mitch-mccormick-1,2013-14,Sam Houston State,G,8,0,12,2,3,.667,1,1,1.000,1,2,.500,0,0,,0,0,0,1,0,0,0,1,5,0.5
11858,Trent Jeffries\trent-jeffries-1,2013-14,Arkansas-Pine Bluff,G,15,0,64,1,7,.143,1,6,.167,0,1,.000,3,5,.600,4,6,10,2,3,0,7,7,5,-0.1
11859,Pat Branin\pat-branin-1,2013-14,College of Charleston,G,11,0,15,1,4,.250,0,1,.000,1,3,.333,2,2,1.000,0,0,0,0,0,0,0,0,5,0.2
11860,A.J. Edwards\aj-edwards-1,2015-16,Yale,G,13,0,37,2,7,.286,1,1,1.000,1,6,.167,0,0,,1,1,2,1,1,0,3,1,5,0.0
11861,Luke Wilfong\luke-wilfong-1,2017-18,Southern Methodist,G,12,0,13,2,3,.667,1,2,.500,1,1,1.000,0,0,,1,0,1,0,1,0,0,1,5,0.4
11862,Jarvis Calhoun\jarvis-calhoun-1,2014-15,Alabama-Birmingham,G,11,0,56,2,16,.125,1,5,.200,1,11,.091,0,1,.000,0,2,2,4,0,0,3,1,5,-0.5
11863,Tim McKinney\tim-mckinney-1,2013-14,Bryant,G,8,0,22,1,4,.250,1,3,.333,0,1,.000,3,4,.750,1,1,2,0,1,0,2,2,5,0.2
11864,Jake Newman\jake-newman-1,2014-15,Lafayette,G,13,0,35,1,1,1.000,1,1,1.000,0,0,,3,8,.375,1,5,6,2,0,0,0,2,5,0.4
11865,Derrell Joubert\derrell-joubert-1,2015-16,McNeese State,G,4,0,13,2,4,.500,1,1,1.000,1,3,.333,0,0,,0,2,2,0,1,0,2,2,5,0.5
11866,Roy Jackson\roy-jackson-1,2013-14,Arkansas-Pine Bluff,G,5,0,17,1,3,.333,0,1,.000,1,2,.500,2,6,.333,0,0,0,0,1,0,0,0,5,0.5
11867,Noah Frampton\noah-frampton-1,2015-16,Marshall,G,6,0,64,2,11,.182,1,2,.500,1,9,.111,0,0,,4,3,7,3,6,0,2,6,5,0.9
11868,Trey Pettus\trey-pettus-1,2014-15,Butler,G,4,0,15,2,3,.667,1,2,.500,1,1,1.000,0,0,,0,0,0,3,2,0,1,0,5,1.7
11869,Marcus White\marcus-white-4,2013-14,Illinois-Chicago,G,11,0,89,1,14,.071,0,3,.000,1,11,.091,2,2,1.000,0,2,2,10,3,0,4,5,5,0.0
11870,Gordon Gehan\gordon-gehan-1,2017-18,Boston College,G,5,0,10,2,3,.667,2,2,1.000,0,1,.000,1,2,.500,0,1,1,0,0,0,0,0,5,0.7
11871,Ky Feldman\ky-feldman-1,2016-17,Syracuse,G,9,0,14,2,6,.333,1,1,1.000,1,5,.200,0,0,,1,1,2,2,0,0,0,0,5,0.4
11872,Ben Whitlatch\ben-whitlatch-1,2013-14,William & Mary,G,8,1,20,2,8,.250,1,4,.250,1,4,.250,0,0,,1,0,1,0,1,0,0,0,5,0.2
11873,Broderick Ross\broderick-ross-1,2016-17,Missouri-Kansas City,G,8,0,29,1,10,.100,0,2,.000,1,8,.125,2,2,1.000,1,3,4,0,2,0,1,2,5,0.0
11874,Alex Nesbitt\alex-nesbitt-1,2013-14,Harvard,G,15,0,53,1,4,.250,1,3,.333,0,1,.000,3,5,.600,1,2,3,6,1,0,2,9,5,0.2
11875,Anson Moye\anson-moye-1,2014-15,Cal State Long Beach,G,12,0,26,2,5,.400,1,3,.333,1,2,.500,0,2,.000,1,2,3,0,2,0,3,3,5,0.1
11876,Joshua White\joshua-white-1,2014-15,South Dakota State,G,2,0,7,2,5,.400,1,4,.250,1,1,1.000,0,0,,1,2,3,1,1,1,1,1,5,2.3
11877,Benquan Petty\benquan-petty-1,2014-15,Lamar,G,5,0,57,0,12,.000,0,6,.000,0,6,.000,5,6,.833,0,3,3,9,0,0,10,5,5,-1.7
11878,Dan Ritter\dan-ritter-1,2017-18,Youngstown State,G,8,0,13,2,8,.250,1,3,.333,1,5,.200,0,0,,3,3,6,2,3,1,1,0,5,0.9
11879,Thomas Booker\thomas-booker-1,2016-17,South Carolina Upstate,G,4,0,37,2,7,.286,2,6,.333,0,1,.000,1,2,.500,2,4,6,2,0,1,2,3,5,0.5
11880,Langston Burnett\langston-burnett-1,2014-15,Wagner,G,8,1,93,2,14,.143,2,3,.667,0,11,.000,1,4,.250,3,6,9,2,0,4,6,6,5,-0.7
11881,Donald Ralls\donald-ralls-1,2014-15,Hampton,G,9,0,17,2,6,.333,1,1,1.000,1,5,.200,0,0,,0,1,1,1,0,0,2,2,5,0.0
11882,Wade Martin\wade-martin-1,2015-16,Louisiana-Monroe,G,13,0,44,1,16,.063,0,6,.000,1,10,.100,2,3,.667,3,6,9,1,0,0,5,6,5,-0.7
11883,Antwann Anderson\antwann-anderson-1,2016-17,Central Connecticut State,G,12,0,19,2,5,.400,1,3,.333,1,2,.500,0,0,,1,2,3,1,0,0,2,1,5,0.2
11884,Zach Frampton\zach-frampton-1,2016-17,Brigham Young,G,13,0,51,1,8,.125,0,3,.000,1,5,.200,2,2,1.000,3,14,17,2,1,0,2,8,5,0.3
11885,Jordan Lyons\jordan-lyons-12,2017-18,Southern Utah,G,13,0,34,1,4,.250,1,4,.250,0,0,,3,4,.750,1,3,4,2,0,1,4,3,5,0.1
11886,Dolan Mahoney\dolan-mahoney-1,2016-17,Florida Gulf Coast,G,5,0,16,2,4,.500,1,1,1.000,1,3,.333,0,0,,0,0,0,1,0,0,0,3,5,0.5
11887,Anfernee Brown\anfernee-brown-1,2014-15,Purdue,G,3,0,11,2,4,.500,1,2,.500,1,2,.500,0,0,,1,4,5,0,1,0,1,3,5,1.2
11888,Ryan Pippins\ryan-pippins-1,2016-17,Little Rock,G,12,0,58,2,9,.222,1,2,.500,1,7,.143,0,1,.000,0,4,4,4,1,0,8,7,5,-0.6
11889,Brian Garrett\brian-garrett-1,2016-17,Hawaii,G,6,0,13,1,4,.250,0,2,.000,1,2,.500,2,4,.500,0,2,2,0,0,0,1,2,5,0.1
11890,Paul Hiepler\paul-hiepler-1,2017-18,Abilene Christian,G,4,0,8,2,3,.667,1,1,1.000,1,2,.500,0,0,,1,2,3,0,1,0,1,0,5,1.3
11891,Drew Crabtree\drew-crabtree-1,2014-15,Ohio,G,9,0,16,1,3,.333,0,0,,1,3,.333,2,2,1.000,1,0,1,0,0,0,3,0,5,0.1
11892,Caleb Johnston\caleb-johnston-1,2014-15,Stephen F. Austin,G,18,0,31,2,3,.667,2,2,1.000,0,1,.000,1,2,.500,0,2,2,1,0,0,2,4,5,0.1
11893,Jamir Andrews\jamir-andrews-1,2016-17,Albany (NY),G,3,0,28,2,13,.154,1,3,.333,1,10,.100,0,0,,1,4,5,2,1,0,1,0,5,0.0
11894,Teo Redding\teo-redding-1,2016-17,Bowling Green State,G,1,0,5,2,3,.667,1,1,1.000,1,2,.500,0,0,,0,0,0,0,0,0,0,0,5,3.7
11895,Jason Martin\jason-martin-1,2013-14,Stephen F. Austin,G,15,0,24,1,5,.200,0,1,.000,1,4,.250,2,2,1.000,1,1,2,1,0,0,2,1,5,0.1
11896,Mory Diane\mory-diane-1,2014-15,Buffalo,G,4,0,31,2,3,.667,1,1,1.000,1,2,.500,0,3,.000,0,4,4,2,0,0,3,3,5,0.2
11897,Spencer Krannitz\spencer-krannitz-1,2014-15,Central Michigan,G,1,0,4,2,2,1.000,1,1,1.000,1,1,1.000,0,0,,1,1,2,0,0,0,0,0,5,5.4
11898,Lionel Love\lionel-love-1,2015-16,Alabama-Birmingham,G,10,0,22,1,2,.500,0,0,,1,2,.500,2,2,1.000,0,3,3,0,0,0,0,1,5,0.5
11899,Daniel Collie\daniel-collie-1,2014-15,Wright State,G,10,2,85,2,7,.286,1,3,.333,1,4,.250,0,0,,1,4,5,6,5,0,3,12,5,0.4
11900,Jaqwan McCauley\jaqwan-mccauley-1,2017-18,North Dakota,G,2,0,14,2,4,.500,2,4,.500,0,0,,1,2,.500,0,2,2,0,0,0,2,5,5,-0.4
11901,Joshua Thomas\joshua-thomas-1,2017-18,Eastern Washington,G,7,0,11,2,7,.286,1,4,.250,1,3,.333,0,0,,2,1,3,0,0,0,3,2,5,-0.2
11902,Mitch McCormick\mitch-mccormick-1,2014-15,Sam Houston State,G,14,0,45,1,10,.100,0,1,.000,1,9,.111,2,2,1.000,1,2,3,1,1,0,1,3,5,-0.1
11903,Kourtlin Jackson\kourtlin-jackson-1,2014-15,Iowa State,G,8,0,26,2,4,.500,2,2,1.000,0,2,.000,1,2,.500,2,3,5,0,1,0,1,3,5,0.5
11904,Vicpatrick Harris\vicpatrick-harris-1,2017-18,Toledo,G,6,0,15,2,4,.500,2,2,1.000,0,2,.000,1,2,.500,0,2,2,3,0,0,0,2,5,0.8
11905,Max Heller\max-heller-1,2013-14,Loyola Marymount,G,12,0,53,1,6,.167,0,3,.000,1,3,.333,2,3,.667,1,1,2,8,4,0,4,12,5,0.2
11906,Khaliq Ghani\khaliq-ghani-1,2013-14,Yale,G,7,0,21,2,8,.250,2,4,.500,0,4,.000,0,0,,1,2,3,1,0,2,4,1,4,-0.3
11907,Cameron Woodyard\cameron-woodyard-1,2016-17,Loyola (IL),G,4,0,9,2,6,.333,2,5,.400,0,1,.000,0,0,,0,3,3,1,1,1,0,0,4,1.0
11908,Armand Shoon\armand-shoon-1,2013-14,Florida Gulf Coast,G,17,0,60,1,9,.111,1,6,.167,0,3,.000,2,6,.333,2,10,12,2,1,0,1,6,4,0.0
11909,Trevon Gross Jr.\trevon-grossjr-1,2017-18,Virginia,G,10,0,27,2,3,.667,2,2,1.000,0,1,.000,0,2,.000,1,3,4,3,1,0,1,2,4,0.5
11910,Cal Reichwein\cal-reichwein-1,2017-18,Lafayette,G,12,0,21,2,5,.400,2,2,1.000,0,3,.000,0,1,.000,0,1,1,4,2,0,1,0,4,0.4
11911,Andrew Johnston\andrew-johnston-1,2013-14,Brigham Young,G,9,0,17,1,3,.333,0,0,,1,3,.333,1,4,.250,0,3,3,1,1,0,2,2,4,0.1
11912,Hasan Abdullah\hasan-abdullah-1,2015-16,Navy,G,9,0,40,2,11,.182,2,4,.500,0,7,.000,0,0,,0,1,1,8,1,0,3,6,4,-0.2
11913,Alex Austin\alex-austin-1,2016-17,Illinois,G,9,0,20,2,8,.250,2,4,.500,0,4,.000,0,0,,4,4,8,0,0,0,0,3,4,0.2
11914,Rory Temkin\rory-temkin-1,2015-16,Rhode Island,G,8,0,8,2,3,.667,2,3,.667,0,0,,0,1,.000,0,2,2,0,0,0,0,1,4,0.3
11915,Jamar Ergas\jamar-ergas-1,2017-18,Washington State,G,10,0,16,2,3,.667,2,3,.667,0,0,,0,0,,0,1,1,1,0,0,2,0,4,0.2
11916,Dominic Ballard\dominic-ballard-1,2013-14,Washington State,G,10,0,27,2,3,.667,2,3,.667,0,0,,0,0,,1,1,2,4,2,0,2,2,4,0.6
11917,Nick Wood\nick-wood-1,2015-16,Tulsa,G,5,1,8,2,4,.500,2,3,.667,0,1,.000,0,0,,1,0,1,0,0,0,0,0,4,0.5
11918,Jacob Talbert\jacob-talbert-1,2016-17,Campbell,G,9,1,24,2,9,.222,2,5,.400,0,4,.000,0,0,,0,4,4,4,2,0,4,5,4,-0.2
11919,Mike Wilson\mike-wilson-4,2014-15,Siena,G,7,0,17,2,4,.500,2,3,.667,0,1,.000,0,0,,0,3,3,0,1,0,0,1,4,0.5
11920,Mark French\mark-french-1,2016-17,Texas A&M,G,3,0,4,1,3,.333,0,1,.000,1,2,.500,1,2,.500,0,0,0,0,0,0,1,1,4,0.2
11921,Mike Harrell\mike-harrell-1,2014-15,Southern,G,25,1,151,1,18,.056,1,18,.056,0,0,,2,4,.500,1,9,10,12,8,1,7,12,4,0.0
11922,Liam Nelligan\liam-nelligan-1,2017-18,Notre Dame,G,12,0,20,2,4,.500,2,3,.667,0,1,.000,0,0,,2,2,4,0,0,2,0,0,4,0.5
11923,Kyler Shula\kyler-shula-1,2014-15,Portland State,G,4,0,10,1,2,.500,1,2,.500,0,0,,2,4,.500,0,0,0,0,1,0,0,0,4,0.8
11924,Jalen Hyde\jalen-hyde-1,2015-16,Rutgers,G,16,0,41,2,9,.222,2,5,.400,0,4,.000,0,0,,1,7,8,0,1,1,3,5,4,-0.1
11925,Noah Arciero\noah-arciero-1,2014-15,Hartford,G,15,0,28,1,5,.200,1,3,.333,0,2,.000,2,4,.500,3,6,9,1,2,1,4,6,4,0.1
11926,Michael Saxton\michael-saxton-1,2014-15,Florida State,G,3,0,4,2,2,1.000,2,2,1.000,0,0,,0,0,,0,1,1,0,0,0,0,1,4,1.1
11927,Dillon Avare\dillon-avare-1,2014-15,Louisville,G,8,0,27,1,5,.200,1,1,1.000,0,4,.000,2,3,.667,1,3,4,0,0,0,1,3,4,0.0
11928,Rem Bakamus\rem-bakamus-1,2014-15,Gonzaga,G,8,0,16,1,3,.333,1,1,1.000,0,2,.000,2,4,.500,0,2,2,1,1,0,0,4,4,0.3
11929,Martin Shaw\martin-shaw-1,2013-14,Old Dominion,G,17,0,24,2,7,.286,2,6,.333,0,1,.000,0,2,.000,0,1,1,2,0,0,2,5,4,-0.2
11930,Chase Cannon\chase-cannon-1,2014-15,North Carolina State,G,5,0,10,2,5,.400,2,3,.667,0,2,.000,0,2,.000,3,2,5,1,0,0,0,2,4,0.6
11931,Taylor McHugh\taylor-mchugh-1,2015-16,Bryant,G,19,0,49,0,11,.000,0,7,.000,0,4,.000,4,4,1.000,1,3,4,3,0,0,2,8,4,-0.3
11932,Patrick Keim\patrick-keim-1,2017-18,Auburn,G,13,0,21,1,2,.500,0,0,,1,2,.500,1,4,.250,0,2,2,0,0,0,4,6,4,-0.3
11933,Desmond Fleming\desmond-fleming-1,2013-14,Cornell,G,17,0,57,2,5,.400,2,4,.500,0,1,.000,0,1,.000,0,5,5,3,0,0,1,4,4,0.1
11934,Alex Tostado\alex-tostado-1,2017-18,Maryland,G,7,0,14,1,3,.333,1,2,.500,0,1,.000,2,3,.667,0,0,0,1,0,0,0,1,4,0.3
11935,Mak Krause\mak-krause-1,2017-18,Florida,G,7,0,16,1,2,.500,1,2,.500,0,0,,2,5,.400,1,0,1,0,0,0,0,2,4,0.2
11936,Niles Tate\niles-tate-1,2014-15,Virginia Military Institute,G,4,0,12,2,5,.400,2,2,1.000,0,3,.000,0,0,,2,0,2,1,0,0,0,3,4,0.6
11937,Jake Baughman\jake-baughman-1,2016-17,Loyola (IL),G,5,0,13,2,3,.667,2,3,.667,0,0,,0,0,,0,1,1,0,0,0,0,1,4,0.5
11938,George Marshall\george-marshall-1,2013-14,Wisconsin,G,2,0,25,1,4,.250,1,2,.500,0,2,.000,2,2,1.000,0,0,0,1,0,0,1,2,4,0.3
11939,Christian Pino\christian-pino-1,2014-15,Buffalo,G,11,0,14,1,3,.333,1,3,.333,0,0,,2,4,.500,0,0,0,1,0,0,2,2,4,-0.1
11940,Nate Buchheit\nate-buchheit-1,2013-14,Northern Iowa,G,6,0,10,2,4,.500,2,3,.667,0,1,.000,0,1,.000,1,0,1,0,0,0,0,2,4,0.3
11941,Gordon Gehan\gordon-gehan-1,2015-16,Boston College,G,7,0,14,2,3,.667,2,3,.667,0,0,,0,0,,2,0,2,0,0,0,0,0,4,0.6
11942,Darrian Gray\darrian-gray-1,2014-15,Southeast Missouri State,G,3,0,20,2,8,.250,2,4,.500,0,4,.000,0,2,.000,1,1,2,2,0,0,0,2,4,0.0
11943,Matthew Jiles\matthew-jiles-1,2016-17,New Orleans,G,17,0,51,1,3,.333,0,2,.000,1,1,1.000,1,2,.500,1,3,4,8,1,0,2,4,4,0.4
11944,Jalen Hyde\jalen-hyde-1,2014-15,Rutgers,G,6,0,20,2,3,.667,2,2,1.000,0,1,.000,0,4,.000,2,2,4,1,2,0,1,1,4,0.7
11945,Jean Yves Toupane\jean-yves-toupane-1,2013-14,St. Bonaventure,G,6,0,12,1,6,.167,1,1,1.000,0,5,.000,2,4,.500,0,1,1,0,1,0,0,1,4,0.1
11946,Michael Onyebalu\michael-onyebalu-1,2015-16,UC-Davis,G,12,1,34,1,6,.167,1,4,.250,0,2,.000,2,3,.667,1,3,4,3,1,1,3,6,4,0.0
11947,David Brown\david-brown-4,2013-14,UCLA,G,11,0,20,1,3,.333,1,2,.500,0,1,.000,2,2,1.000,1,0,1,1,0,0,0,0,4,0.3
11948,Tourron Whitfield\tourron-whitfield-1,2013-14,Marist,G,16,0,15,1,3,.333,0,0,,1,3,.333,1,2,.500,0,1,1,0,0,0,1,2,4,0.0
11949,Blake Edwards\blake-edwards-1,2015-16,South Carolina Upstate,G,6,0,5,1,2,.500,0,0,,1,2,.500,1,2,.500,0,2,2,1,0,0,2,0,4,0.3
11950,Josh Peterson\josh-peterson-1,2017-18,Coastal Carolina,G,2,0,9,2,3,.667,2,3,.667,0,0,,0,0,,0,0,0,3,0,1,2,1,4,1.6
11951,Brian Pete\brian-pete-3,2017-18,Gonzaga,G,7,1,14,2,6,.333,2,5,.400,0,1,.000,0,0,,0,5,5,1,0,0,0,1,4,0.3
11952,Bobby Williams\bobby-williams-1,2016-17,South Carolina State,G,14,0,31,2,8,.250,2,5,.400,0,3,.000,0,0,,0,4,4,0,1,1,0,1,4,0.1
11953,Clay Weatherspoon\clay-weatherspoon-1,2016-17,Southern Mississippi,G,13,0,67,1,5,.200,1,5,.200,0,0,,2,3,.667,2,5,7,1,1,0,5,5,4,-0.1
11954,Sam Norton\sam-norton-1,2016-17,Loyola (MD),G,8,0,19,1,3,.333,1,3,.333,0,0,,2,3,.667,0,1,1,1,4,0,1,0,4,0.7
11955,Gentry Hunt\gentry-hunt-1,2015-16,Chicago State,G,7,0,13,1,4,.250,1,2,.500,0,2,.000,2,4,.500,0,1,1,0,1,1,1,1,4,0.2
11956,Glorind Lisha\glorind-lisha-1,2015-16,Loyola (IL),G,7,0,18,1,3,.333,0,1,.000,1,2,.500,1,4,.250,0,0,0,0,2,0,1,1,4,0.2
11957,Javion Watson\javion-watson-1,2013-14,Cal State Long Beach,G,11,1,45,1,6,.167,0,2,.000,1,4,.250,1,2,.500,0,3,3,5,3,0,4,1,4,0.3
11958,Davante Pope\davante-pope-1,2016-17,Alabama State,G,2,0,20,2,4,.500,2,3,.667,0,1,.000,0,0,,1,2,3,1,2,0,0,2,4,2.6
11959,Parker U'u\parker-uu-1,2015-16,San Diego State,G,9,0,15,1,5,.200,1,2,.500,0,3,.000,2,2,1.000,0,4,4,5,0,0,1,3,4,0.4
11960,Mike Noyes\mike-noyes-1,2015-16,Connecticut,G,9,0,13,2,4,.500,2,4,.500,0,0,,0,0,,0,1,1,0,0,0,1,2,4,0.1
11961,Myles Tate\myles-tate-1,2016-17,George Mason,G,7,0,17,0,3,.000,0,2,.000,0,1,.000,4,7,.571,1,4,5,5,1,0,2,0,4,0.7
11962,Edwin Olympio\edwin-olympio-1,2014-15,Texas-San Antonio,G,5,0,22,1,2,.500,1,2,.500,0,0,,2,4,.500,2,3,5,1,2,0,2,4,4,0.7
11963,Davon Dillard\davon-dillard-1,2015-16,Oklahoma State,G,6,0,24,2,5,.400,2,3,.667,0,2,.000,0,1,.000,3,0,3,0,1,0,0,7,4,0.2
11964,Sam Orchard\sam-orchard-1,2014-15,Utah State,G,9,0,53,2,9,.222,2,6,.333,0,3,.000,0,3,.000,4,5,9,7,3,0,4,7,4,0.3
11965,Andrew Leone\andrew-leone-1,2015-16,Fairfield,G,9,0,11,0,1,.000,0,0,,0,1,.000,4,6,.667,0,3,3,0,0,0,0,0,4,0.4
11966,Cole McConnell\cole-mcconnell-1,2013-14,Michigan,G,4,0,10,1,3,.333,0,0,,1,3,.333,1,2,.500,0,1,1,0,0,0,0,1,4,0.5
11967,Nick Hamilton\nick-hamilton-1,2016-17,University of California,G,10,0,36,1,6,.167,0,1,.000,1,5,.200,1,2,.500,3,1,4,2,0,0,1,4,4,0.1
11968,Billy Donovan\billy-donovan-2,2013-14,Florida,G,16,0,44,0,9,.000,0,1,.000,0,8,.000,4,4,1.000,0,4,4,3,2,0,3,7,4,-0.2
11969,Omari Minor\omari-minor-1,2013-14,Tennessee-Martin,G,4,1,17,2,5,.400,2,4,.500,0,1,.000,0,0,,0,1,1,3,0,0,1,0,4,0.7
11970,Matt Williams\matt-williams-4,2014-15,Central Florida,G,1,0,9,0,3,.000,0,0,,0,3,.000,4,4,1.000,0,1,1,0,0,1,0,1,4,2.5
11971,Evan Manning\evan-manning-1,2013-14,Kansas,G,6,0,10,1,4,.250,0,1,.000,1,3,.333,1,2,.500,0,0,0,1,1,0,2,2,4,0.0
11972,Djordjije Mumin\djordjije-mumin-1,2015-16,Central Florida,G,6,0,15,2,7,.286,2,3,.667,0,4,.000,0,0,,0,2,2,0,0,0,1,2,4,-0.2
11973,Brady Moses\brady-moses-1,2016-17,Stetson,G,5,0,10,2,3,.667,2,2,1.000,0,1,.000,0,0,,0,3,3,0,0,0,0,1,4,0.6
11974,Daniel Collie\daniel-collie-1,2013-14,Wright State,G,8,0,37,2,5,.400,2,3,.667,0,2,.000,0,0,,0,4,4,1,3,0,6,4,4,-0.2
11975,Alec Raven\alec-raven-1,2016-17,Cal Poly,G,5,0,16,1,3,.333,1,2,.500,0,1,.000,2,2,1.000,0,4,4,0,0,0,0,1,4,0.6
11976,Fred Newell\fred-newell-1,2013-14,North Dakota State,G,15,0,40,1,10,.100,1,6,.167,0,4,.000,2,2,1.000,0,4,4,7,1,0,4,4,4,-0.1
11977,Rob Blissitt\rob-blissitt-1,2014-15,Cincinnati,G,5,0,7,1,2,.500,0,1,.000,1,1,1.000,1,2,.500,0,0,0,1,0,0,1,0,4,0.5
11978,Felix Balamou\felix-balamou-1,2013-14,St. John's (NY),G,4,2,35,1,7,.143,1,7,.143,0,0,,2,2,1.000,2,1,3,2,1,0,1,2,4,0.5
11979,Dylan Sanford\dylan-sanford-1,2015-16,Western Kentucky,G,5,0,13,2,2,1.000,2,2,1.000,0,0,,0,0,,1,0,1,0,0,0,4,2,4,-0.1
11980,Ziga Habat\ziga-habat-1,2017-18,Hartford,G,5,0,9,1,1,1.000,1,1,1.000,0,0,,2,2,1.000,0,1,1,0,0,0,0,2,4,0.6
11981,Dezmond James\dezmond-james-1,2014-15,Air Force,G,7,0,23,1,6,.167,1,3,.333,0,3,.000,2,2,1.000,0,6,6,1,1,0,2,1,4,0.2
11982,Devon Williams\devon-williams-1,2015-16,New Mexico,G,2,0,28,0,1,.000,0,1,.000,0,0,,4,6,.667,0,3,3,0,1,0,1,4,4,0.9
11983,Jonah Meredith\jonah-meredith-1,2013-14,Towson,G,4,0,9,1,1,1.000,1,1,1.000,0,0,,2,2,1.000,1,2,3,0,1,0,1,2,4,1.1
11984,Matt Fraschilla\matt-fraschilla-1,2014-15,Harvard,G,12,1,43,1,4,.250,1,4,.250,0,0,,2,5,.400,0,5,5,2,0,0,5,8,4,-0.4
11985,Thomas Davis\thomas-davis-2,2016-17,Tennessee State,G,4,0,14,2,3,.667,2,3,.667,0,0,,0,0,,0,3,3,2,0,0,1,1,4,0.9
11986,Austin Crawford\austin-crawford-1,2017-18,Morehead State,G,9,0,17,1,7,.143,0,3,.000,1,4,.250,1,2,.500,0,1,1,0,0,0,1,0,4,-0.2
11987,Josiah Dunn\josiah-dunn-1,2016-17,Denver,G,5,0,5,2,2,1.000,2,2,1.000,0,0,,0,1,.000,0,1,1,1,0,0,0,0,4,0.8
11988,Eric Youncofski\eric-youncofski-1,2014-15,Rhode Island,G,6,0,6,1,3,.333,1,3,.333,0,0,,2,2,1.000,0,0,0,0,0,0,0,2,4,0.3
11989,Pat Lenehan\pat-lenehan-1,2013-14,Connecticut,G,8,0,21,1,6,.167,0,3,.000,1,3,.333,1,2,.500,1,2,3,1,0,0,1,2,4,0.0
11990,KJ Langston\kj-langston-1,2017-18,Washington State,G,8,0,26,2,8,.250,2,2,1.000,0,6,.000,0,1,.000,0,0,0,0,0,0,0,1,4,-0.2
11991,Joey Lane\joey-lane-1,2015-16,Ohio State,G,7,0,11,1,7,.143,0,0,,1,7,.143,1,2,.500,0,0,0,0,0,0,0,2,4,-0.2
11992,Kyran McClure\kyran-mcclure-1,2016-17,Navy,G,3,0,20,1,6,.167,0,1,.000,1,5,.200,1,3,.333,0,2,2,4,4,0,1,3,4,1.5
11993,Jared Harper\jared-harper-1,2016-17,Fairfield,G,11,0,12,1,2,.500,0,0,,1,2,.500,1,2,.500,1,2,3,1,0,0,1,2,4,0.3
11994,Maceo Baston\maceo-baston-2,2014-15,Florida Atlantic,G,6,0,45,2,9,.222,2,5,.400,0,4,.000,0,0,,0,8,8,0,1,0,4,4,4,-0.6
11995,Carter Josephs\carter-josephs-1,2015-16,Vanderbilt,G,21,1,98,1,1,1.000,1,1,1.000,0,0,,2,5,.400,1,6,7,16,2,0,7,6,4,0.4
11996,Beau Rydalch\beau-rydalch-1,2016-17,Utah,G,10,0,34,1,7,.143,1,3,.333,0,4,.000,2,2,1.000,4,4,8,1,1,0,3,2,4,0.1
11997,Jordan Smith\jordan-smith-2,2015-16,Wisconsin,G,8,0,9,1,3,.333,1,3,.333,0,0,,2,3,.667,1,1,2,0,0,1,1,0,4,0.3
11998,Jimmie Jones\jimmie-jones-1,2013-14,Houston,G,4,0,42,2,5,.400,2,3,.667,0,2,.000,0,1,.000,1,2,3,3,1,0,3,0,4,0.6
11999,Ganlandou Cisse\ganlandou-cisse-1,2015-16,Long Island University,G,7,0,12,2,2,1.000,2,2,1.000,0,0,,0,0,,0,1,1,0,0,0,0,2,4,0.4
12000,Dolan Mahoney\dolan-mahoney-1,2017-18,Florida Gulf Coast,G,13,0,29,2,4,.500,2,3,.667,0,1,.000,0,0,,2,1,3,1,1,0,1,4,4,0.2
12001,Jaylin McDonald\jaylin-mcdonald-1,2016-17,Ohio,G,12,0,19,1,6,.167,1,2,.500,0,4,.000,2,2,1.000,0,1,1,0,0,0,0,1,4,0.0
12002,Dominic Ezeani\dominic-ezeani-1,2016-17,Longwood,G,18,1,90,2,6,.333,2,5,.400,0,1,.000,0,0,,3,7,10,3,2,0,1,11,4,0.2
12003,Dante Scott\dante-scott-1,2015-16,Memphis,G,10,0,27,1,15,.067,1,9,.111,0,6,.000,2,3,.667,1,5,6,0,1,0,0,1,4,-0.4
12004,Matt Staubi\matt-staubi-1,2014-15,Loyola (MD),G,10,0,16,2,3,.667,2,3,.667,0,0,,0,0,,0,2,2,0,1,0,2,3,4,0.1
12005,DeDe Reynolds\dede-reynolds-1,2017-18,Georgia Southern,G,5,0,12,2,6,.333,2,4,.500,0,2,.000,0,0,,3,1,4,0,1,0,1,1,4,0.5
12006,Luke Davis\luke-davis-1,2013-14,North Carolina,G,21,0,130,2,8,.250,2,2,1.000,0,6,.000,0,4,.000,1,7,8,11,2,0,6,10,4,0.0
12007,DeRias Johnson\derias-johnson-1,2016-17,Southern,G,9,0,30,2,16,.125,2,8,.250,0,8,.000,0,0,,3,6,9,3,2,1,0,6,4,0.0
12008,Devon Pekas\devon-pekas-1,2013-14,Liberty,G,10,0,12,2,4,.500,2,3,.667,0,1,.000,0,1,.000,2,1,3,0,1,0,3,1,4,0.1
12009,Trey Slate\trey-slate-1,2013-14,Oklahoma,G,7,0,10,2,4,.500,2,3,.667,0,1,.000,0,0,,0,1,1,0,0,0,2,1,4,0.0
12010,Jared Bloom\jared-bloom-1,2013-14,Purdue-Fort Wayne,G,9,0,18,2,4,.500,2,3,.667,0,1,.000,0,1,.000,0,2,2,1,1,0,0,0,4,0.4
12011,Drew Cayce\drew-cayce-1,2017-18,Illinois,G,9,0,34,0,8,.000,0,1,.000,0,7,.000,4,6,.667,1,3,4,0,4,0,1,1,4,0.2
12012,Aaron Williams\aaron-williams-6,2014-15,Western Carolina,G,6,0,7,1,1,1.000,1,1,1.000,0,0,,2,2,1.000,0,2,2,0,0,1,3,0,4,0.3
12013,Jackson Perez\jackson-perez-1,2013-14,Oklahoma State,G,5,0,4,2,2,1.000,2,2,1.000,0,0,,0,0,,0,0,0,0,0,0,0,1,4,0.6
12014,Patrick Binzer\patrick-binzer-1,2016-17,Texas-Arlington,G,6,0,10,2,4,.500,2,2,1.000,0,2,.000,0,0,,0,0,0,0,0,0,1,0,4,0.2
12015,Juwan Washington\juwan-washington-1,2016-17,Grand Canyon,G,3,0,5,1,1,1.000,1,1,1.000,0,0,,2,2,1.000,0,0,0,0,0,0,0,0,4,1.2
12016,David Brown\david-brown-4,2014-15,UCLA,G,13,0,24,2,10,.200,2,7,.286,0,3,.000,0,0,,1,3,4,1,3,0,5,1,4,-0.2
12017,Evan Richard\evan-richard-1,2014-15,Milwaukee,G,10,1,53,2,5,.400,2,4,.500,0,1,.000,0,0,,2,9,11,2,0,1,2,5,4,0.4
12018,Chris Blakeley\chris-blakeley-1,2013-14,Abilene Christian,G,26,1,145,2,9,.222,2,5,.400,0,4,.000,0,2,.000,1,13,14,19,3,0,19,12,4,-0.2
12019,John Kirincic\john-kirincic-1,2017-18,Youngstown State,G,4,0,10,2,4,.500,2,2,1.000,0,2,.000,0,0,,2,0,2,0,2,0,1,2,4,0.9
12020,Ryan Parsons\ryan-parsons-1,2013-14,Eastern Kentucky,G,10,0,27,1,11,.091,1,2,.500,0,9,.000,2,4,.500,0,3,3,0,2,0,1,1,4,-0.3
12021,Jack Tempchin\jack-tempchin-1,2017-18,George Mason,G,4,0,5,0,0,,0,0,,0,0,,4,6,.667,0,2,2,1,0,0,2,1,4,0.5
12022,Joel King\joel-king-1,2013-14,Portland State,G,5,0,7,2,4,.500,2,4,.500,0,0,,0,0,,3,2,5,1,0,2,0,0,4,1.4
12023,Brock Johnson\brock-johnson-1,2016-17,Charleston Southern,G,3,0,8,2,5,.400,2,3,.667,0,2,.000,0,0,,1,0,1,3,1,0,0,0,4,1.7
12024,Van Rolle\van-rolle-1,2013-14,Coppin State,G,7,0,30,1,8,.125,1,6,.167,0,2,.000,2,2,1.000,1,2,3,3,0,0,4,4,4,-0.5
12025,Patrick Keim\patrick-keim-1,2016-17,Auburn,G,5,0,9,1,3,.333,0,1,.000,1,2,.500,1,2,.500,0,3,3,1,0,0,1,0,4,0.5
12026,Forrest Greenwalt\forrest-greenwalt-1,2013-14,San Diego,G,3,0,6,2,2,1.000,2,2,1.000,0,0,,0,0,,0,1,1,0,0,0,0,1,4,1.1
12027,Brody Hicks\brody-hicks-1,2017-18,Liberty,G,13,0,35,2,5,.400,2,3,.667,0,2,.000,0,0,,4,7,11,6,1,2,2,2,4,0.8
12028,Desmond Fleming\desmond-fleming-1,2014-15,Cornell,G,12,0,26,1,2,.500,1,2,.500,0,0,,2,3,.667,0,1,1,5,1,0,1,7,4,0.3
12029,Frank Byers\frank-byers-1,2015-16,Texas A&M,G,8,0,9,2,4,.500,2,3,.667,0,1,.000,0,1,.000,0,0,0,0,1,0,0,1,4,0.3
12030,Will Burkett\will-burkett-1,2016-17,Santa Clara,G,5,0,14,0,5,.000,0,1,.000,0,4,.000,4,5,.800,0,4,4,0,0,1,1,1,4,0.1
12031,Kelton Conway\kelton-conway-1,2015-16,Cal State Northridge,G,9,0,17,0,4,.000,0,3,.000,0,1,.000,4,6,.667,0,3,3,1,3,0,2,5,4,0.1
12032,Loren Brill\loren-brill-1,2016-17,Cal State Fullerton,G,4,0,12,1,3,.333,1,2,.500,0,1,.000,2,4,.500,0,4,4,1,1,0,4,0,4,0.1
12033,T.K. Hayes\tk-hayes-1,2013-14,Furman,G,6,0,10,1,2,.500,0,0,,1,2,.500,1,2,.500,0,1,1,0,0,0,1,1,4,0.3
12034,Vinny Ferrari\vinny-ferrari-1,2017-18,San Diego,G,2,0,6,1,2,.500,0,0,,1,2,.500,1,2,.500,1,0,1,0,1,1,0,1,4,2.3
12035,Alozie Erondu\alozie-erondu-1,2013-14,Loyola Marymount,G,11,0,21,2,4,.500,2,4,.500,0,0,,0,0,,3,4,7,0,0,1,0,4,4,0.4
12036,Nick Davis\nick-davis-2,2013-14,Alabama State,G,6,0,23,1,7,.143,0,1,.000,1,6,.167,1,2,.500,1,2,3,0,1,0,1,2,4,-0.1
12037,Jordan Pickett\jordan-pickett-1,2013-14,Loyola (IL),G,6,0,45,2,9,.222,2,4,.500,0,5,.000,0,0,,0,2,2,5,1,0,1,2,4,0.3
12038,Tyler Miller\tyler-miller-2,2017-18,Western Kentucky,G,14,0,73,2,6,.333,2,3,.667,0,3,.000,0,4,.000,2,7,9,2,3,0,1,6,4,0.3
12039,Jordan McNair\jordan-mcnair-1,2017-18,Arkansas-Pine Bluff,G,2,0,10,1,5,.200,0,1,.000,1,4,.250,1,3,.333,0,0,0,2,3,0,1,4,4,1.0
12040,Marshall Graves\marshall-graves-1,2016-17,Louisiana State,G,15,0,48,1,9,.111,1,3,.333,0,6,.000,2,3,.667,1,4,5,3,1,0,3,7,4,-0.2
12041,Quinton Chievous\quinton-chievous-1,2013-14,Tennessee,G,9,0,32,1,4,.250,1,3,.333,0,1,.000,2,3,.667,2,5,7,1,0,0,2,9,4,-0.1
12042,Patrick Fisher\patrick-fisher-1,2016-17,Winthrop,G,2,0,9,2,2,1.000,2,2,1.000,0,0,,0,0,,0,0,0,0,0,0,1,1,4,1.0
12043,Chad Hudson\chad-hudson-1,2016-17,IUPUI,G,10,0,23,1,4,.250,0,1,.000,1,3,.333,1,4,.250,0,3,3,2,1,0,3,3,4,-0.1
12044,Sam Averbuck\sam-averbuck-1,2016-17,Wyoming,G,6,0,32,1,6,.167,1,5,.200,0,1,.000,2,2,1.000,1,1,2,4,0,0,0,4,4,0.4
12045,Kofi Andoh\kofi-andoh-1,2014-15,Howard,G,11,0,61,1,4,.250,1,2,.500,0,2,.000,2,6,.333,2,5,7,2,3,0,5,3,4,0.1
12046,Charlie Inclan\charlie-inclan-1,2015-16,Presbyterian,G,2,0,5,2,6,.333,2,5,.400,0,1,.000,0,0,,0,0,0,0,1,0,0,0,4,0.8
12047,Garrett Galvin\garrett-galvin-1,2013-14,University of California,G,9,0,20,2,3,.667,2,3,.667,0,0,,0,2,.000,0,1,1,0,0,0,1,1,4,0.1
12048,Chris Johnson\chris-johnson-8,2013-14,Arizona,G,4,0,6,1,1,1.000,0,0,,1,1,1.000,1,2,.500,0,0,0,0,0,0,0,0,4,0.8
12049,Jamison Glover\jamison-glover-1,2017-18,William & Mary,G,6,1,14,1,4,.250,1,2,.500,0,2,.000,2,2,1.000,0,2,2,1,1,0,0,3,4,0.5
12050,Joshea Singleton\joshea-singleton-1,2014-15,Bucknell,G,3,0,11,1,3,.333,0,1,.000,1,2,.500,1,2,.500,0,0,0,0,0,0,0,2,4,0.4
12051,Mike Washington\mike-washington-2,2014-15,Princeton,G,10,0,21,2,5,.400,2,3,.667,0,2,.000,0,3,.000,0,3,3,4,1,0,1,3,4,0.3
12052,Tyler Winston\tyler-winston-1,2014-15,San Jose State,G,1,0,21,1,3,.333,0,1,.000,1,2,.500,1,2,.500,0,1,1,1,0,0,0,0,4,2.9
12053,Thomas Kennedy\thomas-kennedy-2,2016-17,Holy Cross,G,8,0,10,2,5,.400,2,5,.400,0,0,,0,1,.000,2,1,3,0,1,0,1,0,4,0.3
12054,Bobby Perez\bobby-perez-1,2015-16,Wofford,G,9,0,21,2,4,.500,2,4,.500,0,0,,0,1,.000,0,0,0,3,0,0,2,1,4,0.1
12055,Thomas Blake\thomas-blake-1,2014-15,North Dakota,G,5,0,16,1,5,.200,1,5,.200,0,0,,2,4,.500,0,3,3,0,0,0,0,1,4,0.1
12056,Mark Madden\mark-madden-2,2017-18,Army,G,7,0,27,1,3,.333,1,2,.500,0,1,.000,2,2,1.000,1,3,4,1,1,0,1,2,4,0.5
12057,Taevon Ashmeade\taevon-ashmeade-1,2017-18,Robert Morris,G,3,1,20,2,6,.333,2,5,.400,0,1,.000,0,0,,0,1,1,3,1,0,1,3,4,0.6
12058,Rodney Herenton\rodney-herenton-1,2017-18,Stanford,G,6,0,10,1,2,.500,1,2,.500,0,0,,2,2,1.000,0,1,1,0,0,0,0,0,4,0.6
12059,Peter Barba\peter-barba-1,2016-17,Columbia,G,7,0,31,2,8,.250,2,3,.667,0,5,.000,0,0,,2,3,5,2,1,0,1,6,4,0.1
12060,Sean Tuohy\sean-tuohy-1,2015-16,Loyola (MD),G,11,0,25,2,7,.286,2,2,1.000,0,5,.000,0,0,,1,2,3,2,3,0,2,3,4,0.2
12061,Jordan Howard\jordan-howard-1,2015-16,Troy,G,6,0,6,2,5,.400,2,5,.400,0,0,,0,2,.000,1,2,3,1,0,0,4,1,4,-0.3
12062,Jonny Marlin\jonny-marlin-1,2013-14,Indiana,G,18,0,43,0,4,.000,0,3,.000,0,1,.000,4,4,1.000,2,0,2,3,1,0,1,2,4,0.2
12063,Richard Romeo\richard-romeo-1,2013-14,West Virginia,G,7,0,15,1,3,.333,1,3,.333,0,0,,2,2,1.000,2,2,4,0,0,0,2,3,4,0.2
12064,Milan Williams\milan-williams-1,2017-18,Colgate,G,4,0,17,0,1,.000,0,1,.000,0,0,,4,4,1.000,0,2,2,0,0,0,1,4,4,0.3
12065,Kevin Dunleavy\kevin-dunleavy-1,2013-14,Southern Methodist,G,8,0,11,2,5,.400,2,2,1.000,0,3,.000,0,2,.000,1,0,1,0,1,0,2,0,4,0.0
12066,Isaac Gilliam\isaac-gilliam-1,2015-16,Oral Roberts,G,3,0,10,1,6,.167,1,3,.333,0,3,.000,2,4,.500,0,2,2,0,0,0,1,2,4,-0.6
12067,Hamilton Bailey\hamilton-bailey-1,2013-14,Samford,G,6,0,20,0,1,.000,0,0,,0,1,.000,4,5,.800,0,2,2,0,0,0,0,0,4,0.6
12068,Mike Robbins\mike-robbins-1,2014-15,Temple,G,8,0,11,1,3,.333,0,1,.000,1,2,.500,1,2,.500,1,2,3,2,1,0,1,1,4,0.5
12069,Nathan Watkins\nathan-watkins-1,2015-16,Vanderbilt,G,11,1,29,2,2,1.000,2,2,1.000,0,0,,0,2,.000,1,4,5,1,0,0,0,3,4,0.4
12070,Clayton Jones\clayton-jones-1,2016-17,Illinois,G,9,0,11,1,3,.333,0,1,.000,1,2,.500,1,1,1.000,0,0,0,0,0,0,0,0,4,0.3
12071,Jose Garcia Gonzalez\josegarcia-gonzalez-1,2017-18,Cal State Fullerton,G,1,0,4,2,7,.286,2,5,.400,0,2,.000,0,0,,4,1,5,0,1,0,0,0,4,4.0
12072,Logan Louks\logan-louks-1,2013-14,UC-Santa Barbara,G,4,0,4,2,3,.667,2,3,.667,0,0,,0,0,,0,0,0,0,0,0,0,0,4,0.7
12073,Brandon Leftwich\brandon-leftwich-1,2017-18,Mount St. Mary's,G,10,0,12,1,4,.250,1,4,.250,0,0,,2,4,.500,0,2,2,4,2,0,3,1,4,0.3
12074,Lucas Campbell\lucas-campbell-1,2016-17,Tennessee,G,3,0,5,0,0,,0,0,,0,0,,4,6,.667,0,0,0,0,0,0,0,0,4,1.1
12075,Kevin Crawford\kevin-crawford-2,2013-14,North Carolina Central,G,6,0,19,2,3,.667,2,2,1.000,0,1,.000,0,1,.000,2,2,4,3,2,0,5,3,4,0.4
12076,Lexx Edwards\lexx-edwards-1,2015-16,Florida,G,10,0,14,1,5,.200,0,1,.000,1,4,.250,1,2,.500,1,6,7,1,0,0,0,2,4,0.3
12077,Derek McKnight\derek-mcknight-1,2015-16,NJIT,G,8,0,17,1,4,.250,1,4,.250,0,0,,2,4,.500,1,1,2,0,0,0,1,3,4,-0.1
12078,David Nelson\david-nelson-3,2015-16,Southern Methodist,G,4,0,6,2,2,1.000,2,2,1.000,0,0,,0,0,,0,1,1,1,0,0,0,0,4,1.1
12079,DJ Sylvester\dj-sylvester-1,2016-17,UC-Riverside,G,3,0,41,1,13,.077,1,5,.200,0,8,.000,2,4,.500,3,2,5,3,1,0,4,8,4,-2.3
12080,Brandon Austin\brandon-austin-1,2016-17,Alabama,G,7,0,45,1,19,.053,1,13,.077,0,6,.000,2,5,.400,2,2,4,1,1,1,1,3,4,-1.1
12081,Tyler Loose\tyler-loose-1,2017-18,Northern Colorado,G,16,1,35,2,4,.500,2,4,.500,0,0,,0,1,.000,1,5,6,2,0,0,2,3,4,0.1
12082,Charlie Bagin\charlie-bagin-1,2017-18,Princeton,G,10,0,28,1,6,.167,1,2,.500,0,4,.000,2,2,1.000,0,1,1,1,2,1,2,3,4,0.1
12083,AJ Caldwell\aj-caldwell-1,2017-18,South Alabama,G,4,0,20,1,8,.125,1,1,1.000,0,7,.000,2,3,.667,1,2,3,1,0,1,2,2,4,-0.4
12084,Tareq Coburn\tareq-coburn-1,2016-17,St. Bonaventure,G,11,0,28,1,6,.167,0,2,.000,1,4,.250,1,3,.333,1,2,3,2,1,0,0,2,4,0.2
12085,Dustin Clarke\dustin-clarke-1,2013-14,Appalachian State,G,3,0,11,2,6,.333,2,4,.500,0,2,.000,0,0,,0,4,4,1,1,0,1,1,4,0.7
12086,Otis Dortch\otis-dortch-1,2017-18,Western Illinois,G,5,0,21,1,4,.250,1,3,.333,0,1,.000,2,4,.500,0,1,1,2,1,0,2,2,4,0.1
12087,James Fraschilla\james-fraschilla-1,2013-14,Oklahoma,G,5,0,7,0,0,,0,0,,0,0,,4,6,.667,0,2,2,1,1,0,3,1,4,0.4
12088,Elijah Blake\elijah-blake-1,2017-18,Denver,G,1,0,7,2,2,1.000,2,2,1.000,0,0,,0,0,,0,1,1,0,0,0,0,1,4,3.3
12089,Jordan Forehand\jordan-forehand-1,2016-17,Saint Francis (PA),G,5,0,9,2,3,.667,2,3,.667,0,0,,0,0,,0,0,0,0,0,0,1,2,4,0.2
12090,Jon Fleming\jon-fleming-1,2015-16,Kent State,G,4,0,9,1,3,.333,1,1,1.000,0,2,.000,2,4,.500,1,0,1,0,1,0,0,0,4,0.8
12091,Hameed Ali\hameed-ali-1,2014-15,Texas A&M-Corpus Christi,G,2,0,20,2,6,.333,2,4,.500,0,2,.000,0,0,,1,0,1,4,1,0,1,1,4,1.9
12092,Mohamed Abuarisha\mohamed-abuarisha-1,2016-17,Jacksonville State,G,3,0,15,2,4,.500,2,4,.500,0,0,,0,1,.000,0,2,2,1,0,0,1,1,4,0.5
12093,Dominique Williams\dominique-williams-3,2014-15,San Francisco,G,4,0,7,1,3,.333,0,1,.000,1,2,.500,0,0,,0,1,1,1,0,0,1,1,3,0.2
12094,Jacob Casper\jacob-casper-1,2013-14,North Carolina-Asheville,G,7,0,23,1,4,.250,0,1,.000,1,3,.333,0,0,,0,1,1,0,0,0,4,0,3,-0.4
12095,Ethan Freeman\ethan-freeman-1,2013-14,Western Carolina,G,5,0,13,1,4,.250,0,3,.000,1,1,1.000,0,0,,1,1,2,3,0,0,0,2,3,0.6
12096,Austin Lee\austin-lee-1,2015-16,Northern Arizona,G,3,0,6,1,1,1.000,0,0,,1,1,1.000,0,0,,0,1,1,1,0,0,4,0,3,-0.1
12097,O.J. Lewis\oj-lewis-1,2013-14,La Salle,G,7,0,11,1,2,.500,0,1,.000,1,1,1.000,0,2,.000,0,1,1,2,0,1,2,0,3,0.2
12098,Grant Sinn\grant-sinn-1,2016-17,IUPUI,G,7,0,12,1,7,.143,0,0,,1,7,.143,0,0,,1,0,1,0,0,0,0,3,3,-0.3
12099,Luke Adams\luke-adams-1,2013-14,Texas Tech,G,12,0,43,1,7,.143,1,2,.500,0,5,.000,1,2,.500,0,3,3,7,3,0,3,6,3,0.1
12100,Mark Noble\mark-noble-1,2013-14,Akron,G,1,0,3,1,1,1.000,0,0,,1,1,1.000,0,0,,0,0,0,0,0,0,0,1,3,2.3
12101,David Hanson\david-hanson-2,2014-15,Abilene Christian,G,13,0,35,1,6,.167,0,3,.000,1,3,.333,0,2,.000,1,3,4,5,1,1,2,4,3,0.1
12102,Keenan Wetzel\keenan-wetzel-1,2014-15,Michigan State,G,14,0,31,1,9,.111,0,2,.000,1,7,.143,0,0,,1,3,4,0,0,0,1,2,3,-0.2
12103,Alex Rifkind\alex-rifkind-1,2016-17,Cal State Long Beach,G,5,0,6,1,2,.500,0,0,,1,2,.500,0,0,,0,0,0,0,1,0,1,0,3,0.4
12104,Stelios Papafloratos\stelios-papafloratos-1,2014-15,Nevada,G,9,0,24,1,9,.111,0,2,.000,1,7,.143,0,2,.000,0,3,3,1,0,0,4,3,3,-0.8
12105,Sharieff Medlock\sharieff-medlock-1,2014-15,Chicago State,G,4,0,9,1,1,1.000,0,0,,1,1,1.000,0,0,,0,1,1,0,2,0,0,0,3,1.3
12106,Torey Burston\torey-burston-1,2015-16,Virginia Commonwealth,G,20,0,66,1,8,.125,1,7,.143,0,1,.000,1,2,.500,2,4,6,5,3,0,1,5,3,0.2
12107,Connor Klementowicz\connor-klementowicz-1,2016-17,Hofstra,G,3,0,6,1,1,1.000,0,0,,1,1,1.000,0,0,,0,1,1,0,0,0,0,0,3,1.0
12108,Kory Alford\kory-alford-1,2014-15,UCLA,G,12,0,26,1,4,.250,0,1,.000,1,3,.333,0,0,,0,2,2,1,0,0,2,0,3,0.0
12109,Tarik Clement\tarik-clement-1,2016-17,South Carolina State,G,5,0,7,0,3,.000,0,3,.000,0,0,,3,4,.750,0,0,0,1,0,0,0,0,3,0.2
12110,Kris Alford\kris-alford-1,2016-17,Drexel,G,5,0,19,1,8,.125,0,1,.000,1,7,.143,0,0,,1,2,3,1,1,0,2,1,3,-0.3
12111,Henry Lowe\henry-lowe-1,2014-15,Villanova,G,16,0,33,1,7,.143,0,1,.000,1,6,.167,0,0,,0,2,2,1,1,0,0,3,3,0.0
12112,Eli Carter\eli-carter-1,2013-14,Florida,G,7,0,53,1,14,.071,0,5,.000,1,9,.111,0,2,.000,2,3,5,2,0,0,3,5,3,-1.2
12113,Carlitos Anderson\carlitos-anderson-1,2015-16,Akron,G,5,0,13,1,1,1.000,0,0,,1,1,1.000,0,0,,0,3,3,1,1,0,0,0,3,1.1
12114,Christian White\christian-white-1,2014-15,Syracuse,G,4,0,7,1,2,.500,0,0,,1,2,.500,0,2,.000,1,2,3,0,0,0,1,0,3,0.4
12115,John Mosser\john-mosser-1,2013-14,Mercer,G,9,0,18,0,7,.000,0,3,.000,0,4,.000,3,4,.750,1,7,8,1,0,0,1,1,3,0.0
12116,Jaylin McDonald\jaylin-mcdonald-1,2015-16,Ohio,G,8,0,7,1,1,1.000,1,1,1.000,0,0,,1,2,.500,0,0,0,1,0,0,0,0,3,0.4
12117,Jantzen Raymond\jantzen-colie-raymond-1,2015-16,Charleston Southern,G,3,0,8,1,3,.333,0,1,.000,1,2,.500,0,1,.000,0,0,0,0,0,0,2,1,3,-0.5
12118,Mark Plousis\mark-plousis-1,2015-16,Hartford,G,10,0,32,0,1,.000,0,1,.000,0,0,,3,6,.500,2,0,2,0,1,0,1,7,3,0.0
12119,Kemal Dincer\kemal-dincer-1,2013-14,Texas Christian,G,8,0,12,1,6,.167,1,4,.250,0,2,.000,1,2,.500,2,2,4,0,0,0,1,3,3,-0.2
12120,Alex Martin\alex-martin-2,2017-18,Gonzaga,G,3,0,6,1,3,.333,1,1,1.000,0,2,.000,1,2,.500,1,0,1,0,0,0,0,1,3,0.4
12121,Marcus Brock\marcus-brock-1,2013-14,Incarnate Word,G,11,0,24,1,4,.250,1,1,1.000,0,3,.000,1,2,.500,1,2,3,1,1,0,0,3,3,0.2
12122,Alex Mills\alex-mills-1,2017-18,North Carolina Central,G,7,0,22,1,10,.100,1,4,.250,0,6,.000,1,1,1.000,0,1,1,0,0,0,0,0,3,-0.5
12123,Stilman White\stilman-white-1,2015-16,North Carolina,G,18,0,30,1,8,.125,1,6,.167,0,2,.000,1,2,.500,4,2,6,2,0,0,2,5,3,-0.1
12124,Chris Kuhar\chris-kuhar-1,2017-18,La Salle,G,7,0,9,1,1,1.000,0,0,,1,1,1.000,0,0,,0,5,5,1,0,0,3,1,3,0.2
12125,Andre Chatfield\andre-chatfield-1,2017-18,Harvard,G,5,3,19,1,5,.200,0,2,.000,1,3,.333,0,0,,1,0,1,2,1,0,2,3,3,0.0
12126,Trevor Stumpe\trevor-stumpe-1,2016-17,Wofford,G,2,0,11,1,4,.250,0,2,.000,1,2,.500,0,0,,2,1,3,3,1,0,0,2,3,2.3
12127,Michael Soukup\michael-soukup-1,2015-16,Iowa,G,6,0,15,1,4,.250,0,1,.000,1,3,.333,0,1,.000,0,1,1,3,0,0,0,0,3,0.4
12128,Brycen Bush\brycen-bush-1,2017-18,Wichita State,G,4,0,9,1,1,1.000,0,0,,1,1,1.000,0,0,,0,1,1,0,0,0,2,1,3,0.2
12129,Trey Mason\trey-mason-1,2014-15,Arizona,G,9,0,12,1,3,.333,0,2,.000,1,1,1.000,0,0,,0,1,1,0,0,0,1,0,3,0.1
12130,Brocke Stepteau\brocke-stepteau-1,2015-16,Hawaii,G,18,0,42,0,8,.000,0,2,.000,0,6,.000,3,4,.750,0,3,3,3,1,0,2,5,3,-0.2
12131,Robert Bissant\robert-bissant-1,2015-16,Nicholls State,G,4,0,3,1,3,.333,1,2,.500,0,1,.000,1,2,.500,0,1,1,0,0,0,0,0,3,0.3
12132,Manu Giamoukis\manu-giamoukis-1,2014-15,Davidson,G,11,0,17,1,4,.250,0,1,.000,1,3,.333,0,0,,1,0,1,1,0,0,0,2,3,0.1
12133,Eric Porter\eric-porter-1,2014-15,Loyola (IL),G,4,0,7,1,1,1.000,0,0,,1,1,1.000,0,0,,0,1,1,0,0,0,1,0,3,0.5
12134,Marquez White\marquez-white-1,2013-14,Florida State,G,6,0,10,1,2,.500,0,0,,1,2,.500,0,0,,0,1,1,0,0,0,1,1,3,0.2
12135,Eric Wagenlander\eric-wagenlander-1,2013-14,Wofford,G,10,0,27,1,8,.125,0,2,.000,1,6,.167,0,0,,0,0,0,3,0,0,2,2,3,-0.3
12136,Jordan Martin\jordan-martin-23,2016-17,Jacksonville,G,2,0,5,1,3,.333,0,0,,1,3,.333,0,0,,0,0,0,1,1,0,0,2,3,1.1
12137,Casey Woodring\casey-woodring-1,2014-15,Providence,G,7,0,12,1,7,.143,0,2,.000,1,5,.200,0,0,,1,0,1,0,0,0,0,1,3,-0.2
12138,George Mawanda-Kalema\george-mawanda-kalema-1,2017-18,Brown,G,1,0,8,1,3,.333,0,0,,1,3,.333,0,2,.000,0,0,0,0,0,0,0,2,3,-0.3
12139,Raekwon Harney\raekwon-harney-2,2016-17,North Carolina Central,G,5,0,19,1,6,.167,0,4,.000,1,2,.500,0,2,.000,0,0,0,3,1,0,1,4,3,-0.2
12140,Bailey Walker\bailey-walker-1,2017-18,Northwestern State,G,4,0,35,1,3,.333,1,2,.500,0,1,.000,1,3,.333,1,2,3,1,2,0,2,5,3,0.1
12141,Mike Booth\mike-booth-1,2016-17,Saint Joseph's,G,6,0,10,1,4,.250,0,2,.000,1,2,.500,0,0,,1,2,3,0,0,0,1,0,3,0.2
12142,Aric Gresko\aric-gresko-1,2014-15,Saint Francis (PA),G,6,1,17,1,4,.250,0,0,,1,4,.250,0,0,,2,2,4,2,1,0,3,0,3,0.3
12143,Trey Draper\trey-draper-1,2013-14,Memphis,G,11,0,16,0,10,.000,0,6,.000,0,4,.000,3,5,.600,5,0,5,0,0,0,2,0,3,-0.3
12144,Alex Budke\alex-budke-1,2013-14,Oklahoma State,G,7,0,9,1,1,1.000,0,0,,1,1,1.000,0,0,,0,1,1,1,2,0,1,2,3,0.6
12145,Jimmy Jent\jimmy-jent-1,2016-17,Ohio State,G,4,0,10,1,4,.250,0,2,.000,1,2,.500,0,0,,0,4,4,0,0,0,0,0,3,0.5
12146,Andrew Terrell\andrew-terrell-1,2015-16,Maryland,G,8,0,14,1,2,.500,0,0,,1,2,.500,0,0,,0,1,1,1,0,0,0,0,3,0.4
12147,Kelvin Amayo\kelvin-amayo-1,2015-16,Iona,G,4,0,39,1,10,.100,0,9,.000,1,1,1.000,0,0,,1,5,6,4,2,1,5,5,3,-0.7
12148,Tyler Warford\tyler-warford-1,2016-17,Youngstown State,G,6,1,12,1,2,.500,0,1,.000,1,1,1.000,0,0,,0,3,3,1,0,1,0,1,3,0.7
12149,Amir Shafi\amir-shafi-1,2017-18,William & Mary,G,3,0,9,1,2,.500,0,1,.000,1,1,1.000,0,0,,2,2,4,0,1,0,2,2,3,0.7
12150,Jeremy Bogus\jeremy-bogus-1,2014-15,Jacksonville,G,10,1,38,1,12,.083,0,1,.000,1,11,.091,0,0,,1,1,2,1,2,0,2,3,3,-0.5
12151,Jack Granger\jack-granger-1,2017-18,George Washington,G,8,1,14,1,2,.500,0,0,,1,2,.500,0,0,,0,3,3,1,0,0,0,0,3,0.5
12152,Brevin Galloway\brevin-galloway-1,2017-18,College of Charleston,G,7,0,30,1,6,.167,0,0,,1,6,.167,0,0,,0,6,6,1,0,0,0,3,3,0.1
12153,Blake McBride\blake-mcbride-1,2014-15,Bryant,G,10,0,31,1,7,.143,0,3,.000,1,4,.250,0,0,,1,2,3,1,0,1,0,5,3,-0.1
12154,Austin Witherill\austin-witherill-1,2014-15,Arizona State,G,3,0,5,1,3,.333,0,1,.000,1,2,.500,0,0,,1,2,3,0,0,0,0,1,3,0.7
12155,New Williams\new-williams-1,2017-18,Fresno State,G,4,0,8,1,3,.333,1,2,.500,0,1,.000,1,1,1.000,0,0,0,0,1,0,2,0,3,0.1
12156,Kaelen Malone\kaelen-malone-1,2017-18,Wichita State,G,7,0,28,1,7,.143,1,5,.200,0,2,.000,1,2,.500,0,4,4,6,0,0,4,5,3,-0.4
12157,Casey Perrin\casey-perrin-1,2014-15,Campbell,G,3,0,15,1,3,.333,0,1,.000,1,2,.500,0,0,,0,0,0,4,1,0,0,4,3,1.2
12158,Sam Donahue\sam-donahue-1,2013-14,Boston College,G,12,0,13,1,12,.083,0,1,.000,1,11,.091,0,0,,3,1,4,2,0,0,0,3,3,-0.2
12159,Jared Fay\jared-fay-1,2013-14,Fordham,G,3,0,11,1,3,.333,0,1,.000,1,2,.500,0,0,,1,2,3,0,0,0,0,0,3,0.9
12160,Trevon Gross Jr.\trevon-grossjr-1,2016-17,Virginia,G,11,0,26,1,12,.083,0,4,.000,1,8,.125,0,1,.000,3,2,5,2,2,0,4,4,3,-0.4
12161,Stevan Manojlovic\stevan-manojlovic-1,2013-14,Drexel,G,7,1,15,1,1,1.000,0,0,,1,1,1.000,0,0,,2,0,2,3,1,0,2,0,3,0.7
12162,Devon Pflueger\devon-pflueger-1,2013-14,Southern California,G,3,0,6,1,2,.500,1,1,1.000,0,1,.000,1,2,.500,1,4,5,0,0,0,0,2,3,0.9
12163,Tyler McFarland\tyler-mcfarland-1,2017-18,American,G,2,0,2,1,1,1.000,0,0,,1,1,1.000,0,0,,0,1,1,0,0,0,0,0,3,1.5
12164,Patrick Ryan\patrick-ryan-1,2014-15,Elon,G,3,0,10,1,4,.250,1,1,1.000,0,3,.000,1,2,.500,2,4,6,2,0,0,2,1,3,0.6
12165,Ben Grace\ben-grace-1,2013-14,Maryland-Baltimore County,G,12,0,37,1,4,.250,0,1,.000,1,3,.333,0,0,,0,1,1,3,1,0,2,3,3,0.1
12166,Mike Booth\mike-booth-1,2017-18,Saint Joseph's,G,7,0,9,1,2,.500,0,0,,1,2,.500,0,0,,1,1,2,2,1,0,0,0,3,0.8
12167,Connor Joy\connor-joy-1,2015-16,New Mexico,G,3,0,4,1,1,1.000,0,0,,1,1,1.000,0,0,,0,0,0,0,0,0,2,1,3,0.1
12168,Matt Smith\matt-smith-9,2013-14,Binghamton,G,10,0,36,1,2,.500,1,1,1.000,0,1,.000,1,1,1.000,0,0,0,2,0,0,0,5,3,0.1
12169,Corey Haith\corey-haith-1,2013-14,Missouri,G,6,0,7,1,1,1.000,0,0,,1,1,1.000,0,0,,0,0,0,0,0,0,2,0,3,0.1
12170,Mike Buckmire\mike-buckmire-1,2017-18,Duke,G,4,0,5,1,2,.500,1,2,.500,0,0,,1,1,1.000,0,2,2,1,0,0,0,1,3,0.7
12171,Matt Galloway\matt-galloway-1,2016-17,Virginia Tech,G,14,0,39,1,9,.111,0,0,,1,9,.111,0,0,,0,1,1,1,1,0,0,8,3,-0.3
12172,Darryl McDowell-White\darryl-mcdowell-white-1,2016-17,Fresno State,G,5,0,15,1,2,.500,1,1,1.000,0,1,.000,1,1,1.000,0,0,0,0,0,0,0,1,3,0.3
12173,Elias Berbari\elias-berbari-1,2017-18,Princeton,G,9,0,14,1,2,.500,0,0,,1,2,.500,0,0,,0,0,0,0,0,0,0,1,3,0.2
12174,Zach Young\zach-young-1,2015-16,Nicholls State,G,16,0,37,0,2,.000,0,0,,0,2,.000,3,6,.500,1,2,3,2,0,1,5,2,3,-0.1
12175,Josh Crumpler\josh-crumpler-1,2016-17,Campbell,G,6,0,12,0,3,.000,0,2,.000,0,1,.000,3,5,.600,0,1,1,0,0,0,0,0,3,0.1
12176,T.J. Gray\tj-gray-2,2017-18,Mississippi State,G,5,0,11,1,4,.250,0,1,.000,1,3,.333,0,0,,1,0,1,0,0,0,2,3,3,-0.4
12177,Mitch Purgason\mitch-purgason-1,2013-14,Appalachian State,G,3,0,6,1,3,.333,0,0,,1,3,.333,0,0,,0,2,2,0,0,0,2,0,3,0.0
12178,Niko Bevens\niko-bevens-1,2017-18,Montana,G,15,0,24,1,4,.250,0,1,.000,1,3,.333,0,0,,1,0,1,1,1,0,1,2,3,0.1
12179,Trey Stacey\trey-stacey-1,2014-15,Wright State,G,6,0,7,1,2,.500,0,0,,1,2,.500,0,0,,0,0,0,0,0,0,1,1,3,0.1
12180,Shakwon Barrett\shakwon-barrett-1,2017-18,Tulane,G,7,0,31,0,7,.000,0,7,.000,0,0,,3,7,.429,0,1,1,5,0,0,1,1,3,-0.2
12181,Jordan Shea\jordan-shea-1,2015-16,Massachusetts-Lowell,G,8,0,36,1,7,.143,1,3,.333,0,4,.000,1,2,.500,1,2,3,7,3,0,2,5,3,0.4
12182,Lucas Campbell\lucas-campbell-1,2015-16,Tennessee,G,4,0,8,1,3,.333,0,1,.000,1,2,.500,0,0,,0,1,1,0,0,0,1,1,3,0.1
12183,Cory Dolins\cory-dolins-1,2014-15,DePaul,G,9,0,10,1,2,.500,1,2,.500,0,0,,1,2,.500,1,1,2,1,0,0,1,2,3,0.2
12184,Mike Noyes\mike-noyes-1,2016-17,Connecticut,G,10,0,19,1,3,.333,1,2,.500,0,1,.000,1,2,.500,1,0,1,0,0,0,1,3,3,-0.1
12185,Kyle Brown\kyle-brown-1,2016-17,Cornell,G,12,0,15,1,6,.167,0,0,,1,6,.167,0,0,,2,1,3,1,1,0,3,2,3,-0.1
12186,Leighton Schrand\leighton-schrand-1,2016-17,Xavier,G,8,0,8,0,1,.000,0,1,.000,0,0,,3,4,.750,0,0,0,0,0,0,1,1,3,0.1
12187,Ricardo Hill\ricardo-hill-1,2014-15,Akron,G,8,0,18,1,4,.250,1,2,.500,0,2,.000,1,2,.500,1,2,3,0,2,0,0,0,3,0.4
12188,Dexter Jenkins\dexter-jenkins-1,2014-15,Western Carolina,G,3,0,4,1,3,.333,1,2,.500,0,1,.000,1,2,.500,1,1,2,1,0,0,1,1,3,0.4
12189,Matt Lehmann\matt-lehmann-1,2017-18,Ohio State,G,5,0,11,1,4,.250,0,0,,1,4,.250,0,0,,1,1,2,1,0,0,1,1,3,0.2
12190,Cheick Sy-Savane\cheick-sy-savane-1,2016-17,Grand Canyon,G,2,0,4,1,4,.250,0,1,.000,1,3,.333,0,0,,0,0,0,0,0,0,0,0,3,0.3
12191,Lance Brown\lance-brown-4,2013-14,Campbell,G,3,0,6,0,2,.000,0,1,.000,0,1,.000,3,4,.750,0,1,1,0,0,0,0,0,3,0.5
12192,Denny Grace\denny-grace-1,2017-18,Villanova,G,15,0,19,1,3,.333,0,0,,1,3,.333,0,0,,1,4,5,0,0,0,2,3,3,0.0
12193,Brady Schuck\brady-schuck-1,2016-17,Furman,G,7,0,17,1,5,.200,1,3,.333,0,2,.000,1,2,.500,0,3,3,0,0,0,0,2,3,-0.1
12194,Joe Coleman\joe-coleman-1,2014-15,Saint Mary's (CA),G,1,0,14,1,3,.333,0,0,,1,3,.333,0,0,,0,1,1,0,0,0,2,1,3,-0.8
12195,Divonte Lumpkin\divonte-lumpkin-1,2017-18,Texas Southern,G,10,2,44,1,3,.333,1,3,.333,0,0,,1,3,.333,0,4,4,3,2,0,3,4,3,0.1
12196,Alex Budke\alex-budke-1,2014-15,Oklahoma State,G,6,0,11,1,2,.500,0,1,.000,1,1,1.000,0,0,,1,3,4,1,1,0,2,2,3,0.4
12197,Jon Siu\jon-siu-1,2016-17,Northern Illinois,G,4,0,5,1,2,.500,0,1,.000,1,1,1.000,0,0,,1,0,1,0,0,0,0,0,3,0.7
12198,Jay DeHaan\jay-dehaan-1,2015-16,Northern Illinois,G,8,0,25,1,8,.125,1,6,.167,0,2,.000,1,3,.333,1,7,8,1,0,0,1,0,3,-0.1
12199,Amari Hamilton\amari-hamilton-1,2014-15,North Carolina A&T,G,10,0,25,0,6,.000,0,1,.000,0,5,.000,3,6,.500,0,1,1,3,0,0,2,2,3,-0.3
12200,Justin Ammerman\justin-ammerman-1,2017-18,Virginia Tech,G,7,0,7,0,3,.000,0,2,.000,0,1,.000,3,7,.429,0,0,0,0,0,0,2,0,3,-0.4
12201,Tyler Self\tyler-self-1,2015-16,Kansas,G,14,0,30,1,6,.167,0,1,.000,1,5,.200,0,1,.000,1,1,2,4,1,0,7,4,3,-0.4
12202,C.J. Ward\cj-ward-1,2016-17,Maine,G,4,0,12,1,4,.250,0,1,.000,1,3,.333,0,0,,0,1,1,3,0,0,0,2,3,0.6
12203,Dylan Hodson\dylan-hodson-1,2015-16,Appalachian State,G,4,0,7,1,4,.250,0,3,.000,1,1,1.000,0,0,,1,3,4,0,0,0,0,0,3,0.6
12204,Jordan Brown\jordan-brown-3,2014-15,Weber State,G,4,0,19,1,2,.500,0,0,,1,2,.500,0,0,,0,2,2,0,0,0,0,4,3,0.3
12205,Nathan Messer\nathan-messer-1,2015-16,Navy,G,2,0,3,1,1,1.000,0,0,,1,1,1.000,0,0,,0,0,0,1,0,0,0,0,3,1.7
12206,Colten Gober\colten-gober-1,2014-15,Texas-Arlington,G,3,0,11,1,2,.500,0,0,,1,2,.500,0,0,,1,0,1,0,0,0,1,0,3,0.6
12207,Deshaun Highler\deshaun-highler-1,2017-18,Texas-El Paso,G,1,0,10,0,0,,0,0,,0,0,,3,4,.750,0,0,0,0,0,0,1,0,3,1.6
12208,Wyatt Self\wyatt-self-1,2017-18,Campbell,G,3,0,8,1,2,.500,0,0,,1,2,.500,0,0,,0,0,0,2,1,0,0,0,3,1.5
12209,Carter Cagle\carter-cagle-1,2014-15,Georgia State,G,12,0,16,1,2,.500,0,0,,1,2,.500,0,0,,0,1,1,1,1,0,1,2,3,0.2
12210,Jared Young\jarrod-young-1,2014-15,Arkansas-Pine Bluff,G,4,0,6,1,1,1.000,0,0,,1,1,1.000,0,0,,0,0,0,0,0,0,2,1,3,0.1
12211,Adam Glenville\adam-glenville-1,2013-14,Oral Roberts,G,5,0,8,0,3,.000,0,2,.000,0,1,.000,3,4,.750,1,2,3,0,0,0,0,0,3,0.4
12212,Tyrone Hughes\tyrone-hughes-1,2014-15,West Virginia,G,7,0,14,1,4,.250,0,0,,1,4,.250,0,2,.000,0,1,1,3,0,0,1,1,3,0.1
12213,Edon Molic\edon-molic-1,2014-15,St. Francis (NY),G,6,0,7,1,5,.200,0,0,,1,5,.200,0,0,,0,0,0,0,0,0,1,2,3,-0.3
12214,Ray Featherston\ray-featherston-1,2016-17,Syracuse,G,3,0,4,1,1,1.000,0,0,,1,1,1.000,0,0,,0,0,0,0,0,0,0,0,3,0.9
12215,Ryan Bernstein\ryan-bernstein-1,2017-18,Kent State,G,10,0,44,1,5,.200,1,3,.333,0,2,.000,1,2,.500,2,2,4,2,5,0,0,6,3,0.6
12216,Jay Henderson\jay-henderson-2,2015-16,Louisville,G,10,0,23,1,7,.143,0,3,.000,1,4,.250,0,0,,0,2,2,2,2,0,1,2,3,0.1
12217,Trevor Menke\trevor-menke-1,2014-15,Nebraska,G,7,0,13,1,2,.500,0,0,,1,2,.500,0,0,,0,0,0,0,0,0,0,1,3,0.2
12218,Kyle Thompson\kyle-thompson-1,2014-15,Saint Joseph's,G,4,0,8,1,2,.500,1,2,.500,0,0,,1,2,.500,1,1,2,1,0,0,0,0,3,0.8
12219,Julian Harrell\julian-harrell-1,2016-17,Eastern Washington,G,2,1,36,1,10,.100,0,4,.000,1,6,.167,0,0,,1,2,3,4,1,0,1,4,3,-0.6
12220,Robbie Feinberg\robbie-feinberg-1,2017-18,Harvard,G,3,2,15,1,5,.200,0,0,,1,5,.200,0,0,,0,0,0,0,1,0,1,1,3,-0.2
12221,Daniel Hazlewood\daniel-hazlewood-1,2015-16,Northwestern State,G,9,0,15,1,4,.250,0,0,,1,4,.250,0,0,,1,4,5,1,0,0,1,1,3,0.2
12222,Dalen Dotson\dalen-dotson-1,2017-18,North Carolina A&T,G,3,0,6,1,2,.500,1,2,.500,0,0,,1,2,.500,1,0,1,1,1,0,4,2,3,-0.3
12223,Kris Alford\kris-alford-1,2017-18,Drexel,G,3,0,4,1,1,1.000,1,1,1.000,0,0,,1,1,1.000,0,0,0,0,0,1,0,0,3,1.1
12224,Matthew Johnson\matthew-johnson-2,2015-16,Southern Utah,G,10,0,24,1,10,.100,0,4,.000,1,6,.167,0,0,,0,1,1,0,0,0,0,2,3,-0.4
12225,Zach Altany\zach-altany-1,2014-15,Georgia Southern,G,6,0,14,1,11,.091,0,3,.000,1,8,.125,0,0,,0,2,2,0,1,0,1,0,3,-0.6
12226,Tommy Olds\tommy-olds-1,2015-16,Citadel,G,5,0,10,1,9,.111,0,6,.000,1,3,.333,0,0,,2,3,5,2,0,0,2,3,3,-0.5
12227,David Urso\david-urso-1,2014-15,Vermont,G,9,0,31,1,6,.167,0,2,.000,1,4,.250,0,2,.000,0,8,8,2,0,0,2,2,3,-0.1
12228,Charlie Noebel\charlie-noebel-1,2015-16,Oregon,G,10,0,16,1,4,.250,0,0,,1,4,.250,0,0,,1,1,2,0,0,0,1,3,3,-0.1
12229,Raven Owen\raven-owen-1,2015-16,Canisius,G,3,0,5,1,3,.333,0,0,,1,3,.333,0,0,,0,0,0,0,0,0,1,2,3,-0.2
12230,Rakeen Brown\rakeen-brown-1,2013-14,Delaware State,G,9,0,31,1,7,.143,1,4,.250,0,3,.000,1,2,.500,0,1,1,3,1,0,5,3,3,-0.5
12231,Tim Donohoe\tim-donohoe-1,2015-16,Stony Brook,G,3,0,11,1,5,.200,0,1,.000,1,4,.250,0,0,,0,0,0,0,0,0,0,0,3,0.0
12232,Darius Sharpe\darius-sharpe-1,2013-14,Georgia State,G,4,0,7,1,2,.500,0,0,,1,2,.500,0,0,,0,0,0,0,0,0,1,2,3,0.1
12233,Omar Ndiaye\omar-ndiaye-1,2016-17,Northern Arizona,G,1,0,3,1,2,.500,1,1,1.000,0,1,.000,1,1,1.000,0,1,1,0,0,0,0,1,3,1.9
12234,Tyler Ailshie\tyler-ailshie-1,2014-15,East Tennessee State,G,6,1,24,1,5,.200,0,1,.000,1,4,.250,0,0,,1,2,3,2,1,0,0,1,3,0.5
12235,Charles Simmons\charles-simmons-1,2017-18,Grambling,G,5,0,10,1,3,.333,0,1,.000,1,2,.500,0,0,,1,0,1,1,0,0,0,1,3,0.5
12236,Anthony Starzynski\anthony-starzynski-1,2017-18,Pittsburgh,G,4,0,5,1,1,1.000,0,0,,1,1,1.000,0,0,,0,0,0,0,0,0,1,0,3,0.4
12237,Aaron Spivey\aaron-spivey-1,2017-18,Wake Forest,G,10,0,9,1,2,.500,1,1,1.000,0,1,.000,1,3,.333,0,0,0,0,1,0,0,1,3,0.2
12238,Ryan Strollo\ryan-strollo-1,2015-16,Youngstown State,G,11,0,37,1,2,.500,0,0,,1,2,.500,0,0,,0,6,6,1,1,0,1,1,3,0.4
12239,Michael Saladin\michael-saladin-1,2016-17,Houston Baptist,G,2,0,8,1,5,.200,0,2,.000,1,3,.333,0,0,,2,1,3,0,1,0,1,1,3,0.6
12240,Nick Pagliuca\nick-pagliuca-1,2014-15,Duke,G,11,0,18,1,5,.200,0,1,.000,1,4,.250,0,0,,2,2,4,1,0,0,0,4,3,0.1
12241,Jack Hackman\jack-hackman-1,2013-14,Hawaii,G,4,0,11,1,2,.500,0,1,.000,1,1,1.000,0,0,,1,0,1,0,0,0,1,2,3,0.2
12242,Sean Tuohy\sean-tuohy-1,2013-14,Loyola (MD),G,8,0,20,0,2,.000,0,1,.000,0,1,.000,3,4,.750,0,1,1,0,0,0,1,2,3,0.0
12243,Nehemiah Allen\nehemiah-allen-1,2017-18,Grand Canyon,G,5,0,11,1,2,.500,1,1,1.000,0,1,.000,1,2,.500,0,0,0,0,0,0,0,3,3,0.1
12244,David Irby\david-irby-1,2014-15,San Francisco,G,4,0,6,1,1,1.000,0,0,,1,1,1.000,0,0,,0,0,0,0,0,0,0,0,3,0.7
12245,Justin Coleman\justin-coleman-3,2015-16,North Carolina,G,14,1,17,1,4,.250,1,2,.500,0,2,.000,1,2,.500,0,1,1,1,0,0,1,2,3,0.0
12246,Chris Heine\chris-heine-1,2013-14,Northern Arizona,G,12,1,20,0,5,.000,0,1,.000,0,4,.000,3,4,.750,0,2,2,2,1,0,4,1,3,-0.2
12247,Patrick Keim\patrick-keim-1,2014-15,Auburn,G,8,0,8,1,4,.250,0,0,,1,4,.250,0,2,.000,0,2,2,3,0,0,1,0,3,0.2
12248,Daquan Cook\daquan-cook-2,2015-16,Nevada-Las Vegas,G,2,0,4,1,2,.500,0,1,.000,1,1,1.000,0,0,,0,1,1,0,0,0,0,0,3,1.2
12249,Andrew Dakich\andrew-dakich-1,2013-14,Michigan,G,12,0,24,1,4,.250,0,3,.000,1,1,1.000,0,0,,1,3,4,5,0,0,2,3,3,0.2
12250,Thomas Sanchez\thomas-sanchez-1,2015-16,Fordham,G,2,0,4,1,2,.500,0,1,.000,1,1,1.000,0,0,,0,0,0,0,0,0,0,0,3,1.0
12251,Chris Collins\chris-collins-4,2014-15,Texas A&M,G,3,0,5,1,1,1.000,0,0,,1,1,1.000,0,0,,0,0,0,0,0,0,0,2,3,0.6
12252,Kalen Alexander\kalen-alexander-1,2014-15,Indiana State,G,6,0,8,1,3,.333,0,2,.000,1,1,1.000,0,0,,1,1,2,1,0,0,0,0,3,0.5
12253,Khalill Spencer\khalil-spencer-1,2016-17,Tennessee State,G,5,0,15,1,1,1.000,1,1,1.000,0,0,,1,4,.250,1,1,2,0,1,0,2,2,3,0.1
12254,Gavin Wilson\gavin-wilson-1,2014-15,Charlotte,G,5,0,5,1,6,.167,0,1,.000,1,5,.200,0,0,,0,2,2,0,0,0,1,1,3,-0.3
12255,Quentin Taylor\quentin-taylor-1,2015-16,Indiana,G,7,0,9,1,2,.500,1,2,.500,0,0,,1,2,.500,0,2,2,1,0,0,0,0,3,0.4
12256,Derek Rongstad\derek-rongstad-1,2016-17,Milwaukee,G,7,0,29,1,4,.250,0,0,,1,4,.250,0,0,,1,4,5,1,0,1,0,0,3,0.6
12257,David Allen\david-allen-1,2013-14,Georgetown,G,10,0,17,1,4,.250,0,0,,1,4,.250,0,0,,0,2,2,1,0,0,1,2,3,0.0
12258,Kyle Brown\kyle-brown-1,2014-15,Cornell,G,8,0,16,1,3,.333,0,1,.000,1,2,.500,0,0,,0,2,2,0,1,0,1,0,3,0.2
12259,Trevor Menke\trevor-menke-1,2013-14,Nebraska,G,5,0,10,1,2,.500,0,0,,1,2,.500,0,0,,0,0,0,0,1,0,0,0,3,0.6
12260,Jordan Barros\jordan-barros-1,2015-16,Boston College,G,2,0,7,1,2,.500,0,0,,1,2,.500,0,0,,0,1,1,0,0,0,0,0,3,1.2
12261,Tyler Trillo\tyler-trillo-1,2017-18,Arizona,G,2,0,6,1,1,1.000,0,0,,1,1,1.000,0,0,,0,0,0,0,0,0,1,1,3,0.7
12262,Ryan Ansel\ryan-ansel-1,2013-14,Davidson,G,4,0,9,1,1,1.000,0,0,,1,1,1.000,0,0,,1,1,2,1,1,0,1,0,3,1.1
12263,Mark Patterson\mark-patterson-1,2014-15,Cal Poly,G,2,0,12,1,7,.143,0,4,.000,1,3,.333,0,0,,0,3,3,0,0,0,0,1,3,-0.5
12264,Max Twyman\max-twyman-1,2014-15,Albany (NY),G,8,0,9,1,3,.333,0,0,,1,3,.333,0,0,,0,1,1,0,0,0,0,1,3,0.2
12265,Otto Taylor\otto-taylor-1,2017-18,Pacific,G,13,0,42,1,9,.111,0,1,.000,1,8,.125,0,0,,3,0,3,4,2,0,0,3,3,0.2
12266,Joey Burbach\joey-burbach-1,2013-14,Rice,G,5,0,8,1,3,.333,0,1,.000,1,2,.500,0,1,.000,1,0,1,0,1,0,0,1,3,0.4
12267,Ta'Vonne Bond\tavonne-bond-1,2017-18,Virginia Military Institute,G,7,0,13,0,1,.000,0,1,.000,0,0,,3,3,1.000,0,1,1,3,0,0,4,4,3,-0.1
12268,Tarale Murry\tarale-murry-1,2014-15,Texas,G,5,0,8,1,8,.125,1,3,.333,0,5,.000,1,4,.250,1,2,3,0,0,0,0,1,3,-0.5
12269,Omar Ndiaye\omar-ndiaye-1,2015-16,Northern Arizona,G,3,0,3,1,2,.500,0,0,,1,2,.500,0,0,,0,1,1,0,0,0,0,0,3,0.8
12270,Barrett Hunter\barrett-hunter-1,2013-14,Tulsa,G,10,1,18,1,4,.250,1,4,.250,0,0,,1,2,.500,0,1,1,2,2,0,2,0,3,0.2
12271,Cole Stockton\cole-stockton-1,2014-15,Auburn,G,12,0,21,1,6,.167,0,0,,1,6,.167,0,0,,1,1,2,0,0,0,1,3,3,-0.2
12272,Thomas Sanchez\thomas-sanchez-1,2016-17,Fordham,G,13,0,16,1,2,.500,0,1,.000,1,1,1.000,0,0,,0,0,0,0,0,0,0,2,3,0.1
12273,Richard Brown\richard-brown-2,2013-14,Army,G,10,0,22,1,7,.143,0,1,.000,1,6,.167,0,0,,0,2,2,0,0,0,0,1,3,-0.1
12274,David Favorite\david-favorite-1,2016-17,Colgate,G,7,0,14,1,2,.500,0,0,,1,2,.500,0,2,.000,0,1,1,0,0,0,0,2,3,0.1
12275,Khalil Batie\khalil-batie-1,2016-17,Rutgers,G,7,0,14,1,3,.333,0,0,,1,3,.333,0,1,.000,0,3,3,2,0,0,1,1,3,0.3
12276,T.J. Schlundt\tj-schlundt-1,2016-17,Wisconsin,G,12,0,20,1,6,.167,1,2,.500,0,4,.000,1,1,1.000,1,1,2,0,0,1,0,1,3,0.0
12277,Drew Bost\drew-bost-1,2015-16,East Carolina,G,7,1,14,1,5,.200,0,0,,1,5,.200,0,0,,0,1,1,2,0,0,0,0,3,0.2
12278,Tyler Flores\tyler-flores-1,2014-15,Texas-San Antonio,G,4,0,9,1,3,.333,0,0,,1,3,.333,0,0,,0,0,0,0,0,0,0,0,3,0.3
12279,Nick Victor\nick-victor-1,2014-15,Yale,G,6,0,42,1,6,.167,1,3,.333,0,3,.000,1,4,.250,3,11,14,8,2,3,4,3,3,1.3
12280,Ben Diamond\ben-diamond-1,2017-18,Siena,G,5,0,5,1,1,1.000,0,0,,1,1,1.000,0,0,,0,0,0,0,0,0,1,0,3,0.3
12281,Matt Fraschilla\matt-fraschilla-1,2016-17,Harvard,G,3,1,17,1,3,.333,0,2,.000,1,1,1.000,0,0,,0,1,1,1,0,0,2,5,3,-0.6
12282,Colby Moultrie\colby-moultrie-1,2017-18,Buffalo,G,12,0,21,1,3,.333,0,1,.000,1,2,.500,0,0,,2,2,4,1,0,0,5,6,3,-0.3
12283,Kory Jones\kory-jones-1,2016-17,Arizona,G,4,0,7,1,1,1.000,0,0,,1,1,1.000,0,0,,0,0,0,0,0,1,0,0,3,0.9
12284,Daniel Harper\daniel-harper-1,2014-15,Oklahoma,G,6,0,11,1,2,.500,0,0,,1,2,.500,0,0,,1,1,2,1,0,0,0,0,3,0.6
12285,O.J. Lewis\oj-lewis-1,2014-15,La Salle,G,6,0,7,1,2,.500,1,2,.500,0,0,,1,2,.500,0,0,0,0,1,0,1,1,3,0.2
12286,Jordan Anderson\jordan-anderson-1,2014-15,Troy,G,4,0,3,1,1,1.000,0,0,,1,1,1.000,0,0,,0,0,0,0,0,0,1,0,3,0.4
12287,Adam Mitola\adam-mitola-1,2016-17,George Washington,G,4,0,16,1,5,.200,0,2,.000,1,3,.333,0,0,,0,2,2,0,0,0,1,2,3,-0.3
12288,Spencer Llewellyn\spencer-llewellyn-1,2013-14,Pacific,G,10,0,29,1,8,.125,1,1,1.000,0,7,.000,1,1,1.000,0,2,2,2,0,0,3,1,3,-0.4
12289,Nate Galgalo\nate-galgalo-1,2013-14,Eastern Washington,G,2,0,4,1,1,1.000,0,0,,1,1,1.000,0,0,,0,0,0,0,0,0,0,0,3,1.4
12290,Lucas Campbell\lucas-campbell-1,2017-18,Tennessee,G,2,0,5,1,1,1.000,0,0,,1,1,1.000,0,0,,0,1,1,2,0,0,0,0,3,2.2
12291,Beau Brown\beau-brown-1,2016-17,South Dakota State,G,5,0,4,1,2,.500,0,1,.000,1,1,1.000,0,0,,1,0,1,0,0,0,0,0,3,0.5
12292,Camron Greer\camron-greer-1,2017-18,Dayton,G,4,0,2,1,1,1.000,0,0,,1,1,1.000,0,0,,0,0,0,0,1,0,0,0,3,0.9
12293,Trent VanHorn\trent-vanhorn-1,2014-15,Wake Forest,G,5,0,26,1,6,.167,1,4,.250,0,2,.000,1,2,.500,0,2,2,0,1,0,2,6,3,-0.8
12294,Ethan Good\ethan-good-1,2016-17,Bowling Green State,G,5,0,18,1,5,.200,1,1,1.000,0,4,.000,1,2,.500,1,0,1,1,0,0,2,3,3,-0.5
12295,Martin Shaw\martin-shaw-1,2014-15,Old Dominion,G,11,0,17,1,9,.111,1,9,.111,0,0,,1,2,.500,0,0,0,1,0,1,1,0,3,-0.3
12296,Charlie Noebel\charlie-noebel-1,2016-17,Oregon,G,14,0,31,1,5,.200,0,1,.000,1,4,.250,0,0,,0,4,4,0,1,0,2,3,3,-0.1
12297,Chuchu Enechionyia\chuchu-enechionyia-1,2016-17,Virginia Military Institute,G,5,0,26,1,6,.167,1,2,.500,0,4,.000,1,4,.250,3,4,7,1,0,1,2,4,3,-0.2
12298,Jacob Orender\jacob-orender-1,2015-16,Lafayette,G,12,0,25,1,6,.167,0,0,,1,6,.167,0,0,,0,1,1,1,0,0,4,2,3,-0.4
12299,Joe Kirby\joe-kirby-1,2015-16,Richmond,G,3,0,6,1,4,.250,0,1,.000,1,3,.333,0,0,,2,2,4,0,1,0,0,0,3,1.2
12300,Zach Yoshor\zach-yoshor-1,2015-16,Harvard,G,7,0,19,1,2,.500,0,0,,1,2,.500,0,2,.000,0,4,4,0,0,0,0,0,3,0.3
12301,Patrick Conroy\patrick-conroy-1,2014-15,Nevada,G,7,0,16,1,5,.200,1,1,1.000,0,4,.000,1,2,.500,0,1,1,4,0,0,2,0,3,0.1
12302,Isaiah Dennis\isaiah-dennis-1,2013-14,Georgia State,G,2,0,5,1,2,.500,0,1,.000,1,1,1.000,0,0,,0,1,1,0,0,0,0,1,3,1.0
12303,Jake McDowell\jake-mcdowell-1,2013-14,Memphis,G,10,0,10,1,4,.250,1,3,.333,0,1,.000,1,2,.500,0,2,2,0,1,0,0,1,3,0.1
12304,Tod Lanter\tod-lanter-1,2014-15,Kentucky,G,7,1,8,1,1,1.000,0,0,,1,1,1.000,0,0,,0,0,0,0,0,0,0,0,3,0.4
12305,Shane Plunkett\shane-plunkett-1,2015-16,Rhode Island,G,8,0,10,1,4,.250,0,2,.000,1,2,.500,0,2,.000,0,0,0,0,0,0,0,2,3,-0.1
12306,Gavin Gibson\gavin-gibson-1,2013-14,Middle Tennessee,G,9,0,21,1,3,.333,0,0,,1,3,.333,0,0,,1,3,4,2,0,0,2,1,3,0.2
12307,Brian Rodriguez\bryan-rodriguez-1,2016-17,Radford,G,8,0,12,1,5,.200,0,2,.000,1,3,.333,0,0,,1,0,1,1,0,0,0,3,3,0.0
12308,Camryn Crocker\camryn-crocker-1,2013-14,Pennsylvania,G,6,0,33,1,3,.333,1,2,.500,0,1,.000,1,3,.333,0,2,2,5,1,0,4,7,3,-0.2
12309,Jiday Ugbaja\jidbay-ugbaja-1,2014-15,Sacramento State,G,5,0,8,1,4,.250,1,1,1.000,0,3,.000,1,1,1.000,0,2,2,1,0,0,2,2,3,-0.2
12310,Eric Dadika\eric-dadika-1,2016-17,Rhode Island,G,7,0,9,1,3,.333,0,0,,1,3,.333,0,0,,0,0,0,0,0,0,2,0,3,-0.1
12311,Thomas Odom\thomas-odom-1,2013-14,Charleston Southern,G,7,1,35,1,7,.143,0,0,,1,7,.143,0,0,,0,0,0,1,0,0,2,0,3,-0.4
12312,Henry Shortess\henry-shortess-1,2014-15,Louisiana State,G,3,0,6,1,1,1.000,0,0,,1,1,1.000,0,0,,0,0,0,0,0,0,0,0,3,0.9
12313,Jake Brudish\jake-brudish-1,2015-16,Southern Methodist,G,3,0,3,1,1,1.000,0,0,,1,1,1.000,0,0,,0,0,0,1,0,0,0,0,3,1.1
12314,Maalik Howard\maalik-howard-1,2014-15,Mount St. Mary's,G,9,0,19,1,2,.500,0,1,.000,1,1,1.000,0,0,,1,1,2,1,0,0,0,1,3,0.4
12315,Cory Cardwell\cory-cardwell-1,2013-14,Utah Valley,G,1,0,4,1,2,.500,0,1,.000,1,1,1.000,0,0,,0,0,0,0,1,0,0,1,3,2.6
12316,Lorenzo Jenkins\lorenzo-jenkins-1,2015-16,Arkansas,G,1,0,7,1,4,.250,0,3,.000,1,1,1.000,0,0,,0,2,2,1,0,0,0,0,3,1.9
12317,Jermaine Williams\jermaine-williams-3,2014-15,South Alabama,G,8,1,14,1,3,.333,1,1,1.000,0,2,.000,1,1,1.000,0,1,1,0,2,0,0,1,3,0.4
12318,Joel King\joel-king-1,2014-15,Portland State,G,3,0,7,1,2,.500,1,2,.500,0,0,,1,1,1.000,0,0,0,1,0,0,1,1,3,0.4
12319,Josh Repine\josh-repine-1,2015-16,Colorado,G,6,0,8,1,3,.333,0,0,,1,3,.333,0,0,,0,2,2,2,0,0,0,2,3,0.4
12320,Matt Williams\matt-williams-5,2014-15,Davidson,G,11,0,21,1,2,.500,1,2,.500,0,0,,1,2,.500,2,3,5,1,0,0,3,5,3,0.0
12321,Carter Sanderson\carter-sanderson-1,2014-15,Syracuse,G,4,0,4,1,4,.250,0,0,,1,4,.250,0,0,,0,1,1,0,0,0,0,0,3,0.2
12322,Peter Westra\peter-westra-1,2014-15,Maine,G,1,0,3,1,2,.500,1,1,1.000,0,1,.000,1,2,.500,0,0,0,0,0,0,0,2,3,0.8
12323,Philip Bennett\philip-bennett-1,2013-14,Miami (OH),G,8,1,12,1,1,1.000,0,0,,1,1,1.000,0,0,,0,0,0,0,2,0,0,0,3,0.6
12324,Jack Ryan\jack-ryan-2,2013-14,Stanford,G,6,0,19,1,2,.500,0,0,,1,2,.500,0,0,,0,4,4,2,1,0,2,3,3,0.4
12325,Rayshawn Miller\rayshawn-miller-1,2016-17,Massachusetts,G,3,0,12,1,5,.200,0,1,.000,1,4,.250,0,0,,0,2,2,1,0,0,1,0,3,0.1
12326,Obim Okeke\obim-okeke-1,2017-18,Baylor,G,7,0,21,1,8,.125,0,1,.000,1,7,.143,0,0,,1,1,2,3,1,0,3,1,3,-0.2
12327,Patrick Robinson Jr.\patrick-robinsonjr-1,2015-16,Detroit Mercy,G,7,0,15,1,4,.250,0,0,,1,4,.250,0,0,,0,2,2,1,0,0,2,1,3,-0.1
12328,Sean Tuohy\sean-tuohy-1,2014-15,Loyola (MD),G,11,0,33,1,7,.143,0,2,.000,1,5,.200,0,1,.000,1,2,3,1,0,0,1,2,3,-0.2
12329,Connor Klementowicz\connor-klementowicz-1,2017-18,Hofstra,G,7,0,12,1,1,1.000,0,0,,1,1,1.000,0,2,.000,0,1,1,1,0,0,2,0,3,0.1
12330,Monty Boykins\monty-boykins-1,2016-17,Lafayette,G,2,1,30,1,9,.111,0,1,.000,1,8,.125,0,1,.000,0,2,2,0,1,0,1,1,3,-1.6
12331,Trey Ford\trey-ford-1,2016-17,Appalachian State,G,6,0,17,1,3,.333,0,0,,1,3,.333,0,0,,0,1,1,3,1,0,1,0,3,0.6
12332,Jean-Micheal Mudiay\jean-michael-mudiay-1,2014-15,Southern Methodist,G,6,0,15,0,5,.000,0,2,.000,0,3,.000,3,7,.429,0,1,1,0,0,0,3,1,3,-0.9
12333,Braiten Madrigal\braiten-madrigal-1,2013-14,Boston University,G,7,0,14,1,3,.333,0,0,,1,3,.333,0,0,,0,1,1,0,0,0,0,2,3,0.1
12334,Brad Calipari\brad-calipari-1,2017-18,Kentucky,G,12,0,28,1,7,.143,0,0,,1,7,.143,0,0,,0,2,2,1,0,0,2,0,3,-0.2
12335,Chester Victor\chester-victor-1,2013-14,Jackson State,G,4,0,6,1,4,.250,0,1,.000,1,3,.333,0,0,,0,0,0,0,0,0,1,0,3,-0.1
12336,Ryan Dickey\ryan-dickey-2,2014-15,Samford,G,4,0,10,1,5,.200,0,1,.000,1,4,.250,0,0,,0,1,1,1,0,0,0,1,3,0.1
12337,Elgin Ford Jr.\elgin-fordjr-1,2016-17,Drexel,G,5,1,8,1,1,1.000,0,0,,1,1,1.000,0,0,,1,1,2,0,0,0,0,3,3,0.5
12338,Mark Plousis\mark-plousis-1,2017-18,Hartford,G,12,1,21,0,2,.000,0,2,.000,0,0,,3,8,.375,1,3,4,1,0,1,1,3,3,0.0
12339,Benjamin Nwokeabia\benjamin-nwokeabia-1,2015-16,Iona,G,13,0,16,1,7,.143,0,0,,1,7,.143,0,0,,0,2,2,0,1,0,0,2,3,-0.1
12340,Tanner Beachnau\tanner-beachnau-1,2013-14,Central Michigan,G,1,0,6,1,1,1.000,0,0,,1,1,1.000,0,0,,0,2,2,0,0,0,0,1,3,2.9
12341,Jerron Martin\jerron-martin-1,2013-14,Mississippi,G,2,0,7,1,2,.500,0,1,.000,1,1,1.000,0,0,,0,0,0,1,0,0,0,2,3,1.0
12342,Jacob Gross\jacob-gross-1,2014-15,North Texas,G,8,0,9,1,1,1.000,0,0,,1,1,1.000,0,0,,1,1,2,0,0,0,0,0,3,0.5
12343,Charlie Rose\charlie-rose-1,2014-15,Iowa,G,8,0,16,1,1,1.000,0,0,,1,1,1.000,0,0,,0,0,0,1,0,0,1,0,3,0.3
12344,Bradford Allen\bradford-allen-1,2013-14,Presbyterian,G,5,0,11,1,1,1.000,1,1,1.000,0,0,,1,2,.500,0,2,2,0,0,0,0,0,3,0.6
12345,Trevor Anzmann\trevor-anzmann-1,2015-16,Maryland,G,10,0,24,1,3,.333,0,0,,1,3,.333,0,0,,0,0,0,2,0,0,2,1,3,0.0
12346,Joe Schwartz\joe-schwartz-1,2014-15,Texas,G,1,0,2,1,1,1.000,0,0,,1,1,1.000,0,0,,0,0,0,0,0,0,0,0,3,2.7
12347,Kent Auslander\kent-auslander-1,2015-16,Maryland,G,9,0,17,0,1,.000,0,1,.000,0,0,,3,5,.600,0,3,3,1,0,0,0,0,3,0.3
12348,Patrick Rielly\patrick-rielly-1,2015-16,Holy Cross,G,11,0,14,1,4,.250,1,3,.333,0,1,.000,1,3,.333,0,4,4,0,0,0,0,0,3,0.1
12349,Richard Romeo\richard-romeo-1,2014-15,West Virginia,G,7,0,12,1,3,.333,0,0,,1,3,.333,0,0,,0,2,2,2,0,0,0,2,3,0.4
12350,Ricky Council II\ricky-councilii-1,2016-17,Providence,G,5,0,20,1,6,.167,0,0,,1,6,.167,0,0,,0,3,3,0,0,0,3,1,3,-0.7
12351,Adam Kozinski\adam-kozinski-1,2017-18,Central Michigan,G,6,1,8,1,7,.143,0,0,,1,7,.143,0,0,,0,1,1,0,0,0,0,1,3,-0.3
12352,J.R. William\jr-williams-1,2016-17,Saint Peter's,G,9,0,11,1,4,.250,0,3,.000,1,1,1.000,0,0,,0,2,2,0,2,0,0,2,3,0.3
12353,Courtney Austin\courtney-austin-1,2013-14,Texas-Arlington,G,10,0,24,1,5,.200,1,3,.333,0,2,.000,1,2,.500,1,3,4,1,0,0,5,4,3,-0.5
12354,Justin Lobell\justin-lobell-1,2015-16,Southeastern Louisiana,G,3,0,1,1,1,1.000,0,0,,1,1,1.000,0,0,,0,0,0,0,0,0,1,0,3,0.6
12355,TeJai Allen\tejai-allen-1,2013-14,Florida Gulf Coast,G,13,0,26,1,5,.200,1,5,.200,0,0,,1,2,.500,0,1,1,0,0,0,4,5,3,-0.5
12356,Cody Cambre\cody-cambre-1,2015-16,Northwestern State,G,12,0,22,0,3,.000,0,0,,0,3,.000,3,6,.500,1,4,5,1,1,0,0,2,3,0.2
12357,Jeffrey Prophete\jeffrey-prophete-1,2017-18,Towson,G,13,0,65,1,8,.125,1,6,.167,0,2,.000,1,2,.500,0,4,4,7,2,0,8,6,3,-0.4
12358,Kyle Gonzalez\kyle-gonzalez-1,2013-14,Radford,G,10,0,21,1,2,.500,1,1,1.000,0,1,.000,1,2,.500,1,2,3,0,0,0,2,1,3,0.1
12359,Ben Mesuda\ben-mesuda-1,2013-14,Towson,G,6,0,12,1,2,.500,0,1,.000,1,1,1.000,0,0,,0,3,3,0,0,0,1,2,3,0.2
12360,Eugene Marshall III\eugene-marshalliii-1,2016-17,Hampton,G,5,0,11,1,3,.333,0,0,,1,3,.333,0,0,,1,0,1,1,0,0,0,1,3,0.5
12361,Kaleb Mallory\kaleb-mallory-1,2015-16,Ball State,G,4,0,10,1,2,.500,1,1,1.000,0,1,.000,1,2,.500,0,1,1,2,1,0,2,0,3,0.6
12362,Anthony Pugh\anthony-pugh-1,2015-16,Robert Morris,G,3,0,7,1,1,1.000,0,0,,1,1,1.000,0,0,,0,0,0,0,0,0,0,0,3,0.9
12363,Cal Reichwein\cal-reichwein-1,2016-17,Lafayette,G,3,0,4,1,4,.250,1,2,.500,0,2,.000,1,1,1.000,0,0,0,0,0,0,0,0,3,0.2
12364,James Holder\james-holder-1,2015-16,Georgia Southern,G,2,0,5,1,5,.200,0,1,.000,1,4,.250,0,0,,0,0,0,0,0,0,0,0,3,-0.1
12365,Jaran Hoover\jaran-hoover-1,2014-15,Northern Arizona,G,3,0,6,1,4,.250,0,0,,1,4,.250,0,0,,0,0,0,0,0,0,0,2,3,-0.1
12366,Henry Shortess\henry-shortess-1,2013-14,Louisiana State,G,7,0,15,1,6,.167,0,2,.000,1,4,.250,0,0,,0,0,0,2,1,0,3,1,3,-0.3
12367,Evans Ganapamo\evans-ganapamo-1,2016-17,Prairie View,G,5,1,10,1,6,.167,0,3,.000,1,3,.333,0,0,,0,2,2,0,0,0,1,2,3,-0.4
12368,Jacob Joubert\jacob-joubert-1,2017-18,Detroit Mercy,G,7,1,50,1,5,.200,0,2,.000,1,3,.333,0,0,,0,0,0,3,1,0,3,6,3,-0.3
12369,Drew Crabtree\drew-crabtree-1,2016-17,Ohio,G,13,0,24,1,6,.167,0,1,.000,1,5,.200,0,0,,0,4,4,2,0,0,1,4,3,-0.1
12370,Jarryd Coleman\jarryd-coleman-1,2014-15,Charleston Southern,G,5,0,20,1,8,.125,0,1,.000,1,7,.143,0,0,,0,2,2,0,2,0,1,0,3,-0.1
12371,Addison Owen\addison-owen-1,2016-17,Rice,G,5,0,8,1,3,.333,0,0,,1,3,.333,0,0,,0,1,1,1,0,0,1,1,3,0.2
12372,Cameron Pappas\cameron-pappas-1,2014-15,Charlotte,G,4,0,5,0,3,.000,0,1,.000,0,2,.000,3,4,.750,1,2,3,2,0,0,0,1,3,0.7
12373,Johnny Sawyer\johnny-sawyer-1,2016-17,Santa Clara,G,7,0,16,1,4,.250,0,3,.000,1,1,1.000,0,2,.000,0,1,1,3,0,1,0,2,3,0.3
12374,Ayo Adedeji\ayo-adedeji-1,2015-16,Stanford,G,3,0,6,0,3,.000,0,1,.000,0,2,.000,3,4,.750,2,3,5,0,0,0,0,1,3,0.8
12375,Drew Davis\drew-davis-2,2017-18,Mississippi State,G,8,0,17,1,9,.111,1,5,.200,0,4,.000,1,2,.500,0,2,2,2,0,0,2,1,3,-0.5
12376,Joey Gruden\joey-gruden-1,2017-18,Dayton,G,6,1,10,1,2,.500,0,0,,1,2,.500,0,0,,0,0,0,0,1,0,2,0,3,0.2
12377,Matt Kourouma\matt-kourouma-1,2014-15,North Dakota State,G,4,0,5,1,3,.333,1,3,.333,0,0,,1,2,.500,0,0,0,0,0,0,0,0,3,0.2
12378,Kevin Nelson\kevin-nelson-2,2013-14,Colorado,G,9,0,17,1,2,.500,0,0,,1,2,.500,0,0,,0,4,4,0,0,0,0,2,3,0.3
12379,Joey Downes\joey-downes-1,2017-18,Rutgers,G,5,0,16,1,4,.250,0,0,,1,4,.250,0,0,,0,1,1,1,3,0,0,0,3,0.9
12380,Terrill Toe\terrill-toe-1,2015-16,Bryant,G,14,0,25,1,5,.200,0,1,.000,1,4,.250,0,0,,1,0,1,0,1,0,1,0,3,0.0
12381,Joshua Ko\joshua-ko-1,2014-15,Pittsburgh,G,5,0,6,1,4,.250,0,2,.000,1,2,.500,0,0,,0,1,1,0,0,1,0,1,3,0.2
12382,Mike Robinson\mike-robinson-4,2017-18,Miami (FL),G,7,1,12,1,4,.250,0,1,.000,1,3,.333,0,0,,0,0,0,1,0,0,0,1,3,0.1
12383,Greg Alexander\greg-alexander-1,2014-15,East Carolina,G,6,0,14,1,4,.250,1,2,.500,0,2,.000,1,3,.333,0,0,0,1,0,1,1,2,3,-0.1
12384,Simeon Dennis\simeon-dennis-1,2014-15,Saint Peter's,G,6,0,19,1,4,.250,0,0,,1,4,.250,0,0,,0,1,1,0,1,1,1,2,3,0.1
12385,Keaton Scheer\keaton-scheer-1,2013-14,Southern Illinois-Edwardsville,G,3,0,9,1,3,.333,0,1,.000,1,2,.500,0,0,,0,1,1,1,0,1,1,1,3,0.5
12386,Jack Gordon\jack-gordon-2,2015-16,Cornell,G,10,0,22,1,1,1.000,0,0,,1,1,1.000,0,3,.000,1,2,3,1,0,0,2,0,3,0.2
12387,Casey Woodring\casey-woodring-1,2016-17,Providence,G,4,0,7,1,6,.167,0,1,.000,1,5,.200,0,0,,1,1,2,0,0,0,0,0,3,0.1
12388,Trey Ford\trey-ford-1,2015-16,Appalachian State,G,1,0,1,1,1,1.000,0,0,,1,1,1.000,0,0,,0,0,0,0,0,0,0,1,3,2.3
12389,Calvin Hoffman\calvin-hoffman-1,2015-16,Liberty,G,7,0,39,1,3,.333,0,0,,1,3,.333,0,0,,1,3,4,3,0,0,4,1,3,0.1
12390,T.K. Hayes\tk-hayes-1,2016-17,Furman,G,9,1,19,1,6,.167,1,3,.333,0,3,.000,0,2,.000,1,3,4,1,0,0,1,1,2,-0.2
12391,Steven Cruz\steven-cruz-1,2013-14,Siena,G,11,1,14,0,3,.000,0,2,.000,0,1,.000,2,4,.500,0,4,4,1,0,0,4,3,2,-0.4
12392,Rafael de Souza\rafael-desouza-1,2016-17,Northern Iowa,G,10,0,13,1,3,.333,1,3,.333,0,0,,0,0,,0,0,0,2,1,0,2,1,2,0.0
12393,Will Macoy\will-macoy-1,2017-18,Auburn,G,10,0,17,0,5,.000,0,2,.000,0,3,.000,2,4,.500,1,2,3,0,0,0,0,2,2,-0.2
12394,Matt Fraschilla\matt-fraschilla-1,2015-16,Harvard,G,2,0,17,1,1,1.000,1,1,1.000,0,0,,0,0,,0,1,1,1,1,0,3,1,2,0.2
12395,Steve Perpiglia\steve-perpiglia-1,2013-14,Boston College,G,3,0,4,1,2,.500,1,1,1.000,0,1,.000,0,0,,0,1,1,0,0,0,0,0,2,0.4
12396,Montreal Nabors\montreal-nabors-1,2016-17,Jackson State,G,11,0,27,1,5,.200,1,2,.500,0,3,.000,0,0,,3,4,7,0,0,1,3,3,2,-0.1
12397,James Pyle\james-pyle-1,2017-18,Southern Methodist,G,20,0,38,1,5,.200,1,2,.500,0,3,.000,0,2,.000,1,1,2,1,0,0,2,4,2,-0.2
12398,Michael Servetas\michael-servetas-1,2017-18,Marist,G,9,0,11,1,3,.333,1,3,.333,0,0,,0,0,,0,3,3,0,1,0,0,1,2,0.2
12399,Ky Feldman\ky-feldman-1,2015-16,Syracuse,G,2,0,2,1,1,1.000,1,1,1.000,0,0,,0,0,,0,1,1,0,1,0,0,0,2,1.5
12400,Sam Donahue\sam-donahue-1,2014-15,Boston College,G,7,0,8,1,2,.500,1,1,1.000,0,1,.000,0,0,,0,0,0,0,0,0,0,0,2,0.1
12401,Juan Sabino II\juan-sabinoii-1,2017-18,Colorado State,G,2,0,4,1,3,.333,1,2,.500,0,1,.000,0,0,,2,1,3,0,0,0,0,4,2,0.2
12402,Michael Marconi\michael-marconi-1,2013-14,San Diego,G,4,0,12,1,3,.333,1,1,1.000,0,2,.000,0,0,,0,2,2,1,1,0,1,2,2,0.2
12403,Mohammad Elradi\mohammad-elradi-1,2016-17,Nebraska,G,2,0,3,1,1,1.000,1,1,1.000,0,0,,0,0,,0,1,1,1,0,0,0,0,2,1.4
12404,Andre Chatfield\andre-chatfield-1,2016-17,Harvard,G,2,0,3,1,2,.500,1,1,1.000,0,1,.000,0,0,,0,0,0,0,1,0,0,1,2,0.8
12405,Bobby Williams\bobby-williams-1,2015-16,South Carolina State,G,10,0,15,0,2,.000,0,1,.000,0,1,.000,2,2,1.000,0,3,3,2,0,0,0,1,2,0.3
12406,Ray Jerome\ray-jerome-1,2016-17,Pennsylvania,G,4,0,7,1,2,.500,1,1,1.000,0,1,.000,0,1,.000,1,0,1,0,0,0,0,3,2,0.0
12407,John Koz\john-koz-1,2017-18,Cincinnati,G,8,0,9,1,1,1.000,1,1,1.000,0,0,,0,0,,1,1,2,1,0,0,1,0,2,0.3
12408,Grant Hollander\grant-hollander-1,2014-15,Saint Louis,G,1,0,1,1,2,.500,1,2,.500,0,0,,0,0,,1,0,1,0,0,0,0,0,2,1.7
12409,Auston Evans\auston-evans-1,2017-18,Lafayette,G,6,0,27,1,3,.333,1,3,.333,0,0,,0,4,.000,0,3,3,3,1,1,1,6,2,0.0
12410,Nick Wood\nick-wood-1,2014-15,Tulsa,G,4,0,8,1,4,.250,1,1,1.000,0,3,.000,0,0,,0,0,0,0,0,0,1,0,2,-0.4
12411,Cody Cambre\cody-cambre-1,2016-17,Northwestern State,G,8,0,21,1,2,.500,1,2,.500,0,0,,0,0,,1,3,4,0,0,2,0,2,2,0.4
12412,C.J. Holmes\cj-holmes-1,2013-14,Auburn,G,3,0,3,1,1,1.000,1,1,1.000,0,0,,0,0,,0,0,0,0,0,0,1,0,2,0.2
12413,TeJai Allen\tejai-allen-1,2014-15,Florida Gulf Coast,G,7,0,7,0,0,,0,0,,0,0,,2,2,1.000,1,0,1,0,1,0,1,0,2,0.4
12414,Norman Harris\norman-harris-1,2016-17,Georgia Tech,G,4,0,7,1,4,.250,1,4,.250,0,0,,0,0,,1,0,1,0,0,0,1,2,2,-0.4
12415,Patrick Myers\patrick-myers-1,2014-15,South Carolina State,G,5,0,21,1,3,.333,1,1,1.000,0,2,.000,0,0,,0,5,5,1,1,1,2,2,2,0.3
12416,Harrison Hawks\harrison-hawks-1,2014-15,Tennessee-Martin,G,5,0,14,1,5,.200,1,3,.333,0,2,.000,0,0,,0,0,0,3,0,0,1,0,2,0.0
12417,Jordan Riullano\jordan-riullano-1,2015-16,Virginia Commonwealth,G,8,0,12,0,4,.000,0,2,.000,0,2,.000,2,2,1.000,0,1,1,1,1,0,2,4,2,-0.3
12418,Anders Skou Hansen\anders-skou-hansen-1,2014-15,Niagara,G,15,0,77,1,7,.143,1,5,.200,0,2,.000,0,0,,0,5,5,5,4,0,3,5,2,0.1
12419,Kenneth Taylor\kenneth-taylor-1,2014-15,Jackson State,G,8,0,29,1,5,.200,1,5,.200,0,0,,0,0,,1,2,3,1,0,0,2,4,2,-0.3
12420,Reece Williams\reece-williams-1,2014-15,Albany (NY),G,7,0,11,0,2,.000,0,1,.000,0,1,.000,2,2,1.000,0,2,2,0,0,0,1,3,2,-0.1
12421,Stephen Toyra\stephen-toyra-1,2014-15,Purdue,G,5,0,16,0,2,.000,0,1,.000,0,1,.000,2,4,.500,0,2,2,0,0,0,3,1,2,-0.6
12422,Connor Jean\connor-jean-1,2014-15,Loyola Marymount,G,2,0,16,1,1,1.000,1,1,1.000,0,0,,0,0,,0,1,1,0,0,0,0,4,2,0.2
12423,Randy Cruzet\randy-cruzet-1,2015-16,San Francisco,G,3,0,5,1,2,.500,1,2,.500,0,0,,0,0,,0,0,0,0,0,0,1,2,2,-0.3
12424,Jake Lerner\jake-lerner-1,2013-14,Drexel,G,5,0,4,1,1,1.000,1,1,1.000,0,0,,0,0,,0,0,0,1,0,0,0,1,2,0.4
12425,Khwan Fore\khwan-fore-1,2014-15,Richmond,G,2,0,15,1,3,.333,1,2,.500,0,1,.000,0,0,,0,1,1,1,1,0,2,1,2,-0.1
12426,Gerrald Maddox\gerrald-maddox-1,2014-15,Jackson State,G,7,0,24,1,9,.111,1,6,.167,0,3,.000,0,0,,2,2,4,2,2,0,1,3,2,-0.1
12427,Joey Gruden\joey-gruden-1,2016-17,Dayton,G,6,0,7,0,3,.000,0,1,.000,0,2,.000,2,3,.667,1,0,1,1,0,0,0,0,2,0.2
12428,Stephen O'Suji\stephen-osuji-1,2014-15,Houston Baptist,G,9,0,26,0,4,.000,0,3,.000,0,1,.000,2,5,.400,3,1,4,6,3,0,1,2,2,0.6
12429,David Park\david-park-1,2017-18,Maryland-Baltimore County,G,4,0,5,1,1,1.000,1,1,1.000,0,0,,0,0,,0,0,0,0,0,0,0,0,2,0.4
12430,Hunter Sadlon\hunter-sadlon-1,2015-16,Winthrop,G,12,0,31,1,6,.167,1,4,.250,0,2,.000,0,0,,1,2,3,2,1,0,1,2,2,0.0
12431,Russell McCray\russell-mccray-1,2013-14,Presbyterian,G,2,0,5,1,1,1.000,1,1,1.000,0,0,,0,1,.000,0,1,1,0,0,0,0,0,2,0.8
12432,Evan Crawford\evan-crawford-1,2016-17,Santa Clara,G,6,0,12,0,2,.000,0,2,.000,0,0,,2,2,1.000,2,2,4,1,0,0,2,3,2,0.0
12433,Henry Shortess\henry-shortess-1,2015-16,Louisiana State,G,7,0,7,1,1,1.000,1,1,1.000,0,0,,0,0,,0,1,1,0,1,0,0,0,2,0.4
12434,Kristopher Acevedo\kristopher-acevedo-1,2013-14,UC-Riverside,G,3,0,2,1,2,.500,1,1,1.000,0,1,.000,0,0,,0,0,0,0,0,0,0,1,2,0.2
12435,Josh Peterson\josh-peterson-1,2016-17,Coastal Carolina,G,4,0,15,0,2,.000,0,2,.000,0,0,,2,7,.286,0,2,2,2,1,0,1,1,2,0.1
12436,Aaron Misipeka-Ward\aaron-misipeka-ward-1,2016-17,Montana,G,10,0,23,0,4,.000,0,4,.000,0,0,,2,4,.500,3,5,8,1,0,0,1,2,2,0.1
12437,Armani Dodson\armani-dodson-1,2016-17,UCLA,G,1,0,2,1,1,1.000,1,1,1.000,0,0,,0,0,,1,0,1,0,0,0,0,0,2,2.4
12438,Braedon Bayer\braedon-bayer-1,2017-18,Syracuse,G,9,0,17,1,1,1.000,1,1,1.000,0,0,,0,0,,0,4,4,0,1,1,1,4,2,0.2
12439,Tyquon Jordan\tyquon-jordan-1,2016-17,Houston Baptist,G,3,0,8,0,2,.000,0,2,.000,0,0,,2,7,.286,2,2,4,0,0,0,1,2,2,-0.4
12440,Tim Brennan\tim-brennan-1,2014-15,Western Michigan,G,6,0,21,0,4,.000,0,1,.000,0,3,.000,2,5,.400,1,2,3,1,4,0,1,3,2,0.3
12441,Austin McCullough\austin-mccullough-1,2017-18,University of California,G,19,1,91,0,12,.000,0,2,.000,0,10,.000,2,2,1.000,0,4,4,2,1,0,4,10,2,-0.6
12442,Hunter Sadlon\hunter-sadlon-1,2014-15,Winthrop,G,11,0,31,0,0,,0,0,,0,0,,2,4,.500,0,3,3,2,0,0,2,4,2,0.0
12443,Myles Davis\myles-davis-1,2016-17,Xavier,G,3,0,34,0,8,.000,0,2,.000,0,6,.000,2,4,.500,0,2,2,0,1,0,2,5,2,-2.3
12444,Matt Stacho\matt-stacho-1,2013-14,Illinois State,G,11,0,14,1,10,.100,1,5,.200,0,5,.000,0,0,,0,0,0,1,1,0,0,1,2,-0.3
12445,Jaylan Ballou\jaylan-ballou-1,2016-17,Nevada-Las Vegas,G,4,0,5,1,2,.500,1,2,.500,0,0,,0,1,.000,2,0,2,2,1,0,0,0,2,1.1
12446,Nehemiah Allen\nehemiah-allen-1,2016-17,Grand Canyon,G,6,1,18,1,1,1.000,1,1,1.000,0,0,,0,1,.000,0,5,5,0,1,0,0,0,2,0.6
12447,Matt Donlan\matt-donlan-1,2013-14,South Dakota State,G,7,0,16,1,4,.250,1,3,.333,0,1,.000,0,0,,0,2,2,1,0,0,0,0,2,0.1
12448,Joaquin Pistokache\joaquin-pistokache-1,2015-16,Texas-Rio Grande Valley,G,7,0,17,0,2,.000,0,2,.000,0,0,,2,4,.500,0,1,1,0,0,0,1,0,2,-0.1
12449,David Bloom\david-bloom-1,2014-15,Texas A&M-Corpus Christi,G,2,0,6,0,3,.000,0,3,.000,0,0,,2,6,.333,2,1,3,0,0,0,0,0,2,0.0
12450,Trevor Osborn\trevor-osborn-1,2015-16,Purdue-Fort Wayne,G,6,0,7,1,2,.500,1,1,1.000,0,1,.000,0,0,,1,2,3,2,0,0,1,2,2,0.3
12451,Van Rolle\van-rolle-1,2017-18,Towson,G,7,0,24,1,11,.091,1,7,.143,0,4,.000,0,2,.000,0,1,1,3,1,0,1,1,2,-0.6
12452,Devin Fleming\devin-fleming-1,2017-18,Southern California,G,3,0,3,1,2,.500,1,1,1.000,0,1,.000,0,0,,0,2,2,0,0,0,0,0,2,0.5
12453,Tanner Tapp\tanner-tapp-1,2016-17,Samford,G,8,0,23,1,8,.125,1,4,.250,0,4,.000,0,4,.000,0,3,3,0,1,0,1,1,2,-0.5
12454,Dominique Williams\dominique-williams-3,2013-14,San Francisco,G,3,0,6,1,1,1.000,1,1,1.000,0,0,,0,0,,0,0,0,0,0,0,0,0,2,0.6
12455,Cory Jacobsen\cory-jacobsen-1,2015-16,South Dakota State,G,9,0,43,0,8,.000,0,0,,0,8,.000,2,2,1.000,0,1,1,1,1,0,1,1,2,-0.3
12456,Trevor Osborn\trevor-osborn-1,2014-15,Purdue-Fort Wayne,G,5,0,10,1,4,.250,1,1,1.000,0,3,.000,0,1,.000,0,0,0,0,1,0,1,0,2,-0.2
12457,Ountae Campbell\ountae-campbell-1,2015-16,Fresno State,G,7,0,12,1,3,.333,1,3,.333,0,0,,0,0,,0,3,3,1,0,0,0,1,2,0.2
12458,Tyler Self\tyler-self-1,2014-15,Kansas,G,7,0,12,1,4,.250,1,2,.500,0,2,.000,0,0,,0,1,1,1,0,0,3,3,2,-0.5
12459,Jordan Lester\jordan-lester-1,2016-17,Robert Morris,G,3,1,26,1,3,.333,1,1,1.000,0,2,.000,0,0,,1,2,3,2,2,0,2,8,2,-0.1
12460,Adrian Autry\adrian-autry-1,2015-16,Syracuse,G,4,0,5,0,5,.000,0,2,.000,0,3,.000,2,2,1.000,0,0,0,0,1,0,2,1,2,-0.7
12461,Blake Pagon\blake-pagon-1,2016-17,Stanford,G,5,0,10,0,2,.000,0,1,.000,0,1,.000,2,2,1.000,1,1,2,0,1,0,1,0,2,0.3
12462,Ryan Maas\ryan-maas-1,2015-16,Western Illinois,G,3,0,9,1,4,.250,1,3,.333,0,1,.000,0,0,,0,2,2,0,0,0,0,0,2,0.1
12463,Tyler Miller\tyler-miller-2,2016-17,Western Kentucky,G,15,0,49,1,1,1.000,1,1,1.000,0,0,,0,1,.000,3,0,3,3,2,0,2,2,2,0.3
12464,Isiah Rogers\isiah-rogers-1,2017-18,Maryland-Baltimore County,G,3,0,1,1,2,.500,1,1,1.000,0,1,.000,0,0,,1,0,1,0,0,0,0,0,2,0.6
12465,Kaleb Mallory\kaleb-mallory-1,2013-14,Ball State,G,2,0,3,1,2,.500,1,1,1.000,0,1,.000,0,0,,0,0,0,0,0,0,0,0,2,0.5
12466,Donovan Ham\donovan-ham-1,2015-16,Texas Tech,G,6,0,8,1,1,1.000,1,1,1.000,0,0,,0,0,,0,0,0,0,0,0,0,1,2,0.2
12467,Mitch Schafer\mitch-scafer-1,2017-18,San Diego,G,3,0,5,1,1,1.000,1,1,1.000,0,0,,0,0,,0,0,0,0,0,0,0,0,2,0.6
12468,C.J. Ward\cj-ward-1,2014-15,Maine,G,3,0,12,0,2,.000,0,1,.000,0,1,.000,2,2,1.000,0,0,0,1,0,0,0,0,2,0.4
12469,Jonny David\jonny-david-1,2015-16,Kentucky,G,10,0,11,0,2,.000,0,0,,0,2,.000,2,2,1.000,0,0,0,0,0,0,1,1,2,-0.1
12470,Mark Noble\mark-noble-1,2016-17,Akron,G,4,0,6,1,1,1.000,1,1,1.000,0,0,,0,0,,0,0,0,0,3,0,1,1,2,0.8
12471,Justin Heller\justin-heller-1,2013-14,Miami (FL),G,5,1,5,1,4,.250,1,1,1.000,0,3,.000,0,0,,0,1,1,0,0,0,1,1,2,-0.3
12472,Olivier Cadieux\olivier-cadieux-1,2017-18,Fairfield,G,2,0,3,0,1,.000,0,0,,0,1,.000,2,2,1.000,0,1,1,0,0,0,0,0,2,0.8
12473,Nick Hamilton\nick-hamilton-1,2014-15,University of California,G,5,0,10,1,4,.250,1,4,.250,0,0,,0,0,,1,0,1,0,1,0,0,1,2,0.2
12474,Marius McAllister\marius-mcallister-1,2014-15,North Carolina Central,G,5,0,9,1,1,1.000,1,1,1.000,0,0,,0,0,,0,3,3,1,0,0,0,1,2,0.6
12475,Lee Richmond\lee-richmond-1,2016-17,Jacksonville,G,4,0,11,0,2,.000,0,2,.000,0,0,,2,2,1.000,1,0,1,1,1,0,1,0,2,0.5
12476,Rayshawn Miller\rayshawn-miller-1,2015-16,Massachusetts,G,7,0,11,1,3,.333,1,1,1.000,0,2,.000,0,0,,0,1,1,0,0,0,1,2,2,-0.2
12477,EJ Floreal\ej-floreal-1,2013-14,Kentucky,G,3,0,4,1,1,1.000,1,1,1.000,0,0,,0,0,,0,1,1,0,1,1,0,1,2,1.1
12478,Travis Valmon\travis-valmon-1,2016-17,Maryland,G,5,0,8,0,1,.000,0,1,.000,0,0,,2,2,1.000,2,0,2,0,1,0,2,3,2,0.1
12479,Bola Alade\bola-alade-1,2015-16,Oklahoma,G,7,0,16,1,6,.167,1,3,.333,0,3,.000,0,0,,0,2,2,0,0,0,3,0,2,-0.6
12480,Shaun Belbey\shaun-belbey-1,2016-17,Syracuse,G,12,0,18,1,5,.200,1,3,.333,0,2,.000,0,0,,0,0,0,2,0,0,2,0,2,-0.1
12481,Mike Washington\mike-washington-2,2013-14,Princeton,G,9,0,12,1,6,.167,1,2,.500,0,4,.000,0,0,,1,1,2,0,1,0,1,1,2,-0.1
12482,Brian Fabre\brian-fabre-1,2017-18,Fairleigh Dickinson,G,6,0,9,1,2,.500,1,1,1.000,0,1,.000,0,0,,0,1,1,0,1,0,2,0,2,0.1
12483,Tyler Leedy\tyler-leedy-1,2017-18,Ball State,G,4,0,6,1,1,1.000,1,1,1.000,0,0,,0,0,,0,0,0,1,0,0,0,0,2,0.6
12484,Mike Fernandez\mike-fernandez-1,2014-15,Miami (FL),G,4,0,6,1,2,.500,1,1,1.000,0,1,.000,0,0,,0,0,0,0,0,0,0,1,2,0.2
12485,Chris Perez\chris-perez-2,2013-14,New Mexico,G,2,1,7,1,3,.333,1,2,.500,0,1,.000,0,0,,0,0,0,1,0,0,0,0,2,0.5
12486,Andrew Fonts\andrew-fonts-1,2017-18,Providence,G,7,0,8,1,3,.333,1,2,.500,0,1,.000,0,0,,0,0,0,0,1,0,0,1,2,0.1
12487,Ethan Norton\ethan-norton-1,2017-18,Loyola (MD),G,3,1,8,0,1,.000,0,0,,0,1,.000,2,2,1.000,0,1,1,1,1,0,0,0,2,1.1
12488,Brett Easterling\brett-easterling-1,2017-18,Auburn,G,8,0,14,1,2,.500,1,1,1.000,0,1,.000,0,0,,0,1,1,0,0,0,1,1,2,0.0
12489,Nic Lane\nic-lane-1,2014-15,Colgate,G,5,0,7,1,1,1.000,1,1,1.000,0,0,,0,0,,0,1,1,1,0,0,1,0,2,0.3
12490,Mike Lecak\mike-lecak-1,2015-16,Pittsburgh,G,11,0,21,1,7,.143,1,2,.500,0,5,.000,0,0,,0,0,0,1,0,0,3,4,2,-0.6
12491,Jeremiah Aska\jeremiah-aska-1,2013-14,Hartford,G,14,0,19,0,3,.000,0,0,,0,3,.000,2,2,1.000,0,5,5,1,0,0,0,3,2,0.1
12492,C.J. Hill\cj-hill-1,2014-15,Northeastern,G,10,0,15,0,4,.000,0,3,.000,0,1,.000,2,2,1.000,0,1,1,0,0,0,6,4,2,-0.8
12493,Ryan Dickey\ryan-dickey-2,2015-16,Samford,G,2,0,4,1,4,.250,1,3,.333,0,1,.000,0,0,,0,0,0,0,0,0,0,0,2,-0.2
12494,Malcolm Laws\malcolm-laws-1,2016-17,Nebraska,G,5,0,11,1,6,.167,1,5,.200,0,1,.000,0,3,.000,0,1,1,0,1,0,0,0,2,-0.3
12495,Mark Noble\mark-noble-1,2015-16,Akron,G,5,0,14,1,3,.333,1,2,.500,0,1,.000,0,0,,0,1,1,0,1,0,2,2,2,-0.2
12496,Jay Wimbley\jay-wimbley-1,2013-14,Chattanooga,G,1,0,1,0,0,,0,0,,0,0,,2,2,1.000,0,0,0,0,0,0,0,0,2,2.0
12497,Mike Robbins\mike-robbins-1,2015-16,Temple,G,6,0,7,0,1,.000,0,1,.000,0,0,,2,3,.667,0,0,0,1,0,1,1,0,2,0.2
12498,Nick Fruscio\nick-fruscio-1,2017-18,Albany (NY),G,5,0,6,1,3,.333,1,2,.500,0,1,.000,0,0,,0,0,0,0,0,0,1,0,2,-0.1
12499,Chase Carlton\chase-carlton-1,2016-17,Texas A&M,G,12,0,94,1,5,.200,1,2,.500,0,3,.000,0,3,.000,0,4,4,11,3,0,3,21,2,-0.2
12500,Matt Ferris\matt-ferris-1,2017-18,Wisconsin,G,6,0,8,1,1,1.000,1,1,1.000,0,0,,0,0,,1,2,3,0,0,0,2,1,2,0.1
12501,Riley Dearring\riley-dearring-1,2015-16,Wisconsin,G,3,0,6,0,2,.000,0,0,,0,2,.000,2,2,1.000,0,2,2,0,0,0,2,2,2,-0.5
12502,Christian Garrett\christian-garrett-1,2014-15,Kansas,G,9,1,14,1,5,.200,1,4,.250,0,1,.000,0,0,,1,1,2,1,0,0,3,2,2,-0.4
12503,Sam Martin\sam-martin-4,2017-18,Cincinnati,G,10,0,18,0,5,.000,0,3,.000,0,2,.000,2,2,1.000,0,1,1,2,0,0,2,5,2,-0.4
12504,Tre Duncan\tre-duncan-1,2014-15,High Point,G,7,1,14,1,1,1.000,1,1,1.000,0,0,,0,0,,0,0,0,1,0,0,1,2,2,0.1
12505,Charles Rushman\charles-rushman-1,2013-14,Nevada-Las Vegas,G,11,0,10,1,4,.250,1,4,.250,0,0,,0,0,,1,0,1,0,0,0,0,3,2,-0.1
12506,Mark Plousis\mark-plousis-1,2014-15,Hartford,G,5,0,7,0,0,,0,0,,0,0,,2,4,.500,0,2,2,0,0,0,1,1,2,0.1
12507,Brandon Busuttil\brandon-busuttil-1,2014-15,Bowling Green State,G,9,0,19,1,3,.333,1,1,1.000,0,2,.000,0,0,,0,1,1,1,0,0,1,1,2,0.0
12508,Larry McCollum\larry-mccollum-1,2013-14,Towson,G,6,0,10,1,4,.250,1,3,.333,0,1,.000,0,0,,0,0,0,1,1,0,0,0,2,0.2
12509,Corey Bias\corey-bias-1,2016-17,Charlotte,G,3,0,4,0,0,,0,0,,0,0,,2,2,1.000,0,0,0,0,0,0,0,1,2,0.5
12510,Tim Brennan\tim-brennan-1,2013-14,Western Michigan,G,9,0,14,1,3,.333,1,1,1.000,0,2,.000,0,0,,0,2,2,0,1,0,3,3,2,-0.3
12511,Patrick Crowley\patrick-crowley-1,2013-14,Notre Dame,G,2,0,2,1,2,.500,1,2,.500,0,0,,0,0,,1,0,1,0,1,0,0,0,2,1.4
12512,Micah Littlejohn\micah-littlejohn-1,2014-15,Tulsa,G,4,0,6,1,2,.500,1,1,1.000,0,1,.000,0,0,,0,1,1,0,0,0,0,0,2,0.3
12513,Mike Gillespie\mike-gillespie-5,2017-18,Massachusetts,G,4,0,6,0,1,.000,0,0,,0,1,.000,2,2,1.000,0,3,3,0,0,0,0,1,2,0.5
12514,Armand Shoon\armand-shoon-1,2014-15,Florida Gulf Coast,G,11,0,20,1,4,.250,1,2,.500,0,2,.000,0,0,,0,4,4,2,1,0,2,5,2,-0.1
12515,Solomon Yon\solomon-yon-1,2016-17,Texas-Rio Grande Valley,G,3,0,6,0,1,.000,0,1,.000,0,0,,2,2,1.000,0,2,2,1,0,0,1,0,2,0.5
12516,Trevor Osborn\trevor-osborn-1,2013-14,Purdue-Fort Wayne,G,9,0,14,0,3,.000,0,1,.000,0,2,.000,2,2,1.000,1,1,2,1,1,0,0,1,2,0.2
12517,Chris Corchiani\chris-corchiani-2,2014-15,North Carolina State,G,5,0,10,1,4,.250,1,2,.500,0,2,.000,0,0,,0,1,1,1,1,0,1,2,2,0.0
12518,Shaheed Medlock\shaheed-medlock-1,2016-17,Georgia Tech,G,3,0,6,1,3,.333,1,3,.333,0,0,,0,0,,0,1,1,0,0,0,0,3,2,-0.2
12519,Marquelle McIntyre\marquelle-mcintyre-1,2017-18,Akron,G,10,0,7,1,1,1.000,1,1,1.000,0,0,,0,0,,0,2,2,0,0,0,1,1,2,0.1
12520,Terrill Toe\terrill-toe-1,2016-17,Bryant,G,6,0,20,1,3,.333,1,1,1.000,0,2,.000,0,0,,0,0,0,1,0,0,0,2,2,0.0
12521,Tyler Warford\tyler-warford-1,2015-16,Youngstown State,G,4,0,9,1,5,.200,1,2,.500,0,3,.000,0,0,,0,0,0,1,0,0,0,0,2,-0.1
12522,Landon Russell\landon-russell-1,2016-17,Yale,G,3,0,19,1,6,.167,1,1,1.000,0,5,.000,0,0,,1,0,1,3,0,0,1,2,2,-0.3
12523,Will Culliton\will-culliton-1,2017-18,Army,G,1,0,4,1,2,.500,1,1,1.000,0,1,.000,0,0,,0,1,1,0,0,0,1,0,2,0.3
12524,Brenton Petty\brenton-petty-1,2017-18,Fordham,G,15,1,62,1,6,.167,1,4,.250,0,2,.000,0,0,,2,5,7,0,2,0,1,14,2,-0.2
12525,Simon Pittman\simon-pittman-1,2014-15,Saint Francis (PA),G,3,0,6,0,0,,0,0,,0,0,,2,4,.500,1,2,3,0,0,0,2,1,2,0.0
12526,Matteo Bellusci\matteo-bellusci-1,2013-14,High Point,G,3,0,9,0,1,.000,0,1,.000,0,0,,2,2,1.000,0,1,1,0,0,0,0,1,2,0.4
12527,Stephen Prendergast\stephen-prendergast-1,2014-15,Wake Forest,G,4,0,9,1,3,.333,1,2,.500,0,1,.000,0,0,,0,0,0,0,0,0,1,2,2,-0.4
12528,James McMillon\james-mcmillon-1,2016-17,NJIT,G,1,0,2,1,1,1.000,1,1,1.000,0,0,,0,0,,0,0,0,0,0,0,0,0,2,1.7
12529,Kurt Karis\kurt-karis-1,2017-18,Southern California,G,9,0,18,0,1,.000,0,1,.000,0,0,,2,4,.500,1,2,3,0,1,0,1,2,2,0.1
12530,Shaun Belbey\shaun-belbey-1,2017-18,Syracuse,G,3,0,2,1,1,1.000,1,1,1.000,0,0,,0,0,,0,0,0,1,1,0,0,0,2,1.1
12531,James Edwards\james-edwards-4,2017-18,Air Force,G,1,0,3,1,2,.500,1,1,1.000,0,1,.000,0,0,,0,0,0,0,1,0,0,0,2,2.0
12532,Mike Adewunmi\mike-adewunmi-1,2017-18,Houston,G,14,0,36,0,8,.000,0,1,.000,0,7,.000,2,4,.500,1,5,6,2,2,0,0,2,2,0.0
12533,Isaiah Lewis\isaiah-lewis-1,2016-17,Temple,G,4,0,7,1,4,.250,1,3,.333,0,1,.000,0,0,,0,0,0,0,0,0,1,1,2,-0.5
12534,Isaac Wulff\isaac-wulff-1,2017-18,UCLA,G,2,0,3,0,3,.000,0,1,.000,0,2,.000,2,2,1.000,0,0,0,0,0,0,0,1,2,-0.3
12535,Mark Patterson\mark-patterson-1,2015-16,Cal Poly,G,3,0,7,1,2,.500,1,2,.500,0,0,,0,0,,0,1,1,0,0,0,0,0,2,0.4
12536,Brian Rohleder\brian-rohleder-1,2014-15,Kansas State,G,17,1,65,1,5,.200,1,2,.500,0,3,.000,0,2,.000,2,4,6,5,3,1,3,14,2,0.0
12537,Michael Klebon\michael-klebon-1,2015-16,Saint Francis (PA),G,7,0,11,0,3,.000,0,0,,0,3,.000,2,2,1.000,1,2,3,0,1,0,1,3,2,0.0
12538,Grant Shell\grant-shell-1,2015-16,Fresno State,G,6,0,13,1,5,.200,1,2,.500,0,3,.000,0,0,,2,0,2,1,1,0,4,1,2,-0.4
12539,Greg Tarca\greg-tarca-1,2014-15,Quinnipiac,G,5,0,5,1,3,.333,1,2,.500,0,1,.000,0,0,,0,0,0,0,0,0,0,2,2,-0.1
12540,Eric Youncofski\eric-youncofski-1,2013-14,Rhode Island,G,6,0,5,0,0,,0,0,,0,0,,2,2,1.000,0,0,0,0,0,0,0,0,2,0.3
12541,Duke Antonelli\duke-antonelli-1,2013-14,Wake Forest,G,4,0,4,1,2,.500,1,2,.500,0,0,,0,0,,1,0,1,0,0,0,0,0,2,0.4
12542,Dylan Greene\dylan-greene-1,2013-14,Lipscomb,G,18,0,35,1,7,.143,1,5,.200,0,2,.000,0,0,,3,4,7,3,0,0,3,8,2,-0.2
12543,Brian Rohleder\brian-rohleder-1,2013-14,Kansas State,G,18,0,31,1,3,.333,1,2,.500,0,1,.000,0,0,,1,2,3,1,1,0,1,1,2,0.1
12544,Peyton Robbins\peyton-robbins-1,2014-15,East Carolina,G,1,0,1,1,2,.500,1,2,.500,0,0,,0,0,,0,0,0,0,1,0,0,0,2,2.0
12545,Romero Collier\romero-collier-1,2015-16,Niagara,G,6,0,36,1,12,.083,1,6,.167,0,6,.000,0,0,,2,0,2,3,1,1,3,2,2,-0.8
12546,Robert Cid\robert-cid-1,2013-14,Cal State Northridge,G,3,0,5,0,2,.000,0,2,.000,0,0,,2,2,1.000,0,1,1,0,0,0,0,1,2,0.2
12547,Bruce Brittingham\bruce-brittingham-1,2015-16,Wagner,G,8,0,12,1,3,.333,1,1,1.000,0,2,.000,0,0,,0,4,4,3,0,1,2,0,2,0.3
12548,Kyle Thompson\kyle-thompson-1,2017-18,Saint Joseph's,G,8,0,11,0,1,.000,0,1,.000,0,0,,2,2,1.000,0,1,1,0,1,0,2,0,2,0.1
12549,John Ragin\john-ragin-1,2015-16,South Carolina,G,4,0,8,1,3,.333,1,2,.500,0,1,.000,0,0,,0,1,1,0,1,0,0,0,2,0.4
12550,John Hubler\john-hubler-1,2014-15,IUPUI,G,8,0,22,0,5,.000,0,1,.000,0,4,.000,2,2,1.000,0,0,0,0,0,0,3,2,2,-0.7
12551,Kanler Coker\kanler-coker-1,2015-16,North Carolina,G,13,0,16,1,4,.250,1,2,.500,0,2,.000,0,0,,1,6,7,1,0,0,2,2,2,0.0
12552,Zach Hodskins\zach-hodskins-1,2015-16,Florida,G,7,0,8,1,5,.200,1,3,.333,0,2,.000,0,1,.000,0,1,1,0,0,0,0,2,2,-0.3
12553,Lyles Davis\lyles-davis-1,2016-17,Clemson,G,4,0,8,1,1,1.000,1,1,1.000,0,0,,0,2,.000,0,4,4,2,2,0,0,0,2,1.4
12554,Da'Shawn Robinson\dashawn-robinson-1,2016-17,Louisiana Tech,G,3,0,18,1,4,.250,1,2,.500,0,2,.000,0,0,,0,2,2,3,2,0,1,0,2,1.1
12555,Marlon Williams\marlon-williams-2,2017-18,Texas-Rio Grande Valley,G,10,0,23,1,5,.200,1,1,1.000,0,4,.000,0,2,.000,1,2,3,2,2,0,2,2,2,0.0
12556,Edon Molic\edon-molic-1,2013-14,St. Francis (NY),G,2,0,2,1,3,.333,1,1,1.000,0,2,.000,0,0,,0,0,0,0,0,0,0,0,2,0.2
12557,Justice Obasohan\justice-obasohan-1,2016-17,East Carolina,G,4,0,5,1,1,1.000,1,1,1.000,0,0,,0,0,,1,1,2,1,0,0,0,1,2,0.8
12558,Adam Savion\adam-savion-1,2013-14,Hofstra,G,10,0,36,0,3,.000,0,3,.000,0,0,,2,6,.333,2,4,6,2,2,0,4,4,2,-0.1
12559,Riley McGillan\riley-mcgillan-1,2014-15,Clemson,G,8,0,12,1,5,.200,1,1,1.000,0,4,.000,0,0,,1,1,2,0,1,0,0,1,2,0.1
12560,Parker U'u\parker-uu-1,2014-15,San Diego State,G,2,0,8,1,7,.143,1,3,.333,0,4,.000,0,1,.000,3,3,6,0,0,0,1,1,2,-0.7
12561,Caleb Davis\caleb-davis-1,2017-18,Duquesne,G,4,0,9,1,3,.333,1,2,.500,0,1,.000,0,0,,0,0,0,1,0,0,1,1,2,-0.1
12562,Trent Robinson\trent-robinson-1,2017-18,College of Charleston,G,2,0,3,1,3,.333,1,2,.500,0,1,.000,0,1,.000,0,1,1,0,0,0,0,0,2,0.1
12563,Kristopher Acevedo\kristopher-acevedo-1,2014-15,UC-Riverside,G,2,0,6,1,3,.333,1,2,.500,0,1,.000,0,0,,0,1,1,0,0,0,0,2,2,-0.1
12564,Joaquin Pistokache\joaquin-pistokache-1,2014-15,Texas-Rio Grande Valley,G,7,0,20,1,2,.500,1,2,.500,0,0,,0,0,,0,1,1,0,2,0,1,3,2,0.2
12565,Jordan Ellis\jordan-ellis-1,2014-15,Brigham Young,G,16,1,41,1,2,.500,1,2,.500,0,0,,0,2,.000,0,5,5,3,1,0,2,4,2,0.1
12566,Stephen Strachan\stephen-strachan-1,2016-17,Middle Tennessee,G,6,0,9,0,0,,0,0,,0,0,,2,2,1.000,0,1,1,0,0,0,0,1,2,0.3
12567,Corey Bias\corey-bias-1,2017-18,Charlotte,G,6,1,14,1,2,.500,1,2,.500,0,0,,0,0,,0,2,2,1,0,0,0,2,2,0.3
12568,Cameron Lazare\cameron-lazare-1,2017-18,Northwestern State,G,16,5,117,1,10,.100,1,5,.200,0,5,.000,0,2,.000,5,12,17,6,9,1,5,18,2,0.2
12569,Trey Stacey\trey-stacey-1,2017-18,Wright State,G,9,0,20,1,7,.143,1,4,.250,0,3,.000,0,0,,2,2,4,0,2,0,1,1,2,0.0
12570,Lane Below\lane-below-1,2016-17,Mississippi,G,4,0,9,1,2,.500,1,2,.500,0,0,,0,0,,0,0,0,0,0,0,0,1,2,0.2
12571,Christian Johnston\christian-johnston-1,2014-15,Duquesne,G,8,0,13,1,7,.143,1,6,.167,0,1,.000,0,0,,1,1,2,0,1,0,1,1,2,-0.2
12572,David Molinari\david-molinari-1,2014-15,DePaul,G,10,0,14,1,5,.200,1,2,.500,0,3,.000,0,0,,0,1,1,2,1,0,0,0,2,0.2
12573,Kirkland Humphrey\kirkland-humphrey-1,2016-17,Eastern Kentucky,G,7,0,12,1,9,.111,1,5,.200,0,4,.000,0,0,,1,0,1,0,1,0,1,1,2,-0.5
12574,Sam Volmy\sam-volmy-1,2017-18,Niagara,G,4,0,5,0,3,.000,0,2,.000,0,1,.000,2,2,1.000,0,2,2,0,0,0,0,1,2,0.0
12575,Mike Burnett\mike-burnett-1,2014-15,Colorado State,G,4,0,10,1,2,.500,1,2,.500,0,0,,0,0,,0,0,0,0,0,0,1,3,2,-0.3
12576,Jacob Hazzard\jacob-hazzard-1,2014-15,Arizona,G,17,0,27,1,10,.100,1,4,.250,0,6,.000,0,0,,0,0,0,1,0,0,5,1,2,-0.5
12577,Akintoye Okunrinboye\akintoye-okunrinboye-1,2013-14,Southern Illinois-Edwardsville,G,1,0,4,1,2,.500,1,1,1.000,0,1,.000,0,1,.000,0,0,0,0,1,0,0,0,2,1.6
12578,Max Martino\max-martino-1,2014-15,Northern Iowa,G,16,0,34,0,7,.000,0,3,.000,0,4,.000,2,3,.667,1,2,3,1,0,0,0,4,2,-0.2
12579,Michael Saladin\michael-saladin-1,2017-18,Houston Baptist,G,7,0,19,1,6,.167,1,2,.500,0,4,.000,0,0,,0,2,2,1,2,0,0,0,2,0.2
12580,Chris Nealey\chris-nealey-1,2014-15,Boise State,G,7,0,19,0,1,.000,0,0,,0,1,.000,2,2,1.000,0,1,1,1,3,0,1,3,2,0.4
12581,Mike DeLorenzo\mike-delorenzo-1,2014-15,Monmouth,G,11,0,10,1,3,.333,1,3,.333,0,0,,0,0,,0,0,0,0,1,0,1,0,2,0.0
12582,Ra'Mond Hines\ramond-hines-1,2017-18,Georgetown,G,6,0,15,0,3,.000,0,1,.000,0,2,.000,2,2,1.000,0,1,1,1,1,0,0,1,2,0.3
12583,Samson Oladimeji\samson-oladimeji-1,2016-17,Illinois,G,7,0,8,0,1,.000,0,0,,0,1,.000,2,3,.667,2,1,3,0,0,0,0,1,2,0.3
12584,Mike Booth\mike-booth-1,2015-16,Saint Joseph's,G,8,0,9,0,3,.000,0,1,.000,0,2,.000,2,2,1.000,0,1,1,0,0,0,1,1,2,-0.2
12585,Josh Conley\josh-conley-1,2017-18,Southern Mississippi,G,7,0,41,0,5,.000,0,4,.000,0,1,.000,2,4,.500,0,5,5,2,0,0,2,6,2,-0.5
12586,Dylan Whitbread\dylan-whitbread-1,2017-18,Colgate,G,2,0,4,1,1,1.000,1,1,1.000,0,0,,0,0,,0,0,0,0,0,0,1,1,2,0.2
12587,Ian Chiles\ian-chiles-2,2014-15,Tennessee,G,3,0,14,1,2,.500,1,1,1.000,0,1,.000,0,0,,0,2,2,1,1,0,0,1,2,1.0
12588,Andrew Hurd\andrew-hurd-1,2013-14,Central Connecticut State,G,8,0,25,1,5,.200,1,2,.500,0,3,.000,0,0,,1,2,3,3,0,0,4,4,2,-0.4
12589,Nick McMahon\nick-mcmahon-1,2013-14,Villanova,G,11,1,27,1,4,.250,1,1,1.000,0,3,.000,0,0,,0,1,1,1,1,0,1,2,2,0.0
12590,Kane Ma\kane-ma-1,2017-18,North Carolina,G,12,1,13,1,3,.333,1,2,.500,0,1,.000,0,0,,0,1,1,0,0,0,0,0,2,0.1
12591,Hank Davis\hank-davis-1,2015-16,La Salle,G,3,0,6,1,2,.500,1,2,.500,0,0,,0,0,,0,0,0,0,0,0,0,1,2,0.2
12592,Maceio Choice\maceio-choice-1,2013-14,Maryland-Eastern Shore,G,5,0,8,1,2,.500,1,1,1.000,0,1,.000,0,0,,0,1,1,0,0,0,0,2,2,0.1
12593,Steve Perpiglia\steve-perpiglia-1,2014-15,Boston College,G,17,0,29,1,2,.500,1,1,1.000,0,1,.000,0,0,,0,0,0,5,2,0,3,2,2,0.2
12594,David Cunningham\david-cunningham-1,2017-18,Nevada,G,5,0,4,1,2,.500,1,1,1.000,0,1,.000,0,0,,0,0,0,0,1,0,1,2,2,0.0
12595,Hank Davis\hank-davis-1,2014-15,La Salle,G,5,0,6,1,1,1.000,1,1,1.000,0,0,,0,0,,0,0,0,2,1,0,0,3,2,0.6
12596,Jordan McRae\jordan-mcrae-2,2015-16,Binghamton,G,6,0,10,1,2,.500,1,2,.500,0,0,,0,0,,0,0,0,0,0,0,0,1,2,0.1
12597,Will Leviton\will-leviton-1,2016-17,Rhode Island,G,7,0,10,1,3,.333,1,2,.500,0,1,.000,0,0,,0,2,2,0,2,0,0,0,2,0.4
12598,Matt Poplawski\matt-poplawski-1,2013-14,Pennsylvania,G,4,0,7,0,2,.000,0,0,,0,2,.000,2,3,.667,0,0,0,0,0,0,1,2,2,-0.4
12599,Jahmel Taylor\jahmel-taylor-1,2014-15,Washington,G,2,0,7,1,2,.500,1,1,1.000,0,1,.000,0,0,,0,2,2,1,0,0,1,3,2,0.1
12600,Jeffrey Yan\jeffrey-yan-1,2016-17,Utah Valley,G,1,0,5,0,0,,0,0,,0,0,,2,4,.500,0,0,0,0,0,0,1,0,2,0.2
12601,Greg Tarca\greg-tarca-1,2016-17,Quinnipiac,G,8,0,11,1,4,.250,1,4,.250,0,0,,0,1,.000,1,0,1,0,0,0,2,1,2,-0.3
12602,Jon'te Dotson\jonte-dotson-1,2013-14,Northern Colorado,G,4,0,15,1,2,.500,1,1,1.000,0,1,.000,0,0,,1,2,3,1,1,0,0,0,2,1.0
12603,Kyle McDermed\kyle-mcdermed-1,2017-18,Western Michigan,G,9,0,18,1,7,.143,1,3,.333,0,4,.000,0,0,,0,1,1,2,1,0,0,2,2,-0.1
12604,Nick Colletta\nick-colletta-1,2013-14,Marist,G,3,0,25,1,6,.167,1,3,.333,0,3,.000,0,0,,0,3,3,0,1,0,1,3,2,-0.7
12605,Niko Roberts\niko-roberts-1,2013-14,Kansas,G,6,1,14,0,3,.000,0,1,.000,0,2,.000,2,4,.500,2,1,3,0,0,0,1,4,2,-0.3
12606,Ryan Beddeo\ryan-beddeo-1,2016-17,Fresno State,G,3,0,8,1,2,.500,1,1,1.000,0,1,.000,0,0,,0,1,1,2,1,0,3,0,2,0.2
12607,Jeff Laidig\jeff-laidig-1,2015-16,Belmont,G,30,1,107,0,6,.000,0,2,.000,0,4,.000,2,2,1.000,1,14,15,6,0,0,3,16,2,-0.1
12608,Kyle Molock\kyle-molock-1,2013-14,Saint Joseph's,G,8,0,28,0,1,.000,0,1,.000,0,0,,2,3,.667,0,0,0,1,0,0,6,2,2,-0.7
12609,Jacob Orender\jacob-orender-1,2017-18,University of California,G,3,1,5,0,1,.000,0,1,.000,0,0,,2,2,1.000,0,1,1,0,0,0,0,1,2,0.4
12610,Harrison Brown\harrison-brown-2,2016-17,Rice,G,1,0,1,1,1,1.000,1,1,1.000,0,0,,0,0,,1,0,1,0,0,0,0,1,2,2.0
12611,Kirkland Humphrey\kirkland-humphrey-1,2015-16,Eastern Kentucky,G,2,0,2,1,1,1.000,1,1,1.000,0,0,,0,0,,0,0,0,0,1,0,0,0,2,1.4
12612,Zac DiSalvo\zac-disalvo-1,2015-16,Buffalo,G,4,0,6,1,3,.333,1,1,1.000,0,2,.000,0,0,,3,0,3,1,0,0,0,2,2,0.6
12613,Charlie Rose\charlie-rose-1,2016-17,Iowa,G,7,0,9,1,3,.333,1,2,.500,0,1,.000,0,0,,0,1,1,1,0,0,1,3,2,-0.1
12614,David Haus\david-haus-1,2015-16,Duquesne,G,10,0,13,1,1,1.000,1,1,1.000,0,0,,0,0,,0,3,3,0,0,0,0,3,2,0.1
12615,Adonis Saltes\adonis-saltes-1,2015-16,Southern Utah,G,4,0,8,0,1,.000,0,1,.000,0,0,,2,2,1.000,0,1,1,1,0,0,2,3,2,-0.2
12616,Donald Ralls\donald-ralls-1,2016-17,Hampton,G,6,1,11,1,6,.167,1,3,.333,0,3,.000,0,0,,0,3,3,1,0,0,6,0,2,-1.0
12617,Marcus Wallace\marcus-wallace-3,2017-18,Arkansas-Pine Bluff,G,4,0,22,0,1,.000,0,1,.000,0,0,,2,2,1.000,1,2,3,0,0,0,0,1,2,0.6
12618,Malcolm Laws\malcolm-laws-1,2017-18,Nebraska,G,9,0,15,1,7,.143,1,4,.250,0,3,.000,0,0,,0,0,0,0,0,0,1,0,2,-0.4
12619,Kenneth Taylor\kenneth-taylor-1,2013-14,Jackson State,G,5,1,21,1,2,.500,1,2,.500,0,0,,0,0,,1,3,4,0,0,2,1,5,2,0.2
12620,Darin Haugh\darin-haugh-1,2015-16,Minnesota,G,6,0,19,1,4,.250,1,2,.500,0,2,.000,0,0,,0,0,0,0,0,0,3,0,2,-0.6
12621,Matt Rosenwinkel\matt-rosenwinkel-1,2016-17,Northern Kentucky,G,5,1,10,1,2,.500,1,1,1.000,0,1,.000,0,0,,0,2,2,0,1,0,0,0,2,0.5
12622,Gabriel Dos Santos\gabriel-dos-santos-1,2014-15,Jacksonville State,G,2,0,9,1,2,.500,1,2,.500,0,0,,0,1,.000,0,1,1,2,0,0,2,0,2,0.2
12623,Phillip Coleman\phillip-coleman-1,2013-14,Troy,G,7,0,6,1,4,.250,1,3,.333,0,1,.000,0,0,,1,0,1,0,0,0,0,0,2,0.0
12624,Justin Brickman\justin-brickman-1,2016-17,Bryant,G,4,1,20,1,3,.333,1,3,.333,0,0,,0,0,,0,0,0,7,0,0,1,1,2,1.0
12625,Wade Morgan\wade-morgan-1,2014-15,Stanford,G,8,0,14,1,5,.200,1,3,.333,0,2,.000,0,0,,1,4,5,2,1,0,1,1,2,0.2
12626,Chris Rice\chris-rice-1,2013-14,Binghamton,G,11,0,35,1,5,.200,1,3,.333,0,2,.000,0,0,,0,0,0,2,0,0,5,2,2,-0.5
12627,Quincy Drye\quincy-drye-1,2013-14,High Point,G,5,0,16,1,6,.167,1,6,.167,0,0,,0,0,,0,2,2,0,0,0,1,1,2,-0.5
12628,Matt Ferris\matt-ferris-1,2014-15,Wisconsin,G,9,0,17,1,3,.333,1,2,.500,0,1,.000,0,0,,3,2,5,0,1,1,1,1,2,0.4
12629,Chris Jayne\chris-jayne-1,2014-15,Holy Cross,G,7,1,37,1,8,.125,1,4,.250,0,4,.000,0,2,.000,0,6,6,4,3,0,1,7,2,0.0
12630,William Ridgell\william-ridgell-1,2017-18,Arkansas-Pine Bluff,G,12,0,66,1,3,.333,1,3,.333,0,0,,0,0,,0,5,5,2,1,0,2,5,2,0.0
12631,Chance Garvin\chance-garvin-1,2017-18,Idaho,G,7,0,13,1,2,.500,1,2,.500,0,0,,0,0,,0,2,2,0,0,0,1,1,2,0.0
12632,Stephon Sharp\stephon-sharp-1,2016-17,Minnesota,G,9,0,16,0,0,,0,0,,0,0,,2,2,1.000,0,0,0,1,1,0,1,3,2,0.2
12633,Hank Davis\hank-davis-1,2013-14,La Salle,G,4,0,5,1,2,.500,1,2,.500,0,0,,0,1,.000,1,0,1,0,0,0,0,2,2,0.1
12634,Bryce Hughes\bryce-hughes-1,2017-18,Air Force,G,1,0,3,1,1,1.000,1,1,1.000,0,0,,0,0,,1,0,1,0,0,0,0,0,2,2.4
12635,Conroy Hunt\conroy-hunt-1,2017-18,Minnesota,G,2,0,3,1,2,.500,1,1,1.000,0,1,.000,0,0,,0,0,0,0,0,0,0,0,2,0.5
12636,Zach Flener\zach-flener-1,2017-18,Lipscomb,G,8,0,15,1,2,.500,1,2,.500,0,0,,0,0,,0,0,0,2,0,0,1,2,2,0.1
12637,Drew Crabtree\drew-crabtree-1,2013-14,Ohio,G,6,0,9,1,3,.333,1,2,.500,0,1,.000,0,0,,0,2,2,0,1,0,0,2,2,0.2
12638,Tor Watts\tor-watts-1,2013-14,Connecticut,G,9,0,13,1,4,.250,1,3,.333,0,1,.000,0,0,,0,2,2,0,2,0,0,2,2,0.2
12639,Tyler Warford\tyler-warford-1,2014-15,Youngstown State,G,4,0,8,1,2,.500,1,1,1.000,0,1,.000,0,2,.000,1,1,2,1,1,1,1,1,2,0.6
12640,Charles Carrington\charles-carrington-1,2016-17,North Carolina A&T,G,11,0,29,0,6,.000,0,6,.000,0,0,,2,2,1.000,3,3,6,0,0,2,3,12,2,-0.5
12641,C.J. Mitchell\cj-mitchell-1,2013-14,Oregon State,G,3,0,4,0,0,,0,0,,0,0,,2,2,1.000,0,0,0,0,0,0,0,0,2,0.7
12642,Justin Brent\justin-brent-1,2017-18,Nevada,G,3,0,5,1,1,1.000,1,1,1.000,0,0,,0,0,,0,0,0,0,1,0,0,2,2,0.6
12643,Andrew Calomeris\andrew-calomeris-1,2013-14,Indiana,G,4,0,5,1,2,.500,1,2,.500,0,0,,0,0,,0,0,0,0,0,0,0,2,2,0.1
12644,Christopher Miller\christopher-miller-1,2016-17,Grand Canyon,G,2,0,12,1,2,.500,1,1,1.000,0,1,.000,0,0,,0,1,1,1,0,0,0,1,2,0.8
12645,Thomas Collier\thomas-collier-1,2017-18,Auburn,G,5,0,10,1,2,.500,1,2,.500,0,0,,0,0,,0,2,2,0,0,0,1,3,2,-0.1
12646,Isaiah Juarez\isaiah-juarez-1,2014-15,Grand Canyon,G,6,0,7,1,2,.500,1,1,1.000,0,1,.000,0,0,,0,1,1,1,0,0,0,0,2,0.3
12647,Khyler Fields\khyler-fields-1,2014-15,Cleveland State,G,3,0,10,1,1,1.000,1,1,1.000,0,0,,0,0,,0,1,1,0,1,0,4,1,2,-0.5
12648,Tim Donohoe\tim-donohoe-1,2016-17,Stony Brook,G,6,0,9,1,1,1.000,1,1,1.000,0,0,,0,0,,1,0,1,0,1,0,1,0,2,0.4
12649,Houston Wahlen\houston-wahlen-1,2017-18,Idaho State,G,5,0,6,1,2,.500,1,2,.500,0,0,,0,0,,0,1,1,0,0,0,0,1,2,0.2
12650,Maleek Frazier\maleek-frazier-1,2014-15,Virginia,G,10,0,17,1,2,.500,1,2,.500,0,0,,0,1,.000,0,4,4,0,0,0,2,0,2,0.0
12651,Christian Willis\christian-willis-1,2017-18,Arkansas State,G,2,0,8,1,3,.333,1,2,.500,0,1,.000,0,0,,1,0,1,0,0,0,1,0,2,0.0
12652,Kyle Dobbins\kyle-dobbins-1,2014-15,Texas A&M,G,6,0,9,1,3,.333,1,2,.500,0,1,.000,0,0,,0,0,0,2,0,0,2,1,2,-0.1
12653,Jack Beach\jack-beach-1,2017-18,Gonzaga,G,15,0,39,0,9,.000,0,5,.000,0,4,.000,2,4,.500,1,3,4,2,3,0,0,2,2,0.0
12654,Joseff Smith\joseff-smith-1,2015-16,Alabama State,G,8,0,9,1,1,1.000,1,1,1.000,0,0,,0,0,,0,0,0,0,1,0,1,3,2,0.1
12655,Dylan Flood\dylan-flood-1,2013-14,Marquette,G,6,0,7,1,3,.333,1,2,.500,0,1,.000,0,0,,0,1,1,0,0,0,0,1,2,0.0
12656,Amir Hicks\amir-hicks-2,2017-18,Saint Peter's,G,3,0,4,1,1,1.000,1,1,1.000,0,0,,0,0,,0,0,0,0,0,0,1,0,2,0.2
12657,Chase Cobb\chase-cobb-1,2017-18,Abilene Christian,G,6,0,22,1,9,.111,1,2,.500,0,7,.000,0,0,,1,1,2,4,1,0,4,3,2,-0.7
12658,Spenser Dalton\spenser-dalton-1,2015-16,North Carolina,G,18,1,21,1,9,.111,1,2,.500,0,7,.000,0,0,,1,1,2,0,0,0,1,1,2,-0.2
12659,Riley McGillan\riley-mcgillan-1,2016-17,Clemson,G,6,0,15,1,5,.200,1,1,1.000,0,4,.000,0,0,,0,0,0,1,1,0,1,1,2,-0.1
12660,Khiorie Stewart\khiorie-stewart-1,2016-17,Stephen F. Austin,G,7,0,15,1,2,.500,1,1,1.000,0,1,.000,0,0,,0,1,1,0,1,0,0,0,2,0.3
12661,Austin Witherill\austin-witherill-1,2016-17,Arizona State,G,16,0,25,0,4,.000,0,0,,0,4,.000,2,2,1.000,0,2,2,1,0,0,0,0,2,0.0
12662,Anfernee Brown\anfernee-brown-1,2013-14,Purdue,G,5,0,9,1,4,.250,1,2,.500,0,2,.000,0,0,,0,2,2,2,0,0,0,0,2,0.3
12663,Dylan Ennis\dylan-ennis-1,2015-16,Oregon,G,3,0,21,1,4,.250,1,2,.500,0,2,.000,0,0,,1,2,3,2,0,0,2,0,2,0.1
12664,Dylan Greene\dylan-greene-1,2014-15,Lipscomb,G,8,0,21,0,2,.000,0,0,,0,2,.000,2,4,.500,1,1,2,2,0,0,1,3,2,0.0
12665,Seth Dittmer\seth-dittmer-1,2017-18,Milwaukee,G,7,0,12,0,0,,0,0,,0,0,,2,2,1.000,2,3,5,0,0,0,0,1,2,0.6
12666,Tyler Ailshie\tyler-ailshie-1,2013-14,East Tennessee State,G,2,0,4,1,1,1.000,1,1,1.000,0,0,,0,0,,0,0,0,0,1,0,0,0,2,1.4
12667,Ryan Parilla\ryan-parilla-1,2017-18,San Jose State,G,5,0,39,1,5,.200,1,5,.200,0,0,,0,1,.000,1,2,3,6,1,0,2,5,2,0.2
12668,Jonathan Holmes\jonathan-holmes-3,2016-17,Arkansas,G,6,0,7,1,5,.200,1,1,1.000,0,4,.000,0,0,,0,1,1,0,0,0,0,1,2,-0.2
12669,Jason Braden\jason-braden-1,2015-16,Pacific,G,4,0,11,1,2,.500,1,2,.500,0,0,,0,2,.000,2,0,2,4,0,0,0,3,2,0.8
12670,Jeremiah Tate\jeremiah-tate-1,2013-14,Wofford,G,10,0,28,1,4,.250,1,4,.250,0,0,,0,6,.000,2,1,3,3,0,1,3,5,2,-0.3
12671,John Whitley\john-whitley-1,2017-18,East Carolina,G,3,0,7,1,1,1.000,1,1,1.000,0,0,,0,0,,0,1,1,1,0,0,0,0,2,0.9
12672,K.J. Bates\kj-bates-1,2014-15,Chattanooga,G,6,0,24,1,6,.167,1,4,.250,0,2,.000,0,0,,0,6,6,2,2,0,3,2,2,-0.1
12673,Jacoby Green\jacoby-green-1,2016-17,Prairie View,G,3,0,12,0,1,.000,0,0,,0,1,.000,2,4,.500,0,0,0,0,0,0,0,2,2,-0.1
12674,Cameron Neysmith\cameron-neysmith-1,2014-15,Kennesaw State,G,6,0,10,1,3,.333,1,2,.500,0,1,.000,0,0,,1,2,3,0,0,0,0,2,2,0.1
12675,Mike Wells\mike-wells-2,2014-15,Albany (NY),G,7,0,10,1,2,.500,1,2,.500,0,0,,0,0,,0,0,0,0,0,0,0,1,2,0.1
12676,Matt Kennedy\matt-kennedy-2,2017-18,Villanova,G,12,0,16,1,1,1.000,1,1,1.000,0,0,,0,0,,0,3,3,0,0,1,0,1,2,0.2
12677,Dalton Cesarz\dalton-cesarz-1,2014-15,Saint Francis (PA),G,3,0,6,1,1,1.000,1,1,1.000,0,0,,0,0,,0,0,0,1,0,0,0,1,2,0.7
12678,Cal Freundlich\cal-freundlich-1,2017-18,Davidson,G,11,0,16,0,2,.000,0,0,,0,2,.000,2,4,.500,0,4,4,0,1,0,0,1,2,0.1
12679,Devon Williams\devon-williams-1,2013-14,New Mexico,G,5,0,8,1,1,1.000,1,1,1.000,0,0,,0,0,,1,1,2,1,0,0,1,6,2,0.0
12680,Ryan Strollo\ryan-strollo-1,2016-17,Youngstown State,G,7,0,23,1,1,1.000,1,1,1.000,0,0,,0,0,,0,1,1,2,1,1,1,1,2,0.5
12681,Stephen Walker\stephen-walker-1,2014-15,Prairie View,G,7,0,26,1,2,.500,1,2,.500,0,0,,0,0,,0,2,2,2,3,0,1,1,2,0.7
12682,Britton Anderson\britton-anderson-1,2017-18,Wake Forest,G,7,1,8,0,4,.000,0,3,.000,0,1,.000,2,2,1.000,0,4,4,0,0,1,0,1,2,0.1
12683,Tyree Chambers\tyree-chambers-1,2015-16,Providence,G,11,0,24,1,2,.500,1,1,1.000,0,1,.000,0,0,,0,3,3,4,2,0,3,5,2,0.2
12684,Jake Dadika\jake-dadika-1,2016-17,Rutgers,G,10,0,52,1,3,.333,1,2,.500,0,1,.000,0,0,,0,2,2,5,2,0,4,1,2,0.2
12685,Tommy Papas\tommy-papas-1,2017-18,William & Mary,G,3,0,9,1,3,.333,1,2,.500,0,1,.000,0,0,,0,0,0,2,0,0,0,1,2,0.4
12686,Conrad Jenne\conrad-jenne-1,2014-15,Virginia Military Institute,G,1,0,9,1,5,.200,1,1,1.000,0,4,.000,0,2,.000,0,1,1,0,2,0,0,1,2,0.0
12687,D.J. Suter\dj-suter-1,2015-16,Georgia Southern,G,2,0,5,1,2,.500,1,1,1.000,0,1,.000,0,0,,0,0,0,0,0,0,0,0,2,0.5
12688,Chris Corchiani\chris-corchiani-2,2015-16,North Carolina State,G,2,0,2,1,1,1.000,1,1,1.000,0,0,,0,0,,0,0,0,0,0,0,0,0,2,0.9
12689,Jonathan Thomas\justin-thomas-3,2015-16,Jackson State,G,11,0,20,1,1,1.000,1,1,1.000,0,0,,0,0,,0,0,0,0,0,0,0,6,2,-0.1
12690,Jack Beach\jack-beach-1,2015-16,Gonzaga,G,13,0,20,1,4,.250,1,2,.500,0,2,.000,0,0,,1,1,2,1,1,0,0,1,2,0.1
12691,Brandon Lawrence\brandon-lawrence-1,2016-17,St. John's (NY),G,2,0,2,1,1,1.000,1,1,1.000,0,0,,0,0,,0,0,0,0,0,0,0,0,2,0.9
12692,Matt Massimino\matt-massimino-1,2013-14,Fordham,G,3,0,7,1,1,1.000,1,1,1.000,0,0,,0,0,,0,0,0,0,0,0,0,0,2,0.6
12693,Kevin Montminy\kevin-montminy-1,2013-14,Penn State,G,8,0,14,1,1,1.000,1,1,1.000,0,0,,0,0,,1,0,1,0,0,0,0,2,2,0.2
12694,Caleb Davis\caleb-davis-1,2016-17,Duquesne,G,1,0,3,1,3,.333,1,2,.500,0,1,.000,0,0,,0,0,0,0,0,0,1,0,2,-0.7
12695,Harrison Brown\harrison-brown-2,2015-16,Rice,G,6,0,5,1,3,.333,1,3,.333,0,0,,0,0,,1,1,2,0,0,0,0,0,2,0.2
12696,Tyler Tafoya\tyler-tafoya-1,2013-14,Texas-El Paso,G,3,0,3,0,1,.000,0,0,,0,1,.000,2,2,1.000,0,0,0,0,0,0,0,0,2,0.4
12697,Emanuel Binyam\emanuel-binyam-1,2013-14,Quinnipiac,G,8,0,8,0,2,.000,0,0,,0,2,.000,2,4,.500,0,1,1,0,0,0,0,0,2,0.0
12698,Jacob Herrs\jacob-herrs-1,2017-18,Wichita State,G,3,0,8,1,1,1.000,1,1,1.000,0,0,,0,0,,0,1,1,1,0,0,0,1,2,0.8
12699,Aitor Zubizarreta\aitor-zubizarreta-1,2013-14,Portland,G,7,0,21,0,1,.000,0,0,,0,1,.000,2,2,1.000,0,2,2,2,1,0,6,3,2,-0.4
12700,Josh Pollard\josh-pollard-1,2014-15,Kansas,G,7,0,13,1,4,.250,1,4,.250,0,0,,0,0,,1,1,2,1,1,0,1,2,2,0.1
12701,Richard Brown\richard-brown-2,2014-15,Army,G,11,0,56,1,4,.250,1,2,.500,0,2,.000,0,0,,5,6,11,4,1,0,2,4,2,0.5
12702,Justin Williams\justin-williams-4,2016-17,George Washington,G,7,0,33,0,6,.000,0,3,.000,0,3,.000,2,2,1.000,2,5,7,0,1,1,2,1,2,0.0
12703,Tyrell Mason\tyrell-mason-1,2014-15,Virginia Military Institute,G,7,0,27,1,6,.167,1,4,.250,0,2,.000,0,0,,5,6,11,1,2,0,2,4,2,0.4
12704,Ausar Madison\ausar-madison-1,2015-16,Howard,G,8,0,41,0,4,.000,0,2,.000,0,2,.000,2,2,1.000,0,1,1,4,1,0,3,4,2,-0.2
12705,Isaac Fields\isaac-fields-1,2016-17,Clemson,G,3,0,6,1,2,.500,1,1,1.000,0,1,.000,0,0,,0,0,0,0,0,0,0,0,2,0.3
12706,Frank Dounis\frank-dounis-1,2013-14,Illinois-Chicago,G,5,0,12,0,0,,0,0,,0,0,,2,2,1.000,1,0,1,0,0,0,1,1,2,0.3
12707,Cole Currie\cole-currie-1,2013-14,Tulane,G,14,0,24,0,7,.000,0,4,.000,0,3,.000,2,2,1.000,0,2,2,1,1,0,4,2,2,-0.4
12708,Rodney Herenton\rodney-herenton-1,2016-17,Stanford,G,5,0,5,1,4,.250,1,3,.333,0,1,.000,0,2,.000,0,0,0,0,0,0,2,0,2,-0.6
12709,Quentin Taylor\quentin-taylor-1,2016-17,Indiana,G,6,0,10,1,1,1.000,1,1,1.000,0,0,,0,0,,1,1,2,0,1,0,4,2,2,-0.2
12710,Ryan Maas\ryan-maas-1,2016-17,Western Illinois,G,4,0,16,1,5,.200,1,4,.250,0,1,.000,0,0,,0,1,1,0,1,0,2,1,2,-0.6
12711,Matt Hanessian\matt-hanessian-1,2014-15,Pennsylvania,G,6,0,18,1,2,.500,1,2,.500,0,0,,0,0,,2,3,5,0,0,0,5,4,2,-0.6
12712,Jimmy Panzini\jimmy-panzini-1,2016-17,Lafayette,G,10,0,13,1,1,1.000,1,1,1.000,0,0,,0,0,,0,0,0,0,1,0,2,2,2,0.0
12713,T.K. Hayes\tk-hayes-1,2015-16,Furman,G,8,0,17,1,5,.200,1,2,.500,0,3,.000,0,0,,0,2,2,0,1,0,1,0,2,-0.1
12714,Rusty Reigel\rusty-reigel-1,2014-15,Davidson,G,12,0,26,1,5,.200,1,2,.500,0,3,.000,0,0,,1,2,3,2,0,0,2,3,2,-0.1
12715,Brian Herring\brian-herring-1,2014-15,Texas State,G,5,0,14,1,6,.167,1,2,.500,0,4,.000,0,1,.000,0,0,0,1,1,0,0,1,2,-0.2
12716,Mike Wilson\mike-wilson-4,2013-14,Siena,G,10,0,10,1,2,.500,1,1,1.000,0,1,.000,0,0,,1,0,1,0,0,0,1,1,2,0.0
12717,Tyler Sharpe\tyler-sharpe-1,2016-17,Louisville,G,7,0,11,1,8,.125,1,2,.500,0,6,.000,0,0,,1,2,3,1,0,0,1,1,2,-0.4
12718,Brady Rudrud\brady-rudrud-1,2017-18,Minnesota,G,6,0,14,1,3,.333,1,1,1.000,0,2,.000,0,0,,0,2,2,1,0,0,3,1,2,-0.3
12719,Danny Mahoney\danny-mahoney-1,2015-16,San Jose State,G,3,0,18,1,6,.167,1,3,.333,0,3,.000,0,0,,0,3,3,4,2,0,1,2,2,0.7
12720,Patrick Triplett\patrick-triplett-1,2017-18,Brown,G,1,0,4,0,1,.000,0,0,,0,1,.000,2,2,1.000,0,1,1,1,0,0,1,1,2,0.9
12721,Markos Psimitis\markos-psimitis-1,2016-17,Saint Louis,G,8,0,11,0,2,.000,0,1,.000,0,1,.000,2,4,.500,2,0,2,0,0,0,0,1,2,0.1
12722,David Haus\david-haus-1,2014-15,Duquesne,G,11,0,28,1,4,.250,1,3,.333,0,1,.000,0,0,,4,1,5,2,0,0,0,3,2,0.3
12723,Jordan Howard\jordan-howard-1,2013-14,Troy,G,6,0,10,1,3,.333,1,2,.500,0,1,.000,0,0,,0,1,1,0,1,0,1,0,2,0.1
12724,Riyan Williams\riyan-williams-1,2014-15,Georgetown,G,8,0,10,0,3,.000,0,2,.000,0,1,.000,2,2,1.000,2,1,3,0,0,1,0,1,2,0.2
12725,Daniel Parke\daniel-parke-1,2016-17,Eastern Kentucky,G,9,0,20,0,3,.000,0,1,.000,0,2,.000,2,4,.500,3,0,3,0,1,0,0,4,2,0.1
12726,Nick Pagliuca\nick-pagliuca-1,2013-14,Duke,G,3,0,5,0,1,.000,0,1,.000,0,0,,1,2,.500,1,1,2,0,0,0,0,0,1,0.3
12727,Jake Dadika\jake-dadika-1,2014-15,Rutgers,G,7,0,39,0,6,.000,0,4,.000,0,2,.000,1,2,.500,0,1,1,1,1,0,3,4,1,-0.9
12728,Sky Williams\sky-williams-1,2016-17,Manhattan,G,1,0,1,0,0,,0,0,,0,0,,1,2,.500,0,0,0,0,0,0,0,0,1,0.6
12729,Manu Giamoukis\manu-giamoukis-1,2015-16,Davidson,G,5,0,8,0,1,.000,0,1,.000,0,0,,1,2,.500,0,1,1,0,1,0,2,1,1,-0.2
12730,Marcus Reed\marcus-reed-2,2017-18,Marshall,G,3,0,9,0,2,.000,0,0,,0,2,.000,1,2,.500,1,3,4,3,0,0,0,1,1,0.8
12731,Blake Johnson\blake-johnson-1,2013-14,Middle Tennessee,G,4,0,6,0,2,.000,0,1,.000,0,1,.000,1,2,.500,0,0,0,1,0,0,0,2,1,-0.2
12732,Jamani Spencer\jamani-spencer-1,2015-16,Pepperdine,G,1,0,16,0,2,.000,0,2,.000,0,0,,1,4,.250,1,2,3,2,0,0,2,1,1,-1.3
12733,Charlie Byers\charlie-byers-1,2014-15,Kennesaw State,G,5,0,8,0,0,,0,0,,0,0,,1,2,.500,0,1,1,1,2,0,0,1,1,0.6
12734,Wade Morgan\wade-morgan-1,2013-14,Stanford,G,8,0,13,0,2,.000,0,0,,0,2,.000,1,4,.250,0,3,3,1,2,0,0,0,1,0.3
12735,Josh Humphrey\josh-humphrey-2,2014-15,Green Bay,G,14,1,41,0,4,.000,0,4,.000,0,0,,1,3,.333,1,4,5,3,0,2,2,7,1,-0.1
12736,Jeremiah Taylor\jeremiah-taylor-1,2016-17,Louisiana Tech,G,14,0,36,0,4,.000,0,1,.000,0,3,.000,1,2,.500,2,2,4,1,1,0,1,6,1,-0.1
12737,Chase Driscoll\chase-driscoll-1,2016-17,North Florida,G,8,0,15,0,3,.000,0,1,.000,0,2,.000,1,3,.333,0,1,1,0,0,0,2,0,1,-0.5
12738,Joel Swallow\joel-swallow-1,2016-17,Southern Utah,G,3,0,7,0,0,,0,0,,0,0,,1,4,.250,0,2,2,0,0,0,0,0,1,0.1
12739,Jamal Mitchell\jamal-mitchell-1,2013-14,North Carolina-Greensboro,G,5,0,11,0,1,.000,0,0,,0,1,.000,1,2,.500,0,0,0,0,1,0,0,2,1,0.0
12740,Ashanti Burgess\ashanti-burgess-1,2015-16,Xavier,G,3,0,7,0,1,.000,0,1,.000,0,0,,1,2,.500,0,0,0,0,0,0,1,0,1,-0.4
12741,Stephen Prendergast\stephen-prendergast-1,2015-16,Wake Forest,G,8,1,13,0,4,.000,0,3,.000,0,1,.000,1,2,.500,0,0,0,0,1,0,2,0,1,-0.4
12742,Nolan Hart\nolan-hart-1,2013-14,Syracuse,G,4,0,4,0,3,.000,0,0,,0,3,.000,1,2,.500,1,1,2,1,0,0,0,0,1,0.1
12743,Ra'Mond Hines\ramond-hines-1,2016-17,Georgetown,G,5,0,7,0,1,.000,0,0,,0,1,.000,1,2,.500,0,0,0,1,0,0,1,0,1,-0.1
12744,Joe Schwartz\joe-schwartz-1,2015-16,Texas,G,2,0,3,0,2,.000,0,1,.000,0,1,.000,1,3,.333,0,1,1,0,0,0,0,0,1,-0.5
12745,Connor Fulton\connor-fulton-1,2017-18,Ohio State,G,4,0,9,0,2,.000,0,0,,0,2,.000,1,2,.500,0,1,1,0,0,0,1,0,1,-0.4
12746,Jalen Manumaleuga\jalen-manumaleuga-1,2015-16,Jackson State,G,5,0,22,0,3,.000,0,2,.000,0,1,.000,1,4,.250,1,4,5,1,0,1,1,2,1,-0.2
12747,London Dokubo\london-dokubo-1,2013-14,Loyola (IL),G,28,0,155,0,5,.000,0,3,.000,0,2,.000,1,3,.333,2,7,9,11,6,0,6,15,1,0.1
12748,Shawn Meyer\shawn-meyer-1,2014-15,Kansas State,G,9,0,11,0,2,.000,0,2,.000,0,0,,1,3,.333,0,1,1,1,1,0,0,2,1,0.0
12749,Mike Robinson\mike-robinson-4,2016-17,Miami (FL),G,9,0,20,0,5,.000,0,1,.000,0,4,.000,1,2,.500,1,0,1,0,1,0,1,2,1,-0.3
12750,Sam Harris\sam-harris-2,2016-17,St. Francis (NY),G,12,0,12,0,1,.000,0,0,,0,1,.000,1,2,.500,1,1,2,0,1,0,0,3,1,0.1
12751,Cayne Edwards\cayne-edwards-1,2016-17,Army,G,4,0,10,0,3,.000,0,2,.000,0,1,.000,1,2,.500,1,6,7,0,1,0,1,2,1,0.1
12752,Jackson Johnson\jackson-johnson-1,2017-18,Tulane,G,3,0,4,0,0,,0,0,,0,0,,1,2,.500,0,2,2,0,0,0,0,0,1,0.4
12753,Kendall Smith\kendall-smith-2,2014-15,Nevada-Las Vegas,G,2,0,14,0,1,.000,0,1,.000,0,0,,1,2,.500,0,1,1,0,0,0,3,0,1,-1.4
12754,Adam Mitola\adam-mitola-1,2017-18,George Washington,G,13,0,34,0,8,.000,0,1,.000,0,7,.000,1,2,.500,1,4,5,3,1,0,1,3,1,-0.2
12755,Rashad Andrews\rashad-andrews-1,2014-15,Southern,G,4,0,10,0,2,.000,0,0,,0,2,.000,1,3,.333,1,2,3,1,0,0,4,2,1,-1.0
12756,Charles Webb\charles-webb-1,2013-14,Denver,G,6,0,7,0,6,.000,0,6,.000,0,0,,1,2,.500,2,1,3,0,0,0,0,4,1,-0.6
12757,Isaiah Rice\isaiah-rice-1,2017-18,Vanderbilt,G,2,0,6,0,2,.000,0,0,,0,2,.000,1,2,.500,0,0,0,0,0,0,2,1,1,-1.6
12758,Justin Coleman\justin-coleman-3,2014-15,North Carolina,G,10,0,19,0,6,.000,0,2,.000,0,4,.000,1,2,.500,1,2,3,3,0,0,1,1,1,-0.2
12759,Paddy Quinn\paddy-quinn-1,2014-15,Columbia,G,8,0,19,0,1,.000,0,0,,0,1,.000,1,2,.500,2,1,3,1,0,0,0,4,1,0.1
12760,Johnny Trueblood\johnny-trueblood-1,2017-18,Nebraska,G,7,0,11,0,2,.000,0,2,.000,0,0,,1,4,.250,0,3,3,1,0,0,3,1,1,-0.5
12761,Adam Giles\adam-giles-1,2017-18,Wright State,G,7,1,17,0,0,,0,0,,0,0,,1,2,.500,2,1,3,1,2,0,1,1,1,0.5
12762,Greg White-Pittman\greg-white-pittman-1,2016-17,North Texas,G,2,0,11,0,0,,0,0,,0,0,,1,2,.500,0,0,0,0,0,0,0,1,1,0.1
12763,Mason Schoen\mason-schoen-1,2015-16,Kansas State,G,9,0,10,0,4,.000,0,2,.000,0,2,.000,1,2,.500,1,0,1,1,0,0,0,0,1,-0.1
12764,Malcolm Laws\malcolm-laws-1,2015-16,Nebraska,G,6,0,24,0,3,.000,0,2,.000,0,1,.000,1,2,.500,0,2,2,0,1,0,0,4,1,-0.3
12765,Tanner Beachnau\tanner-beachnau-1,2014-15,Central Michigan,G,6,0,13,0,4,.000,0,2,.000,0,2,.000,1,2,.500,0,0,0,3,2,0,1,0,1,0.2
12766,Ayinde Sprewell\ayinde-sprewell-1,2014-15,Western Kentucky,G,3,0,23,0,5,.000,0,5,.000,0,0,,1,2,.500,2,3,5,0,1,0,3,2,1,-1.1
12767,Rem Bakamus\rem-bakamus-1,2016-17,Gonzaga,G,17,1,29,0,4,.000,0,0,,0,4,.000,1,1,1.000,1,3,4,2,0,0,2,5,1,-0.2
12768,Sam Malone\sam-malone-1,2014-15,Kentucky,G,8,1,11,0,1,.000,0,1,.000,0,0,,1,2,.500,1,2,3,0,0,0,1,0,1,0.0
12769,Tide Osifeso\tide-osifeso-1,2015-16,UC-Santa Barbara,G,4,0,8,0,1,.000,0,0,,0,1,.000,1,5,.200,0,1,1,0,2,0,3,2,1,-0.7
12770,Tim Whelan\tim-whelan-1,2013-14,Xavier,G,5,0,5,0,0,,0,0,,0,0,,1,2,.500,0,0,0,0,0,0,1,1,1,-0.2
12771,Lance Brown\lance-brown-4,2014-15,Campbell,G,3,0,19,0,5,.000,0,3,.000,0,2,.000,1,2,.500,3,0,3,2,2,0,3,2,1,-0.4
12772,Mehran Nazarian\mehran-nazarian-1,2016-17,Cal State Northridge,G,3,0,5,0,1,.000,0,0,,0,1,.000,1,2,.500,0,0,0,0,0,0,1,0,1,-0.4
12773,Cameron Carmical\cameron-carmical-1,2017-18,Eastern Kentucky,G,14,1,63,0,6,.000,0,1,.000,0,5,.000,1,2,.500,0,4,4,8,1,0,5,8,1,-0.3
12774,Pat Smith\pat-smith-1,2015-16,Cornell,G,1,0,13,0,3,.000,0,0,,0,3,.000,1,2,.500,0,0,0,1,0,0,0,1,1,-1.2
12775,Aleksa Nikolic\aleksa-nikolic-1,2015-16,Marshall,G,2,1,22,0,6,.000,0,5,.000,0,1,.000,1,2,.500,0,2,2,1,1,0,4,6,1,-3.9
12776,Chris Jayne\chris-jayne-1,2013-14,Holy Cross,G,7,0,7,0,0,,0,0,,0,0,,1,2,.500,0,2,2,0,0,0,0,1,1,0.1
12777,Kyle Thompson\kyle-thompson-1,2016-17,Saint Joseph's,G,6,0,12,0,2,.000,0,2,.000,0,0,,1,4,.250,1,2,3,1,0,0,2,0,1,-0.3
12778,Hunter Sadlon\hunter-sadlon-1,2013-14,Winthrop,G,7,0,10,0,2,.000,0,1,.000,0,1,.000,1,2,.500,0,2,2,2,0,0,0,2,1,0.1
12779,Charlie Inclan\charlie-inclan-1,2013-14,Presbyterian,G,2,0,4,0,0,,0,0,,0,0,,1,2,.500,0,1,1,1,0,0,1,0,1,0.3
12780,Seve Stavroff\seve-stavroff-1,2017-18,Furman,G,12,0,29,0,7,.000,0,3,.000,0,4,.000,1,2,.500,1,3,4,0,1,0,1,1,1,-0.3
12781,Mitch McLaughlin\mitch-mclaughlin-1,2013-14,Drake,G,13,0,13,0,1,.000,0,1,.000,0,0,,1,2,.500,0,1,1,1,2,0,2,1,1,0.0
12782,Cam Marotta\cam-marotta-1,2015-16,Marquette,G,3,0,8,0,2,.000,0,1,.000,0,1,.000,1,2,.500,0,0,0,0,0,0,0,0,1,-0.3
12783,Marlon Daniel\marlon-daniel-1,2016-17,Savannah State,G,15,0,30,0,6,.000,0,1,.000,0,5,.000,1,3,.333,3,3,6,1,0,0,4,1,1,-0.3
12784,Joel Engulu\joel-engulu-1,2014-15,Texas A&M-Corpus Christi,G,1,0,3,0,1,.000,0,1,.000,0,0,,1,2,.500,0,1,1,0,0,0,1,1,1,-1.2
12785,Mitch Schafer\mitch-scafer-1,2016-17,San Diego,G,7,0,9,0,1,.000,0,0,,0,1,.000,1,2,.500,0,0,0,1,0,0,0,0,1,0.1
12786,Alex Allbery\alex-allbery-1,2015-16,Omaha,G,7,0,28,0,3,.000,0,1,.000,0,2,.000,1,2,.500,0,2,2,2,0,0,4,5,1,-0.8
12787,Trey Miller\trey-miller-1,2015-16,North Dakota State,G,3,0,5,0,0,,0,0,,0,0,,1,2,.500,0,1,1,0,1,0,0,0,1,0.6
12788,EJ Floreal\ej-floreal-1,2014-15,Kentucky,G,13,0,20,0,1,.000,0,1,.000,0,0,,1,2,.500,0,1,1,0,1,0,4,2,1,-0.3
12789,Tyler Scott\tyler-scott-1,2013-14,Kent State,G,5,0,8,0,2,.000,0,2,.000,0,0,,1,2,.500,2,0,2,1,1,0,0,2,1,0.3
12790,Chris Wise\christian-wise-1,2015-16,Florida A&M,G,10,0,15,0,6,.000,0,2,.000,0,4,.000,1,2,.500,0,1,1,0,1,0,2,4,1,-0.6
12791,Cameron Neysmith\cameron-neysmith-1,2016-17,Kennesaw State,G,1,0,1,0,0,,0,0,,0,0,,1,2,.500,0,1,1,0,0,0,1,0,1,-0.1
12792,Isaiah Washington\isaiah-washington-1,2014-15,Penn State,G,1,0,3,0,0,,0,0,,0,0,,1,2,.500,0,0,0,0,0,0,0,0,1,0.6
12793,Brandon Young\brandon-young-2,2015-16,Georgia,G,5,0,7,0,2,.000,0,2,.000,0,0,,1,2,.500,0,0,0,1,0,0,2,1,1,-0.5
12794,Henry Beard\henry-beard-1,2017-18,South Florida,G,17,0,33,0,4,.000,0,4,.000,0,0,,1,2,.500,0,3,3,2,1,0,1,4,1,-0.1
12795,Sean Locke\sean-locke-1,2013-14,Delaware,G,7,0,8,0,3,.000,0,0,,0,3,.000,1,2,.500,0,0,0,0,0,0,0,0,1,-0.2
12796,Austin Eastman\austin-eastman-1,2013-14,Utah,G,3,0,5,0,1,.000,0,0,,0,1,.000,1,2,.500,0,1,1,0,0,0,0,0,1,0.1
12797,Thomas Nolan\thomas-nolan-1,2017-18,Fairfield,G,9,0,10,0,4,.000,0,1,.000,0,3,.000,1,2,.500,0,0,0,0,0,0,0,1,1,-0.3
12798,Hunter Sadlon\hunter-sadlon-1,2016-17,Winthrop,G,13,1,25,0,2,.000,0,1,.000,0,1,.000,1,2,.500,1,4,5,1,0,0,0,1,1,0.1
12799,Koko Kurdoghlian\koko-kurdoghlian-1,2016-17,University of California,G,5,0,9,0,1,.000,0,1,.000,0,0,,1,2,.500,0,0,0,0,0,0,0,1,1,-0.1
12800,Don Thomas\don-thomas-1,2013-14,Texas A&M,G,8,0,9,0,3,.000,0,0,,0,3,.000,1,2,.500,0,1,1,0,0,0,2,0,1,-0.4
12801,Peter Barba\peter-barba-1,2015-16,Columbia,G,4,0,5,0,4,.000,0,0,,0,4,.000,1,2,.500,0,1,1,0,0,0,0,0,1,-0.5
12802,Adam Pike\adam-pike-1,2015-16,Austin Peay,G,6,0,7,0,2,.000,0,2,.000,0,0,,1,2,.500,2,0,2,0,0,0,0,1,1,0.0
12803,Enrico Bueno\enrico-bueno-1,2013-14,Colorado State,G,7,0,16,0,3,.000,0,0,,0,3,.000,1,4,.250,0,0,0,1,1,1,1,3,1,-0.3
12804,Tommy Luce\tommy-luce-1,2016-17,Purdue,G,15,0,25,0,5,.000,0,4,.000,0,1,.000,1,3,.333,0,0,0,4,1,0,6,3,1,-0.4
12805,Devin Epps\devin-epps-1,2017-18,South Alabama,G,9,1,17,0,4,.000,0,2,.000,0,2,.000,1,2,.500,1,0,1,1,3,0,1,0,1,0.1
12806,Matthew Jiles\matthew-jiles-1,2014-15,New Orleans,G,10,0,30,0,7,.000,0,4,.000,0,3,.000,1,2,.500,1,3,4,4,1,0,2,1,1,-0.1
12807,Devontae Williams\devontae-williams-1,2017-18,Auburn,G,8,0,11,0,1,.000,0,1,.000,0,0,,1,2,.500,0,1,1,1,0,0,2,1,1,-0.2
12808,Talbott Denny\talbott-denny-1,2017-18,Arizona,G,3,0,6,0,0,,0,0,,0,0,,1,2,.500,0,0,0,0,0,0,1,1,1,-0.3
12809,Alex Sokol\alex-sokol-1,2017-18,Cal State Northridge,G,7,0,12,0,4,.000,0,1,.000,0,3,.000,1,2,.500,0,0,0,1,0,0,1,2,1,-0.5
12810,Aaron Spivey\aaron-spivey-1,2016-17,Wake Forest,G,2,0,2,0,0,,0,0,,0,0,,1,2,.500,0,1,1,0,0,0,0,0,1,0.5
12811,Darryl Geyen\darryl-geyen-1,2015-16,Cal State Bakersfield,G,9,0,16,0,3,.000,0,1,.000,0,2,.000,1,2,.500,1,2,3,0,0,0,0,0,1,0.0
12812,Jimmy Paige\jimmy-paige-1,2015-16,Siena,G,10,0,22,0,2,.000,0,1,.000,0,1,.000,1,2,.500,0,0,0,1,0,1,1,2,1,-0.1
12813,Joshua White\joshua-white-1,2013-14,South Dakota State,G,11,0,25,0,7,.000,0,3,.000,0,4,.000,1,3,.333,1,7,8,2,2,0,5,2,1,-0.4
12814,Parker Dale\parker-dale-1,2017-18,Grand Canyon,G,3,0,4,0,1,.000,0,1,.000,0,0,,1,2,.500,1,0,1,0,0,0,1,1,1,-0.3
12815,Cory Dolins\cory-dolins-1,2013-14,DePaul,G,3,0,5,0,1,.000,0,1,.000,0,0,,1,2,.500,0,1,1,0,0,0,0,1,1,-0.1
12816,Curtis Lochner\curtis-lochner-1,2015-16,Delaware,G,13,0,24,0,4,.000,0,2,.000,0,2,.000,1,2,.500,1,1,2,1,1,0,0,2,1,0.0
12817,Austin Hatch\austin-hatch-1,2014-15,Michigan,G,5,0,5,0,2,.000,0,0,,0,2,.000,1,3,.333,0,0,0,0,0,0,1,0,1,-0.4
12818,Torey Burston\torey-burston-1,2013-14,Virginia Commonwealth,G,16,0,18,0,6,.000,0,6,.000,0,0,,1,4,.250,1,1,2,1,0,0,1,4,1,-0.3
12819,Jacob Gross\jacob-gross-1,2015-16,North Texas,G,11,0,13,0,3,.000,0,2,.000,0,1,.000,1,3,.333,1,1,2,0,1,0,0,2,1,-0.1
12820,Myles McGregor\myles-mcgregor-1,2016-17,Presbyterian,G,2,0,2,0,1,.000,0,1,.000,0,0,,1,2,.500,0,1,1,0,0,0,0,0,1,0.1
12821,Jacob Kessler\jacob-kessler-1,2014-15,Army,G,4,0,15,0,2,.000,0,1,.000,0,1,.000,1,2,.500,2,3,5,2,0,0,1,2,1,0.3
12822,Aubrey Williams\aubrey-williams-1,2013-14,UCLA,G,11,0,14,0,2,.000,0,2,.000,0,0,,1,2,.500,0,1,1,0,1,0,0,1,1,0.0
12823,Angel Aparicio\angel-aparicio-1,2014-15,Toledo,G,11,0,15,0,4,.000,0,3,.000,0,1,.000,1,2,.500,1,3,4,2,0,0,1,0,1,0.0
12824,Elijah Staley\elijah-staley-1,2015-16,Mississippi State,G,2,0,8,0,1,.000,0,1,.000,0,0,,1,2,.500,0,1,1,0,1,0,1,1,1,-0.1
12825,Will McQuitter\will-mcquitters-1,2014-15,Houston Baptist,G,2,0,7,0,1,.000,0,1,.000,0,0,,1,2,.500,0,2,2,1,1,0,1,1,1,0.4
12826,David Allen\david-allen-1,2014-15,Georgetown,G,10,0,20,0,2,.000,0,0,,0,2,.000,1,3,.333,0,1,1,0,1,0,1,2,1,-0.2
12827,Kyle Thompson\kyle-thompson-1,2015-16,Saint Joseph's,G,7,0,10,0,1,.000,0,0,,0,1,.000,1,2,.500,0,5,5,1,0,0,0,3,1,0.1
12828,Mike Peltz\mike-peltz-1,2013-14,Nebraska,G,11,0,54,0,4,.000,0,4,.000,0,0,,1,2,.500,3,6,9,1,1,0,1,10,1,-0.1
12829,Nick Mora\nick-mora-1,2016-17,Texas-Rio Grande Valley,G,8,0,14,0,1,.000,0,1,.000,0,0,,1,4,.250,1,3,4,1,0,0,2,2,1,-0.2
12830,Bobby Mannie\bobby-mannie-1,2015-16,Southern Illinois,G,6,0,12,0,1,.000,0,0,,0,1,.000,1,2,.500,1,0,1,0,0,0,0,2,1,0.0
12831,Curtis Lochner\curtis-lochner-1,2017-18,Delaware,G,11,0,21,0,5,.000,0,2,.000,0,3,.000,1,2,.500,0,1,1,0,0,0,3,0,1,-0.5
12832,Emmanuel Wilson\emmanuel-wilson-1,2016-17,San Diego State,G,4,0,18,0,4,.000,0,1,.000,0,3,.000,1,2,.500,0,1,1,0,2,1,4,3,1,-1.1
12833,Shawn Simmons\shawn-simmons-1,2014-15,Pennsylvania,G,9,0,13,0,1,.000,0,1,.000,0,0,,1,6,.167,1,2,3,0,0,0,1,1,1,-0.2
12834,Jamie Baker\jamie-baker-1,2017-18,Presbyterian,G,3,0,19,0,5,.000,0,3,.000,0,2,.000,1,2,.500,1,4,5,4,0,0,1,0,1,0.3
12835,Jalen Hyde\jalen-hyde-1,2013-14,Rutgers,G,4,0,5,0,0,,0,0,,0,0,,1,1,1.000,0,0,0,0,0,0,0,1,1,0.2
12836,Ethan Haslam\ethan-haslam-1,2017-18,South Alabama,G,8,0,18,0,2,.000,0,1,.000,0,1,.000,1,2,.500,1,2,3,0,0,0,1,3,1,-0.2
12837,Marquelle McIntyre\marquelle-mcintyre-1,2016-17,Akron,G,4,0,5,0,3,.000,0,3,.000,0,0,,1,2,.500,1,2,3,1,0,0,2,0,1,-0.4
12838,London Dokubo\london-dokubo-1,2014-15,Loyola (IL),G,18,1,32,0,3,.000,0,3,.000,0,0,,1,2,.500,1,4,5,3,2,0,3,2,1,0.0
12839,Keifer Dalton\keifer-dalton-1,2015-16,Western Kentucky,G,4,0,13,0,1,.000,0,0,,0,1,.000,1,2,.500,0,4,4,3,0,0,3,1,1,-0.1
12840,Bill Muse\bill-muse-1,2017-18,Coastal Carolina,G,4,0,11,0,2,.000,0,0,,0,2,.000,1,2,.500,0,1,1,0,0,0,0,0,1,-0.1
12841,Reed Vial\reed-vial-1,2016-17,Louisiana State,G,6,0,7,0,0,,0,0,,0,0,,1,2,.500,0,1,1,0,0,0,1,0,1,0.0
12842,Tre Duncan\tre-duncan-1,2013-14,High Point,G,4,0,11,0,3,.000,0,1,.000,0,2,.000,1,3,.333,0,1,1,0,0,0,2,1,1,-1.0
12843,Andrew Terrell\andrew-terrell-1,2016-17,Maryland,G,5,0,8,0,1,.000,0,0,,0,1,.000,0,0,,0,0,0,2,0,0,0,1,0,0.1
12844,David Lipscomb\david-lipscomb-1,2014-15,St. John's (NY),G,13,0,15,0,1,.000,0,1,.000,0,0,,0,0,,0,4,4,2,0,0,1,1,0,0.0
12845,Tedaro France III\tedaro-franceiii-1,2015-16,Central Michigan,G,3,0,5,0,0,,0,0,,0,0,,0,0,,0,0,0,0,0,0,0,0,0,0.0
12846,Patrick Speller\patrick-speller-1,2014-15,Howard,G,2,0,2,0,0,,0,0,,0,0,,0,0,,0,0,0,0,0,0,0,0,0,0.0
12847,Devocio Butler\devocio-butler-1,2017-18,Texas Southern,G,1,0,0,0,0,,0,0,,0,0,,0,0,,0,0,0,0,0,0,0,0,0,0.0
12848,Ford Stuen\ford-stuen-1,2015-16,Oklahoma State,G,4,1,9,0,2,.000,0,1,.000,0,1,.000,0,0,,1,0,1,1,0,0,1,0,0,-0.3
12849,Austin Eagleton\austin-eagleton-1,2015-16,Saint Louis,G,1,0,1,0,0,,0,0,,0,0,,0,0,,0,0,0,0,0,0,0,0,0,0.0
12850,Adam Cumber\adam-cumber-1,2016-17,New Mexico,G,1,0,2,0,0,,0,0,,0,0,,0,0,,0,0,0,0,0,0,0,0,0,0.0
12851,Austin Lee\austin-lee-1,2014-15,Northern Arizona,G,3,0,4,0,0,,0,0,,0,0,,0,0,,0,1,1,0,0,0,3,0,0,-0.9
12852,Anthony Graves\anthony-graves-1,2014-15,Florida Atlantic,G,2,0,4,0,0,,0,0,,0,0,,0,0,,1,0,1,0,0,0,0,0,0,0.4
12853,Joe Schwartz\joe-schwartz-1,2016-17,Texas,G,1,0,1,0,0,,0,0,,0,0,,0,0,,0,0,0,0,0,0,0,0,0,0.0
12854,Tyler Berryhill\tyler-berryhill-1,2017-18,Jackson State,G,1,1,1,0,0,,0,0,,0,0,,0,0,,0,0,0,0,0,0,0,0,0,0.0
12855,Jacob Raspopovich\jacob-raspopovich-1,2013-14,Texas-Rio Grande Valley,G,12,0,63,0,5,.000,0,4,.000,0,1,.000,0,0,,0,7,7,9,2,0,3,8,0,0.1
12856,Kenneth Taylor\kenneth-taylor-1,2015-16,Jackson State,G,10,0,24,0,1,.000,0,1,.000,0,0,,0,0,,0,1,1,0,0,0,1,3,0,-0.3
12857,Michael Moyer\michael-moyer-1,2013-14,Oregon State,G,3,0,3,0,0,,0,0,,0,0,,0,0,,0,0,0,0,0,0,0,0,0,0.0
12858,Cameron Neysmith\cameron-neysmith-1,2015-16,Kennesaw State,G,2,0,3,0,2,.000,0,2,.000,0,0,,0,0,,0,0,0,0,0,0,0,0,0,-0.7
12859,Brandon Turner\brandon-turner-1,2013-14,Maryland-Eastern Shore,G,2,0,4,0,0,,0,0,,0,0,,0,0,,0,0,0,0,0,0,0,0,0,0.0
12860,Dillon Graham\dillon-graham-1,2014-15,Florida,G,1,0,3,0,1,.000,0,0,,0,1,.000,0,0,,0,0,0,0,1,0,0,0,0,0.3
12861,Terry Ellis\terry-ellis-1,2017-18,Alabama A&M,G,1,1,10,0,0,,0,0,,0,0,,0,0,,0,0,0,0,0,0,0,0,0,0.0
12862,Trevor Hill\trevor-hill-1,2016-17,Eastern Kentucky,G,2,0,7,0,1,.000,0,0,,0,1,.000,0,0,,0,0,0,0,0,0,1,2,0,-1.3
12863,Jordan Reed\jordan-reed-2,2014-15,Rice,G,12,0,64,0,11,.000,0,1,.000,0,10,.000,0,0,,5,8,13,3,2,0,4,8,0,-0.4
12864,Alex Seutin\alex-seutin-1,2015-16,Stanford,G,3,0,10,0,1,.000,0,1,.000,0,0,,0,0,,0,0,0,0,0,0,0,0,0,-0.2
12865,Devin Fleming\devin-fleming-1,2016-17,Southern California,G,4,0,6,0,1,.000,0,1,.000,0,0,,0,0,,0,2,2,0,1,0,0,0,0,0.2
12866,James Griffin\james-griffin-3,2015-16,Marist,G,1,0,0,0,0,,0,0,,0,0,,0,0,,0,0,0,0,0,0,0,0,0,0.0
12867,Marcus Larsson\marcus-larsson-1,2016-17,Virginia Military Institute,G,2,0,3,0,1,.000,0,1,.000,0,0,,0,0,,0,0,0,0,0,0,0,0,0,-0.4
12868,Grant Vermeer\grant-vermeer-1,2015-16,Navy,G,5,0,9,0,2,.000,0,2,.000,0,0,,0,0,,0,6,6,1,0,0,2,0,0,-0.2
12869,Joe Fagan\joe-fagan-1,2013-14,Indiana,G,5,0,6,0,0,,0,0,,0,0,,0,0,,1,0,1,0,0,0,1,0,0,-0.1
12870,Andy Nelson\andy-nelson-2,2016-17,San Diego,G,1,0,1,0,0,,0,0,,0,0,,0,0,,0,0,0,0,0,0,0,0,0,0.0
12871,Xavion Turnage\xavion-turnage-1,2015-16,Prairie View,G,1,0,1,0,0,,0,0,,0,0,,0,0,,0,0,0,0,0,0,0,0,0,0.0
12872,Corey Tobin\corey-tobin-1,2014-15,Georgia State,G,8,0,13,0,0,,0,0,,0,0,,0,0,,1,2,3,0,0,0,0,1,0,0.1
12873,Michael Adams\michael-adams-2,2014-15,North Carolina-Greensboro,G,3,0,8,0,2,.000,0,1,.000,0,1,.000,0,0,,0,2,2,0,0,0,0,1,0,-0.4
12874,Jeremiah Tate\jeremiah-tate-1,2014-15,Wofford,G,3,0,7,0,0,,0,0,,0,0,,0,2,.000,0,0,0,0,0,0,0,0,0,-0.3
12875,Dan Henry\dan-henry-2,2017-18,Saint Francis (PA),G,6,0,13,0,2,.000,0,2,.000,0,0,,0,0,,0,1,1,0,1,0,1,0,0,-0.2
12876,Kaleb Marquis\kaleb-marquis-1,2013-14,Long Island University,G,1,0,1,0,0,,0,0,,0,0,,0,0,,0,0,0,0,0,0,0,0,0,0.0
12877,David Goodwater\david-goodwater-1,2014-15,Cleveland State,G,3,0,4,0,0,,0,0,,0,0,,0,0,,0,1,1,0,1,0,0,0,0,0.4
12878,Ilya Tyrtyshnik\ilya-tyrtyshnik-1,2017-18,Mississippi,G,3,0,5,0,3,.000,0,1,.000,0,2,.000,0,0,,0,2,2,0,0,0,1,0,0,-0.8
12879,Allen Stevens\allen-stevens-1,2013-14,Pepperdine,G,1,0,1,0,0,,0,0,,0,0,,0,0,,0,0,0,0,0,0,0,0,0,0.0
12880,Chris Odionu\chris-odionu-1,2016-17,Arizona State,G,2,0,2,0,0,,0,0,,0,0,,0,0,,0,0,0,0,0,0,0,1,0,-0.2
12881,Curtis McRoy\curtis-mcroy-1,2014-15,Delaware,G,4,0,5,0,0,,0,0,,0,0,,0,0,,0,0,0,0,0,0,0,0,0,0.0
12882,Caleb Martin\caleb-martin-2,2017-18,Pepperdine,G,2,0,3,0,1,.000,0,0,,0,1,.000,0,0,,0,0,0,0,0,0,1,0,0,-0.9
12883,Clive Vaughan\clive-vaughan-1,2016-17,Morgan State,G,1,0,3,0,0,,0,0,,0,0,,0,0,,0,0,0,0,0,0,0,0,0,0.0
12884,Marquel Ingram\marquel-ingram-1,2016-17,Bethune-Cookman,G,1,0,1,0,0,,0,0,,0,0,,0,0,,0,1,1,0,0,0,3,0,0,-2.7
12885,Brian Long\brian-long-1,2014-15,Kentucky,G,10,1,16,0,2,.000,0,0,,0,2,.000,0,0,,0,0,0,0,1,0,0,2,0,-0.1
12886,Malcolm Reid\malcom-reid-1,2015-16,Southeastern Louisiana,G,6,0,10,0,2,.000,0,0,,0,2,.000,0,0,,0,2,2,1,2,0,0,2,0,0.2
12887,Michael Salazar\michael-salazar-1,2013-14,Fresno State,G,4,0,10,0,2,.000,0,0,,0,2,.000,0,0,,0,1,1,0,0,0,0,0,0,-0.3
12888,Brett Brady\brett-brady-1,2014-15,Colorado,G,6,0,14,0,1,.000,0,0,,0,1,.000,0,0,,0,0,0,1,0,0,0,2,0,-0.1
12889,David Varoli\david-varoli-1,2014-15,Niagara,G,1,0,1,0,1,.000,0,0,,0,1,.000,0,0,,0,0,0,0,0,0,0,0,0,-0.7
12890,Nick Diclementi\nick-diclementi-1,2017-18,George Mason,G,4,0,5,0,1,.000,0,0,,0,1,.000,0,0,,0,2,2,0,1,0,1,0,0,0.0
12891,Khalid Robinson\khalid-robinson-1,2013-14,Fordham,G,9,1,16,0,3,.000,0,3,.000,0,0,,0,0,,2,1,3,0,0,0,1,5,0,-0.4
12892,Greg Tarca\greg-tarca-1,2015-16,Quinnipiac,G,2,0,1,0,0,,0,0,,0,0,,0,0,,1,0,1,0,0,0,1,0,0,-0.2
12893,Tyus Bowser\tyus-bowser-1,2014-15,Houston,G,1,0,1,0,0,,0,0,,0,0,,0,0,,0,0,0,0,0,0,0,0,0,0.0
12894,Jay Camus\jay-camus-1,2017-18,St. John's (NY),G,2,0,4,0,2,.000,0,0,,0,2,.000,0,0,,0,0,0,0,1,0,1,0,0,-0.7
12895,Josh Repine\josh-repine-1,2016-17,Colorado,G,6,0,9,0,4,.000,0,3,.000,0,1,.000,0,0,,0,0,0,0,0,0,1,1,0,-0.7
12896,Cole Rives\cole-rives-1,2013-14,Georgia Southern,G,11,0,21,0,6,.000,0,2,.000,0,4,.000,0,0,,0,1,1,1,2,0,1,1,0,-0.2
12897,Malik Abbott\malik-abbott-1,2015-16,Air Force,G,4,0,7,0,0,,0,0,,0,0,,0,0,,1,3,4,1,0,0,1,1,0,0.2
12898,James Conley\james-conley-1,2017-18,Oral Roberts,G,2,0,23,0,2,.000,0,0,,0,2,.000,0,0,,0,3,3,6,1,1,3,1,0,1.0
12899,Dominik Fragala\dominik-fragala-1,2017-18,Niagara,G,1,0,2,0,0,,0,0,,0,0,,0,0,,0,0,0,0,0,0,0,0,0,0.0
12900,Bernard Woodside\bernard-woodside-1,2016-17,Tulane,G,3,0,2,0,0,,0,0,,0,0,,0,0,,1,0,1,0,0,0,0,0,0,0.2
12901,Jonathan Radner\jonathan-radner-1,2015-16,Syracuse,G,1,0,1,0,0,,0,0,,0,0,,0,0,,0,0,0,0,0,0,0,0,0,0.0
12902,Patrick Rielly\patrick-rielly-1,2016-17,Holy Cross,G,8,0,8,0,2,.000,0,2,.000,0,0,,0,0,,1,1,2,0,0,0,0,1,0,-0.1
12903,Samir Kalil\samir-kalil-1,2014-15,Quinnipiac,G,7,0,8,0,1,.000,0,0,,0,1,.000,0,0,,0,0,0,0,0,0,1,0,0,-0.2
12904,Rashad Andrews\rashad-andrews-1,2017-18,Southern,G,3,0,7,0,1,.000,0,1,.000,0,0,,0,0,,0,0,0,0,0,0,0,0,0,-0.2
12905,Jackson Bax\jackson-bax-1,2015-16,Wisconsin,G,3,0,2,0,0,,0,0,,0,0,,0,0,,0,0,0,0,0,0,0,0,0,0.0
12906,Tristan Simmons\tristan-simmons-1,2015-16,Arkansas,G,1,0,0,0,0,,0,0,,0,0,,0,0,,0,0,0,0,0,0,0,0,0,0.0
12907,Jake Mosiman\jake-mosiman-1,2015-16,Arkansas,G,2,0,1,0,1,.000,0,1,.000,0,0,,0,0,,0,0,0,0,0,0,0,0,0,-0.4
12908,Aaron Law\aaron-law-1,2014-15,Coastal Carolina,G,6,0,32,0,3,.000,0,2,.000,0,1,.000,0,0,,2,6,8,7,4,0,2,3,0,1.1
12909,Travis Waldroup-Rodriguez\travis-waldroup-rodriguez-1,2014-15,Army,G,1,0,4,0,0,,0,0,,0,0,,0,0,,0,0,0,0,0,0,0,0,0,0.0
12910,Christian Garrett\christian-garrett-1,2013-14,Kansas,G,7,0,11,0,1,.000,0,1,.000,0,0,,0,2,.000,1,0,1,1,0,0,3,3,0,-0.6
12911,Brent Carraway\brent-carraway-1,2017-18,Presbyterian,G,1,0,6,0,3,.000,0,2,.000,0,1,.000,0,0,,0,0,0,0,0,0,0,0,0,-2.1
12912,Brandon Lopez\brandon-lopez-1,2013-14,Tennessee,G,7,0,13,0,0,,0,0,,0,0,,0,0,,0,1,1,0,0,0,1,0,0,-0.1
12913,Mike Booth\mike-booth-1,2014-15,Saint Joseph's,G,4,0,8,0,1,.000,0,1,.000,0,0,,0,2,.000,1,1,2,0,0,0,0,0,0,-0.1
12914,Tyler Trillo\tyler-trillo-1,2016-17,Arizona,G,8,0,31,0,3,.000,0,0,,0,3,.000,0,0,,0,0,0,4,0,0,1,1,0,-0.1
12915,Paulo Cruz\paulo-cruz-1,2015-16,Arizona,G,6,0,16,0,2,.000,0,0,,0,2,.000,0,0,,0,0,0,0,0,0,1,2,0,-0.5
12916,Isaac Fields\isaac-fields-1,2017-18,Clemson,G,4,0,6,0,1,.000,0,0,,0,1,.000,0,0,,0,1,1,0,0,0,0,0,0,-0.1
12917,Chase Driscoll\chase-driscoll-1,2014-15,North Florida,G,8,0,13,0,4,.000,0,0,,0,4,.000,0,0,,0,1,1,0,0,0,0,1,0,-0.4
12918,O'Barcus Taylor\obarcus-taylor-1,2013-14,Jackson State,G,1,0,0,0,0,,0,0,,0,0,,0,0,,1,0,1,0,0,0,0,0,0,0.7
12919,Will Powers\will-powers-1,2016-17,Holy Cross,G,5,0,5,0,1,.000,0,1,.000,0,0,,0,0,,1,0,1,1,0,0,0,0,0,0.1
12920,Djordjije Mumin\djordjije-mumin-1,2014-15,Central Florida,G,5,0,6,0,2,.000,0,0,,0,2,.000,0,0,,0,0,0,0,0,0,0,0,0,-0.3
12921,Chad Cooke\chad-cooke-1,2013-14,College of Charleston,G,2,0,2,0,0,,0,0,,0,0,,0,0,,0,0,0,1,0,0,0,0,0,0.4
12922,Mike Sutton\mike-sutton-2,2014-15,Syracuse,G,4,0,5,0,1,.000,0,0,,0,1,.000,0,0,,0,0,0,0,0,1,0,0,0,0.0
12923,Markus Smith\markus-smith-1,2017-18,Kennesaw State,G,2,0,3,0,1,.000,0,1,.000,0,0,,0,0,,0,0,0,1,0,0,1,0,0,-0.5
12924,Phil Richmond\phil-richmond-1,2015-16,Oregon,G,4,0,5,0,0,,0,0,,0,0,,0,0,,0,0,0,0,0,0,0,1,0,-0.1
12925,David Urso\david-urso-1,2017-18,Vermont,G,6,1,13,0,2,.000,0,2,.000,0,0,,0,0,,0,1,1,2,0,0,0,1,0,0.0
12926,Taqqi Muhammad\taqqi-muhammad-1,2015-16,North Carolina-Greensboro,G,3,0,5,0,2,.000,0,1,.000,0,1,.000,0,0,,0,1,1,0,0,0,0,2,0,-0.6
12927,DC Gaitley\dc-gaitley-1,2013-14,Fordham,G,2,0,7,0,0,,0,0,,0,0,,0,0,,0,0,0,0,0,0,0,0,0,0.0
12928,John Whitely\john-whitely-1,2016-17,East Carolina,G,4,0,2,0,0,,0,0,,0,0,,0,0,,0,0,0,0,0,0,0,0,0,0.0
12929,Jordan Smith\jordan-smith-2,2014-15,Wisconsin,G,14,0,35,0,9,.000,0,4,.000,0,5,.000,0,0,,1,1,2,0,0,0,0,3,0,-0.5
12930,Clay Tormey\clay-tormey-1,2013-14,Davidson,G,12,1,22,0,1,.000,0,0,,0,1,.000,0,0,,0,2,2,2,1,0,3,1,0,-0.1
12931,Johnny Jager\johnny-jager-1,2017-18,Indiana,G,6,0,7,0,0,,0,0,,0,0,,0,0,,0,0,0,2,0,0,0,1,0,0.2
12932,Jackson Kane\jackson-kane-1,2014-15,Bradley,G,9,0,11,0,0,,0,0,,0,0,,0,0,,1,1,2,2,0,0,0,0,0,0.3
12933,AJ Hedgecock\aj-hedgecock-1,2014-15,Oregon State,G,4,1,9,0,1,.000,0,1,.000,0,0,,0,0,,0,1,1,1,0,0,2,1,0,-0.5
12934,Darius Sizemore\darius-sizemore-1,2014-15,Alabama State,G,1,0,0,0,1,.000,0,1,.000,0,0,,0,0,,0,0,0,0,0,0,0,0,0,-0.7
12935,Jeremiah Moore\jeremiah-moore-1,2013-14,Texas State,G,6,0,11,0,5,.000,0,3,.000,0,2,.000,0,2,.000,0,0,0,0,0,0,0,0,0,-0.7
12936,Paul Perez\paul-perez-1,2014-15,Texas A&M-Corpus Christi,G,1,0,3,0,1,.000,0,0,,0,1,.000,0,0,,0,0,0,0,0,0,0,1,0,-1.1
12937,Brontae Harris\brontae-harris-1,2015-16,Alabama A&M,G,1,0,0,0,0,,0,0,,0,0,,0,0,,0,0,0,0,0,0,1,0,0,-1.0
12938,Max Betkowski\max-betkowski-1,2013-14,Cal Poly,G,6,0,12,0,1,.000,0,0,,0,1,.000,0,2,.000,0,1,1,0,0,0,1,1,0,-0.4
12939,Jon Brown\jon-brown-2,2017-18,Georgia Tech,G,3,0,5,0,0,,0,0,,0,0,,0,2,.000,0,0,0,0,0,0,1,1,0,-0.7
12940,Danny Farrell\danny-farrell-1,2013-14,St. Bonaventure,G,4,0,4,0,4,.000,0,2,.000,0,2,.000,0,0,,0,1,1,0,0,0,1,0,0,-0.9
12941,Domas Budrys\domas-budrys-1,2015-16,Austin Peay,G,12,0,25,0,13,.000,0,7,.000,0,6,.000,0,0,,2,0,2,1,1,0,0,0,0,-0.5
12942,Jared Ravenscraft\jared-ravenscraft-1,2013-14,Morehead State,G,4,0,15,0,8,.000,0,0,,0,8,.000,0,2,.000,1,3,4,0,2,1,0,2,0,-0.7
12943,J. Walter Lawson\j-walter-lawson-1,2013-14,Delaware State,G,1,0,0,0,0,,0,0,,0,0,,0,0,,0,0,0,0,0,0,1,0,0,-1.0
12944,Max Heller\max-heller-1,2015-16,Oregon,G,13,0,27,0,3,.000,0,3,.000,0,0,,0,0,,2,2,4,1,0,0,1,2,0,-0.1
12945,Jaquan Robertson\jacquan-robertson-1,2015-16,Saint Peter's,G,6,0,2,0,0,,0,0,,0,0,,0,0,,0,1,1,0,0,0,1,0,0,-0.1
12946,Derek Cox\derek-cox-1,2013-14,Cincinnati,G,3,0,2,0,1,.000,0,1,.000,0,0,,0,0,,0,1,1,0,0,0,0,0,0,-0.1
12947,Blake Pagon\blake-pagon-1,2017-18,Stanford,G,13,0,85,0,3,.000,0,0,,0,3,.000,0,1,.000,0,12,12,6,1,0,5,8,0,-0.1
12948,Nick Kazemi\nick-kazemi-1,2014-15,UCLA,G,12,0,18,0,2,.000,0,2,.000,0,0,,0,0,,1,1,2,1,1,0,2,1,0,-0.1
12949,Jadon Reynolds\jadon-reynolds-1,2016-17,Abilene Christian,G,5,0,8,0,1,.000,0,0,,0,1,.000,0,0,,0,1,1,0,0,0,2,0,0,-0.5
12950,Toliver Freeman\toliver-freeman-1,2017-18,Saint Joseph's,G,5,0,5,0,3,.000,0,1,.000,0,2,.000,0,0,,0,2,2,0,0,0,1,0,0,-0.5
12951,Jack Galatio\jack-galatio-1,2017-18,St. Bonaventure,G,4,0,4,0,0,,0,0,,0,0,,0,0,,0,0,0,0,0,0,1,0,0,-0.3
12952,Jack Biebel\jack-biebel-1,2014-15,Saint Mary's (CA),G,9,0,12,0,0,,0,0,,0,0,,0,0,,0,1,1,0,0,0,0,0,0,0.0
12953,Cade Peeper\cade-peeper-1,2013-14,Mississippi,G,3,0,2,0,0,,0,0,,0,0,,0,0,,0,1,1,0,0,0,0,0,0,0.1
12954,Kamau Faines\kamau-faines-1,2016-17,Davidson,G,7,0,9,0,2,.000,0,2,.000,0,0,,0,0,,0,0,0,0,0,0,0,1,0,-0.3
12955,Antonio Morgano\antonio-morgano-1,2017-18,Mississippi,G,1,0,1,0,0,,0,0,,0,0,,0,0,,0,0,0,0,0,0,1,0,0,-1.0
12956,Max Heller\max-heller-1,2014-15,Oregon,G,2,0,7,0,0,,0,0,,0,0,,0,0,,0,0,0,0,0,0,1,1,0,-0.7
12957,Taylor Johnson\taylor-johnson-1,2013-14,Central Arkansas,G,1,0,0,0,1,.000,0,0,,0,1,.000,0,0,,0,0,0,0,0,0,0,0,0,-0.7
12958,Jamelle Christian\jamelle-christian-1,2015-16,Delaware State,G,4,0,14,0,0,,0,0,,0,0,,0,0,,0,0,0,2,1,0,3,1,0,-0.3
12959,Henry Beard\henry-beard-1,2016-17,South Florida,G,6,0,12,0,0,,0,0,,0,0,,0,0,,1,0,1,1,1,0,1,0,0,0.2
12960,Daniel Pillari\daniel-pillari-1,2014-15,Monmouth,G,12,0,10,0,3,.000,0,1,.000,0,2,.000,0,0,,0,0,0,1,0,0,0,2,0,-0.2
12961,David Urso\david-urso-1,2015-16,Vermont,G,7,0,25,0,6,.000,0,1,.000,0,5,.000,0,0,,1,2,3,4,1,0,3,2,0,-0.4
12962,Daniel Etoroma\daniel-etoroma-1,2017-18,North Carolina-Wilmington,G,14,0,29,0,3,.000,0,3,.000,0,0,,0,0,,3,4,7,0,0,1,0,2,0,0.1
12963,Jaecee Martin\jaecee-martin-1,2017-18,Sacred Heart,G,7,0,35,0,4,.000,0,3,.000,0,1,.000,0,4,.000,0,3,3,3,2,0,5,4,0,-0.9
12964,Zach Smith\zach-smith-2,2017-18,Pittsburgh,G,8,1,11,0,3,.000,0,0,,0,3,.000,0,0,,0,1,1,1,0,0,0,1,0,-0.2
12965,Jacob Broussard\jacob-broussard-1,2015-16,Louisiana,G,4,0,6,0,0,,0,0,,0,0,,0,0,,0,1,1,0,1,0,0,2,0,0.1
12966,Marcus Merriweather\marcus-merriweather-1,2015-16,Alabama A&M,G,1,0,0,0,0,,0,0,,0,0,,0,0,,0,0,0,0,0,0,0,0,0,0.0
12967,Anthony Bilas\anthony-bilas-1,2017-18,Wake Forest,G,7,0,7,0,3,.000,0,3,.000,0,0,,0,0,,3,1,4,2,0,0,1,0,0,0.1
12968,Longi Yiljep\longi-yiljep-1,2013-14,Brown,G,4,0,16,0,2,.000,0,1,.000,0,1,.000,0,0,,0,3,3,3,0,0,0,1,0,0.3
12969,Dusan Langura\dusan-langura-1,2013-14,Georgia,G,1,0,1,0,0,,0,0,,0,0,,0,0,,0,0,0,0,0,0,0,0,0,0.0
12970,Lindsey Hunter IV\lindsey-hunteriv-1,2015-16,Jackson State,G,1,0,2,0,0,,0,0,,0,0,,0,0,,0,0,0,0,0,0,0,0,0,0.0
12971,Milton Washington\milton-washington-1,2013-14,Army,G,1,0,0,0,0,,0,0,,0,0,,0,0,,0,0,0,0,0,0,0,0,0,0.0
12972,Sean Kelly\sean-kelly-2,2014-15,Duke,G,10,0,12,0,1,.000,0,0,,0,1,.000,0,0,,0,0,0,2,0,0,0,0,0,0.1
12973,Kobi Betts\kobi-betts-1,2017-18,Air Force,G,1,0,3,0,0,,0,0,,0,0,,0,0,,0,1,1,0,0,0,0,0,0,0.3
12974,Casey Woodring\casey-woodring-1,2015-16,Providence,G,6,0,11,0,4,.000,0,1,.000,0,3,.000,0,0,,1,2,3,0,0,0,0,1,0,-0.3
12975,Colin Gurry\colin-gurry-1,2013-14,Georgia Tech,G,3,0,7,0,0,,0,0,,0,0,,0,0,,0,0,0,0,1,0,1,0,0,0.0
12976,Joey Downes\joey-downes-1,2016-17,Rutgers,G,1,0,0,0,0,,0,0,,0,0,,0,0,,1,0,1,0,0,0,0,0,0,0.7
12977,K.C. Goodwin\kc-goodwin-1,2013-14,Southern Illinois,G,1,0,0,0,0,,0,0,,0,0,,0,0,,0,0,0,0,0,0,0,0,0,0.0
12978,John Dawson\john-dawson-1,2014-15,Marquette,G,1,0,4,0,1,.000,0,1,.000,0,0,,0,0,,0,0,0,0,0,0,0,0,0,-0.7
12979,Jordan Banks\jordan-banks-1,2013-14,Northern Arizona,G,5,0,9,0,0,,0,0,,0,0,,0,0,,0,2,2,2,1,0,2,2,0,0.0
12980,Chris Rivera\chris-rivera-1,2015-16,Manhattan,G,3,0,6,0,0,,0,0,,0,0,,0,0,,0,1,1,1,0,0,0,2,0,0.1
12981,Isaiah Hobbs\isaiah-hobbs-1,2016-17,Texas,G,2,0,4,0,0,,0,0,,0,0,,0,0,,0,0,0,1,0,0,1,1,0,-0.4
12982,Jean-Micheal Mudiay\jean-michael-mudiay-1,2013-14,Southern Methodist,G,8,0,13,0,5,.000,0,3,.000,0,2,.000,0,2,.000,0,2,2,0,0,0,0,1,0,-0.5
12983,Dante Holmes\dante-holmes-1,2013-14,North Carolina Central,G,1,0,1,0,0,,0,0,,0,0,,0,0,,0,0,0,0,0,0,0,0,0,0.0
12984,Jon Fleming\jon-fleming-1,2014-15,Kent State,G,8,0,15,0,1,.000,0,0,,0,1,.000,0,0,,0,2,2,2,1,0,2,2,0,-0.1
12985,Brandon Wimberly\brandon-wimberly-1,2015-16,Georgia Southern,G,4,0,9,0,3,.000,0,1,.000,0,2,.000,0,0,,0,1,1,1,0,0,0,2,0,-0.5
12986,Tony Thompson\tony-thompson-1,2013-14,Samford,G,7,0,5,0,1,.000,0,1,.000,0,0,,0,0,,2,0,2,0,0,0,1,0,0,0.0
12987,Joseph Wallace\joseph-wallace-1,2017-18,UCLA,G,2,0,3,0,0,,0,0,,0,0,,0,0,,1,0,1,0,0,0,0,0,0,0.4
12988,Sam Averbuck\sam-averbuck-1,2017-18,Wyoming,G,10,0,31,0,2,.000,0,1,.000,0,1,.000,0,0,,0,3,3,2,1,0,3,2,0,-0.2
12989,Aaron Siler\aaron-siler-1,2015-16,Southern Illinois,G,2,0,3,0,0,,0,0,,0,0,,0,1,.000,0,0,0,1,0,0,0,0,0,0.2
12990,Chandler Fraser-Pauls\chandler-fraser-pauls-1,2015-16,Drexel,G,5,1,7,0,1,.000,0,0,,0,1,.000,0,2,.000,0,0,0,1,0,0,0,1,0,-0.2
12991,Preston Troutt\preston-troutt-1,2013-14,Pennsylvania,G,4,0,7,0,3,.000,0,1,.000,0,2,.000,0,0,,1,0,1,2,0,0,0,1,0,-0.1
12992,Matt Maloney\matt-maloney-2,2017-18,Manhattan,G,4,0,3,0,0,,0,0,,0,0,,0,0,,0,0,0,0,0,0,0,0,0,0.0
12993,Caylen Williams\caylen-williams-1,2016-17,Long Island University,G,1,0,4,0,0,,0,0,,0,0,,0,0,,0,0,0,1,0,0,0,1,0,0.3
12994,Landen Amos\landen-amos-1,2013-14,Xavier,G,3,0,4,0,0,,0,0,,0,0,,0,0,,0,0,0,1,1,1,1,1,0,0.3
12995,Josh Repine\josh-repine-1,2014-15,Colorado,G,4,0,4,0,0,,0,0,,0,0,,0,0,,0,0,0,0,0,0,0,1,0,-0.1
12996,David Varoli\david-varoli-1,2017-18,Manhattan,G,1,0,1,0,0,,0,0,,0,0,,0,0,,0,0,0,0,0,0,0,0,0,0.0
12997,Will Poole\will-poole-2,2015-16,Northwestern State,G,7,0,6,0,0,,0,0,,0,0,,0,0,,0,1,1,0,0,0,0,0,0,0.0
12998,DeVante Mayes\devante-mayes-1,2014-15,Western Illinois,G,6,0,12,0,1,.000,0,1,.000,0,0,,0,0,,0,1,1,1,0,0,0,3,0,-0.2
12999,Michael Schlotman\michael-schlotman-1,2013-14,William & Mary,G,2,0,16,0,0,,0,0,,0,0,,0,2,.000,0,0,0,1,0,0,0,1,0,-0.3
13000,Langdon Neal\langdon-neal-1,2014-15,American,G,5,0,3,0,0,,0,0,,0,0,,0,0,,0,0,0,0,1,0,0,4,0,-0.1
13001,Mike Davis\mike-davis-7,2013-14,San Diego,G,1,0,0,0,0,,0,0,,0,0,,0,0,,0,0,0,0,0,0,0,0,0,0.0
13002,Ahmad Frost\ahmad-frost-1,2016-17,Maryland-Eastern Shore,G,1,0,0,0,0,,0,0,,0,0,,0,0,,0,0,0,0,0,0,1,0,0,-1.0
13003,Trevor Anzmann\trevor-anzmann-1,2014-15,Maryland,G,2,0,4,0,0,,0,0,,0,0,,0,0,,0,1,1,0,0,0,1,0,0,-0.4
13004,Anfernee Felton\anfernee-felton-1,2015-16,Jackson State,G,2,0,0,0,1,.000,0,1,.000,0,0,,0,0,,0,2,2,0,0,2,0,0,0,0.7
13005,Addison Owen\addison-owen-1,2017-18,Rice,G,2,0,4,0,0,,0,0,,0,0,,0,0,,0,2,2,0,1,0,0,1,0,0.6
13006,Venjie Wallis\venjie-wallis-1,2015-16,New Orleans,G,1,0,0,0,0,,0,0,,0,0,,0,0,,0,0,0,0,0,1,0,0,0,0.7
13007,Anderson McCoy\anderson-mccoy-1,2017-18,Alabama-Birmingham,G,2,0,8,0,0,,0,0,,0,0,,0,0,,0,0,0,1,0,0,0,2,0,-0.1
13008,Ryder Bowline\ryder-bowline-1,2015-16,Elon,G,3,0,6,0,0,,0,0,,0,0,,0,0,,0,1,1,2,0,0,1,0,0,0.2
13009,Marcus Berkley\marcus-berkley-1,2017-18,UC-Riverside,G,1,0,2,0,1,.000,0,0,,0,1,.000,0,0,,0,0,0,0,0,0,1,0,0,-1.7
13010,Julian Richardson\julian-richardson-1,2016-17,Cal State Northridge,G,4,0,10,0,1,.000,0,0,,0,1,.000,0,0,,0,1,1,2,1,0,0,0,0,0.5
13011,Kevin Rutledge\kevin-rutledge-1,2013-14,Cal State Northridge,G,1,0,1,0,1,.000,0,1,.000,0,0,,0,0,,1,0,1,0,0,0,0,1,0,-0.4
13012,Ramon White\ramon-white-1,2014-15,Texas A&M,G,1,0,1,0,0,,0,0,,0,0,,0,0,,0,0,0,0,0,0,0,0,0,0.0
13013,Thomas Davis\thomas-davis-2,2015-16,Tennessee State,G,1,0,0,0,0,,0,0,,0,0,,0,0,,0,0,0,0,0,0,0,0,0,0.0
13014,Cooper Ainge\cooper-ainge-1,2015-16,Brigham Young,G,2,0,4,0,1,.000,0,0,,0,1,.000,0,0,,0,0,0,0,0,0,0,1,0,-0.6
13015,Joshua Batson\joshua-batson-1,2013-14,Chicago State,G,8,0,15,0,7,.000,0,4,.000,0,3,.000,0,2,.000,0,1,1,0,1,0,0,2,0,-0.7
13016,Grant Sinn\grant-sinn-1,2015-16,IUPUI,G,8,0,8,0,3,.000,0,0,,0,3,.000,0,0,,0,1,1,0,0,0,1,0,0,-0.4
13017,Latio Cosmos\latio-cosmos-1,2016-17,Seattle,G,3,0,12,0,1,.000,0,1,.000,0,0,,0,0,,0,1,1,2,0,0,2,3,0,-0.7
13018,Ty Cannaday\ty-cannaday-1,2014-15,Radford,G,3,0,12,0,3,.000,0,1,.000,0,2,.000,0,0,,0,1,1,0,0,0,2,2,0,-1.5
13019,T.J. Schlundt\tj-schlundt-1,2015-16,Wisconsin,G,5,0,4,0,0,,0,0,,0,0,,0,0,,0,0,0,1,0,0,0,0,0,0.1
13020,Phillip McGloin\phillip-mcgloin-1,2016-17,Vanderbilt,G,2,0,0,0,0,,0,0,,0,0,,0,0,,0,0,0,0,0,0,0,1,0,-0.2
13021,E.C. Matthews\ec-matthews-1,2015-16,Rhode Island,G,1,1,10,0,2,.000,0,2,.000,0,0,,0,0,,1,1,2,0,0,0,1,1,0,-1.8
13022,Thomas Fleming\thomas-fleming-1,2015-16,Niagara,G,1,1,2,0,1,.000,0,0,,0,1,.000,0,0,,0,0,0,0,1,0,0,0,0,0.3
13023,Peyton Robbins\peyton-robbins-1,2015-16,East Carolina,G,5,1,4,0,0,,0,0,,0,0,,0,0,,0,1,1,0,0,0,0,0,0,0.1
13024,Wes Greder\wes-greder-1,2016-17,Iowa State,G,8,0,14,0,3,.000,0,0,,0,3,.000,0,3,.000,1,2,3,0,0,1,0,1,0,-0.2
13025,Jt Plummer\jt-plummer-1,2017-18,Arkansas,G,7,0,6,0,0,,0,0,,0,0,,0,0,,0,0,0,0,0,0,0,0,0,0.0
13026,Tanner Sanders\tanner-sanders-1,2017-18,Oregon State,G,7,0,15,0,2,.000,0,0,,0,2,.000,0,0,,0,2,2,0,0,0,1,3,0,-0.4
13027,Charlie Inclan\charlie-inclan-1,2014-15,Presbyterian,G,3,0,5,0,5,.000,0,4,.000,0,1,.000,0,0,,0,3,3,1,0,0,1,0,0,-1.0
13028,Jacob Begin\jacob-begin-1,2013-14,Portland State,G,11,0,23,0,4,.000,0,1,.000,0,3,.000,0,0,,0,1,1,2,0,0,0,0,0,-0.1
13029,Matt Kennedy\matt-kennedy-2,2016-17,Villanova,G,7,0,14,0,0,,0,0,,0,0,,0,0,,1,0,1,0,0,0,0,0,0,0.1
13030,Matt Massimino\matt-massimino-1,2015-16,Fordham,G,2,0,4,0,0,,0,0,,0,0,,0,0,,1,0,1,1,0,0,0,2,0,0.3
13031,Chuck Smith\chuck-smith-1,2015-16,Howard,G,7,0,8,0,2,.000,0,2,.000,0,0,,0,0,,1,0,1,1,0,0,0,4,0,-0.2
13032,Tyler Simmons\tyler-simmons-1,2017-18,Central Arkansas,G,9,0,16,0,6,.000,0,0,,0,6,.000,0,0,,0,1,1,0,0,0,0,1,0,-0.5
13033,Britton Lee\britton-lee-1,2013-14,Robert Morris,G,3,0,10,0,3,.000,0,3,.000,0,0,,0,2,.000,0,0,0,0,0,0,1,1,0,-1.4
13034,Austin Constable\austin-constable-1,2013-14,South Carolina,G,3,0,6,0,2,.000,0,1,.000,0,1,.000,0,0,,0,0,0,0,1,0,0,1,0,-0.3
13035,Jonathan Tshminga\jonathan-tshminga-1,2015-16,Florida A&M,G,2,0,1,0,1,.000,0,1,.000,0,0,,0,0,,0,0,0,0,0,0,0,0,0,-0.4
13036,Nathan Watkins\nathan-watkins-1,2014-15,Vanderbilt,G,12,0,18,0,2,.000,0,0,,0,2,.000,0,0,,0,1,1,0,0,0,1,2,0,-0.2
13037,James McMillon\james-mcmillon-1,2015-16,NJIT,G,3,0,5,0,2,.000,0,2,.000,0,0,,0,0,,1,1,2,1,0,0,1,0,0,-0.2
13038,Reginald Smith\reginald-smith-2,2013-14,Grambling,G,3,0,1,0,1,.000,0,1,.000,0,0,,0,0,,0,0,0,0,0,0,0,2,0,-0.5
13039,Francis Edosomwan\francis-edosomwan-1,2014-15,East Carolina,G,4,1,7,0,0,,0,0,,0,0,,0,0,,0,0,0,0,0,0,0,1,0,-0.1
13040,Cole Renninger\cole-renninger-1,2013-14,Lehigh,G,12,0,9,0,0,,0,0,,0,0,,0,0,,0,1,1,0,0,0,0,2,0,0.0
13041,Jack Detmer\jack-detmer-1,2013-14,Lafayette,G,14,2,30,0,2,.000,0,0,,0,2,.000,0,0,,0,2,2,0,3,0,3,5,0,-0.2
13042,Malik Amos\malik-amos-1,2016-17,Prairie View,G,1,0,1,0,0,,0,0,,0,0,,0,0,,0,1,1,0,0,0,0,1,0,-0.1
13043,Grant Youngkin\grant-youngkin-1,2016-17,Rice,G,5,0,8,0,5,.000,0,5,.000,0,0,,0,0,,2,0,2,0,0,0,0,0,0,-0.4
13044,Noah Wells\noah-wells-1,2016-17,Western Illinois,G,2,0,9,0,1,.000,0,0,,0,1,.000,0,0,,1,2,3,2,0,0,0,1,0,0.8
13045,Alario Harris\alario-harris-1,2015-16,Georgia State,G,6,0,3,0,2,.000,0,2,.000,0,0,,0,0,,0,1,1,0,1,0,1,0,0,-0.2
13046,Kade Kinnamon\kade-kinnamon-1,2017-18,Kansas State,G,11,0,12,0,3,.000,0,0,,0,3,.000,0,0,,0,0,0,1,0,1,0,0,0,-0.1
13047,Mitch Warner\mitch-warner-1,2014-15,Charlotte,G,3,0,2,0,2,.000,0,2,.000,0,0,,0,0,,0,0,0,0,0,0,0,0,0,-0.5
13048,Matt Jasaitis\matt-jasaitis-1,2017-18,Santa Clara,G,4,0,11,0,3,.000,0,0,,0,3,.000,0,0,,0,1,1,2,0,0,1,2,0,-0.6
13049,Will Powers\will-powers-1,2017-18,Holy Cross,G,5,0,5,0,0,,0,0,,0,0,,0,0,,0,0,0,0,0,0,0,0,0,0.0
13050,T.J. Distefano\tj-distefano-1,2015-16,Texas A&M,G,11,0,14,0,3,.000,0,2,.000,0,1,.000,0,0,,0,2,2,0,0,0,2,2,0,-0.4
13051,Christian Schmitt\christian-schmitt-1,2017-18,South Carolina,G,3,0,6,0,2,.000,0,0,,0,2,.000,0,0,,0,0,0,0,0,0,0,0,0,-0.5
13052,Collin Weaver\collin-weaver-1,2016-17,Nevada,G,3,0,8,0,2,.000,0,0,,0,2,.000,0,0,,0,1,1,0,0,0,0,0,0,-0.4
13053,Davis Graham\davis-graham-1,2013-14,Rider,G,7,0,7,0,0,,0,0,,0,0,,0,0,,0,0,0,0,1,0,0,0,0,0.1
13054,Crishawn Cook\crishawn-cook-1,2016-17,Southern Illinois,G,4,0,3,0,0,,0,0,,0,0,,0,0,,0,0,0,0,0,0,1,0,0,-0.3
13055,Elliott Kampen\elliott-kampen-1,2013-14,Butler,G,6,0,20,0,1,.000,0,0,,0,1,.000,0,0,,0,2,2,1,0,0,1,2,0,-0.2
13056,Alvin Jones\alvin-jones-2,2013-14,Texas-El Paso,G,3,0,5,0,0,,0,0,,0,0,,0,0,,0,0,0,0,0,0,0,0,0,0.0
13057,Jacob Lunsford\jacob-lunsford-1,2016-17,Denver,G,4,0,3,0,0,,0,0,,0,0,,0,0,,0,0,0,0,0,0,0,0,0,0.0
13058,Dee Wallace\dee-wallace-1,2014-15,Cal State Bakersfield,G,6,0,14,0,4,.000,0,0,,0,4,.000,0,0,,0,2,2,0,0,0,0,1,0,-0.4
13059,Dalton Stewart\dalton-stewart-1,2017-18,Dayton,G,3,0,1,0,1,.000,0,1,.000,0,0,,0,0,,1,0,1,0,1,0,0,0,0,0.3
13060,Peyton Robbins\peyton-robbins-1,2013-14,East Carolina,G,3,0,6,0,3,.000,0,3,.000,0,0,,0,0,,1,1,2,0,0,0,1,1,0,-0.8
13061,Eli Stalzer\eli-stalzer-1,2015-16,Colorado,G,9,0,18,0,2,.000,0,0,,0,2,.000,0,0,,0,2,2,2,0,0,0,0,0,0.1
13062,Ryan Staten\ryan-staten-1,2014-15,San Diego State,G,6,0,11,0,5,.000,0,3,.000,0,2,.000,0,0,,0,1,1,2,0,1,0,0,0,-0.2
13063,Joseph Battle\joseph-battle-1,2016-17,Tulsa,G,1,0,1,0,0,,0,0,,0,0,,0,0,,0,0,0,0,0,0,0,1,0,-0.4
13064,Mark French\mark-french-1,2017-18,Texas A&M,G,5,0,7,0,3,.000,0,1,.000,0,2,.000,0,0,,0,0,0,0,0,0,0,2,0,-0.6
13065,Stefano Mancini\stefano-mancini-1,2014-15,Loyola (MD),G,10,0,30,0,6,.000,0,3,.000,0,3,.000,0,0,,0,1,1,0,1,0,2,2,0,-0.6
13066,Kevin Brown\kevin-brown-1,2017-18,American,G,6,0,10,0,4,.000,0,2,.000,0,2,.000,0,0,,0,2,2,0,0,0,2,3,0,-0.9
13067,Vilontae Eanes\vilontae-eanes-1,2017-18,Norfolk State,G,2,0,3,0,0,,0,0,,0,0,,0,2,.000,0,0,0,1,1,0,0,0,0,0.5
13068,Mike Lopez\mike-lopez-1,2014-15,Texas-Rio Grande Valley,G,2,0,5,0,3,.000,0,1,.000,0,2,.000,0,0,,0,0,0,1,0,0,0,1,0,-0.9
13069,Brandon Cartmill\brandon-cartmill-1,2013-14,Duquesne,G,1,0,1,0,0,,0,0,,0,0,,0,0,,0,0,0,0,0,0,0,0,0,0.0
13070,Garrett Turner\garrett-turner-1,2016-17,San Francisco,G,3,0,4,0,0,,0,0,,0,0,,0,0,,0,0,0,0,0,0,0,0,0,0.0
13071,Ryan Diew\ryan-diew-1,2015-16,Colgate,G,1,0,1,0,0,,0,0,,0,0,,0,0,,0,1,1,0,0,0,0,0,0,0.3
13072,Will Hornsby\will-hornsby-1,2013-14,Grambling,G,1,1,17,0,2,.000,0,1,.000,0,1,.000,0,0,,0,2,2,0,0,0,3,3,0,-5.0
13073,Jay Jay Elvir\jay-jay-elvir-1,2014-15,Loyola (IL),G,1,0,2,0,1,.000,0,1,.000,0,0,,0,0,,0,1,1,0,0,0,0,0,0,-0.4
13074,Marcus Ellison\marcus-ellison-1,2013-14,Texas A&M-Corpus Christi,G,1,0,3,0,0,,0,0,,0,0,,0,0,,0,0,0,0,0,0,0,1,0,-0.4
13075,Jason Houle\jason-houle-1,2017-18,Army,G,2,0,7,0,2,.000,0,1,.000,0,1,.000,0,0,,0,1,1,0,0,0,1,0,0,-1.1
13076,Staats Battle\staats-battle-1,2013-14,North Carolina State,G,6,0,7,0,3,.000,0,0,,0,3,.000,0,1,.000,0,2,2,1,0,0,1,0,0,-0.4
13077,Daniel Harper\daniel-harper-1,2013-14,Oklahoma,G,5,0,6,0,0,,0,0,,0,0,,0,0,,0,0,0,1,0,0,0,0,0,0.1
13078,Zach Chu\zach-chu-1,2013-14,Richmond,G,1,0,1,0,0,,0,0,,0,0,,0,0,,1,0,1,0,0,0,0,0,0,0.7
13079,Tim Branin\tim-branin-1,2015-16,College of Charleston,G,2,0,5,0,1,.000,0,1,.000,0,0,,0,0,,0,1,1,0,0,0,1,0,0,-0.7
13080,Carter Holmes\carter-holmes-1,2015-16,Mississippi State,G,6,0,9,0,2,.000,0,0,,0,2,.000,0,0,,0,0,0,0,0,0,1,0,0,-0.4
13081,Shazier Lawson\shazier-lawson-1,2015-16,Arizona State,G,5,0,6,0,0,,0,0,,0,0,,0,0,,1,0,1,0,0,1,0,3,0,0.0
13082,Brennan Besser\brennan-besser-1,2016-17,Duke,G,1,0,2,0,1,.000,0,0,,0,1,.000,0,0,,0,0,0,0,0,0,0,1,0,-1.1
13083,Cal Freundlich\cal-freundlich-1,2016-17,Davidson,G,2,0,2,0,0,,0,0,,0,0,,0,0,,0,0,0,0,0,0,0,0,0,0.0
13084,Kevin Kerley\kevin-kerley-1,2015-16,Appalachian State,G,2,0,4,0,0,,0,0,,0,0,,0,0,,0,0,0,0,0,0,1,0,0,-0.5
13085,Jefkins Agyeman-Budu\jefkin-agyeman-budu-1,2015-16,Grambling,G,2,0,1,0,0,,0,0,,0,0,,0,0,,0,0,0,0,0,1,0,0,0,0.4
13086,C.J. Massengill\cj-massengill-1,2017-18,Chattanooga,G,2,0,7,0,1,.000,0,1,.000,0,0,,0,0,,0,0,0,0,0,0,0,0,0,-0.4
13087,Aidan Hadley\aidan-hadley-1,2013-14,Stetson,G,2,0,2,0,0,,0,0,,0,0,,0,0,,0,0,0,0,1,0,0,0,0,0.5
13088,Nick Norton\nick-norton-1,2016-17,Alabama-Birmingham,G,1,1,11,0,1,.000,0,0,,0,1,.000,0,0,,0,1,1,5,0,0,1,0,0,2.1
13089,Jakob Cornelissen\jakob-cornelissen-1,2015-16,Hawaii,G,5,0,7,0,4,.000,0,1,.000,0,3,.000,0,0,,2,1,3,0,0,0,0,1,0,-0.3
13090,Christopher Brown\christopher-brown-1,2014-15,Morgan State,G,1,0,3,0,0,,0,0,,0,0,,0,0,,0,1,1,0,0,0,0,0,0,0.3
13091,Forrest Greenwalt\forrest-greenwalt-1,2014-15,San Diego,G,2,0,4,0,0,,0,0,,0,0,,0,0,,0,0,0,0,0,0,1,1,0,-0.7
13092,Conner Lipinski\conner-lipinski-1,2013-14,Maryland,G,3,0,5,0,0,,0,0,,0,0,,0,0,,0,0,0,0,0,0,0,1,0,-0.1
13093,Tucker Vang\tucker-vang-1,2016-17,Kansas,G,10,0,17,0,1,.000,0,1,.000,0,0,,0,0,,0,1,1,1,0,0,1,2,0,-0.2
13094,Thomas Blake\thomas-blake-1,2013-14,North Dakota,G,5,0,13,0,3,.000,0,1,.000,0,2,.000,0,0,,0,3,3,1,0,0,2,2,0,-0.7
13095,Myles Fitzgerald-Warren\myles-fitzgerald-warren-1,2017-18,Fresno State,G,7,0,17,0,2,.000,0,1,.000,0,1,.000,0,1,.000,0,0,0,0,0,0,1,0,0,-0.4
13096,Langdon Neal\langdon-neal-1,2013-14,American,G,1,0,1,0,0,,0,0,,0,0,,0,0,,0,0,0,0,0,0,0,0,0,0.0
13097,Christopher Miller\christopher-miller-1,2014-15,Northern Arizona,G,4,0,16,0,3,.000,0,3,.000,0,0,,0,0,,0,1,1,2,0,0,2,2,0,-0.8
13098,Yosef Yacob\yosef-yacob-1,2017-18,Binghamton,G,4,0,27,0,3,.000,0,0,,0,3,.000,0,0,,0,3,3,2,1,0,1,2,0,-0.2
13099,Miles Rockafeler\miles-rockafeler-1,2015-16,St. Francis (NY),G,7,0,4,0,1,.000,0,1,.000,0,0,,0,2,.000,0,0,0,1,0,0,1,2,0,-0.4
13100,Elijah Mays\elijah-mays-1,2015-16,Florida A&M,G,1,0,0,0,0,,0,0,,0,0,,0,0,,0,1,1,0,0,0,0,0,0,0.3
13101,Jackie Saucer\jackie-saucer-1,2015-16,Bethune-Cookman,G,2,0,12,0,2,.000,0,0,,0,2,.000,0,0,,1,0,1,0,1,0,3,2,0,-1.8
13102,Caleb Oehlberg\caleb-oehlberg-1,2017-18,Northern Illinois,G,1,0,1,0,1,.000,0,0,,0,1,.000,0,0,,0,0,0,1,0,0,0,0,0,0.0
13103,Christian Harrison\christian-harrison-1,2015-16,Troy,G,1,0,8,0,0,,0,0,,0,0,,0,0,,0,0,0,0,3,0,1,2,0,1.2
13104,Ishmail Jabbie\ishmail-jabbie-1,2016-17,Maryland-Baltimore County,G,7,0,10,0,3,.000,0,2,.000,0,1,.000,0,2,.000,2,3,5,0,0,0,0,2,0,-0.2
13105,Matt Williams\matt-williams-5,2015-16,Davidson,G,8,1,13,0,0,,0,0,,0,0,,0,0,,0,1,1,0,0,0,1,2,0,-0.2
13106,Maleek Frazier\maleek-frazier-1,2013-14,Virginia,G,12,0,23,0,4,.000,0,3,.000,0,1,.000,0,0,,0,2,2,2,1,1,4,4,0,-0.4
13107,Tim Branin\tim-branin-1,2014-15,College of Charleston,G,2,0,1,0,0,,0,0,,0,0,,0,1,.000,0,0,0,0,1,0,1,1,0,-0.4
13108,Lou Griffith\lou-griffith-1,2016-17,Bradley,G,1,0,3,0,0,,0,0,,0,0,,0,0,,0,0,0,0,0,0,0,0,0,0.0
13109,Chris Lydon\chris-lydon-1,2015-16,Massachusetts,G,2,1,3,0,0,,0,0,,0,0,,0,0,,0,0,0,0,0,0,0,1,0,-0.2
13110,Clarke Cooper\clarke-cooper-1,2016-17,Texas-Rio Grande Valley,G,4,0,7,0,1,.000,0,1,.000,0,0,,0,0,,0,1,1,0,0,0,2,2,0,-0.8
13111,Eric Wagenlander\eric-wagenlander-1,2014-15,Wofford,G,3,0,6,0,1,.000,0,0,,0,1,.000,0,0,,0,1,1,0,0,0,1,0,0,-0.5
13112,Dexter Gooding\dexter-gooding-1,2016-17,High Point,G,12,0,30,0,8,.000,0,3,.000,0,5,.000,0,0,,0,5,5,2,0,0,1,0,0,-0.3
13113,Carter Josephs\carter-josephs-1,2013-14,Vanderbilt,G,20,1,160,0,1,.000,0,1,.000,0,0,,0,1,.000,0,7,7,22,6,0,8,17,0,0.4
13114,Tim Hasbargen\tim-hasbargen-1,2014-15,Cleveland State,G,5,0,22,0,1,.000,0,0,,0,1,.000,0,0,,0,1,1,1,0,0,1,2,0,-0.3
13115,Riyan Williams\riyan-williams-1,2013-14,Georgetown,G,1,0,1,0,0,,0,0,,0,0,,0,0,,0,0,0,0,0,0,0,0,0,0.0
13116,Zach Checkal\zach-checkal-1,2014-15,North Dakota State,G,7,0,9,0,3,.000,0,2,.000,0,1,.000,0,0,,2,2,4,0,0,0,0,2,0,-0.1
13117,Elijah Cooks\elijah-cooks-1,2017-18,Nevada,G,4,0,4,0,0,,0,0,,0,0,,0,0,,1,0,1,0,0,0,0,4,0,-0.2
13118,Robbie Feinberg\robbie-feinberg-1,2015-16,Harvard,G,2,0,5,0,2,.000,0,2,.000,0,0,,0,0,,1,2,3,1,0,0,0,0,0,0.3
13119,Nihad Musovic\nihad-musovic-1,2014-15,Fordham,G,6,0,5,0,0,,0,0,,0,0,,0,0,,0,0,0,0,0,0,0,1,0,-0.1
13120,Luke Wilson\luke-wilson-1,2017-18,Michigan,G,2,0,7,0,1,.000,0,0,,0,1,.000,0,1,.000,0,0,0,0,0,0,1,1,0,-1.3
13121,Tommy Corchiani\tommy-corchiani-1,2017-18,South Carolina,G,2,0,3,0,0,,0,0,,0,0,,0,0,,0,2,2,0,0,0,0,0,0,0.3
13122,Jordan Borucki\jordan-borucki-1,2013-14,American,G,1,0,1,0,0,,0,0,,0,0,,0,0,,0,0,0,0,0,0,1,0,0,-1.0
13123,Tre' Bryant\tre-bryant-1,2015-16,South Florida,G,10,1,17,0,3,.000,0,1,.000,0,2,.000,0,0,,1,0,1,0,0,0,2,3,0,-0.5
13124,Corban Murphy\corban-murphy-1,2014-15,Arizona State,G,3,0,3,0,1,.000,0,0,,0,1,.000,0,0,,0,0,0,1,0,0,0,0,0,0.0
13125,Reggie Williams\reggie-williams-6,2014-15,Ohio,G,7,0,12,0,1,.000,0,1,.000,0,0,,0,2,.000,0,0,0,1,0,0,0,1,0,-0.2
13126,Andrew Crowley\andrew-crowley-1,2014-15,Hartford,G,2,0,1,0,0,,0,0,,0,0,,0,0,,0,0,0,0,0,0,0,0,0,0.0
13127,Zach Garrett\zach-garrett-1,2017-18,George Mason,G,4,0,5,0,0,,0,0,,0,0,,0,2,.000,0,0,0,0,0,0,0,0,0,-0.2
13128,Travis Berry\travis-berry-1,2015-16,Sacred Heart,G,3,0,28,0,1,.000,0,1,.000,0,0,,0,0,,0,0,0,0,0,0,1,0,0,-0.6
13129,A.J. Lapray\aj-lapray-1,2013-14,Oregon,G,2,0,5,0,1,.000,0,1,.000,0,0,,0,0,,0,0,0,0,0,0,0,1,0,-0.6
13130,Robbie Feinberg\robbie-feinberg-1,2016-17,Harvard,G,2,0,1,0,1,.000,0,0,,0,1,.000,0,0,,0,0,0,0,0,0,0,0,0,-0.4
13131,Kade Kinnamon\kade-kinnamon-1,2016-17,Kansas State,G,7,0,8,0,0,,0,0,,0,0,,0,0,,0,0,0,2,0,0,0,1,0,0.1
13132,John Yi\john-yi-1,2015-16,Pepperdine,G,1,0,7,0,2,.000,0,0,,0,2,.000,0,1,.000,0,0,0,2,0,0,1,1,0,-1.8
13133,Austin Eagleton\austin-eagleton-1,2013-14,Saint Louis,G,5,0,6,0,0,,0,0,,0,0,,0,0,,0,0,0,0,0,0,2,0,0,-0.4
13134,Jack Konstanzer\jack-konstanzer-1,2016-17,North Carolina-Greensboro,G,1,0,3,0,0,,0,0,,0,0,,0,0,,0,0,0,0,0,0,0,0,0,0.0
13135,Ryan Diew\ryan-diew-1,2016-17,Colgate,G,4,1,5,0,1,.000,0,0,,0,1,.000,0,0,,0,0,0,0,0,0,1,1,0,-0.5
13136,Zach Smith\zach-smith-2,2016-17,Pittsburgh,G,8,0,15,0,5,.000,0,0,,0,5,.000,0,0,,1,1,2,0,0,0,1,1,0,-0.5
13137,Steven Soukup\steven-soukup-1,2015-16,Iowa,G,6,0,14,0,4,.000,0,2,.000,0,2,.000,0,0,,0,4,4,1,0,0,0,1,0,-0.2
13138,Gavin Wilson\gavin-wilson-1,2015-16,Charlotte,G,4,0,6,0,2,.000,0,1,.000,0,1,.000,0,0,,0,0,0,0,0,0,1,0,0,-0.6
13139,Paulo Morastoni\paulo-morastoni-1,2017-18,Siena,G,4,0,5,0,0,,0,0,,0,0,,0,0,,0,0,0,0,0,0,0,1,0,-0.1
13140,Jeremiah Bozeman\jeremiah-bozeman-1,2016-17,Jackson State,G,1,0,0,0,0,,0,0,,0,0,,0,0,,1,0,1,0,0,0,0,0,0,0.7
13141,John Mosser\john-mosser-1,2014-15,Mercer,G,1,,3,0,1,.000,0,0,,0,1,.000,0,0,,1,0,1,1,0,0,0,0,0,0.7
13142,Laquarious Paige\laguarious-paige-1,2014-15,Indiana State,G,4,0,41,0,2,.000,0,1,.000,0,1,.000,0,1,.000,1,1,2,2,2,0,8,5,0,-1.9
13143,Caleb McGuire\caleb-mcguire-1,2016-17,St. Bonaventure,G,1,0,2,0,0,,0,0,,0,0,,0,0,,0,0,0,0,0,0,1,0,0,-1.0
13144,Mike Sutton\mike-sutton-2,2015-16,Syracuse,G,3,0,4,0,1,.000,0,0,,0,1,.000,0,0,,0,0,0,0,0,0,0,0,0,-0.2
13145,Jasen Baranowski\jasen-baranowski-1,2013-14,Minnesota,G,2,0,2,0,0,,0,0,,0,0,,0,0,,0,0,0,0,0,0,0,0,0,0.0
13146,Ray Kowalski\ray-kowalski-1,2016-17,Southeast Missouri State,G,2,0,1,0,1,.000,0,0,,0,1,.000,0,0,,0,1,1,0,0,0,0,0,0,-0.2
13147,James Fraschilla\james-fraschilla-1,2014-15,Oklahoma,G,7,0,13,0,1,.000,0,0,,0,1,.000,0,0,,0,0,0,2,0,0,1,1,0,-0.1
13148,Kyle Nugent\kyle-nugent-1,2016-17,Texas A&M,G,2,0,2,0,0,,0,0,,0,0,,0,0,,0,0,0,0,0,0,0,0,0,0.0
13149,Sam Halle\sam-halle-1,2015-16,Penn State,G,1,0,1,0,0,,0,0,,0,0,,0,0,,1,0,1,0,0,0,0,0,0,0.7
13150,Stephen Gavin\stephen-gavin-1,2016-17,Mercer,G,2,0,3,0,1,.000,0,1,.000,0,0,,0,0,,0,0,0,0,0,0,0,0,0,-0.4
13151,Nathan Harries\nathan-harries-1,2015-16,Colgate,G,2,0,2,0,0,,0,0,,0,0,,0,0,,0,0,0,0,0,0,0,0,0,0.0
13152,Tyler Smithpeters\tyler-smithpeters-1,2016-17,Southern Illinois,G,1,0,7,0,2,.000,0,2,.000,0,0,,0,0,,0,0,0,0,0,0,0,1,0,-1.8
13153,Mike Cohen\mike-cohen-2,2016-17,Auburn,G,2,0,4,0,0,,0,0,,0,0,,0,0,,0,0,0,1,0,0,0,0,0,0.4
13154,Alvin Cunningham\alvin-cunningham-1,2015-16,Florida Gulf Coast,G,4,0,8,0,1,.000,0,1,.000,0,0,,0,1,.000,0,2,2,0,0,0,0,0,0,-0.1
13155,Khyler Fields\khyler-fields-1,2013-14,Cleveland State,G,8,0,12,0,4,.000,0,3,.000,0,1,.000,0,0,,1,2,3,1,0,0,0,2,0,-0.2
13156,Brenton Petty\brenton-petty-1,2016-17,Fordham,G,5,0,7,0,1,.000,0,0,,0,1,.000,0,0,,0,0,0,1,0,0,0,2,0,-0.2
13157,Stephen Leazer\stephen-leazer-1,2014-15,Saint Louis,G,1,0,1,0,0,,0,0,,0,0,,0,0,,0,0,0,0,0,0,0,0,0,0.0
13158,Odri Dedolli\odri-dedolli-1,2017-18,Mount St. Mary's,G,1,0,2,0,1,.000,0,0,,0,1,.000,0,0,,0,1,1,0,0,0,0,0,0,-0.4
13159,Travis Berry\travis-berry-1,2016-17,Sacred Heart,G,1,0,1,0,0,,0,0,,0,0,,0,0,,0,0,0,0,0,0,0,0,0,0.0
13160,Carter Josephs\carter-josephs-1,2014-15,Vanderbilt,G,13,0,52,0,0,,0,0,,0,0,,0,2,.000,0,5,5,8,0,0,3,7,0,0.0
13161,Brad Woodson\brad-woodson-1,2017-18,Tennessee,G,2,0,6,0,2,.000,0,0,,0,2,.000,0,0,,0,0,0,0,0,0,0,1,0,-0.9
13162,Josh Pierre\josh-pierre-1,2014-15,Arkansas State,G,8,0,22,0,2,.000,0,0,,0,2,.000,0,0,,0,3,3,0,1,0,1,0,0,-0.1
13163,Jonny David\jonny-david-1,2017-18,Kentucky,G,6,0,4,0,0,,0,0,,0,0,,0,0,,0,0,0,0,0,0,2,1,0,-0.4
13164,Andrew Goldstein\andrew-goldstein-1,2013-14,Ohio State,G,2,0,2,0,1,.000,0,1,.000,0,0,,0,0,,0,0,0,0,0,0,0,1,0,-0.6
13165,Isaiah Rose\isaiah-rose-1,2017-18,Kennesaw State,G,1,0,1,0,0,,0,0,,0,0,,0,0,,0,1,1,0,0,0,0,0,0,0.3
13166,Jemaa Yuori\jemaa-yuoir-1,2015-16,Quinnipiac,G,1,0,1,0,0,,0,0,,0,0,,0,0,,0,0,0,0,0,0,0,0,0,0.0
13167,Paul Baxter\paul-baxter-1,2015-16,Sam Houston State,G,1,0,0,0,0,,0,0,,0,0,,0,0,,1,0,1,0,0,0,0,0,0,0.7
13168,Jaiquan Manning\jaiquan-manning-1,2014-15,Maryland-Eastern Shore,G,1,0,0,0,0,,0,0,,0,0,,0,0,,0,0,0,0,0,0,0,0,0,0.0
13169,Devin Waddell\devin-waddell-1,2013-14,Auburn,G,3,0,3,0,0,,0,0,,0,0,,0,0,,0,0,0,0,0,0,0,1,0,-0.1
13170,Nils Taylor\nils-taylor-1,2017-18,Iona,G,2,0,2,0,0,,0,0,,0,0,,0,0,,0,0,0,1,0,0,0,1,0,0.2
13171,Mark Crowe\mark-crowe-1,2016-17,Cal Poly,G,1,0,0,0,0,,0,0,,0,0,,0,0,,0,1,1,0,0,0,0,0,0,0.3
13172,Tanner Tapp\tanner-tapp-1,2017-18,Samford,G,9,1,22,0,6,.000,0,2,.000,0,4,.000,0,0,,0,0,0,2,1,0,4,1,0,-0.7
13173,Seth Dittmer\seth-dittmer-1,2016-17,Milwaukee,G,2,0,2,0,1,.000,0,0,,0,1,.000,0,0,,0,1,1,0,0,0,0,0,0,-0.2
13174,Nate Velasco\nate-velasco-1,2013-14,Texas State,G,7,0,14,0,0,,0,0,,0,0,,0,0,,0,1,1,1,0,0,1,1,0,-0.1
13175,Hudson Urbanus\hudson-urbanus-1,2016-17,Texas-El Paso,G,8,0,22,0,6,.000,0,1,.000,0,5,.000,0,0,,1,2,3,3,1,0,3,2,0,-0.5
13176,EJ Floreal\ej-floreal-1,2015-16,Kentucky,G,12,0,16,0,1,.000,0,1,.000,0,0,,0,2,.000,1,5,6,0,0,0,1,0,0,0.0
13177,Gerald Smith\gerald-smith-1,2014-15,Samford,G,3,0,15,0,4,.000,0,2,.000,0,2,.000,0,0,,0,1,1,2,0,0,1,1,0,-0.8
13178,Markel Leonard\markel-leonard-1,2013-14,Cal Poly,G,4,0,11,0,4,.000,0,1,.000,0,3,.000,0,0,,0,1,1,0,0,0,1,2,0,-1.1
13179,Malachi Rice\malachi-rice-1,2017-18,Georgia Tech,G,6,0,6,0,1,.000,0,1,.000,0,0,,0,0,,0,0,0,0,0,0,1,0,0,-0.3
13180,Julian Robertson\julian-robertson-1,2013-14,Eastern Illinois,G,2,0,2,0,0,,0,0,,0,0,,0,0,,0,0,0,0,0,0,1,1,0,-0.7
13181,Beau Brown\beau-brown-1,2015-16,South Dakota State,G,1,0,0,0,0,,0,0,,0,0,,0,0,,0,0,0,0,0,0,0,0,0,0.0
13182,Torry Johnson\torry-johnson-1,2016-17,Northern Arizona,G,2,0,0,0,0,,0,0,,0,0,,0,0,,0,1,1,0,0,0,0,0,0,0.2
13183,Sergine Athj\sergine-athj-1,2015-16,Cal Poly,G,1,0,0,0,0,,0,0,,0,0,,0,0,,0,1,1,0,0,0,0,0,0,0.3
13184,Nick Pagliuca\nick-pagliuca-1,2016-17,Duke,G,5,0,8,0,2,.000,0,0,,0,2,.000,0,0,,0,0,0,2,0,0,0,0,0,0.0
13185,Dontel Highsmith\dontel-highsmith-1,2015-16,Northern Illinois,G,1,0,1,0,0,,0,0,,0,0,,0,0,,0,0,0,0,0,0,0,0,0,0.0
13186,Tarale Murry\tarale-murry-1,2013-14,Texas,G,5,0,8,0,4,.000,0,1,.000,0,3,.000,0,2,.000,0,0,0,0,0,1,1,1,0,-0.9
13187,Kevin Dunleavy\kevin-dunleavy-1,2014-15,Southern Methodist,G,7,0,14,0,3,.000,0,1,.000,0,2,.000,0,1,.000,0,2,2,0,0,0,2,1,0,-0.6
13188,Rodney Gill\rodney-gill-1,2017-18,Southern Mississippi,G,9,0,31,0,10,.000,0,5,.000,0,5,.000,0,2,.000,2,2,4,4,2,0,1,2,0,-0.3
13189,J.R. William\jr-williams-1,2015-16,Saint Peter's,G,5,0,5,0,0,,0,0,,0,0,,0,0,,0,0,0,0,0,0,0,0,0,0.0
13190,Jake Shaper\jake-shaper-1,2017-18,Brown,G,2,0,4,0,1,.000,0,0,,0,1,.000,0,0,,0,0,0,0,0,0,0,0,0,-0.4
13191,Dwaun Anderson\dwaun-anderson-1,2014-15,Wagner,G,1,0,6,0,2,.000,0,2,.000,0,0,,0,0,,0,3,3,0,0,0,0,2,0,-1.3
13192,Omar Ndiaye\omar-ndiaye-1,2017-18,Northern Arizona,G,1,0,1,0,1,.000,0,0,,0,1,.000,0,0,,0,0,0,0,0,0,0,0,0,-0.7
13193,William Dupuy\william-dupuy-1,2014-15,Dayton,G,5,0,4,0,0,,0,0,,0,0,,0,0,,0,0,0,0,0,0,0,0,0,0.0
13194,Jamelle Christian\jamelle-christian-1,2014-15,Delaware State,G,1,0,0,0,0,,0,0,,0,0,,0,0,,1,0,1,0,0,0,0,0,0,0.7
13195,Matt Grassi\matt-grassi-1,2014-15,Delaware,G,3,0,4,0,0,,0,0,,0,0,,0,0,,0,0,0,1,0,0,0,0,0,0.2
13196,Reece Williams\reece-williams-1,2013-14,Albany (NY),G,5,0,5,0,1,.000,0,1,.000,0,0,,0,0,,0,1,1,0,0,0,1,0,0,-0.3
13197,Manu Giamoukis\manu-giamoukis-1,2016-17,Davidson,G,7,1,7,0,2,.000,0,0,,0,2,.000,0,0,,0,0,0,0,1,0,0,1,0,-0.1
13198,Michael Orlich\michael-orlich-1,2017-18,San Francisco,G,2,0,2,0,0,,0,0,,0,0,,0,0,,0,0,0,0,0,0,2,0,0,-1.0
13199,Isiah Patterson\isiah-patterson-1,2013-14,Grambling,G,1,0,0,0,2,.000,0,0,,0,2,.000,0,0,,0,0,0,0,0,0,0,0,0,-1.4
13200,Temi Aiyegbusi\temi-aiyegbusi-1,2017-18,Connecticut,G,1,0,0,0,0,,0,0,,0,0,,0,0,,0,0,0,0,0,0,0,0,0,0.0
13201,Antonio Bisutti\antonio-bisutti-1,2017-18,Ohio,G,6,0,13,0,5,.000,0,3,.000,0,2,.000,0,0,,0,0,0,1,0,0,0,0,0,-0.5
13202,Patrick Conroy\patrick-conroy-1,2013-14,Nevada,G,2,0,3,0,1,.000,0,0,,0,1,.000,0,0,,0,1,1,0,0,0,0,0,0,-0.2
13203,Des Curry\des-curry-1,2015-16,Jacksonville State,G,1,0,0,0,0,,0,0,,0,0,,0,0,,0,0,0,0,0,0,0,0,0,0.0
13204,David Haus\david-haus-1,2016-17,Duquesne,G,8,0,12,0,0,,0,0,,0,0,,0,0,,1,3,4,2,0,0,2,1,0,0.1
13205,Montraz Oliver\montraz-oliver-1,2016-17,Maryland-Eastern Shore,G,1,0,0,0,0,,0,0,,0,0,,0,1,.000,0,0,0,0,0,0,0,0,0,-0.4
13206,Andrew Mitchell\andrew-mitchell-3,2014-15,Xavier,G,3,0,4,0,0,,0,0,,0,0,,0,0,,0,1,1,0,0,0,0,0,0,0.1
13207,J.T. Trauber\jt-trauber-1,2017-18,Rice,G,4,1,8,0,3,.000,0,1,.000,0,2,.000,0,0,,0,1,1,1,0,0,0,2,0,-0.5
13208,Kevin Brown\kevin-brown-1,2016-17,American,G,5,0,1,0,0,,0,0,,0,0,,0,0,,0,0,0,0,0,0,0,4,0,-0.3
13209,Corey Raley-Ross\corey-raley-ross-1,2013-14,Buffalo,G,11,1,23,0,1,.000,0,1,.000,0,0,,0,0,,0,3,3,2,0,1,2,4,0,-0.1
13210,Jason Camus\jason-camus-1,2015-16,Manhattan,G,1,0,1,0,0,,0,0,,0,0,,0,0,,0,0,0,0,0,0,0,0,0,0.0
13211,Dalton Cesarz\dalton-cesarz-1,2013-14,Saint Francis (PA),G,4,0,8,0,2,.000,0,1,.000,0,1,.000,0,0,,0,1,1,0,1,0,0,0,0,0.0
13212,Anthony Bilas\anthony-bilas-1,2016-17,Wake Forest,G,2,0,2,0,1,.000,0,1,.000,0,0,,0,0,,0,0,0,0,0,0,0,1,0,-0.6
13213,Braiten Madrigal\braiten-madrigal-1,2014-15,Boston University,G,4,0,8,0,2,.000,0,0,,0,2,.000,0,0,,0,0,0,0,1,0,0,0,0,-0.1
13214,James Carlton\james-carlton-1,2013-14,Howard,G,1,0,1,0,0,,0,0,,0,0,,0,0,,0,0,0,0,0,0,0,0,0,0.0
13215,Jaspin Canteen\jaspin-canteen-1,2014-15,Jacksonville,G,4,0,6,0,3,.000,0,1,.000,0,2,.000,0,0,,0,1,1,0,0,0,0,0,0,-0.5
13216,Curtis McRoy\curtis-mcroy-1,2016-17,Delaware,G,13,4,78,0,3,.000,0,2,.000,0,1,.000,0,0,,0,5,5,7,4,0,1,5,0,0.4
13217,Reilly Walsh\reilly-walsh-1,2015-16,NJIT,G,7,0,23,0,2,.000,0,1,.000,0,1,.000,0,1,.000,0,1,1,0,0,0,0,1,0,-0.3
13218,Rory Temkin\rory-temkin-1,2014-15,Rhode Island,G,2,0,2,0,0,,0,0,,0,0,,0,0,,0,0,0,0,0,0,0,0,0,0.0
13219,Anfernee Robinson\anfernee-robinson-1,2013-14,Maryland-Eastern Shore,G,2,0,4,0,1,.000,0,1,.000,0,0,,0,0,,0,1,1,0,1,0,1,0,0,-0.2
13220,Lexx Edwards\lexx-edwards-1,2014-15,Florida,G,10,0,24,0,1,.000,0,0,,0,1,.000,0,0,,0,5,5,1,0,0,0,5,0,-0.1
13221,Keoni Wallington\keoni-wallington-1,2017-18,Longwood,G,1,0,0,0,0,,0,0,,0,0,,0,0,,0,0,0,0,0,0,0,1,0,-0.4
13222,Brooks Doyle\brooks-doyle-1,2014-15,Georgia Tech,G,4,0,19,0,3,.000,0,1,.000,0,2,.000,0,0,,0,1,1,0,0,0,1,2,0,-0.9
13223,Jesse Pistokache\jesse-pistokache-1,2016-17,Richmond,G,4,0,5,0,1,.000,0,0,,0,1,.000,0,0,,0,0,0,1,0,0,0,1,0,-0.1
13224,Byron Abrams\byron-abrams-1,2017-18,Florida Atlantic,G,3,0,9,0,2,.000,0,0,,0,2,.000,0,0,,0,0,0,0,0,0,0,0,0,-0.5
13225,Josh Hanson\josh-hanson-1,2015-16,Stanford,G,4,0,7,0,3,.000,0,0,,0,3,.000,0,0,,0,1,1,0,0,0,0,2,0,-0.7
13226,Britton Anderson\britton-anderson-1,2015-16,Wake Forest,G,1,0,1,0,0,,0,0,,0,0,,0,0,,0,0,0,0,0,0,0,0,0,0.0
13227,Christian Pierce\christian-pierce-1,2013-14,James Madison,G,7,1,14,0,3,.000,0,1,.000,0,2,.000,0,0,,0,0,0,0,1,0,2,1,0,-0.5
13228,Gerald Smith\gerald-smith-1,2015-16,Samford,G,3,0,31,0,4,.000,0,2,.000,0,2,.000,0,0,,2,2,4,2,1,0,1,5,0,-0.5
13229,Sedrick Barefield\sedrick-barefield-1,2015-16,Southern Methodist,G,5,0,16,0,4,.000,0,2,.000,0,2,.000,0,1,.000,0,4,4,2,0,0,1,0,0,-0.3
13230,Tyler Simmons\tyler-simmons-1,2015-16,Central Arkansas,G,1,0,0,0,0,,0,0,,0,0,,0,0,,0,0,0,1,0,0,0,0,0,0.7
13231,Kam Rowan\kam-rowan-1,2014-15,Western Illinois,G,4,0,5,0,0,,0,0,,0,0,,0,0,,0,0,0,0,1,0,1,1,0,-0.1
13232,Nathan Laing\nathan-laing-1,2015-16,Jacksonville State,G,8,0,18,0,5,.000,0,1,.000,0,4,.000,0,0,,1,0,1,1,0,0,0,0,0,-0.3
13233,Zach Yoshor\zach-yoshor-1,2016-17,Harvard,G,2,0,2,0,0,,0,0,,0,0,,0,0,,0,0,0,1,0,0,0,0,0,0.4
13234,Armon Fletcher\armon-fletcher-1,2014-15,Southern Illinois,G,1,0,0,0,0,,0,0,,0,0,,0,0,,0,0,0,0,0,0,0,0,0,0.0
13235,Shaun Belbey\shaun-belbey-1,2015-16,Syracuse,G,3,0,4,0,1,.000,0,1,.000,0,0,,0,0,,0,0,0,0,0,0,1,0,0,-0.6
13236,Marcel Simon\marcel-simon-1,2013-14,Texas-Rio Grande Valley,G,2,0,4,0,1,.000,0,0,,0,1,.000,0,0,,0,0,0,1,0,0,1,0,0,-0.5
13237,Matt MacDougall\matt-macdougall-1,2013-14,Northern Iowa,G,4,0,12,0,3,.000,0,3,.000,0,0,,0,0,,0,1,1,0,0,0,1,1,0,-0.8
13238,Dillon Pulliam\dillon-pulliam-1,2016-17,Kentucky,G,6,0,8,0,1,.000,0,1,.000,0,0,,0,0,,0,1,1,1,0,0,1,0,0,-0.1
13239,Brian Vonderhaar\brian-vonderhaar-1,2013-14,Dayton,G,3,0,2,0,0,,0,0,,0,0,,0,0,,0,0,0,0,0,0,0,0,0,0.0
13240,Grant Fogerty\grant-fogerty-1,2016-17,Arizona State,G,2,0,2,0,0,,0,0,,0,0,,0,0,,0,0,0,0,0,0,0,0,0,0.0
13241,Matt Ferris\matt-ferris-1,2016-17,Wisconsin,G,9,0,11,0,5,.000,0,3,.000,0,2,.000,0,0,,3,2,5,2,1,0,0,1,0,0.1
13242,Samir Kalil\samir-kalil-1,2013-14,Quinnipiac,G,8,0,7,0,0,,0,0,,0,0,,0,0,,0,1,1,0,0,0,0,0,0,0.0
13243,Grant Youngkin\grant-youngkin-1,2017-18,Rice,G,1,0,2,0,1,.000,0,1,.000,0,0,,0,0,,0,0,0,0,0,0,0,0,0,-0.7
13244,Pat Lenehan\pat-lenehan-1,2014-15,Connecticut,G,6,0,7,0,1,.000,0,1,.000,0,0,,0,0,,0,2,2,0,0,1,0,1,0,0.0
13245,D'Quan Applewhite\dquan-applewhite-1,2016-17,Southern Illinois-Edwardsville,G,2,0,2,0,0,,0,0,,0,0,,0,0,,0,0,0,0,0,0,0,0,0,0.0
13246,Jordan Reed\jordan-reed-1,2015-16,Tennessee State,G,1,0,1,0,0,,0,0,,0,0,,0,0,,0,0,0,0,0,0,0,0,0,0.0
13247,Kendal Shell\kendal-shell-1,2013-14,Minnesota,G,8,0,7,0,2,.000,0,1,.000,0,1,.000,0,0,,0,0,0,0,0,0,0,0,0,-0.2
13248,Zack Allen\zack-allen-1,2013-14,North Carolina-Wilmington,G,7,1,12,0,2,.000,0,0,,0,2,.000,0,0,,0,0,0,1,0,0,0,2,0,-0.2
13249,Chance Garvin\chance-garvin-1,2016-17,Idaho,G,1,0,1,0,0,,0,0,,0,0,,0,0,,0,0,0,0,0,0,0,0,0,0.0
13250,Talbott Denny\talbott-denny-1,2015-16,Lipscomb,G,1,0,3,0,0,,0,0,,0,0,,0,0,,0,0,0,0,0,0,0,0,0,0.0
13251,Geoffrey Bates\geoffrey-bates-1,2014-15,Colorado,G,5,0,3,0,0,,0,0,,0,0,,0,0,,0,0,0,0,0,0,0,1,0,-0.1
13252,Tre McKeithen\tre-mckeithen-1,2017-18,Saint Francis (PA),G,7,0,18,0,5,.000,0,0,,0,5,.000,0,0,,0,1,1,2,0,0,0,3,0,-0.4
13253,Nic Thomas\nic-thomas-1,2015-16,Houston Baptist,G,3,0,8,0,4,.000,0,4,.000,0,0,,0,0,,0,1,1,1,0,0,1,0,0,-0.9
13254,Jack Buckmelter\jack-buckmelter-1,2016-17,Colgate,G,1,0,1,0,0,,0,0,,0,0,,0,0,,0,0,0,0,0,0,0,0,0,0.0
13255,Cam Marotta\cam-marotta-1,2017-18,Marquette,G,7,0,12,0,2,.000,0,1,.000,0,1,.000,0,0,,0,1,1,0,0,0,0,2,0,-0.3
13256,Brandon Young\brandon-young-2,2016-17,Georgia,G,7,1,9,0,4,.000,0,3,.000,0,1,.000,0,0,,0,1,1,0,0,0,0,0,0,-0.4
13257,Mory Diane\mory-diane-1,2015-16,Buffalo,G,3,0,15,0,3,.000,0,3,.000,0,0,,0,0,,0,0,0,0,1,0,1,1,0,-0.8
13258,Robbie Stenzel\robbie-stenzel-1,2013-14,Eastern Kentucky,G,6,0,12,0,0,,0,0,,0,0,,0,0,,0,2,2,2,1,0,1,1,0,0.3
13259,Cameron Young\cameron-young-1,2016-17,Quinnipiac,G,6,0,8,0,4,.000,0,1,.000,0,3,.000,0,0,,1,0,1,0,0,1,0,0,0,-0.2
13260,Daniel Stensland\daniel-stensland-1,2014-15,Iowa State,G,4,0,8,0,0,,0,0,,0,0,,0,0,,0,1,1,1,0,0,0,0,0,0.3
13261,Chase Driscoll\chase-driscoll-1,2017-18,North Florida,G,7,0,13,0,3,.000,0,2,.000,0,1,.000,0,1,.000,0,1,1,0,0,0,0,2,0,-0.4
13262,Tyree Chambers\tyree-chambers-1,2014-15,Providence,G,3,0,5,0,1,.000,0,0,,0,1,.000,0,0,,0,0,0,0,0,0,0,2,0,-0.5
13263,Jack Westerfield\jack-westerfield-1,2015-16,Dayton,G,1,0,1,0,0,,0,0,,0,0,,0,0,,0,0,0,0,0,0,0,0,0,0.0
13264,Tyrone Cohen\tyrone-cohen-1,2016-17,Holy Cross,G,1,0,2,0,1,.000,0,1,.000,0,0,,0,0,,0,1,1,0,0,0,0,0,0,-0.4
13265,Zach Rumph\zach-rumph-1,2014-15,Southeastern Louisiana,G,12,0,46,0,3,.000,0,2,.000,0,1,.000,0,0,,0,5,5,3,2,0,6,6,0,-0.4
13266,Jimmy Jent\jimmy-jent-1,2015-16,Wofford,G,7,0,12,0,6,.000,0,2,.000,0,4,.000,0,0,,0,2,2,0,0,0,1,0,0,-0.7
13267,Sam Hershberger\sam-hershberger-1,2013-14,Elon,G,3,0,9,0,1,.000,0,0,,0,1,.000,0,0,,0,1,1,1,0,0,0,1,0,0.0
13268,Nate Johnson\nate-johnson-6,2016-17,Gardner-Webb,G,1,0,0,0,0,,0,0,,0,0,,0,0,,0,1,1,0,0,0,0,0,0,0.3
13269,Nick Vanderpohl\nick-vanderpohl-1,2017-18,Xavier,G,4,0,4,0,0,,0,0,,0,0,,0,0,,0,0,0,1,0,0,0,0,0,0.2
13270,DeVante Mayes\devante-mayes-1,2015-16,Western Illinois,G,3,0,8,0,3,.000,0,0,,0,3,.000,0,0,,1,1,2,2,1,0,0,0,0,0.4
13271,Rasheed James\rasheed-james-1,2013-14,Jackson State,G,8,0,6,0,0,,0,0,,0,0,,0,0,,0,0,0,0,0,0,0,2,0,-0.1
13272,Jamal Smith\jamal-smith-2,2015-16,Cal State Fullerton,G,1,0,2,0,0,,0,0,,0,0,,0,0,,0,0,0,0,0,0,0,0,0,0.0
13273,Christian Pino\christian-pino-1,2015-16,Buffalo,G,10,0,17,0,6,.000,0,2,.000,0,4,.000,0,0,,0,0,0,1,0,1,2,2,0,-0.6
13274,Benjamin James\benjamin-james-1,2013-14,New Orleans,G,1,0,3,0,0,,0,0,,0,0,,0,0,,0,0,0,0,0,0,2,1,0,-2.4
13275,Cameron Galic\cameron-galic-1,2017-18,Tulane,G,2,0,3,0,1,.000,0,1,.000,0,0,,0,0,,0,1,1,0,0,0,0,0,0,-0.2
13276,Mason Schoen\mason-schoen-1,2017-18,Kansas State,G,13,0,20,0,4,.000,0,2,.000,0,2,.000,0,0,,0,0,0,1,0,0,1,0,0,-0.2
13277,Josh Crumpler\josh-crumpler-1,2015-16,Campbell,G,1,0,1,0,0,,0,0,,0,0,,0,0,,0,0,0,0,0,0,0,0,0,0.0
13278,John Koz\john-koz-1,2016-17,Cincinnati,G,6,0,10,0,2,.000,0,0,,0,2,.000,0,0,,0,2,2,2,0,0,0,0,0,0.1
13279,Kyle Cooney\kyle-cooney-1,2017-18,La Salle,G,6,0,7,0,1,.000,0,0,,0,1,.000,0,0,,1,0,1,1,0,0,0,1,0,0.1
13280,Mitch Lombard\mitch-lombard-1,2015-16,Colorado,G,6,0,9,0,1,.000,0,1,.000,0,0,,0,0,,0,0,0,1,0,0,0,0,0,0.0
13281,Brian Wright\brian-wright-2,2014-15,UC-Riverside,G,9,0,22,0,1,.000,0,0,,0,1,.000,0,0,,0,1,1,1,0,1,1,3,0,-0.1
13282,Kevin Lynch\kevin-lynch-3,2013-14,Seton Hall,G,4,1,7,0,1,.000,0,0,,0,1,.000,0,0,,0,0,0,0,0,0,0,4,0,-0.6
13283,Josh Thompson\josh-thompson-1,2016-17,Ball State,G,4,0,7,0,2,.000,0,2,.000,0,0,,0,1,.000,0,0,0,0,0,0,5,1,0,-1.8
13284,Zane Stull\zane-stull-1,2013-14,Wyoming,G,4,0,6,0,0,,0,0,,0,0,,0,0,,0,0,0,0,0,0,1,0,0,-0.3
13285,Lyles Davis\lyles-davis-1,2017-18,Clemson,G,4,0,8,0,2,.000,0,1,.000,0,1,.000,0,0,,0,1,1,1,0,0,1,0,0,-0.4
13286,Erik Goldbach\erik-goldbach-1,2016-17,College of Charleston,G,3,1,5,0,2,.000,0,0,,0,2,.000,0,0,,0,1,1,0,0,0,1,0,0,-0.7
13287,Jacob Fleschman\jacob-fleschman-1,2017-18,Tennessee,G,2,0,5,0,0,,0,0,,0,0,,0,0,,0,0,0,0,0,0,0,0,0,0.0
13288,Darnell Vandivort\darnell-vandivort-1,2013-14,Texas-El Paso,G,3,0,3,0,0,,0,0,,0,0,,0,0,,0,0,0,0,0,0,0,0,0,0.0
13289,Brennan Besser\brennan-besser-1,2015-16,Duke,G,1,0,1,0,1,.000,0,0,,0,1,.000,0,0,,0,0,0,0,0,0,0,0,0,-0.7
13290,Nick Mora\nick-mora-1,2017-18,Texas-Rio Grande Valley,G,3,0,5,0,0,,0,0,,0,0,,0,0,,0,1,1,2,0,0,2,1,0,-0.2
13291,Bryson Lockley\bryson-lockley-1,2015-16,Santa Clara,G,2,0,5,0,1,.000,0,0,,0,1,.000,0,0,,0,0,0,0,0,0,0,0,0,-0.4
13292,Mitch Warner\mitch-warner-1,2015-16,Charlotte,G,2,0,2,0,2,.000,0,0,,0,2,.000,0,0,,0,0,0,0,0,0,0,2,0,-1.1
13293,Raiquan Clark\raiquan-clark-1,2015-16,Long Island University,G,1,0,2,0,0,,0,0,,0,0,,0,0,,0,0,0,1,0,0,0,0,0,0.7
13294,Tate Morse\tate-morse-1,2016-17,Central Florida,G,2,0,4,0,2,.000,0,0,,0,2,.000,0,0,,0,0,0,1,0,0,0,0,0,-0.4
13295,Nile Felton\nile-felton-1,2017-18,Georgia State,G,12,0,13,0,3,.000,0,1,.000,0,2,.000,0,0,,1,2,3,0,0,0,0,2,0,-0.1
13296,Andrew Sorrells\andrew-sorrells-1,2015-16,Texas Tech,G,6,0,11,0,2,.000,0,0,,0,2,.000,0,0,,0,1,1,0,0,0,1,1,0,-0.4
13297,Nick Kazemi\nick-kazemi-1,2013-14,UCLA,G,10,0,14,0,3,.000,0,3,.000,0,0,,0,0,,1,3,4,0,0,0,0,1,0,-0.1
13298,KJ Garrett\kj-garrett-1,2015-16,Washington,G,7,0,13,0,7,.000,0,4,.000,0,3,.000,0,1,.000,0,0,0,0,0,2,0,6,0,-0.9
13299,Russ DeRemer\russ-deremer-1,2013-14,Syracuse,G,4,0,6,0,1,.000,0,0,,0,1,.000,0,0,,0,0,0,0,0,0,1,2,0,-0.6
13300,Ryan Kapustka\ryan-kapustka-1,2014-15,Michigan,G,1,0,1,0,0,,0,0,,0,0,,0,0,,0,0,0,0,0,0,0,0,0,0.0
13301,Justin Colvin\justin-colvin-1,2015-16,Alabama A&M,G,1,0,1,0,0,,0,0,,0,0,,0,0,,0,0,0,0,0,0,0,0,0,0.0
13302,Lance Lawson\lance-lawson-1,2017-18,Army,G,2,0,6,0,0,,0,0,,0,0,,0,0,,0,0,0,3,0,0,0,1,0,0.9
13303,Chase Cannon\chase-cannon-1,2013-14,North Carolina State,G,5,0,6,0,3,.000,0,0,,0,3,.000,0,0,,1,0,1,1,0,1,1,0,0,-0.2
13304,Ethan Lasko\ethan-lasko-1,2017-18,Indiana,G,1,0,1,0,0,,0,0,,0,0,,0,0,,0,0,0,0,0,0,0,0,0,0.0
13305,Nile Felton\nile-felton-1,2016-17,Georgia State,G,10,0,8,0,3,.000,0,0,,0,3,.000,0,0,,0,2,2,0,1,0,1,0,0,-0.2
13306,Trevor Glassman\trevor-glassman-1,2013-14,Manhattan,G,4,0,3,0,3,.000,0,1,.000,0,2,.000,0,0,,0,0,0,0,0,0,0,1,0,-0.6
13307,Galen Campbell\galen-campbell-1,2014-15,Tennessee,G,2,0,2,0,0,,0,0,,0,0,,0,0,,0,0,0,0,0,0,0,1,0,-0.2
13308,John Moran\john-moran-1,2013-14,Richmond,G,2,0,2,0,0,,0,0,,0,0,,0,0,,0,0,0,0,0,0,0,1,0,-0.2
13309,John Eck\john-eck-1,2015-16,College of Charleston,G,4,0,8,0,2,.000,0,2,.000,0,0,,0,0,,0,2,2,1,0,0,0,3,0,-0.3
13310,Jared Harper\jared-harper-1,2015-16,Fairfield,G,3,0,1,0,0,,0,0,,0,0,,0,0,,0,1,1,0,1,0,0,0,0,0.4
13311,Steve Sorenson\steve-sorenson-2,2013-14,Miami (FL),G,2,0,2,0,0,,0,0,,0,0,,0,0,,0,0,0,0,0,0,0,0,0,0.0
13312,Daniel Hummer\daniel-hummer-1,2016-17,Air Force,G,1,0,2,0,0,,0,0,,0,0,,0,0,,0,0,0,0,0,0,0,0,0,0.0
13313,Zach Allison\zach-allison-2,2015-16,Auburn,G,10,0,27,0,1,.000,0,1,.000,0,0,,0,0,,1,6,7,4,0,0,6,4,0,-0.3
13314,Jett Jobe\jett-jobe-1,2015-16,Mississippi State,G,7,0,14,0,3,.000,0,3,.000,0,0,,0,0,,0,2,2,1,0,0,0,1,0,-0.2
13315,Nate Duda\nate-duda-1,2017-18,Utah,G,1,0,4,0,0,,0,0,,0,0,,0,0,,0,0,0,0,0,0,0,0,0,0.0
13316,Donald Beatty\donald-beatty-1,2013-14,Toledo,G,5,0,6,0,1,.000,0,1,.000,0,0,,0,0,,0,0,0,0,0,0,0,1,0,-0.2
13317,Malcolm Wynter\malcolm-wynter-1,2016-17,Davidson,G,3,0,3,0,1,.000,0,0,,0,1,.000,0,0,,0,0,0,1,0,0,0,0,0,0.0
13318,Trey Moore\trey-moore-2,2013-14,Texas-San Antonio,G,5,0,13,0,2,.000,0,2,.000,0,0,,0,0,,0,1,1,6,0,0,1,0,0,0.4
13319,John Yi\john-yi-1,2014-15,Pepperdine,G,5,0,4,0,1,.000,0,1,.000,0,0,,0,0,,0,0,0,0,0,0,2,0,0,-0.5
13320,Jalen Sanders\jalen-sanders-1,2015-16,Appalachian State,G,1,0,1,0,0,,0,0,,0,0,,0,0,,0,0,0,1,0,0,1,0,0,-0.3
13321,Duke DaRe\duke-dare-1,2013-14,UC-Santa Barbara,G,4,0,8,0,1,.000,0,1,.000,0,0,,0,0,,0,0,0,0,0,0,1,1,0,-0.5
13322,Sam Norton\sam-norton-1,2015-16,Loyola (MD),G,6,0,7,0,2,.000,0,0,,0,2,.000,0,0,,0,1,1,1,1,0,0,3,0,-0.1
13323,Dusan Langura\dusan-langura-1,2014-15,Georgia,G,5,0,3,0,3,.000,0,1,.000,0,2,.000,0,0,,0,0,0,0,0,0,0,0,0,-0.4
13324,Jacob Talbert\jacob-talbert-1,2013-14,Campbell,G,1,0,2,0,0,,0,0,,0,0,,0,0,,0,1,1,0,0,0,0,2,0,-0.5
13325,Kyle Massie\kyle-massie-1,2016-17,Texas-San Antonio,G,7,0,15,0,7,.000,0,1,.000,0,6,.000,0,1,.000,2,0,2,1,0,0,0,0,0,-0.5
13326,Anthony DeRiggs\anthony-deriggs-1,2013-14,Colgate,G,5,0,3,0,0,,0,0,,0,0,,0,0,,0,0,0,0,0,0,0,0,0,0.0
13327,Opeyemi Olomo\opeyemi-olomo-1,2014-15,St. Bonaventure,G,2,0,1,0,2,.000,0,0,,0,2,.000,0,0,,0,0,0,0,0,0,1,0,0,-1.2
13328,Daniel Harper\daniel-harper-1,2015-16,Oklahoma,G,5,0,14,0,3,.000,0,2,.000,0,1,.000,0,0,,1,0,1,0,3,0,1,0,0,0.1
13329,David Varoli\david-varoli-1,2013-14,Niagara,G,1,0,2,0,0,,0,0,,0,0,,0,0,,0,0,0,0,0,0,0,0,0,0.0
13330,Jacob Orender\jacob-orender-1,2016-17,Lafayette,G,1,0,1,0,0,,0,0,,0,0,,0,0,,0,0,0,0,0,0,0,0,0,0.0
13331,Peyton Heck\peyton-heck-1,2017-18,Villanova,G,11,0,15,0,1,.000,0,0,,0,1,.000,0,0,,1,1,2,0,0,0,0,0,0,0.0
13332,Jacob Susskind\jacob-susskind-1,2013-14,Maryland,G,5,0,10,0,3,.000,0,1,.000,0,2,.000,0,0,,0,2,2,1,0,0,1,0,0,-0.4
13333,Matt DiLuccio\matt-diluccio-1,2017-18,Boston College,G,2,0,2,0,0,,0,0,,0,0,,0,0,,0,0,0,0,0,0,0,0,0,0.0
13334,Evan Dourdas\evan-dourdas-1,2016-17,Syracuse,G,3,0,3,0,0,,0,0,,0,0,,0,0,,0,0,0,0,0,0,1,0,0,-0.3
13335,Kaleb Mallory\kaleb-mallory-1,2016-17,Ball State,G,7,0,21,0,4,.000,0,3,.000,0,1,.000,0,1,.000,1,0,1,3,0,0,1,2,0,-0.3
13336,Jared Harper\jared-harper-1,2014-15,Fairfield,G,4,0,4,0,0,,0,0,,0,0,,0,0,,0,0,0,0,1,0,1,0,0,0.0
13337,Wyatt Voorhes\wyatt-voorhes-1,2015-16,Missouri-Kansas City,G,1,0,1,0,0,,0,0,,0,0,,0,0,,0,0,0,0,0,0,0,0,0,0.0
13338,Riley Conroy\riley-conroy-1,2016-17,Tulane,G,8,0,9,0,2,.000,0,1,.000,0,1,.000,0,0,,1,0,1,1,1,0,1,0,0,0.0
13339,Davonte Chaney\davonte-chaney-1,2013-14,Texas Southern,G,4,0,3,0,1,.000,0,1,.000,0,0,,0,0,,1,0,1,0,0,0,1,1,0,-0.4
13340,Keith Pinckney\keith-pinckney-1,2016-17,Old Dominion,G,9,0,30,0,2,.000,0,2,.000,0,0,,0,0,,0,1,1,0,0,0,0,2,0,-0.2
13341,Treyvon Francis\treyvon-francis-1,2015-16,Savannah State,G,1,0,0,0,1,.000,0,1,.000,0,0,,0,0,,0,0,0,0,0,0,0,0,0,-0.7
13342,Marcus Mathieu\marcus-mathieu-1,2013-14,McNeese State,G,1,0,0,0,0,,0,0,,0,0,,0,0,,0,0,0,0,0,0,1,0,0,-1.0
13343,Zach Hodskins\zach-hodskins-1,2014-15,Florida,G,4,0,7,0,2,.000,0,1,.000,0,1,.000,0,0,,0,0,0,0,0,0,1,1,0,-0.7
13344,David Favorite\david-favorite-1,2017-18,Colgate,G,1,0,2,0,0,,0,0,,0,0,,0,0,,0,0,0,0,0,0,0,0,0,0.0
13345,Milan Williams\milan-williams-1,2016-17,Colgate,G,2,0,2,0,0,,0,0,,0,0,,0,0,,0,1,1,0,0,0,0,0,0,0.2
13346,Joe Kirby\joe-kirby-1,2014-15,Richmond,G,3,0,6,0,2,.000,0,0,,0,2,.000,0,0,,0,1,1,2,0,1,0,0,0,0.3
13347,Mike Sutton\mike-sutton-2,2016-17,Syracuse,G,7,0,12,0,2,.000,0,0,,0,2,.000,0,1,.000,1,3,4,2,0,0,1,0,0,0.0
13348,Eric Wagenlander\eric-wagenlander-1,2016-17,Wofford,G,6,1,22,0,6,.000,0,0,,0,6,.000,0,0,,1,1,2,2,1,1,2,1,0,-0.4
13349,Antonio Robinson\antonio-robinson-2,2014-15,Louisiana State,G,1,0,4,0,0,,0,0,,0,0,,0,0,,0,1,1,0,0,0,1,0,0,-0.7
13350,Keith Oddo\keith-oddo-1,2016-17,Richmond,G,1,0,2,0,0,,0,0,,0,0,,0,0,,0,0,0,0,0,0,1,0,0,-1.0
13351,Sam Walters\sam-walters-1,2015-16,UC-Santa Barbara,G,8,0,16,0,3,.000,0,0,,0,3,.000,0,0,,0,1,1,1,0,0,3,1,0,-0.6
13352,Travis Berry\travis-berry-1,2013-14,Seton Hall,G,5,0,14,0,2,.000,0,1,.000,0,1,.000,0,0,,0,0,0,3,0,0,1,1,0,-0.1
13353,Elias Berbari\elias-berbari-1,2016-17,Princeton,G,4,0,8,0,4,.000,0,1,.000,0,3,.000,0,0,,0,1,1,0,0,0,0,0,0,-0.6
13354,Cole Martinez\cole-martinez-1,2015-16,Texas A&M-Corpus Christi,G,1,0,3,0,0,,0,0,,0,0,,0,0,,0,0,0,0,0,0,0,0,0,0.0
13355,Christian Harrison\christian-harrison-1,2017-18,Georgia,G,2,0,3,0,0,,0,0,,0,0,,0,0,,0,1,1,0,0,0,0,0,0,0.2
13356,Thomas Kennedy\thomas-kennedy-2,2015-16,Holy Cross,G,11,0,16,0,1,.000,0,0,,0,1,.000,0,0,,0,1,1,0,0,0,0,0,0,0.0
13357,Paulo Cruz\paulo-cruz-1,2017-18,Cal Poly,G,1,0,1,0,0,,0,0,,0,0,,0,0,,0,0,0,0,0,0,0,0,0,0.0
13358,Jordan Brown\jordan-brown-2,2013-14,Missouri-Kansas City,G,5,0,23,0,3,.000,0,3,.000,0,0,,0,0,,0,2,2,1,4,0,1,5,0,0.0
13359,Bobby Griffin\bobby-griffin-1,2013-14,Texas Southern,G,1,0,1,0,0,,0,0,,0,0,,0,0,,0,0,0,0,0,0,0,0,0,0.0
13360,Zaire Thompson\zaire-thompson-1,2014-15,Fordham,G,9,0,23,0,0,,0,0,,0,0,,0,0,,1,3,4,2,3,0,3,7,0,0.0
13361,Beau Brown\beau-brown-1,2017-18,South Dakota State,G,7,0,14,0,8,.000,0,1,.000,0,7,.000,0,0,,0,0,0,0,0,0,0,1,0,-0.9
13362,Richard Brown\richard-brown-2,2015-16,Army,G,3,0,7,0,1,.000,0,0,,0,1,.000,0,0,,0,0,0,0,0,0,3,0,0,-1.2
13363,Kyle McLeroy\kyle-mcleroy-1,2013-14,Sam Houston State,G,11,0,24,0,1,.000,0,0,,0,1,.000,0,1,.000,1,2,3,7,0,0,3,0,0,0.2
13364,Sam Malone\sam-malone-1,2013-14,Kentucky,G,1,0,0,0,0,,0,0,,0,0,,0,0,,0,0,0,0,0,0,0,0,0,0.0
13365,Adrian Carrion Armas\adrian-carrion-armas-1,2014-15,Grand Canyon,G,4,0,9,0,2,.000,0,1,.000,0,1,.000,0,2,.000,0,2,2,0,0,0,1,2,0,-0.9
13366,Chase Cannon\chase-cannon-1,2015-16,North Carolina State,G,2,0,2,0,4,.000,0,2,.000,0,2,.000,0,0,,1,1,2,0,0,0,0,0,0,-0.9
13367,Isaiah Butler\isaiah-butler-1,2014-15,Mississippi State,G,9,1,26,0,1,.000,0,0,,0,1,.000,0,0,,0,3,3,1,2,0,2,4,0,-0.1
13368,Haudrick Hilaire\haudrick-hilaire-1,2015-16,Jackson State,G,1,0,0,0,0,,0,0,,0,0,,0,0,,0,0,0,0,0,0,0,1,0,-0.4
13369,Taylor Wayer\taylor-wayer-1,2013-14,Indiana,G,4,0,4,0,4,.000,0,1,.000,0,3,.000,0,0,,1,2,3,0,0,0,0,0,0,-0.4
13370,James McLean\james-mclean-1,2015-16,Harvard,G,2,0,5,0,0,,0,0,,0,0,,0,0,,0,0,0,0,0,0,1,1,0,-0.7
13371,Richard Anderson\richard-anderson-2,2016-17,Oklahoma,G,3,0,5,0,1,.000,0,1,.000,0,0,,0,0,,0,0,0,0,0,0,0,0,0,-0.2
13372,Jordan Shea\jordan-shea-1,2014-15,Massachusetts-Lowell,G,1,,0,0,0,,0,0,,0,0,,0,0,,0,0,0,0,0,0,0,1,0,-0.4
13373,Chris Campbell\chris-campbell-2,2014-15,North Texas,G,7,0,16,0,2,.000,0,1,.000,0,1,.000,0,0,,1,4,5,2,0,0,0,5,0,0.0
13374,Sam Harris\sam-harris-2,2017-18,St. Francis (NY),G,10,0,12,0,2,.000,0,1,.000,0,1,.000,0,0,,0,0,0,0,1,0,1,0,0,-0.1
13375,Mike Lecak\mike-lecak-1,2013-14,Pittsburgh,G,11,0,17,0,5,.000,0,0,,0,5,.000,0,0,,0,1,1,3,0,0,1,3,0,-0.3
13376,Kade Kager\kade-kager-1,2013-14,American,G,3,0,2,0,0,,0,0,,0,0,,0,2,.000,0,1,1,0,0,0,0,0,0,-0.2
13377,Christian Vega\christian-vega-1,2015-16,Saint Joseph's,G,2,0,2,0,0,,0,0,,0,0,,0,0,,0,1,1,0,0,0,2,0,0,-0.9
13378,Zach Cooper\zach-cooper-1,2013-14,Penn State,G,6,1,5,0,0,,0,0,,0,0,,0,0,,0,1,1,0,0,0,0,0,0,0.1
13379,Charlie Noebel\charlie-noebel-1,2014-15,Oregon,G,4,0,6,0,1,.000,0,0,,0,1,.000,0,0,,0,1,1,0,0,0,2,1,0,-0.7
13380,Jason Shultis\jason-shultis-1,2016-17,Nebraska,G,2,0,3,0,0,,0,0,,0,0,,0,0,,1,2,3,0,0,0,0,0,0,0.7
13381,Davante Pope\davante-pope-1,2015-16,Alabama State,G,5,0,7,0,1,.000,0,0,,0,1,.000,0,0,,0,1,1,1,0,0,0,2,0,-0.1
13382,Jared Ertel\jared-ertel-1,2015-16,Pennsylvania,G,1,0,1,0,1,.000,0,0,,0,1,.000,0,0,,0,0,0,0,0,0,0,0,0,-0.7
13383,Michael Wearne\michael-wearne-1,2016-17,Eastern Washington,G,6,0,22,0,3,.000,0,1,.000,0,2,.000,0,0,,0,2,2,0,4,0,4,1,0,-0.3
13384,Jose Martinez\jose-martinez-2,2016-17,Texas-El Paso,G,6,0,8,0,1,.000,0,1,.000,0,0,,0,2,.000,1,2,3,0,0,1,0,2,0,-0.1
13385,Patrick Ryan\patrick-ryan-1,2013-14,Elon,G,2,0,5,0,1,.000,0,0,,0,1,.000,0,0,,0,1,1,0,0,1,1,0,0,-0.4
13386,Terry Henderson\terry-henderson-1,2015-16,North Carolina State,G,1,1,7,0,3,.000,0,2,.000,0,1,.000,0,0,,1,0,1,0,0,0,1,1,0,-2.8
13387,Alex Nesbitt\alex-nesbitt-1,2014-15,Harvard,G,3,1,9,0,0,,0,0,,0,0,,0,0,,0,0,0,0,0,0,1,0,0,-0.3
13388,Carlos Mancasola\carlos-mancasola-1,2013-14,UC-Davis,G,2,0,6,0,3,.000,0,0,,0,3,.000,0,0,,0,0,0,1,0,0,0,0,0,-0.7
13389,Adrian Autry\adrian-autry-1,2017-18,Syracuse,G,3,0,2,0,1,.000,0,0,,0,1,.000,0,0,,0,0,0,0,0,0,0,0,0,-0.2
13390,Cameron Maes\cameron-maes-1,2014-15,Missouri State,G,2,0,10,0,3,.000,0,1,.000,0,2,.000,0,0,,0,2,2,3,0,0,1,1,0,-0.4
13391,Darin Haugh\darin-haugh-1,2016-17,Minnesota,G,5,0,8,0,1,.000,0,0,,0,1,.000,0,0,,0,2,2,2,0,0,1,0,0,0.1
13392,Tre Houston\tre-houston-1,2016-17,Hampton,G,5,0,10,0,1,.000,0,1,.000,0,0,,0,0,,0,0,0,0,0,0,0,4,0,-0.5
13393,Phillip Jones\phillip-jones-3,2017-18,Howard,G,2,0,1,0,0,,0,0,,0,0,,0,0,,0,0,0,0,0,0,0,0,0,0.0
13394,Phillip McGloin\phillip-mcgloin-1,2014-15,Vanderbilt,G,5,0,5,0,1,.000,0,0,,0,1,.000,0,0,,0,3,3,1,0,0,3,0,0,-0.4
13395,Jacob Lunsford\jacob-lunsford-1,2015-16,Denver,G,1,0,1,0,0,,0,0,,0,0,,0,0,,0,0,0,0,0,0,0,0,0,0.0
13396,Andrew Nene\andrew-nene-1,2013-14,Massachusetts-Lowell,G,1,0,4,0,0,,0,0,,0,0,,0,0,,0,0,0,0,0,0,0,0,0,0.0
13397,Nate Johnson\nate-johnson-5,2015-16,Robert Morris,G,4,0,9,0,5,.000,0,2,.000,0,3,.000,0,0,,0,2,2,1,0,0,1,1,0,-0.9
13398,Jonathan Radner\jonathan-radner-1,2016-17,Syracuse,G,4,0,6,0,2,.000,0,1,.000,0,1,.000,0,0,,0,2,2,2,0,0,1,0,0,-0.1
13399,Travis Rice\travis-rice-1,2016-17,Northern Arizona,G,1,0,0,0,1,.000,0,0,,0,1,.000,0,0,,0,0,0,0,0,0,0,0,0,-0.7
13400,Will Decorah\will-decorah-1,2015-16,Wisconsin,G,4,0,3,0,1,.000,0,1,.000,0,0,,0,0,,1,0,1,0,0,0,1,1,0,-0.4
13401,Will Leviton\will-leviton-1,2017-18,Rhode Island,G,8,0,11,0,1,.000,0,1,.000,0,0,,0,0,,1,1,2,2,1,0,1,0,0,0.2
13402,Raquan Mitchell\raquan-mitchell-1,2015-16,Memphis,G,1,0,4,0,0,,0,0,,0,0,,0,0,,0,1,1,1,0,0,1,0,0,0.0
13403,Dallas Lussier\dallas-lussier-1,2016-17,Montana State,G,5,0,7,0,1,.000,0,0,,0,1,.000,0,0,,0,1,1,0,0,0,0,1,0,-0.2
13404,Jonathan Nazarko\jonathan-nazarko-1,2013-14,Rhode Island,G,7,0,6,0,2,.000,0,0,,0,2,.000,0,0,,0,1,1,0,0,0,0,1,0,-0.2
13405,Denny Grace\denny-grace-1,2016-17,Villanova,G,7,0,10,0,0,,0,0,,0,0,,0,0,,0,2,2,0,0,0,1,2,0,-0.2
13406,Jon Fleming\jon-fleming-1,2013-14,Kent State,G,4,0,5,0,0,,0,0,,0,0,,0,0,,0,1,1,0,1,0,1,2,0,-0.1
13407,Damon'te Moore\damonte-moore-1,2017-18,Mount St. Mary's,G,2,0,4,0,0,,0,0,,0,0,,0,0,,0,0,0,0,0,0,0,0,0,0.0
13408,Jay Jay Davis\jayjay-davis-1,2017-18,Lehigh,G,1,0,3,0,0,,0,0,,0,0,,0,0,,0,0,0,0,0,0,1,2,0,-1.8
13409,Kajon Brown\kajon-brown-1,2015-16,Tulsa,G,6,1,16,0,1,.000,0,0,,0,1,.000,0,0,,1,0,1,2,1,0,0,3,0,0.2
13410,Brenton Petty\brenton-petty-1,2015-16,Fordham,G,4,0,8,0,1,.000,0,1,.000,0,0,,0,0,,0,0,0,0,1,0,2,0,0,-0.4
13411,Zach Yoshor\zach-yoshor-1,2017-18,Harvard,G,4,3,16,0,1,.000,0,1,.000,0,0,,0,0,,1,0,1,0,0,0,1,1,0,-0.4
13412,Zach Altany\zach-altany-1,2013-14,Georgia Southern,G,8,0,12,0,5,.000,0,2,.000,0,3,.000,0,0,,0,3,3,0,0,0,0,0,0,-0.3
13413,Mike Leazer\mike-leazer-1,2013-14,Evansville,G,3,0,6,0,2,.000,0,2,.000,0,0,,0,0,,0,0,0,1,0,0,2,0,0,-0.9
13414,Caleb McGuire\caleb-mcguire-1,2015-16,St. Bonaventure,G,2,0,1,0,0,,0,0,,0,0,,0,0,,0,0,0,0,0,0,0,0,0,0.0
13415,Rashann London\rashann-london-1,2017-18,North Carolina Central,G,1,0,0,0,0,,0,0,,0,0,,0,0,,0,0,0,0,0,0,1,0,0,-1.0
13416,Dillon Pulliam\dillon-pulliam-1,2017-18,Kentucky,G,5,0,3,0,0,,0,0,,0,0,,0,0,,0,0,0,0,0,0,0,0,0,0.0
13417,Josh Hanson\josh-hanson-1,2016-17,Stanford,G,4,0,5,0,1,.000,0,0,,0,1,.000,0,0,,0,0,0,0,0,0,0,0,0,-0.2
13418,Ethan Good\ethan-good-1,2017-18,Bowling Green State,G,6,0,15,0,3,.000,0,0,,0,3,.000,0,0,,0,0,0,1,0,0,1,2,0,-0.5
13419,Carter Cagle\carter-cagle-1,2015-16,Georgia State,G,6,0,3,0,0,,0,0,,0,0,,0,0,,0,0,0,0,0,0,0,0,0,0.0
13420,Ronald Ross\ronald-ross-2,2013-14,Middle Tennessee,G,1,0,5,0,1,.000,0,1,.000,0,0,,0,0,,0,1,1,0,0,0,1,0,0,-1.4
13421,KJ Garrett\kj-garrett-1,2014-15,Washington,G,5,0,10,0,1,.000,0,1,.000,0,0,,0,3,.000,1,0,1,0,0,1,2,2,0,-0.7
13422,Brandon Young\brandon-young-2,2013-14,Georgia,G,10,0,12,0,3,.000,0,2,.000,0,1,.000,0,0,,0,1,1,0,0,0,1,0,0,-0.3
13423,Ben Swett\ben-swett-1,2017-18,Dartmouth,G,6,0,8,0,1,.000,0,1,.000,0,0,,0,0,,0,2,2,2,2,0,0,1,0,0.5
13424,Mark Noble\mark-noble-1,2014-15,Akron,G,6,0,12,0,4,.000,0,3,.000,0,1,.000,0,1,.000,2,1,3,0,1,0,0,3,0,-0.3
13425,Greg Andrade\greg-andrade-1,2013-14,Central Connecticut State,G,6,0,6,0,2,.000,0,2,.000,0,0,,0,0,,0,0,0,0,0,0,0,1,0,-0.3
13426,Tommy Corchiani\tommy-corchiani-1,2016-17,South Carolina,G,5,0,11,0,0,,0,0,,0,0,,0,0,,0,1,1,0,0,0,1,4,0,-0.5
13427,Nicholas Lucenti\nicholas-lucenti-1,2013-14,Oregon,G,7,0,13,0,3,.000,0,1,.000,0,2,.000,0,0,,1,2,3,0,0,0,0,1,0,-0.2
13428,Kalen Alexander\kalen-alexander-1,2015-16,Indiana State,G,3,0,6,0,0,,0,0,,0,0,,0,0,,0,0,0,0,0,0,0,0,0,0.0
13429,Nick Ayers\nick-ayers-1,2016-17,Northern Kentucky,G,2,0,2,0,0,,0,0,,0,0,,0,0,,0,0,0,0,0,0,0,0,0,0.0
13430,Skyler Flatten\skyler-flatten-1,2015-16,South Dakota State,G,1,0,0,0,0,,0,0,,0,0,,0,0,,0,0,0,0,0,0,0,0,0,0.0
13431,Jerrold Smith\jerrold-smith-1,2015-16,UCLA,G,8,0,10,0,2,.000,0,1,.000,0,1,.000,0,0,,1,0,1,1,0,0,1,0,0,-0.1
13432,Chase Brogna\chase-brogna-1,2013-14,Ball State,G,2,0,4,0,2,.000,0,1,.000,0,1,.000,0,0,,0,1,1,0,0,0,0,0,0,-0.6
13433,Tate Clayton\tate-clayton-1,2017-18,Mississippi State,G,4,0,9,0,0,,0,0,,0,0,,0,0,,0,0,0,0,0,0,0,0,0,0.0
13434,Samson Oladimeji\samson-oladimeji-1,2017-18,Illinois,G,8,0,15,0,1,.000,0,0,,0,1,.000,0,0,,1,3,4,0,1,0,0,1,0,0.2
13435,Joey Gruden\joey-gruden-1,2015-16,Dayton,G,4,0,4,0,1,.000,0,1,.000,0,0,,0,0,,0,1,1,0,0,0,0,0,0,-0.1
13436,Troy Norris\troy-norris-1,2015-16,Oregon,G,5,0,11,0,1,.000,0,1,.000,0,0,,0,2,.000,0,0,0,2,1,0,2,0,0,-0.2
13437,Georgios Pilitsis\georgios-pilitsis-1,2013-14,Lehigh,G,8,0,8,0,1,.000,0,1,.000,0,0,,0,0,,0,1,1,0,0,0,1,0,0,-0.2
13438,Cameron Alo\cameron-alo-1,2017-18,Texas A&M,G,2,0,1,0,0,,0,0,,0,0,,0,0,,0,0,0,1,1,0,0,0,0,0.9
13439,Morgan Young\morgan-young-1,2013-14,Montana,G,5,0,5,0,0,,0,0,,0,0,,0,2,.000,0,0,0,0,0,0,0,0,0,-0.2
13440,Trevis Jackson\trevis-jackson-1,2013-14,Sacramento State,G,11,0,34,0,6,.000,0,2,.000,0,4,.000,0,1,.000,2,0,2,4,1,0,2,2,0,-0.2
13441,Chris Williams\chris-williams-12,2015-16,Saint Peter's,G,4,0,2,0,0,,0,0,,0,0,,0,0,,0,0,0,0,0,0,2,0,0,-0.5
13442,Karandeep Malhi\karandeep-malhi-1,2014-15,Savannah State,G,1,0,1,0,1,.000,0,0,,0,1,.000,0,0,,0,0,0,0,0,0,0,0,0,-0.7
13443,Brandon Miller\brandon-miller-4,2015-16,Utah,G,3,0,6,0,0,,0,0,,0,0,,0,0,,0,0,0,0,0,0,1,1,0,-0.5
13444,Tre Hawkins\tre-hawkins-1,2014-15,Miami (OH),G,1,0,1,0,0,,0,0,,0,0,,0,0,,0,0,0,1,1,0,0,0,0,1.7
13445,Alec Wulff\alec-wulff-1,2014-15,UCLA,G,4,0,5,0,1,.000,0,0,,0,1,.000,0,0,,0,0,0,1,1,0,0,0,0,0.3
13446,Chase Miller\chase-miller-1,2016-17,Middle Tennessee,G,11,0,14,0,3,.000,0,0,,0,3,.000,0,0,,0,2,2,0,0,1,0,0,0,-0.1
13447,Joey Gruden\joey-gruden-1,2014-15,Dayton,G,7,0,7,0,0,,0,0,,0,0,,0,0,,0,0,0,0,0,0,0,0,0,0.0
13448,Spenser Dalton\spenser-dalton-1,2014-15,North Carolina,G,2,0,2,0,0,,0,0,,0,0,,0,0,,0,0,0,0,1,0,0,0,0,0.5
13449,David Cunningham\david-cunningham-1,2016-17,Nevada,G,6,0,6,0,0,,0,0,,0,0,,0,0,,0,0,0,0,1,0,0,0,0,0.2
13450,Nick Ayers\nick-ayers-1,2017-18,Northern Kentucky,G,8,1,18,0,2,.000,0,2,.000,0,0,,0,0,,0,6,6,2,1,0,0,1,0,0.3
13451,Christian Vega\christian-vega-1,2016-17,Saint Joseph's,G,3,0,4,0,2,.000,0,1,.000,0,1,.000,0,0,,0,1,1,0,0,0,0,1,0,-0.5
13452,Christian Villers\christian-villers-1,2017-18,Marshall,G,2,0,5,0,2,.000,0,1,.000,0,1,.000,0,0,,0,1,1,0,0,0,0,1,0,-0.8
13453,Shawn Simmons\shawn-simmons-1,2015-16,Pennsylvania,G,6,0,5,0,1,.000,0,0,,0,1,.000,0,0,,0,0,0,1,0,0,1,0,0,-0.2
13454,Jahvari Josiah\jahvari-josiah-1,2013-14,Coppin State,G,1,0,0,0,0,,0,0,,0,0,,0,0,,0,0,0,0,0,0,0,0,0,0.0
13455,Omotayo Aiyegbusi\omotayo-aiyegbusi-1,2016-17,Connecticut,G,6,0,8,0,2,.000,0,0,,0,2,.000,0,0,,0,0,0,1,0,0,0,0,0,-0.1
13456,Alec Raven\alec-raven-1,2015-16,Cal Poly,G,1,0,1,0,0,,0,0,,0,0,,0,0,,0,0,0,0,0,0,0,0,0,0.0
13457,Alex Bergen\alex-bergen-1,2016-17,Xavier,G,9,0,8,0,0,,0,0,,0,0,,0,0,,1,1,2,0,0,0,0,0,0,0.1
13458,Michael Benkert\michael-benkert-1,2015-16,Belmont,G,1,0,0,0,0,,0,0,,0,0,,0,0,,1,0,1,0,0,0,0,0,0,0.7
13459,Trevor Glassman\trevor-glassman-1,2016-17,Missouri,G,7,1,13,0,6,.000,0,1,.000,0,5,.000,0,0,,2,3,5,1,2,0,2,1,0,-0.2
13460,Jaylin McDonald\jaylin-mcdonald-1,2017-18,Ohio,G,7,0,15,0,1,.000,0,1,.000,0,0,,0,0,,1,3,4,0,1,0,0,0,0,0.3
13461,Addison Hill\addison-hill-1,2017-18,East Carolina,G,6,0,7,0,1,.000,0,1,.000,0,0,,0,0,,0,3,3,1,0,0,0,1,0,0.1
13462,Jesse Love\jesse-love-1,2015-16,Jackson State,G,1,0,3,0,0,,0,0,,0,0,,0,0,,0,0,0,0,0,0,0,0,0,0.0
13463,Manny Anderson\manny-anderson-1,2016-17,Seton Hall,G,4,0,5,0,0,,0,0,,0,0,,0,0,,0,0,0,0,0,0,0,0,0,0.0
13464,Waseem Ali Jr.\waseem-alijr-1,2017-18,Houston Baptist,G,3,0,8,0,4,.000,0,3,.000,0,1,.000,0,0,,1,1,2,0,0,0,1,0,0,-0.9
13465,Jon Siu\jon-siu-1,2015-16,Northern Illinois,G,1,0,0,0,0,,0,0,,0,0,,0,0,,0,0,0,0,0,0,0,0,0,0.0
13466,Kevin Brown\kevin-brown-1,2015-16,American,G,1,0,0,0,0,,0,0,,0,0,,0,0,,1,0,1,0,0,0,0,0,0,0.7
13467,Dylan Clark\dylan-clark-1,2015-16,Air Force,G,1,0,1,0,0,,0,0,,0,0,,0,0,,0,0,0,0,0,0,0,0,0,0.0
13468,Matt DiLuccio\matt-diluccio-1,2016-17,Boston College,G,1,0,1,0,0,,0,0,,0,0,,0,0,,0,0,0,0,0,0,0,0,0,0.0
13469,Jon McKeeman\john-mckeeman-1,2014-15,Purdue,G,5,0,12,0,1,.000,0,1,.000,0,0,,0,0,,0,0,0,0,0,0,1,1,0,-0.4
13470,Ryan Schmidt\ryan-schmidt-1,2014-15,Illinois,G,4,0,2,0,0,,0,0,,0,0,,0,0,,0,0,0,0,0,0,0,0,0,0.0
13471,Royce Simpson\royce-simpson-1,2013-14,Saint Louis,G,3,0,1,0,0,,0,0,,0,0,,0,0,,0,0,0,0,0,0,0,0,0,0.0
13472,Matthew Mazzara\matthew-mazzara-1,2013-14,Saint Francis (PA),G,5,1,11,0,2,.000,0,0,,0,2,.000,0,0,,0,1,1,0,2,0,3,1,0,-0.5
13473,Ray Featherston\ray-featherston-1,2017-18,Syracuse,G,3,0,2,0,0,,0,0,,0,0,,0,0,,0,0,0,1,0,0,0,0,0,0.2
13474,Alex Rifkind\alex-rifkind-1,2015-16,Cal State Long Beach,G,10,0,15,0,3,.000,0,0,,0,3,.000,0,0,,1,1,2,0,1,0,1,1,0,-0.2
13475,Isaiah White\isaiah-white-1,2015-16,North Carolina-Asheville,G,1,0,0,0,0,,0,0,,0,0,,0,0,,1,0,1,0,0,0,0,0,0,0.7
13476,Justice Montgomery\justice-montgomery-1,2014-15,American,G,11,0,15,0,0,,0,0,,0,0,,0,1,.000,1,0,1,1,0,0,0,4,0,-0.1
13477,Jeremiah Bonsu\jeremiah-bonsu-1,2016-17,Dayton,G,2,0,1,0,0,,0,0,,0,0,,0,0,,0,0,0,0,0,0,0,0,0,0.0
13478,Marcus Johnson\marcus-johnson-9,2013-14,Mississippi Valley State,G,1,0,0,0,0,,0,0,,0,0,,0,0,,0,0,0,0,0,0,0,0,0,0.0
13479,Chris Campbell\chris-campbell-2,2015-16,North Texas,G,5,0,14,0,4,.000,0,2,.000,0,2,.000,0,2,.000,0,1,1,0,0,0,0,3,0,-0.9
13480,Nathan Laing\nathan-laing-1,2017-18,Central Florida,G,20,0,51,0,4,.000,0,2,.000,0,2,.000,0,0,,0,5,5,2,0,0,4,7,0,-0.3
13481,Ayan Nunez de Carvalho\ayan-nunezdecarvalho-1,2016-17,Temple,G,4,0,9,0,3,.000,0,0,,0,3,.000,0,0,,1,2,3,1,1,0,1,2,0,-0.2
13482,Jordan Poydras\jordan-poydras-1,2015-16,Utah Valley,G,1,0,5,0,2,.000,0,1,.000,0,1,.000,0,0,,0,0,0,0,0,0,0,0,0,-1.4
13483,Lance Potier\lance-potier-1,2013-14,McNeese State,G,9,0,31,0,8,.000,0,4,.000,0,4,.000,0,0,,1,3,4,1,0,1,0,4,0,-0.5
13484,Elias Berbari\elias-berbari-1,2015-16,Princeton,G,8,0,11,0,1,.000,0,0,,0,1,.000,0,2,.000,0,1,1,1,0,0,0,1,0,-0.1
13485,A.J. Rutter\aj-rutter-1,2013-14,Drake,G,2,0,1,0,0,,0,0,,0,0,,0,0,,0,1,1,0,0,0,0,0,0,0.2
13486,Joshua Filmore\joshua-filmore-1,2016-17,Southeastern Louisiana,G,1,0,0,0,0,,0,0,,0,0,,0,0,,0,1,1,0,0,0,0,0,0,0.3
13487,Joey Burbach\joey-burbach-1,2014-15,Rice,G,2,0,7,0,2,.000,0,1,.000,0,1,.000,0,0,,1,0,1,0,0,0,0,0,0,-0.4
13488,Ian Proulx\ian-proulx-1,2015-16,Stanford,G,1,0,4,0,0,,0,0,,0,0,,0,0,,0,0,0,0,0,0,0,0,0,0.0
13489,Drew Jacobs\drew-jacobs-1,2013-14,Boston College,G,4,0,5,0,1,.000,0,0,,0,1,.000,0,0,,1,0,1,0,0,0,0,0,0,0.0
13490,Anthony Bilas\anthony-bilas-1,2015-16,Wake Forest,G,1,0,1,0,0,,0,0,,0,0,,0,0,,0,0,0,0,0,0,0,0,0,0.0
13491,Josh Biber\josh-biber-1,2013-14,Brown,G,4,1,20,0,0,,0,0,,0,0,,0,3,.000,0,2,2,3,1,0,2,0,0,0.1
13492,Spencer Newman\spencer-newman-1,2017-18,North Carolina State,G,6,0,11,0,3,.000,0,1,.000,0,2,.000,0,0,,1,3,4,0,0,0,1,1,0,-0.3
13493,Charlie Inclan\charlie-inclan-1,2016-17,Presbyterian,G,1,0,1,0,1,.000,0,0,,0,1,.000,0,0,,0,0,0,0,0,0,0,0,0,-0.7
13494,Mason Schoen\mason-schoen-1,2014-15,Kansas State,G,10,0,9,0,2,.000,0,0,,0,2,.000,0,0,,2,0,2,0,0,0,0,0,0,0.0
13495,Gavin Gibson\gavin-gibson-1,2014-15,Middle Tennessee,G,7,0,12,0,5,.000,0,1,.000,0,4,.000,0,0,,0,0,0,0,1,0,0,1,0,-0.4
13496,Cezanne Carson\cezanne-carson-1,2015-16,Alabama A&M,G,1,1,0,0,0,,0,0,,0,0,,0,0,,0,0,0,0,0,0,0,0,0,0.0
13497,Michael Pickney\michael-pickney-1,2014-15,Georgia State,G,1,0,0,0,1,.000,0,1,.000,0,0,,0,0,,0,1,1,0,0,0,1,1,0,-1.8
13498,Haboubacar Mutombo\haboubacar-mutombo-1,2014-15,Western Carolina,G,2,0,8,0,1,.000,0,1,.000,0,0,,0,0,,3,1,4,0,1,0,1,1,0,0.7
13499,Seth Fuller\seth-fuller-1,2016-17,Elon,G,2,0,7,0,1,.000,0,0,,0,1,.000,0,0,,0,1,1,0,0,0,2,2,0,-1.6
13500,Tucker Lee\tucker-lee-1,2017-18,Marist,G,9,0,11,0,2,.000,0,1,.000,0,1,.000,0,0,,0,1,1,0,0,0,0,1,0,-0.2
13501,Evan Dourdas\evan-dourdas-1,2015-16,Syracuse,G,3,0,3,0,0,,0,0,,0,0,,0,0,,0,0,0,0,0,0,0,1,0,-0.1
13502,Maalik Howard\maalik-howard-1,2013-14,Mount St. Mary's,G,16,0,56,0,0,,0,0,,0,0,,0,0,,1,0,1,2,1,0,2,6,0,-0.1
13503,Nick Hamilton\nick-hamilton-1,2015-16,University of California,G,1,0,2,0,0,,0,0,,0,0,,0,0,,0,0,0,0,0,0,0,0,0,0.0
13504,Kassius Robertson\kassius-robertson-1,2013-14,Canisius,G,1,0,0,0,0,,0,0,,0,0,,0,0,,1,0,1,0,0,0,0,0,0,0.7
13505,Romaine Jackson\romaine-jackson-1,2016-17,Arizona State,G,4,0,5,0,0,,0,0,,0,0,,0,0,,1,0,1,0,0,0,2,0,0,-0.3
13506,Jacob Susskind\jacob-susskind-1,2014-15,Maryland,G,3,0,5,0,1,.000,0,1,.000,0,0,,0,0,,0,0,0,0,0,0,1,0,0,-0.6
13507,Sean Locke\sean-locke-1,2014-15,Delaware,G,5,0,5,0,0,,0,0,,0,0,,0,0,,0,1,1,1,0,0,0,0,0,0.2
13508,Kendrick Ray\kendrick-ray-1,2013-14,Quinnipiac,G,1,0,2,0,0,,0,0,,0,0,,0,0,,0,0,0,1,1,0,0,0,0,1.7
13509,Jared Harper\jared-harper-1,2017-18,Fairfield,G,4,1,6,0,0,,0,0,,0,0,,0,0,,1,0,1,1,0,0,1,1,0,0.0
13510,Will Fenton\will-fenton-1,2017-18,Marshall,G,1,0,4,0,0,,0,0,,0,0,,0,0,,0,2,2,0,0,0,0,0,0,0.6
13511,Ayan Nunez de Carvalho\ayan-nunezdecarvalho-1,2017-18,Temple,G,7,0,9,0,3,.000,0,0,,0,3,.000,0,0,,0,1,1,0,0,0,1,0,0,-0.4
13512,Chase Driscoll\chase-driscoll-1,2015-16,North Florida,G,8,0,11,0,1,.000,0,1,.000,0,0,,0,0,,0,0,0,0,0,0,0,1,0,-0.1
13513,Shawn Simmons\shawn-simmons-1,2016-17,Pennsylvania,G,1,0,1,0,0,,0,0,,0,0,,0,0,,0,0,0,0,0,0,0,0,0,0.0
13514,Lawrence Paye\lawrence-paye-1,2013-14,Houston,G,4,0,4,0,3,.000,0,1,.000,0,2,.000,0,0,,0,0,0,0,0,0,0,0,0,-0.5
13515,Thomas Fleming\thomas-fleming-1,2014-15,Niagara,G,1,0,1,0,0,,0,0,,0,0,,0,0,,0,0,0,0,0,0,0,0,0,0.0
13516,Dylan Whitbread\dylan-whitbread-1,2016-17,Colgate,G,1,0,1,0,0,,0,0,,0,0,,0,0,,0,0,0,0,0,0,0,0,0,0.0
13517,Jordan Howard\jordan-howard-1,2014-15,Troy,G,7,0,4,0,0,,0,0,,0,0,,0,0,,1,1,2,0,0,0,0,0,0,0.1
13518,Ian Fox\ian-fox-1,2014-15,Idaho State,G,3,0,39,0,14,.000,0,4,.000,0,10,.000,0,0,,1,0,1,3,2,0,2,3,0,-2.7
13519,Mitch Lombard\mitch-lombard-1,2016-17,Colorado,G,6,0,9,0,1,.000,0,1,.000,0,0,,0,0,,0,1,1,2,0,0,1,1,0,-0.1
13520,Rico Ozuna-Harrison\rico-ozuna-harrison-1,2017-18,Michigan,G,1,0,3,0,1,.000,0,0,,0,1,.000,0,0,,0,1,1,0,0,0,0,0,0,-0.4
13521,A.J. Martinka\aj-martinka-1,2017-18,Colorado,G,1,0,1,0,0,,0,0,,0,0,,0,0,,0,0,0,0,0,0,1,1,0,-1.4
13522,Jackson Johnson\johnson-jackson-1,2016-17,Tulane,G,3,0,4,0,1,.000,0,1,.000,0,0,,0,1,.000,0,2,2,0,0,0,0,1,0,-0.3
13523,Michael Ballard\michael-ballard-1,2017-18,Wisconsin,G,1,0,1,0,0,,0,0,,0,0,,0,0,,0,0,0,0,0,0,0,0,0,0.0
13524,Jake Fay\jake-fay-1,2015-16,Hartford,G,10,0,22,0,9,.000,0,3,.000,0,6,.000,0,0,,1,1,2,1,1,0,2,0,0,-0.6
13525,Antonio Bruno\antonio-bruno-1,2016-17,Cal State Northridge,G,2,0,5,0,2,.000,0,2,.000,0,0,,0,0,,0,0,0,1,0,0,1,3,0,-1.5
13526,Gavin Wilson\gavin-wilson-1,2013-14,Charlotte,G,5,0,6,0,3,.000,0,1,.000,0,2,.000,0,0,,0,0,0,0,0,0,1,1,0,-0.7
13527,Gordon Gehan\gordon-gehan-1,2016-17,Boston College,G,3,0,3,0,2,.000,0,1,.000,0,1,.000,0,0,,0,0,0,0,0,0,0,0,0,-0.5
13528,Matt Massimino\matt-massimino-1,2014-15,Fordham,G,10,0,12,0,3,.000,0,3,.000,0,0,,0,0,,1,0,1,0,0,0,1,1,0,-0.3
13529,Emanuel Binyam\emanuel-binyam-1,2014-15,Quinnipiac,G,4,0,5,0,5,.000,0,4,.000,0,1,.000,0,0,,1,1,2,0,0,0,1,0,0,-0.9
13530,Justice Bartley\justice-bartley-1,2015-16,Virginia,G,8,0,12,0,2,.000,0,2,.000,0,0,,0,0,,1,2,3,1,0,0,5,1,0,-0.6
13531,Kimium Woods\kimium-woods-1,2016-17,Alabama A&M,G,1,0,0,0,0,,0,0,,0,0,,0,0,,0,1,1,0,0,0,0,0,0,0.3
13532,Frank Byers\frank-byers-1,2016-17,Texas A&M,G,3,0,3,0,0,,0,0,,0,0,,0,0,,0,1,1,1,0,0,1,0,0,0.0
13533,Nick Amor\nick-amor-1,2014-15,Indiana State,G,8,0,10,0,0,,0,0,,0,0,,0,0,,0,0,0,1,0,0,0,1,0,0.0
13534,Jason Anderson\jason-anderson-2,2015-16,Air Force,G,2,0,1,0,0,,0,0,,0,0,,0,0,,1,0,1,0,0,0,0,0,0,0.4
13535,LaQuentin Collins\laquentin-collins-1,2014-15,Southern,G,1,0,9,0,0,,0,0,,0,0,,0,0,,0,0,0,0,0,0,0,0,0,0.0
13536,Jo Griffin\jo-griffin-1,2017-18,Louisville,G,6,0,18,0,1,.000,0,0,,0,1,.000,0,0,,0,0,0,2,1,0,1,2,0,0.0
13537,Jhonny Victor\jhonny-victor-1,2015-16,Florida,G,5,0,5,0,1,.000,0,1,.000,0,0,,0,0,,1,0,1,1,0,0,1,0,0,-0.1
13538,Skyler Kolli\skyler-kolli-1,2015-16,Northern Kentucky,G,3,0,4,0,1,.000,0,0,,0,1,.000,0,2,.000,0,1,1,0,0,0,1,0,0,-0.7
13539,Jordan Grant\jordan-grant-1,2017-18,Central Arkansas,G,10,0,21,0,1,.000,0,0,,0,1,.000,0,0,,0,2,2,4,1,0,1,1,0,0.2
13540,Johnny Sawyer\johnny-sawyer-1,2017-18,Santa Clara,G,1,0,3,0,0,,0,0,,0,0,,0,0,,1,0,1,0,0,0,0,0,0,0.7
13541,Riley Conroy\riley-conroy-1,2017-18,Tulane,G,5,0,8,0,1,.000,0,0,,0,1,.000,0,0,,0,1,1,0,0,0,0,2,0,-0.2
13542,Miles Jenkins\miles-jenkins-1,2013-14,North Carolina A&T,G,1,0,1,0,0,,0,0,,0,0,,0,0,,0,0,0,0,0,0,0,0,0,0.0
13543,Beau Rydalch\beau-rydalch-1,2017-18,Utah,G,5,0,14,0,0,,0,0,,0,0,,0,0,,1,1,2,1,0,1,1,1,0,0.2
13544,Stilman White\stilman-white-1,2014-15,North Carolina,G,9,0,23,0,1,.000,0,0,,0,1,.000,0,0,,1,0,1,3,0,0,0,2,0,0.1
13545,Rory Flaherty\rory-flaherty-1,2016-17,Holy Cross,G,5,0,5,0,1,.000,0,1,.000,0,0,,0,0,,0,1,1,0,0,0,3,1,0,-0.8
13546,Anthony Polite\anthony-polite-1,2017-18,Florida State,G,1,0,4,0,0,,0,0,,0,0,,0,0,,0,1,1,1,1,0,1,0,0,1.0
13547,Nick Castelveter\nick-castelveter-1,2017-18,Robert Morris,G,2,0,4,0,2,.000,0,2,.000,0,0,,0,0,,1,1,2,0,0,0,0,1,0,-0.4
13548,Joey Coffaro\joey-coffaro-1,2017-18,South Florida,G,5,0,6,0,1,.000,0,1,.000,0,0,,0,0,,1,0,1,1,0,0,0,0,0,0.1
13549,Wyatt Self\wyatt-self-1,2016-17,Campbell,G,1,0,2,0,0,,0,0,,0,0,,0,0,,0,0,0,0,0,0,0,1,0,-0.4
13550,Manu Giamoukis\manu-giamoukis-1,2013-14,Davidson,G,1,0,2,0,0,,0,0,,0,0,,0,0,,0,0,0,0,0,0,0,1,0,-0.4
13551,Brandon Young\brandon-young-2,2014-15,Georgia,G,7,0,5,0,2,.000,0,1,.000,0,1,.000,0,0,,0,1,1,0,0,0,0,0,0,-0.2
13552,Anthony Tate\anthony-tate-1,2015-16,Morgan State,G,1,0,4,0,0,,0,0,,0,0,,0,0,,0,0,0,1,0,0,0,1,0,0.3
13553,Christian Johnston\christian-johnston-1,2013-14,Duquesne,G,2,0,2,0,0,,0,0,,0,0,,0,0,,0,0,0,0,1,0,0,0,0,0.5
13554,Alex Bergen\alex-bergen-1,2015-16,Xavier,G,4,0,4,0,0,,0,0,,0,0,,0,0,,0,0,0,0,0,0,0,1,0,-0.1
13555,Evan Beucler\evan-beucler-1,2016-17,Incarnate Word,G,1,0,3,0,0,,0,0,,0,0,,0,0,,0,0,0,0,0,0,0,0,0,0.0
13556,Dylan Miller\dylan-miller-1,2013-14,Delaware,G,7,0,7,0,0,,0,0,,0,0,,0,0,,0,0,0,0,0,0,1,1,0,-0.2
13557,Nick Pagliuca\nick-pagliuca-1,2015-16,Duke,G,10,0,10,0,1,.000,0,0,,0,1,.000,0,0,,1,3,4,0,1,0,1,1,0,0.1
13558,Brock Stephenson\brock-stephenson-1,2016-17,Central Florida,G,11,0,17,0,6,.000,0,1,.000,0,5,.000,0,0,,1,1,2,0,0,0,0,1,0,-0.3
13559,Samm Jones\samm-jones-1,2017-18,Drake,G,5,0,9,0,1,.000,0,1,.000,0,0,,0,0,,1,1,2,0,0,0,0,1,0,0.0
13560,Nick Haldes\nick-haldes-1,2014-15,Dayton,G,4,0,3,0,0,,0,0,,0,0,,0,0,,0,0,0,0,0,0,0,0,0,0.0
13561,Justin Brickman\justin-brickman-1,2014-15,Bryant,G,3,0,3,0,0,,0,0,,0,0,,0,0,,0,1,1,1,0,0,1,0,0,0.0
13562,Joe Schwartz\joe-schwartz-1,2017-18,Texas,G,4,0,5,0,3,.000,0,0,,0,3,.000,0,1,.000,0,0,0,1,0,0,0,2,0,-0.7
13563,Deondre Burns\deondre-burns-1,2017-18,Little Rock,G,1,0,0,0,1,.000,0,1,.000,0,0,,0,0,,0,0,0,0,0,0,0,0,0,-0.7
13564,Jon Rubenstein\jon-rubenstein-1,2014-15,Michigan,G,1,0,1,0,0,,0,0,,0,0,,0,1,.000,0,0,0,0,0,0,0,0,0,-0.4
13565,Tyler Robinson\tyler-robinson-1,2015-16,Monmouth,G,2,0,1,0,0,,0,0,,0,0,,0,0,,0,0,0,0,0,0,0,0,0,0.0
13566,Quentin Taylor\quentin-taylor-1,2017-18,Indiana,G,1,0,2,0,0,,0,0,,0,0,,0,0,,0,0,0,1,0,0,0,0,0,0.7
13567,Trent Perry\trent-perry-1,2013-14,Eastern Michigan,G,1,0,0,0,0,,0,0,,0,0,,0,0,,0,0,0,0,0,0,1,0,0,-1.0
13568,Tim Singleton\tim-singleton-1,2013-14,Richmond,G,3,0,3,0,1,.000,0,0,,0,1,.000,0,0,,0,0,0,0,0,0,0,1,0,-0.4
13569,Paulo Cruz\paulo-cruz-1,2016-17,Arizona,G,8,0,20,0,4,.000,0,2,.000,0,2,.000,0,0,,0,3,3,0,0,0,4,2,0,-0.8
13570,Christian Vega\christian-vega-1,2017-18,Saint Joseph's,G,4,0,5,0,3,.000,0,3,.000,0,0,,0,0,,0,0,0,1,0,0,0,0,0,-0.4
13571,Jake Fay\jake-fay-1,2016-17,Hartford,G,8,0,15,0,6,.000,0,2,.000,0,4,.000,0,0,,1,0,1,0,1,1,1,0,0,-0.4
13572,Mairega Clarke\mairega-clarke-1,2016-17,Texas-Arlington,G,1,0,1,0,0,,0,0,,0,0,,0,0,,0,0,0,0,0,0,0,0,0,0.0
13573,Raemond Robinson\raemond-robinson-1,2014-15,Charleston Southern,G,1,0,0,0,0,,0,0,,0,0,,0,0,,0,0,0,0,0,0,0,0,0,0.0
13574,Henry Lowe\henry-lowe-1,2015-16,Villanova,G,15,0,26,0,1,.000,0,0,,0,1,.000,0,2,.000,0,0,0,2,1,0,4,1,0,-0.2
13575,Juan Sabino II\juan-sabinoii-1,2016-17,Colorado State,G,5,0,8,0,3,.000,0,0,,0,3,.000,0,0,,1,0,1,0,1,0,4,1,0,-1.0
13576,Kirkland Humphrey\kirkland-humphrey-1,2017-18,Eastern Kentucky,G,7,0,10,0,2,.000,0,1,.000,0,1,.000,0,0,,0,3,3,0,0,0,0,1,0,-0.1
13577,Marshall Holmes\marshall-holmes-1,2014-15,Central Florida,G,3,0,2,0,0,,0,0,,0,0,,0,0,,0,0,0,0,0,0,0,0,0,0.0
13578,Nic Lane\nic-lane-1,2013-14,Colgate,G,5,0,3,0,1,.000,0,0,,0,1,.000,0,0,,0,0,0,0,0,0,1,1,0,-0.4
13579,Mark Parisi\mark-parisi-1,2014-15,Long Island University,G,2,0,4,0,0,,0,0,,0,0,,0,0,,0,1,1,0,0,0,0,0,0,0.2
13580,Austin Nelson\austin-nelson-1,2017-18,South Carolina Upstate,G,3,0,7,0,4,.000,0,2,.000,0,2,.000,0,0,,1,0,1,1,0,0,1,1,0,-0.9
13581,Stefan Cox\stefan-cox-1,2015-16,San Francisco,G,4,0,11,0,2,.000,0,0,,0,2,.000,0,0,,0,1,1,0,0,0,0,1,0,-0.4
13582,Lane Below\lane-below-1,2017-18,Mississippi,G,2,0,2,0,0,,0,0,,0,0,,0,0,,0,0,0,0,0,0,0,0,0,0.0
13583,Andrew Leone\andrew-leone-1,2014-15,Fairfield,G,3,0,2,0,1,.000,0,0,,0,1,.000,0,0,,0,0,0,0,0,0,1,0,0,-0.6
13584,D.J. Suter\dj-suter-1,2013-14,Georgia Southern,G,1,0,2,0,0,,0,0,,0,0,,0,0,,0,0,0,0,0,0,0,2,0,-0.8
13585,Hunter Eggers\hunter-eggers-1,2013-14,Rice,G,4,0,4,0,2,.000,0,1,.000,0,1,.000,0,0,,0,1,1,1,0,0,0,0,0,-0.1
13586,Matt Donahue\matt-donahue-1,2017-18,Quinnipiac,G,1,0,1,0,0,,0,0,,0,0,,0,0,,0,0,0,0,0,0,0,0,0,0.0
13587,Edward Chung\edward-chung-1,2013-14,Texas Southern,G,2,0,2,0,0,,0,0,,0,0,,0,0,,0,0,0,0,0,0,0,0,0,0.0
13588,Taylor Nussbaum\taylor-nussbaum-1,2017-18,Penn State,G,2,0,2,0,0,,0,0,,0,0,,0,0,,0,0,0,0,0,0,0,0,0,0.0
13589,Toliver Freeman\toliver-freeman-1,2016-17,Saint Joseph's,G,1,0,1,0,1,.000,0,0,,0,1,.000,0,0,,0,0,0,0,0,0,0,0,0,-0.7
13590,Lavar Harewood\lavar-harewood-1,2017-18,South Carolina State,G,1,0,0,0,0,,0,0,,0,0,,0,0,,0,0,0,0,0,0,0,0,0,0.0
13591,Joe Mascaro\joe-mascaro-1,2017-18,Pittsburgh,G,4,0,4,0,0,,0,0,,0,0,,0,0,,0,0,0,1,0,0,0,0,0,0.2
13592,Blair Mendy\blair-mendy-1,2016-17,Stony Brook,G,2,0,4,0,0,,0,0,,0,0,,0,0,,0,0,0,0,0,0,0,1,0,-0.2
13593,Grant Fogerty\grant-fogerty-1,2017-18,Arizona State,G,12,0,12,0,2,.000,0,1,.000,0,1,.000,0,0,,0,0,0,1,0,0,0,3,0,-0.2
13594,John Moran\john-moran-1,2014-15,Richmond,G,3,0,5,0,0,,0,0,,0,0,,0,0,,0,0,0,1,0,0,0,1,0,0.1
13595,Andrew Terrell\andrew-terrell-1,2017-18,Maryland,G,6,0,13,0,3,.000,0,1,.000,0,2,.000,0,2,.000,0,1,1,1,0,0,0,1,0,-0.4
13596,Jake Bischoff\jake-bischoff-1,2015-16,Miami (OH),G,5,0,17,0,4,.000,0,1,.000,0,3,.000,0,0,,1,1,2,0,0,0,0,3,0,-0.6
13597,Carlton Speight\carlton-speight-1,2014-15,Louisiana State,G,1,0,4,0,1,.000,0,1,.000,0,0,,0,0,,0,0,0,1,0,0,0,0,0,0.0
13598,Marcus Lightfoot\marcus-lightfoot-1,2016-17,Texas A&M-Corpus Christi,G,3,0,2,0,1,.000,0,0,,0,1,.000,0,0,,0,1,1,0,0,0,0,2,0,-0.4
13599,Monte Burney\monte-burney-1,2013-14,Eastern Kentucky,G,3,0,3,0,2,.000,0,0,,0,2,.000,0,0,,0,0,0,0,0,0,1,2,0,-1.1
13600,Marcus Love\marcus-love-1,2015-16,Jackson State,G,1,0,3,0,0,,0,0,,0,0,,0,0,,0,0,0,0,0,0,0,0,0,0.0
13601,Shane Plunkett\shane-plunkett-1,2014-15,Rhode Island,G,4,0,5,0,1,.000,0,0,,0,1,.000,0,0,,0,0,0,1,0,0,0,1,0,-0.1
13602,Tyus Bowser\tyus-bowser-1,2013-14,Houston,G,3,0,3,0,3,.000,0,1,.000,0,2,.000,0,0,,0,0,0,0,1,0,1,0,0,-0.7
13603,Les Smith\les-smith-1,2013-14,Lafayette,G,9,1,19,0,2,.000,0,0,,0,2,.000,0,0,,0,0,0,3,0,0,1,6,0,-0.3
13604,Connor Gholson\connor-gholson-1,2017-18,Drake,G,2,0,0,0,0,,0,0,,0,0,,0,0,,1,0,1,0,0,1,0,0,0,0.7
13605,Brian Long\brian-long-1,2013-14,Kentucky,G,1,0,1,0,0,,0,0,,0,0,,0,0,,0,0,0,0,0,0,0,0,0,0.0
13606,Jeffery Johnson\jeffery-johnson-1,2014-15,Mississippi State,G,6,1,12,0,1,.000,0,1,.000,0,0,,0,0,,1,1,2,0,2,0,1,1,0,0.2
13607,Peter Burquest\peter-burquest-1,2017-18,Fordham,G,1,0,1,0,0,,0,0,,0,0,,0,0,,0,0,0,0,0,0,0,0,0,0.0
13608,Daniel Harper\daniel-harper-1,2016-17,Oklahoma,G,3,0,5,0,1,.000,0,1,.000,0,0,,0,0,,0,2,2,2,0,0,1,0,0,0.1
13609,Armani Dodson\armani-dodson-1,2017-18,UCLA,G,2,0,3,0,0,,0,0,,0,0,,0,0,,1,1,2,0,0,0,0,1,0,0.3
13610,Robert Knar\robert-knar-1,2014-15,Northern Iowa,G,12,0,17,0,1,.000,0,1,.000,0,0,,0,0,,1,0,1,0,0,0,0,1,0,0.0
13611,John Jones\john-jones-6,2017-18,Nevada,G,7,0,7,0,2,.000,0,2,.000,0,0,,0,0,,1,0,1,0,0,0,0,1,0,-0.2
13612,Anthony Piganelli\anthony-piganelli-1,2014-15,Oregon,G,4,0,6,0,1,.000,0,1,.000,0,0,,0,0,,0,0,0,0,0,0,0,1,0,-0.3
13613,Jesse Boyce\jesse-boyce-1,2017-18,Manhattan,G,3,0,3,0,0,,0,0,,0,0,,0,0,,0,1,1,0,0,0,0,0,0,0.1
13614,Dillon Graham\dillon-graham-1,2013-14,Florida,G,1,0,8,0,2,.000,0,1,.000,0,1,.000,0,0,,0,0,0,0,0,0,0,0,0,-1.4
13615,Justin Lindner\justin-lindner-1,2017-18,Florida State,G,3,0,7,0,1,.000,0,1,.000,0,0,,0,0,,0,1,1,2,0,0,2,1,0,-0.5
13616,Phil Guglielmo\phil-guglielmo-1,2013-14,Navy,G,1,0,1,0,1,.000,0,0,,0,1,.000,0,0,,0,0,0,0,0,0,0,0,0,-0.7
13617,Kevin Doi\kevin-doi-1,2017-18,Drexel,G,7,0,8,0,0,,0,0,,0,0,,0,0,,0,0,0,0,0,0,0,1,0,-0.1
13618,Brett Paul\brett-paul-1,2015-16,Pennsylvania,G,1,0,1,0,0,,0,0,,0,0,,0,0,,0,0,0,0,0,0,1,1,0,-1.4
13619,E.J. Conley\ej-conley-1,2013-14,South Alabama,G,6,0,16,0,1,.000,0,1,.000,0,0,,0,0,,0,0,0,1,1,0,1,1,0,-0.1
13620,Jacoby Green\jacoby-green-1,2015-16,Prairie View,G,2,0,0,0,0,,0,0,,0,0,,0,1,.000,0,0,0,0,0,0,0,0,0,-0.2
13621,Ryder Bowline\ryder-bowline-1,2016-17,Elon,G,4,1,10,0,2,.000,0,0,,0,2,.000,0,2,.000,1,1,2,1,1,0,1,4,0,-0.5
13622,Adrian Moore\adrian-moore-1,2016-17,Texas-El Paso,G,1,0,1,0,0,,0,0,,0,0,,0,0,,0,0,0,0,0,0,0,0,0,0.0
13623,James McLean\james-mclean-1,2016-17,Harvard,G,1,0,1,0,1,.000,0,1,.000,0,0,,0,0,,1,0,1,0,0,0,0,0,0,0.0
13624,Corey Walker\corey-walker-1,2014-15,Cal State Fullerton,G,7,1,19,0,2,.000,0,1,.000,0,1,.000,0,0,,0,2,2,0,0,0,2,3,0,-0.6
13625,Daniel Terpin\daniel-terpin-1,2015-16,Jacksonville,G,3,0,6,0,3,.000,0,2,.000,0,1,.000,0,0,,0,0,0,0,0,0,1,0,0,-1.0
13626,Bobby Frasco\bobby-frasco-1,2014-15,Buffalo,G,9,0,14,0,4,.000,0,1,.000,0,3,.000,0,0,,0,1,1,0,0,0,0,2,0,-0.4
13627,Joey Lepak\joey-lepak-1,2013-14,Saint Louis,G,3,0,2,0,1,.000,0,0,,0,1,.000,0,0,,0,0,0,1,0,0,0,0,0,0.0
13628,David Irby\david-irby-1,2013-14,San Francisco,G,2,0,3,0,0,,0,0,,0,0,,0,0,,0,0,0,0,0,0,0,1,0,-0.2
13629,Andrew Leone\andrew-leone-1,2013-14,Fairfield,G,1,0,1,0,0,,0,0,,0,0,,0,0,,0,1,1,0,0,0,0,0,0,0.3
13630,Shakaris Laney\sharkaris-laney-1,2016-17,Central Connecticut State,G,1,0,0,0,0,,0,0,,0,0,,0,0,,0,1,1,0,0,0,0,0,0,0.3
13631,Josh Repine\josh-repine-1,2017-18,Colorado,G,5,1,6,0,2,.000,0,1,.000,0,1,.000,0,0,,1,0,1,1,0,0,0,0,0,0.0
13632,Tyler Simmons\tyler-simmons-1,2016-17,Central Arkansas,G,2,0,3,0,0,,0,0,,0,0,,0,0,,0,0,0,1,0,0,0,0,0,0.4
13633,C.J. Rhodes\cj-rhodes-1,2017-18,Ohio,G,2,0,4,0,0,,0,0,,0,0,,0,0,,0,0,0,0,0,0,0,0,0,0.0
13634,Lonnie Jackson\lonnie-jackson-2,2014-15,Boston College,G,3,0,26,0,5,.000,0,0,,0,5,.000,0,0,,0,2,2,1,2,0,0,5,0,-0.7
13635,Matthew Cotton\matthew-cotton-1,2013-14,Alabama A&M,G,7,0,22,0,2,.000,0,0,,0,2,.000,0,0,,0,0,0,1,2,0,1,1,0,0.0
13636,Nick Moschetti\nick-moschetti-1,2014-15,Purdue-Fort Wayne,G,5,0,7,0,1,.000,0,0,,0,1,.000,0,0,,0,0,0,0,1,0,1,0,0,-0.1
13637,Mike Lukashewich\mike-lukashewich-1,2014-15,Minnesota,G,3,0,9,0,0,,0,0,,0,0,,0,0,,0,0,0,0,0,1,1,0,0,-0.1
13638,Mike Lelito\mike-lelito-1,2017-18,Marquette,G,1,0,3,0,1,.000,0,0,,0,1,.000,0,0,,0,0,0,0,0,0,0,0,0,-0.7
13639,Brevin Pritzl\brevin-pritzl-1,2015-16,Wisconsin,G,1,0,4,0,0,,0,0,,0,0,,0,0,,0,0,0,0,0,0,1,0,0,-1.0
13640,Justice Obasohan\justice-obasohan-1,2015-16,East Carolina,G,4,0,3,0,0,,0,0,,0,0,,0,0,,0,1,1,1,0,0,1,0,0,0.0
13641,Shane Plunkett\shane-plunkett-1,2013-14,Rhode Island,G,5,0,4,0,1,.000,0,0,,0,1,.000,0,0,,1,1,2,0,0,0,1,2,0,-0.3
13642,George Davis III\george-davisiii-1,2015-16,Central Connecticut State,G,1,0,1,0,0,,0,0,,0,0,,0,0,,0,0,0,0,0,0,0,0,0,0.0
13643,Mike Noyes\mike-noyes-1,2017-18,Connecticut,G,6,0,6,0,2,.000,0,1,.000,0,1,.000,0,0,,0,0,0,0,0,0,0,0,0,-0.2
13644,David Bloom\david-bloom-1,2015-16,Texas A&M-Corpus Christi,G,4,0,6,0,0,,0,0,,0,0,,0,0,,0,1,1,0,0,0,2,1,0,-0.5
13645,Daniel Munoz\daniel-munoz-2,2013-14,Southern California,G,7,1,14,0,2,.000,0,0,,0,2,.000,0,0,,1,2,3,0,1,0,2,3,0,-0.3
13646,Caleb Martin\caleb-martin-2,2016-17,Pepperdine,G,5,0,5,0,0,,0,0,,0,0,,0,0,,0,2,2,0,0,0,0,0,0,0.1
13647,Marko Stajkovski\marko-stajkovski-1,2016-17,Western Kentucky,G,2,0,3,0,0,,0,0,,0,0,,0,0,,0,1,1,0,0,0,0,0,0,0.2
13648,Riley Conroy\riley-conroy-1,2015-16,Tulane,G,8,0,16,0,6,.000,0,0,,0,6,.000,0,0,,0,0,0,0,0,0,0,2,0,-0.6
13649,Juan Aparicio\juan-aparicio-1,2014-15,Texas A&M,G,1,0,2,0,3,.000,0,3,.000,0,0,,0,0,,0,1,1,0,0,1,0,0,0,-1.1
13650,Michael Schwieterman\michael-schwieterman-1,2015-16,Dayton,G,1,0,1,0,0,,0,0,,0,0,,0,0,,0,0,0,0,0,0,0,1,0,-0.4
13651,Dom Antonelli\dom-antonelli-1,2015-16,Navy,G,1,0,0,0,1,.000,0,0,,0,1,.000,0,0,,0,0,0,0,0,0,0,0,0,-0.7
13652,Lexx Edwards\lexx-edwards-1,2013-14,Florida,G,11,0,15,0,1,.000,0,1,.000,0,0,,0,0,,0,3,3,0,0,0,1,4,0,-0.2
13653,Corey Vinson\corey-vinson-1,2015-16,New Orleans,G,2,0,3,0,0,,0,0,,0,0,,0,0,,0,1,1,0,0,0,0,0,0,0.2
13654,Adam Cumber\adam-cumber-1,2015-16,New Mexico,G,2,0,2,0,1,.000,0,0,,0,1,.000,0,0,,0,0,0,0,0,0,0,0,0,-0.4
13655,Leighton Schrand\leighton-schrand-1,2017-18,Xavier,G,5,0,7,0,0,,0,0,,0,0,,0,0,,0,1,1,0,0,0,4,0,0,-0.7
13656,Josiah Dunn\josiah-dunn-1,2014-15,Denver,G,5,0,3,0,0,,0,0,,0,0,,0,0,,0,2,2,0,0,0,0,0,0,0.1
13657,Josiah Dunn\josiah-dunn-1,2013-14,Denver,G,2,0,3,0,0,,0,0,,0,0,,0,0,,0,0,0,0,0,0,1,0,0,-0.5
13658,Ryan McLaurin\ryan-mclaurin-1,2017-18,Alabama A&M,G,3,0,12,0,3,.000,0,2,.000,0,1,.000,0,0,,0,0,0,0,0,0,3,0,0,-1.7
13659,Aaron Briggs\aaron-briggs-1,2016-17,Navy,G,1,0,2,0,0,,0,0,,0,0,,0,0,,0,0,0,0,0,0,0,0,0,0.0
13660,Tim Donohoe\tim-donohoe-1,2017-18,Stony Brook,G,3,0,6,0,1,.000,0,1,.000,0,0,,0,0,,0,0,0,0,0,0,0,1,0,-0.4
13661,Emmanuel Toney\emmanuel-toney-1,2013-14,Texas A&M-Corpus Christi,G,2,0,5,0,2,.000,0,2,.000,0,0,,0,0,,0,1,1,0,0,0,0,2,0,-1.0
13662,Jonathan Allen\jonathan-allen-1,2013-14,Pepperdine,G,2,0,7,0,0,,0,0,,0,0,,0,0,,0,1,1,0,1,0,0,3,0,0.1
13663,Michael Brown\michael-brown-3,2017-18,Davidson,G,11,0,14,0,1,.000,0,0,,0,1,.000,0,0,,0,0,0,1,0,0,0,1,0,0.0
13664,Sean Gurdon\sean-gurdon-1,2016-17,Mount St. Mary's,G,6,0,9,0,1,.000,0,1,.000,0,0,,0,0,,1,1,2,1,0,1,1,0,0,0.1
13665,Christian Schmitt\christian-schmitt-1,2016-17,South Carolina,G,5,0,7,0,1,.000,0,0,,0,1,.000,0,0,,0,0,0,0,0,0,2,1,0,-0.6
13666,Lionel Love\lionel-love-1,2014-15,Alabama-Birmingham,G,7,0,9,0,0,,0,0,,0,0,,0,0,,0,1,1,0,0,0,0,1,0,0.0
13667,Lyles Davis\lyles-davis-1,2015-16,Clemson,G,6,0,7,0,0,,0,0,,0,0,,0,2,.000,0,0,0,2,0,0,1,2,0,-0.2
13668,Noah Togiai\noah-togiai-1,2015-16,Oregon State,G,2,0,3,0,0,,0,0,,0,0,,0,0,,0,1,1,0,0,0,0,0,0,0.2
13669,Jordan Bushrod\jordan-bushrod-1,2016-17,Delaware State,G,3,0,7,0,0,,0,0,,0,0,,0,0,,1,2,3,0,0,0,0,0,0,0.4
13670,Moe McDonald\moe-mcdonald-1,2013-14,Texas-Rio Grande Valley,G,1,0,3,0,0,,0,0,,0,0,,0,0,,0,0,0,0,0,0,0,0,0,0.0
13671,Dylan Sheehy-Guiseppi\dylan-sheehy-guiseppi-1,2017-18,Virginia Commonwealth,G,4,0,6,0,0,,0,0,,0,0,,0,0,,0,0,0,3,1,0,0,0,0,0.8
13672,Carlitos Anderson\carlitos-anderson-1,2016-17,Akron,G,2,0,6,0,1,.000,0,1,.000,0,0,,0,0,,0,2,2,1,0,0,0,0,0,0.3
13673,Colen Gaynor\colen-gaynor-1,2016-17,Maryland-Eastern Shore,G,1,0,0,0,0,,0,0,,0,0,,0,0,,0,0,0,0,0,0,0,0,0,0.0
13674,Maxwell Chester\maxwell-chester-1,2017-18,Elon,G,2,0,2,0,1,.000,0,1,.000,0,0,,0,0,,0,0,0,0,0,0,0,0,0,-0.4
13675,Brandon Brady\brandon-brady-1,2016-17,Little Rock,G,3,0,4,0,1,.000,0,0,,0,1,.000,0,0,,1,0,1,0,1,0,1,2,0,-0.3
13676,Aric Gresko\aric-gresko-1,2013-14,Saint Francis (PA),G,5,0,10,0,0,,0,0,,0,0,,0,0,,0,0,0,0,0,0,0,0,0,0.0
13677,Daniel Davydov\daniel-davydov-1,2016-17,Portland State,G,1,0,0,0,0,,0,0,,0,0,,0,0,,0,0,0,0,0,0,0,0,0,0.0
13678,Frank Byers\frank-byers-1,2017-18,Texas A&M,G,3,0,5,0,1,.000,0,0,,0,1,.000,0,0,,1,0,1,0,0,0,0,0,0,0.0
13679,Cameron Johnson\cameron-johnson-2,2013-14,Tennessee State,G,1,0,2,0,1,.000,0,0,,0,1,.000,0,0,,0,0,0,0,0,0,1,0,0,-1.7
13680,Oliver Bishop\oliver-bishop-1,2016-17,Eastern Kentucky,G,1,0,1,0,0,,0,0,,0,0,,0,0,,0,0,0,0,0,0,0,0,0,0.0
13681,Tione Jones\tione-jones-1,2017-18,Georgia Southern,G,5,0,8,0,5,.000,0,0,,0,5,.000,0,0,,0,1,1,0,1,1,0,1,0,-0.4
13682,Andy Nelson\andy-nelson-2,2017-18,San Diego,G,4,0,5,0,0,,0,0,,0,0,,0,1,.000,0,0,0,1,0,0,0,1,0,0.0
13683,Jordan Grant\jordan-grant-1,2016-17,Central Arkansas,G,9,0,15,0,0,,0,0,,0,0,,0,0,,0,0,0,1,1,0,0,1,0,0.1
13684,Luke Davis\luke-davis-1,2014-15,North Carolina,G,3,1,4,0,0,,0,0,,0,0,,0,0,,0,0,0,1,0,0,0,1,0,0.1
13685,Derrick Boone\derrick-boone-1,2013-14,Loyola (IL),G,2,0,3,0,1,.000,0,0,,0,1,.000,0,0,,0,2,2,0,0,0,0,0,0,-0.1
13686,Jo'Vontae Millner\jovontae-millner-1,2017-18,Presbyterian,G,1,0,7,0,1,.000,0,0,,0,1,.000,0,0,,0,0,0,0,0,0,2,1,0,-3.1
13687,Eli Lake\eli-lake-1,2017-18,Navy,G,1,0,3,0,0,,0,0,,0,0,,0,0,,0,1,1,0,0,0,1,0,0,-0.7
13688,Jack Westerfield\jack-westerfield-1,2016-17,Dayton,G,3,0,3,0,1,.000,0,0,,0,1,.000,0,1,.000,0,0,0,0,0,0,0,0,0,-0.4
13689,Sean-Michael King\sean-michael-king-1,2013-14,Old Dominion,G,7,0,7,0,2,.000,0,1,.000,0,1,.000,0,0,,0,0,0,0,0,0,0,1,0,-0.3
13690,Restinel Lomotey\restinel-lomotey-1,2016-17,Connecticut,G,7,0,9,0,1,.000,0,1,.000,0,0,,0,0,,0,1,1,0,0,0,0,0,0,-0.1
13691,Mike Fernandez\mike-fernandez-1,2013-14,Miami (FL),G,3,0,4,0,0,,0,0,,0,0,,0,0,,0,0,0,0,0,0,3,0,0,-1.0
13692,Conor Peterson\conor-peterson-1,2016-17,Xavier,G,8,0,8,0,0,,0,0,,0,0,,0,0,,0,2,2,0,0,0,0,0,0,0.1
13693,Nate Galgalo\nate-galgalo-1,2014-15,Eastern Washington,G,5,0,7,0,2,.000,0,1,.000,0,1,.000,0,0,,0,0,0,0,0,0,0,1,0,-0.4
13694,Evin Olds\evin-olds-1,2017-18,Memphis,G,1,0,2,0,0,,0,0,,0,0,,0,0,,0,0,0,0,0,0,0,0,0,0.0
13695,Tino Malnati\tino-malnati-1,2017-18,Northwestern,G,9,0,12,0,4,.000,0,3,.000,0,1,.000,0,0,,0,2,2,1,1,1,1,0,0,-0.1
13696,Tyler Harris\tyler-harris-2,2015-16,Arizona State,G,8,0,13,0,0,,0,0,,0,0,,0,0,,0,2,2,1,0,0,0,0,0,0.2
13697,Michael Brown\michael-brown-3,2016-17,Davidson,G,1,0,1,0,0,,0,0,,0,0,,0,0,,0,0,0,0,0,0,1,0,0,-1.0
13698,Trey Scott\trey-scott-1,2014-15,Alabama State,G,3,0,4,0,0,,0,0,,0,0,,0,0,,0,1,1,0,0,0,1,0,0,-0.2
13699,Jordan Salzman\jordan-salzman-1,2017-18,Arizona State,G,8,0,8,0,3,.000,0,3,.000,0,0,,0,0,,0,0,0,0,0,0,0,0,0,-0.3
13700,Kevin Montminy\kevin-montminy-1,2014-15,Penn State,G,5,1,6,0,2,.000,0,2,.000,0,0,,0,2,.000,1,0,1,0,0,0,0,0,0,-0.3
