Rk,Player,Season,Pos,G,GS,MP,FG,FGA,FG%,2P,2PA,2P%,3P,3PA,3P%,FT,FTA,FT%,ORB,DRB,TRB,AST,STL,BLK,TOV,PF,PTS,GmSc
1,James Harden\hardeja01,2018-19,G,78,78,2867,843,1909,.442,465,881,.528,378,1028,.368,754,858,.879,66,452,518,586,158,58,387,244,2818,26.7
2,Russell Westbrook\westbru01,2016-17,G,81,81,2802,824,1941,.425,624,1358,.459,200,583,.343,710,840,.845,137,727,864,840,132,31,438,190,2558,24.9
3,James Harden\hardeja01,2015-16,G,82,82,3125,710,1617,.439,474,960,.494,236,657,.359,720,837,.860,63,438,501,612,139,51,374,229,2376,21.9
4,Stephen Curry\curryst01,2015-16,G,79,79,2700,805,1598,.504,403,712,.566,402,886,.454,363,400,.908,68,362,430,527,169,15,262,161,2375,24.6
5,James Harden\hardeja01,2016-17,G,81,81,2947,674,1533,.440,412,777,.530,262,756,.347,746,881,.847,95,564,659,907,121,38,464,215,2356,24.3
6,James Harden\hardeja01,2014-15,G,81,81,2981,647,1470,.440,439,915,.480,208,555,.375,715,824,.868,75,384,459,565,154,60,321,208,2217,21.7
7,Isaiah Thomas\thomais02,2016-17,G,76,76,2569,682,1473,.463,437,827,.528,245,646,.379,590,649,.909,43,162,205,448,70,13,210,167,2199,21.2
8,James Harden\hardeja01,2017-18,G,72,72,2551,651,1449,.449,386,727,.531,265,722,.367,624,727,.858,41,348,389,630,126,50,315,169,2191,24.3
9,Kemba Walker\walkeke02,2018-19,G,82,82,2863,731,1684,.434,471,953,.494,260,731,.356,380,450,.844,52,309,361,484,102,34,211,131,2102,18.5
10,Bradley Beal\bealbr01,2018-19,G,82,82,3028,764,1609,.475,555,1013,.548,209,596,.351,362,448,.808,89,322,411,448,121,58,224,226,2099,19.1
11,Damian Lillard\lillada01,2018-19,G,80,80,2838,681,1533,.444,444,890,.499,237,643,.369,468,513,.912,68,303,371,551,88,34,212,148,2067,20.2
12,Russell Westbrook\westbru01,2017-18,G,80,80,2914,757,1687,.449,660,1361,.485,97,326,.298,417,566,.737,152,652,804,820,147,20,381,200,2028,20.8
13,Damian Lillard\lillada01,2016-17,G,75,75,2694,661,1488,.444,447,909,.492,214,579,.370,488,545,.895,46,322,368,440,68,20,197,152,2024,19.8
14,DeMar DeRozan\derozde01,2016-17,G-F,74,74,2620,721,1545,.467,688,1421,.484,33,124,.266,545,647,.842,70,316,386,290,78,13,180,134,2020,18.7
15,Stephen Curry\curryst01,2016-17,G,79,79,2638,675,1443,.468,351,654,.537,324,789,.411,325,362,.898,61,292,353,524,142,17,239,183,1999,20.0
16,Damian Lillard\lillada01,2017-18,G,73,73,2670,621,1415,.439,394,786,.501,227,629,.361,493,538,.916,62,263,325,481,77,27,206,117,1962,20.6
17,Stephen Curry\curryst01,2014-15,G,80,80,2613,653,1341,.487,367,695,.528,286,646,.443,308,337,.914,56,285,341,619,163,16,249,158,1900,20.4
18,Russell Westbrook\westbru01,2014-15,G,67,67,2302,627,1471,.426,541,1183,.457,86,288,.299,546,654,.835,124,364,488,574,140,14,293,184,1886,21.6
19,Stephen Curry\curryst01,2018-19,G,69,69,2331,632,1340,.472,278,530,.525,354,810,.437,263,287,.916,45,324,369,361,92,25,192,166,1881,20.6
20,Damian Lillard\lillada01,2015-16,G,75,75,2676,618,1474,.419,389,864,.450,229,610,.375,414,464,.892,45,257,302,512,65,28,242,165,1879,17.6
21,Russell Westbrook\westbru01,2015-16,G,80,80,2749,656,1444,.454,555,1103,.503,101,341,.296,465,573,.812,145,481,626,834,163,20,342,200,1878,20.9
22,Bradley Beal\bealbr01,2017-18,G,82,82,2977,683,1484,.460,484,954,.507,199,530,.375,292,369,.791,61,302,363,373,96,36,214,160,1857,15.8
23,DeMar DeRozan\derozde01,2017-18,G-F,80,80,2712,645,1413,.456,556,1126,.494,89,287,.310,461,559,.825,59,256,315,417,85,22,175,151,1840,16.8
24,CJ McCollum\mccolcj01,2016-17,G,80,80,2796,692,1441,.480,507,1002,.506,185,439,.421,268,294,.912,60,229,289,285,72,42,172,202,1837,15.7
25,DeMar DeRozan\derozde01,2015-16,G-F,78,78,2804,614,1377,.446,567,1238,.458,47,139,.338,555,653,.850,64,285,349,315,81,21,175,167,1830,16.4
26,Kemba Walker\walkeke02,2016-17,G,79,79,2739,643,1449,.444,403,847,.476,240,602,.399,304,359,.847,45,263,308,434,85,22,168,119,1830,17.1
27,Donovan Mitchell\mitchdo01,2018-19,G,77,77,2598,661,1530,.432,473,1011,.468,188,519,.362,319,396,.806,59,257,316,322,106,31,218,208,1829,15.1
28,Isaiah Thomas\thomais02,2015-16,G,82,79,2644,591,1382,.428,424,917,.462,167,465,.359,474,544,.871,46,197,243,509,91,9,220,167,1823,16.1
29,Kyrie Irving\irvinky01,2016-17,G,72,72,2525,671,1420,.473,494,979,.505,177,441,.401,297,328,.905,52,178,230,418,83,24,180,157,1816,18.3
30,John Wall\walljo01,2016-17,G,78,78,2836,647,1435,.451,558,1163,.480,89,272,.327,422,527,.801,59,267,326,831,157,49,322,151,1805,19.6
31,Lou Williams\willilo02,2017-18,G,79,19,2589,582,1337,.435,396,819,.484,186,518,.359,432,491,.880,40,158,198,417,85,19,234,106,1782,15.8
32,Bradley Beal\bealbr01,2016-17,G,77,77,2684,637,1322,.482,414,770,.538,223,552,.404,282,342,.825,53,187,240,267,83,21,156,169,1779,16.1
33,Klay Thompson\thompkl01,2015-16,G-F,80,80,2666,651,1386,.470,375,736,.510,276,650,.425,193,221,.873,35,271,306,166,60,49,138,152,1771,14.6
34,Kemba Walker\walkeke02,2017-18,G,80,80,2736,588,1363,.431,357,762,.469,231,601,.384,363,420,.864,32,216,248,444,91,24,179,98,1770,16.4
35,Klay Thompson\thompkl01,2016-17,G-F,78,78,2649,644,1376,.468,376,729,.516,268,647,.414,186,218,.853,49,236,285,160,66,40,128,139,1742,14.8
36,Victor Oladipo\oladivi01,2017-18,G,75,75,2552,640,1342,.477,479,908,.528,161,434,.371,294,368,.799,47,343,390,323,177,57,219,175,1735,17.5
37,CJ McCollum\mccolcj01,2017-18,G,81,81,2923,667,1505,.443,478,1029,.465,189,476,.397,209,250,.836,53,268,321,272,77,35,151,168,1732,13.8
38,Devin Booker\bookede01,2016-17,G,78,78,2730,606,1431,.423,459,1026,.447,147,405,.363,367,441,.832,46,203,249,268,72,21,241,242,1726,12.4
39,Damian Lillard\lillada01,2014-15,G,82,82,2925,590,1360,.434,394,788,.500,196,572,.343,344,398,.864,49,329,378,507,97,21,222,164,1720,15.8
40,D'Angelo Russell\russeda01,2018-19,G,81,81,2448,659,1517,.434,425,882,.482,234,635,.369,160,205,.780,53,262,315,563,100,20,253,141,1712,14.9
41,Devin Booker\bookede01,2018-19,G,64,64,2242,586,1255,.467,451,841,.536,135,414,.326,393,454,.866,39,226,265,433,56,13,264,200,1700,18.0
42,Buddy Hield\hieldbu01,2018-19,G,82,82,2615,623,1360,.458,345,709,.487,278,651,.427,171,193,.886,106,306,412,205,58,33,146,202,1695,14.0
43,Kemba Walker\walkeke02,2015-16,G,81,81,2885,568,1331,.427,386,841,.459,182,490,.371,371,438,.847,56,301,357,421,126,39,171,111,1689,16.3
44,Klay Thompson\thompkl01,2018-19,G-F,78,78,2652,655,1402,.467,414,803,.516,241,599,.402,129,158,.816,37,262,299,186,84,47,115,157,1680,14.4
45,Russell Westbrook\westbru01,2018-19,G,73,73,2630,630,1473,.428,511,1062,.481,119,411,.290,296,451,.656,109,698,807,784,142,33,325,245,1675,19.3
46,Klay Thompson\thompkl01,2014-15,G-F,77,77,2455,602,1299,.463,363,754,.481,239,545,.439,225,256,.879,27,220,247,222,87,60,149,122,1668,15.0
47,CJ McCollum\mccolcj01,2015-16,G,80,80,2780,641,1431,.448,444,959,.463,197,472,.417,187,226,.827,47,212,259,341,97,23,196,187,1666,13.5
48,DeMar DeRozan\derozde01,2018-19,G-F,77,77,2688,631,1313,.481,624,1268,.492,7,45,.156,366,441,.830,54,408,462,475,86,36,199,177,1635,16.5
49,Kyle Lowry\lowryky01,2015-16,G,77,77,2851,512,1198,.427,300,651,.461,212,547,.388,398,491,.811,55,310,365,494,158,34,225,211,1634,17.0
50,Kyrie Irving\irvinky01,2014-15,G,75,75,2730,578,1235,.468,421,857,.491,157,378,.415,315,365,.863,55,182,237,389,114,20,186,146,1628,16.3
51,Donovan Mitchell\mitchdo01,2017-18,G,79,71,2638,595,1362,.437,408,812,.502,187,550,.340,239,297,.805,52,244,296,291,118,27,215,213,1616,13.0
52,Kyrie Irving\irvinky01,2018-19,G,67,67,2214,604,1241,.487,430,807,.533,174,434,.401,214,245,.873,71,264,335,464,103,34,172,167,1596,19.4
53,Chris Paul\paulch01,2014-15,G,82,82,2857,568,1170,.485,429,821,.523,139,349,.398,289,321,.900,52,324,376,838,156,15,190,203,1564,19.2
54,Trae Young\youngtr01,2018-19,G,81,81,2503,525,1256,.418,369,774,.477,156,482,.324,343,414,.829,64,237,301,653,72,15,308,140,1549,14.1
55,Jrue Holiday\holidjr01,2017-18,G,81,81,2927,615,1244,.494,495,888,.557,120,356,.337,187,238,.786,62,303,365,486,123,64,213,201,1537,15.3
56,John Wall\walljo01,2015-16,G,77,77,2784,572,1349,.424,457,1021,.448,115,328,.351,272,344,.791,42,337,379,789,145,59,318,159,1531,16.5
57,Luka Dončić\doncilu01,2018-19,G-F,72,72,2318,506,1186,.427,338,672,.503,168,514,.327,346,485,.713,86,477,563,429,77,25,247,137,1526,15.8
58,Monta Ellis\ellismo01,2014-15,G,80,80,2699,602,1354,.445,521,1070,.487,81,284,.285,228,303,.752,34,156,190,329,148,25,198,197,1513,12.1
59,Lou Williams\willilo02,2018-19,G,75,1,1993,484,1138,.425,379,847,.447,105,291,.361,425,485,.876,40,182,222,402,57,11,181,80,1498,14.5
60,Zach LaVine\lavinza01,2018-19,G,63,62,2171,530,1135,.467,410,814,.504,120,321,.374,312,375,.832,40,254,294,283,60,26,215,140,1492,15.8
61,Reggie Jackson\jacksre01,2015-16,G,79,79,2424,540,1244,.434,422,910,.464,118,334,.353,291,337,.864,58,195,253,492,59,11,223,187,1489,13.0
62,Goran Dragić\dragigo01,2016-17,G,73,73,2459,534,1124,.475,417,835,.499,117,289,.405,298,377,.790,62,217,279,423,89,13,212,199,1483,14.9
63,Mike Conley\conlemi01,2018-19,G,70,70,2342,490,1120,.438,335,694,.483,155,426,.364,343,406,.845,40,199,239,449,94,22,130,123,1478,17.1
64,CJ McCollum\mccolcj01,2018-19,G,70,70,2375,571,1243,.459,404,798,.506,167,445,.375,159,192,.828,62,220,282,207,55,28,106,172,1468,13.8
65,Kyrie Irving\irvinky01,2017-18,G,60,60,1931,534,1087,.491,368,680,.541,166,407,.408,232,261,.889,33,194,227,306,65,17,140,122,1466,18.2
66,Klay Thompson\thompkl01,2017-18,G-F,73,73,2506,575,1179,.488,346,658,.526,229,521,.440,82,98,.837,31,246,277,185,55,34,128,117,1461,13.5
67,Bojan Bogdanović\bogdabo02,2018-19,G-F,81,81,2573,522,1051,.497,358,665,.538,164,386,.425,246,305,.807,33,300,333,161,69,1,134,138,1454,12.5
68,Chris Paul\paulch01,2015-16,G,74,74,2420,515,1114,.462,393,785,.501,122,329,.371,294,328,.896,39,271,310,738,152,13,194,185,1446,18.6
69,Lou Williams\willilo02,2016-17,G,81,1,1993,428,998,.429,265,552,.480,163,446,.365,402,457,.880,26,176,202,239,80,20,160,92,1421,12.4
70,Jrue Holiday\holidjr01,2018-19,G,67,67,2402,547,1159,.472,429,796,.539,118,363,.325,208,271,.768,75,259,334,518,109,54,210,148,1420,17.5
71,Mike Conley\conlemi01,2016-17,G,69,68,2292,464,1009,.460,293,590,.497,171,419,.408,316,368,.859,31,210,241,433,92,19,156,126,1415,16.8
72,Dennis Schröder\schrode01,2016-17,G,79,78,2485,548,1214,.451,448,920,.487,100,294,.340,218,255,.855,42,206,248,499,74,16,258,149,1414,12.4
73,Dwyane Wade\wadedw01,2015-16,G,74,73,2258,540,1183,.456,533,1139,.468,7,44,.159,322,406,.793,82,220,302,344,79,42,203,116,1409,13.3
74,De'Aaron Fox\foxde01,2018-19,G,81,81,2546,505,1102,.458,419,870,.482,86,232,.371,303,417,.727,43,261,304,590,133,45,227,204,1399,14.3
75,Eric Bledsoe\bledser01,2016-17,G,66,66,2176,449,1034,.434,345,724,.477,104,310,.335,388,458,.847,52,268,320,418,91,31,224,164,1390,15.9
76,John Wall\walljo01,2014-15,G,79,79,2837,519,1166,.445,454,949,.478,65,217,.300,284,362,.785,36,330,366,792,138,45,304,180,1387,15.4
77,Eric Bledsoe\bledser01,2014-15,G,81,81,2800,468,1046,.447,380,774,.491,88,272,.324,353,441,.800,72,351,423,493,127,45,274,189,1377,13.7
78,J.J. Redick\redicjj01,2018-19,G,76,63,2379,452,1027,.440,212,422,.502,240,605,.397,228,255,.894,20,166,186,206,32,17,101,129,1372,12.1
79,Collin Sexton\sextoco01,2018-19,G,82,72,2605,519,1206,.430,400,910,.440,119,296,.402,214,255,.839,57,179,236,243,44,6,185,186,1371,9.4
80,Jamal Murray\murraja01,2018-19,G,75,74,2447,513,1173,.437,361,759,.476,152,414,.367,189,223,.848,65,252,317,363,67,27,158,153,1367,13.1
81,Jordan Clarkson\clarkjo01,2018-19,G,81,0,2214,529,1180,.448,385,735,.524,144,445,.324,162,192,.844,82,188,270,196,57,13,135,112,1364,10.8
82,Jamal Murray\murraja01,2017-18,G,81,80,2565,479,1062,.451,314,626,.502,165,436,.378,229,253,.905,82,215,297,274,79,28,172,173,1352,11.9
83,Devin Booker\bookede01,2017-18,G,54,54,1865,455,1054,.432,308,670,.460,147,384,.383,289,329,.878,26,218,244,253,47,14,194,168,1346,15.4
84,Stephen Curry\curryst01,2017-18,G,51,51,1631,428,864,.495,216,363,.595,212,501,.423,278,302,.921,36,225,261,310,80,8,153,114,1346,21.6
85,Kyle Lowry\lowryky01,2016-17,G,60,60,2244,426,918,.464,233,450,.518,193,468,.412,299,365,.819,48,238,286,417,88,19,173,170,1344,18.4
86,Ben Simmons\simmobe01,2018-19,G-F,79,79,2700,540,960,.563,540,954,.566,0,6,.000,257,428,.600,172,525,697,610,112,61,274,209,1337,16.6
87,Dwyane Wade\wadedw01,2014-15,G,62,62,1971,509,1084,.470,480,982,.489,29,102,.284,284,370,.768,58,161,219,299,73,21,209,105,1331,14.1
88,Eric Bledsoe\bledser01,2017-18,G,74,74,2322,468,989,.473,343,629,.545,125,360,.347,252,317,.795,51,233,284,370,149,42,216,185,1313,14.0
89,Tyreke Evans\evansty01,2014-15,G-F,79,76,2690,521,1165,.447,452,938,.482,69,227,.304,202,291,.694,82,334,416,521,100,37,246,198,1313,12.6
90,Dennis Schröder\schrode01,2017-18,G,67,67,2078,500,1146,.436,424,884,.480,76,262,.290,225,265,.849,44,164,208,417,72,6,183,147,1301,13.3
91,Goran Dragić\dragigo01,2017-18,G,75,75,2378,484,1075,.450,373,775,.481,111,300,.370,217,271,.801,54,253,307,359,63,12,166,180,1296,12.2
92,Victor Oladipo\oladivi01,2014-15,G,72,71,2573,473,1086,.436,389,838,.464,84,248,.339,262,320,.819,51,251,302,295,120,19,204,187,1292,12.1
93,Ben Simmons\simmobe01,2017-18,G-F,81,81,2732,544,998,.545,544,987,.551,0,11,.000,191,341,.560,145,514,659,661,140,70,278,211,1279,15.8
94,J.J. Redick\redicjj01,2014-15,G,78,78,2409,447,938,.477,247,480,.515,200,458,.437,183,203,.901,22,145,167,137,39,8,95,134,1277,10.8
95,Goran Dragić\dragigo01,2014-15,G,78,78,2640,502,1002,.501,412,743,.555,90,259,.347,181,234,.774,81,193,274,350,78,15,173,195,1275,12.2
96,Will Barton\bartowi01,2017-18,G,81,40,2683,465,1028,.452,309,606,.510,156,422,.370,182,226,.805,70,339,409,331,82,52,149,168,1268,12.4
97,Kyle Lowry\lowryky01,2017-18,G,78,78,2510,403,944,.427,165,348,.474,238,596,.399,223,261,.854,66,368,434,537,85,19,183,192,1267,14.4
98,Reggie Jackson\jacksre01,2018-19,G,82,82,2289,441,1047,.421,267,576,.464,174,471,.369,204,236,.864,45,171,216,344,55,9,148,208,1260,10.3
99,Jeff Teague\teaguje01,2016-17,G,82,82,2657,402,909,.442,312,657,.475,90,252,.357,360,415,.867,33,297,330,639,100,32,216,165,1254,14.1
100,Kyle Lowry\lowryky01,2014-15,G,70,70,2414,430,1043,.412,298,652,.457,132,391,.338,252,312,.808,54,274,328,473,109,13,173,212,1244,13.9
101,Eric Gordon\gordoer01,2017-18,G,69,30,2154,415,970,.428,197,362,.544,218,608,.359,195,241,.809,25,145,170,154,44,27,130,116,1243,11.1
102,Lou Williams\willilo02,2014-15,G,80,0,2016,375,928,.404,223,481,.464,152,447,.340,340,395,.861,24,127,151,164,88,10,101,103,1242,10.5
103,Eric Bledsoe\bledser01,2018-19,G,78,78,2272,470,971,.484,346,594,.582,124,377,.329,177,236,.750,82,280,362,430,116,29,165,156,1241,13.8
104,Jeff Teague\teaguje01,2015-16,G,79,78,2255,434,988,.439,324,714,.454,110,274,.401,261,312,.837,33,181,214,470,97,24,218,167,1239,11.8
105,Evan Fournier\fournev01,2018-19,G-F,81,81,2553,468,1069,.438,315,619,.509,153,450,.340,137,170,.806,38,220,258,295,71,12,154,225,1226,9.7
106,J.J. Redick\redicjj01,2015-16,G,75,75,2097,422,880,.480,222,459,.484,200,421,.475,182,205,.888,10,129,139,106,42,5,78,135,1226,10.7
107,Jordan Clarkson\clarkjo01,2015-16,G,79,79,2552,475,1098,.433,364,778,.468,111,320,.347,164,204,.804,93,220,313,192,88,7,135,168,1225,10.0
108,Dennis Schröder\schrode01,2018-19,G,79,14,2314,457,1104,.414,333,740,.450,124,364,.341,186,227,.819,38,246,284,323,65,12,172,189,1224,9.7
109,Eric Gordon\gordoer01,2016-17,G,75,15,2323,412,1016,.406,166,355,.468,246,661,.372,147,175,.840,29,172,201,188,48,41,121,150,1217,10.1
110,Evan Fournier\fournev01,2015-16,G-F,79,71,2566,429,929,.462,273,539,.506,156,390,.400,199,238,.836,33,192,225,213,96,2,133,214,1213,10.5
111,Josh Richardson\richajo01,2018-19,G,73,73,2539,423,1026,.412,259,566,.458,164,460,.357,199,231,.861,54,209,263,298,79,34,113,200,1209,11.9
112,Jeremy Lamb\lambje01,2018-19,G-F,79,55,2250,431,979,.440,316,649,.487,115,330,.348,231,260,.888,65,369,434,172,88,32,80,140,1208,11.8
113,Jordan Clarkson\clarkjo01,2016-17,G,82,19,2397,477,1071,.445,360,715,.503,117,356,.329,134,168,.798,49,197,246,213,88,8,164,150,1205,9.1
114,DeMar DeRozan\derozde01,2014-15,G-F,60,60,2100,409,990,.413,384,902,.426,25,88,.284,361,434,.832,41,236,277,210,73,11,137,122,1204,13.1
115,J.J. Redick\redicjj01,2017-18,G,70,70,2116,404,879,.460,211,419,.504,193,460,.420,197,218,.904,9,169,178,210,35,6,103,123,1198,11.8
116,Will Barton\bartowi01,2015-16,G,82,1,2353,425,983,.432,313,658,.476,112,325,.345,216,268,.806,59,417,476,203,71,39,139,147,1178,10.3
117,Tim Hardaway\hardati02,2018-19,G,65,63,2057,390,993,.393,228,516,.442,162,477,.340,232,276,.841,33,189,222,159,54,8,105,141,1174,10.9
118,J.J. Redick\redicjj01,2016-17,G,78,78,2198,396,890,.445,195,422,.462,201,468,.429,180,202,.891,11,160,171,110,54,13,98,125,1173,9.6
119,Gary Harris\harriga01,2017-18,G,67,65,2304,440,908,.485,284,514,.553,156,394,.396,134,162,.827,37,139,176,194,122,15,119,119,1170,13.0
120,Evan Fournier\fournev01,2016-17,G-F,68,66,2234,408,930,.439,280,570,.491,128,360,.356,223,277,.805,44,165,209,202,66,4,141,180,1167,10.8
121,Jeff Teague\teaguje01,2014-15,G,73,72,2228,408,887,.460,337,680,.496,71,207,.343,275,319,.862,30,154,184,513,125,31,205,139,1162,13.7
122,Kobe Bryant\bryanko01,2015-16,G-F,66,66,1863,398,1113,.358,265,646,.410,133,467,.285,232,281,.826,41,206,247,184,62,13,129,115,1161,9.7
123,Avery Bradley\bradlav01,2015-16,G,76,72,2536,456,1019,.447,309,612,.505,147,407,.361,96,123,.780,48,172,220,158,117,19,109,164,1155,10.1
124,Joe Johnson\johnsjo02,2014-15,G-F,80,80,2791,446,1025,.435,325,688,.472,121,337,.359,141,176,.801,53,331,384,292,59,14,137,120,1154,10.3
125,Derrick Rose\rosede01,2016-17,G,64,64,2082,460,977,.471,447,917,.487,13,60,.217,221,253,.874,66,180,246,283,44,17,147,84,1154,12.7
126,Victor Oladipo\oladivi01,2015-16,G,72,52,2379,425,970,.438,327,688,.475,98,282,.348,205,247,.830,48,297,345,282,116,54,153,174,1153,12.2
127,Zach LaVine\lavinza01,2015-16,G,82,33,2294,433,959,.452,310,643,.482,123,316,.389,161,203,.793,27,201,228,251,69,17,155,193,1150,9.0
128,Rodney Hood\hoodro01,2015-16,G-F,79,79,2541,408,972,.420,247,523,.472,161,449,.359,172,200,.860,38,229,267,213,73,16,125,202,1149,9.4
129,Spencer Dinwiddie\dinwisp01,2018-19,G,68,4,1914,366,828,.442,242,458,.528,124,370,.335,287,356,.806,26,140,166,311,40,17,152,187,1143,11.5
130,Tim Hardaway\hardati02,2016-17,G,79,30,2154,415,912,.455,266,495,.537,149,417,.357,164,214,.766,35,189,224,182,55,15,106,103,1143,9.8
131,Ty Lawson\lawsoty01,2014-15,G,75,75,2665,404,926,.436,334,721,.463,70,205,.341,265,363,.730,42,192,234,720,92,9,185,128,1143,14.3
132,Bojan Bogdanović\bogdabo02,2017-18,G-F,80,80,2464,404,852,.474,249,466,.534,155,386,.402,178,205,.868,30,240,270,119,55,8,106,129,1141,9.7
133,Jordan Clarkson\clarkjo01,2017-18,G,81,2,1887,430,954,.451,318,636,.500,112,318,.352,152,190,.800,57,160,217,221,58,6,127,107,1124,9.2
134,Monta Ellis\ellismo01,2015-16,G,81,81,2734,436,1021,.427,349,739,.472,87,282,.309,162,206,.786,42,229,271,383,150,37,203,174,1121,10.3
135,Jamal Crawford\crawfja01,2015-16,G,79,5,2126,379,939,.404,262,595,.440,117,344,.340,245,271,.904,20,125,145,183,52,12,113,122,1120,8.6
136,Reggie Jackson\jacksre01,2014-15,G,77,40,2268,432,996,.434,360,755,.477,72,241,.299,181,218,.830,56,271,327,462,62,9,186,167,1117,10.9
137,Bojan Bogdanović\bogdabo02,2016-17,G-F,81,54,2083,376,845,.445,232,453,.512,144,392,.367,217,243,.893,37,240,277,111,34,7,131,146,1113,8.5
138,Mike Conley\conlemi01,2014-15,G,70,70,2225,393,882,.446,286,605,.473,107,277,.386,214,249,.859,29,180,209,375,89,14,156,139,1107,12.2
139,Kentavious Caldwell-Pope\caldwke01,2015-16,G,76,76,2789,403,960,.420,289,591,.489,114,369,.309,185,228,.811,70,212,282,138,110,17,105,167,1105,9.7
140,Chris Paul\paulch01,2016-17,G,61,61,1921,374,785,.476,250,483,.518,124,302,.411,232,260,.892,40,264,304,563,119,8,147,146,1104,18.3
141,Eric Gordon\gordoer01,2018-19,G,68,53,2158,384,938,.409,168,338,.497,216,600,.360,119,152,.783,17,131,148,129,41,27,90,143,1103,9.4
142,Isaiah Thomas\thomais02,2014-15,G,67,1,1726,335,797,.420,206,451,.457,129,346,.373,302,348,.868,33,120,153,284,57,5,143,150,1101,11.6
143,Dwyane Wade\wadedw01,2016-17,G,60,59,1792,414,955,.434,369,810,.456,45,145,.310,223,281,.794,63,207,270,228,86,41,138,112,1096,12.8
144,Jrue Holiday\holidjr01,2015-16,G,65,23,1831,410,935,.439,323,676,.478,87,259,.336,182,216,.843,27,168,195,391,88,22,167,148,1089,12.4
145,Dwyane Wade\wadedw01,2018-19,G,72,2,1885,416,960,.433,330,699,.472,86,261,.330,165,233,.708,69,216,285,301,59,38,166,118,1083,10.4
146,Chris Paul\paulch01,2017-18,G,58,58,1847,367,798,.460,223,419,.532,144,379,.380,203,221,.919,37,276,313,457,96,14,128,141,1081,17.4
147,Derrick Rose\rosede01,2015-16,G,66,66,2097,447,1048,.427,403,898,.449,44,150,.293,142,179,.793,46,179,225,311,44,14,175,84,1080,10.0
148,Buddy Hield\hieldbu01,2017-18,G,80,13,2024,416,933,.446,240,525,.457,176,408,.431,71,81,.877,55,252,307,155,85,22,124,148,1079,9.1
149,Kemba Walker\walkeke02,2014-15,G,62,58,2119,378,981,.385,293,701,.418,85,280,.304,234,283,.827,35,185,220,318,89,31,100,92,1075,12.8
150,Avery Bradley\bradlav01,2014-15,G,77,77,2428,434,1012,.429,310,660,.470,124,352,.352,79,100,.790,46,195,241,135,82,15,109,177,1071,8.1
151,Brandon Knight\knighbr03,2014-15,G,63,61,2035,375,888,.422,250,567,.441,125,321,.389,195,223,.874,28,216,244,330,90,10,189,114,1070,12.1
152,Victor Oladipo\oladivi01,2016-17,G,67,67,2222,412,932,.442,285,580,.491,127,352,.361,116,154,.753,39,252,291,176,78,21,119,155,1067,10.5
153,D'Angelo Russell\russeda01,2015-16,G,80,48,2259,392,956,.410,262,586,.447,130,370,.351,140,190,.737,47,227,274,266,93,13,196,142,1054,8.2
154,Devin Booker\bookede01,2015-16,G,76,51,2108,367,867,.423,268,578,.464,99,289,.343,215,256,.840,27,160,187,200,44,20,160,225,1048,7.7
155,Dennis Smith\smithde03,2017-18,G,69,69,2049,404,1024,.395,298,685,.435,106,339,.313,134,193,.694,50,210,260,358,71,18,194,152,1048,9.4
156,Kentavious Caldwell-Pope\caldwke01,2016-17,G,76,75,2529,370,928,.399,217,491,.442,153,437,.350,154,185,.832,55,193,248,193,89,12,86,118,1047,9.6
157,Elfrid Payton\paytoel01,2016-17,G,82,58,2412,430,912,.471,390,766,.509,40,146,.274,146,211,.692,89,298,387,529,88,40,178,177,1046,11.5
158,Josh Richardson\richajo01,2017-18,G,81,81,2689,399,885,.451,272,549,.495,127,336,.378,120,142,.845,69,216,285,231,121,75,140,199,1045,9.9
159,Kentavious Caldwell-Pope\caldwke01,2014-15,G,82,82,2587,390,972,.401,237,528,.449,153,444,.345,110,158,.696,46,209,255,109,93,18,94,161,1043,7.5
160,Joe Harris\harrijo01,2018-19,G,76,76,2293,374,748,.500,191,362,.528,183,386,.474,110,133,.827,52,239,291,181,38,17,121,182,1041,9.9
161,Kyrie Irving\irvinky01,2015-16,G,53,53,1667,394,879,.448,310,617,.502,84,262,.321,169,191,.885,44,113,157,249,56,18,124,107,1041,13.5
162,Arron Afflalo\afflaar01,2014-15,G-F,78,72,2502,375,884,.424,257,551,.466,118,333,.354,167,198,.843,27,220,247,129,41,7,116,167,1035,7.6
163,Darren Collison\collida01,2015-16,G,74,15,2219,377,776,.486,290,559,.519,87,217,.401,194,226,.858,28,141,169,318,76,4,130,142,1035,10.9
164,Jeremy Lamb\lambje01,2017-18,G-F,80,18,1967,380,832,.457,286,578,.495,94,254,.370,179,208,.861,49,275,324,186,61,32,93,138,1033,9.7
165,Jrue Holiday\holidjr01,2016-17,G,67,61,2190,405,893,.454,305,612,.498,100,281,.356,119,168,.708,46,218,264,488,100,44,194,133,1029,13.0
166,Lou Williams\willilo02,2015-16,G,67,35,1907,283,693,.408,173,373,.464,110,320,.344,352,424,.830,31,138,169,167,62,19,107,107,1028,10.9
167,E'Twaun Moore\mooreet01,2017-18,G-F,82,80,2586,423,832,.508,295,531,.556,128,301,.425,48,68,.706,57,181,238,187,79,12,102,182,1022,9.0
168,Goran Dragić\dragigo01,2015-16,G,72,72,2363,417,875,.477,353,670,.527,64,205,.312,120,165,.727,54,223,277,419,71,17,185,188,1018,10.8
169,Brandon Knight\knighbr03,2015-16,G,52,50,1870,371,895,.415,251,544,.461,120,351,.342,156,183,.852,36,166,202,263,61,20,177,124,1018,12.2
170,Evan Fournier\fournev01,2017-18,G-F,57,57,1837,368,802,.459,241,467,.516,127,335,.379,150,173,.867,23,157,180,165,47,16,95,138,1013,11.9
171,Jamal Crawford\crawfja01,2014-15,G,64,4,1703,332,839,.396,213,475,.448,119,364,.327,227,252,.901,18,106,124,158,59,14,92,108,1010,9.9
172,Tyreke Evans\evansty01,2017-18,G-F,52,32,1607,366,809,.452,252,523,.482,114,286,.399,164,209,.785,44,221,265,269,57,17,117,96,1010,14.8
173,Jamal Crawford\crawfja01,2016-17,G,82,1,2157,359,870,.413,243,548,.443,116,322,.360,174,203,.857,17,112,129,214,61,14,134,115,1008,7.5
174,Ricky Rubio\rubiori01,2017-18,G,77,77,2254,346,827,.418,250,554,.451,96,273,.352,220,254,.866,44,307,351,410,121,11,207,206,1008,10.4
175,Spencer Dinwiddie\dinwisp01,2017-18,G,80,58,2306,324,838,.387,183,405,.452,141,433,.326,218,268,.813,40,219,259,524,68,23,128,186,1007,10.9
176,Tyler Johnson\johnsty01,2016-17,G,73,0,2178,357,824,.433,264,574,.460,93,250,.372,195,254,.768,50,243,293,233,84,44,90,176,1002,10.5
177,Malcolm Brogdon\brogdma01,2018-19,G,64,64,1832,378,748,.505,274,504,.544,104,244,.426,141,152,.928,65,223,288,205,46,13,91,102,1001,12.6
178,Tim Hardaway\hardati02,2017-18,G,57,54,1885,360,856,.421,230,446,.516,130,410,.317,146,179,.816,32,192,224,155,62,10,92,123,996,11.3
179,Ben McLemore\mclembe01,2014-15,G,82,82,2670,363,831,.437,223,440,.507,140,391,.358,130,160,.813,31,210,241,140,77,19,138,219,996,7.3
180,Jeff Teague\teaguje01,2017-18,G,70,70,2311,354,794,.446,270,566,.477,84,228,.368,202,239,.845,24,185,209,492,102,23,177,171,994,12.2
181,Kentavious Caldwell-Pope\caldwke01,2017-18,G,74,74,2458,340,798,.426,181,383,.473,159,415,.383,153,194,.789,60,327,387,162,106,16,97,145,992,10.4
182,Joe Johnson\johnsjo02,2015-16,G-F,81,81,2703,377,859,.439,257,546,.471,120,313,.383,118,142,.831,49,243,292,318,61,4,159,146,992,8.7
183,Bogdan Bogdanović\bogdabo01,2018-19,G,70,17,1947,361,863,.418,227,491,.462,134,372,.360,134,162,.827,40,203,243,267,72,15,117,142,990,10.1
184,Allen Crabbe\crabbal01,2017-18,G-F,75,68,2197,337,827,.407,136,295,.461,201,532,.378,115,135,.852,28,296,324,117,47,35,78,168,990,8.7
185,Wesley Matthews\matthwe02,2016-17,G,73,73,2495,333,847,.393,159,368,.432,174,479,.363,146,179,.816,18,241,259,210,77,15,102,161,986,9.1
186,D'Angelo Russell\russeda01,2016-17,G,63,60,1811,351,867,.405,216,483,.447,135,384,.352,147,188,.782,31,190,221,303,87,16,176,130,984,10.5
187,Wesley Matthews\matthwe02,2015-16,G,78,78,2644,331,854,.388,142,329,.432,189,525,.360,126,146,.863,27,211,238,151,78,17,78,179,977,8.1
188,Tony Parker\parketo01,2014-15,G,68,68,1953,404,832,.486,366,743,.493,38,89,.427,130,166,.783,15,114,129,335,44,2,146,108,976,9.9
189,Trey Burke\burketr01,2014-15,G,76,43,2288,370,1005,.368,246,615,.400,124,390,.318,109,145,.752,31,173,204,328,65,15,124,119,973,8.0
190,Ish Smith\smithis01,2015-16,G,77,53,2239,397,967,.411,341,797,.428,56,170,.329,122,176,.693,43,262,305,502,88,24,175,133,972,10.0
191,Marco Belinelli\belinma01,2017-18,G-F,80,2,1947,337,764,.441,188,369,.509,149,395,.377,148,163,.908,20,131,151,148,66,12,94,91,971,8.3
192,Gerald Henderson\hendege02,2014-15,G,80,72,2315,370,847,.437,325,711,.457,45,136,.331,184,217,.848,36,237,273,206,51,22,110,135,969,8.2
193,Bryn Forbes\forbebr01,2018-19,G,82,81,2293,361,791,.456,185,378,.489,176,413,.426,69,78,.885,18,221,239,175,45,4,80,159,967,8.0
194,Michael Carter-Williams\cartemi01,2014-15,G,66,63,2150,364,919,.396,328,766,.428,36,153,.235,202,291,.694,64,289,353,442,111,30,253,167,966,10.4
195,Mo Williams\willima01,2014-15,G,68,33,1980,341,860,.397,222,512,.434,119,348,.342,163,187,.872,22,152,174,424,46,14,172,162,964,9.8
196,Bradley Beal\bealbr01,2014-15,G,63,59,2107,363,851,.427,257,592,.434,106,259,.409,130,166,.783,57,184,241,194,76,18,123,136,962,10.1
197,Jonathon Simmons\simmojo02,2017-18,G-F,69,50,2029,354,761,.465,285,557,.512,69,204,.338,185,241,.768,61,178,239,171,58,16,146,175,962,8.9
198,Bradley Beal\bealbr01,2015-16,G,55,35,1708,359,799,.449,254,528,.481,105,271,.387,135,176,.767,41,147,188,162,54,11,112,117,958,11.2
199,Jarrett Jack\jackja01,2014-15,G,80,27,2241,359,817,.439,320,671,.477,39,146,.267,200,227,.881,19,226,245,373,75,13,191,143,957,8.7
200,Wesley Matthews\matthwe02,2014-15,G,60,60,2024,337,752,.448,164,307,.534,173,445,.389,109,145,.752,38,184,222,139,77,10,81,132,956,11.3
201,J.R. Smith\smithjr01,2015-16,G-F,77,77,2362,353,850,.415,149,340,.438,204,510,.400,45,71,.634,43,174,217,130,81,21,59,204,955,8.0
202,Aaron Brooks\brookaa01,2014-15,G,82,21,1885,344,817,.421,223,504,.442,121,313,.387,145,174,.833,32,134,166,261,54,15,157,189,954,7.1
203,D.J. Augustin\augusdj01,2018-19,G,81,81,2269,318,677,.470,187,366,.511,131,311,.421,181,209,.866,41,162,203,426,52,4,128,115,948,10.4
204,Danny Green\greenda02,2014-15,G-F,81,80,2312,322,738,.436,131,281,.466,191,457,.418,111,127,.874,54,289,343,158,101,87,93,163,946,9.8
205,C.J. Miles\milescj01,2014-15,G-F,70,40,1841,329,827,.398,175,381,.459,154,446,.345,130,161,.807,18,196,214,75,60,26,73,132,942,8.0
206,Dion Waiters\waitedi01,2014-15,G,80,23,2208,375,946,.396,302,700,.431,73,246,.297,117,172,.680,41,151,192,163,90,21,113,155,940,6.5
207,Kentavious Caldwell-Pope\caldwke01,2018-19,G,82,23,2035,325,756,.430,174,321,.542,151,435,.347,137,158,.867,48,190,238,110,73,13,65,137,938,8.1
208,Gary Harris\harriga01,2015-16,G,76,76,2439,359,765,.469,254,468,.543,105,297,.354,109,133,.820,54,166,220,147,97,18,98,143,932,8.9
209,Kyle Lowry\lowryky01,2018-19,G,65,65,2213,304,739,.411,147,286,.514,157,453,.347,161,194,.830,41,271,312,564,91,31,182,166,926,13.6
210,Austin Rivers\riverau01,2017-18,G,61,59,2057,341,805,.424,205,445,.461,136,360,.378,102,159,.642,27,118,145,242,74,16,109,152,920,10.0
211,Sean Kilpatrick\kilpase01,2016-17,G,70,24,1754,305,735,.415,200,427,.468,105,308,.341,204,242,.843,22,258,280,157,45,6,135,118,919,8.3
212,Deron Williams\willide01,2015-16,G,65,63,2106,321,775,.414,224,493,.454,97,282,.344,179,206,.869,19,171,190,378,61,14,150,155,918,10.5
213,Malik Beasley\beaslma01,2018-19,G,81,18,1879,349,737,.474,186,332,.560,163,405,.402,56,66,.848,35,165,200,97,55,10,55,116,917,7.9
214,Bogdan Bogdanović\bogdabo01,2017-18,G,78,52,2175,344,772,.446,215,443,.485,129,329,.392,100,119,.840,31,192,223,258,72,16,125,172,917,8.4
215,Derrick Rose\rosede01,2018-19,G,51,13,1392,363,753,.482,309,607,.509,54,146,.370,137,160,.856,33,107,140,220,31,12,82,57,917,13.1
216,Jeremy Lin\linje01,2015-16,G,78,13,2048,300,728,.412,224,502,.446,76,226,.336,238,292,.815,42,211,253,235,58,42,150,165,914,8.1
217,Courtney Lee\leeco01,2017-18,G,76,69,2310,343,755,.454,230,477,.482,113,278,.406,114,124,.919,30,194,224,180,80,17,84,109,913,9.0
218,Kyle Korver\korveky01,2014-15,G-F,75,75,2418,292,600,.487,71,151,.470,221,449,.492,106,118,.898,15,289,304,196,52,42,107,140,911,10.1
219,Arron Afflalo\afflaar01,2015-16,G-F,71,57,2371,354,799,.443,263,561,.469,91,238,.382,110,131,.840,23,243,266,144,25,10,82,142,909,8.0
220,Chris Paul\paulch01,2018-19,G,58,58,1857,302,720,.419,175,365,.479,127,355,.358,175,203,.862,36,229,265,473,114,18,152,146,906,14.7
221,Derrick Rose\rosede01,2014-15,G,51,51,1530,338,835,.405,262,564,.465,76,271,.280,152,187,.813,35,126,161,251,36,16,161,63,904,10.6
222,Darren Collison\collida01,2016-17,G,68,64,2063,340,714,.476,267,539,.495,73,175,.417,147,171,.860,23,129,152,312,67,9,114,119,900,10.5
223,Terry Rozier\roziete01,2017-18,G,80,16,2068,316,800,.395,163,398,.410,153,402,.381,115,149,.772,63,313,376,232,80,19,80,123,900,9.0
224,Seth Curry\curryse01,2016-17,G,70,42,2029,338,703,.481,201,381,.528,137,322,.425,85,100,.850,25,154,179,189,79,7,92,126,898,9.6
225,Rodney Stuckey\stuckro01,2014-15,G,71,36,1874,332,754,.440,277,613,.452,55,141,.390,177,216,.819,36,212,248,219,56,10,118,131,896,8.7
226,Avery Bradley\bradlav01,2016-17,G,55,55,1835,359,775,.463,251,498,.504,108,277,.390,68,93,.731,65,269,334,122,68,11,88,141,894,11.4
227,George Hill\hillge01,2015-16,G,74,73,2524,326,739,.441,198,425,.466,128,314,.408,114,150,.760,58,240,298,259,83,17,101,149,894,9.7
228,Ish Smith\smithis01,2017-18,G,82,35,2043,389,801,.486,354,700,.506,35,101,.347,81,116,.698,27,197,224,360,64,20,108,140,894,8.8
229,Shai Gilgeous-Alexander\gilgesh01,2018-19,G,82,73,2174,341,716,.476,290,577,.503,51,139,.367,156,195,.800,57,175,232,270,96,45,141,175,889,8.6
230,Zach LaVine\lavinza01,2016-17,G,47,47,1749,326,710,.459,206,400,.515,120,310,.387,117,140,.836,19,141,160,139,41,10,85,104,889,12.5
231,Austin Rivers\riverau01,2016-17,G,74,29,2054,323,731,.442,212,432,.491,111,299,.371,132,191,.691,20,141,161,204,48,10,115,187,889,7.4
232,Bojan Bogdanović\bogdabo02,2015-16,G-F,79,39,2115,324,749,.433,195,411,.474,129,338,.382,110,132,.833,36,219,255,99,29,5,115,119,887,6.5
233,Gerald Green\greenge01,2014-15,G-F,74,4,1446,324,778,.416,187,391,.478,137,387,.354,99,120,.825,33,153,186,91,42,12,104,145,884,6.5
234,Deron Williams\willide01,2014-15,G,68,55,2114,298,771,.387,211,534,.395,87,237,.367,201,241,.834,29,208,237,448,64,17,154,157,884,10.3
235,Rodney Hood\hoodro01,2017-18,G-F,60,23,1615,322,751,.429,195,418,.467,127,333,.381,111,129,.860,22,143,165,95,45,12,70,105,882,9.1
236,Dennis Schröder\schrode01,2015-16,G,80,6,1621,329,781,.421,252,542,.465,77,239,.322,144,182,.791,25,179,204,349,70,9,183,138,879,7.5
237,Emmanuel Mudiay\mudiaem01,2018-19,G,59,42,1607,330,740,.446,261,530,.492,69,210,.329,144,186,.774,33,163,196,228,43,19,140,103,873,9.8
238,Kent Bazemore\bazemke01,2015-16,G-F,75,68,2083,320,725,.441,211,420,.502,109,305,.357,123,151,.815,28,351,379,171,98,38,138,176,872,8.6
239,Emmanuel Mudiay\mudiaem01,2015-16,G,68,66,2068,329,905,.364,255,673,.379,74,232,.319,140,209,.670,32,200,232,372,65,35,217,141,872,7.4
240,Buddy Hield\hieldbu01,2016-17,G,82,55,1888,327,767,.426,179,388,.461,148,379,.391,64,76,.842,35,234,269,121,38,9,101,115,866,6.5
241,Wayne Ellington\ellinwa01,2017-18,G,77,2,2041,285,700,.407,58,121,.479,227,579,.392,67,78,.859,23,195,218,79,53,8,52,94,864,7.6
242,Ricky Rubio\rubiori01,2018-19,G,68,67,1899,295,730,.404,216,476,.454,79,254,.311,195,228,.855,33,210,243,416,91,10,180,180,864,10.0
243,Rajon Rondo\rondora01,2015-16,G,72,72,2537,355,782,.454,293,612,.479,62,170,.365,87,150,.580,77,358,435,839,141,10,278,175,859,13.6
244,Caris LeVert\leverca01,2017-18,G-F,71,10,1864,320,735,.435,235,490,.480,85,245,.347,133,187,.711,53,207,260,299,82,22,153,159,858,9.0
245,Mike Conley\conlemi01,2015-16,G,56,56,1760,294,696,.422,216,481,.449,78,215,.363,191,229,.834,26,138,164,342,67,16,84,100,857,13.0
246,Tony Parker\parketo01,2015-16,G,72,72,1980,350,710,.493,323,645,.501,27,65,.415,130,171,.760,17,159,176,379,54,11,131,114,857,9.6
247,Darren Collison\collida01,2017-18,G,69,64,2018,316,638,.495,220,433,.508,96,205,.468,127,144,.882,37,141,178,368,92,15,86,122,855,11.9
248,Evan Turner\turneev01,2015-16,G,81,12,2271,343,753,.456,323,670,.482,20,83,.241,148,179,.827,50,347,397,359,80,28,169,139,854,8.9
249,Darren Collison\collida01,2018-19,G,76,76,2143,308,659,.467,229,465,.492,79,194,.407,158,190,.832,36,196,232,459,110,9,125,138,853,11.1
250,Gary Harris\harriga01,2016-17,G,57,56,1782,320,637,.502,213,382,.558,107,255,.420,104,134,.776,48,130,178,164,71,8,76,92,851,11.8
251,Monte Morris\morrimo01,2018-19,G,82,6,1970,346,702,.493,252,475,.531,94,227,.414,65,81,.802,35,159,194,297,73,4,52,102,851,9.2
252,J.R. Smith\smithjr01,2014-15,G-F,70,51,2079,315,755,.417,152,329,.462,163,426,.383,54,72,.750,30,188,218,195,82,22,97,163,847,8.4
253,Isaiah Canaan\canaais01,2015-16,G,77,39,1966,260,722,.360,84,237,.354,176,485,.363,150,180,.833,20,154,174,137,56,12,91,133,846,6.6
254,Joe Harris\harrijo01,2017-18,G,78,14,1975,305,621,.491,155,263,.589,150,358,.419,86,104,.827,51,209,260,128,35,20,91,153,846,7.8
255,Allen Crabbe\crabbal01,2016-17,G-F,79,7,2254,303,647,.468,169,345,.490,134,302,.444,105,124,.847,19,207,226,94,54,20,62,171,845,7.4
256,De'Aaron Fox\foxde01,2017-18,G,73,61,2026,328,797,.412,281,644,.436,47,153,.307,141,195,.723,33,171,204,320,70,20,173,163,844,7.4
257,Tyler Johnson\johnsty01,2017-18,G,72,39,2052,309,711,.435,190,387,.491,119,324,.367,106,129,.822,34,214,248,165,60,34,81,148,843,8.4
258,Wesley Matthews\matthwe02,2018-19,G,69,68,2091,279,698,.400,129,295,.437,150,403,.372,132,163,.810,32,138,170,160,54,17,91,160,840,7.8
259,Yogi Ferrell\ferreyo01,2017-18,G,82,21,2282,311,730,.426,177,371,.477,134,359,.373,82,103,.796,26,223,249,201,64,9,78,153,838,7.3
260,Kent Bazemore\bazemke01,2017-18,G-F,65,65,1789,284,676,.420,176,402,.438,108,274,.394,160,201,.796,25,223,248,228,100,45,157,147,836,9.5
261,Ricky Rubio\rubiori01,2016-17,G,75,75,2469,261,650,.402,201,454,.443,60,196,.306,254,285,.891,68,237,305,682,128,10,195,202,836,12.4
262,Courtney Lee\leeco01,2016-17,G,77,74,2459,321,704,.456,213,435,.490,108,269,.401,85,98,.867,53,206,259,179,81,24,69,141,835,8.6
263,Marcus Smart\smartma01,2016-17,G,79,24,2399,269,749,.359,175,417,.420,94,332,.283,203,250,.812,78,227,305,364,125,34,159,192,835,8.7
264,Allen Crabbe\crabbal01,2015-16,G-F,81,8,2105,311,678,.459,199,393,.506,112,285,.393,98,113,.867,27,189,216,99,63,16,64,192,832,6.8
265,Jeremy Lin\linje01,2014-15,G,74,30,1907,277,654,.424,212,478,.444,65,176,.369,213,268,.795,26,170,196,339,82,32,166,189,832,8.5
266,Marco Belinelli\belinma01,2018-19,G-F,79,1,1815,285,690,.413,138,295,.468,147,395,.372,112,124,.903,16,182,198,132,35,8,72,121,829,6.8
267,George Hill\hillge01,2016-17,G,49,49,1544,289,606,.477,195,373,.523,94,233,.403,157,196,.801,23,144,167,204,50,11,85,114,829,12.9
268,Jamal Crawford\crawfja01,2017-18,G,80,0,1653,308,742,.415,204,428,.477,104,314,.331,102,113,.903,21,78,99,185,40,9,95,85,822,6.3
269,Danny Green\greenda02,2018-19,G-F,80,80,2216,293,630,.465,95,195,.487,198,435,.455,37,44,.841,60,257,317,126,73,53,75,171,821,8.4
270,Will Barton\bartowi01,2016-17,G,60,19,1705,295,666,.443,208,431,.483,87,235,.370,143,190,.753,58,201,259,206,48,28,97,110,820,10.4
271,Patty Mills\millspa02,2017-18,G,82,36,2107,280,682,.411,126,268,.470,154,414,.372,105,118,.890,26,128,154,229,55,11,106,128,819,7.0
272,Eric Gordon\gordoer01,2014-15,G,61,60,2018,285,694,.411,144,379,.380,141,315,.448,107,133,.805,28,131,159,229,50,14,122,145,818,8.8
273,C.J. Miles\milescj01,2016-17,G-F,76,29,1776,281,647,.434,112,238,.471,169,409,.413,84,93,.903,30,199,229,48,46,25,40,151,815,7.2
274,Mario Chalmers\chalmma01,2014-15,G,80,37,2368,267,663,.403,194,415,.467,73,248,.294,206,266,.774,24,182,206,307,122,10,173,251,813,7.2
275,Patty Mills\millspa02,2018-19,G,82,1,1908,282,663,.425,123,259,.475,159,404,.394,88,103,.854,24,158,182,245,49,10,93,129,811,7.3
276,Jamal Murray\murraja01,2016-17,G,82,10,1764,295,730,.404,180,386,.466,115,344,.334,106,120,.883,41,173,214,170,51,24,113,124,811,6.3
277,Ramon Sessions\sessira01,2015-16,G,82,5,1667,280,592,.473,244,481,.507,36,111,.324,214,283,.756,25,178,203,239,46,5,115,102,810,7.5
278,J.J. Barea\bareajo01,2015-16,G,74,16,1667,317,711,.446,217,451,.481,100,260,.385,74,96,.771,26,126,152,302,26,2,113,110,808,7.7
279,O.J. Mayo\mayooj01,2014-15,G,71,15,1697,296,701,.422,197,424,.465,99,277,.357,115,139,.827,30,157,187,197,57,18,128,165,806,7.1
280,Rodney Hood\hoodro01,2018-19,G-F,72,49,1893,292,671,.435,208,435,.478,84,236,.356,137,155,.884,25,132,157,126,59,12,55,146,805,7.6
281,Tim Hardaway\hardati02,2014-15,G,70,30,1681,279,717,.389,158,363,.435,121,354,.342,125,156,.801,12,144,156,127,20,14,82,119,804,6.3
282,Wesley Matthews\matthwe02,2017-18,G,63,63,2131,283,697,.406,130,295,.441,153,402,.381,83,101,.822,28,170,198,172,76,16,83,140,802,8.9
283,J.J. Barea\bareajo01,2017-18,G,69,11,1603,303,690,.439,188,377,.499,115,313,.367,80,102,.784,15,186,201,434,35,3,143,83,801,9.6
284,Kent Bazemore\bazemke01,2016-17,G-F,73,64,1963,295,721,.409,203,455,.446,92,266,.346,119,168,.708,45,186,231,177,91,52,125,165,801,7.4
285,Elfrid Payton\paytoel01,2017-18,G,63,63,1809,329,667,.493,299,575,.520,30,92,.326,109,168,.649,64,210,274,393,83,22,168,147,797,11.0
286,John Wall\walljo01,2017-18,G,41,41,1410,280,667,.420,218,500,.436,62,167,.371,175,241,.726,22,128,150,393,57,45,158,80,797,15.7
287,Nick Young\youngni01,2016-17,G-F,60,60,1556,272,633,.430,102,212,.481,170,421,.404,77,90,.856,25,113,138,58,37,14,36,137,791,8.3
288,Anthony Morrow\morroan01,2014-15,G,74,0,1806,285,615,.463,144,290,.497,141,325,.434,79,89,.888,40,155,195,60,54,11,38,135,790,7.5
289,Denzel Valentine\valende01,2017-18,G,77,37,2095,301,721,.417,158,351,.450,143,370,.386,38,51,.745,48,345,393,244,65,11,99,185,783,7.8
290,Kobe Bryant\bryanko01,2014-15,G-F,35,35,1207,266,713,.373,212,529,.401,54,184,.293,196,241,.813,26,173,199,197,47,7,128,65,782,13.6
291,Marco Belinelli\belinma01,2016-17,G-F,74,0,1778,264,615,.429,162,332,.488,102,283,.360,150,168,.893,14,164,178,147,44,9,70,90,780,7.5
292,Kent Bazemore\bazemke01,2018-19,G-F,67,35,1643,278,691,.402,182,391,.465,96,300,.320,127,175,.726,37,224,261,152,89,42,121,170,779,7.7
293,Damyean Dotson\dotsoda01,2018-19,G,73,40,2004,290,698,.415,164,356,.461,126,342,.368,73,98,.745,34,228,262,135,58,10,71,135,779,7.2
294,Kevin Martin\martike02,2014-15,G,39,36,1302,267,625,.427,192,434,.442,75,191,.393,170,193,.881,19,123,142,89,33,1,76,76,779,12.3
295,Evan Turner\turneev01,2014-15,G,82,57,2260,320,746,.429,287,627,.458,33,119,.277,106,141,.752,40,377,417,449,83,19,198,180,779,8.0
296,Zach LaVine\lavinza01,2014-15,G,77,40,1902,286,677,.422,229,510,.449,57,167,.341,149,177,.842,27,187,214,276,54,10,193,158,778,6.2
297,Elfrid Payton\paytoel01,2015-16,G,73,69,2145,318,730,.436,288,638,.451,30,92,.326,112,190,.589,77,184,261,468,89,20,177,159,778,9.1
298,D.J. Augustin\augusdj01,2014-15,G,82,14,1964,258,647,.399,175,401,.436,83,246,.337,178,205,.868,20,141,161,353,49,3,145,93,777,7.2
299,Courtney Lee\leeco01,2014-15,G,77,74,2354,288,643,.448,198,419,.473,90,224,.402,111,129,.860,21,157,178,151,75,12,78,129,777,7.2
300,Greivis Vásquez\vasqugr01,2014-15,G,82,29,1991,296,725,.408,163,374,.436,133,351,.379,50,66,.758,22,194,216,302,46,10,119,177,775,6.4
301,Dennis Schröder\schrode01,2014-15,G,77,10,1516,284,665,.427,232,517,.449,52,148,.351,148,179,.827,29,135,164,317,49,4,150,127,768,7.0
302,Malcolm Brogdon\brogdma01,2016-17,G,75,28,1982,290,635,.457,212,442,.480,78,193,.404,109,126,.865,47,166,213,317,84,12,113,140,767,8.8
303,D.J. Augustin\augusdj01,2017-18,G,75,36,1760,244,540,.452,130,268,.485,114,272,.419,164,189,.868,30,130,160,287,54,0,123,94,766,8.4
304,Ricky Rubio\rubiori01,2015-16,G,76,76,2323,219,586,.374,157,396,.396,62,190,.326,266,314,.847,40,286,326,658,162,10,193,201,766,11.8
305,Dwyane Wade\wadedw01,2017-18,G,67,3,1536,299,682,.438,267,571,.468,32,111,.288,135,189,.714,50,202,252,228,61,47,140,124,765,8.1
306,Raymond Felton\feltora01,2015-16,G,80,31,2192,277,682,.406,217,469,.463,60,213,.282,149,176,.847,36,222,258,284,68,15,121,141,763,7.2
307,Dion Waiters\waitedi01,2015-16,G,78,15,2152,282,706,.399,196,466,.421,86,240,.358,112,157,.713,36,166,202,154,81,15,120,143,762,5.9
308,Courtney Lee\leeco01,2015-16,G,79,65,2334,290,639,.454,208,422,.493,82,217,.378,99,118,.839,29,176,205,136,85,28,72,134,761,7.2
309,Patty Mills\millspa02,2016-17,G,80,8,1754,273,621,.440,126,266,.474,147,355,.414,66,80,.825,24,117,141,280,65,3,101,109,759,7.5
310,Ish Smith\smithis01,2016-17,G,81,32,1955,329,749,.439,301,644,.467,28,105,.267,72,102,.706,21,214,235,418,61,33,112,127,758,8.0
311,Hollis Thompson\thompho01,2015-16,G-F,77,17,2154,270,680,.397,121,288,.420,149,392,.380,69,96,.719,54,218,272,99,36,24,76,187,758,5.9
312,Lance Stephenson\stephla01,2017-18,G-F,82,7,1850,303,709,.427,236,477,.495,67,232,.289,84,127,.661,62,362,424,235,46,17,131,177,757,6.6
313,Nik Stauskas\stausni01,2016-17,G,80,27,2188,251,634,.396,119,275,.433,132,359,.368,122,150,.813,21,205,226,188,45,32,128,144,756,6.1
314,C.J. Miles\milescj01,2015-16,G-F,64,24,1464,259,634,.409,117,247,.474,142,387,.367,93,124,.750,25,150,175,63,53,29,70,142,753,7.1
315,Reggie Jackson\jacksre01,2016-17,G,52,50,1424,284,677,.419,218,493,.442,66,184,.359,118,136,.868,21,93,114,270,35,5,114,129,752,9.4
316,Rodney Hood\hoodro01,2016-17,G-F,59,55,1593,272,666,.408,158,359,.440,114,307,.371,90,115,.783,16,186,202,96,38,11,65,132,748,7.5
317,D'Angelo Russell\russeda01,2017-18,G,48,35,1234,278,672,.414,188,394,.477,90,278,.324,97,131,.740,30,159,189,249,36,17,147,93,743,9.9
318,Cory Joseph\josepco01,2016-17,G,80,22,2003,299,661,.452,251,526,.477,48,135,.356,94,122,.770,51,184,235,265,66,13,108,140,740,7.2
319,Kyle Korver\korveky01,2015-16,G-F,80,80,2401,268,616,.435,110,219,.502,158,397,.398,45,54,.833,14,246,260,164,60,35,98,161,739,6.6
320,Manu Ginóbili\ginobma01,2014-15,G,70,0,1587,251,589,.426,162,331,.489,89,258,.345,147,204,.721,28,183,211,293,67,20,154,138,738,7.9
321,Gary Harris\harriga01,2018-19,G,57,48,1639,270,637,.424,188,395,.476,82,242,.339,115,144,.799,41,119,160,127,55,19,68,113,737,8.7
322,Elfrid Payton\paytoel01,2014-15,G,82,63,2489,301,708,.425,290,666,.435,11,42,.262,118,214,.551,107,242,349,533,142,20,203,193,731,8.7
323,Dion Waiters\waitedi01,2016-17,G,46,43,1384,281,663,.424,196,448,.438,85,215,.395,82,127,.646,18,135,153,200,42,20,103,95,729,10.2
324,Kevin Huerter\huertke01,2018-19,G,75,59,2048,275,657,.419,139,304,.457,136,353,.385,41,56,.732,60,185,245,214,65,25,109,155,727,7.1
325,Darren Collison\collida01,2014-15,G,45,45,1565,260,550,.473,200,389,.514,60,161,.373,145,184,.788,19,124,143,252,67,14,112,95,725,12.9
326,Landry Shamet\shamela01,2018-19,G,79,27,1802,240,557,.431,73,161,.453,167,396,.422,75,93,.806,21,113,134,117,37,10,45,155,722,6.2
327,Dennis Smith\smithde03,2018-19,G,53,50,1508,278,650,.428,211,442,.477,67,208,.322,99,156,.635,32,123,155,252,67,20,154,129,722,8.8
328,Joe Johnson\johnsjo02,2016-17,G-F,78,14,1843,273,626,.436,167,368,.454,106,258,.411,63,77,.818,33,210,243,144,36,18,69,93,715,6.5
329,Reggie Bullock\bullore01,2018-19,G-F,63,60,1879,245,594,.412,97,201,.483,148,393,.377,73,85,.859,22,151,173,129,40,12,65,109,711,7.6
330,Tomáš Satoranský\satorto01,2018-19,G,80,54,2164,257,530,.485,193,368,.524,64,162,.395,131,160,.819,82,197,279,399,82,13,120,172,709,9.1
331,Terry Rozier\roziete01,2018-19,G,79,14,1791,258,666,.387,139,329,.422,119,337,.353,73,93,.785,32,275,307,231,68,21,68,101,708,7.3
332,Marcus Smart\smartma01,2018-19,G,80,60,2200,239,567,.422,113,221,.511,126,346,.364,104,129,.806,57,177,234,321,143,28,123,201,708,8.4
333,Jeremy Lin\linje01,2018-19,G,74,4,1436,238,541,.440,183,354,.517,55,187,.294,176,210,.838,22,157,179,231,47,13,124,144,707,6.9
334,Tyreke Evans\evansty01,2018-19,G-F,69,18,1402,257,660,.389,180,444,.405,77,216,.356,115,160,.719,33,168,201,166,58,18,118,117,706,6.1
335,Jordan Clarkson\clarkjo01,2014-15,G,59,38,1476,267,596,.448,229,475,.482,38,121,.314,131,158,.829,56,135,191,206,51,12,96,109,703,8.9
336,Troy Daniels\danietr01,2017-18,G,79,15,1622,232,575,.403,49,117,.419,183,458,.400,56,64,.875,12,115,127,48,26,5,56,137,703,4.9
337,Fred VanVleet\vanvlfr01,2018-19,G,64,28,1760,246,600,.410,134,304,.441,112,296,.378,97,115,.843,21,146,167,307,57,20,82,110,701,9.2
338,Deron Williams\willide01,2016-17,G,64,44,1657,263,600,.438,178,366,.486,85,234,.363,90,109,.826,14,133,147,360,31,8,138,138,701,8.2
339,Patrick Beverley\beverpa01,2015-16,G,71,63,2041,258,594,.434,134,284,.472,124,310,.400,60,88,.682,73,177,250,239,94,26,91,234,700,8.1
340,Bojan Bogdanović\bogdabo02,2014-15,G-F,78,28,1854,261,576,.453,170,320,.531,91,256,.355,87,106,.821,50,163,213,68,34,9,78,104,700,5.7
341,E'Twaun Moore\mooreet01,2016-17,G-F,73,22,1820,283,619,.457,206,411,.501,77,208,.370,57,74,.770,33,119,152,164,50,32,62,131,700,6.9
342,Kris Dunn\dunnkr01,2017-18,G,52,43,1525,286,666,.429,243,532,.457,43,134,.321,84,114,.737,24,197,221,310,104,27,150,174,699,10.2
343,C.J. Miles\milescj01,2017-18,G-F,70,3,1337,227,599,.379,63,145,.434,164,454,.361,81,97,.835,18,134,152,55,37,21,39,134,699,5.9
344,Reggie Bullock\bullore01,2017-18,G-F,62,52,1732,267,546,.489,142,265,.536,125,281,.445,39,49,.796,27,127,154,95,47,13,47,70,698,8.4
345,Evan Fournier\fournev01,2014-15,G-F,58,32,1661,253,575,.440,168,350,.480,85,225,.378,107,147,.728,28,125,153,120,40,2,82,116,698,7.5
346,Marco Belinelli\belinma01,2015-16,G-F,68,7,1672,245,635,.386,154,338,.456,91,297,.306,115,138,.833,10,107,117,127,37,2,80,91,696,5.7
347,Allonzo Trier\trieral01,2018-19,G,64,3,1459,232,518,.448,180,386,.466,52,132,.394,179,223,.803,31,166,197,119,28,14,116,117,695,6.8
348,George Hill\hillge01,2014-15,G,43,36,1267,255,535,.477,186,342,.544,69,193,.358,113,143,.790,25,154,179,220,44,14,69,111,692,13.2
349,Patty Mills\millspa02,2015-16,G,81,3,1662,260,612,.425,137,292,.469,123,320,.384,47,58,.810,27,131,158,226,59,6,76,102,690,6.5
350,Jameer Nelson\nelsoja01,2016-17,G,75,39,2045,268,604,.444,162,331,.489,106,273,.388,45,63,.714,28,164,192,385,54,8,128,197,687,7.4
351,Eric Gordon\gordoer01,2015-16,G,45,44,1481,231,552,.418,118,258,.457,113,294,.384,111,125,.888,10,89,99,121,43,14,73,98,686,9.9
352,Mikal Bridges\bridgmi01,2018-19,G,82,56,2417,242,563,.430,137,250,.548,105,313,.335,95,118,.805,56,208,264,173,129,38,70,201,684,7.4
353,Tony Snell\snellto01,2016-17,G-F,80,80,2336,246,541,.455,102,186,.548,144,355,.406,47,58,.810,22,226,248,96,55,14,55,125,683,6.4
354,Ty Lawson\lawsoty01,2016-17,G,69,24,1732,237,522,.454,203,404,.502,34,118,.288,173,217,.797,44,135,179,334,74,6,129,119,681,8.7
355,Trey Burke\burketr01,2015-16,G,64,0,1366,262,634,.413,174,378,.460,88,256,.344,67,82,.817,18,94,112,148,35,6,80,86,679,6.3
356,Jalen Brunson\brunsja01,2018-19,G,73,38,1591,264,565,.467,201,384,.523,63,181,.348,87,120,.725,25,144,169,230,37,4,88,127,678,6.8
357,Kyle Korver\korveky01,2016-17,G-F,67,22,1753,239,515,.464,77,156,.494,162,359,.451,38,42,.905,7,179,186,110,34,21,69,107,678,7.2
358,Cory Joseph\josepco01,2015-16,G,80,4,2046,257,585,.439,227,475,.478,30,110,.273,133,174,.764,39,171,210,250,63,20,102,131,677,6.6
359,Gerald Green\greenge01,2018-19,G-F,73,0,1473,231,578,.400,75,137,.547,156,441,.354,57,68,.838,30,152,182,40,33,27,55,126,675,5.5
360,Victor Oladipo\oladivi01,2018-19,G,36,36,1147,249,588,.423,175,372,.470,74,216,.343,103,141,.730,21,181,202,186,60,11,82,72,675,14.0
361,Langston Galloway\gallola01,2018-19,G,80,4,1745,228,587,.388,93,207,.449,135,380,.355,81,96,.844,49,122,171,85,37,8,24,135,672,5.5
362,Kyle Korver\korveky01,2017-18,G-F,73,4,1574,222,484,.459,58,108,.537,164,376,.436,64,72,.889,9,156,165,88,31,27,55,130,672,6.5
363,George Hill\hillge01,2017-18,G,67,60,1812,236,513,.460,151,308,.490,85,205,.415,110,140,.786,42,139,181,186,61,27,88,128,667,7.9
364,Devin Harris\harride01,2014-15,G,76,3,1685,219,524,.418,124,258,.481,95,266,.357,132,162,.815,13,122,135,237,78,14,85,147,665,7.0
365,Jodie Meeks\meeksjo01,2014-15,G,60,0,1462,222,534,.416,148,322,.460,74,212,.349,145,160,.906,12,92,104,79,59,6,57,76,663,7.3
366,John Wall\walljo01,2018-19,G,32,32,1104,245,552,.444,194,383,.507,51,169,.302,122,175,.697,15,101,116,279,49,29,121,71,663,15.9
367,Derrick White\whitede01,2018-19,G,67,55,1728,260,543,.479,212,401,.529,48,142,.338,95,123,.772,35,212,247,263,67,47,97,145,663,8.8
368,Gerald Henderson\hendege02,2016-17,G,72,41,1667,234,553,.423,173,380,.455,61,173,.353,133,165,.806,34,151,185,112,40,15,62,129,662,6.1
369,J.R. Smith\smithjr01,2017-18,G-F,80,61,2244,240,595,.403,97,214,.453,143,381,.375,39,56,.696,29,206,235,141,68,11,81,161,662,5.6
370,Avery Bradley\bradlav01,2017-18,G,46,46,1433,259,625,.414,184,422,.436,75,203,.369,63,82,.768,22,94,116,94,51,8,101,92,656,7.5
371,Reggie Jackson\jacksre01,2017-18,G,45,45,1201,246,577,.426,194,408,.475,52,169,.308,112,134,.836,29,96,125,238,27,4,99,87,656,10.1
372,Fred VanVleet\vanvlfr01,2017-18,G,76,0,1520,232,545,.426,124,284,.437,108,261,.414,84,101,.832,25,159,184,243,68,19,74,130,656,7.3
373,Dejounte Murray\murrade01,2017-18,G,81,48,1743,270,609,.443,261,575,.454,9,34,.265,105,148,.709,110,349,459,231,97,31,134,151,654,7.2
374,Malik Monk\monkma01,2018-19,G,73,0,1258,227,586,.387,118,256,.461,109,330,.330,90,102,.882,16,121,137,117,37,19,86,106,653,5.2
375,Delon Wright\wrighde01,2018-19,G,75,13,1698,242,558,.434,192,390,.492,50,168,.298,119,150,.793,68,198,266,248,88,30,77,103,653,8.2
376,Wayne Ellington\ellinwa01,2014-15,G,65,36,1675,254,617,.412,164,374,.439,90,243,.370,52,64,.813,31,179,210,105,33,2,50,77,650,6.4
377,Cory Joseph\josepco01,2017-18,G,82,17,2210,256,604,.424,189,414,.457,67,190,.353,70,94,.745,39,224,263,260,80,18,87,141,649,6.6
378,Evan Turner\turneev01,2017-18,G,79,40,2034,258,577,.447,216,445,.485,42,132,.318,91,107,.850,30,214,244,173,47,29,99,163,649,5.7
379,Wayne Ellington\ellinwa01,2016-17,G,62,13,1500,231,555,.416,82,161,.509,149,394,.378,37,43,.860,18,114,132,70,35,4,30,70,648,6.9
380,Shabazz Napier\napiesh01,2017-18,G,74,9,1535,223,531,.420,141,313,.450,82,218,.376,116,138,.841,26,144,170,150,81,14,90,84,644,6.6
381,Tony Allen\allento01,2016-17,G-F,71,66,1914,274,595,.461,259,541,.479,15,54,.278,80,130,.615,166,225,391,98,115,29,100,178,643,7.5
382,Patrick Beverley\beverpa01,2016-17,G,67,67,2058,228,543,.420,118,255,.463,110,288,.382,73,95,.768,95,298,393,281,99,25,100,222,639,9.3
383,Tony Parker\parketo01,2016-17,G,63,63,1587,265,569,.466,242,500,.484,23,69,.333,85,117,.726,9,104,113,285,34,2,89,92,638,7.6
384,Norman Powell\powelno01,2016-17,G,76,18,1368,227,506,.449,171,333,.514,56,173,.324,126,159,.792,26,143,169,82,52,14,70,127,636,5.5
385,E'Twaun Moore\mooreet01,2018-19,G-F,53,36,1463,256,532,.481,180,356,.506,76,176,.432,45,59,.763,35,92,127,102,40,8,59,112,633,8.0
386,Eric Bledsoe\bledser01,2015-16,G,31,31,1059,223,492,.453,175,363,.482,48,129,.372,138,172,.802,18,107,125,190,63,19,110,75,632,15.4
387,Brandon Jennings\jennibr01,2014-15,G,41,41,1173,218,543,.401,142,332,.428,76,211,.360,120,143,.839,21,83,104,272,44,4,90,64,632,12.0
388,Trey Burke\burketr01,2018-19,G,58,8,1124,236,548,.431,180,389,.463,56,159,.352,103,124,.831,28,71,99,159,33,7,49,58,631,7.8
389,Monta Ellis\ellismo01,2016-17,G,74,33,1998,247,557,.443,204,422,.483,43,135,.319,93,128,.727,19,185,204,236,78,27,135,149,630,6.2
390,Mario Chalmers\chalmma01,2015-16,G,61,7,1373,182,444,.410,136,295,.461,46,149,.309,218,262,.832,24,133,157,230,88,13,110,181,628,8.3
391,Hollis Thompson\thompho01,2014-15,G-F,71,23,1776,224,543,.413,109,256,.426,115,287,.401,63,89,.708,53,145,198,85,57,26,66,141,626,5.9
392,Avery Bradley\bradlav01,2018-19,G,63,63,1905,248,608,.408,162,363,.446,86,245,.351,43,50,.860,43,132,175,152,41,16,89,167,625,5.8
393,Malcolm Brogdon\brogdma01,2017-18,G,48,20,1436,244,503,.485,182,342,.532,62,161,.385,75,85,.882,23,133,156,152,41,13,66,128,625,9.6
394,Langston Galloway\gallola01,2015-16,G,82,7,2033,231,588,.393,154,364,.423,77,224,.344,86,114,.754,43,245,288,207,77,22,61,177,625,6.1
395,Gerald Henderson\hendege02,2015-16,G,72,0,1431,232,529,.439,184,393,.468,48,136,.353,112,146,.767,30,181,211,75,39,19,68,87,624,5.7
396,Michael Carter-Williams\cartemi01,2015-16,G,54,37,1649,251,555,.452,236,500,.472,15,55,.273,106,162,.654,48,228,276,281,80,41,153,162,623,9.3
397,Jerian Grant\grantje02,2017-18,G,74,26,1686,209,503,.416,148,316,.468,61,187,.326,140,188,.745,31,141,172,342,63,8,89,132,619,7.6
398,Tyler Johnson\johnsty01,2018-19,G,57,22,1529,217,526,.413,127,266,.477,90,260,.346,95,127,.748,34,139,173,166,54,27,77,97,619,8.1
399,Austin Rivers\riverau01,2018-19,G,76,15,2028,232,572,.406,128,245,.522,104,327,.318,50,95,.526,25,137,162,167,47,23,68,207,618,5.0
400,Nik Stauskas\stausni01,2015-16,G,73,35,1809,210,545,.385,104,220,.473,106,325,.326,91,118,.771,23,160,183,138,44,20,94,115,617,5.3
401,D.J. Augustin\augusdj01,2016-17,G,78,20,1538,195,517,.377,100,243,.412,95,274,.347,131,161,.814,15,102,117,209,31,1,90,101,616,5.2
402,Gerald Green\greenge01,2015-16,G-F,69,14,1557,230,587,.392,146,327,.446,84,260,.323,72,92,.783,25,138,163,56,38,19,46,123,616,5.0
403,Luke Kennard\kennalu01,2018-19,G,63,10,1437,228,520,.438,122,251,.486,106,269,.394,51,61,.836,12,171,183,114,26,10,57,92,613,6.6
404,Rajon Rondo\rondora01,2014-15,G,68,68,2019,275,645,.426,248,559,.444,27,86,.314,31,78,.397,73,300,373,538,91,7,210,153,608,8.7
405,Beno Udrih\udrihbe01,2014-15,G,79,12,1494,246,505,.487,220,408,.539,26,97,.268,87,102,.853,20,123,143,220,46,8,89,88,605,6.0
406,Andre Iguodala\iguodan01,2014-15,G-F,77,0,2069,231,496,.466,157,284,.553,74,212,.349,68,114,.596,44,213,257,228,89,25,88,100,604,7.3
407,Jeremy Lamb\lambje01,2016-17,G-F,62,5,1143,226,491,.460,185,345,.536,41,146,.281,110,129,.853,30,234,264,75,27,23,40,98,603,7.3
408,Emmanuel Mudiay\mudiaem01,2016-17,G,55,41,1406,208,551,.377,152,373,.408,56,178,.315,131,167,.784,29,149,178,217,41,13,123,95,603,7.1
409,Danny Green\greenda02,2017-18,G-F,70,60,1791,217,561,.387,101,241,.419,116,320,.363,50,65,.769,41,208,249,110,63,80,74,122,600,6.5
410,Kyle Korver\korveky01,2018-19,G-F,70,0,1334,201,483,.416,63,135,.467,138,348,.397,60,73,.822,9,153,162,81,25,12,59,106,600,5.4
411,Jerryd Bayless\bayleje01,2014-15,G,77,4,1717,220,516,.426,183,396,.462,37,120,.308,121,137,.883,22,189,211,233,59,12,133,163,598,5.5
412,Miles Bridges\bridgmi02,2018-19,G-F,80,25,1696,237,511,.464,172,311,.553,65,200,.325,58,77,.753,67,256,323,95,55,49,50,111,597,6.4
413,Patrick Beverley\beverpa01,2018-19,G,78,49,2137,194,477,.407,82,195,.421,112,282,.397,96,123,.780,76,312,388,300,67,43,85,265,596,7.6
414,Devin Harris\harride01,2017-18,G,71,1,1340,187,454,.412,108,227,.476,79,227,.348,142,170,.835,12,115,127,152,47,12,76,158,595,5.7
415,Brandon Knight\knighbr03,2016-17,G,54,5,1140,209,525,.398,164,386,.425,45,139,.324,132,154,.857,25,93,118,130,27,5,88,87,595,6.4
416,Austin Rivers\riverau01,2015-16,G,67,7,1464,226,516,.438,164,331,.495,62,185,.335,79,116,.681,22,108,130,99,48,9,61,137,593,5.4
417,Jrue Holiday\holidjr01,2014-15,G,40,37,1303,238,534,.446,187,399,.469,51,135,.378,65,76,.855,32,103,135,274,63,23,91,110,592,12.5
418,Marcus Thornton\thornma01,2015-16,G,61,8,1108,216,542,.399,125,272,.460,91,270,.337,67,79,.848,38,112,150,85,47,4,51,90,590,6.1
419,Vince Carter\cartevi01,2016-17,G-F,73,15,1799,193,490,.394,81,194,.418,112,296,.378,88,115,.765,36,191,227,133,60,36,50,163,586,6.2
420,Wayne Ellington\ellinwa01,2015-16,G,76,41,1615,218,561,.389,122,293,.416,96,268,.358,54,63,.857,20,154,174,83,48,5,45,82,586,4.9
421,Garrett Temple\templga01,2018-19,G,75,55,2041,208,493,.422,118,229,.515,90,264,.341,80,107,.748,28,188,216,106,76,30,70,204,586,5.5
422,Evan Turner\turneev01,2016-17,G,65,12,1658,235,552,.426,204,434,.470,31,118,.263,85,103,.825,36,211,247,205,53,24,100,121,586,6.8
423,Langston Galloway\gallola01,2016-17,G,74,2,1495,207,545,.380,87,237,.367,120,308,.390,51,64,.797,27,129,156,93,46,6,46,96,585,5.0
424,Justin Jackson\jacksju01,2018-19,G-F,81,14,1613,217,485,.447,130,240,.542,87,245,.355,62,79,.785,44,168,212,96,32,14,29,99,583,5.5
425,Garrett Temple\templga01,2015-16,G,80,43,1951,201,505,.398,112,247,.453,89,258,.345,91,125,.728,36,176,212,140,69,18,64,195,582,5.1
426,Seth Curry\curryse01,2018-19,G,74,2,1399,212,465,.456,99,214,.463,113,251,.450,44,52,.846,27,93,120,66,36,12,61,97,581,5.1
427,Nick Young\youngni01,2017-18,G-F,80,8,1393,201,488,.412,78,162,.481,123,326,.377,56,65,.862,20,105,125,36,38,7,39,100,581,4.4
428,J.J. Barea\bareajo01,2014-15,G,77,10,1362,225,536,.420,171,369,.463,54,167,.323,76,94,.809,23,111,134,263,33,1,70,104,580,5.8
429,Jeremy Lamb\lambje01,2015-16,G-F,66,0,1227,230,510,.451,174,329,.529,56,181,.309,64,88,.727,44,208,252,77,42,30,50,105,580,6.4
430,Matthew Dellavedova\dellama01,2016-17,G,76,54,1986,208,534,.390,129,319,.404,79,215,.367,82,96,.854,24,123,147,357,53,0,133,153,577,5.8
431,Brandon Jennings\jennibr01,2016-17,G,81,13,1801,192,535,.359,113,283,.399,79,252,.313,114,152,.750,29,167,196,395,70,4,128,116,577,6.3
432,Manu Ginóbili\ginobma01,2017-18,G,65,0,1299,201,463,.434,137,271,.506,64,192,.333,110,131,.840,19,123,142,163,43,16,105,126,576,6.0
433,Andre Iguodala\iguodan01,2016-17,G-F,76,0,1998,219,415,.528,155,238,.651,64,177,.362,72,102,.706,51,253,304,261,76,39,58,97,574,8.7
434,Norris Cole\coleno01,2014-15,G,75,25,1831,230,558,.412,175,382,.458,55,176,.313,58,81,.716,13,146,159,255,57,15,99,124,573,5.5
435,Lance Stephenson\stephla01,2015-16,G-F,69,13,1372,228,474,.481,198,396,.500,30,78,.385,87,111,.784,40,183,223,133,43,9,94,135,573,5.8
436,Danny Green\greenda02,2015-16,G-F,79,79,2061,211,561,.376,95,212,.448,116,349,.332,34,46,.739,48,255,303,141,79,64,75,141,572,5.8
437,Josh Okogie\okogijo01,2018-19,G,74,52,1757,196,508,.386,136,293,.464,60,215,.279,118,162,.728,41,177,218,91,88,33,63,166,570,5.4
438,C.J. Watson\watsocj01,2014-15,G,57,21,1422,181,417,.434,111,242,.459,70,175,.400,138,167,.826,18,145,163,208,57,9,100,107,570,8.1
439,Matthew Dellavedova\dellama01,2015-16,G,76,14,1867,207,511,.405,109,272,.401,98,239,.410,57,66,.864,33,129,162,337,44,9,116,178,569,5.9
440,Marco Belinelli\belinma01,2014-15,G-F,62,9,1388,199,470,.423,113,240,.471,86,230,.374,84,99,.848,26,131,157,94,31,3,61,85,568,6.0
441,Patrick Beverley\beverpa01,2014-15,G,56,55,1727,204,532,.383,89,209,.426,115,323,.356,45,60,.750,67,170,237,192,59,23,83,182,568,7.6
442,Iman Shumpert\shumpim01,2016-17,G,76,31,1937,201,489,.411,107,228,.469,94,261,.360,71,90,.789,39,179,218,109,62,27,78,150,567,5.2
443,Shane Larkin\larkish01,2015-16,G,78,17,1751,222,502,.442,183,394,.464,39,108,.361,83,107,.776,28,152,180,342,95,12,146,121,566,6.5
444,Raymond Felton\feltora01,2017-18,G,82,2,1365,224,552,.406,143,322,.444,81,230,.352,36,44,.818,25,131,156,203,49,16,76,91,565,5.0
445,Nick Young\youngni01,2014-15,G-F,42,0,1000,174,476,.366,91,251,.363,83,225,.369,132,148,.892,17,79,96,41,23,11,44,83,563,7.4
446,Vince Carter\cartevi01,2018-19,G-F,76,9,1330,196,468,.419,73,152,.480,123,316,.389,47,66,.712,31,163,194,87,44,27,48,141,562,5.2
447,Alec Burks\burksal01,2018-19,G,64,24,1375,192,474,.405,131,306,.428,61,168,.363,116,141,.823,30,205,235,128,39,21,65,91,561,6.6
448,Luke Kennard\kennalu01,2017-18,G,73,9,1463,206,465,.443,125,270,.463,81,195,.415,65,76,.855,21,155,176,124,44,13,69,86,558,5.6
449,Marcus Smart\smartma01,2015-16,G,61,10,1667,184,529,.348,123,288,.427,61,241,.253,129,166,.777,76,179,255,185,91,18,80,183,558,7.1
450,T.J. McConnell\mccontj01,2016-17,G,81,51,2133,236,512,.461,225,457,.492,11,55,.200,73,90,.811,39,212,251,534,134,10,159,139,556,8.3
451,Bryn Forbes\forbebr01,2017-18,G,80,12,1517,209,497,.421,120,269,.446,89,228,.390,48,72,.667,12,98,110,80,28,2,37,108,555,4.1
452,Manu Ginóbili\ginobma01,2015-16,G,58,0,1134,197,435,.453,127,256,.496,70,179,.391,91,112,.813,26,120,146,177,66,11,99,99,555,7.5
453,David Nwaba\nwabada01,2017-18,G,70,21,1646,202,423,.478,184,371,.496,18,52,.346,133,203,.655,89,237,326,104,59,29,77,158,555,6.5
454,Delon Wright\wrighde01,2017-18,G,69,4,1433,201,432,.465,145,279,.520,56,153,.366,97,117,.829,45,153,198,200,72,33,78,81,555,7.6
455,Tyler Ulis\ulisty01,2017-18,G,71,43,1658,214,551,.388,172,405,.425,42,146,.288,84,101,.832,24,104,128,311,70,7,127,120,554,5.8
456,Emmanuel Mudiay\mudiaem01,2017-18,G,64,14,1244,204,526,.388,157,378,.415,47,148,.318,98,129,.760,26,126,152,206,41,11,113,80,553,5.6
457,Ian Clark\clarkia01,2017-18,G,74,2,1455,222,495,.448,160,300,.533,62,195,.318,45,59,.763,10,117,127,110,33,10,57,120,551,4.6
458,Troy Daniels\danietr01,2016-17,G,67,3,1183,185,495,.374,47,140,.336,138,355,.389,43,54,.796,22,78,100,46,20,4,45,90,551,4.3
459,Marcus Smart\smartma01,2017-18,G,54,11,1614,189,515,.367,114,266,.429,75,249,.301,97,133,.729,43,146,189,259,71,23,129,133,550,7.6
460,Caris LeVert\leverca01,2018-19,G-F,40,25,1063,207,483,.429,159,329,.483,48,154,.312,85,123,.691,35,116,151,156,42,14,69,77,547,9.9
461,Garrett Temple\templga01,2017-18,G,65,35,1615,199,476,.418,110,249,.442,89,227,.392,60,78,.769,22,130,152,124,57,27,79,135,547,5.7
462,Alan Anderson\anderal01,2014-15,G-F,74,19,1744,195,440,.443,122,230,.530,73,210,.348,82,101,.812,31,173,204,83,56,5,60,148,545,5.1
463,Wayne Ellington\ellinwa01,2018-19,G,53,38,1297,184,457,.403,46,85,.541,138,372,.371,39,49,.796,14,93,107,72,54,6,40,92,545,6.9
464,Ryan Arcidiacono\arcidry01,2018-19,G,81,32,1961,187,418,.447,106,201,.527,81,217,.373,89,102,.873,27,192,219,269,65,4,63,171,544,6.4
465,José Calderón\caldejo01,2015-16,G,72,72,2024,209,455,.459,125,252,.496,84,203,.414,42,48,.875,22,207,229,298,63,7,87,135,544,7.2
466,Gary Neal\nealga01,2014-15,G,54,1,1192,188,503,.374,138,339,.407,50,164,.305,117,135,.867,14,115,129,100,23,1,65,88,543,5.5
467,Isaiah Whitehead\whiteis01,2016-17,G,73,26,1643,204,508,.402,160,359,.446,44,149,.295,91,113,.805,32,152,184,192,42,36,142,175,543,4.4
468,Jerryd Bayless\bayleje01,2015-16,G,52,18,1505,185,437,.423,84,206,.408,101,231,.437,70,90,.778,21,120,141,163,47,11,73,111,541,7.8
469,Jason Terry\terryja01,2014-15,G,77,18,1641,188,446,.422,62,123,.504,126,323,.390,39,48,.813,15,106,121,147,66,19,74,116,541,5.3
470,Tony Allen\allento01,2014-15,G-F,63,41,1648,225,455,.495,215,426,.505,10,29,.345,79,126,.627,103,177,280,86,129,30,86,166,539,7.5
471,Josh Richardson\richajo01,2016-17,G,53,34,1614,202,513,.394,127,286,.444,75,227,.330,60,77,.779,35,133,168,140,60,39,65,132,539,7.3
472,Raymond Felton\feltora01,2016-17,G,80,11,1700,221,514,.430,175,370,.473,46,144,.319,50,64,.781,33,185,218,191,66,22,83,125,538,5.3
473,Quincy Pondexter\pondequ01,2014-15,G-F,75,30,1793,188,447,.421,97,203,.478,91,244,.373,71,96,.740,53,142,195,94,19,24,51,150,538,4.8
474,Rajon Rondo\rondora01,2016-17,G,69,42,1843,229,561,.408,179,428,.418,50,133,.376,30,50,.600,73,282,355,461,99,11,169,144,538,8.2
475,Cory Joseph\josepco01,2018-19,G,82,9,2063,226,548,.412,171,377,.454,55,171,.322,30,43,.698,39,240,279,321,94,22,80,131,537,6.6
476,Rajon Rondo\rondora01,2017-18,G,65,63,1705,231,494,.468,181,344,.526,50,150,.333,25,46,.543,31,232,263,533,70,10,151,119,537,9.5
477,Tony Allen\allento01,2015-16,G-F,64,57,1620,215,469,.458,200,427,.468,15,42,.357,90,138,.652,104,192,296,70,110,18,78,175,535,6.7
478,Cory Joseph\josepco01,2014-15,G,79,14,1444,207,411,.504,191,367,.520,16,44,.364,105,143,.734,44,148,192,188,46,17,67,105,535,6.0
479,Langston Galloway\gallola01,2014-15,G,45,41,1457,204,511,.399,142,335,.424,62,176,.352,63,78,.808,37,153,190,150,52,12,61,129,533,8.3
480,Andrew Harrison\harrian01,2017-18,G,56,46,1326,181,429,.422,134,287,.467,47,142,.331,124,159,.780,23,108,131,177,38,26,81,138,533,6.8
481,Justin Anderson\anderju01,2016-17,G,75,10,1227,186,439,.424,128,245,.522,58,194,.299,102,129,.791,69,176,245,66,41,23,66,109,532,5.1
482,Toney Douglas\douglto01,2015-16,G,61,18,1262,183,445,.411,102,242,.421,81,203,.399,84,99,.848,25,118,143,157,70,5,64,131,531,6.7
483,Ben McLemore\mclembe01,2015-16,G,68,53,1443,195,455,.429,128,270,.474,67,185,.362,74,103,.718,34,114,148,79,52,10,99,140,531,4.4
484,Tony Parker\parketo01,2018-19,G,56,0,1003,213,463,.460,200,412,.485,13,51,.255,91,124,.734,14,69,83,207,21,7,75,53,530,6.8
485,Austin Rivers\riverau01,2014-15,G,76,5,1563,203,496,.409,164,365,.449,39,131,.298,85,126,.675,27,125,152,155,48,14,65,146,530,4.6
486,Sergio Rodríguez\rodrise01,2016-17,G,68,30,1518,210,536,.392,118,284,.415,92,252,.365,18,27,.667,21,136,157,344,49,4,128,95,530,6.1
487,Shabazz Napier\napiesh01,2018-19,G,56,2,983,169,435,.389,93,207,.449,76,228,.333,115,138,.833,18,82,100,143,41,16,66,67,529,6.8
488,Lonzo Ball\balllo01,2017-18,G,52,50,1780,203,564,.360,113,269,.420,90,295,.305,32,71,.451,69,291,360,376,88,43,136,117,528,10.2
489,Ian Clark\clarkia01,2016-17,G,77,0,1137,211,433,.487,150,270,.556,61,163,.374,44,58,.759,22,99,121,90,39,8,55,77,527,4.8
490,Dion Waiters\waitedi01,2018-19,G,44,28,1138,198,478,.414,89,189,.471,109,289,.377,22,44,.500,7,109,116,121,29,9,64,72,527,7.4
491,Josh Hart\hartjo01,2018-19,G,67,22,1715,189,464,.407,97,190,.511,92,274,.336,55,80,.688,35,213,248,93,64,40,58,147,525,5.9
492,Tomáš Satoranský\satorto01,2017-18,G,73,30,1643,201,384,.523,154,283,.544,47,101,.465,75,96,.781,72,161,233,286,52,15,83,131,524,7.6
493,Jeremy Lin\linje01,2016-17,G,36,33,883,175,400,.438,117,244,.480,58,156,.372,115,141,.816,11,124,135,184,42,14,86,79,523,11.4
494,Jameer Nelson\nelsoja01,2014-15,G,63,29,1406,205,504,.407,116,246,.472,89,258,.345,24,36,.667,33,113,146,253,47,6,109,136,523,5.9
495,Marcus Smart\smartma01,2014-15,G,67,38,1808,175,477,.367,84,205,.410,91,272,.335,82,127,.646,61,161,222,208,99,18,90,176,523,6.4
496,Andre Roberson\roberan03,2016-17,G-F,79,79,2376,215,463,.464,170,279,.609,45,184,.245,47,111,.423,98,305,403,79,94,79,51,204,522,6.2
497,Kris Dunn\dunnkr01,2018-19,G,46,44,1389,215,506,.425,181,410,.441,34,96,.354,55,69,.797,19,168,187,277,68,21,104,166,519,9.0
498,Manu Ginóbili\ginobma01,2016-17,G,69,0,1291,171,439,.390,82,212,.387,89,227,.392,86,107,.804,28,129,157,183,82,16,96,119,517,5.9
499,Rodney Stuckey\stuckro01,2015-16,G,58,1,1275,183,443,.413,163,360,.453,20,83,.241,131,158,.829,19,137,156,142,43,8,76,77,517,6.3
500,Norman Powell\powelno01,2018-19,G,60,3,1126,193,400,.483,125,230,.543,68,170,.400,62,75,.827,16,123,139,91,39,13,65,96,516,6.1
501,Tony Snell\snellto01,2017-18,G-F,75,59,2053,185,425,.435,77,157,.490,108,268,.403,38,48,.792,9,132,141,98,47,28,36,115,516,5.2
502,Arron Afflalo\afflaar01,2016-17,G-F,61,45,1580,185,420,.440,123,269,.457,62,151,.411,83,93,.892,9,116,125,78,21,6,42,104,515,5.4
503,Kevin Martin\martike02,2015-16,G,55,13,1095,156,419,.372,107,283,.378,49,136,.360,153,172,.890,14,96,110,58,26,3,54,83,514,5.4
504,Wayne Selden\seldewa01,2018-19,G-F,75,13,1438,196,483,.406,141,309,.456,55,174,.316,67,92,.728,37,143,180,109,33,13,79,131,514,4.0
505,Terrance Ferguson\fergute01,2018-19,G-F,74,74,1931,185,431,.429,79,141,.560,106,290,.366,37,51,.725,33,108,141,72,40,16,47,231,513,4.0
506,Jeff Teague\teaguje01,2018-19,G,42,41,1264,176,416,.423,141,311,.453,35,105,.333,123,153,.804,16,90,106,343,43,18,97,90,510,11.4
507,Quinn Cook\cookqu01,2018-19,G,74,10,1059,204,439,.465,123,239,.515,81,200,.405,20,26,.769,22,135,157,116,20,3,50,92,509,4.8
508,Jamal Crawford\crawfja01,2018-19,G,64,0,1211,174,438,.397,107,236,.453,67,202,.332,93,110,.845,8,77,85,229,33,12,99,75,508,5.7
509,Mario Chalmers\chalmma01,2017-18,G,66,10,1421,168,443,.379,115,252,.456,53,191,.277,118,138,.855,13,144,157,197,79,14,117,179,507,5.3
510,Tony Wroten\wroteto01,2014-15,G,30,15,895,175,434,.403,138,292,.473,37,142,.261,120,180,.667,22,64,86,157,48,8,113,72,507,10.2
511,Garrett Temple\templga01,2016-17,G,65,21,1728,183,432,.424,101,212,.476,82,220,.373,58,74,.784,32,152,184,168,84,28,78,141,506,6.5
512,Archie Goodwin\goodwar01,2015-16,G,57,13,1114,176,422,.417,153,323,.474,23,99,.232,130,193,.674,27,115,142,118,27,13,100,84,505,5.1
513,Ray McCallum\mccalra01,2014-15,G,68,30,1436,206,470,.438,172,359,.479,34,111,.306,57,84,.679,52,128,180,188,45,11,85,92,503,5.6
514,Rodney McGruder\mcgruro01,2018-19,G,66,45,1550,186,461,.403,107,236,.453,79,225,.351,52,72,.722,60,178,238,112,36,12,64,115,503,5.4
515,Ish Smith\smithis01,2018-19,G,56,0,1251,205,489,.419,161,354,.455,44,135,.326,47,62,.758,23,122,145,203,28,11,61,109,501,6.4
516,Lance Stephenson\stephla01,2014-15,G-F,61,25,1573,207,550,.376,189,445,.425,18,105,.171,69,110,.627,39,238,277,240,38,8,128,134,501,5.1
517,Danny Green\greenda02,2016-17,G-F,68,68,1807,176,449,.392,58,138,.420,118,311,.379,27,32,.844,31,193,224,124,70,57,76,120,497,5.9
518,Gerald Green\greenge01,2017-18,G-F,41,2,929,168,413,.407,58,115,.504,110,298,.369,51,60,.850,15,118,133,25,24,15,31,87,497,7.4
519,Rodney McGruder\mcgruro01,2016-17,G,78,65,1966,190,460,.413,117,240,.488,73,220,.332,44,71,.620,94,162,256,124,46,18,56,140,497,5.0
520,Josh Hart\hartjo01,2017-18,G,63,23,1461,176,375,.469,98,178,.551,78,197,.396,66,94,.702,42,221,263,80,47,16,47,107,496,6.6
521,Iman Shumpert\shumpim01,2014-15,G,62,25,1545,193,471,.410,126,275,.458,67,196,.342,43,64,.672,55,169,224,135,81,16,91,138,496,5.9
522,Frank Jackson\jacksfr01,2018-19,G,61,16,1169,194,447,.434,141,278,.507,53,169,.314,54,73,.740,25,109,134,69,25,2,48,92,495,4.8
523,Ben McLemore\mclembe01,2016-17,G,61,26,1176,180,419,.430,115,249,.462,65,170,.382,70,93,.753,19,110,129,51,29,6,62,108,495,4.5
524,Will Barton\bartowi01,2018-19,G,43,38,1189,185,460,.402,118,264,.447,67,196,.342,57,74,.770,32,167,199,124,18,22,65,82,494,7.8
525,Alec Burks\burksal01,2017-18,G,64,1,1059,170,414,.411,123,272,.452,47,142,.331,107,124,.863,19,173,192,67,37,8,60,75,494,5.2
526,Goran Dragić\dragigo01,2018-19,G,36,22,991,179,433,.413,122,269,.454,57,164,.348,79,101,.782,20,91,111,174,30,5,71,81,494,9.6
527,Evan Turner\turneev01,2018-19,G,73,2,1605,204,443,.460,193,391,.494,11,52,.212,75,106,.708,37,291,328,283,33,18,114,110,494,6.2
528,T.J. McConnell\mccontj01,2015-16,G,81,17,1606,218,464,.470,187,375,.499,31,89,.348,26,41,.634,43,207,250,367,95,10,140,114,493,6.4
529,Aaron Brooks\brookaa01,2015-16,G,69,0,1108,188,469,.401,122,284,.430,66,185,.357,49,64,.766,21,80,101,180,30,10,82,132,491,4.3
530,Lance Stephenson\stephla01,2018-19,G-F,68,3,1123,184,432,.426,111,235,.472,73,197,.371,50,73,.685,32,183,215,140,41,7,86,111,491,5.1
531,Shaun Livingston\livinsh01,2015-16,G,78,3,1520,203,379,.536,201,367,.548,2,12,.167,80,93,.860,42,127,169,237,57,27,78,140,488,6.1
532,Devin Harris\harride01,2015-16,G,64,0,1280,167,374,.447,115,216,.532,52,158,.329,101,140,.721,18,120,138,118,60,13,66,124,487,5.6
533,K.J. McDaniels\mcdankj01,2014-15,G-F,62,15,1352,172,434,.396,129,284,.454,43,150,.287,100,133,.752,65,135,200,72,44,70,105,126,487,5.0
534,Jodie Meeks\meeksjo01,2017-18,G,77,0,1119,157,393,.399,85,183,.464,72,210,.343,101,117,.863,15,111,126,70,29,4,37,55,487,4.3
535,Isaiah Thomas\thomais02,2017-18,G,32,15,862,157,421,.373,102,233,.438,55,188,.293,117,131,.893,17,50,67,153,15,3,95,58,486,8.8
536,T.J. McConnell\mccontj01,2018-19,G,76,3,1470,220,419,.525,206,377,.546,14,42,.333,29,37,.784,28,146,174,258,79,17,91,105,483,6.3
537,Jonathon Simmons\simmojo02,2016-17,G-F,78,8,1392,177,421,.420,147,319,.461,30,102,.294,99,132,.750,20,140,160,126,47,25,76,146,483,4.1
538,Brian Roberts\roberbr01,2014-15,G,72,10,1330,176,452,.389,114,259,.440,62,193,.321,66,74,.892,13,96,109,162,33,6,57,75,480,4.6
539,Thabo Sefolosha\sefolth01,2015-16,G-F,75,11,1758,188,372,.505,146,248,.589,42,124,.339,62,99,.626,52,282,334,107,85,37,68,109,480,6.3
540,T.J. McConnell\mccontj01,2017-18,G,76,1,1706,210,421,.499,183,359,.510,27,62,.435,31,39,.795,37,189,226,303,92,13,112,122,478,6.6
541,Norris Cole\coleno01,2015-16,G,45,23,1198,196,484,.405,163,382,.427,33,102,.324,52,65,.800,10,141,151,167,37,5,75,102,477,6.7
542,Raul Neto\netora01,2015-16,G,81,53,1499,180,418,.431,116,256,.453,64,162,.395,52,70,.743,17,103,120,174,62,2,109,122,476,3.9
543,Randy Foye\foyera01,2015-16,G,81,8,1642,169,482,.351,94,232,.405,75,250,.300,61,74,.824,24,132,156,161,39,29,86,131,474,3.6
544,Shaquille Harrison\harrish01,2018-19,G,73,11,1430,184,426,.432,160,337,.475,24,89,.270,82,123,.667,33,189,222,139,89,30,60,124,474,5.6
545,Shelvin Mack\macksh01,2017-18,G,69,3,1365,178,414,.430,130,275,.473,48,139,.345,69,97,.711,23,143,166,272,54,8,89,91,473,6.2
546,Shane Larkin\larkish01,2014-15,G,76,22,1865,187,432,.433,152,316,.481,35,116,.302,61,78,.782,29,147,176,226,93,9,83,150,470,5.5
547,Tyus Jones\jonesty01,2018-19,G,68,23,1560,185,446,.415,145,320,.453,40,126,.317,58,69,.841,23,111,134,327,81,5,47,78,468,7.5
548,Caris LeVert\leverca01,2016-17,G-F,57,26,1237,171,380,.450,112,196,.571,59,184,.321,67,93,.720,23,165,188,110,49,8,59,91,468,6.3
549,D.J. Augustin\augusdj01,2015-16,G,62,0,1178,148,350,.423,80,182,.440,68,168,.405,103,128,.805,8,87,95,198,38,4,84,85,467,5.9
550,Leandro Barbosa\barbole01,2014-15,G,66,1,982,183,386,.474,140,274,.511,43,112,.384,58,74,.784,23,68,91,99,41,8,44,87,467,5.1
551,Jarrett Jack\jackja01,2017-18,G,62,56,1548,189,443,.427,164,357,.459,25,86,.291,63,75,.840,22,169,191,348,35,4,115,98,466,6.8
552,Lonzo Ball\balllo01,2018-19,G,47,45,1423,185,456,.406,110,228,.482,75,228,.329,20,48,.417,54,197,251,255,69,19,103,114,465,8.9
553,Iman Shumpert\shumpim01,2018-19,G,62,41,1481,167,446,.374,72,173,.416,95,273,.348,36,45,.800,27,156,183,112,59,24,50,127,465,5.4
554,Tim Frazier\fraziti01,2016-17,G,65,35,1525,163,404,.403,123,276,.446,40,128,.313,98,129,.760,34,139,173,335,56,6,101,133,464,6.8
555,Frank Ntilikina\ntilila01,2017-18,G,78,9,1706,182,500,.364,132,343,.385,50,157,.318,49,68,.721,37,140,177,250,65,18,131,181,463,3.8
556,Yogi Ferrell\ferreyo01,2016-17,G,46,29,1197,160,394,.406,92,218,.422,68,176,.386,74,89,.831,20,91,111,172,42,9,70,90,462,7.6
557,Trey Burke\burketr01,2017-18,G,36,9,785,193,384,.503,155,279,.556,38,105,.362,37,57,.649,13,58,71,170,24,4,43,43,461,10.4
558,Shaun Livingston\livinsh01,2014-15,G,78,2,1468,198,396,.500,198,394,.503,0,2,.000,65,91,.714,43,140,183,259,49,20,102,110,461,5.4
559,George Hill\hillge01,2018-19,G,60,13,1302,170,376,.452,122,223,.547,48,153,.314,70,85,.824,39,109,148,135,52,8,51,102,458,6.3
560,Andre Iguodala\iguodan01,2015-16,G-F,65,1,1732,176,368,.478,122,214,.570,54,154,.351,51,83,.614,52,211,263,219,73,19,79,102,457,7.3
561,Justin Jackson\jacksju01,2017-18,G-F,68,41,1506,185,419,.442,128,234,.547,57,185,.308,26,36,.722,27,160,187,74,28,13,40,81,453,4.6
562,Shelvin Mack\macksh01,2015-16,G,52,27,1058,182,415,.439,143,290,.493,39,125,.312,45,61,.738,13,115,128,187,34,3,95,72,448,6.0
563,Elfrid Payton\paytoel01,2018-19,G,42,42,1250,179,412,.434,146,307,.476,33,105,.314,55,74,.743,49,171,220,320,44,17,112,81,446,10.5
564,Isaiah Taylor\taylois01,2017-18,G,67,9,1167,163,390,.418,143,310,.461,20,80,.250,99,141,.702,22,72,94,206,34,10,84,116,445,4.7
565,Thabo Sefolosha\sefolth01,2016-17,G-F,62,42,1596,174,395,.441,133,275,.484,41,120,.342,55,75,.733,54,216,270,107,96,31,58,97,444,6.9
566,Tony Snell\snellto01,2018-19,G-F,74,12,1304,163,361,.452,82,157,.522,81,204,.397,37,42,.881,29,128,157,68,26,18,23,90,444,4.6
567,Tyler Ulis\ulisty01,2016-17,G,61,15,1123,184,437,.421,163,358,.455,21,79,.266,55,71,.775,20,75,95,226,48,5,77,73,444,5.7
568,E'Twaun Moore\mooreet01,2015-16,G-F,59,22,1263,187,389,.481,140,285,.491,47,104,.452,22,35,.629,19,114,133,99,37,18,53,103,443,5.3
569,Pat Connaughton\connapa01,2017-18,G,82,5,1488,165,390,.423,91,180,.506,74,210,.352,37,44,.841,36,125,161,91,23,22,43,120,441,3.7
570,Devin Harris\harride01,2016-17,G,65,0,1087,136,341,.399,78,164,.476,58,177,.328,107,129,.829,11,116,127,136,43,7,57,101,437,5.1
571,Randy Foye\foyera01,2014-15,G,50,21,1087,148,402,.368,54,139,.388,94,263,.357,45,55,.818,9,76,85,119,34,11,60,97,435,5.3
572,Tony Snell\snellto01,2014-15,G-F,72,22,1412,159,371,.429,86,174,.494,73,197,.371,44,55,.800,31,145,176,62,32,11,48,86,435,4.2
573,Alexey Shved\shvedal01,2014-15,G,42,9,767,133,335,.397,86,196,.439,47,139,.338,121,150,.807,23,76,99,106,30,6,48,48,434,7.6
574,Leandro Barbosa\barbole01,2015-16,G,68,0,1079,171,370,.462,132,260,.508,39,110,.355,52,62,.839,28,89,117,82,44,10,53,107,433,4.4
575,Rodney Hood\hoodro01,2014-15,G-F,50,21,1064,155,374,.414,93,204,.456,62,170,.365,61,80,.763,9,108,117,83,30,12,45,119,433,5.4
576,Isaiah Canaan\canaais01,2014-15,G,47,21,938,146,378,.386,55,132,.417,91,246,.370,49,60,.817,18,69,87,98,29,3,62,83,432,5.5
577,Spencer Dinwiddie\dinwisp01,2016-17,G,59,18,1334,134,302,.444,96,201,.478,38,101,.376,126,159,.792,27,137,164,185,44,23,66,119,432,6.7
578,Torrey Craig\craigto01,2018-19,G-F,75,37,1503,160,362,.442,99,174,.569,61,188,.324,49,70,.700,89,174,263,72,37,46,44,175,430,4.7
579,Shelvin Mack\macksh01,2016-17,G,55,9,1205,170,381,.446,133,261,.510,37,120,.308,53,77,.688,20,105,125,154,42,3,90,100,430,5.3
580,Shelvin Mack\macksh01,2018-19,G,57,3,1247,163,403,.404,117,273,.429,46,130,.354,58,84,.690,18,86,104,183,47,4,66,84,430,5.6
581,Miloš Teodosić\teodomi01,2017-18,G,45,36,1134,151,360,.419,63,128,.492,88,232,.379,39,46,.848,16,110,126,209,23,5,97,103,429,7.0
582,Dion Waiters\waitedi01,2017-18,G,30,30,918,163,410,.398,111,240,.463,52,170,.306,51,69,.739,8,69,77,113,23,9,70,61,429,8.0
583,Devin Harris\harride01,2018-19,G,68,2,1071,132,347,.380,70,147,.476,62,200,.310,102,134,.761,12,100,112,122,35,16,56,133,428,4.2
584,Joe Harris\harrijo01,2016-17,G,52,11,1138,154,362,.425,69,141,.489,85,221,.385,35,49,.714,16,131,147,54,30,8,55,121,428,4.8
585,Jerian Grant\grantje02,2015-16,G,76,6,1265,154,391,.394,132,291,.454,22,100,.220,96,123,.780,23,120,143,177,50,10,87,97,426,4.1
586,Andrew Harrison\harrian01,2016-17,G,72,18,1474,117,360,.325,74,204,.363,43,156,.276,148,194,.763,23,113,136,198,53,21,85,194,425,4.1
587,CJ McCollum\mccolcj01,2014-15,G,62,3,973,159,365,.436,104,226,.460,55,139,.396,51,73,.699,14,77,91,64,43,8,48,81,424,4.3
588,Rajon Rondo\rondora01,2018-19,G,46,29,1369,175,432,.405,124,290,.428,51,142,.359,23,36,.639,34,209,243,367,57,7,127,100,424,9.2
589,Donald Sloan\sloando01,2015-16,G,61,33,1318,154,350,.440,116,251,.462,38,99,.384,78,104,.750,17,156,173,268,32,4,80,73,424,6.6
590,Ben McLemore\mclembe01,2017-18,G,56,17,1091,157,373,.421,102,214,.477,55,159,.346,53,64,.828,34,105,139,51,38,15,61,139,422,4.3
591,Jason Terry\terryja01,2015-16,G,72,7,1258,151,376,.402,58,115,.504,93,261,.356,27,33,.818,14,65,79,103,47,9,49,91,422,4.0
592,Pat Connaughton\connapa01,2018-19,G,61,2,1261,163,350,.466,97,150,.647,66,200,.330,29,40,.725,61,197,258,122,33,25,33,81,421,6.7
593,Malik Monk\monkma01,2017-18,G,63,0,854,153,425,.360,70,182,.385,83,243,.342,32,38,.842,8,58,66,91,20,9,49,60,421,3.5
594,Tony Parker\parketo01,2017-18,G,55,21,1071,178,388,.459,168,351,.479,10,37,.270,55,78,.705,7,88,95,195,28,1,68,52,421,5.8
595,Yogi Ferrell\ferreyo01,2018-19,G,71,3,1067,153,352,.435,99,203,.488,54,149,.362,60,67,.896,13,96,109,137,36,4,40,64,420,4.8
596,Leandro Barbosa\barbole01,2016-17,G,67,0,963,172,392,.439,137,294,.466,35,98,.357,40,45,.889,15,89,104,81,31,8,48,82,419,3.9
597,Glenn Robinson\robingl02,2016-17,G-F,69,27,1427,158,338,.467,109,213,.512,49,125,.392,54,76,.711,57,189,246,47,41,20,37,63,419,5.2
598,Antonio Blakeney\blakean01,2018-19,G,57,3,829,166,396,.419,130,305,.426,36,91,.396,50,76,.658,7,99,106,42,12,9,35,41,418,4.0
599,Tyus Jones\jonesty01,2017-18,G,82,11,1467,150,328,.457,105,199,.528,45,129,.349,71,81,.877,16,116,132,232,95,6,59,110,416,5.5
600,J.J. Barea\bareajo01,2018-19,G,38,0,752,161,385,.418,123,257,.479,38,128,.297,55,78,.705,13,82,95,211,22,1,72,50,415,8.2
601,Allen Crabbe\crabbal01,2018-19,G-F,43,20,1133,137,373,.367,39,114,.342,98,259,.378,41,56,.732,16,132,148,46,23,13,46,102,413,5.3
602,Frank Mason\masonfr01,2017-18,G,52,2,984,144,380,.379,113,294,.384,31,86,.360,94,115,.817,30,100,130,147,34,10,65,72,413,5.7
603,Alec Burks\burksal01,2015-16,G,31,3,797,137,334,.410,105,255,.412,32,79,.405,106,141,.752,16,93,109,63,18,4,51,71,412,7.9
604,Dante Exum\exumda01,2016-17,G,66,26,1228,155,363,.427,111,214,.519,44,149,.295,58,73,.795,30,102,132,111,21,12,80,146,412,3.5
605,Tyreke Evans\evansty01,2016-17,G-F,40,6,788,150,370,.405,108,252,.429,42,118,.356,69,92,.750,13,124,137,124,35,9,61,60,411,7.3
606,Jarrett Jack\jackja01,2015-16,G,32,32,1027,140,358,.391,109,256,.426,31,102,.304,100,112,.893,9,127,136,236,34,7,94,77,411,10.5
607,P.J. Hairston\hairspj02,2015-16,G-F,66,52,1313,145,408,.355,75,167,.449,70,241,.290,50,64,.781,25,149,174,38,32,11,41,137,410,3.2
608,Terry Rozier\roziete01,2016-17,G,74,0,1263,151,411,.367,94,232,.405,57,179,.318,51,66,.773,40,187,227,131,46,11,47,69,410,4.5
609,Álex Abrines\abrinal01,2016-17,G-F,68,6,1055,134,341,.393,40,94,.426,94,247,.381,44,49,.898,18,68,86,40,37,8,33,114,406,3.6
610,Tyler Dorsey\dorsety01,2017-18,G,56,5,974,144,382,.377,72,183,.393,72,199,.362,45,63,.714,17,113,130,79,17,5,37,63,405,4.4
611,Ramon Sessions\sessira01,2014-15,G,64,10,1188,125,334,.374,106,274,.387,19,60,.317,133,173,.769,23,121,144,182,29,0,86,73,402,4.6
612,Ian Clark\clarkia01,2018-19,G,60,6,973,151,383,.394,85,181,.470,66,202,.327,33,37,.892,13,76,89,94,22,8,58,95,401,3.7
613,Zach LaVine\lavinza01,2017-18,G,24,24,656,136,355,.383,94,232,.405,42,123,.341,87,107,.813,9,85,94,72,24,4,43,55,401,10.1
614,Nik Stauskas\stausni01,2018-19,G,68,0,1015,136,338,.402,66,150,.440,70,188,.372,57,64,.891,18,109,127,81,21,7,51,50,399,4.0
615,Will Barton\bartowi01,2014-15,G,58,0,984,150,353,.425,127,268,.474,23,85,.271,74,94,.787,26,136,162,81,48,19,61,70,397,5.0
616,Vince Carter\cartevi01,2015-16,G-F,60,3,1005,133,343,.388,74,174,.425,59,169,.349,70,84,.833,31,115,146,56,38,16,35,101,395,4.5
617,Shaun Livingston\livinsh01,2017-18,G,71,7,1129,172,343,.501,172,338,.509,0,5,.000,50,61,.820,32,99,131,140,35,21,58,117,394,4.4
618,Dante Exum\exumda01,2014-15,G,82,41,1817,145,416,.349,62,152,.408,83,264,.314,20,32,.625,27,104,131,198,41,14,118,147,393,2.7
619,Nick Young\youngni01,2015-16,G-F,54,2,1033,126,372,.339,49,135,.363,77,237,.325,63,76,.829,14,83,97,34,23,7,30,50,392,3.9
620,Malcolm Delaney\delanma01,2016-17,G,73,2,1248,145,388,.374,119,278,.428,26,110,.236,75,93,.806,10,113,123,193,39,1,95,112,391,3.4
621,Donald Sloan\sloando01,2014-15,G,53,21,1107,145,355,.408,104,224,.464,41,131,.313,60,77,.779,12,131,143,190,23,0,65,47,391,5.9
622,Kent Bazemore\bazemke01,2014-15,G-F,75,10,1324,141,331,.426,93,199,.467,48,132,.364,60,100,.600,21,201,222,78,52,33,73,127,390,3.7
623,Gary Neal\nealga01,2015-16,G,40,2,807,151,325,.465,110,225,.489,41,100,.410,47,55,.855,11,72,83,47,20,1,29,55,390,6.3
624,Andre Iguodala\iguodan01,2018-19,G-F,68,13,1578,151,302,.500,103,158,.652,48,144,.333,39,67,.582,48,204,252,216,61,51,52,95,389,7.1
625,Shaun Livingston\livinsh01,2016-17,G,76,3,1345,173,316,.547,172,313,.550,1,3,.333,42,60,.700,28,123,151,139,38,20,62,120,389,4.3
626,JaKarr Sampson\sampsja02,2014-15,G-F,74,32,1131,146,346,.422,115,219,.525,31,127,.244,63,94,.670,35,128,163,77,38,26,76,135,386,3.1
627,Norman Powell\powelno01,2017-18,G,70,18,1062,150,374,.401,97,188,.516,53,186,.285,32,39,.821,14,105,119,89,37,16,66,111,385,3.2
628,Vince Carter\cartevi01,2014-15,G-F,66,1,1091,135,406,.333,66,174,.379,69,232,.297,45,57,.789,27,106,133,79,43,14,43,102,384,3.4
629,Andre Iguodala\iguodan01,2017-18,G-F,64,7,1622,148,320,.463,115,203,.567,33,117,.282,55,87,.632,50,196,246,210,54,38,67,99,384,6.6
630,José Calderón\caldejo01,2014-15,G,42,42,1270,147,354,.415,88,212,.415,59,142,.415,29,32,.906,19,105,124,198,31,0,75,76,382,7.2
631,J.J. Barea\bareajo01,2016-17,G,35,6,771,142,343,.414,89,195,.456,53,148,.358,44,51,.863,9,75,84,193,14,1,63,30,381,8.5
632,Anthony Morrow\morroan01,2015-16,G,68,6,926,136,333,.408,57,129,.442,79,204,.387,29,39,.744,10,52,62,24,22,5,17,64,380,3.2
633,Marcus Thornton\thornma01,2014-15,G,48,0,721,140,345,.406,86,202,.426,54,143,.378,46,56,.821,23,63,86,36,27,7,27,38,380,5.0
634,Tyreke Evans\evansty01,2015-16,G-F,25,25,765,136,314,.433,103,229,.450,33,85,.388,74,93,.796,20,109,129,164,32,8,73,66,379,12.2
635,Kirk Hinrich\hinriki01,2014-15,G,66,22,1610,142,381,.373,84,213,.394,58,168,.345,35,50,.700,20,101,121,148,46,14,73,144,377,3.5
636,Alec Burks\burksal01,2014-15,G,27,27,899,121,300,.403,95,232,.409,26,68,.382,106,129,.822,19,95,114,82,17,5,52,64,374,9.1
637,JaKarr Sampson\sampsja02,2015-16,G-F,73,40,1160,140,317,.442,126,254,.496,14,63,.222,80,122,.656,46,144,190,46,23,33,70,142,374,3.0
638,Ty Lawson\lawsoty01,2015-16,G,66,13,1411,139,354,.393,103,246,.419,36,108,.333,59,86,.686,26,94,120,237,53,7,95,87,373,4.7
639,Sterling Brown\brownst02,2018-19,G,58,7,1034,145,312,.465,92,165,.558,53,147,.361,29,42,.690,29,155,184,84,25,8,46,88,372,4.9
640,Joe Johnson\johnsjo02,2017-18,G-F,55,4,1205,146,360,.406,106,215,.493,40,145,.276,40,45,.889,14,158,172,83,18,7,49,67,372,4.3
641,Jerian Grant\grantje02,2016-17,G,63,28,1028,128,301,.425,79,167,.473,49,134,.366,65,73,.890,17,94,111,121,47,8,44,93,370,4.8
642,Danuel House\houseda01,2018-19,G,39,13,979,118,252,.468,44,74,.595,74,178,.416,56,71,.789,25,115,140,40,21,11,35,80,366,7.0
643,Jonathon Simmons\simmojo02,2018-19,G-F,56,9,1064,133,350,.380,105,246,.427,28,104,.269,72,97,.742,27,99,126,128,29,15,68,89,366,4.3
644,Markel Brown\brownma02,2015-16,G,62,6,982,127,322,.394,89,201,.443,38,121,.314,71,94,.755,23,99,122,91,38,15,54,94,363,4.0
645,Langston Galloway\gallola01,2017-18,G,58,2,863,126,340,.371,51,122,.418,75,218,.344,33,41,.805,13,79,92,58,35,5,18,39,360,4.3
646,Randy Foye\foyera01,2016-17,G,69,40,1284,118,325,.363,51,122,.418,67,203,.330,54,63,.857,9,146,155,135,35,9,80,99,357,3.5
647,Andre Miller\millean02,2014-15,G,81,0,1253,145,290,.500,138,256,.539,7,34,.206,58,77,.753,37,116,153,284,32,6,104,103,355,4.4
648,Álex Abrines\abrinal01,2017-18,G-F,75,8,1134,115,291,.395,31,70,.443,84,221,.380,39,46,.848,26,88,114,28,38,8,25,124,353,3.0
649,Patty Mills\millspa02,2014-15,G,51,0,801,128,336,.381,66,154,.429,62,182,.341,33,40,.825,21,54,75,87,28,2,35,58,351,4.5
650,J.R. Smith\smithjr01,2016-17,G-F,41,35,1187,123,356,.346,28,85,.329,95,271,.351,10,15,.667,17,96,113,62,40,11,26,77,351,5.5
651,Steve Blake\blakest01,2014-15,G,81,0,1529,122,327,.373,45,108,.417,77,219,.352,29,41,.707,16,121,137,288,41,5,104,118,350,3.8
652,Ben Gordon\gordobe01,2014-15,G,56,0,790,129,295,.437,94,198,.475,35,97,.361,56,67,.836,6,57,63,50,14,1,55,60,349,3.2
653,Sean Kilpatrick\kilpase01,2015-16,G,31,0,616,123,270,.456,84,156,.538,39,114,.342,60,67,.896,12,44,56,29,12,2,31,37,345,6.8
654,Josh Richardson\richajo01,2015-16,G,52,2,1107,123,272,.452,70,157,.446,53,115,.461,42,63,.667,21,86,107,73,36,25,35,107,341,5.0
655,C.J. Miles\milescj01,2018-19,G-F,53,1,857,112,311,.360,45,108,.417,67,203,.330,48,58,.828,13,82,95,36,26,15,30,79,339,3.7
656,Malcolm Delaney\delanma01,2017-18,G,54,3,1014,109,285,.382,63,161,.391,46,124,.371,74,92,.804,9,91,100,163,35,6,66,82,338,4.9
657,Ish Smith\smithis01,2014-15,G,55,14,831,143,367,.390,125,307,.407,18,60,.300,34,57,.596,15,85,100,180,36,6,78,50,338,4.2
658,Tony Snell\snellto01,2015-16,G-F,64,33,1301,126,339,.372,70,184,.380,56,155,.361,30,33,.909,19,180,199,63,16,17,52,100,338,3.1
659,Mo Williams\willima01,2015-16,G,41,14,748,132,302,.437,96,200,.480,36,102,.353,38,42,.905,6,66,72,98,14,5,57,60,338,5.0
660,Andre Roberson\roberan03,2015-16,G-F,70,70,1553,136,274,.496,104,171,.608,32,103,.311,33,54,.611,79,172,251,47,53,42,35,133,337,4.6
661,Mike James\jamesmi02,2017-18,G,36,10,687,123,321,.383,97,223,.435,26,98,.265,64,84,.762,13,77,90,126,28,7,49,48,336,6.6
662,David Nwaba\nwabada01,2018-19,G,51,14,984,126,262,.481,102,187,.545,24,75,.320,58,85,.682,41,122,163,54,36,17,29,106,334,5.3
663,Brandon Jennings\jennibr01,2015-16,G,48,7,868,112,304,.368,61,149,.409,51,155,.329,57,78,.731,16,80,96,170,29,7,57,57,332,5.5
664,Ronnie Price\pricero01,2015-16,G,62,18,1211,116,302,.384,48,106,.453,68,196,.347,31,41,.756,25,74,99,147,74,13,70,161,331,4.1
665,Jonathon Simmons\simmojo02,2015-16,G-F,55,2,813,122,242,.504,104,195,.533,18,47,.383,69,92,.750,16,80,96,58,24,5,53,103,331,3.8
666,Sean Kilpatrick\kilpase01,2017-18,G,52,1,640,110,294,.374,64,150,.427,46,144,.319,64,72,.889,5,82,87,46,13,5,38,33,330,3.7
667,Jodie Meeks\meeksjo01,2016-17,G,36,10,738,103,256,.402,47,119,.395,56,137,.409,65,74,.878,5,72,77,45,34,4,36,41,327,6.3
668,Tim Hardaway\hardati02,2015-16,G,51,1,864,114,265,.430,66,123,.537,48,142,.338,50,56,.893,7,79,86,51,21,7,23,48,326,4.5
669,Alonzo Gee\geeal01,2015-16,G,73,38,1632,132,255,.518,115,195,.590,17,60,.283,44,66,.667,60,185,245,72,63,13,55,169,325,3.9
670,Wayne Selden\seldewa01,2017-18,G-F,35,9,692,116,269,.431,67,147,.456,49,122,.402,44,59,.746,16,40,56,66,18,5,54,59,325,5.4
671,Aaron Brooks\brookaa01,2016-17,G,65,0,894,121,300,.403,73,172,.424,48,128,.375,32,40,.800,18,51,69,125,25,9,66,93,322,3.1
672,O.J. Mayo\mayooj01,2015-16,G,41,24,1090,119,321,.371,67,159,.421,52,162,.321,31,40,.775,13,92,105,118,48,8,72,126,321,4.7
673,Bruce Brown\brownbr01,2018-19,G,74,56,1449,125,314,.398,101,221,.457,24,93,.258,45,60,.750,48,137,185,91,40,36,46,178,319,3.1
674,Matthew Dellavedova\dellama01,2014-15,G,67,13,1380,111,307,.362,43,140,.307,68,167,.407,29,38,.763,37,89,126,204,24,2,61,152,319,3.6
675,Nik Stauskas\stausni01,2014-15,G,73,1,1127,108,296,.365,60,147,.408,48,149,.322,55,64,.859,11,77,88,67,20,17,40,92,319,2.5
676,Troy Daniels\danietr01,2018-19,G,51,1,760,113,275,.411,39,81,.481,74,194,.381,18,23,.783,13,60,73,26,26,5,27,79,318,3.6
677,Dwayne Bacon\bacondw01,2018-19,G,43,13,759,122,257,.475,84,170,.494,38,87,.437,34,46,.739,8,81,89,47,12,5,18,72,316,4.9
678,Tyler Johnson\johnsty01,2015-16,G,36,5,863,118,243,.486,91,172,.529,27,71,.380,51,64,.797,28,81,109,79,24,14,47,66,314,6.8
679,Vince Carter\cartevi01,2017-18,G-F,58,4,1026,114,283,.403,57,118,.483,57,165,.345,28,37,.757,18,130,148,69,42,26,36,96,313,4.2
680,Quinn Cook\cookqu01,2017-18,G,33,18,740,122,252,.484,76,148,.514,46,104,.442,22,25,.880,10,72,82,89,12,1,32,59,312,7.0
681,Thabo Sefolosha\sefolth01,2017-18,G-F,38,6,806,118,240,.492,86,156,.551,32,84,.381,44,54,.815,29,132,161,33,52,12,30,59,312,7.3
682,Ramon Sessions\sessira01,2016-17,G,50,1,811,100,263,.380,79,201,.393,21,62,.339,91,118,.771,11,62,73,129,27,3,46,43,312,4.8
683,Iman Shumpert\shumpim01,2015-16,G,54,5,1316,114,305,.374,71,159,.447,43,146,.295,40,51,.784,32,171,203,92,54,19,57,119,311,4.4
684,Tim Frazier\fraziti01,2018-19,G,59,19,1120,116,261,.444,79,160,.494,37,101,.366,41,54,.759,41,127,168,248,30,5,76,112,310,5.5
685,Jerryd Bayless\bayleje01,2017-18,G,39,11,925,109,262,.416,55,116,.474,54,146,.370,35,44,.795,15,65,80,54,23,6,46,91,307,4.5
686,Jason Terry\terryja01,2016-17,G,74,0,1365,105,243,.432,32,72,.444,73,171,.427,24,29,.828,15,91,106,98,46,20,36,95,307,3.6
687,Willie Green\greenwi01,2014-15,G,52,2,951,118,306,.386,76,185,.411,42,121,.347,28,34,.824,14,65,79,68,26,5,48,81,306,3.1
688,Brandon Rush\rushbr01,2015-16,G-F,72,25,1055,111,260,.427,46,103,.447,65,157,.414,18,28,.643,21,160,181,57,20,23,33,57,305,3.4
689,Elie Okobo\okoboel01,2018-19,G,53,16,958,114,290,.393,75,158,.475,39,132,.295,37,47,.787,12,86,98,127,32,7,69,109,304,3.6
690,Seth Curry\curryse01,2015-16,G,44,9,692,102,224,.455,52,113,.460,50,111,.450,45,54,.833,9,51,60,67,22,3,36,41,299,5.0
691,Shelvin Mack\macksh01,2014-15,G,55,0,833,117,292,.401,77,165,.467,40,127,.315,25,31,.806,8,71,79,155,30,2,49,32,299,4.4
692,Jameer Nelson\nelsoja01,2015-16,G,39,15,1036,113,307,.368,70,163,.429,43,144,.299,30,35,.857,19,96,115,190,25,5,66,100,299,5.8
693,Michael Carter-Williams\cartemi01,2016-17,G,45,19,846,112,306,.366,97,242,.401,15,64,.234,58,77,.753,24,129,153,113,38,23,66,102,297,4.5
694,Tyler Dorsey\dorsety01,2018-19,G,48,11,698,107,264,.405,63,132,.477,44,132,.333,38,61,.623,27,86,113,56,14,2,27,53,296,4.1
695,Sasha Vujačić\vujacsa01,2015-16,G,61,25,908,106,277,.383,54,134,.403,52,143,.364,32,39,.821,26,123,149,84,34,5,44,83,296,3.5
696,Jeremy Lamb\lambje01,2014-15,G-F,47,8,633,104,250,.416,66,139,.475,38,111,.342,49,55,.891,8,99,107,44,21,6,27,52,295,4.3
697,Aaron Holiday\holidaa01,2018-19,G,50,0,646,105,262,.401,62,135,.459,43,127,.339,41,50,.820,5,62,67,87,21,13,40,71,294,3.9
698,Kris Dunn\dunnkr01,2016-17,G,78,7,1333,118,313,.377,97,240,.404,21,73,.288,36,59,.610,24,142,166,188,78,36,89,178,293,3.2
699,Denzel Valentine\valende01,2016-17,G,57,0,976,102,288,.354,29,80,.363,73,208,.351,14,18,.778,11,140,151,63,30,7,49,86,291,3.1
700,Tyrone Wallace\wallaty01,2017-18,G,30,19,851,110,247,.445,100,207,.483,10,40,.250,61,78,.782,21,84,105,71,27,13,46,83,291,6.7
701,Dante Exum\exumda01,2018-19,G,42,1,664,101,241,.419,83,179,.464,18,62,.290,68,86,.791,16,52,68,110,14,5,52,69,288,4.6
702,Trey Burke\burketr01,2016-17,G,57,0,703,116,255,.455,85,185,.459,31,70,.443,22,29,.759,7,40,47,100,11,5,48,54,285,3.2
703,Alec Burks\burksal01,2016-17,G,42,0,653,99,248,.399,74,172,.430,25,76,.329,60,78,.769,17,103,120,30,18,5,35,50,283,4.1
704,Cameron Payne\payneca01,2015-16,G,57,1,698,114,278,.410,78,167,.467,36,111,.324,19,24,.792,9,76,85,108,36,6,44,80,283,3.5
705,Matthew Dellavedova\dellama01,2018-19,G,48,0,812,98,242,.405,54,112,.482,44,130,.338,42,52,.808,6,71,77,181,14,2,68,75,282,4.5
706,Patrick McCaw\mccawpa01,2016-17,G,71,20,1074,106,245,.433,65,122,.533,41,123,.333,29,37,.784,21,79,100,77,32,15,36,62,282,3.2
707,Sindarius Thornwell\thornsi01,2017-18,G,73,16,1156,100,233,.429,77,172,.448,23,61,.377,59,88,.670,33,107,140,68,48,25,53,125,282,2.9
708,Rodney Stuckey\stuckro01,2016-17,G,39,0,696,91,244,.373,72,184,.391,19,60,.317,80,107,.748,6,78,84,84,16,0,53,44,281,4.3
709,C.J. Watson\watsocj01,2016-17,G,62,9,1012,96,248,.387,64,143,.448,32,105,.305,57,66,.864,16,73,89,114,43,2,47,84,281,3.5
710,Furkan Korkmaz\korkmfu01,2018-19,G,48,7,679,98,245,.400,51,101,.505,47,144,.326,36,44,.818,16,91,107,52,29,2,25,62,279,4.1
711,Kenrich Williams\willike04,2018-19,G-F,46,29,1079,107,279,.384,55,123,.447,52,156,.333,13,19,.684,55,164,219,83,45,19,36,95,279,5.5
712,Thabo Sefolosha\sefolth01,2014-15,G-F,52,7,976,104,249,.418,79,171,.462,25,78,.321,45,58,.776,53,170,223,75,53,21,38,67,278,5.5
713,Pablo Prigioni\prigipa01,2014-15,G,67,3,1197,91,228,.399,34,62,.548,57,166,.343,35,41,.854,30,89,119,171,79,1,62,88,274,4.5
714,Treveon Graham\grahatr01,2017-18,G,63,2,1050,96,221,.434,56,124,.452,40,97,.412,41,59,.695,42,79,121,59,33,2,27,109,273,3.3
715,Norman Powell\powelno01,2015-16,G,49,24,725,97,229,.424,61,140,.436,36,89,.404,43,53,.811,16,95,111,47,29,10,32,59,273,4.1
716,Anthony Morrow\morroan01,2016-17,G,49,7,714,98,252,.389,57,119,.479,41,133,.308,34,37,.919,12,19,31,25,24,2,6,44,271,3.4
717,Chasson Randle\randlch01,2018-19,G,49,2,743,91,217,.419,45,102,.441,46,115,.400,43,62,.694,10,46,56,97,25,3,43,91,271,3.8
718,Jordan Crawford\crawfjo02,2016-17,G,19,0,442,105,218,.482,68,123,.553,37,95,.389,20,26,.769,4,30,34,57,11,2,25,30,267,9.5
719,Brandon Knight\knighbr03,2018-19,G,39,26,737,99,260,.381,58,131,.443,41,129,.318,27,34,.794,10,49,59,71,21,2,30,62,266,4.1
720,Gerald Green\greenge01,2016-17,G-F,47,0,538,95,232,.409,56,121,.463,39,111,.351,33,41,.805,16,68,84,33,9,7,25,48,262,3.4
721,Tim Frazier\fraziti01,2015-16,G,51,2,741,96,229,.419,80,181,.442,16,48,.333,53,74,.716,26,84,110,162,33,2,65,73,261,4.5
722,Shabazz Napier\napiesh01,2014-15,G,51,10,1012,87,228,.382,44,110,.400,43,118,.364,44,56,.786,17,96,113,130,40,4,81,76,261,3.8
723,Shaun Livingston\livinsh01,2018-19,G,64,0,967,109,210,.519,109,208,.524,0,2,.000,40,51,.784,42,75,117,114,31,27,38,74,258,4.1
724,José Calderón\caldejo01,2017-18,G,57,32,914,93,185,.503,48,88,.545,45,97,.464,24,30,.800,14,70,84,117,27,2,41,81,255,4.0
725,Steve Blake\blakest01,2015-16,G,58,2,986,93,240,.388,41,89,.461,52,151,.344,16,20,.800,9,80,89,200,24,5,81,70,254,3.6
726,P.J. Hairston\hairspj02,2014-15,G-F,45,2,687,87,269,.323,38,106,.358,49,163,.301,31,36,.861,22,70,92,21,21,13,22,61,254,3.0
727,Jerian Grant\grantje02,2018-19,G,60,1,939,92,220,.418,52,110,.473,40,110,.364,26,40,.650,19,79,98,156,44,6,51,78,250,4.0
728,De'Anthony Melton\meltode01,2018-19,G,50,31,984,100,256,.391,71,161,.441,29,95,.305,21,28,.750,25,109,134,159,68,23,75,113,250,4.7
729,Cameron Payne\payneca01,2018-19,G,40,13,712,96,223,.430,71,139,.511,25,84,.298,33,41,.805,13,59,72,106,28,9,45,64,250,4.8
730,Troy Brown\browntr01,2018-19,G-F,52,10,730,97,234,.415,75,165,.455,22,69,.319,32,47,.681,35,110,145,80,21,5,30,56,248,3.9
731,Elijah Millsap\millsel01,2014-15,G-F,47,5,924,81,238,.340,53,148,.358,28,90,.311,58,86,.674,28,122,150,58,56,16,67,124,248,3.2
732,Jameer Nelson\nelsoja01,2017-18,G,50,0,1013,95,244,.389,54,120,.450,41,124,.331,16,20,.800,13,91,104,179,27,4,67,81,247,4.1
733,Frank Ntilikina\ntilila01,2018-19,G,43,16,904,95,282,.337,62,167,.371,33,115,.287,23,30,.767,12,75,87,121,30,14,56,104,246,3.3
734,Nick Calathes\calatni01,2014-15,G,58,0,838,104,247,.421,93,204,.456,11,43,.256,24,45,.533,19,87,106,146,63,5,61,100,243,3.6
735,Troy Daniels\danietr01,2015-16,G,43,0,476,89,187,.476,30,65,.462,59,122,.484,5,9,.556,7,50,57,21,11,3,24,40,242,3.6
736,Alonzo Gee\geeal01,2014-15,G,54,2,661,87,186,.468,74,151,.490,13,35,.371,54,77,.701,37,57,94,25,35,7,33,58,241,3.3
737,Paul Zipser\zipsepa01,2016-17,G-F,44,18,843,88,221,.398,55,122,.451,33,99,.333,31,40,.775,15,110,125,36,15,16,40,78,240,3.2
738,Michael Carter-Williams\cartemi01,2017-18,G,52,2,835,76,229,.332,62,170,.365,14,59,.237,73,89,.820,37,101,138,116,44,23,52,99,239,4.0
739,Nate Robinson\robinna01,2014-15,G,42,1,591,88,255,.345,57,143,.399,31,112,.277,31,46,.674,17,33,50,97,20,3,30,76,238,3.3
740,Marcelo Huertas\huertma01,2015-16,G,53,0,869,97,230,.422,81,169,.479,16,61,.262,27,29,.931,18,72,90,182,26,7,80,76,237,3.7
741,Justin Anderson\anderju01,2017-18,G,38,0,519,87,202,.431,53,99,.535,34,103,.330,28,38,.737,25,68,93,25,15,7,16,54,236,4.3
742,Ian Clark\clarkia01,2015-16,G,66,1,578,89,202,.441,59,118,.500,30,84,.357,28,34,.824,13,55,68,64,17,13,43,58,236,2.4
743,Jawun Evans\evansja01,2017-18,G,48,4,778,89,253,.352,74,199,.372,15,54,.278,38,49,.776,9,75,84,100,36,6,44,97,231,2.9
744,Archie Goodwin\goodwar01,2014-15,G,41,2,535,79,201,.393,67,160,.419,12,41,.293,61,83,.735,27,47,74,44,18,9,48,55,231,3.2
745,Shane Larkin\larkish01,2017-18,G,54,2,775,84,219,.384,53,133,.398,31,86,.360,32,37,.865,15,77,92,98,29,2,33,58,231,3.4
746,Alex Caruso\carusal01,2018-19,G,25,4,531,77,173,.445,53,123,.431,24,50,.480,51,64,.797,20,47,67,77,24,9,42,54,229,7.3
747,Chandler Hutchison\hutchch01,2018-19,G,44,14,895,96,209,.459,82,159,.516,14,50,.280,23,38,.605,31,154,185,34,23,6,25,59,229,4.2
748,Patrick McCaw\mccawpa01,2017-18,G,57,10,961,92,225,.409,73,145,.503,19,80,.238,26,34,.765,16,66,82,81,43,10,41,67,229,3.1
749,Tyler Ennis\ennisty01,2016-17,G,53,2,588,90,208,.433,63,138,.457,27,70,.386,21,25,.840,9,36,45,86,25,2,45,58,228,2.9
750,Andre Roberson\roberan03,2014-15,G-F,67,65,1286,92,201,.458,71,116,.612,21,85,.247,23,48,.479,60,195,255,70,53,29,46,141,228,3.5
751,Jabari Brown\brownja01,2014-15,G,19,5,568,70,170,.412,47,108,.435,23,62,.371,64,85,.753,3,33,36,40,12,2,32,33,227,7.1
752,Beno Udrih\udrihbe01,2016-17,G,39,0,560,92,197,.467,81,165,.491,11,32,.344,32,34,.941,6,51,57,131,13,0,36,29,227,5.2
753,Ricky Rubio\rubiori01,2014-15,G,22,22,692,78,219,.356,65,168,.387,13,51,.255,57,71,.803,19,106,125,193,38,1,64,59,226,10.4
754,Tyler Ennis\ennisty01,2017-18,G,54,11,683,94,224,.420,80,168,.476,14,56,.250,22,29,.759,19,76,95,105,30,10,38,75,224,3.3
755,Cameron Payne\payneca01,2017-18,G,25,14,582,87,215,.405,52,124,.419,35,91,.385,12,16,.750,18,51,69,113,26,9,36,44,221,7.6
756,Ronnie Price\pricero01,2014-15,G,43,20,982,77,223,.345,46,114,.404,31,109,.284,36,45,.800,19,50,69,165,67,4,52,118,221,4.8
757,Marcus Thornton\thornma01,2016-17,G,33,1,575,84,210,.400,56,130,.431,28,80,.350,23,27,.852,22,54,76,41,19,3,25,48,219,4.3
758,Shabazz Napier\napiesh01,2016-17,G,53,2,512,73,183,.399,39,91,.429,34,92,.370,38,49,.776,8,53,61,67,32,2,41,38,218,3.0
759,Tyrone Wallace\wallaty01,2018-19,G,62,0,628,92,217,.424,88,198,.444,4,19,.211,30,57,.526,20,81,101,42,21,7,36,83,218,1.9
760,Paul Zipser\zipsepa01,2017-18,G-F,54,12,824,81,234,.346,44,124,.355,37,110,.336,19,25,.760,13,118,131,46,20,15,43,86,218,2.1
761,Sterling Brown\brownst02,2017-18,G,54,4,776,82,205,.400,50,114,.439,32,91,.352,21,24,.875,27,116,143,25,31,13,25,80,217,3.0
762,Devonte' Graham\grahade01,2018-19,G,46,3,676,74,216,.343,40,95,.421,34,121,.281,35,46,.761,10,53,63,121,23,2,30,48,217,3.8
763,Rashad Vaughn\vaughra01,2015-16,G,70,6,1001,81,266,.305,38,119,.319,43,147,.293,12,15,.800,11,77,88,39,29,16,28,73,217,1.5
764,Markel Brown\brownma02,2014-15,G,47,29,781,76,210,.362,59,146,.404,17,64,.266,47,57,.825,16,91,107,39,31,12,27,57,216,3.2
765,Ron Baker\bakerro01,2016-17,G,52,13,857,82,217,.378,59,131,.450,23,86,.267,28,43,.651,12,86,98,107,34,8,56,74,215,2.9
766,Dwight Buycks\buyckdw01,2017-18,G,29,0,427,82,198,.414,67,153,.438,15,45,.333,36,41,.878,12,29,41,59,19,2,39,39,215,4.5
767,Grayson Allen\allengr01,2018-19,G,38,2,416,67,178,.376,35,79,.443,32,99,.323,45,60,.750,3,20,23,25,6,6,33,47,211,2.4
768,Jerryd Bayless\bayleje01,2018-19,G,34,6,657,82,230,.357,53,132,.402,29,98,.296,16,28,.571,11,51,62,119,18,2,32,56,209,4.3
769,Tyus Jones\jonesty01,2016-17,G,60,0,774,75,181,.414,49,108,.454,26,73,.356,33,43,.767,10,57,67,156,48,5,38,50,209,3.9
770,Derrick Rose\rosede01,2017-18,G,25,7,419,81,186,.435,74,156,.474,7,30,.233,40,46,.870,13,22,35,37,7,4,35,16,209,4.8
771,C.J. Williams\willicj01,2017-18,G,38,18,707,87,197,.442,65,119,.546,22,78,.282,13,16,.813,12,44,56,43,31,13,20,63,209,4.0
772,Justin Anderson\anderju01,2015-16,G,55,9,647,71,175,.406,49,92,.533,22,83,.265,44,55,.800,18,114,132,29,19,25,24,45,208,3.1
773,Joe Young\youngjo01,2017-18,G,53,1,558,80,186,.430,55,120,.458,25,66,.379,22,29,.759,12,51,63,39,14,1,26,39,207,2.5
774,Tyler Ennis\ennisty01,2015-16,G,46,7,654,84,187,.449,71,148,.480,13,39,.333,25,34,.735,13,62,75,95,25,1,46,64,206,3.3
775,K.J. McDaniels\mcdankj01,2016-17,G-F,49,0,506,77,169,.456,57,103,.553,20,66,.303,32,38,.842,15,67,82,13,19,18,29,49,206,2.8
776,Mike Conley\conlemi01,2017-18,G,12,12,373,64,168,.381,40,91,.440,24,77,.312,53,66,.803,0,27,27,49,12,3,18,24,205,11.4
777,Brian Roberts\roberbr01,2015-16,G,51,0,470,74,165,.448,59,123,.480,15,42,.357,42,47,.894,6,35,41,54,10,2,23,35,205,2.8
778,Hollis Thompson\thompho01,2016-17,G-F,40,9,752,77,200,.385,45,105,.429,32,95,.337,19,29,.655,19,93,112,35,20,6,11,69,205,3.6
779,Beno Udrih\udrihbe01,2015-16,G,44,5,708,86,198,.434,71,154,.461,15,44,.341,18,20,.900,8,64,72,116,14,1,53,51,205,3.3
780,Garrett Temple\templga01,2014-15,G,52,18,735,68,170,.400,35,82,.427,33,88,.375,35,48,.729,24,66,90,56,42,9,34,76,204,3.2
781,Shabazz Napier\napiesh01,2015-16,G,55,0,600,68,201,.338,34,97,.351,34,104,.327,33,45,.733,9,46,55,97,23,1,46,38,203,2.5
782,Glenn Robinson\robingl02,2018-19,G-F,47,18,610,74,176,.420,56,114,.491,18,62,.290,32,40,.800,17,54,71,21,14,8,18,45,198,2.7
783,Brandon Rush\rushbr01,2016-17,G-F,47,33,1030,70,187,.374,26,73,.356,44,114,.386,13,18,.722,16,83,99,45,22,23,28,42,197,3.3
784,Malik Beasley\beaslma01,2017-18,G,62,0,583,73,178,.410,45,96,.469,28,82,.341,22,33,.667,14,57,71,31,15,7,24,36,196,2.0
785,Raul Neto\netora01,2018-19,G,37,1,474,74,161,.460,54,101,.535,20,60,.333,28,33,.848,6,56,62,93,14,4,35,49,196,4.3
786,Kobi Simmons\simmoko01,2017-18,G,32,12,643,80,189,.423,69,150,.460,11,39,.282,25,25,1.000,14,36,50,68,18,5,44,61,196,3.7
787,Frank Mason\masonfr01,2018-19,G,38,0,435,71,169,.420,57,105,.543,14,64,.219,39,57,.684,6,37,43,84,16,4,36,34,195,3.7
788,Andre Roberson\roberan03,2017-18,G-F,39,39,1037,87,162,.537,79,126,.627,8,36,.222,12,38,.316,75,110,185,46,45,35,30,89,194,5.8
789,MarShon Brooks\brookma01,2018-19,G-F,29,0,387,76,169,.450,61,115,.530,15,54,.278,23,33,.697,12,33,45,25,9,4,21,33,190,3.8
790,Hamidou Diallo\diallha01,2018-19,G,51,3,526,75,165,.455,71,141,.504,4,24,.167,36,59,.610,38,59,97,17,21,10,23,77,190,2.5
791,Tyler Johnson\johnsty01,2014-15,G,32,2,603,70,167,.419,52,119,.437,18,48,.375,32,47,.681,14,67,81,42,33,9,30,42,190,4.6
792,Thabo Sefolosha\sefolth01,2018-19,G-F,50,2,609,71,149,.477,37,71,.521,34,78,.436,14,22,.636,8,115,123,27,43,5,25,41,190,3.5
793,Kadeem Allen\allenka01,2018-19,G,19,1,416,65,141,.461,48,105,.457,17,36,.472,42,54,.778,8,43,51,76,16,4,26,46,189,8.3
794,Terrance Ferguson\fergute01,2017-18,G-F,61,12,763,70,169,.414,30,49,.612,40,120,.333,9,10,.900,19,28,47,19,24,10,11,83,189,2.0
795,Gary Harris\harriga01,2014-15,G,55,6,719,66,217,.304,45,114,.395,21,103,.204,35,47,.745,21,43,64,29,39,7,38,71,188,1.5
796,Luke Ridnour\ridnolu01,2014-15,G,47,0,683,75,176,.426,55,113,.487,20,63,.317,18,21,.857,8,60,68,96,20,4,38,67,188,3.0
797,Treveon Graham\grahatr01,2018-19,G,35,21,715,64,191,.335,26,63,.413,38,128,.297,18,22,.818,23,84,107,34,13,7,17,68,184,3.2
798,Semaj Christon\chrisse01,2016-17,G,64,1,973,77,223,.345,65,160,.406,12,63,.190,17,31,.548,19,68,87,130,28,7,43,79,183,2.1
799,Raul Neto\netora01,2017-18,G,41,0,498,69,151,.457,50,104,.481,19,47,.404,26,35,.743,7,42,49,75,13,4,36,38,183,3.3
800,Damyean Dotson\dotsoda01,2017-18,G,44,2,474,72,161,.447,50,93,.538,22,68,.324,16,23,.696,9,75,84,31,12,2,17,34,182,2.9
801,Isaiah Canaan\canaais01,2016-17,G,39,0,592,63,173,.364,38,79,.481,25,94,.266,30,33,.909,6,44,50,37,22,1,21,35,181,2.9
802,Isaiah Canaan\canaais01,2018-19,G,30,16,628,64,164,.390,30,68,.441,34,96,.354,19,24,.792,6,52,58,84,14,2,35,52,181,4.3
803,Nik Stauskas\stausni01,2017-18,G,41,0,523,60,154,.390,20,54,.370,40,100,.400,21,29,.724,4,60,64,39,9,4,26,24,181,2.9
804,Arron Afflalo\afflaar01,2017-18,G-F,53,3,682,65,162,.401,38,92,.413,27,70,.386,22,26,.846,4,62,66,30,4,9,21,56,179,1.9
805,James Anderson\anderja01,2015-16,G-F,51,15,721,67,178,.376,44,92,.478,23,86,.267,22,29,.759,13,73,86,41,21,14,42,54,179,2.1
806,Justin Anderson\anderju01,2018-19,G,48,4,463,64,157,.408,40,80,.500,24,77,.312,26,35,.743,24,60,84,23,22,13,23,48,178,2.7
807,Jimmer Fredette\fredeji01,2014-15,G,50,0,509,63,166,.380,54,118,.458,9,48,.188,43,45,.956,8,32,40,58,15,2,33,43,178,2.2
808,John Jenkins\jenkijo01,2015-16,G,43,3,480,71,160,.444,55,109,.505,16,51,.314,20,24,.833,8,49,57,35,8,1,27,22,178,2.6
809,Phil Pressey\pressph01,2014-15,G,50,0,600,64,174,.368,48,109,.440,16,65,.246,33,49,.673,13,67,80,117,30,6,41,54,177,3.1
810,Troy Daniels\danietr01,2014-15,G,47,0,397,61,165,.370,18,47,.383,43,118,.364,11,13,.846,8,25,33,22,6,1,20,40,176,1.8
811,Tim Frazier\fraziti01,2017-18,G,59,11,838,68,172,.395,51,116,.440,17,56,.304,23,30,.767,18,97,115,194,47,7,57,97,176,3.6
812,Dwayne Bacon\bacondw01,2017-18,G,53,6,713,72,192,.375,61,149,.409,11,43,.256,20,25,.800,4,120,124,38,16,2,23,46,175,2.1
813,Isaiah Canaan\canaais01,2017-18,G,20,1,422,52,137,.380,30,71,.423,22,66,.333,46,51,.902,6,39,45,76,16,1,29,36,172,6.9
814,Jevon Carter\carteje01,2018-19,G,39,3,577,56,185,.303,22,83,.265,34,102,.333,26,32,.813,14,52,66,69,26,11,33,55,172,2.9
815,Jason Richardson\richaja01,2014-15,G,19,15,416,62,178,.348,31,82,.378,31,96,.323,17,22,.773,13,53,66,38,13,3,16,28,172,5.8
816,Glenn Robinson\robingl02,2015-16,G-F,45,4,508,65,151,.430,51,114,.447,14,37,.378,27,39,.692,12,56,68,26,17,9,18,21,171,2.8
817,Allen Crabbe\crabbal01,2014-15,G-F,51,9,683,63,153,.412,33,68,.485,30,85,.353,12,16,.750,7,66,73,39,19,15,15,74,168,2.4
818,Jordan Farmar\farmajo01,2014-15,G,36,0,529,61,158,.386,26,61,.426,35,97,.361,10,11,.909,8,34,42,67,20,5,32,52,167,3.2
819,Kay Felder\feldeka01,2016-17,G,42,0,386,62,158,.392,55,136,.404,7,22,.318,35,49,.714,3,38,41,58,18,7,30,38,166,2.5
820,Jason Terry\terryja01,2017-18,G,51,4,814,59,154,.383,19,39,.487,40,115,.348,8,9,.889,5,43,48,59,42,13,25,52,166,2.8
821,Álex Abrines\abrinal01,2018-19,G-F,31,2,588,56,157,.357,15,30,.500,41,127,.323,12,13,.923,5,43,48,20,17,6,14,53,165,3.0
822,Matthew Dellavedova\dellama01,2017-18,G,38,3,712,55,152,.362,26,74,.351,29,78,.372,25,27,.926,14,50,64,145,14,0,49,67,164,3.8
823,Torrey Craig\craigto01,2017-18,G-F,39,5,629,62,137,.453,45,79,.570,17,58,.293,22,35,.629,40,87,127,25,12,15,20,63,163,3.5
824,Damion Lee\leeda03,2017-18,G,15,11,404,62,152,.408,47,92,.511,15,60,.250,22,29,.759,11,60,71,29,19,1,14,25,161,7.9
825,Jordan McRae\mcraejo01,2016-17,G,37,4,384,58,150,.387,40,99,.404,18,51,.353,27,34,.794,6,35,41,19,8,6,14,31,161,2.4
826,Jordan McRae\mcraejo01,2018-19,G,27,0,333,61,130,.469,51,95,.537,10,35,.286,28,35,.800,6,34,40,30,13,7,15,26,160,4.4
827,Cameron Payne\payneca01,2016-17,G,31,0,462,64,193,.332,37,107,.346,27,86,.314,5,8,.625,3,45,48,55,14,4,29,52,160,2.3
828,Damion Lee\leeda03,2018-19,G,32,0,375,56,127,.441,29,59,.492,27,68,.397,19,22,.864,8,56,64,13,13,0,11,28,158,3.5
829,Tyus Jones\jonesty01,2015-16,G,37,0,573,56,156,.359,40,103,.388,16,53,.302,28,39,.718,7,40,47,108,31,3,33,33,156,3.9
830,Markelle Fultz\fultzma01,2018-19,G,19,15,427,65,155,.419,61,141,.433,4,14,.286,21,37,.568,26,44,70,59,17,5,25,52,155,6.0
831,Tomáš Satoranský\satorto01,2016-17,G,57,3,719,61,147,.415,52,110,.473,9,37,.243,23,33,.697,25,58,83,92,26,6,38,60,154,2.4
832,Joe Young\youngjo01,2015-16,G,41,0,384,62,169,.367,52,123,.423,10,46,.217,20,25,.800,6,44,50,65,15,0,33,30,154,2.2
833,Sergey Karasev\karasse01,2014-15,G-F,33,16,555,54,134,.403,38,80,.475,16,54,.296,29,38,.763,22,44,66,46,23,1,24,45,153,3.6
834,Shaquille Harrison\harrish01,2017-18,G,23,2,384,59,124,.476,53,98,.541,6,26,.231,28,38,.737,9,52,61,55,26,7,22,42,152,6.0
835,Darrun Hilliard\hillida01,2015-16,G,38,2,383,52,131,.397,33,81,.407,19,50,.380,29,40,.725,5,40,45,27,9,1,19,28,152,2.4
836,Danuel House\houseda01,2017-18,G,23,3,403,56,129,.434,41,71,.577,15,58,.259,25,31,.806,13,63,76,25,7,6,11,23,152,5.1
837,DeAndre Liggins\liggide01,2016-17,G,62,19,777,55,142,.387,38,96,.396,17,46,.370,25,40,.625,20,88,108,54,47,14,42,81,152,2.1
838,Antonio Blakeney\blakean01,2017-18,G,19,0,314,53,143,.371,38,91,.418,15,52,.288,30,39,.769,4,29,33,20,7,1,11,19,151,4.4
839,Nicolás Brussino\brussni01,2016-17,G-F,54,2,521,52,141,.369,23,46,.500,29,95,.305,17,22,.773,26,69,95,47,17,8,26,43,150,2.2
840,Delon Wright\wrighde01,2016-17,G,27,0,446,49,116,.422,39,86,.453,10,30,.333,42,55,.764,16,32,48,57,27,11,25,31,150,5.2
841,E'Twaun Moore\mooreet01,2014-15,G-F,56,0,504,62,139,.446,49,101,.485,13,38,.342,12,20,.600,12,34,46,33,20,6,14,45,149,1.9
842,Brandon Paul\paulbr01,2017-18,G,64,2,576,55,127,.433,40,73,.548,15,54,.278,22,43,.512,6,62,68,37,25,7,29,58,147,1.5
843,Erick Green\greener01,2014-15,G,43,1,410,61,162,.377,47,115,.409,14,47,.298,10,12,.833,7,24,31,39,12,0,14,26,146,1.9
844,Spencer Dinwiddie\dinwisp01,2014-15,G,34,1,455,51,169,.302,39,104,.375,12,65,.185,31,34,.912,4,44,48,104,19,6,33,53,145,3.1
845,Pablo Prigioni\prigipa01,2015-16,G,59,3,823,55,147,.374,27,52,.519,28,95,.295,7,8,.875,38,76,114,130,53,1,49,82,145,3.0
846,Andre Miller\millean02,2015-16,G,39,4,461,59,106,.557,57,98,.582,2,8,.250,24,32,.750,12,39,51,87,16,0,37,46,144,3.4
847,Raymond Felton\feltora01,2018-19,G,33,0,379,55,135,.407,35,74,.473,20,61,.328,12,13,.923,4,30,34,52,10,6,14,29,142,3.2
848,Brian Roberts\roberbr01,2016-17,G,41,2,416,46,122,.377,29,78,.372,17,44,.386,33,39,.846,5,34,39,52,9,1,26,18,142,2.4
849,Rashad Vaughn\vaughra01,2016-17,G,41,2,458,57,156,.365,31,75,.413,26,81,.321,2,5,.400,4,45,49,23,19,10,14,32,142,2.1
850,C.J. Watson\watsocj01,2015-16,G,33,2,656,47,137,.343,33,89,.371,14,48,.292,34,39,.872,10,56,66,88,19,5,25,49,142,3.8
851,MarShon Brooks\brookma01,2017-18,G-F,7,1,193,51,102,.500,32,70,.457,19,32,.594,20,23,.870,8,13,21,25,11,3,16,6,141,15.8
852,Reggie Bullock\bullore01,2016-17,G-F,31,5,467,54,128,.422,26,55,.473,28,73,.384,5,7,.714,13,51,64,29,18,3,10,22,141,3.8
853,José Calderón\caldejo01,2016-17,G,41,13,539,55,134,.410,35,70,.500,20,64,.313,11,12,.917,15,59,74,88,11,1,41,36,141,2.8
854,Brad Wanamaker\wanambr01,2018-19,G,36,0,343,50,105,.476,34,66,.515,16,39,.410,24,28,.857,3,38,41,56,12,2,19,34,140,3.3
855,Kirk Hinrich\hinriki01,2015-16,G,46,7,631,49,129,.380,25,67,.373,24,62,.387,15,16,.938,8,62,70,73,15,2,30,64,137,2.2
856,Ray McCallum\mccalra01,2015-16,G,41,6,474,55,146,.377,40,104,.385,15,42,.357,12,15,.800,8,39,47,60,12,7,24,29,137,2.3
857,Chasson Randle\randlch01,2016-17,G,26,0,299,40,98,.408,24,51,.471,16,47,.340,41,43,.953,6,26,32,34,9,2,19,39,137,3.7
858,Isaiah Briscoe\briscis01,2018-19,G,39,0,559,55,138,.399,44,104,.423,11,34,.324,15,26,.577,5,69,74,87,11,2,31,66,136,2.5
859,Joe Harris\harrijo01,2014-15,G,51,1,493,48,120,.400,17,36,.472,31,84,.369,9,15,.600,7,34,41,26,7,2,27,62,136,1.2
860,Courtney Lee\leeco01,2018-19,G,34,6,428,53,129,.411,37,74,.500,16,55,.291,14,21,.667,9,45,54,37,21,3,14,32,136,3.1
861,Ramon Sessions\sessira01,2017-18,G,28,3,392,42,117,.359,34,91,.374,8,26,.308,44,57,.772,6,32,38,77,14,2,30,29,136,3.8
862,John Jenkins\jenkijo01,2014-15,G,24,3,297,49,99,.495,28,47,.596,21,52,.404,16,19,.842,2,37,39,13,10,0,8,15,135,4.2
863,Patrick Beverley\beverpa01,2017-18,G,11,11,334,48,119,.403,24,59,.407,24,60,.400,14,17,.824,16,29,45,32,19,5,25,34,134,8.6
864,Michael Carter-Williams\cartemi01,2018-19,G,28,1,372,46,123,.374,36,85,.424,10,38,.263,32,53,.604,19,51,70,70,20,15,20,48,134,4.5
865,Alex Caruso\carusal01,2017-18,G,37,7,562,50,116,.431,37,73,.507,13,43,.302,21,30,.700,15,50,65,75,23,10,42,52,134,3.1
866,Sebastian Telfair\telfase01,2014-15,G,16,1,327,46,125,.368,28,65,.431,18,60,.300,24,34,.706,2,28,30,45,10,0,18,29,134,5.2
867,Sviatoslav Mykhailiuk\mykhasv01,2018-19,G-F,42,0,440,46,140,.329,17,51,.333,29,89,.326,12,20,.600,9,27,36,37,14,1,21,25,133,1.8
868,A.J. Price\priceaj01,2014-15,G,26,0,324,51,137,.372,36,80,.450,15,57,.263,16,24,.667,6,26,32,46,7,0,14,15,133,3.3
869,Donte DiVincenzo\divindo01,2018-19,G,27,0,411,50,124,.403,28,41,.683,22,83,.265,9,12,.750,16,49,65,31,13,6,19,38,131,3.5
870,Dejounte Murray\murrade01,2016-17,G,38,8,322,50,116,.431,41,93,.441,9,23,.391,21,30,.700,6,36,42,48,8,6,38,29,130,2.0
871,Greivis Vásquez\vasqugr01,2015-16,G,23,0,460,45,138,.326,27,65,.415,18,73,.247,22,26,.846,5,42,47,91,10,0,40,42,130,3.6
872,Darrun Hilliard\hillida01,2016-17,G,39,1,381,47,126,.373,35,80,.438,12,46,.261,21,28,.750,2,31,33,33,11,2,28,39,127,1.5
873,Jordan Hamilton\hamiljo02,2015-16,G-F,11,4,304,49,116,.422,36,71,.507,13,45,.289,14,21,.667,12,50,62,25,8,3,17,24,125,7.7
874,Sasha Vujačić\vujacsa01,2016-17,G,42,4,408,42,136,.309,19,62,.306,23,74,.311,17,24,.708,12,47,59,52,13,2,16,38,124,2.0
875,Lorenzo Brown\brownlo01,2014-15,G,29,7,549,52,122,.426,46,94,.489,6,28,.214,12,19,.632,14,56,70,90,28,6,30,49,122,4.4
876,Reggie Bullock\bullore01,2015-16,G-F,37,0,429,43,98,.439,21,45,.467,22,53,.415,14,15,.933,14,54,68,27,10,2,8,29,122,2.9
877,Lance Stephenson\stephla01,2016-17,G-F,18,0,362,54,120,.450,48,100,.480,6,20,.300,8,13,.615,4,48,52,59,5,3,26,32,122,4.7
878,Tyler Ennis\ennisty01,2014-15,G,33,1,411,52,144,.361,40,101,.396,12,43,.279,5,7,.714,7,28,35,73,18,5,42,36,121,2.1
879,John Jenkins\jenkijo01,2018-19,G,26,0,333,42,105,.400,20,47,.426,22,58,.379,15,18,.833,6,31,37,22,0,2,9,10,121,3.1
880,Jared Cunningham\cunnija01,2015-16,G,44,3,410,36,105,.343,24,66,.364,12,39,.308,36,55,.655,3,35,38,20,14,2,21,41,120,1.3
881,David Nwaba\nwabada01,2016-17,G,20,2,397,47,81,.580,46,76,.605,1,5,.200,25,39,.641,17,46,63,14,13,7,11,36,120,5.2
882,Kendall Marshall\marshke01,2014-15,G,28,3,417,46,101,.455,28,55,.509,18,46,.391,8,9,.889,2,26,28,86,21,0,35,26,118,3.9
883,Toney Douglas\douglto01,2016-17,G,24,0,394,43,117,.368,36,75,.480,7,42,.167,24,29,.828,13,48,61,56,18,5,21,50,117,3.9
884,Dante Exum\exumda01,2017-18,G,14,0,235,42,87,.483,37,69,.536,5,18,.278,25,31,.806,4,22,26,43,8,3,20,20,114,6.4
885,José Calderón\caldejo01,2018-19,G,49,0,632,45,120,.375,31,63,.492,14,57,.246,9,11,.818,11,49,60,115,16,3,35,64,113,2.2
886,Jerome Robinson\robinje01,2018-19,G,33,0,320,44,110,.400,26,53,.491,18,57,.316,6,9,.667,3,38,41,19,11,3,13,46,112,1.8
887,Kendall Marshall\marshke01,2015-16,G,30,6,400,43,118,.364,27,69,.391,16,49,.327,9,13,.692,2,26,28,73,16,2,43,30,111,2.2
888,Jordan Farmar\farmajo01,2015-16,G,12,10,291,42,100,.420,26,55,.473,16,45,.356,10,10,1.000,4,21,25,37,15,2,18,22,110,6.8
889,Archie Goodwin\goodwar01,2016-17,G,15,0,214,36,66,.545,31,51,.608,5,15,.333,33,42,.786,7,21,28,24,4,5,14,8,110,6.2
890,Jaylen Adams\adamsja01,2018-19,G,34,1,428,38,110,.345,13,36,.361,25,74,.338,7,9,.778,11,49,60,65,14,5,28,45,108,2.5
891,Raymond Felton\feltora01,2014-15,G,29,3,281,43,106,.406,33,72,.458,10,34,.294,12,15,.800,2,24,26,41,11,4,18,17,108,2.6
892,Fred VanVleet\vanvlfr01,2016-17,G,37,0,294,39,111,.351,28,82,.341,11,29,.379,18,22,.818,4,38,42,35,16,3,15,36,107,1.9
893,Sonny Weems\weemsso01,2015-16,G-F,43,0,498,42,110,.382,27,69,.391,15,41,.366,8,15,.533,7,46,53,49,10,1,41,47,107,1.1
894,Wade Baldwin\baldwwa01,2016-17,G,33,1,405,36,115,.313,33,93,.355,3,22,.136,31,37,.838,11,35,46,61,18,7,39,40,106,2.0
895,Jonathan Gibson\gibsojo01,2016-17,G,17,0,231,35,95,.368,20,50,.400,15,45,.333,21,29,.724,1,21,22,26,8,0,21,21,106,3.2
896,Martell Webster\webstma02,2014-15,G-F,32,0,352,24,91,.264,14,48,.292,10,43,.233,48,64,.750,10,36,46,17,7,1,22,24,106,1.6
897,James Young\youngja01,2014-15,G-F,31,0,332,36,102,.353,19,36,.528,17,66,.258,16,29,.552,9,33,42,13,8,2,5,22,105,2.1
898,Tony Allen\allento01,2017-18,G-F,22,0,273,44,91,.484,40,79,.506,4,12,.333,11,21,.524,20,27,47,9,11,3,19,49,103,2.5
899,JaKarr Sampson\sampsja02,2017-18,G-F,22,6,344,44,81,.543,39,71,.549,5,10,.500,10,16,.625,21,57,78,9,8,22,8,48,103,4.4
900,Delon Wright\wrighde01,2015-16,G,27,1,229,36,80,.450,31,67,.463,5,13,.385,26,35,.743,8,29,37,31,8,3,16,7,103,3.2
901,Kyle Collinsworth\colliky01,2017-18,G-F,32,2,480,38,99,.384,34,82,.415,4,17,.235,21,40,.525,32,75,107,56,17,9,24,44,101,3.3
902,DeAndre Liggins\liggide01,2017-18,G,58,4,724,40,106,.377,21,53,.396,19,53,.358,2,5,.400,7,68,75,48,37,14,20,81,101,1.6
903,Markelle Fultz\fultzma01,2017-18,G,14,0,253,45,111,.405,45,110,.409,0,1,.000,10,21,.476,11,32,43,53,12,4,17,22,100,5.7
904,Raul Neto\netora01,2016-17,G,40,0,346,41,91,.451,31,60,.517,10,31,.323,8,9,.889,4,26,30,34,21,5,15,48,100,1.9
905,Isaiah Whitehead\whiteis01,2017-18,G,16,0,180,40,86,.465,33,68,.485,7,18,.389,13,19,.684,4,22,26,20,8,2,24,23,100,3.3
906,Jordan McRae\mcraejo01,2015-16,G,22,1,196,34,78,.436,24,56,.429,10,22,.455,21,28,.750,4,16,20,25,3,1,15,17,99,2.8
907,Pat Connaughton\connapa01,2016-17,G,39,1,316,37,72,.514,20,39,.513,17,33,.515,7,9,.778,10,42,52,28,6,2,17,23,98,2.1
908,John Lucas III\lucasjo02,2014-15,G,21,0,272,42,104,.404,33,75,.440,9,29,.310,5,5,1.000,4,12,16,60,8,0,16,18,98,3.6
909,Quincy Pondexter\pondequ01,2018-19,G-F,53,0,292,29,58,.500,23,40,.575,6,18,.333,34,42,.810,8,38,46,24,11,1,13,24,98,1.7
910,R.J. Hunter\hunterj01,2015-16,G,36,0,315,36,98,.367,17,35,.486,19,63,.302,6,7,.857,2,35,37,13,14,4,11,29,97,1.6
911,Sergey Karasev\karasse01,2015-16,G-F,40,5,399,30,74,.405,19,37,.514,11,37,.297,26,28,.929,8,50,58,35,6,2,22,27,97,1.9
912,Isaiah Thomas\thomais02,2018-19,G,12,0,181,34,99,.343,22,56,.393,12,43,.279,17,27,.630,5,8,13,23,5,1,18,17,97,3.4
913,Rodney Purvis\purviro01,2017-18,G,16,2,290,35,107,.327,22,55,.400,13,52,.250,13,15,.867,1,26,27,17,3,3,10,26,96,2.5
914,Cameron Reynolds\reynoca01,2018-19,G,19,0,259,33,78,.423,12,27,.444,21,51,.412,8,9,.889,4,27,31,13,6,2,5,26,95,3.4
915,Glenn Robinson\robingl02,2017-18,G-F,23,1,338,36,85,.424,22,51,.431,14,34,.412,9,11,.818,11,26,37,17,13,1,5,14,95,3.5
916,Jordan Adams\adamsjo01,2014-15,G,30,0,248,35,86,.407,25,61,.410,10,25,.400,14,23,.609,9,19,28,16,16,7,14,24,94,2.2
917,Bryn Forbes\forbebr01,2016-17,G,36,0,285,36,99,.364,19,46,.413,17,53,.321,5,6,.833,2,21,23,23,1,0,11,20,94,1.2
918,Rodney McGruder\mcgruro01,2017-18,G,18,2,299,36,73,.493,21,38,.553,15,35,.429,4,8,.500,11,21,32,17,8,3,4,21,91,4.2
919,Ricky Ledo\ledori01,2014-15,G,17,0,244,32,96,.333,22,69,.319,10,27,.370,16,22,.727,16,20,36,19,6,1,26,21,90,2.1
920,Sheldon Mac\mcclesh01,2016-17,G,30,3,287,30,75,.400,23,45,.511,7,30,.233,23,27,.852,4,30,34,15,8,2,5,17,90,2.3
921,K.J. McDaniels\mcdankj01,2015-16,G-F,37,1,235,29,72,.403,22,47,.468,7,25,.280,24,30,.800,16,26,42,10,7,6,17,30,89,1.5
922,Malachi Richardson\richama01,2017-18,G,26,4,323,30,90,.333,18,50,.360,12,40,.300,17,22,.773,5,29,34,13,10,1,10,27,89,1.8
923,Shake Milton\miltosh01,2018-19,G,20,0,268,34,87,.391,20,43,.465,14,44,.318,5,7,.714,9,26,35,18,8,8,6,29,87,3.1
924,Alan Anderson\anderal01,2016-17,G-F,30,0,308,30,80,.375,16,36,.444,14,44,.318,12,16,.750,3,21,24,11,3,0,7,35,86,1.3
925,Walt Lemon\lemonwa01,2018-19,G,6,3,167,38,87,.437,36,82,.439,2,5,.400,8,11,.727,4,23,27,30,11,1,10,14,86,11.0
926,Lamar Patterson\pattela01,2015-16,G-F,35,0,395,28,80,.350,16,31,.516,12,49,.245,16,22,.727,4,46,50,39,9,2,23,45,84,1.4
927,Malik Beasley\beaslma01,2016-17,G,22,1,165,33,73,.452,24,45,.533,9,28,.321,8,10,.800,5,12,17,11,7,0,8,10,83,2.5
928,Darius Morris\morrida01,2014-15,G,38,0,299,36,106,.340,29,73,.397,7,33,.212,4,9,.444,7,20,27,48,9,0,21,20,83,1.2
929,Deonte Burton\burtode02,2018-19,G,32,0,240,33,82,.402,25,55,.455,8,27,.296,8,12,.667,4,24,28,9,6,8,9,31,82,1.3
930,Jalen Jones\jonesja04,2018-19,G,16,0,214,26,62,.419,16,34,.471,10,28,.357,19,27,.704,11,23,34,7,9,2,8,27,81,3.5
931,Theo Pinson\pinsoth01,2018-19,G,18,0,211,25,73,.342,13,27,.481,12,46,.261,19,22,.864,4,32,36,21,6,0,18,15,81,2.7
932,Bryce Cotton\cottobr01,2014-15,G,15,0,159,29,69,.420,22,49,.449,7,20,.350,15,18,.833,3,15,18,15,4,0,12,6,80,3.3
933,Xavier Munford\munfoxa02,2015-16,G,14,0,244,32,77,.416,23,54,.426,9,23,.391,7,14,.500,3,28,31,22,13,3,15,25,80,3.7
934,JaKarr Sampson\sampsja02,2018-19,G-F,4,0,127,29,54,.537,24,40,.600,5,14,.357,17,21,.810,5,27,32,4,4,3,4,8,80,16.4
935,Quinn Cook\cookqu01,2016-17,G,14,0,187,33,66,.500,22,40,.550,11,26,.423,2,5,.400,1,6,7,26,4,0,13,13,79,3.7
936,Bryce Dejean-Jones\dejeabr01,2015-16,G,14,11,279,28,69,.406,16,37,.432,12,32,.375,11,21,.524,8,40,48,15,10,2,11,17,79,4.3
937,Malachi Richardson\richama01,2016-17,G,22,0,198,28,68,.412,20,40,.500,8,28,.286,15,19,.789,3,20,23,11,5,1,8,23,79,2.1
938,Jamel Artis\artisja01,2017-18,G-F,15,1,279,31,79,.392,23,50,.460,8,29,.276,7,12,.583,4,34,38,18,2,3,8,11,77,3.3
939,Phil Pressey\pressph01,2015-16,G,23,0,283,30,78,.385,26,60,.433,4,18,.222,13,25,.520,3,28,31,75,18,4,33,28,77,3.0
940,Axel Toupane\toupaax01,2015-16,G-F,21,0,305,25,70,.357,12,30,.400,13,40,.325,13,17,.765,8,23,31,15,7,6,6,40,76,2.3
941,Aaron Brooks\brookaa01,2017-18,G,32,1,189,28,69,.406,17,38,.447,11,31,.355,8,11,.727,7,10,17,20,6,0,11,28,75,1.3
942,Ben McLemore\mclembe01,2018-19,G,19,0,158,25,64,.391,8,23,.348,17,41,.415,8,12,.667,3,14,17,4,6,3,5,22,75,2.2
943,Anfernee Simons\simonan01,2018-19,G,20,1,141,28,63,.444,18,34,.529,10,29,.345,9,16,.563,3,10,13,13,1,0,11,9,75,2.0
944,Nick Johnson\johnsni01,2014-15,G,28,0,262,26,75,.347,21,54,.389,5,21,.238,17,25,.680,13,26,39,11,7,3,19,34,74,1.1
945,Jalen Jones\jonesja04,2017-18,G,16,0,181,26,68,.382,16,42,.381,10,26,.385,12,19,.632,13,25,38,4,5,1,7,22,74,2.7
946,Patrick McCaw\mccawpa01,2018-19,G,29,1,397,26,63,.413,17,35,.486,9,28,.321,13,15,.867,7,41,48,29,23,2,17,38,74,2.4
947,J.R. Smith\smithjr01,2018-19,G-F,11,4,222,27,79,.342,15,40,.375,12,39,.308,8,10,.800,0,18,18,21,11,3,11,19,74,3.9
948,Brandon Jennings\jennibr01,2017-18,G,14,0,205,27,72,.375,18,39,.462,9,33,.273,10,10,1.000,5,26,31,44,6,4,18,11,73,4.4
949,Glenn Robinson\robingl02,2014-15,G-F,35,1,261,26,67,.388,21,48,.438,5,19,.263,16,24,.667,15,24,39,11,6,1,11,15,73,1.4
950,Terry Rozier\roziete01,2015-16,G,39,0,311,29,106,.274,23,79,.291,6,27,.222,8,10,.800,24,39,63,37,6,1,19,23,72,1.1
951,Ron Baker\bakerro01,2017-18,G,29,1,385,20,59,.339,9,26,.346,11,33,.333,20,26,.769,5,25,30,47,26,6,18,33,71,2.7
952,Brandon Sampson\sampsbr01,2018-19,G,14,2,214,28,60,.467,17,31,.548,11,29,.379,4,6,.667,3,13,16,10,8,3,12,19,71,3.1
953,Wayne Selden\seldewa01,2016-17,G-F,14,5,236,25,58,.431,18,30,.600,7,28,.250,14,22,.636,1,15,16,13,6,1,12,18,71,2.8
954,C.J. Wilcox\wilcocj01,2015-16,G,23,0,167,26,66,.394,17,43,.395,9,23,.391,9,12,.750,1,11,12,10,10,2,2,15,70,2.1
955,Reggie Bullock\bullore01,2014-15,G-F,36,2,338,24,70,.343,9,24,.375,15,46,.326,6,9,.667,1,49,50,8,10,4,8,19,69,1.3
956,Gary Payton\paytoga02,2017-18,G,23,6,221,30,74,.405,24,49,.490,6,25,.240,3,9,.333,13,31,44,21,7,3,7,30,69,2.2
957,Andrew White\whitean01,2017-18,G,15,0,209,25,73,.342,7,24,.292,18,49,.367,1,4,.250,4,30,34,6,3,1,8,12,69,2.2
958,James Young\youngja01,2016-17,G-F,29,0,220,25,58,.431,13,23,.565,12,35,.343,6,9,.667,6,20,26,4,10,2,4,15,68,1.7
959,Joe Young\youngjo01,2016-17,G,33,0,135,26,72,.361,21,49,.429,5,23,.217,11,15,.733,1,16,17,15,4,0,5,5,68,1.2
960,Tony Wroten\wroteto01,2015-16,G,8,3,144,22,65,.338,19,48,.396,3,17,.176,20,37,.541,2,19,21,20,3,0,29,11,67,1.8
961,Edmond Sumner\sumneed01,2018-19,G,23,2,210,22,64,.344,15,37,.405,7,27,.259,15,24,.625,9,15,24,10,12,5,10,26,66,1.7
962,Alan Anderson\anderal01,2015-16,G-F,13,0,192,21,59,.356,9,22,.409,12,37,.324,11,15,.733,1,26,27,14,4,1,2,25,65,3.2
963,Rashad Vaughn\vaughra01,2017-18,G,28,0,212,23,56,.411,9,19,.474,14,37,.378,4,6,.667,3,18,21,13,5,3,6,15,64,1.6
964,Jarell Eddie\eddieja01,2015-16,G-F,26,0,147,20,65,.308,5,18,.278,15,47,.319,8,8,1.000,2,21,23,5,5,1,1,5,63,1.5
965,Marcelo Huertas\huertma01,2016-17,G,23,1,237,25,68,.368,21,49,.429,4,19,.211,9,17,.529,2,22,24,52,10,2,19,16,63,2.3
966,Davon Reed\reedda01,2017-18,G,21,1,242,22,76,.289,11,38,.289,11,38,.289,8,12,.667,2,37,39,13,10,2,10,17,63,1.6
967,Bobby Brown\brownbo02,2016-17,G,25,0,123,23,60,.383,9,25,.360,14,35,.400,2,2,1.000,0,6,6,14,1,0,5,5,62,1.4
968,Iman Shumpert\shumpim01,2017-18,G,14,6,276,22,58,.379,15,32,.469,7,26,.269,11,15,.733,7,34,41,17,9,4,16,22,62,3.0
969,Sindarius Thornwell\thornsi01,2018-19,G,64,1,313,17,49,.347,14,34,.412,3,15,.200,25,34,.735,5,39,44,18,14,7,20,41,62,0.6
970,Briante Weber\weberbr01,2016-17,G,20,0,205,25,60,.417,24,50,.480,1,10,.100,11,16,.688,8,18,26,21,12,1,8,16,62,2.6
971,Khyri Thomas\thomakh01,2018-19,G,26,0,195,22,69,.319,12,34,.353,10,35,.286,7,11,.636,4,16,20,8,7,5,4,22,61,1.2
972,Aaron Harrison\harriaa01,2017-18,G,9,3,233,19,69,.275,10,26,.385,9,43,.209,13,17,.765,4,20,24,11,9,2,3,27,60,3.4
973,Devyn Marble\marblde01,2015-16,G-F,28,0,249,21,71,.296,13,39,.333,8,32,.250,10,24,.417,6,32,38,12,13,1,7,25,60,1.1
974,Marcus Georges-Hunt\georgma01,2017-18,G,42,0,224,21,48,.438,17,33,.515,4,15,.267,13,21,.619,7,9,16,7,6,0,3,32,59,0.8
975,Nicolás Laprovíttola\laproni01,2016-17,G,18,3,174,20,47,.426,10,20,.500,10,27,.370,9,9,1.000,1,9,10,28,4,1,19,19,59,2.0
976,Spencer Dinwiddie\dinwisp01,2015-16,G,12,0,159,19,54,.352,18,44,.409,1,10,.100,19,33,.576,4,13,17,22,3,0,7,20,58,2.7
977,Ian Clark\clarkia01,2014-15,G,30,0,192,19,55,.345,9,25,.360,10,30,.333,9,9,1.000,4,12,16,12,9,3,9,20,57,1.2
978,Kay Felder\feldeka01,2017-18,G,16,0,140,21,70,.300,17,51,.333,4,19,.211,11,12,.917,3,15,18,20,3,1,16,11,57,1.2
979,Tim Frazier\fraziti01,2014-15,G,11,3,240,21,61,.344,16,44,.364,5,17,.294,10,21,.476,6,22,28,60,8,0,25,26,57,4.0
980,Treveon Graham\grahatr01,2016-17,G,27,1,189,19,40,.475,10,25,.400,9,15,.600,10,15,.667,5,17,22,6,6,1,3,18,57,1.6
981,Daniel Hamilton\hamilda02,2018-19,G-F,19,3,204,23,60,.383,15,37,.405,8,23,.348,3,6,.500,10,37,47,22,6,1,16,19,57,2.1
982,Lorenzo Brown\brownlo01,2018-19,G,26,0,212,23,71,.324,17,43,.395,6,28,.214,3,3,1.000,5,26,31,28,12,5,16,22,55,1.4
983,Andrew Harrison\harrian01,2018-19,G,17,0,186,16,53,.302,11,28,.393,5,25,.200,17,18,.944,6,14,20,24,4,2,12,34,54,1.6
984,John Holland\hollajo02,2017-18,G-F,24,0,174,17,59,.288,6,23,.261,11,36,.306,9,13,.692,6,18,24,5,7,2,8,10,54,1.1
985,Derrick White\whitede01,2017-18,G,17,0,139,16,33,.485,8,20,.400,8,13,.615,14,20,.700,5,21,26,9,4,3,6,8,54,2.8
986,Jorge Gutiérrez\gutiejo01,2014-15,G,20,1,174,22,41,.537,22,38,.579,0,3,.000,9,13,.692,5,20,25,22,6,0,12,25,53,2.0
987,Dwight Buycks\buyckdw01,2014-15,G,6,0,123,18,40,.450,11,29,.379,7,11,.636,9,10,.900,2,10,12,14,3,0,12,3,52,5.8
988,Toney Douglas\douglto01,2014-15,G,12,0,177,19,51,.373,14,33,.424,5,18,.278,8,13,.615,2,20,22,24,11,4,10,20,51,3.4
989,Jodie Meeks\meeksjo01,2018-19,G,8,0,104,21,39,.538,13,21,.619,8,18,.444,1,1,1.000,1,11,12,8,1,1,2,5,51,4.9
990,Bobby Brown\brownbo02,2017-18,G,20,0,115,19,58,.328,8,18,.444,11,40,.275,1,2,.500,0,7,7,11,4,0,9,6,50,1.0
991,Duncan Robinson\robindu01,2018-19,G,15,1,161,18,46,.391,8,11,.727,10,35,.286,4,6,.667,2,17,19,5,5,0,4,11,50,2.1
992,Briante Weber\weberbr01,2017-18,G,18,0,237,19,43,.442,15,32,.469,4,11,.364,8,10,.800,8,27,35,22,18,5,15,28,50,2.8
993,Ryan Arcidiacono\arcidry01,2017-18,G,24,0,304,17,41,.415,8,10,.800,9,31,.290,5,6,.833,1,24,25,35,13,0,13,18,48,2.1
994,Miloš Teodosić\teodomi01,2018-19,G,15,0,150,17,40,.425,7,13,.538,10,27,.370,4,7,.571,3,13,16,32,3,1,21,27,48,1.7
995,Larry Drew\drewla02,2014-15,G,12,1,219,20,58,.345,16,32,.500,4,26,.154,2,3,.667,1,14,15,45,6,0,25,13,46,2.1
996,Josh Magette\magetjo01,2017-18,G,18,0,216,15,46,.326,7,24,.292,8,22,.364,8,8,1.000,2,17,19,57,8,1,9,16,46,3.3
997,Quincy Pondexter\pondequ01,2017-18,G-F,23,1,196,14,49,.286,11,27,.407,3,22,.136,14,17,.824,8,19,27,9,8,2,11,24,45,0.9
998,Lonnie Walker\walkelo01,2018-19,G,17,0,118,16,46,.348,11,33,.333,5,13,.385,8,10,.800,0,17,17,9,7,3,4,7,45,1.9
999,Norris Cole\coleno01,2016-17,G,13,0,125,16,52,.308,13,39,.333,3,13,.231,8,10,.800,0,11,11,14,8,0,7,18,43,1.5
1000,John Salmons\salmojo01,2014-15,G,21,0,270,16,48,.333,8,22,.364,8,26,.308,2,4,.500,4,17,21,13,9,4,5,25,42,1.3
1001,Nate Wolters\woltena01,2014-15,G,21,0,247,20,57,.351,20,50,.400,0,7,.000,2,6,.333,8,26,34,21,8,2,13,18,42,1.2
1002,Jannero Pargo\pargoja01,2014-15,G,9,0,73,15,35,.429,6,13,.462,9,22,.409,2,2,1.000,0,3,3,8,0,0,3,8,41,2.5
1003,C.J. Wilcox\wilcocj01,2014-15,G,21,0,101,16,38,.421,9,19,.474,7,19,.368,2,2,1.000,1,6,7,8,3,1,10,7,41,0.9
1004,Jacob Evans\evansja02,2018-19,G-F,30,1,204,18,53,.340,14,38,.368,4,15,.267,0,1,.000,6,19,25,23,5,3,11,28,40,0.7
1005,Zhaire Smith\smithzh01,2018-19,G,6,2,111,14,34,.412,8,18,.444,6,16,.375,6,8,.750,3,10,13,10,2,2,6,8,40,4.6
1006,Gary Trent\trentga02,2018-19,G,15,1,111,16,50,.320,11,29,.379,5,21,.238,3,7,.429,1,10,11,5,1,2,4,4,40,0.9
1007,Jabari Bird\birdja01,2017-18,G,13,1,115,15,26,.577,12,19,.632,3,7,.429,6,13,.462,6,13,19,8,3,1,8,7,39,2.4
1008,C.J. Williams\willicj01,2018-19,G,15,0,128,17,35,.486,12,19,.632,5,16,.313,0,1,.000,1,7,8,12,6,0,5,16,39,1.8
1009,Wade Baldwin\baldwwa01,2017-18,G,7,0,80,14,21,.667,10,16,.625,4,5,.800,6,10,.600,1,7,8,5,2,1,4,12,38,3.9
1010,Jordan Hamilton\hamiljo02,2014-15,G-F,14,2,122,14,35,.400,4,14,.286,10,21,.476,0,0,,2,14,16,7,2,0,4,14,38,1.6
1011,Rawle Alkins\alkinra01,2018-19,G,10,1,120,13,39,.333,10,27,.370,3,12,.250,8,12,.667,11,15,26,13,1,0,8,7,37,2.5
1012,Devyn Marble\marblde01,2014-15,G-F,16,7,208,14,44,.318,10,22,.455,4,22,.182,5,16,.313,5,26,31,17,9,2,9,14,37,1.7
1013,Elliot Williams\williel01,2014-15,G,13,0,119,14,37,.378,6,19,.316,8,18,.444,1,4,.250,0,8,8,12,4,0,4,12,37,1.7
1014,Pat Connaughton\connapa01,2015-16,G,34,0,143,13,49,.265,8,28,.286,5,21,.238,5,5,1.000,11,21,32,10,2,0,10,6,36,0.5
1015,Elijah Millsap\millsel01,2015-16,G-F,20,0,173,11,39,.282,10,27,.370,1,12,.083,13,18,.722,6,29,35,19,7,3,9,33,36,1.2
1016,Jared Cunningham\cunnija01,2014-15,G,19,0,89,12,33,.364,8,20,.400,4,13,.308,7,13,.538,1,8,9,10,3,0,7,12,35,0.8
1017,Pierre Jackson\jackspi01,2016-17,G,8,1,84,13,39,.333,10,28,.357,3,11,.273,6,7,.857,1,8,9,19,2,0,3,5,35,3.2
1018,Dairis Bertāns\bertada02,2018-19,G,12,0,167,12,47,.255,2,13,.154,10,34,.294,0,0,,2,7,9,10,1,0,2,7,34,1.1
1019,Milton Doyle\doylemi01,2017-18,G,10,0,125,13,47,.277,9,24,.375,4,23,.174,4,8,.500,3,15,18,10,6,2,2,13,34,1.9
1020,Jonathan Gibson\gibsojo01,2017-18,G,4,0,40,14,23,.609,8,11,.727,6,12,.500,0,0,,0,3,3,4,0,0,3,5,34,5.6
1021,Jerryd Bayless\bayleje01,2016-17,G,3,1,71,11,32,.344,9,27,.333,2,5,.400,9,10,.900,3,9,12,13,0,0,9,4,33,6.0
1022,Jordan Crawford\crawfjo02,2017-18,G,5,0,53,12,27,.444,4,13,.308,8,14,.571,1,1,1.000,2,2,4,13,1,1,5,7,33,4.8
1023,Lorenzo Brown\brownlo01,2017-18,G,14,0,139,14,34,.412,12,22,.545,2,12,.167,2,2,1.000,1,14,15,13,5,0,3,7,32,1.9
1024,Josh Gray\grayjo01,2017-18,G,5,0,86,11,41,.268,8,28,.286,3,13,.231,7,11,.636,2,8,10,12,8,2,7,8,32,3.5
1025,Tim Quarterman\quartti01,2016-17,G,16,0,80,13,29,.448,8,16,.500,5,13,.385,0,3,.000,4,10,14,11,2,3,11,6,31,1.2
1026,Jared Terrell\terreja01,2018-19,G,14,0,111,12,39,.308,8,22,.364,4,17,.235,3,6,.500,1,5,6,12,3,2,10,16,31,0.4
1027,Briante Weber\weberbr01,2015-16,G,7,4,169,14,39,.359,14,34,.412,0,5,.000,3,4,.750,8,17,25,21,9,3,9,12,31,4.5
1028,Wade Baldwin\baldwwa01,2018-19,G,16,0,94,10,33,.303,8,24,.333,2,9,.222,8,11,.727,2,13,15,12,1,2,14,11,30,0.5
1029,Malachi Richardson\richama01,2018-19,G,22,0,103,9,29,.310,1,4,.250,8,25,.320,4,5,.800,2,11,13,0,1,0,8,13,30,0.2
1030,Brandon Rush\rushbr01,2014-15,G-F,33,0,271,11,54,.204,8,27,.296,3,27,.111,5,11,.455,4,37,41,12,5,12,11,27,30,0.2
1031,Russ Smith\smithru01,2014-15,G,12,0,65,8,25,.320,6,14,.429,2,11,.182,12,13,.923,1,5,6,8,3,0,12,13,30,0.7
1032,Jordan Loyd\loydjo01,2018-19,G,12,0,55,8,18,.444,4,10,.400,4,8,.500,9,11,.818,1,8,9,6,0,0,2,5,29,1.8
1033,Daryl Macon\maconda01,2018-19,G,8,0,90,10,27,.370,5,16,.313,5,11,.455,4,7,.571,2,10,12,7,1,0,6,8,29,1.8
1034,Xavier Rathan-Mayes\rathaxa01,2017-18,G,5,0,118,12,42,.286,11,28,.393,1,14,.071,4,9,.444,0,5,5,18,6,3,11,18,29,1.3
1035,Derrick Walton\waltode01,2017-18,G,16,0,147,8,25,.320,1,8,.125,7,17,.412,6,6,1.000,2,14,16,16,7,3,2,7,29,2.2
1036,James Young\youngja01,2015-16,G-F,29,0,199,11,36,.306,5,10,.500,6,26,.231,1,4,.250,4,22,26,9,6,1,5,17,29,0.6
1037,Zoran Dragić\dragizo01,2014-15,G-F,16,1,75,11,30,.367,8,16,.500,3,14,.214,3,5,.600,5,3,8,5,2,0,5,6,28,0.8
1038,Jaylen Morris\morrija01,2017-18,G,6,0,98,13,32,.406,11,22,.500,2,10,.200,0,0,,2,14,16,7,2,1,6,2,28,2.9
1039,Billy Garrett\garrebi01,2018-19,G,4,0,63,11,27,.407,11,19,.579,0,8,.000,4,4,1.000,0,3,3,7,1,1,2,3,26,4.0
1040,Orlando Johnson\johnsor01,2015-16,G,7,1,102,9,34,.265,7,24,.292,2,10,.200,6,8,.750,4,11,15,2,3,3,4,9,26,1.4
1041,Jarell Eddie\eddieja01,2016-17,G-F,5,0,62,6,19,.316,2,3,.667,4,16,.250,8,9,.889,1,6,7,0,1,0,1,1,24,3.0
1042,Andre Ingram\ingraan01,2017-18,G,2,0,64,8,17,.471,3,8,.375,5,9,.556,3,3,1.000,1,5,6,7,3,3,3,3,24,11.7
1043,Antonius Cleveland\clevean01,2017-18,G,17,0,123,8,21,.381,5,17,.294,3,4,.750,4,6,.667,3,11,14,2,7,5,7,23,23,0.7
1044,Brandon Goodwin\goodwbr01,2018-19,G,16,0,57,6,23,.261,4,17,.235,2,6,.333,9,11,.818,1,2,3,14,0,0,3,7,23,0.9
1045,B.J. Johnson\johnsbj01,2018-19,G,7,0,49,9,18,.500,6,11,.545,3,7,.429,2,2,1.000,2,6,8,0,2,0,2,4,23,2.2
1046,Furkan Korkmaz\korkmfu01,2017-18,G,14,0,80,8,28,.286,3,11,.273,5,17,.294,2,4,.500,2,9,11,4,2,1,2,12,23,0.6
1047,Russ Smith\smithru01,2015-16,G,15,0,66,7,22,.318,6,17,.353,1,5,.200,8,13,.615,1,8,9,11,5,1,7,5,23,1.1
1048,Vander Blue\blueva01,2014-15,G,2,1,74,9,30,.300,7,20,.350,2,10,.200,2,5,.400,2,7,9,8,3,0,6,4,22,4.0
1049,Will Bynum\bynumwi01,2014-15,G,7,0,67,10,31,.323,10,22,.455,0,9,.000,2,4,.500,2,4,6,18,1,1,8,9,22,1.3
1050,Jimmer Fredette\fredeji01,2018-19,G,6,0,65,8,29,.276,8,16,.500,0,13,.000,6,6,1.000,1,6,7,8,3,0,5,5,22,1.5
1051,Andrew Goudelock\goudean01,2015-16,G,8,0,50,9,20,.450,8,11,.727,1,9,.111,3,4,.750,1,1,2,4,6,2,7,4,22,1.7
1052,Jorge Gutiérrez\gutiejo01,2015-16,G,12,0,63,6,11,.545,6,9,.667,0,2,.000,10,11,.909,0,7,7,17,3,0,6,3,22,2.2
1053,Demetrius Jackson\jacksde01,2018-19,G,6,0,39,8,15,.533,6,9,.667,2,6,.333,4,4,1.000,2,1,3,5,2,0,1,4,22,3.2
1054,Sean Kilpatrick\kilpase01,2014-15,G,4,0,72,7,20,.350,3,7,.429,4,13,.308,4,4,1.000,1,5,6,4,3,0,2,3,22,3.9
1055,Jodie Meeks\meeksjo01,2015-16,G,3,0,43,7,20,.350,3,11,.273,4,9,.444,4,4,1.000,1,4,5,3,0,0,1,2,22,4.3
1056,Mitch Creek\creekmi01,2018-19,G,5,0,47,8,16,.500,8,14,.571,0,2,.000,5,7,.714,6,6,12,6,2,0,1,3,21,4.4
1057,Dahntay Jones\jonesda02,2014-15,G-F,33,0,123,6,21,.286,6,17,.353,0,4,.000,9,11,.818,1,10,11,2,3,0,1,23,21,0.2
1058,C.J. Wilcox\wilcocj01,2016-17,G,22,0,108,8,31,.258,5,16,.313,3,15,.200,2,2,1.000,4,8,12,12,2,1,6,8,21,0.4
1059,Lorenzo Brown\brownlo01,2015-16,G,8,0,61,8,25,.320,7,17,.412,1,8,.125,3,4,.750,0,7,7,11,3,1,9,4,20,1.0
1060,Shannon Brown\brownsh01,2014-15,G,5,2,89,7,19,.368,4,12,.333,3,7,.429,3,4,.750,0,1,1,3,4,0,4,8,20,1.7
1061,Gian Clavell\clavegi01,2017-18,G,7,0,64,6,18,.333,0,3,.000,6,15,.400,2,2,1.000,1,6,7,3,2,0,2,8,20,1.6
1062,Xavier Henry\henryxa01,2014-15,G,9,0,86,3,13,.231,3,13,.231,0,0,,14,24,.583,2,2,4,3,3,0,3,6,20,1.1
1063,Gary Payton\paytoga02,2016-17,G,6,0,99,8,22,.364,7,13,.538,1,9,.111,3,5,.600,0,12,12,13,3,4,10,9,20,2.0
1064,Kadeem Allen\allenka01,2017-18,G,18,1,107,6,22,.273,6,11,.545,0,11,.000,7,9,.778,4,7,11,12,3,2,9,15,19,0.4
1065,Isaac Bonga\bongais01,2018-19,G,22,0,120,5,33,.152,5,25,.200,0,8,.000,9,15,.600,9,16,25,15,9,4,6,9,19,0.9
1066,Chris Douglas-Roberts\douglch01,2014-15,G,12,0,103,5,21,.238,4,14,.286,1,7,.143,8,8,1.000,1,11,12,4,1,0,0,14,19,0.7
1067,PJ Dozier\doziepj01,2018-19,G,6,0,51,8,21,.381,6,13,.462,2,8,.250,1,2,.500,6,11,17,5,2,0,0,2,19,3.2
1068,R.J. Hunter\hunterj01,2017-18,G,5,1,45,7,20,.350,4,6,.667,3,14,.214,2,2,1.000,0,5,5,3,3,0,2,7,19,1.9
1069,Džanan Musa\musadz01,2018-19,G-F,9,0,39,9,22,.409,8,12,.667,1,10,.100,0,2,.000,1,4,5,2,2,0,4,1,19,0.8
1070,Julyan Stone\stoneju01,2017-18,G,23,0,175,6,13,.462,0,0,,6,13,.462,1,2,.500,1,28,29,26,4,2,7,21,19,1.3
1071,Aaron Harrison\harriaa01,2015-16,G,21,0,93,5,19,.263,2,9,.222,3,10,.300,5,12,.417,4,11,15,2,6,0,4,10,18,0.4
1072,Lester Hudson\hudsole01,2014-15,G,5,0,56,6,14,.429,3,8,.375,3,6,.500,3,4,.750,1,7,8,5,6,1,3,4,18,3.7
1073,Jeremy Lin\linje01,2017-18,G,1,1,25,5,12,.417,4,10,.400,1,2,.500,7,7,1.000,0,0,0,4,0,0,3,3,18,10.2
1074,Larry Drew\drewla02,2017-18,G,10,0,70,7,24,.292,4,15,.267,3,9,.333,0,0,,3,0,3,10,0,0,3,6,17,0.7
1075,R.J. Hunter\hunterj01,2018-19,G,1,0,26,6,13,.462,2,3,.667,4,10,.400,1,2,.500,1,2,3,3,1,0,0,3,17,13.1
1076,Walt Lemon\lemonwa01,2017-18,G,5,0,35,7,16,.438,6,15,.400,1,1,1.000,2,3,.667,0,2,2,5,0,1,4,5,17,1.4
1077,James Young\youngja01,2017-18,G-F,6,0,61,5,14,.357,2,4,.500,3,10,.300,4,6,.667,0,2,2,2,0,0,1,4,17,1.3
1078,Darrun Hilliard\hillida01,2017-18,G,14,0,95,5,19,.263,5,13,.385,0,6,.000,6,7,.857,0,7,7,11,2,0,4,7,16,0.7
1079,Demetrius Jackson\jacksde01,2017-18,G,15,0,80,7,18,.389,6,11,.545,1,7,.143,1,2,.500,5,7,12,9,5,1,10,7,16,0.7
1080,Naz Mitrou-Long\mitrona01,2018-19,G,14,0,84,6,20,.300,4,9,.444,2,11,.182,2,2,1.000,1,5,6,15,1,1,8,10,16,0.5
1081,Will Cherry\cherrwi01,2014-15,G,8,0,69,5,19,.263,3,10,.300,2,9,.222,3,6,.500,1,4,5,8,6,1,4,10,15,1.1
1082,Melvin Frazier\frazime01,2018-19,G,10,0,44,7,21,.333,7,15,.467,0,6,.000,1,4,.250,3,2,5,1,1,0,1,6,15,0.3
1083,Ron Baker\bakerro01,2018-19,G,15,0,152,4,20,.200,3,7,.429,1,13,.077,5,6,.833,1,10,11,15,6,1,5,18,14,0.7
1084,Marcus Georges-Hunt\georgma01,2016-17,G,5,0,48,2,7,.286,1,5,.200,1,2,.500,9,10,.900,1,8,9,3,1,0,2,5,14,2.3
1085,Luis Montero\montelu01,2015-16,G,12,0,42,5,19,.263,4,10,.400,1,9,.111,3,4,.750,0,4,4,1,0,0,4,1,14,0.0
1086,Ronnie Price\pricero01,2016-17,G,14,0,134,4,24,.167,1,7,.143,3,17,.176,3,4,.750,3,8,11,18,11,1,3,14,14,1.3
1087,Erick Green\greener01,2015-16,G,9,0,42,5,13,.385,4,8,.500,1,5,.200,2,2,1.000,3,3,6,3,1,0,0,4,13,1.2
1088,Dahntay Jones\jonesda02,2015-16,G-F,1,0,42,6,14,.429,5,12,.417,1,2,.500,0,0,,1,4,5,2,1,2,0,6,13,8.9
1089,Jordan Farmar\farmajo01,2016-17,G,2,0,35,4,12,.333,0,3,.000,4,9,.444,0,0,,1,2,3,9,2,0,3,1,12,5.7
1090,Daniel Hamilton\hamilda02,2017-18,G-F,6,0,28,5,11,.455,3,6,.500,2,5,.400,0,0,,0,5,5,8,1,0,2,2,12,1.9
1091,Marcus Paige\paigema01,2017-18,G,5,0,28,4,14,.286,2,6,.333,2,8,.250,2,2,1.000,0,4,4,3,0,0,0,0,12,1.4
1092,Davon Reed\reedda01,2018-19,G,10,0,47,5,12,.417,3,8,.375,2,4,.500,0,0,,2,4,6,3,1,0,1,3,12,0.9
1093,Alonzo Gee\geeal01,2016-17,G,13,0,89,3,14,.214,3,11,.273,0,3,.000,5,9,.556,4,11,15,6,5,1,4,14,11,0.6
1094,Gary Payton\paytoga02,2018-19,G,3,0,16,5,8,.625,4,6,.667,1,2,.500,0,0,,1,1,2,4,3,1,1,2,11,4.4
1095,Glen Rice\ricegl02,2014-15,G,5,0,43,3,15,.200,2,8,.250,1,7,.143,4,6,.667,2,2,4,2,0,0,2,11,11,-0.4
1096,Marquis Teague\teaguma01,2017-18,G,3,0,74,4,16,.250,3,12,.250,1,4,.250,2,5,.400,1,5,6,13,4,0,3,5,11,3.5
1097,Axel Toupane\toupaax01,2016-17,G-F,4,0,47,5,9,.556,4,5,.800,1,4,.250,0,0,,0,1,1,0,1,1,0,6,11,1.6
1098,Troy Caupain\caupatr01,2018-19,G,4,0,16,4,8,.500,2,5,.400,2,3,.667,0,0,,1,2,3,4,1,0,0,0,10,2.8
1099,Demetrius Jackson\jacksde01,2016-17,G,5,0,17,3,4,.750,2,3,.667,1,1,1.000,3,6,.500,2,2,4,3,0,0,0,0,10,2.3
1100,Scott Machado\machasc01,2018-19,G,4,0,19,4,6,.667,3,5,.600,1,1,1.000,1,1,1.000,0,0,0,3,1,0,0,2,10,2.4
1101,Jaylen Morris\morrija01,2018-19,G,4,0,29,4,10,.400,3,7,.429,1,3,.333,1,2,.500,0,5,5,4,2,0,1,1,10,2.3
1102,Monte Morris\morrimo01,2017-18,G,3,0,25,4,6,.667,4,5,.800,0,1,.000,2,2,1.000,0,2,2,7,3,0,1,1,10,4.8
1103,David Stockton\stockda01,2017-18,G,3,0,9,2,3,.667,0,0,,2,3,.667,4,4,1.000,0,0,0,0,0,0,1,3,10,2.2
1104,Jimmer Fredette\fredeji01,2015-16,G,6,0,18,2,5,.400,1,3,.333,1,2,.500,4,5,.800,0,0,0,1,1,0,2,2,9,0.8
1105,Dahntay Jones\jonesda02,2016-17,G-F,1,0,12,3,8,.375,3,6,.500,0,2,.000,3,4,.750,1,1,2,1,0,0,1,1,9,4.5
1106,Jerel McNeal\mcneaje01,2014-15,G,6,0,36,3,11,.273,2,9,.222,1,2,.500,2,2,1.000,0,3,3,2,3,1,5,5,9,0.3
1107,Lamar Patterson\pattela01,2016-17,G-F,5,0,40,3,15,.200,2,9,.222,1,6,.167,2,3,.667,1,6,7,6,1,0,4,6,9,0.1
1108,Nick Young\youngni01,2018-19,G-F,4,0,37,3,9,.333,0,1,.000,3,8,.375,0,0,,0,1,1,2,0,1,2,4,9,0.7
1109,Bryce Cotton\cottobr01,2015-16,G,8,0,39,4,10,.400,4,7,.571,0,3,.000,0,0,,0,0,0,3,3,0,5,2,8,0.2
1110,Dusty Hannahs\hannadu01,2018-19,G,2,0,26,3,12,.250,3,7,.429,0,5,.000,2,2,1.000,0,1,1,5,1,0,1,1,8,2.1
1111,Manny Harris\harrima01,2016-17,G,4,0,25,3,15,.200,3,13,.231,0,2,.000,2,4,.500,3,6,9,2,0,0,2,1,8,0.2
1112,Aaron Jackson\jacksaa01,2017-18,G,1,0,35,3,9,.333,2,5,.400,1,4,.250,1,2,.500,2,1,3,1,0,0,1,4,8,2.3
1113,David Stockton\stockda01,2014-15,G,3,0,33,2,6,.333,1,4,.250,1,2,.500,3,6,.500,0,2,2,9,2,0,4,1,8,2.6
1114,Elliot Williams\williel01,2015-16,G,5,0,45,2,10,.200,1,6,.167,1,4,.250,3,4,.750,1,3,4,4,0,0,1,2,8,0.8
1115,Jordan Adams\adamsjo01,2015-16,G,2,0,15,2,6,.333,2,5,.400,0,1,.000,3,5,.600,0,2,2,3,3,0,2,2,7,2.9
1116,DeVaughn Akoon-Purcell\akoonde01,2018-19,G,7,0,22,3,10,.300,3,6,.500,0,4,.000,1,2,.500,1,3,4,6,2,0,2,4,7,0.7
1117,John Jenkins\jenkijo01,2016-17,G,4,0,13,2,5,.400,1,3,.333,1,2,.500,2,2,1.000,0,1,1,1,0,0,0,0,7,1.3
1118,London Perrantes\perralo01,2017-18,G,14,0,66,2,13,.154,2,10,.200,0,3,.000,3,5,.600,1,3,4,5,2,1,1,6,7,0.2
1119,Greivis Vásquez\vasqugr01,2016-17,G,3,0,39,2,8,.250,1,5,.200,1,3,.333,2,3,.667,0,2,2,5,1,1,1,6,7,1.4
1120,Keith Appling\applike01,2015-16,G,5,0,27,2,8,.250,2,5,.400,0,3,.000,2,2,1.000,0,1,1,1,1,0,3,5,6,-0.4
1121,Chris Chiozza\chiozch01,2018-19,G,7,0,33,2,8,.250,0,3,.000,2,5,.400,0,0,,1,3,4,4,1,1,1,2,6,0.8
1122,Patrick Christopher\chrispa01,2014-15,G-F,4,1,29,3,12,.250,3,8,.375,0,4,.000,0,0,,2,4,6,0,1,0,1,6,6,-0.3
1123,Charles Cooke\cookech01,2017-18,G,13,0,38,2,14,.143,1,6,.167,1,8,.125,1,2,.500,0,2,2,1,1,0,1,0,6,-0.2
1124,Jawun Evans\evansja01,2018-19,G,8,0,64,3,14,.214,3,11,.273,0,3,.000,0,0,,1,11,12,10,3,0,6,8,6,0.3
1125,Jarrett Jack\jackja01,2016-17,G,2,0,33,2,3,.667,2,2,1.000,0,1,.000,2,2,1.000,0,0,0,5,2,0,3,4,6,2.8
1126,J.P. Macura\macurjp01,2018-19,G,2,0,17,3,9,.333,3,5,.600,0,4,.000,0,0,,0,3,3,2,0,0,0,0,6,1.6
1127,Gal Mekel\mekelga01,2014-15,G,4,0,43,3,20,.150,3,17,.176,0,3,.000,0,0,,0,1,1,13,2,0,2,1,6,0.6
1128,Toure' Murry\murryto01,2014-15,G-F,5,0,18,2,5,.400,2,5,.400,0,0,,2,2,1.000,1,0,1,1,1,0,4,2,6,0.2
1129,Markel Brown\brownma02,2017-18,G,4,0,31,2,7,.286,1,2,.500,1,5,.200,0,0,,1,4,5,2,0,0,2,6,5,-0.1
1130,Trevon Duval\duvaltr01,2018-19,G,3,0,6,2,3,.667,1,2,.500,1,1,1.000,0,0,,0,1,1,2,0,0,0,0,5,1.8
1131,Matt Williams\willima05,2017-18,G,3,0,11,2,6,.333,1,1,1.000,1,5,.200,0,0,,0,1,1,0,0,0,1,1,5,0.2
1132,Michael Gbinije\gbinimi01,2016-17,G,9,0,32,1,10,.100,1,6,.167,0,4,.000,2,2,1.000,2,1,3,2,0,0,0,2,4,0.0
1133,Tahjere McCall\mccalta01,2018-19,G,1,0,8,2,3,.667,2,2,1.000,0,1,.000,0,1,.000,0,1,1,0,0,0,0,2,4,1.8
1134,Gary Neal\nealga01,2016-17,G,2,0,18,0,7,.000,0,5,.000,0,2,.000,4,4,1.000,0,1,1,1,0,0,0,1,4,-0.2
1135,Tim Quarterman\quartti01,2017-18,G,3,0,13,1,3,.333,1,1,1.000,0,2,.000,2,2,1.000,0,3,3,1,0,0,2,1,4,0.5
1136,Vander Blue\blueva01,2017-18,G,5,0,45,1,5,.200,1,3,.333,0,2,.000,1,2,.500,0,1,1,3,1,0,3,2,3,-0.2
1137,Andre Dawkins\dawkian01,2014-15,G,4,0,22,1,6,.167,0,0,,1,6,.167,0,0,,0,2,2,1,0,0,1,3,3,-0.4
1138,Jamaal Franklin\frankja01,2014-15,G,3,0,13,1,2,.500,0,0,,1,2,.500,0,0,,1,1,2,3,0,1,3,4,3,0.4
1139,Joe Harris\harrijo01,2015-16,G,5,0,15,1,4,.250,0,0,,1,4,.250,0,0,,0,3,3,2,0,0,1,1,3,0.3
1140,Reggie Hearn\hearnre01,2017-18,G,3,0,7,1,2,.500,0,0,,1,2,.500,0,0,,0,0,0,0,0,0,0,0,3,0.7
1141,Elijah Millsap\millsel01,2016-17,G-F,2,0,23,1,7,.143,1,5,.200,0,2,.000,1,2,.500,3,3,6,1,0,0,2,2,3,-0.5
1142,Naz Mitrou-Long\mitrona01,2017-18,G,1,0,1,1,1,1.000,0,0,,1,1,1.000,0,0,,0,0,0,0,0,0,0,0,3,2.7
1143,Xavier Munford\munfoxa02,2017-18,G,6,0,21,1,6,.167,1,4,.250,0,2,.000,1,2,.500,1,0,1,4,1,0,2,4,3,-0.1
1144,Jordan Sibert\siberjo01,2018-19,G,1,0,4,1,1,1.000,0,0,,1,1,1.000,0,0,,0,0,0,0,0,0,0,0,3,2.7
1145,Isaiah Taylor\taylois01,2016-17,G,4,0,52,1,7,.143,1,5,.200,0,2,.000,1,2,.500,1,2,3,3,1,1,0,6,3,0.2
1146,Joe Chealey\chealjo01,2018-19,G,1,0,8,1,3,.333,1,3,.333,0,0,,0,0,,0,0,0,1,0,0,0,1,2,0.6
1147,PJ Dozier\doziepj01,2017-18,G,2,0,3,1,2,.500,1,2,.500,0,0,,0,0,,0,1,1,0,0,0,1,1,2,-0.1
1148,John Lucas III\lucasjo02,2016-17,G,5,0,11,1,4,.250,1,3,.333,0,1,.000,0,0,,0,0,0,1,2,0,0,0,2,0.5
1149,Kalin Lucas\lucaska01,2018-19,G,1,0,6,0,1,.000,0,0,,0,1,.000,2,2,1.000,0,3,3,1,0,0,0,1,2,2.5
1150,Jacob Pullen\pulleja01,2017-18,G,3,0,6,1,2,.500,1,1,1.000,0,1,.000,0,0,,0,0,0,0,0,0,1,0,2,0.0
1151,D.J. Stephens\stephdj01,2018-19,G-F,1,0,7,1,2,.500,1,2,.500,0,0,,0,0,,0,0,0,0,1,0,1,0,2,1.0
1152,Edmond Sumner\sumneed01,2017-18,G,1,0,2,1,1,1.000,1,1,1.000,0,0,,0,0,,0,1,1,0,0,0,0,1,2,1.6
1153,Nate Wolters\woltena01,2017-18,G,5,0,19,1,6,.167,1,6,.167,0,0,,0,0,,1,1,2,1,0,0,0,1,2,-0.1
1154,Aaron Harrison\harriaa01,2016-17,G,5,0,17,0,4,.000,0,2,.000,0,2,.000,1,2,.500,0,3,3,3,0,0,0,2,1,0.0
1155,Scotty Hopson\hopsosc01,2017-18,G,1,0,8,0,1,.000,0,1,.000,0,0,,1,2,.500,0,0,0,1,0,0,1,0,1,-0.4
1156,Nicolás Brussino\brussni01,2017-18,G-F,4,0,10,0,2,.000,0,0,,0,2,.000,0,0,,0,3,3,0,0,0,0,0,0,-0.1
1157,Seth Curry\curryse01,2014-15,G,2,0,8,0,3,.000,0,2,.000,0,1,.000,0,0,,0,2,2,1,0,0,0,2,0,-0.8
1158,Jarell Eddie\eddieja01,2017-18,G-F,3,0,9,0,2,.000,0,0,,0,2,.000,0,0,,0,1,1,0,1,0,0,0,0,0.0
1159,Patricio Garino\garinpa01,2016-17,G-F,5,0,43,0,7,.000,0,2,.000,0,5,.000,0,0,,1,6,7,0,0,0,3,4,0,-1.4
1160,John Holland\hollajo02,2018-19,G-F,1,0,1,0,0,,0,0,,0,0,,0,0,,0,0,0,0,0,0,0,0,0,0.0
1161,Danuel House\houseda01,2016-17,G,1,0,1,0,0,,0,0,,0,0,,0,0,,0,1,1,0,0,0,0,0,0,0.3
1162,R.J. Hunter\hunterj01,2016-17,G,3,0,9,0,1,.000,0,0,,0,1,.000,0,0,,0,1,1,0,0,0,0,0,0,-0.1
1163,Andre Ingram\ingraan01,2018-19,G,4,0,15,0,6,.000,0,3,.000,0,3,.000,0,0,,1,1,2,0,1,0,1,0,0,-0.8
1164,George King\kingge03,2018-19,G-F,1,0,6,0,0,,0,0,,0,0,,0,0,,0,1,1,0,0,0,0,0,0,0.3
1165,Malcolm Lee\leema01,2014-15,G,1,0,2,0,1,.000,0,1,.000,0,0,,0,0,,0,0,0,0,0,0,0,0,0,-0.7
1166,Zach Lofton\loftoza01,2018-19,G,1,0,4,0,1,.000,0,0,,0,1,.000,0,0,,0,0,0,0,1,0,1,0,0,-0.7
1167,Kalin Lucas\lucaska01,2014-15,G,1,0,6,0,1,.000,0,1,.000,0,0,,0,0,,0,0,0,0,1,0,0,1,0,-0.1
1168,Trey McKinney-Jones\mckintr01,2017-18,G,1,0,1,0,0,,0,0,,0,0,,0,0,,0,0,0,0,0,0,0,0,0,0.0
1169,Luis Montero\montelu01,2017-18,G,2,0,8,0,1,.000,0,1,.000,0,0,,0,0,,0,2,2,0,0,0,2,0,0,-1.1
1170,Nate Robinson\robinna01,2015-16,G,2,1,23,0,1,.000,0,0,,0,1,.000,0,0,,0,0,0,4,1,0,0,5,0,0.6
1171,Xavier Silas\silasxa01,2017-18,G,2,0,7,0,3,.000,0,1,.000,0,2,.000,0,0,,1,1,2,0,1,0,0,1,0,-0.3
1172,Kobi Simmons\simmoko01,2018-19,G,1,0,2,0,0,,0,0,,0,0,,0,0,,0,0,0,0,0,0,0,0,0,0.0
1173,Tyler Ulis\ulisty01,2018-19,G,1,0,1,0,0,,0,0,,0,0,,0,0,,0,0,0,0,0,0,0,0,0,0.0
