"Rk","Player","Season","Age","Tm","Lg","WS","G","GS","MP","FG","FGA","X2P","X2PA","X3P","X3PA","FT","FTA","ORB","DRB","TRB","AST","STL","BLK","TOV","PF","PTS","GmSc"
1,"Michael Jordan\jordami01","1995-96",32,"CHI","NBA",20.4,82,82,3090,916,1850,805,1590,111,260,548,657,148,395,543,352,180,42,197,195,2491,26.73
2,"LeBron James\jamesle01","2008-09",24,"CLE","NBA",20.3,81,81,3054,789,1613,657,1229,132,384,594,762,106,507,613,587,137,93,241,139,2304,28.17
3,"David Robinson\robinda01","1993-94",28,"SAS","NBA",20,80,80,3241,840,1658,830,1629,10,29,693,925,241,614,855,381,139,265,253,228,2383,29.99
4,"LeBron James\jamesle01","2012-13",28,"MIA","NBA",19.3,76,76,2877,765,1354,662,1100,103,254,403,535,97,513,610,551,129,67,226,110,2036,28.25
5,"Kevin Durant\duranke01","2013-14",25,"OKC","NBA",19.2,81,81,3122,849,1688,657,1197,192,491,703,805,58,540,598,445,103,59,285,174,2593,29.69
6,"Kevin Durant\duranke01","2012-13",24,"OKC","NBA",18.9,81,81,3119,731,1433,592,1099,139,334,679,750,46,594,640,374,116,105,280,143,2280,27.76
7,"Shaquille O'Neal\onealsh01","1999-00",27,"LAL","NBA",18.6,79,79,3163,956,1665,956,1664,0,1,432,824,336,742,1078,299,36,239,223,255,2344,28.45
8,"LeBron James\jamesle01","2009-10",25,"CLE","NBA",18.5,76,76,2966,768,1528,639,1141,129,387,593,773,71,483,554,651,125,77,261,119,2258,30
9,"Kevin Garnett\garneke01","2003-04",27,"MIN","NBA",18.3,82,82,3231,804,1611,793,1568,11,43,368,465,245,894,1139,409,120,178,212,202,1987,25.96
10,"Michael Jordan\jordami01","1996-97",33,"CHI","NBA",18.3,82,82,3106,920,1892,809,1595,111,297,480,576,113,369,482,352,140,44,166,156,2431,24.95
11,"Chris Paul\paulch01","2008-09",23,"NOH","NBA",18.3,78,78,3002,631,1255,567,1079,64,176,455,524,69,363,432,861,216,10,231,212,1781,27.25
12,"David Robinson\robinda01","1995-96",30,"SAS","NBA",18.3,82,82,3019,711,1378,708,1369,3,9,626,823,319,681,1000,247,111,271,190,262,2051,26.41
13,"Stephen Curry\curryst01","2015-16",27,"GSW","NBA",17.9,79,79,2700,805,1598,403,712,402,886,363,400,68,362,430,527,169,15,262,161,2375,28.91
14,"Tim Duncan\duncati01","2001-02",25,"SAS","NBA",17.8,82,82,3329,764,1504,763,1494,1,10,560,701,268,774,1042,307,61,203,263,217,2089,25.86
15,"Chris Paul\paulch01","2007-08",22,"NOH","NBA",17.8,80,80,3006,630,1291,538,1042,92,249,332,390,62,259,321,925,217,4,201,185,1684,25.06
16,"Dirk Nowitzki\nowitdi01","2005-06",27,"DAL","NBA",17.7,81,81,3089,751,1564,641,1293,110,271,539,598,115,613,728,226,58,83,156,164,2151,23.44
17,"David Robinson\robinda01","1994-95",29,"SAS","NBA",17.5,81,81,3074,788,1487,782,1467,6,20,656,847,234,643,877,236,134,262,233,230,2238,28.02
18,"Michael Jordan\jordami01","1992-93",29,"CHI","NBA",17.2,78,78,3067,992,2003,911,1773,81,230,476,569,135,387,522,428,221,61,207,188,2541,29.11
19,"Shaquille O'Neal\onealsh01","1993-94",21,"ORL","NBA",16.9,81,81,3224,953,1591,953,1589,0,2,471,850,384,688,1072,195,76,231,222,281,2377,28.34
20,"Karl Malone\malonka01","1996-97",33,"UTA","NBA",16.7,82,82,2998,864,1571,864,1558,0,13,521,690,193,616,809,368,113,48,233,217,2249,26.28
21,"Tim Duncan\duncati01","2002-03",26,"SAS","NBA",16.5,81,81,3181,714,1392,708,1370,6,22,450,634,259,784,1043,316,55,237,248,231,1884,24.46
22,"James Harden\hardeja01","2014-15",25,"HOU","NBA",16.4,81,81,2981,647,1470,439,915,208,555,715,824,75,384,459,565,154,60,321,208,2217,26.89
23,"Karl Malone\malonka01","1997-98",34,"UTA","NBA",16.4,81,81,3030,780,1472,778,1466,2,6,628,825,189,645,834,316,96,70,247,237,2190,25.83
24,"LeBron James\jamesle01","2005-06",21,"CLE","NBA",16.3,79,79,3361,875,1823,748,1444,127,379,601,814,75,481,556,521,123,66,260,181,2478,28.14
25,"Dirk Nowitzki\nowitdi01","2006-07",28,"DAL","NBA",16.3,78,78,2820,673,1341,601,1168,72,173,498,551,122,571,693,263,52,62,167,171,1916,22.85
26,"Kevin Durant\duranke01","2009-10",21,"OKC","NBA",16.1,82,82,3239,794,1668,666,1317,128,351,756,840,105,518,623,231,112,84,271,171,2472,26.46
27,"Kevin Garnett\garneke01","2004-05",28,"MIN","NBA",16.1,82,82,3121,683,1360,677,1335,6,25,445,549,247,861,1108,466,121,112,222,207,1817,25.19
28,"Tracy McGrady\mcgratr01","2002-03",23,"ORL","NBA",16.1,75,74,2954,829,1813,656,1365,173,448,576,726,121,367,488,411,124,59,195,156,2407,27.44
29,"Dirk Nowitzki\nowitdi01","2002-03",24,"DAL","NBA",16.1,80,80,3117,690,1489,542,1099,148,390,483,548,81,710,791,239,111,82,152,206,2011,23.39
30,"Chris Paul\paulch01","2014-15",29,"LAC","NBA",16.1,82,82,2857,568,1170,429,821,139,349,289,321,52,324,376,838,156,15,190,203,1564,22.72
31,"LeBron James\jamesle01","2013-14",29,"MIA","NBA",15.9,77,77,2902,767,1353,651,1047,116,306,439,585,81,452,533,488,121,26,270,126,2089,27.07
32,"Michael Jordan\jordami01","1997-98",34,"CHI","NBA",15.8,82,82,3181,881,1893,851,1767,30,126,565,721,130,345,475,283,141,45,185,151,2357,22.96
33,"Hakeem Olajuwon\olajuha01","1992-93",30,"HOU","NBA",15.8,82,82,3242,848,1603,848,1595,0,8,444,570,283,785,1068,291,150,342,262,305,2140,28.38
34,"Stephen Curry\curryst01","2014-15",26,"GSW","NBA",15.7,80,80,2613,653,1341,367,695,286,646,308,337,56,285,341,619,163,16,249,158,1900,24.44
35,"Kevin Garnett\garneke01","2002-03",26,"MIN","NBA",15.6,82,82,3321,743,1481,723,1410,20,71,377,502,244,858,1102,495,113,129,229,199,1883,25.42
36,"LeBron James\jamesle01","2010-11",26,"MIA","NBA",15.6,79,79,3063,758,1485,666,1206,92,279,503,663,80,510,590,554,124,50,284,163,2111,26.5
37,"Dirk Nowitzki\nowitdi01","2004-05",26,"DAL","NBA",15.6,78,78,3020,663,1445,572,1217,91,228,615,708,96,661,757,240,97,119,176,219,2032,24.35
38,"Chauncey Billups\billuch01","2005-06",29,"DET","NBA",15.5,81,81,2925,423,1012,239,587,184,425,465,520,41,211,252,699,71,8,170,160,1495,19.76
39,"James Harden\hardeja01","2017-18",28,"HOU","NBA",15.4,72,72,2551,651,1449,386,727,265,722,624,727,41,348,389,630,126,50,315,169,2191,29.91
40,"Karl Malone\malonka01","1992-93",29,"UTA","NBA",15.4,82,82,3099,797,1443,793,1423,4,20,619,836,227,692,919,308,124,85,240,261,2217,26.9
41,"Kobe Bryant\bryanko01","2005-06",27,"LAL","NBA",15.3,80,80,3277,978,2173,798,1655,180,518,696,819,71,354,425,360,147,30,250,233,2832,28.04
42,"Karl Malone\malonka01","1999-00",36,"UTA","NBA",15.3,82,82,2947,752,1476,750,1468,2,8,589,739,169,610,779,304,79,71,231,229,2095,23.85
43,"James Harden\hardeja01","2018-19",29,"HOU","NBA",15.2,78,78,2867,843,1909,465,881,378,1028,754,858,66,452,518,586,158,58,387,244,2818,33.25
44,"LeBron James\jamesle01","2007-08",23,"CLE","NBA",15.2,75,74,3027,794,1642,681,1283,113,359,549,771,133,459,592,539,138,81,255,165,2250,28.51
45,"Karl Malone\malonka01","1995-96",32,"UTA","NBA",15.1,82,82,3113,789,1520,773,1480,16,40,512,708,175,629,804,345,138,56,199,245,2106,24.63
46,"James Harden\hardeja01","2016-17",27,"HOU","NBA",15,81,81,2947,674,1533,412,777,262,756,746,881,95,564,659,907,121,38,464,215,2356,31.41
47,"Kobe Bryant\bryanko01","2002-03",24,"LAL","NBA",14.9,82,82,3401,868,1924,744,1600,124,324,601,713,106,458,564,481,181,67,288,218,2461,26.91
48,"Kevin Garnett\garneke01","2005-06",29,"MIN","NBA",14.9,76,76,2957,626,1191,618,1161,8,30,396,489,214,752,966,308,104,107,180,206,1656,23.9
49,"Shaquille O'Neal\onealsh01","2000-01",28,"LAL","NBA",14.9,74,74,2924,813,1422,813,1420,0,2,499,972,291,649,940,277,47,204,218,256,2125,27.37
50,"Elton Brand\brandel01","2005-06",26,"LAC","NBA",14.8,79,79,3099,756,1435,755,1432,1,3,440,568,236,554,790,208,81,201,173,227,1953,23.84
51,"Pau Gasol\gasolpa01","2010-11",30,"LAL","NBA",14.7,82,82,3037,593,1120,592,1117,1,3,354,430,268,568,836,273,48,130,142,203,1541,19.86
52,"Dwyane Wade\wadedw01","2008-09",27,"MIA","NBA",14.7,79,79,3048,854,1739,766,1461,88,278,590,771,89,309,398,589,173,106,272,178,2386,28.56
53,"Grant Hill\hillgr01","1996-97",24,"DET","NBA",14.6,80,80,3147,625,1259,615,1226,10,33,450,633,123,598,721,583,144,48,259,186,1710,23.49
54,"Shawn Marion\mariosh01","2005-06",27,"PHO","NBA",14.6,81,81,3263,716,1365,620,1075,96,290,241,298,249,710,959,143,160,137,125,223,1769,22.43
55,"Dirk Nowitzki\nowitdi01","2000-01",22,"DAL","NBA",14.6,82,82,3125,591,1247,440,857,151,390,451,538,119,635,754,173,79,101,156,245,1784,20.55
56,"Amar'e Stoudemire\stoudam01","2004-05",22,"PHO","NBA",14.6,80,80,2889,747,1336,744,1320,3,16,583,795,219,494,713,131,77,130,189,278,2080,23.8
57,"Amar'e Stoudemire\stoudam01","2007-08",25,"PHO","NBA",14.6,79,79,2677,714,1211,709,1180,5,31,556,691,178,541,719,118,64,163,174,294,1989,24.32
58,"Kevin Durant\duranke01","2015-16",27,"OKC","NBA",14.5,72,72,2578,698,1381,512,900,186,481,447,498,45,544,589,361,69,85,250,137,2029,26.92
59,"LeBron James\jamesle01","2011-12",27,"MIA","NBA",14.5,62,62,2326,621,1169,567,1020,54,149,387,502,94,398,492,387,115,50,213,96,1683,27.17
60,"Giannis Antetokounmpo\antetgi01","2018-19",24,"MIL","NBA",14.4,72,72,2358,721,1247,669,1044,52,203,500,686,159,739,898,424,92,110,268,232,1994,30
61,"Charles Barkley\barklch01","1992-93",29,"PHO","NBA",14.4,76,76,2859,716,1376,649,1156,67,220,445,582,237,691,928,385,119,74,233,196,1944,26.63
62,"Rudy Gobert\goberru01","2018-19",26,"UTA","NBA",14.4,81,80,2577,476,712,476,712,0,0,332,522,309,732,1041,161,66,187,130,231,1284,20.07
63,"Anfernee Hardaway\hardaan01","1995-96",24,"ORL","NBA",14.4,82,82,3015,623,1215,534,932,89,283,445,580,129,225,354,582,166,41,229,160,1780,22.79
64,"Dwight Howard\howardw01","2010-11",25,"ORL","NBA",14.4,78,78,2935,619,1044,619,1037,0,7,546,916,309,789,1098,107,107,186,279,258,1784,24.41
65,"Dwyane Wade\wadedw01","2005-06",24,"MIA","NBA",14.4,75,75,2892,699,1413,686,1337,13,76,629,803,107,323,430,503,146,58,268,217,2040,26.29
66,"Rudy Gobert\goberru01","2016-17",24,"UTA","NBA",14.3,81,81,2744,413,625,413,624,0,1,311,476,314,721,1035,97,49,214,147,246,1137,18.26
67,"LeBron James\jamesle01","2004-05",20,"CLE","NBA",14.3,80,80,3388,795,1684,687,1376,108,308,477,636,111,477,588,577,177,52,262,146,2175,26.29
68,"Kevin Love\loveke01","2013-14",25,"MIN","NBA",14.3,77,77,2797,650,1421,460,916,190,505,520,633,224,739,963,341,59,35,196,136,2010,25.16
69,"Hakeem Olajuwon\olajuha01","1993-94",31,"HOU","NBA",14.3,80,80,3277,894,1694,886,1675,8,19,388,542,229,726,955,287,128,297,271,289,2184,27.66
70,"Anthony Davis\davisan02","2014-15",21,"NOP","NBA",14,68,68,2455,642,1199,641,1187,1,12,371,461,173,523,696,149,100,200,95,141,1656,24.41
71,"LeBron James\jamesle01","2017-18",33,"CLE","NBA",14,82,82,3026,857,1580,708,1174,149,406,388,531,97,612,709,747,116,71,347,136,2251,29.3
72,"Shaquille O'Neal\onealsh01","1994-95",22,"ORL","NBA",14,79,79,2923,930,1594,930,1589,0,5,455,854,328,573,901,214,73,192,204,258,2315,26.95
73,"Karl-Anthony Towns\townska01","2017-18",22,"MIN","NBA",14,82,82,2918,639,1172,519,887,120,285,345,402,238,774,1012,199,64,115,159,285,1743,22.49
74,"Russell Westbrook\westbru01","2015-16",27,"OKC","NBA",14,80,80,2750,656,1444,555,1103,101,341,465,573,145,481,626,834,163,20,342,200,1878,26.22
75,"Pau Gasol\gasolpa01","2008-09",28,"LAL","NBA",13.9,81,81,2999,592,1045,591,1043,1,2,343,439,262,518,780,284,52,81,157,172,1528,19.93
76,"Chris Paul\paulch01","2012-13",27,"LAC","NBA",13.9,70,70,2335,412,856,336,624,76,232,286,323,53,209,262,678,169,10,159,143,1186,21.32
77,"Chris Paul\paulch01","2010-11",25,"NOH","NBA",13.9,80,80,2880,430,928,359,745,71,183,337,384,38,289,327,782,188,5,177,196,1268,20.52
78,"Gary Payton\paytoga01","1999-00",31,"SEA","NBA",13.9,82,82,3425,747,1666,570,1146,177,520,311,423,100,429,529,732,153,18,224,178,1982,23.9
79,"John Stockton\stockjo01","1994-95",32,"UTA","NBA",13.9,82,82,2867,429,791,327,564,102,227,246,306,57,194,251,1011,194,22,267,215,1206,22.16
80,"Kobe Bryant\bryanko01","2007-08",29,"LAL","NBA",13.8,82,82,3192,775,1690,625,1275,150,415,623,742,94,423,517,441,151,40,257,227,2323,25.57
81,"Jimmy Butler\butleji01","2016-17",27,"CHI","NBA",13.8,76,75,2809,570,1252,479,1004,91,248,585,676,129,341,470,417,143,32,159,112,1816,23.38
82,"Dwight Howard\howardw01","2008-09",23,"ORL","NBA",13.8,79,79,2821,560,979,560,977,0,2,504,849,336,757,1093,112,77,231,240,270,1624,22.52
83,"Karl Malone\malonka01","1994-95",31,"UTA","NBA",13.8,82,82,3126,830,1548,819,1507,11,41,516,695,156,715,871,285,129,85,236,269,2187,25.61
84,"David Robinson\robinda01","1997-98",32,"SAS","NBA",13.8,73,73,2457,544,1065,543,1061,1,4,485,660,239,536,775,199,64,192,202,204,1574,22.24
85,"Ray Allen\allenra02","2000-01",25,"MIL","NBA",13.7,82,82,3129,628,1309,426,842,202,467,348,392,101,327,428,374,124,20,204,192,1806,20.66
86,"Anthony Davis\davisan02","2017-18",24,"NOP","NBA",13.7,75,75,2727,780,1462,725,1300,55,162,495,598,187,645,832,174,115,193,162,159,2110,27.49
87,"LeBron James\jamesle01","2006-07",22,"CLE","NBA",13.7,78,78,3190,772,1621,673,1311,99,310,489,701,83,443,526,470,125,55,250,171,2132,24.67
88,"Kawhi Leonard\leonaka01","2015-16",24,"SAS","NBA",13.7,72,72,2380,551,1090,422,799,129,291,292,334,95,398,493,186,128,71,105,133,1523,20.4
89,"Gilbert Arenas\arenagi01","2005-06",24,"WAS","NBA",13.6,80,80,3384,746,1668,547,1128,199,540,655,799,59,221,280,484,161,25,297,286,2346,25.61
90,"Elton Brand\brandel01","2001-02",22,"LAC","NBA",13.6,80,80,3020,532,1010,532,1010,0,0,389,524,396,529,925,191,80,163,173,254,1453,20.03
91,"LeBron James\jamesle01","2015-16",31,"CLE","NBA",13.6,76,76,2709,737,1416,650,1134,87,282,359,491,111,454,565,514,104,49,249,143,1920,24.93
92,"Kawhi Leonard\leonaka01","2016-17",25,"SAS","NBA",13.6,74,74,2474,636,1312,489,925,147,387,469,533,80,350,430,260,133,55,154,122,1888,23.3
93,"John Stockton\stockjo01","1996-97",34,"UTA","NBA",13.6,82,82,2896,416,759,340,579,76,180,275,325,45,183,228,860,166,15,248,194,1183,20.34
94,"Chauncey Billups\billuch01","2007-08",31,"DET","NBA",13.5,78,78,2522,393,877,256,535,137,342,401,437,42,170,212,529,101,17,160,130,1324,18.22
95,"Brandon Roy\roybr01","2008-09",24,"POR","NBA",13.5,78,78,2903,633,1318,550,1098,83,220,416,505,104,266,370,400,88,22,152,127,1765,20.4
96,"Peja Stojaković\stojape01","2003-04",26,"SAC","NBA",13.5,81,81,3264,665,1386,425,832,240,554,394,425,91,417,508,173,108,14,153,159,1964,20.86
97,"Stephen Curry\curryst01","2013-14",25,"GSW","NBA",13.4,78,78,2846,652,1383,391,768,261,615,308,348,46,288,334,666,128,14,294,194,1873,24.2
98,"Karl Malone\malonka01","1993-94",30,"UTA","NBA",13.4,82,82,3329,772,1552,764,1520,8,32,511,736,235,705,940,328,125,126,234,268,2063,24.56
99,"Dirk Nowitzki\nowitdi01","2001-02",23,"DAL","NBA",13.4,76,76,2891,600,1258,461,908,139,350,440,516,120,635,755,186,83,77,145,222,1779,22.07
100,"James Harden\hardeja01","2015-16",26,"HOU","NBA",13.3,82,82,3125,710,1617,474,960,236,657,720,837,63,438,501,612,139,51,374,229,2376,27.86
101,"Tim Duncan\duncati01","2000-01",24,"SAS","NBA",13.2,82,82,3174,702,1406,695,1379,7,27,409,662,259,738,997,245,70,192,242,247,1820,21.83
102,"Dwight Howard\howardw01","2009-10",24,"ORL","NBA",13.2,82,82,2843,510,834,510,827,0,7,483,816,284,798,1082,144,75,228,274,287,1503,21.44
103,"Shaquille O'Neal\onealsh01","2001-02",29,"LAL","NBA",13.2,67,66,2422,712,1229,712,1228,0,1,398,717,235,480,715,200,41,137,171,199,1822,25.1
104,"Shaquille O'Neal\onealsh01","2002-03",30,"LAL","NBA",13.2,67,66,2535,695,1211,695,1211,0,0,451,725,259,483,742,206,38,159,196,229,1841,26.15
105,"David Robinson\robinda01","1992-93",27,"SAS","NBA",13.2,82,82,3211,676,1348,673,1331,3,17,561,766,229,727,956,301,127,264,241,239,1916,25.19
106,"John Stockton\stockjo01","1993-94",31,"UTA","NBA",13.2,82,82,2969,458,868,410,719,48,149,272,338,72,186,258,1031,199,22,266,236,1236,22.25
107,"Tim Duncan\duncati01","2003-04",27,"SAS","NBA",13.1,69,68,2527,592,1181,590,1169,2,12,352,588,227,632,859,213,62,185,183,164,1538,22.29
108,"Patrick Ewing\ewingpa01","1993-94",31,"NYK","NBA",13.1,79,79,2972,745,1503,741,1489,4,14,445,582,219,666,885,179,90,217,260,275,1939,23.43
109,"Karl Malone\malonka01","2000-01",37,"UTA","NBA",13.1,81,81,2895,670,1345,668,1340,2,5,536,676,114,555,669,361,93,62,244,216,1878,22.29
110,"Scottie Pippen\pippesc01","1996-97",31,"CHI","NBA",13.1,82,82,3095,648,1366,492,942,156,424,204,291,160,371,531,467,154,45,214,213,1656,20.11
111,"Derrick Rose\rosede01","2010-11",22,"CHI","NBA",13.1,81,81,3026,711,1597,583,1212,128,385,476,555,81,249,330,623,85,51,278,136,2026,22.84
112,"Russell Westbrook\westbru01","2016-17",28,"OKC","NBA",13.1,81,81,2802,824,1941,624,1358,200,583,710,840,137,727,864,840,132,31,438,190,2558,31.66
113,"Kobe Bryant\bryanko01","2006-07",28,"LAL","NBA",13,77,77,3140,813,1757,676,1359,137,398,667,768,75,364,439,413,111,36,255,205,2430,27.09
114,"Tim Duncan\duncati01","1999-00",23,"SAS","NBA",13,74,74,2875,628,1281,627,1270,1,11,459,603,262,656,918,234,66,165,242,210,1716,23.32
115,"Tim Duncan\duncati01","2006-07",30,"SAS","NBA",13,80,80,2726,618,1131,617,1122,1,9,362,568,213,633,846,273,66,190,224,203,1599,21.26
116,"Shawn Marion\mariosh01","2002-03",24,"PHO","NBA",13,81,81,3373,662,1466,521,1102,141,364,251,295,199,574,773,198,185,95,157,208,1716,20.2
117,"John Stockton\stockjo01","1995-96",33,"UTA","NBA",13,82,82,2915,440,818,345,593,95,225,234,282,54,172,226,916,140,15,246,207,1209,20.43
118,"Dwyane Wade\wadedw01","2009-10",28,"MIA","NBA",13,77,77,2792,719,1511,646,1268,73,243,534,702,107,266,373,501,142,82,252,181,2045,24.77
119,"Vince Carter\cartevi01","2000-01",24,"TOR","NBA",12.9,75,75,2979,762,1656,600,1259,162,397,384,502,176,240,416,291,114,82,167,205,2070,22.8
120,"Kevin Garnett\garneke01","2007-08",31,"BOS","NBA",12.9,71,71,2328,534,990,534,979,0,11,269,336,135,520,655,244,100,89,138,163,1337,20.08
121,"Tim Hardaway\hardati01","1996-97",30,"MIA","NBA",12.9,81,81,3136,575,1384,372,794,203,590,291,364,49,228,277,695,151,9,230,165,1644,20.13
122,"Dwight Howard\howardw01","2007-08",22,"ORL","NBA",12.9,82,82,3088,583,974,583,970,0,4,529,897,279,882,1161,110,74,176,263,274,1695,22.41
123,"LeBron James\jamesle01","2016-17",32,"CLE","NBA",12.9,74,74,2794,736,1344,612,1002,124,342,358,531,97,542,639,646,92,44,303,134,1954,27.96
124,"Alonzo Mourning\mournal01","1999-00",29,"MIA","NBA",12.9,79,78,2748,652,1184,652,1180,0,4,414,582,215,538,753,123,40,294,217,308,1718,21.72
125,"Dirk Nowitzki\nowitdi01","2007-08",29,"DAL","NBA",12.9,77,77,2769,630,1314,551,1094,79,220,478,544,95,564,659,266,51,71,160,198,1817,21.73
126,"Gary Payton\paytoga01","1996-97",28,"SEA","NBA",12.9,82,82,3213,706,1482,587,1102,119,380,254,355,106,272,378,583,197,13,215,208,1785,21.4
127,"Paul Pierce\piercpa01","2001-02",24,"BOS","NBA",12.9,82,82,3302,707,1598,497,1078,210,520,520,643,81,485,566,261,154,86,241,237,2144,22.95
128,"Detlef Schrempf\schrede01","1994-95",32,"SEA","NBA",12.9,82,82,2886,521,997,428,816,93,181,437,521,135,373,508,310,93,35,176,252,1572,19.35
129,"Tim Duncan\duncati01","1997-98",21,"SAS","NBA",12.8,82,82,3204,706,1287,706,1277,0,10,319,482,274,703,977,224,55,206,279,254,1731,21.88
130,"Kevin Garnett\garneke01","2001-02",25,"MIN","NBA",12.8,81,81,3175,659,1401,622,1285,37,116,359,448,243,738,981,422,96,126,229,184,1714,22.63
131,"James Harden\hardeja01","2013-14",24,"HOU","NBA",12.8,73,73,2777,549,1205,372,722,177,483,576,665,61,283,344,446,115,29,265,177,1851,24.34
132,"James Harden\hardeja01","2012-13",23,"HOU","NBA",12.8,78,78,2985,585,1337,406,851,179,486,674,792,62,317,379,455,142,38,295,178,2023,24.52
133,"DeAndre Jordan\jordade01","2014-15",26,"LAC","NBA",12.8,82,82,2820,379,534,378,530,1,4,187,471,397,829,1226,61,81,183,109,245,946,16.49
134,"Dwyane Wade\wadedw01","2010-11",29,"MIA","NBA",12.8,76,76,2823,692,1384,629,1178,63,206,494,652,123,362,485,346,111,87,237,197,1941,23.6
135,"Dana Barros\barroda01","1994-95",27,"PHI","NBA",12.7,82,82,3318,571,1165,374,740,197,425,347,386,27,247,274,619,149,4,242,159,1686,21.68
136,"Terrell Brandon\brandte01","1995-96",25,"CLE","NBA",12.7,75,75,2570,510,1096,419,861,91,235,338,381,47,201,248,487,132,33,142,146,1449,19.52
137,"Kobe Bryant\bryanko01","2001-02",23,"LAL","NBA",12.7,80,80,3063,749,1597,716,1465,33,132,488,589,112,329,441,438,118,35,223,228,2019,22.32
138,"Kobe Bryant\bryanko01","2008-09",30,"LAL","NBA",12.7,82,82,2960,800,1712,682,1376,118,336,483,564,90,339,429,399,120,37,210,189,2201,23.01
139,"Brad Daugherty\daughbr01","1992-93",27,"CLE","NBA",12.7,71,71,2691,520,911,519,909,1,2,391,492,164,562,726,312,53,56,150,174,1432,22.01
140,"Chris Paul\paulch01","2011-12",26,"LAC","NBA",12.7,60,60,2181,425,890,346,677,79,213,260,302,42,171,213,543,152,4,124,138,1189,22.32
141,"Chris Paul\paulch01","2015-16",30,"LAC","NBA",12.7,74,74,2420,515,1114,393,785,122,329,294,328,39,271,310,738,152,13,194,185,1446,22.44
142,"David Robinson\robinda01","1999-00",34,"SAS","NBA",12.7,80,80,2557,528,1031,528,1029,0,2,371,511,193,577,770,142,97,183,164,247,1427,18.66
143,"Karl-Anthony Towns\townska01","2016-17",21,"MIN","NBA",12.7,82,82,3030,802,1480,701,1205,101,275,356,428,296,711,1007,220,56,103,212,241,2061,24.41
144,"Stephen Curry\curryst01","2016-17",28,"GSW","NBA",12.6,79,79,2638,675,1443,351,654,324,789,325,362,61,292,353,524,142,17,239,183,1999,24.13
145,"Damian Lillard\lillada01","2017-18",27,"POR","NBA",12.6,73,73,2670,621,1415,394,786,227,629,493,538,62,263,325,481,77,27,206,117,1962,24.17
146,"Steve Nash\nashst01","2006-07",32,"PHO","NBA",12.6,76,76,2682,517,971,361,628,156,343,222,247,30,239,269,884,57,6,287,117,1412,22.59
147,"Gary Payton\paytoga01","2001-02",33,"SEA","NBA",12.6,82,82,3301,737,1578,663,1342,74,236,267,335,80,316,396,737,131,26,209,179,1815,21.97
148,"Mookie Blaylock\blaylmo01","1996-97",29,"ATL","NBA",12.5,78,78,3056,501,1159,280,555,221,604,131,174,114,299,413,463,212,20,185,141,1354,18.48
149,"Shawn Marion\mariosh01","2004-05",26,"PHO","NBA",12.5,81,81,3146,613,1289,499,948,114,341,229,275,235,680,915,154,163,119,125,199,1569,19.92
150,"Gary Payton\paytoga01","1997-98",29,"SEA","NBA",12.5,82,82,3145,579,1278,445,881,134,397,279,375,77,299,376,679,185,18,229,195,1571,20.65
151,"Isaiah Thomas\thomais02","2016-17",27,"BOS","NBA",12.5,76,76,2569,682,1473,437,827,245,646,590,649,43,162,205,448,70,13,210,167,2199,24.89
152,"Kenny Anderson\anderke01","1996-97",26,"POR","NBA",12.4,82,81,3081,485,1137,353,771,132,366,334,435,91,272,363,584,162,15,193,222,1436,18.54
153,"Giannis Antetokounmpo\antetgi01","2016-17",22,"MIL","NBA",12.4,80,80,2845,656,1259,607,1079,49,180,471,612,142,558,700,434,131,151,234,246,1832,24.71
154,"Steve Nash\nashst01","2005-06",31,"PHO","NBA",12.4,79,79,2796,541,1056,391,714,150,342,257,279,47,286,333,826,61,12,276,120,1489,22
155,"Paul Pierce\piercpa01","2007-08",30,"BOS","NBA",12.4,80,80,2874,509,1098,366,733,143,365,409,485,53,358,411,363,101,36,221,200,1570,18.99
156,"Reggie Miller\millere01","1996-97",31,"IND","NBA",12.3,81,81,2966,552,1244,323,708,229,536,418,475,53,233,286,273,75,25,166,172,1751,18.22
157,"Dirk Nowitzki\nowitdi01","2009-10",31,"DAL","NBA",12.3,81,80,3039,720,1496,669,1375,51,121,536,586,80,540,620,218,70,79,149,208,2027,21.9
158,"Scottie Pippen\pippesc01","1995-96",30,"CHI","NBA",12.3,77,77,2825,563,1216,413,815,150,401,220,324,152,344,496,452,133,57,207,198,1496,19.69
159,"Kevin Durant\duranke01","2011-12",23,"OKC","NBA",12.2,66,66,2546,643,1297,510,953,133,344,431,501,40,487,527,231,88,77,248,133,1850,25.54
160,"Steve Francis\francst01","2000-01",23,"HOU","NBA",12.2,80,79,3194,550,1219,417,883,133,336,358,438,190,363,553,517,141,31,265,274,1591,20.89
161,"Blake Griffin\griffbl01","2013-14",24,"LAC","NBA",12.2,80,80,2863,718,1359,706,1315,12,44,482,674,192,565,757,309,92,51,224,265,1930,22.95
162,"Tracy McGrady\mcgratr01","2000-01",21,"ORL","NBA",12.2,77,77,3087,788,1724,729,1558,59,166,430,587,192,388,580,352,116,118,198,160,2065,23.22
163,"Chris Paul\paulch01","2013-14",28,"LAC","NBA",12.2,62,62,2171,406,870,328,658,78,212,295,345,38,230,268,663,154,4,145,157,1185,23.33
164,"Brent Barry\barrybr01","2001-02",30,"SEA","NBA",12.1,81,81,3040,401,790,237,403,164,387,198,234,58,383,441,426,147,37,165,182,1164,17.34
165,"Chauncey Billups\billuch01","2004-05",28,"DET","NBA",12.1,80,80,2866,404,913,239,526,165,387,343,382,48,223,271,464,81,9,180,194,1316,16.79
166,"Sam Cassell\cassesa01","2003-04",34,"MIN","NBA",12.1,81,81,2838,620,1270,546,1084,74,186,289,331,44,227,271,592,102,18,220,247,1603,19.54
167,"Damian Lillard\lillada01","2018-19",28,"POR","NBA",12.1,80,80,2838,681,1533,444,890,237,643,468,513,68,303,371,551,88,34,212,148,2067,23.68
168,"David Robinson\robinda01","2000-01",35,"SAS","NBA",12.1,80,80,2371,400,823,400,822,0,1,351,470,208,483,691,116,80,197,122,212,1151,15.79
169,"Kevin Durant\duranke01","2016-17",28,"GSW","NBA",12,62,62,2070,551,1026,434,714,117,312,336,384,39,474,513,300,66,99,138,117,1555,25.62
170,"Kevin Durant\duranke01","2010-11",22,"OKC","NBA",12,78,78,3038,711,1538,566,1124,145,414,594,675,57,476,533,214,88,76,218,159,2161,23.6
171,"Pau Gasol\gasolpa01","2005-06",25,"MEM","NBA",12,80,80,3135,600,1194,597,1182,3,12,425,617,191,522,713,371,46,153,235,184,1628,20.67
172,"Shawn Marion\mariosh01","2006-07",28,"PHO","NBA",12,80,80,3010,561,1071,481,819,80,252,201,248,172,613,785,134,156,122,114,216,1403,18.85
173,"Tracy McGrady\mcgratr01","2004-05",25,"HOU","NBA",12,78,78,3182,715,1660,573,1225,142,435,431,557,71,413,484,448,135,52,201,167,2003,22.5
174,"Reggie Miller\millere01","1997-98",32,"IND","NBA",12,81,81,2795,516,1081,352,699,164,382,382,440,46,186,232,171,78,11,128,148,1578,16.08
175,"Giannis Antetokounmpo\antetgi01","2017-18",23,"MIL","NBA",11.9,75,75,2756,742,1402,699,1262,43,140,487,641,156,597,753,361,109,106,223,231,2014,26.73
176,"Paul George\georgpa01","2018-19",28,"OKC","NBA",11.9,77,77,2841,707,1614,415,857,292,757,453,540,105,523,628,318,170,34,205,214,2159,25.26
177,"Vince Carter\cartevi01","1999-00",23,"TOR","NBA",11.8,82,82,3126,788,1696,693,1460,95,236,436,551,150,326,476,322,110,92,178,263,2107,21.7
178,"Kevin Garnett\garneke01","2000-01",24,"MIN","NBA",11.8,81,81,3202,704,1475,685,1409,19,66,357,467,219,702,921,401,111,145,230,204,1784,22.85
179,"Allen Iverson\iversal01","2000-01",25,"PHI","NBA",11.8,71,71,2979,762,1813,664,1507,98,306,585,719,50,223,273,325,178,20,237,147,2207,24.19
180,"Nikola Jokić\jokicni01","2018-19",23,"DEN","NBA",11.8,80,80,2504,616,1206,533,936,83,270,289,352,228,637,865,580,108,55,248,228,1604,23.49
181,"DeAndre Jordan\jordade01","2016-17",28,"LAC","NBA",11.8,81,81,2570,412,577,412,575,0,2,205,425,298,816,1114,96,51,134,115,212,1029,16.78
182,"Scottie Pippen\pippesc01","1994-95",29,"CHI","NBA",11.8,79,79,3014,634,1320,525,1004,109,316,315,440,175,464,639,409,232,89,271,238,1692,22.88
183,"Clyde Drexler\drexlcl01","1994-95",32,"TOT","NBA",11.7,76,75,2728,571,1238,424,830,147,408,364,442,152,328,480,362,136,45,186,206,1653,21.01
184,"Tim Hardaway\hardati01","1997-98",31,"MIA","NBA",11.7,81,81,3031,558,1296,403,854,155,442,257,329,48,251,299,672,136,16,224,200,1528,19.17
185,"Grant Hill\hillgr01","1995-96",23,"DET","NBA",11.7,80,80,3260,564,1221,559,1195,5,26,485,646,127,656,783,548,100,48,263,242,1618,21.94
186,"Richard Jefferson\jefferi01","2005-06",25,"NJN","NBA",11.7,78,78,3059,495,1005,435,817,60,188,471,580,95,439,534,297,59,17,174,193,1521,18.77
187,"Kevin Johnson\johnske02","1996-97",30,"PHO","NBA",11.7,70,70,2658,441,890,352,688,89,202,439,515,54,199,253,653,102,12,217,141,1410,22.88
188,"Shawn Kemp\kempsh01","1993-94",24,"SEA","NBA",11.7,79,73,2597,533,990,532,986,1,4,364,491,312,539,851,207,142,166,259,312,1431,20.81
189,"Kyle Lowry\lowryky01","2013-14",27,"TOR","NBA",11.7,79,79,2862,457,1080,267,580,190,500,313,385,88,281,369,586,121,15,194,267,1417,19.04
190,"Stephon Marbury\marbust01","2004-05",27,"NYK","NBA",11.7,82,82,3281,604,1308,489,983,115,325,458,549,50,198,248,668,122,6,233,186,1781,21.51
191,"Shawn Marion\mariosh01","2000-01",22,"PHO","NBA",11.7,79,79,2857,557,1160,536,1078,21,82,234,289,220,628,848,160,132,108,129,211,1369,17.93
192,"Reggie Miller\millere01","1993-94",28,"IND","NBA",11.7,79,79,2638,524,1042,401,750,123,292,403,444,30,182,212,248,119,24,175,193,1574,18.13
193,"Gary Payton\paytoga01","1994-95",26,"SEA","NBA",11.7,82,82,3015,685,1345,615,1113,70,232,249,348,108,173,281,583,204,13,201,206,1689,20.92
194,"Kevin Garnett\garneke01","1999-00",23,"MIN","NBA",11.6,81,81,3243,759,1526,729,1445,30,81,309,404,223,733,956,401,120,126,268,205,1857,23.77
195,"Allen Iverson\iversal01","2007-08",32,"DEN","NBA",11.6,82,82,3424,712,1556,617,1281,95,275,645,797,47,196,243,586,160,12,245,109,2164,24.08
196,"Andrei Kirilenko\kirilan01","2003-04",22,"UTA","NBA",11.6,78,78,2895,412,931,344,730,68,201,392,496,226,403,629,244,150,215,215,174,1284,18.95
197,"Christian Laettner\laettch01","1996-97",27,"ATL","NBA",11.6,82,82,3140,548,1128,517,1040,31,88,359,440,212,508,720,223,102,64,218,277,1486,17.98
198,"Kyle Lowry\lowryky01","2015-16",29,"TOR","NBA",11.6,77,77,2851,512,1198,300,651,212,547,398,491,55,310,365,494,158,34,225,211,1634,21.25
199,"Anthony Mason\masonan01","2000-01",34,"MIA","NBA",11.6,80,80,3254,460,954,460,954,0,0,370,474,169,601,770,248,80,25,179,231,1290,16.8
200,"Steve Nash\nashst01","2002-03",28,"DAL","NBA",11.6,82,82,2711,518,1114,407,845,111,269,308,339,63,171,234,598,85,6,192,134,1455,17.94
201,"Paul Pierce\piercpa01","2010-11",33,"BOS","NBA",11.6,80,80,2774,507,1021,396,724,111,297,386,449,34,396,430,260,80,51,171,231,1511,18.05
202,"Ben Wallace\wallabe01","2001-02",27,"DET","NBA",11.6,80,80,2921,255,480,255,477,0,3,99,234,318,721,1039,115,138,278,70,178,609,14.37
203,"Russell Westbrook\westbru01","2012-13",24,"OKC","NBA",11.6,82,82,2861,673,1535,576,1235,97,300,460,575,111,317,428,607,145,24,273,189,1903,22.07
204,"Gilbert Arenas\arenagi01","2004-05",23,"WAS","NBA",11.5,80,80,3274,656,1523,451,961,205,562,521,640,83,295,378,411,139,23,242,245,2038,22.26
205,"Elton Brand\brandel01","2006-07",27,"LAC","NBA",11.5,80,80,3077,645,1211,644,1210,1,1,351,461,268,476,744,235,77,179,202,238,1642,20.91
206,"Kevin Durant\duranke01","2018-19",30,"GSW","NBA",11.5,78,78,2702,721,1383,584,995,137,388,448,506,33,464,497,457,58,84,225,155,2027,25.12
207,"Marc Gasol\gasolma01","2012-13",28,"MEM","NBA",11.5,80,80,2796,429,869,428,855,1,14,268,316,184,438,622,318,80,139,157,255,1127,16.5
208,"DeAndre Jordan\jordade01","2015-16",27,"LAC","NBA",11.5,77,77,2598,357,508,357,507,0,1,266,619,267,792,1059,90,51,177,107,207,980,16.72
209,"Tracy McGrady\mcgratr01","2001-02",22,"ORL","NBA",11.5,76,76,2912,715,1586,612,1303,103,283,415,555,150,447,597,400,119,73,189,139,1948,23.11
210,"Dirk Nowitzki\nowitdi01","2003-04",25,"DAL","NBA",11.5,77,77,2915,605,1310,506,1020,99,290,371,423,90,580,670,207,92,104,135,216,1680,20.28
211,"Gary Payton\paytoga01","1995-96",27,"SEA","NBA",11.5,81,81,3162,618,1276,520,977,98,299,229,306,104,235,339,608,231,19,260,221,1563,20.89
212,"Paul Pierce\piercpa01","2005-06",28,"BOS","NBA",11.5,79,79,3084,689,1462,578,1148,111,314,627,812,77,453,530,375,107,34,273,223,2116,24.04
213,"Gerald Wallace\wallage01","2009-10",27,"CHA","NBA",11.5,76,76,3119,456,943,404,803,52,140,422,544,150,612,762,161,117,83,178,194,1386,19.11
214,"Chauncey Billups\billuch01","2006-07",30,"DET","NBA",11.4,70,70,2533,348,815,239,499,109,316,386,437,23,214,237,502,84,17,140,161,1191,18.31
215,"Kevin Love\loveke01","2010-11",22,"MIN","NBA",11.4,73,73,2611,482,1026,394,815,88,211,424,499,330,782,1112,184,45,28,155,148,1476,21.35
216,"Anthony Mason\masonan01","1996-97",30,"CHH","NBA",11.4,73,73,3143,433,825,432,822,1,3,319,428,186,643,829,414,76,33,165,202,1186,19.98
217,"Reggie Miller\millere01","1994-95",29,"IND","NBA",11.4,81,81,2665,505,1092,310,622,195,470,383,427,30,180,210,242,98,16,151,157,1588,16.92
218,"Yao Ming\mingya01","2003-04",23,"HOU","NBA",11.4,82,82,2692,535,1025,535,1023,0,2,361,446,197,538,735,122,22,156,204,273,1431,17.12
219,"Chauncey Billups\billuch01","2003-04",27,"DET","NBA",11.3,78,78,2758,392,996,262,661,130,335,404,460,35,241,276,446,84,8,189,177,1318,16.25
220,"Kobe Bryant\bryanko01","2000-01",22,"LAL","NBA",11.3,68,68,2783,701,1510,640,1310,61,200,475,557,104,295,399,338,114,43,220,222,1938,24.54
221,"Luol Deng\denglu01","2006-07",21,"CHI","NBA",11.3,82,82,3071,630,1218,629,1211,1,7,279,359,148,431,579,204,97,48,153,167,1540,17.22
222,"Jason Kidd\kiddja01","2002-03",29,"NJN","NBA",11.3,80,80,2989,515,1244,389,874,126,370,339,403,110,394,504,711,179,25,296,127,1495,21.26
223,"Anthony Mason\masonan01","1995-96",29,"NYK","NBA",11.3,82,82,3457,449,798,449,798,0,0,298,414,220,544,764,363,69,34,211,246,1196,17.35
224,"Reggie Miller\millere01","1992-93",27,"IND","NBA",11.3,82,82,2954,571,1193,404,774,167,419,427,485,67,191,258,262,120,26,145,182,1736,18.67
225,"Dikembe Mutombo\mutomdi01","1996-97",30,"ATL","NBA",11.3,80,80,2973,380,721,380,721,0,0,306,434,268,661,929,110,49,264,186,249,1066,16.81
226,"Deron Williams\willide01","2007-08",23,"UTA","NBA",11.3,82,82,3059,566,1117,483,907,83,210,330,411,34,209,243,862,90,23,279,200,1545,21.51
227,"Jimmy Butler\butleji01","2014-15",25,"CHI","NBA",11.2,65,65,2513,421,912,348,719,73,193,386,463,114,265,379,212,114,36,93,108,1301,19.07
228,"Stephen Curry\curryst01","2012-13",24,"GSW","NBA",11.2,78,78,2983,626,1388,354,788,272,600,262,291,59,255,314,539,126,12,240,198,1786,21.67
229,"Tim Duncan\duncati01","2004-05",28,"SAS","NBA",11.2,66,66,2203,517,1042,514,1033,3,9,305,455,202,530,732,179,45,174,127,144,1342,20.37
230,"Shawn Kemp\kempsh01","1995-96",26,"SEA","NBA",11.2,79,76,2631,526,937,521,925,5,12,493,664,276,628,904,173,93,127,315,299,1550,21.53
231,"Joakim Noah\noahjo01","2013-14",28,"CHI","NBA",11.2,80,80,2820,380,800,380,798,0,2,247,335,282,618,900,431,99,121,194,245,1007,17.62
232,"Paul Pierce\piercpa01","2004-05",27,"BOS","NBA",11.2,82,82,2960,556,1223,448,931,108,292,549,668,78,461,539,348,133,39,230,255,1769,20.82
233,"Scottie Pippen\pippesc01","1993-94",28,"CHI","NBA",11.2,72,72,2759,627,1278,564,1081,63,197,270,409,173,456,629,403,211,58,232,227,1587,23.23
234,"John Stockton\stockjo01","1999-00",37,"UTA","NBA",11.2,82,82,2432,363,725,320,604,43,121,221,257,45,170,215,703,143,15,179,192,990,16.4
235,"Amar'e Stoudemire\stoudam01","2006-07",24,"PHO","NBA",11.2,82,78,2689,607,1055,607,1052,0,3,457,585,222,564,786,84,78,110,232,295,1671,20.15
236,"LaMarcus Aldridge\aldrila01","2010-11",25,"POR","NBA",11.1,81,81,3211,707,1415,703,1392,4,23,351,444,278,431,709,170,82,94,153,220,1769,19.44
237,"Ray Allen\allenra02","2008-09",33,"BOS","NBA",11.1,79,79,2876,499,1040,300,554,199,486,237,249,66,212,278,218,69,13,134,157,1434,15.73
238,"Tim Duncan\duncati01","2007-08",31,"SAS","NBA",11.1,78,78,2651,585,1178,585,1174,0,4,338,463,237,644,881,218,56,152,178,185,1508,19.68
239,"Steve Francis\francst01","2002-03",25,"HOU","NBA",11.1,81,81,3318,571,1312,486,1072,85,240,476,595,159,340,499,502,141,41,299,251,1703,20.82
240,"Manu Ginóbili\ginobma01","2007-08",30,"SAS","NBA",11.1,74,23,2299,453,984,297,595,156,389,380,442,63,291,354,332,109,33,200,173,1442,19.13
241,"Draymond Green\greendr01","2015-16",25,"GSW","NBA",11.1,81,81,2808,401,819,301,561,100,258,229,329,134,635,769,598,119,113,259,240,1131,19.78
242,"DeAndre Jordan\jordade01","2013-14",25,"LAC","NBA",11.1,82,82,2870,348,515,348,515,0,0,160,374,331,783,1114,74,80,203,123,264,856,15.47
243,"Karl Malone\malonka01","2002-03",39,"UTA","NBA",11.1,81,81,2936,595,1289,592,1275,3,14,474,621,113,515,628,379,136,31,210,204,1667,19.98
244,"Dirk Nowitzki\nowitdi01","2010-11",32,"DAL","NBA",11.1,73,73,2504,610,1179,544,1011,66,168,395,443,50,463,513,190,38,47,137,172,1681,20.41
245,"Anthony Davis\davisan02","2016-17",23,"NOP","NBA",11,75,75,2708,770,1526,730,1392,40,134,519,647,172,712,884,157,94,167,181,168,2099,26.16
246,"Pau Gasol\gasolpa01","2009-10",29,"LAL","NBA",11,65,65,2403,452,844,452,839,0,5,286,362,243,491,734,218,37,113,143,152,1190,20.18
247,"Manu Ginóbili\ginobma01","2004-05",27,"SAS","NBA",11,74,74,2193,367,780,270,522,97,258,355,442,75,254,329,288,119,27,172,190,1186,16.53
248,"Richard Jefferson\jefferi01","2003-04",23,"NJN","NBA",11,82,82,3133,555,1115,507,983,48,132,357,468,109,355,464,315,92,28,198,224,1515,17.44
249,"Shaquille O'Neal\onealsh01","2004-05",32,"MIA","NBA",11,73,73,2492,658,1095,658,1095,0,0,353,765,253,507,760,200,36,171,203,262,1669,21.93
250,"Dwyane Wade\wadedw01","2004-05",23,"MIA","NBA",11,77,77,2974,630,1318,617,1273,13,45,581,762,110,287,397,520,121,82,321,230,1854,23.54
251,"Rasheed Wallace\wallara01","2000-01",26,"POR","NBA",11,77,75,2940,590,1178,538,1016,52,162,245,320,147,455,602,212,90,135,158,206,1477,18.6
252,"Chris Webber\webbech01","2000-01",27,"SAC","NBA",11,70,70,2836,786,1635,784,1607,2,28,324,461,179,598,777,294,93,118,195,226,1898,24.36
253,"LaMarcus Aldridge\aldrila01","2017-18",32,"SAS","NBA",10.9,75,75,2509,687,1347,660,1255,27,92,334,399,246,389,635,152,43,90,111,161,1735,20.1
254,"Kobe Bryant\bryanko01","2012-13",34,"LAL","NBA",10.9,78,78,3013,738,1595,606,1188,132,407,525,626,66,367,433,469,106,25,287,173,2133,24.31
255,"Tim Duncan\duncati01","2009-10",33,"SAS","NBA",10.9,78,77,2438,561,1082,559,1071,2,11,271,374,221,567,788,246,45,117,140,152,1395,18.4
256,"Hersey Hawkins\hawkihe01","1996-97",30,"SEA","NBA",10.9,82,82,2755,369,795,226,440,143,355,258,295,92,228,320,250,159,12,130,146,1139,14.46
257,"Al Horford\horfoal01","2009-10",23,"ATL","NBA",10.9,81,81,2845,467,847,466,846,1,1,213,270,236,563,799,189,59,91,122,225,1148,15.97
258,"Steve Nash\nashst01","2004-05",30,"PHO","NBA",10.9,75,75,2573,430,857,336,639,94,218,211,238,57,192,249,861,74,6,245,136,1165,20.09
259,"Dirk Nowitzki\nowitdi01","2008-09",30,"DAL","NBA",10.9,81,81,3050,774,1616,713,1446,61,170,485,545,88,593,681,197,61,63,157,176,2094,21.78
260,"Dirk Nowitzki\nowitdi01","2013-14",35,"DAL","NBA",10.9,80,80,2628,633,1273,502,944,131,329,338,376,40,458,498,216,73,45,117,165,1735,19.21
261,"Deron Williams\willide01","2012-13",28,"BRK","NBA",10.9,78,78,2842,495,1124,326,677,169,447,317,369,29,203,232,604,75,30,218,194,1476,18.95
262,"Gilbert Arenas\arenagi01","2006-07",25,"WAS","NBA",10.8,74,73,2942,647,1548,442,964,205,584,606,718,61,277,338,443,139,13,236,249,2105,24.71
263,"Terrell Brandon\brandte01","1996-97",26,"CLE","NBA",10.8,78,78,2868,575,1313,474,1042,101,271,268,297,48,253,301,490,138,30,178,177,1519,18.47
264,"Clint Capela\capelca01","2018-19",24,"HOU","NBA",10.8,67,67,2249,474,732,474,732,0,0,166,261,298,550,848,96,44,102,94,168,1114,19.03
265,"Tim Duncan\duncati01","2005-06",29,"SAS","NBA",10.8,80,80,2784,574,1185,572,1180,2,5,335,533,231,650,881,253,70,162,198,219,1485,18.98
266,"Paul George\georgpa01","2013-14",23,"IND","NBA",10.8,80,80,2898,577,1362,395,862,182,500,401,464,64,478,542,283,151,22,224,198,1737,19.63
267,"Nenê Hilário\hilarne01","2009-10",27,"DEN","NBA",10.8,82,82,2755,421,717,421,715,0,2,293,416,166,461,627,203,115,82,125,281,1135,16.07
268,"Dikembe Mutombo\mutomdi01","1997-98",31,"ATL","NBA",10.8,82,82,2917,399,743,399,743,0,0,303,452,276,656,932,82,34,277,168,254,1101,16.33
269,"Gary Payton\paytoga01","2000-01",32,"SEA","NBA",10.8,79,79,3244,725,1591,623,1319,102,272,271,354,73,288,361,642,127,26,209,184,1823,21.58
270,"Michael Redd\reddmi01","2005-06",26,"MIL","NBA",10.8,80,80,3130,682,1516,519,1103,163,413,501,571,78,264,342,229,95,5,170,157,2028,20.09
271,"Glen Rice\ricegl01","1996-97",29,"CHH","NBA",10.8,79,78,3362,722,1513,515,1073,207,440,464,535,67,251,318,160,72,26,177,190,2115,20.83
272,"Mitch Richmond\richmmi01","1996-97",31,"SAC","NBA",10.8,81,81,3125,717,1578,513,1101,204,477,457,531,59,260,319,338,118,24,237,211,2095,21.56
273,"John Stockton\stockjo01","2000-01",38,"UTA","NBA",10.8,82,82,2397,328,651,267,519,61,132,227,278,54,173,227,713,132,21,203,194,944,16.29
274,"Jason Terry\terryja01","2006-07",29,"DAL","NBA",10.8,81,80,2846,514,1063,352,693,162,370,160,199,41,190,231,422,81,17,152,170,1350,15.76
275,"Ray Allen\allenra02","2004-05",29,"SEA","NBA",10.7,78,78,3064,640,1494,431,938,209,556,378,428,79,268,347,289,84,5,171,167,1867,19.05
276,"Carmelo Anthony\anthoca01","2013-14",29,"NYK","NBA",10.7,77,77,2982,743,1643,576,1228,167,415,459,541,145,477,622,242,95,51,198,224,2112,23.05
277,"Kobe Bryant\bryanko01","2003-04",25,"LAL","NBA",10.7,65,64,2447,516,1178,445,961,71,217,454,533,103,256,359,330,112,28,171,176,1557,21.74
278,"Kevin Garnett\garneke01","2006-07",30,"MIN","NBA",10.7,76,76,2995,638,1341,626,1285,12,56,416,498,183,792,975,313,89,126,205,184,1704,23.34
279,"Anfernee Hardaway\hardaan01","1994-95",23,"ORL","NBA",10.7,77,77,2901,585,1142,498,893,87,249,356,463,139,197,336,551,130,26,258,158,1613,21.73
280,"Grant Hill\hillgr01","1999-00",27,"DET","NBA",10.7,74,74,2776,696,1422,662,1324,34,98,480,604,97,393,490,385,103,43,240,190,1906,23.49
281,"Nikola Jokić\jokicni01","2017-18",22,"DEN","NBA",10.7,75,73,2443,504,1010,393,730,111,280,266,313,195,608,803,458,90,61,210,212,1385,21.8
282,"Yao Ming\mingya01","2004-05",24,"HOU","NBA",10.7,80,80,2447,538,975,538,975,0,0,389,497,208,461,669,61,34,160,196,298,1465,17.63
283,"Larry Nance\nancela01","1992-93",33,"CLE","NBA",10.7,77,77,2753,533,971,533,967,0,4,202,247,184,484,668,223,54,198,107,223,1268,18.17
284,"Hakeem Olajuwon\olajuha01","1994-95",32,"HOU","NBA",10.7,72,72,2853,798,1545,795,1529,3,16,406,537,172,603,775,255,133,242,237,250,2005,27.52
285,"John Stockton\stockjo01","2001-02",39,"UTA","NBA",10.7,82,82,2566,401,775,376,697,25,78,275,321,59,204,263,674,152,24,208,209,1102,17.65
286,"Amar'e Stoudemire\stoudam01","2009-10",27,"PHO","NBA",10.7,82,82,2838,704,1264,703,1258,1,6,487,632,230,502,732,82,52,83,213,281,1896,20.67
287,"Chris Webber\webbech01","1999-00",26,"SAC","NBA",10.7,75,75,2880,748,1548,721,1453,27,95,311,414,189,598,787,345,120,128,218,264,1834,23.66
288,"Charles Barkley\barklch01","1994-95",31,"PHO","NBA",10.6,68,66,2382,554,1141,480,922,74,219,379,507,203,553,756,276,110,45,150,201,1561,23.09
289,"Elton Brand\brandel01","2004-05",25,"LAC","NBA",10.6,81,81,3001,629,1251,629,1248,0,3,364,484,296,474,770,208,62,169,183,240,1622,19.55
290,"Kobe Bryant\bryanko01","1999-00",21,"LAL","NBA",10.6,66,62,2524,554,1183,508,1039,46,144,331,403,108,308,416,323,106,62,182,220,1485,21.08
291,"Patrick Ewing\ewingpa01","1992-93",30,"NYK","NBA",10.6,81,81,3003,779,1550,778,1543,1,7,400,556,191,789,980,151,74,161,265,286,1959,22.32
292,"Manu Ginóbili\ginobma01","2006-07",29,"SAS","NBA",10.6,75,36,2060,396,854,268,531,128,323,320,372,59,268,327,263,109,27,157,155,1240,16.3
293,"Blake Griffin\griffbl01","2012-13",23,"LAC","NBA",10.6,80,80,2598,577,1072,572,1044,5,28,281,426,186,476,662,299,97,50,185,231,1440,18.36
294,"Allen Iverson\iversal01","2005-06",30,"PHI","NBA",10.6,72,72,3103,815,1822,743,1599,72,223,675,829,44,188,232,532,140,10,248,121,2377,27.48
295,"Shawn Kemp\kempsh01","1994-95",25,"SEA","NBA",10.6,82,79,2679,545,997,543,990,2,7,438,585,318,575,893,149,102,122,259,337,1530,20
296,"Damian Lillard\lillada01","2014-15",24,"POR","NBA",10.6,82,82,2925,590,1360,394,788,196,572,344,398,49,329,378,507,97,21,222,164,1720,19.51
297,"Yao Ming\mingya01","2008-09",28,"HOU","NBA",10.6,77,77,2589,566,1032,565,1031,1,1,381,440,204,557,761,137,30,150,234,257,1514,19.87
298,"Chris Paul\paulch01","2016-17",31,"LAC","NBA",10.6,61,61,1921,374,785,250,483,124,302,232,260,40,264,304,563,119,8,147,146,1104,21.86
299,"John Stockton\stockjo01","1992-93",30,"UTA","NBA",10.6,82,82,2863,437,899,365,712,72,187,293,367,64,173,237,987,199,21,266,224,1239,21.39
300,"Ben Wallace\wallabe01","2002-03",28,"DET","NBA",10.6,73,73,2873,210,437,209,431,1,6,85,189,293,833,1126,120,104,230,88,179,506,14.27
301,"Russell Westbrook\westbru01","2014-15",26,"OKC","NBA",10.6,67,67,2302,627,1471,541,1183,86,288,546,654,124,364,488,574,140,14,293,184,1886,27.03
302,"Charles Barkley\barklch01","1995-96",32,"PHO","NBA",10.5,71,71,2632,580,1160,531,985,49,175,440,566,243,578,821,262,114,56,218,208,1649,23.71
303,"Vince Carter\cartevi01","2006-07",30,"NJN","NBA",10.5,82,82,3126,726,1598,570,1161,156,437,462,576,114,378,492,393,82,30,217,266,2070,21.6
304,"Eddie Jones\jonesed02","2001-02",30,"MIA","NBA",10.5,81,81,3156,517,1198,368,816,149,382,297,355,61,317,378,262,117,77,148,258,1480,16.43
305,"Steve Nash\nashst01","2007-08",33,"PHO","NBA",10.5,81,81,2780,485,962,306,581,179,381,222,245,28,254,282,898,53,5,295,113,1371,20.74
306,"Jermaine O'Neal\onealje01","2002-03",24,"IND","NBA",10.5,77,76,2864,610,1260,603,1239,7,21,373,510,202,594,796,155,66,178,180,277,1600,19.8
307,"Charles Oakley\oaklech01","1993-94",30,"NYK","NBA",10.5,82,82,2932,363,760,363,757,0,3,243,313,349,616,965,218,110,18,193,293,969,14.82
308,"Zach Randolph\randoza01","2010-11",29,"MEM","NBA",10.5,75,74,2724,598,1188,590,1145,8,43,300,396,326,588,914,163,63,25,151,175,1504,19.11
309,"Dominique Wilkins\wilkido01","1992-93",33,"ATL","NBA",10.5,71,70,2647,741,1584,621,1268,120,316,519,627,187,295,482,227,70,27,184,116,2121,24.03
310,"Vin Baker\bakervi01","1997-98",26,"SEA","NBA",10.4,82,82,2944,631,1164,630,1157,1,7,311,526,286,370,656,152,91,86,174,278,1574,17.63
311,"Anthony Davis\davisan02","2013-14",20,"NOP","NBA",10.4,67,66,2358,522,1005,520,996,2,9,348,440,207,466,673,105,89,189,109,200,1394,21.29
312,"Kevin Durant\duranke01","2017-18",29,"GSW","NBA",10.4,68,68,2325,630,1222,457,809,173,413,359,404,31,433,464,366,50,119,207,133,1792,25.67
313,"Pau Gasol\gasolpa01","2014-15",34,"CHI","NBA",10.4,78,78,2681,570,1153,558,1127,12,26,294,366,220,699,919,210,25,147,158,147,1446,18.98
314,"Gordon Hayward\haywago01","2016-17",26,"UTA","NBA",10.4,73,73,2516,545,1156,396,782,149,374,362,429,49,345,394,252,73,20,140,117,1601,19.23
315,"Kyrie Irving\irvinky01","2014-15",22,"CLE","NBA",10.4,75,75,2730,578,1235,421,857,157,378,315,365,55,182,237,389,114,20,186,146,1628,19.6
316,"LeBron James\jamesle01","2014-15",30,"CLE","NBA",10.4,69,69,2493,624,1279,504,940,120,339,375,528,51,365,416,511,109,49,272,135,1743,24.69
317,"Damian Lillard\lillada01","2016-17",26,"POR","NBA",10.4,75,75,2694,661,1488,447,909,214,579,488,545,46,322,368,440,68,20,197,152,2024,23.48
318,"Donyell Marshall\marshdo01","2003-04",30,"TOT","NBA",10.4,82,74,2988,470,1020,339,695,131,325,134,182,210,598,808,122,93,124,117,247,1205,15.22
319,"Shaquille O'Neal\onealsh01","1992-93",20,"ORL","NBA",10.4,81,81,3071,733,1304,733,1302,0,2,427,721,342,780,1122,152,60,286,307,321,1893,24.34
320,"Chris Paul\paulch01","2005-06",20,"NOK","NBA",10.4,78,78,2808,407,947,357,770,50,177,394,465,61,339,400,611,175,6,183,218,1258,19.18
321,"Paul Pierce\piercpa01","2000-01",23,"BOS","NBA",10.4,82,82,3120,687,1513,540,1129,147,384,550,738,94,428,522,253,138,69,262,251,2071,21.75
322,"Detlef Schrempf\schrede01","1992-93",30,"IND","NBA",10.4,82,60,3098,517,1085,509,1033,8,52,525,653,210,570,780,493,79,27,243,305,1567,20.95
323,"Detlef Schrempf\schrede01","1997-98",35,"SEA","NBA",10.4,78,78,2742,437,898,376,751,61,147,297,352,135,419,554,341,60,19,168,205,1232,16.54
324,"Steve Smith\smithst01","1999-00",30,"POR","NBA",10.4,82,81,2689,420,900,324,659,96,241,289,340,123,190,313,209,71,31,117,214,1225,13.5
325,"Karl-Anthony Towns\townska01","2018-19",23,"MIN","NBA",10.4,77,77,2545,681,1314,539,959,142,355,376,450,263,691,954,259,67,125,240,292,1880,24.94
326,"Chris Bosh\boshch01","2010-11",26,"MIA","NBA",10.3,77,77,2795,524,1056,518,1031,6,25,384,471,141,500,641,144,59,49,138,172,1438,17.2
327,"Kobe Bryant\bryanko01","2010-11",32,"LAL","NBA",10.3,82,82,2779,740,1639,625,1283,115,356,483,583,83,336,419,388,99,12,243,172,2078,21.14
328,"Marcus Camby\cambyma01","2000-01",26,"NYK","NBA",10.3,63,63,2127,304,580,303,572,1,8,150,225,196,527,723,52,66,136,63,205,759,14.78
329,"Tyson Chandler\chandty01","2014-15",32,"DAL","NBA",10.3,75,75,2286,293,440,293,440,0,0,185,257,294,570,864,84,42,91,105,169,771,14.15
330,"Goran Dragić\dragigo01","2013-14",27,"PHO","NBA",10.3,76,75,2668,552,1093,430,794,122,299,316,416,69,176,245,447,104,22,213,206,1542,19.58
331,"Andre Drummond\drumman01","2017-18",24,"DET","NBA",10.3,78,78,2625,466,881,466,870,0,11,239,395,399,848,1247,237,114,127,200,250,1171,19.82
332,"David Lee\leeda02","2009-10",26,"NYK","NBA",10.3,81,81,3019,686,1258,686,1250,0,8,268,330,228,721,949,295,85,40,189,257,1640,21.09
333,"Andre Miller\millean02","2001-02",25,"CLE","NBA",10.3,81,81,3023,474,1045,452,958,22,87,365,447,108,271,379,882,126,34,245,228,1335,20.73
334,"Reggie Miller\millere01","1995-96",30,"IND","NBA",10.3,76,76,2621,504,1066,336,656,168,410,430,498,38,176,214,253,77,13,189,175,1606,18.2
335,"Reggie Miller\millere01","2000-01",35,"IND","NBA",10.3,81,81,3181,517,1176,347,712,170,464,323,348,38,247,285,260,81,15,133,162,1527,15.9
336,"Wesley Person\persowe01","1997-98",26,"CLE","NBA",10.3,82,82,3198,440,957,248,510,192,447,132,170,65,298,363,188,129,49,110,108,1204,13.84
337,"Paul Pierce\piercpa01","2008-09",31,"BOS","NBA",10.3,81,81,3035,540,1181,421,877,119,304,459,553,56,401,457,294,80,27,228,215,1658,18.48
338,"Hassan Whiteside\whiteha01","2015-16",26,"MIA","NBA",10.3,73,43,2125,413,682,413,682,0,0,214,329,238,627,865,30,44,269,137,201,1040,17.55
339,"Deron Williams\willide01","2009-10",25,"UTA","NBA",10.3,76,76,2802,494,1053,398,794,96,259,335,418,50,253,303,798,96,16,252,208,1419,21.49
340,"Mookie Blaylock\blaylmo01","1993-94",26,"ATL","NBA",10.2,81,81,2915,444,1079,330,738,114,341,116,159,117,307,424,789,212,44,196,144,1118,18.37
341,"Carlos Boozer\boozeca01","2007-08",26,"UTA","NBA",10.2,81,81,2827,709,1297,709,1296,0,1,290,393,197,647,844,233,100,41,210,293,1708,20.64
342,"P.J. Brown\brownpj01","2002-03",33,"NOH","NBA",10.2,78,78,2609,319,601,319,598,0,3,194,232,243,458,701,147,67,80,98,203,832,13.21
343,"José Calderón\caldejo01","2007-08",26,"TOR","NBA",10.2,82,56,2484,367,707,288,523,79,184,109,120,34,202,236,678,87,6,126,134,922,15
344,"Clint Capela\capelca01","2017-18",23,"HOU","NBA",10.2,74,74,2034,441,676,441,675,0,1,144,257,241,561,802,68,58,137,103,185,1026,16.3
345,"Marc Gasol\gasolma01","2014-15",30,"MEM","NBA",10.2,81,81,2687,530,1072,527,1055,3,17,350,440,115,515,630,307,70,131,176,208,1413,18.11
346,"Grant Hill\hillgr01","1997-98",25,"DET","NBA",10.2,81,81,3294,615,1361,612,1340,3,21,479,647,93,530,623,551,143,53,285,196,1712,21.64
347,"Jeff Hornacek\hornaje01","1995-96",32,"UTA","NBA",10.2,82,59,2588,442,880,338,657,104,223,259,290,62,147,209,340,106,20,127,171,1247,15.09
348,"Jeff Hornacek\hornaje01","1996-97",33,"UTA","NBA",10.2,82,82,2592,413,856,341,661,72,195,293,326,60,181,241,361,124,26,134,188,1191,15.06
349,"Kyle Lowry\lowryky01","2017-18",31,"TOR","NBA",10.2,78,78,2510,403,944,165,348,238,596,223,261,66,368,434,537,85,19,183,192,1267,17.95
350,"Kevin Martin\martike02","2006-07",23,"SAC","NBA",10.2,80,80,2818,505,1067,378,734,127,333,481,570,69,273,342,173,98,11,135,181,1618,17.51
351,"Shaquille O'Neal\onealsh01","1997-98",25,"LAL","NBA",10.2,60,57,2175,670,1147,670,1147,0,0,359,681,208,473,681,142,39,144,175,193,1699,25.78
352,"Chris Paul\paulch01","2017-18",32,"HOU","NBA",10.2,58,58,1847,367,798,223,419,144,379,203,221,37,276,313,457,96,14,128,141,1081,20.91
353,"Glen Rice\ricegl01","1993-94",26,"MIA","NBA",10.2,81,81,2999,663,1421,531,1075,132,346,250,284,76,358,434,184,110,32,130,186,1708,17.28
354,"Steve Smith\smithst01","1997-98",28,"ATL","NBA",10.2,73,73,2857,489,1101,392,825,97,276,389,455,133,176,309,292,75,29,176,219,1464,17.61
355,"Ben Wallace\wallabe01","2003-04",29,"DET","NBA",10.2,81,81,3050,315,748,314,740,1,8,142,290,324,682,1006,138,143,246,123,162,773,13.96
356,"Kevin Willis\willike02","1993-94",31,"ATL","NBA",10.2,80,80,2867,627,1257,618,1233,9,24,268,376,335,628,963,150,79,38,188,250,1531,18.18
357,"LaMarcus Aldridge\aldrila01","2015-16",30,"SAS","NBA",10.1,74,74,2261,536,1045,536,1029,0,16,259,302,176,456,632,110,38,81,99,151,1331,16.5
358,"Ray Allen\allenra02","1999-00",24,"MIL","NBA",10.1,82,82,3070,642,1411,470,1004,172,407,353,398,83,276,359,308,110,19,183,187,1809,18.81
359,"Chauncey Billups\billuch01","2008-09",32,"TOT","NBA",10.1,79,79,2789,410,980,248,583,162,397,418,458,32,207,239,506,93,18,177,161,1400,17.94
360,"Chris Bosh\boshch01","2007-08",23,"TOR","NBA",10.1,67,67,2425,507,1027,497,1002,10,25,472,559,174,409,583,171,63,67,153,157,1496,21.01
361,"Tim Duncan\duncati01","2008-09",32,"SAS","NBA",10.1,75,75,2524,558,1107,558,1105,0,2,334,483,201,599,800,264,38,126,165,173,1450,19.6
362,"Kirk Hinrich\hinriki01","2006-07",26,"CHI","NBA",10.1,80,80,2839,475,1061,335,724,140,337,237,284,32,242,274,500,100,23,191,274,1327,16.64
363,"Al Horford\horfoal01","2010-11",24,"ATL","NBA",10.1,77,77,2704,513,921,511,917,2,4,150,188,182,536,718,266,59,80,119,193,1178,17.04
364,"Jeff Hornacek\hornaje01","1994-95",31,"UTA","NBA",10.1,81,81,2696,482,937,393,718,89,219,284,322,53,157,210,347,129,17,145,181,1337,16.38
365,"Larry Johnson\johnsla02","1995-96",26,"CHH","NBA",10.1,81,81,3274,583,1225,516,1042,67,183,427,564,249,434,683,355,55,43,182,173,1660,19.6
366,"Eddie Jones\jonesed02","1999-00",28,"CHH","NBA",10.1,72,72,2807,478,1119,350,778,128,341,362,419,81,262,343,305,192,49,160,176,1446,19.56
367,"Eddie Jones\jonesed02","1997-98",26,"LAL","NBA",10.1,80,80,2910,486,1005,343,637,143,368,234,306,85,217,302,246,160,55,146,164,1349,16.28
368,"Jason Kidd\kiddja01","2005-06",32,"NJN","NBA",10.1,80,80,2975,366,905,227,510,139,395,194,244,86,494,580,672,150,29,192,157,1065,17.88
369,"Toni Kukoč\kukocto01","1995-96",27,"CHI","NBA",10.1,81,20,2103,386,787,299,571,87,216,206,267,115,208,323,287,64,28,114,150,1065,13.06
370,"Kyle Lowry\lowryky01","2016-17",30,"TOR","NBA",10.1,60,60,2244,426,918,233,450,193,468,299,365,48,238,286,417,88,19,173,170,1344,22.55
371,"Reggie Miller\millere01","1999-00",34,"IND","NBA",10.1,81,81,2987,466,1041,301,637,165,404,373,406,50,189,239,187,85,25,129,126,1470,15.35
372,"Paul Millsap\millspa01","2015-16",30,"ATL","NBA",10.1,81,81,2647,501,1066,427,834,74,232,309,408,198,534,732,265,147,139,191,237,1385,18.79
373,"Lamar Odom\odomla01","2010-11",31,"LAL","NBA",10.1,82,35,2639,473,893,405,715,68,178,166,246,175,535,710,249,47,61,139,200,1180,15.37
374,"Paul Pierce\piercpa01","2002-03",25,"BOS","NBA",10.1,79,79,3096,663,1592,545,1201,118,391,604,753,106,472,578,349,139,62,288,227,2048,22.75
375,"David Robinson\robinda01","2001-02",36,"SAS","NBA",10.1,78,78,2303,341,672,341,672,0,0,269,395,191,456,647,94,86,140,104,193,951,13.78
376,"Peja Stojaković\stojape01","2002-03",25,"SAC","NBA",10.1,72,72,2450,497,1034,342,628,155,406,231,264,61,336,397,141,72,5,101,143,1380,16.32
377,"Peja Stojaković\stojape01","2000-01",23,"SAC","NBA",10.1,75,75,2905,559,1189,415,829,144,360,267,312,93,341,434,164,91,13,146,144,1529,17.21
378,"Nikola Vučević\vucevni01","2018-19",28,"ORL","NBA",10.1,80,80,2510,701,1354,617,1123,84,231,179,227,224,736,960,307,81,89,159,157,1665,21.51
379,"Ben Wallace\wallabe01","2005-06",31,"DET","NBA",10.1,82,82,2890,237,465,237,461,0,4,123,296,301,622,923,158,146,181,88,164,597,12.8
380,"Russell Westbrook\westbru01","2017-18",29,"OKC","NBA",10.1,80,80,2914,757,1687,660,1361,97,326,417,566,152,652,804,820,147,20,381,200,2028,26.84
381,"Ray Allen\allenra02","2010-11",35,"BOS","NBA",10,80,80,2890,480,978,312,600,168,378,193,219,51,223,274,219,77,16,117,147,1321,14.61
382,"Tyson Chandler\chandty01","2007-08",25,"NOH","NBA",10,79,79,2783,377,605,377,604,0,1,175,295,322,606,928,81,45,84,136,243,929,14.43
383,"Mike Conley\conlemi01","2016-17",29,"MEM","NBA",10,69,68,2292,464,1009,293,590,171,419,316,368,31,210,241,433,92,19,156,126,1415,19.98
384,"Andre Drummond\drumman01","2018-19",25,"DET","NBA",10,79,79,2647,561,1052,556,1014,5,38,243,412,423,809,1232,112,136,138,175,272,1370,20.18
385,"Horace Grant\grantho01","1993-94",28,"CHI","NBA",10,70,69,2570,460,878,460,872,0,6,137,230,306,463,769,236,74,84,109,164,1057,17.07
386,"Shawn Kemp\kempsh01","1996-97",27,"SEA","NBA",10,81,75,2750,526,1032,514,999,12,33,452,609,275,532,807,156,125,81,280,320,1516,19.2
387,"Toni Kukoč\kukocto01","1994-95",26,"CHI","NBA",10,81,55,2584,487,967,425,769,62,198,235,314,155,285,440,372,102,16,165,163,1271,16.13
388,"Kevin Love\loveke01","2011-12",23,"MIN","NBA",10,55,55,2145,474,1059,369,777,105,282,379,460,226,508,734,111,47,28,128,152,1432,23.38
389,"Brad Miller\millebr01","2003-04",27,"SAC","NBA",10,72,53,2621,373,731,361,693,12,38,256,329,191,552,743,312,68,86,144,247,1014,17.58
390,"James Posey\poseyja01","2003-04",27,"MEM","NBA",10,82,82,2451,368,770,256,480,112,290,278,335,92,311,403,122,137,40,112,248,1126,13.7
391,"Mark Price\pricema01","1993-94",29,"CLE","NBA",10,76,73,2386,480,1005,362,708,118,297,238,268,39,189,228,589,103,11,189,93,1316,18.51
392,"Glen Rice\ricegl01","1994-95",27,"MIA","NBA",10,82,82,3014,667,1403,482,952,185,451,312,365,99,279,378,192,112,14,153,203,1831,18.32
393,"Derek Anderson\anderde01","2000-01",26,"SAS","NBA",9.9,82,82,2859,413,993,312,740,101,253,342,402,75,288,363,301,120,14,165,188,1269,14.64
394,"Chauncey Billups\billuch01","2002-03",26,"DET","NBA",9.9,74,74,2327,366,870,217,490,149,380,318,362,38,235,273,287,63,15,134,136,1199,14.9
395,"Carlos Boozer\boozeca01","2006-07",25,"UTA","NBA",9.9,74,74,2557,647,1154,647,1154,0,0,255,372,235,632,867,221,70,21,194,217,1549,20.8
396,"Carlos Boozer\boozeca01","2009-10",28,"UTA","NBA",9.9,78,78,2673,617,1098,617,1098,0,0,285,384,181,693,874,247,84,36,212,270,1519,20.38
397,"Derrick Coleman\colemde01","1993-94",26,"NJN","NBA",9.9,77,77,2778,541,1209,503,1088,38,121,439,567,262,608,870,262,68,142,208,209,1559,20.48
398,"Mike Conley\conlemi01","2012-13",25,"MEM","NBA",9.9,80,80,2757,414,940,308,647,106,293,234,282,43,182,225,487,174,24,189,171,1168,15.98
399,"Luol Deng\denglu01","2010-11",25,"CHI","NBA",9.9,82,82,3208,531,1155,416,822,115,333,253,336,116,360,476,230,78,48,156,162,1430,15.41
400,"DeMar DeRozan\derozde01","2015-16",26,"TOR","NBA",9.9,78,78,2804,614,1377,567,1238,47,139,555,653,64,285,349,315,81,21,175,167,1830,19.59
401,"Andre Drummond\drumman01","2013-14",20,"DET","NBA",9.9,81,81,2619,479,769,479,767,0,2,137,328,440,631,1071,35,101,131,110,273,1095,16.27
402,"Manu Ginóbili\ginobma01","2010-11",33,"SAS","NBA",9.9,80,79,2426,441,1018,287,577,154,441,357,410,42,253,295,393,123,28,174,163,1393,17.14
403,"Tyrone Hill\hillty01","1996-97",28,"CLE","NBA",9.9,74,70,2582,357,595,357,594,0,1,241,381,259,477,736,92,63,30,147,268,955,14.43
404,"Richard Jefferson\jefferi01","2002-03",22,"NJN","NBA",9.9,80,80,2879,456,911,450,887,6,24,324,436,150,364,514,201,80,44,156,216,1242,14.99
405,"Alonzo Mourning\mournal01","1995-96",25,"MIA","NBA",9.9,70,70,2671,563,1076,554,1046,9,30,488,712,218,509,727,159,70,189,262,245,1623,23
406,"Dikembe Mutombo\mutomdi01","1999-00",33,"ATL","NBA",9.9,82,82,2984,322,573,322,573,0,0,298,421,304,853,1157,105,27,269,174,248,942,16.73
407,"Steve Nash\nashst01","2009-10",35,"PHO","NBA",9.9,81,81,2660,499,985,375,694,124,291,211,225,34,234,268,892,42,12,295,108,1333,19.99
408,"Steve Nash\nashst01","2001-02",27,"DAL","NBA",9.9,82,82,2837,525,1088,369,745,156,343,260,293,50,204,254,634,53,4,229,164,1466,18.32
409,"Shaquille O'Neal\onealsh01","2003-04",31,"LAL","NBA",9.9,67,67,2464,554,948,554,948,0,0,331,676,246,523,769,196,34,166,195,225,1439,21.7
410,"Rajon Rondo\rondora01","2008-09",22,"BOS","NBA",9.9,80,80,2642,383,759,368,711,15,48,172,268,100,316,416,659,149,11,209,193,953,16.51
411,"Peja Stojaković\stojape01","2001-02",24,"SAC","NBA",9.9,71,71,2649,547,1130,418,820,129,310,283,323,72,301,373,175,81,14,140,120,1506,18.03
412,"Kemba Walker\walkeke02","2015-16",25,"CHO","NBA",9.9,81,81,2885,568,1331,386,841,182,490,371,438,56,301,357,421,126,39,171,111,1689,19.12
413,"Chris Bosh\boshch01","2005-06",21,"TOR","NBA",9.8,70,70,2751,549,1087,549,1074,0,13,474,581,204,443,647,181,50,79,157,209,1572,21.12
414,"Cedric Ceballos\cebalce01","1995-96",26,"LAL","NBA",9.8,78,71,2628,638,1203,587,1019,51,184,329,409,215,321,536,119,94,22,167,144,1656,18.52
415,"Patrick Ewing\ewingpa01","1996-97",34,"NYK","NBA",9.8,78,78,2887,655,1342,653,1333,2,9,439,582,175,659,834,156,69,189,269,250,1751,21.29
416,"Blake Griffin\griffbl01","2010-11",21,"LAC","NBA",9.8,82,82,3112,696,1376,689,1352,7,24,446,695,270,719,989,312,63,45,223,252,1845,21.57
417,"Rashard Lewis\lewisra02","2007-08",28,"ORL","NBA",9.8,81,81,3076,516,1135,290,582,226,553,218,260,97,340,437,196,99,38,140,214,1476,16.16
418,"Dan Majerle\majerda01","1992-93",27,"PHO","NBA",9.8,82,82,3199,509,1096,342,658,167,438,203,261,120,263,383,311,138,33,133,180,1388,16.26
419,"Karl Malone\malonka01","2001-02",38,"UTA","NBA",9.8,80,80,3040,635,1399,626,1374,9,25,509,639,142,544,686,341,152,59,263,229,1788,21.46
420,"Shawn Marion\mariosh01","2001-02",23,"PHO","NBA",9.8,81,81,3109,654,1395,606,1273,48,122,191,226,211,592,803,162,149,86,144,214,1547,18.05
421,"Mark Price\pricema01","1992-93",28,"CLE","NBA",9.8,75,74,2380,477,986,355,693,122,293,289,305,37,164,201,602,89,11,196,105,1365,19.44
422,"Otis Thorpe\thorpot01","1993-94",31,"HOU","NBA",9.8,82,82,2909,449,801,449,799,0,2,251,382,271,599,870,189,66,28,185,253,1149,15.63
423,"Mo Williams\willima01","2008-09",26,"CLE","NBA",9.8,81,81,2834,526,1126,343,706,183,420,208,228,47,232,279,329,69,9,179,215,1443,15.73
424,"Shareef Abdur-Rahim\abdursh01","2002-03",26,"ATL","NBA",9.7,81,81,3087,566,1183,545,1123,21,60,455,541,175,502,677,242,87,38,212,240,1608,18.84
425,"Steven Adams\adamsst01","2017-18",24,"OKC","NBA",9.7,76,76,2487,448,712,448,710,0,2,160,286,384,301,685,88,92,78,128,215,1056,15.38
426,"Ray Allen\allenra02","2007-08",32,"BOS","NBA",9.7,73,73,2624,439,986,259,534,180,452,215,237,75,193,268,225,65,16,127,147,1273,14.94
427,"Stacey Augmon\augmost01","1993-94",25,"ATL","NBA",9.7,82,82,2605,439,861,438,854,1,7,333,436,178,216,394,187,149,45,147,179,1212,14.79
428,"Chris Bosh\boshch01","2008-09",24,"TOR","NBA",9.7,77,77,2928,615,1263,603,1214,12,49,504,617,215,556,771,191,67,77,174,189,1746,21.11
429,"Elton Brand\brandel01","2003-04",24,"LAC","NBA",9.7,69,68,2670,484,982,484,981,0,1,411,532,269,445,714,227,64,154,193,229,1379,21.06
430,"Stephen Curry\curryst01","2018-19",30,"GSW","NBA",9.7,69,69,2331,632,1340,278,530,354,810,263,287,45,324,369,361,92,25,192,166,1881,24.58
431,"Manu Ginóbili\ginobma01","2009-10",32,"SAS","NBA",9.7,75,21,2150,398,903,266,553,132,350,309,355,68,216,284,370,103,24,154,154,1237,16.51
432,"George Hill\hillge01","2012-13",26,"IND","NBA",9.7,76,76,2620,386,871,256,518,130,353,174,213,47,237,284,355,81,26,116,134,1076,14.03
433,"Dwight Howard\howardw01","2006-07",21,"ORL","NBA",9.7,82,82,3023,526,873,525,871,1,2,390,666,283,725,1008,158,70,156,317,245,1443,19.82
434,"Nikola Jokić\jokicni01","2016-17",21,"DEN","NBA",9.7,73,59,2038,494,854,449,715,45,139,188,228,212,506,718,359,61,55,171,214,1221,19.76
435,"Lamar Odom\odomla01","2007-08",28,"LAL","NBA",9.7,77,77,2921,417,795,386,682,31,113,229,328,197,622,819,273,75,72,156,222,1094,17
436,"Hakeem Olajuwon\olajuha01","1995-96",33,"HOU","NBA",9.7,72,72,2797,768,1494,765,1480,3,14,397,548,176,608,784,257,113,207,247,242,1936,26.23
437,"Zach Randolph\randoza01","2009-10",28,"MEM","NBA",9.7,81,81,3051,652,1336,637,1284,15,52,362,465,330,620,950,149,80,34,174,226,1681,19.18
438,"Michael Redd\reddmi01","2003-04",24,"MIL","NBA",9.7,82,82,3021,633,1439,506,1076,127,363,383,441,118,289,407,185,81,6,116,152,1776,16.78
439,"Arvydas Sabonis\sabonar01","1997-98",33,"POR","NBA",9.7,73,73,2333,407,826,377,711,30,115,323,405,149,580,729,218,65,80,190,267,1167,17.59
440,"Isaiah Thomas\thomais02","2015-16",26,"BOS","NBA",9.7,82,79,2644,591,1382,424,917,167,465,474,544,46,197,243,509,91,9,220,167,1823,19.69
441,"Rasheed Wallace\wallara01","2001-02",27,"POR","NBA",9.7,79,79,2963,603,1287,489,970,114,317,201,274,136,509,645,152,101,101,131,212,1521,17.32
442,"Chris Bosh\boshch01","2009-10",25,"TOR","NBA",9.6,70,70,2526,600,1158,592,1136,8,22,470,590,205,554,759,166,43,68,169,170,1678,22.43
443,"Chris Bosh\boshch01","2006-07",22,"TOR","NBA",9.6,69,69,2658,543,1094,531,1059,12,35,463,590,186,555,741,175,39,90,179,163,1561,21.49
444,"Sam Cassell\cassesa01","2002-03",33,"MIL","NBA",9.6,78,77,2700,546,1162,487,999,59,163,385,447,57,285,342,450,88,14,177,216,1536,18.79
445,"DeMar DeRozan\derozde01","2017-18",28,"TOR","NBA",9.6,80,80,2711,645,1413,556,1126,89,287,461,559,59,256,315,417,85,22,175,151,1840,19.85
446,"Tim Duncan\duncati01","2014-15",38,"SAS","NBA",9.6,77,77,2227,419,819,417,812,2,7,230,311,170,534,704,230,63,151,131,165,1070,16.15
447,"Patrick Ewing\ewingpa01","1994-95",32,"NYK","NBA",9.6,79,79,2920,730,1452,724,1431,6,21,420,560,157,710,867,212,68,159,256,272,1886,22.53
448,"Kevin Garnett\garneke01","1997-98",21,"MIN","NBA",9.6,82,82,3222,635,1293,632,1277,3,16,245,332,222,564,786,348,139,150,192,224,1518,19.93
449,"Nenê Hilário\hilarne01","2010-11",28,"DEN","NBA",9.6,75,75,2291,402,654,401,649,1,5,286,402,145,426,571,149,84,73,134,238,1091,16.21
450,"Serge Ibaka\ibakase01","2013-14",24,"OKC","NBA",9.6,81,81,2666,524,978,501,918,23,60,156,199,224,485,709,85,39,219,123,233,1227,15.68
451,"Andre Iguodala\iguodan01","2007-08",24,"PHI","NBA",9.6,82,82,3242,582,1277,481,970,101,307,365,506,85,361,446,391,171,49,214,187,1630,19.15
452,"Larry Johnson\johnsla02","1992-93",23,"CHH","NBA",9.6,82,82,3323,728,1385,710,1314,18,71,336,438,281,583,864,353,53,27,227,187,1810,21.41
453,"Eddie Jones\jonesed02","1996-97",25,"LAL","NBA",9.6,80,80,2998,473,1081,321,692,152,389,276,337,90,236,326,270,189,49,169,226,1374,16.56
454,"Jason Kidd\kiddja01","2000-01",27,"PHO","NBA",9.6,77,76,3065,451,1097,382,865,69,232,328,403,91,403,494,753,166,23,286,171,1299,20.63
455,"Damian Lillard\lillada01","2013-14",23,"POR","NBA",9.6,82,82,2937,553,1304,335,750,218,554,371,426,35,253,288,457,64,22,193,197,1695,18.24
456,"Karl Malone\malonka01","1998-99",35,"UTA","NBA",9.6,49,49,1832,393,797,393,796,0,1,378,480,107,356,463,201,62,28,162,134,1164,23.06
457,"Stephon Marbury\marbust01","2002-03",25,"PHO","NBA",9.6,81,81,3240,671,1530,582,1234,89,296,375,467,53,210,263,654,108,20,263,200,1806,20.39
458,"Brad Miller\millebr01","2002-03",26,"IND","NBA",9.6,73,72,2270,329,667,324,651,5,16,292,357,185,418,603,193,65,43,118,203,955,14.59
459,"Dikembe Mutombo\mutomdi01","2001-02",35,"PHI","NBA",9.6,80,80,2907,321,641,321,641,0,0,278,364,254,609,863,83,29,190,156,242,920,14.13
460,"Tony Parker\parketo01","2006-07",24,"SAS","NBA",9.6,77,77,2499,570,1096,555,1058,15,38,274,350,34,216,250,420,82,6,191,137,1429,17.4
461,"Tony Parker\parketo01","2005-06",23,"SAS","NBA",9.6,80,80,2715,623,1136,612,1100,11,36,253,358,38,223,261,460,83,4,249,161,1510,17.93
462,"Clifford Robinson\robincl02","1999-00",33,"PHO","NBA",9.6,80,67,2839,530,1142,410,818,120,324,298,381,105,254,359,224,90,61,166,239,1478,16.13
463,"Rajon Rondo\rondora01","2009-10",23,"BOS","NBA",9.6,81,81,2963,459,904,442,824,17,80,175,282,100,260,360,794,189,11,246,198,1110,18.7
464,"Jason Terry\terryja01","2005-06",28,"DAL","NBA",9.6,80,80,2798,516,1099,345,683,171,416,168,210,31,127,158,306,100,27,135,196,1371,14.85
465,"Dwyane Wade\wadedw01","2012-13",31,"MIA","NBA",9.6,69,69,2391,569,1093,552,1027,17,66,308,425,86,258,344,352,128,56,194,140,1463,20.72
466,"LaMarcus Aldridge\aldrila01","2008-09",23,"POR","NBA",9.5,81,81,3004,601,1243,594,1215,7,28,261,334,234,371,605,157,77,77,121,207,1470,15.97
467,"Ray Allen\allenra02","2005-06",30,"SEA","NBA",9.5,78,78,3022,681,1500,412,847,269,653,324,359,71,261,332,286,105,16,188,151,1955,20.67
468,"Carmelo Anthony\anthoca01","2012-13",28,"NYK","NBA",9.5,67,67,2482,669,1489,512,1075,157,414,425,512,134,326,460,171,52,32,175,205,1920,22.22
469,"Chauncey Billups\billuch01","2009-10",33,"DEN","NBA",9.5,73,73,2490,402,962,245,555,157,407,466,512,25,203,228,409,82,9,177,153,1427,18.65
470,"Tyson Chandler\chandty01","2011-12",29,"NYK","NBA",9.5,62,62,2061,241,355,241,353,0,2,217,315,212,400,612,56,56,89,102,186,699,14.68
471,"Derrick Coleman\colemde01","1992-93",25,"NJN","NBA",9.5,76,73,2759,564,1226,541,1127,23,99,421,521,247,605,852,276,92,126,243,210,1572,21.23
472,"Anthony Davis\davisan02","2018-19",25,"NOP","NBA",9.5,56,56,1850,530,1026,482,881,48,145,344,433,174,498,672,218,88,135,112,132,1452,27.04
473,"Vlade Divac\divacvl01","1994-95",26,"LAL","NBA",9.5,80,80,2807,485,957,475,904,10,53,297,382,261,568,829,329,109,174,205,305,1277,19.5
474,"Horace Grant\grantho01","1994-95",29,"ORL","NBA",9.5,74,74,2693,401,707,401,699,0,8,146,211,223,492,715,173,76,88,85,203,948,15.3
475,"Hersey Hawkins\hawkihe01","1995-96",29,"SEA","NBA",9.5,82,82,2823,443,936,297,556,146,380,249,285,86,211,297,218,149,14,164,172,1281,14.86
476,"Jeff Hornacek\hornaje01","1997-98",34,"UTA","NBA",9.5,80,80,2460,399,828,343,701,56,127,285,322,65,205,270,349,109,15,132,175,1139,14.7
477,"Kawhi Leonard\leonaka01","2018-19",27,"TOR","NBA",9.5,60,60,2040,560,1129,448,827,112,302,364,426,78,361,439,199,106,24,121,87,1596,24.04
478,"Rashard Lewis\lewisra02","2008-09",29,"ORL","NBA",9.5,79,79,2859,478,1089,258,535,220,554,225,269,92,361,453,205,81,51,158,194,1401,15.87
479,"Robin Lopez\lopezro01","2013-14",25,"POR","NBA",9.5,82,82,2603,355,644,355,643,0,1,198,242,326,374,700,73,25,139,84,196,908,12.62
480,"Kevin Martin\martike02","2010-11",27,"HOU","NBA",9.5,80,80,2603,553,1267,377,808,176,459,594,669,28,230,258,198,80,15,184,155,1876,18.91
481,"Reggie Miller\millere01","2001-02",36,"IND","NBA",9.5,79,79,2889,414,913,234,470,180,443,296,325,23,196,219,253,88,10,120,143,1304,14.92
482,"Gerald Wallace\wallage01","2008-09",26,"CHA","NBA",9.5,71,71,2669,389,811,350,680,39,131,365,454,112,441,553,189,121,67,148,210,1182,17.69
483,"Hassan Whiteside\whiteha01","2016-17",27,"MIA","NBA",9.5,77,77,2513,542,973,542,973,0,0,225,358,293,795,1088,57,57,161,154,226,1309,18.65
484,"Carmelo Anthony\anthoca01","2005-06",21,"DEN","NBA",9.4,80,80,2941,756,1572,719,1420,37,152,573,709,122,272,394,216,88,42,218,229,2122,21.2
485,"Charles Barkley\barklch01","1996-97",33,"HOU","NBA",9.4,53,53,2009,335,692,277,487,58,205,288,415,212,504,716,248,69,25,151,153,1016,21.91
486,"Mookie Blaylock\blaylmo01","1994-95",27,"ATL","NBA",9.4,80,80,3069,509,1198,310,643,199,555,156,214,117,276,393,616,200,26,242,164,1373,19.02
487,"Carlos Boozer\boozeca01","2003-04",22,"CLE","NBA",9.4,75,75,2592,471,900,470,894,1,6,219,285,230,627,857,148,74,55,134,199,1162,16.71
488,"Elton Brand\brandel01","2010-11",31,"PHI","NBA",9.4,81,81,2809,502,981,502,980,0,1,213,273,237,439,676,120,92,106,101,244,1217,15.16
489,"Kobe Bryant\bryanko01","2009-10",31,"LAL","NBA",9.4,73,73,2835,716,1569,617,1268,99,301,439,541,78,313,391,365,113,20,233,187,1970,22.69
490,"Vince Carter\cartevi01","2004-05",28,"TOT","NBA",9.4,77,76,2828,696,1541,569,1228,127,313,367,460,106,295,401,327,109,48,168,243,1886,20.52
491,"Tyson Chandler\chandty01","2010-11",28,"DAL","NBA",9.4,74,74,2059,266,407,266,407,0,0,216,295,206,486,692,32,36,80,88,240,748,12.56
492,"Al Horford\horfoal01","2015-16",29,"ATL","NBA",9.4,82,82,2631,529,1048,441,792,88,256,103,129,148,448,596,263,68,121,107,163,1249,15.75
493,"Serge Ibaka\ibakase01","2012-13",23,"OKC","NBA",9.4,80,80,2486,446,778,426,721,20,57,143,191,222,395,617,43,28,242,125,213,1055,14.3
494,"Zydrunas Ilgauskas\ilgauzy01","1997-98",22,"CLE","NBA",9.4,82,81,2379,454,876,453,872,1,4,230,302,279,444,723,71,52,135,146,288,1139,14.2
495,"DeAndre Jordan\jordade01","2017-18",29,"LAC","NBA",9.4,77,77,2424,373,578,373,578,0,0,181,312,329,842,1171,117,39,71,137,203,927,16.34
496,"Antonio McDyess\mcdyean01","1997-98",23,"PHO","NBA",9.4,81,81,2441,497,927,497,925,0,2,231,329,206,407,613,106,100,135,142,292,1225,15.43
497,"Alonzo Mourning\mournal01","1994-95",24,"CHH","NBA",9.4,77,77,2941,571,1101,560,1067,11,34,490,644,200,561,761,111,49,225,241,275,1643,21.14
498,"Dikembe Mutombo\mutomdi01","1993-94",27,"DEN","NBA",9.4,82,82,2853,365,642,365,641,0,1,256,439,286,685,971,127,59,336,206,262,986,16.84
499,"Otto Porter\porteot01","2016-17",23,"WAS","NBA",9.4,80,80,2605,414,803,266,462,148,341,99,119,118,396,514,121,116,42,44,193,1075,13.83
500,"Tayshaun Prince\princta01","2004-05",24,"DET","NBA",9.4,82,82,3039,469,963,422,825,47,138,221,274,133,302,435,247,56,71,135,161,1206,14.04
501,"Russell Westbrook\westbru01","2010-11",22,"OKC","NBA",9.4,82,82,2847,614,1390,580,1287,34,103,531,631,121,258,379,670,155,30,316,207,1793,22.22
502,"LaMarcus Aldridge\aldrila01","2018-19",33,"SAS","NBA",9.3,81,81,2687,684,1319,674,1277,10,42,349,412,251,493,744,194,43,107,144,179,1727,19.8
503,"Mike Bibby\bibbymi01","2003-04",25,"SAC","NBA",9.3,82,82,2980,527,1170,379,792,148,378,304,373,67,210,277,444,112,18,175,146,1506,17.27
504,"Vince Carter\cartevi01","2005-06",29,"NJN","NBA",9.3,79,79,2906,653,1518,528,1151,125,367,480,601,135,327,462,338,94,53,213,235,1911,20.43
505,"Tyson Chandler\chandty01","2012-13",30,"NYK","NBA",9.3,66,66,2164,255,400,255,400,0,0,179,258,269,434,703,62,42,75,87,188,689,13.61
506,"Rudy Gobert\goberru01","2014-15",22,"UTA","NBA",9.3,82,37,2158,258,427,258,425,0,2,170,273,265,510,775,109,64,189,111,175,686,12.58
507,"A.C. Green\greenac01","1993-94",30,"PHO","NBA",9.3,82,55,2825,465,926,457,891,8,35,266,362,275,478,753,137,70,38,100,142,1204,14.6
508,"James Harden\hardeja01","2011-12",22,"OKC","NBA",9.3,62,2,1946,309,629,195,337,114,292,312,369,30,222,252,229,62,15,137,150,1044,16.74
509,"Nenê Hilário\hilarne01","2008-09",26,"DEN","NBA",9.3,77,76,2510,428,709,427,704,1,5,266,368,183,415,598,108,95,101,147,278,1123,16.07
510,"Jason Kidd\kiddja01","2006-07",33,"NJN","NBA",9.3,80,80,2933,369,908,245,547,124,361,179,230,135,520,655,736,127,23,213,146,1041,18.16
511,"Anthony Mason\masonan01","1997-98",31,"CHH","NBA",9.3,81,80,3148,389,764,389,760,0,4,261,402,177,649,826,342,68,18,146,182,1039,15.48
512,"Mehmet Okur\okurme01","2005-06",26,"UTA","NBA",9.3,82,82,2945,519,1128,439,894,80,234,354,454,211,535,746,194,40,73,163,285,1472,16.77
513,"Tony Parker\parketo01","2012-13",30,"SAS","NBA",9.3,66,66,2174,519,995,495,927,24,68,279,330,18,180,198,499,54,6,170,92,1341,19.98
514,"Gary Payton\paytoga01","1993-94",25,"SEA","NBA",9.3,82,82,2881,584,1159,569,1105,15,54,166,279,105,164,269,494,188,19,173,227,1349,16.84
515,"Glen Rice\ricegl01","1997-98",30,"CHH","NBA",9.3,82,82,3295,634,1386,504,1086,130,300,428,504,89,264,353,182,77,22,182,200,1826,17.56
516,"Mitch Richmond\richmmi01","1995-96",30,"SAC","NBA",9.3,81,81,2946,611,1368,386,853,225,515,425,491,54,215,269,255,125,19,220,233,1872,19.22
517,"Pascal Siakam\siakapa01","2018-19",24,"TOR","NBA",9.3,80,79,2548,519,945,440,731,79,214,237,302,124,425,549,248,73,52,154,241,1354,17.21
518,"Josh Smith\smithjo03","2009-10",24,"ATL","NBA",9.3,81,81,2871,504,999,504,992,0,7,261,422,223,482,705,342,130,172,198,240,1269,18.26
519,"Rod Strickland\stricro02","1993-94",27,"POR","NBA",9.3,82,58,2889,528,1093,526,1083,2,10,353,471,122,248,370,740,147,24,257,171,1411,20
520,"Rasheed Wallace\wallara01","1999-00",25,"POR","NBA",9.3,81,77,2845,542,1045,534,995,8,50,233,331,129,437,566,142,87,107,157,216,1325,15.54
521,"Chris Webber\webbech01","1996-97",23,"WSB","NBA",9.3,72,72,2806,604,1167,544,1016,60,151,177,313,238,505,743,331,122,137,230,258,1445,21.7
522,"Sam Cassell\cassesa01","1999-00",30,"MIL","NBA",9.2,81,81,2899,545,1170,519,1080,26,90,390,445,69,232,301,729,102,8,267,255,1506,20.02
523,"Paul George\georgpa01","2015-16",25,"IND","NBA",9.2,81,81,2819,605,1449,395,883,210,566,454,528,79,484,563,329,152,29,265,230,1874,20.99
524,"Blake Griffin\griffbl01","2011-12",22,"LAC","NBA",9.2,66,66,2392,561,1022,559,1006,2,16,244,468,218,499,717,210,54,48,150,216,1368,19.83
525,"Udonis Haslem\hasleud01","2004-05",24,"MIA","NBA",9.2,80,80,2675,346,641,346,637,0,4,178,225,239,487,726,108,63,41,113,260,870,12.48
526,"Andre Iguodala\iguodan01","2008-09",25,"PHI","NBA",9.2,82,82,3269,542,1147,462,886,80,261,377,521,92,379,471,434,131,36,222,152,1541,18.85
527,"Allen Iverson\iversal01","2002-03",27,"PHI","NBA",9.2,82,82,3485,804,1940,720,1637,84,303,570,736,68,276,344,454,225,13,286,149,2262,22.55
528,"Antawn Jamison\jamisan01","2007-08",31,"WAS","NBA",9.2,79,79,3061,618,1417,498,1063,120,354,333,438,215,591,806,120,106,34,113,195,1689,18.21
529,"Andrei Kirilenko\kirilan01","2002-03",21,"UTA","NBA",9.2,80,11,2213,315,642,278,528,37,114,296,370,147,273,420,138,118,175,136,185,963,13.94
530,"Damian Lillard\lillada01","2015-16",25,"POR","NBA",9.2,75,75,2676,618,1474,389,864,229,610,414,464,45,257,302,512,65,28,242,165,1879,21.84
531,"Lamar Odom\odomla01","2005-06",26,"LAL","NBA",9.2,80,80,3221,445,925,365,710,80,215,216,313,181,557,738,443,75,64,213,256,1186,17.54
532,"Ben Simmons\simmobe01","2017-18",21,"PHI","NBA",9.2,81,81,2732,544,998,544,987,0,11,191,341,145,514,659,661,140,70,278,211,1279,20.41
533,"Jerry Stackhouse\stackje01","2000-01",26,"DET","NBA",9.2,80,80,3215,774,1927,608,1454,166,473,666,810,99,216,315,410,97,54,326,160,2380,22.89
534,"Steven Adams\adamsst01","2018-19",25,"OKC","NBA",9.1,80,80,2669,481,809,481,807,0,2,146,292,391,369,760,124,117,76,135,204,1108,15.46
535,"Ray Allen\allenra02","2002-03",27,"TOT","NBA",9.1,76,75,2880,598,1363,397,830,201,533,316,345,94,287,381,334,103,14,198,220,1713,19.55
536,"Shane Battier\battish01","2005-06",27,"MEM","NBA",9.1,81,81,2839,303,621,238,456,65,165,147,208,164,265,429,136,92,114,90,223,818,11.34
537,"Jimmy Butler\butleji01","2015-16",26,"CHI","NBA",9.1,67,67,2474,470,1035,406,830,64,205,395,475,79,279,358,321,110,43,132,124,1399,19.98
538,"Stephen Curry\curryst01","2017-18",29,"GSW","NBA",9.1,51,51,1631,428,864,216,363,212,501,278,302,36,225,261,310,80,8,153,114,1346,25.68
539,"Joe Dumars\dumarjo01","1992-93",29,"DET","NBA",9.1,77,77,3094,677,1454,565,1155,112,299,343,397,63,85,148,308,78,7,138,141,1809,18.16
540,"Manu Ginóbili\ginobma01","2003-04",26,"SAS","NBA",9.1,77,38,2260,330,789,242,544,88,245,239,298,86,258,344,291,136,16,161,181,987,13.4
541,"Horace Grant\grantho01","1992-93",27,"CHI","NBA",9.1,77,77,2745,421,829,420,824,1,5,174,281,341,388,729,201,89,96,110,218,1017,14.95
542,"Kyrie Irving\irvinky01","2018-19",26,"BOS","NBA",9.1,67,67,2214,604,1241,430,807,174,434,214,245,71,264,335,464,103,34,172,167,1596,23.02
543,"Avery Johnson\johnsav01","1995-96",30,"SAS","NBA",9.1,82,82,3084,438,887,432,856,6,31,189,262,37,169,206,789,119,21,195,179,1071,16.64
544,"Eddie Jones\jonesed02","2003-04",32,"MIA","NBA",9.1,81,81,2998,473,1156,296,677,177,479,278,333,38,270,308,258,92,34,129,226,1401,14.55
545,"Shawn Kemp\kempsh01","1992-93",23,"SEA","NBA",9.1,78,68,2582,515,1047,515,1043,0,4,358,503,287,546,833,155,119,146,217,327,1388,18.79
546,"David Lee\leeda02","2012-13",29,"GSW","NBA",9.1,79,79,2907,602,1160,602,1156,0,4,255,320,218,668,886,279,67,22,207,246,1459,18.91
547,"Stephon Marbury\marbust01","2003-04",26,"TOT","NBA",9.1,81,81,3254,598,1386,511,1112,87,274,356,436,58,205,263,719,129,9,249,172,1639,20
548,"Shawn Marion\mariosh01","2003-04",25,"PHO","NBA",9.1,79,79,3217,590,1341,500,1076,90,265,228,268,212,525,737,214,167,104,156,203,1498,18.53
549,"Brad Miller\millebr01","2005-06",29,"SAC","NBA",9.1,79,79,2923,434,877,400,789,34,88,280,338,122,493,615,374,61,62,180,234,1182,16.84
550,"Hakeem Olajuwon\olajuha01","1996-97",34,"HOU","NBA",9.1,78,78,2852,727,1426,722,1410,5,16,351,446,173,543,716,236,117,173,281,249,1810,22.49
551,"Gary Payton\paytoga01","2002-03",34,"TOT","NBA",9.1,80,80,3208,665,1466,611,1284,54,182,250,352,79,255,334,663,133,20,187,181,1634,19.72
552,"Brandon Roy\roybr01","2009-10",25,"POR","NBA",9.1,65,65,2419,491,1038,418,817,73,221,343,440,73,212,285,305,61,16,129,136,1398,18.9
553,"Steve Smith\smithst01","1996-97",27,"ATL","NBA",9.1,72,72,2818,491,1145,361,757,130,388,333,393,90,148,238,305,62,23,176,173,1445,16.7
554,"David West\westda01","2012-13",32,"IND","NBA",9.1,73,73,2435,502,1009,498,990,4,19,242,315,145,418,563,213,74,69,157,149,1250,16.6
555,"Shane Battier\battish01","2006-07",28,"HOU","NBA",9,82,82,2988,292,654,135,281,157,373,88,113,67,271,338,175,79,60,72,190,829,10.45
556,"Mookie Blaylock\blaylmo01","1995-96",28,"ATL","NBA",9,81,81,2893,455,1123,224,500,231,623,127,170,110,222,332,478,212,17,188,151,1268,16.52
557,"Chris Bosh\boshch01","2012-13",28,"MIA","NBA",9,74,74,2454,485,907,464,833,21,74,241,302,131,370,501,123,66,101,128,168,1232,16.08
558,"DeMar DeRozan\derozde01","2016-17",27,"TOR","NBA",9,74,74,2620,721,1545,688,1421,33,124,545,647,70,316,386,290,78,13,180,134,2020,22.04
559,"Monta Ellis\ellismo01","2007-08",22,"GSW","NBA",9,81,72,3071,652,1227,640,1175,12,52,320,417,133,271,404,315,124,27,173,195,1636,18.82
560,"Kevin Garnett\garneke01","2010-11",34,"BOS","NBA",9,71,71,2220,434,822,433,817,1,5,187,217,83,548,631,171,95,57,115,148,1056,16.19
561,"Paul George\georgpa01","2012-13",22,"IND","NBA",9,79,79,2972,493,1176,323,707,170,469,221,274,88,515,603,327,143,51,233,227,1377,17.45
562,"Blake Griffin\griffbl01","2014-15",25,"LAC","NBA",9,67,67,2356,574,1144,564,1119,10,25,311,427,126,382,508,354,63,35,152,196,1469,20.74
563,"Allen Iverson\iversal01","1997-98",22,"PHI","NBA",9,80,80,3150,649,1407,579,1172,70,235,390,535,86,210,296,494,176,25,244,200,1758,20.4
564,"Allen Iverson\iversal01","2004-05",29,"PHI","NBA",9,75,75,3174,771,1818,667,1480,104,338,656,786,51,248,299,596,180,9,344,140,2302,26.79
565,"Antawn Jamison\jamisan01","2003-04",27,"DAL","NBA",9,82,2,2376,488,913,472,873,16,40,220,294,233,287,520,70,83,30,81,174,1212,13.41
566,"David Lee\leeda02","2008-09",25,"NYK","NBA",9,81,74,2824,522,951,522,948,0,3,249,330,256,695,951,174,80,22,150,260,1293,17.3
567,"Brook Lopez\lopezbr01","2012-13",24,"BRK","NBA",9,74,74,2253,570,1094,570,1093,0,1,297,392,208,304,512,70,33,154,131,152,1437,16.97
568,"Jamal Mashburn\mashbja01","2002-03",30,"NOH","NBA",9,82,81,3321,670,1586,551,1280,119,306,313,369,66,432,498,462,83,17,230,196,1772,18.6
569,"Joakim Noah\noahjo01","2011-12",26,"CHI","NBA",9,64,64,1945,249,490,249,489,0,1,154,206,242,387,629,160,41,92,92,162,652,13.39
570,"Jermaine O'Neal\onealje01","2003-04",25,"IND","NBA",9,78,78,2788,608,1400,606,1382,2,18,348,460,193,585,778,164,59,199,181,248,1566,18.06
571,"Shaquille O'Neal\onealsh01","1998-99",26,"LAL","NBA",9,49,49,1705,510,885,510,884,0,1,269,498,187,338,525,114,36,82,122,155,1289,23.78
572,"Glen Rice\ricegl01","1999-00",32,"LAL","NBA",9,80,80,2530,421,980,337,751,84,229,346,396,56,271,327,176,47,12,114,179,1272,13.05
573,"John Stockton\stockjo01","2002-03",40,"UTA","NBA",9,82,82,2275,309,640,280,560,29,80,237,287,51,150,201,629,137,16,182,184,884,14.74
574,"Hedo Türkoğlu\turkohe01","2007-08",28,"ORL","NBA",9,82,82,3026,556,1219,390,804,166,415,324,391,83,388,471,409,74,25,246,244,1602,18.42
575,"Ray Allen\allenra02","2001-02",26,"MIL","NBA",8.9,69,67,2525,530,1148,301,620,229,528,214,245,81,231,312,271,88,18,159,157,1503,19.04
576,"Ryan Anderson\anderry01","2011-12",23,"ORL","NBA",8.9,61,61,1964,332,757,166,335,166,422,150,171,224,247,471,54,50,26,57,146,980,14.24
577,"Jimmy Butler\butleji01","2017-18",28,"MIN","NBA",8.9,59,59,2164,437,921,367,721,70,200,363,425,79,235,314,288,116,24,108,78,1307,21.56
578,"Doug Christie\chrisdo01","2002-03",32,"SAC","NBA",8.9,80,80,2710,267,557,194,372,73,185,141,174,61,281,342,376,180,37,144,186,748,13.22
579,"Erick Dampier\dampier01","2003-04",28,"GSW","NBA",8.9,74,74,2403,348,650,348,648,0,2,217,332,344,543,887,60,33,137,131,227,913,14.55
580,"Baron Davis\davisba01","2000-01",21,"CHH","NBA",8.9,82,82,3192,409,957,324,683,85,274,228,337,129,279,408,598,170,36,226,267,1131,16.56
581,"Boris Diaw\diawbo01","2005-06",23,"PHO","NBA",8.9,81,70,2874,449,853,441,823,8,30,174,238,159,399,558,503,58,85,189,260,1080,16.42
582,"Mario Elie\eliema01","1996-97",33,"HOU","NBA",8.9,78,77,2687,291,585,171,299,120,286,207,231,60,175,235,310,92,12,135,200,909,13.05
583,"Paul George\georgpa01","2017-18",27,"OKC","NBA",8.9,79,79,2891,576,1340,332,731,244,609,338,411,72,375,447,263,161,39,212,233,1734,19.6
584,"Gordon Hayward\haywago01","2015-16",25,"UTA","NBA",8.9,80,80,2893,521,1202,378,792,143,410,393,477,61,336,397,296,95,27,202,183,1578,17.39
585,"Kyrie Irving\irvinky01","2016-17",24,"CLE","NBA",8.9,72,72,2525,671,1420,494,979,177,441,297,328,52,178,230,418,83,24,180,157,1816,21.7
586,"Kyrie Irving\irvinky01","2017-18",25,"BOS","NBA",8.9,60,60,1931,534,1087,368,680,166,407,232,261,33,194,227,306,65,17,140,122,1466,21.48
587,"Jason Kidd\kiddja01","2009-10",36,"DAL","NBA",8.9,80,80,2881,284,671,108,257,176,414,80,99,48,397,445,724,145,35,195,142,824,16.43
588,"Jason Kidd\kiddja01","2001-02",28,"NJN","NBA",8.9,82,82,3056,445,1138,328,774,117,364,201,247,130,465,595,808,175,20,286,136,1208,19.07
589,"Anthony Mason\masonan01","1999-00",33,"CHH","NBA",8.9,82,81,3133,317,661,317,660,0,1,314,421,145,554,699,367,74,29,160,220,948,14.64
590,"Reggie Miller\millere01","2003-04",38,"IND","NBA",8.9,80,80,2254,260,594,126,260,134,334,146,165,18,170,188,249,65,11,68,96,800,10.04
591,"Chris Mills\millsch01","1996-97",27,"CLE","NBA",8.9,80,79,3167,405,894,319,674,86,220,176,209,118,379,497,198,86,41,120,222,1072,13.09
592,"Charles Oakley\oaklech01","1996-97",33,"NYK","NBA",8.9,80,80,2873,339,694,334,675,5,19,181,224,246,535,781,221,111,21,171,305,864,13.62
593,"Rasheed Wallace\wallara01","2005-06",31,"DET","NBA",8.9,80,80,2780,459,1067,304,633,155,434,136,183,90,457,547,182,82,130,85,232,1209,14.33
594,"Shareef Abdur-Rahim\abdursh01","1999-00",23,"VAN","NBA",8.8,82,82,3223,594,1277,565,1181,29,96,446,551,218,607,825,271,89,87,249,244,1663,19.93
595,"LaMarcus Aldridge\aldrila01","2009-10",24,"POR","NBA",8.8,78,78,2922,579,1169,574,1153,5,16,230,304,192,435,627,160,67,48,104,231,1393,15.9
596,"Charles Barkley\barklch01","1993-94",30,"PHO","NBA",8.8,65,65,2298,518,1046,470,868,48,178,318,452,198,529,727,296,101,37,206,160,1402,22.28
597,"DeMar DeRozan\derozde01","2013-14",24,"TOR","NBA",8.8,79,79,3017,604,1407,540,1197,64,210,519,630,51,292,343,313,86,28,176,197,1791,18.55
598,"Joe Dumars\dumarjo01","1996-97",33,"DET","NBA",8.8,79,79,2923,385,875,219,491,166,384,222,256,38,153,191,318,57,1,128,97,1158,13.2
599,"Kendall Gill\gillke01","1996-97",28,"NJN","NBA",8.8,82,81,3199,644,1453,570,1233,74,220,427,536,183,316,499,326,154,46,218,225,1789,19.51
600,"Manu Ginóbili\ginobma01","2005-06",28,"SAS","NBA",8.8,65,56,1813,309,669,226,452,83,217,280,360,42,188,230,235,101,26,121,156,981,15.08
601,"Matt Harpring\harprma01","2002-03",26,"UTA","NBA",8.8,78,69,2557,521,1020,455,860,66,160,262,331,190,324,514,133,73,17,160,217,1370,15.65
602,"Al Horford\horfoal01","2012-13",26,"ATL","NBA",8.8,74,74,2756,576,1060,573,1054,3,6,134,208,195,562,757,240,78,78,147,163,1289,18.26
603,"Josh Howard\howarjo01","2006-07",26,"DAL","NBA",8.8,70,69,2455,493,1075,401,836,92,239,243,294,130,345,475,127,82,56,123,180,1321,16.36
604,"Andre Miller\millean02","2003-04",27,"DEN","NBA",8.8,82,82,2838,430,941,418,876,12,65,342,411,127,239,366,501,142,25,215,194,1214,16.54
605,"Andre Miller\millean02","2008-09",32,"PHI","NBA",8.8,82,82,2976,492,1041,477,988,15,53,338,409,123,245,368,534,109,14,199,196,1337,17.27
606,"Dikembe Mutombo\mutomdi01","1992-93",26,"DEN","NBA",8.8,82,82,3029,398,781,398,781,0,0,335,492,344,726,1070,147,43,287,216,284,1131,17.75
607,"Steve Nash\nashst01","2003-04",29,"DAL","NBA",8.8,78,78,2612,397,845,293,588,104,257,230,251,59,173,232,687,67,8,209,139,1128,17.09
608,"Mehmet Okur\okurme01","2006-07",27,"UTA","NBA",8.8,80,80,2664,490,1061,361,725,129,336,296,387,160,419,579,156,36,38,125,257,1405,15.32
609,"Chris Paul\paulch01","2006-07",21,"NOK","NBA",8.8,64,64,2353,381,871,331,728,50,143,292,357,54,226,280,569,118,3,161,154,1104,19.55
610,"Terry Porter\portete01","1992-93",29,"POR","NBA",8.8,81,81,2883,503,1108,360,763,143,345,327,388,58,258,316,419,101,10,199,122,1476,17.34
611,"Bryon Russell\russebr01","1999-00",29,"UTA","NBA",8.8,82,70,2900,408,914,302,646,106,268,237,316,99,328,427,158,128,23,101,255,1159,13.13
612,"Dennis Scott\scottde01","1995-96",27,"ORL","NBA",8.8,82,82,3041,491,1117,224,489,267,628,182,222,63,246,309,243,90,29,122,169,1431,15.04
613,"Rod Strickland\stricro02","1996-97",30,"WSB","NBA",8.8,82,81,2997,515,1105,502,1028,13,77,367,497,95,240,335,727,143,14,270,166,1410,19.34
614,"Klay Thompson\thompkl01","2014-15",24,"GSW","NBA",8.8,77,77,2455,602,1299,363,754,239,545,225,256,27,220,247,222,87,60,149,122,1668,17.8
615,"Dwyane Wade\wadedw01","2006-07",25,"MIA","NBA",8.8,51,50,1931,472,962,451,883,21,79,432,535,51,188,239,384,107,62,216,117,1397,27.18
616,"John Wall\walljo01","2016-17",26,"WAS","NBA",8.8,78,78,2836,647,1435,558,1163,89,272,422,527,59,267,326,831,157,49,322,151,1805,24.62
617,"Darrell Armstrong\armstda01","2000-01",32,"ORL","NBA",8.7,75,75,2767,413,1002,270,599,143,403,220,249,94,249,343,524,135,13,200,155,1189,17.19
618,"Doug Christie\chrisdo01","2000-01",30,"SAC","NBA",8.7,81,81,2939,311,788,217,538,94,250,280,312,95,260,355,289,183,45,154,224,996,13.76
619,"Baron Davis\davisba01","2007-08",28,"GSW","NBA",8.7,82,82,3196,650,1526,477,1001,173,525,318,424,96,289,385,623,191,43,232,247,1791,21.36
620,"Tim Duncan\duncati01","1998-99",22,"SAS","NBA",8.7,50,50,1963,418,845,417,838,1,7,247,358,159,412,571,121,45,126,146,147,1084,21.23
621,"Sean Elliott\elliose01","1994-95",26,"SAS","NBA",8.7,81,81,2858,502,1072,366,739,136,333,326,404,63,224,287,206,78,38,151,216,1466,15.42
622,"Joel Embiid\embiijo01","2018-19",24,"PHI","NBA",8.7,64,64,2154,580,1199,501,936,79,263,522,649,160,711,871,234,46,122,226,211,1761,27.29
623,"Brian Grant\grantbr01","2000-01",28,"MIA","NBA",8.7,82,79,2771,484,1010,484,1009,0,1,282,354,217,501,718,101,60,71,170,293,1250,14.33
624,"Montrezl Harrell\harremo01","2018-19",25,"LAC","NBA",8.7,82,5,2158,546,888,543,871,3,17,266,414,184,351,535,162,71,110,132,255,1361,16.76
625,"Hersey Hawkins\hawkihe01","1994-95",28,"CHH","NBA",8.7,82,82,2731,390,809,259,511,131,298,261,301,60,254,314,262,122,18,150,178,1172,14.5
626,"Gordon Hayward\haywago01","2014-15",24,"UTA","NBA",8.7,76,76,2618,484,1087,364,757,120,330,375,462,54,319,373,313,108,30,206,131,1463,17.87
627,"Al Horford\horfoal01","2014-15",28,"ATL","NBA",8.7,76,76,2318,519,965,508,929,11,36,107,141,131,413,544,244,68,98,100,121,1156,15.78
628,"Zydrunas Ilgauskas\ilgauzy01","2005-06",30,"CLE","NBA",8.7,78,78,2283,450,889,450,884,0,5,317,380,245,346,591,91,38,136,155,280,1217,15.16
629,"Kevin Johnson\johnske02","1993-94",27,"PHO","NBA",8.7,67,67,2449,477,980,471,953,6,27,380,464,55,112,167,637,125,10,235,127,1340,21.73
630,"Damon Jones\jonesda01","2004-05",28,"MIA","NBA",8.7,82,66,2576,331,726,106,205,225,521,68,86,14,217,231,350,44,5,98,121,955,11.67
631,"Kevin Love\loveke01","2014-15",26,"CLE","NBA",8.7,75,75,2532,413,952,269,560,144,392,258,321,142,589,731,168,51,39,122,140,1228,15.87
632,"Yao Ming\mingya01","2002-03",22,"HOU","NBA",8.7,82,72,2382,401,805,400,803,1,2,301,371,196,479,675,137,31,147,173,230,1104,14.3
633,"Dikembe Mutombo\mutomdi01","1994-95",28,"DEN","NBA",8.7,82,82,3100,349,628,349,628,0,0,248,379,319,710,1029,113,40,321,192,284,946,16.45
634,"Clifford Robinson\robincl02","1994-95",28,"POR","NBA",8.7,75,73,2725,597,1320,455,937,142,383,265,382,152,271,423,198,79,82,158,240,1601,17.51
635,"Dennis Rodman\rodmade01","1993-94",32,"SAS","NBA",8.7,79,51,2989,156,292,151,268,5,24,53,102,453,914,1367,184,52,32,138,229,370,12.13
636,"Wally Szczerbiak\szczewa02","2001-02",24,"MIN","NBA",8.7,82,82,3117,609,1200,522,1009,87,191,226,272,120,271,391,257,66,21,181,188,1531,16.26
637,"Tristan Thompson\thomptr01","2015-16",24,"CLE","NBA",8.7,82,34,2269,247,420,247,420,0,0,149,242,268,470,738,62,38,51,61,202,643,10.04
638,"LaMarcus Aldridge\aldrila01","2014-15",29,"POR","NBA",8.6,71,71,2512,659,1415,622,1310,37,105,306,362,177,549,726,124,48,68,122,125,1661,19.5
639,"Charles Barkley\barklch01","1997-98",34,"HOU","NBA",8.6,68,41,2243,361,744,343,660,18,84,296,397,241,553,794,217,71,28,147,187,1036,17.34
640,"Muggsy Bogues\boguemu01","1994-95",30,"CHH","NBA",8.6,78,78,2629,348,730,342,700,6,30,160,180,51,206,257,675,103,0,132,151,862,14.88
641,"Terrell Brandon\brandte01","1999-00",29,"MIN","NBA",8.6,71,71,2587,486,1042,433,910,53,132,187,208,44,194,238,629,134,30,184,158,1212,19.14
642,"Sam Cassell\cassesa01","2001-02",32,"MIL","NBA",8.6,74,73,2605,554,1197,483,993,71,204,282,328,54,258,312,493,90,12,177,208,1461,18.85
643,"Doug Christie\chrisdo01","2001-02",31,"SAC","NBA",8.6,81,81,2798,338,735,248,479,90,256,206,242,74,300,374,340,160,25,164,209,972,14.12
644,"Ben Gordon\gordobe01","2006-07",23,"CHI","NBA",8.6,82,51,2704,609,1338,454,963,155,375,380,440,35,223,258,296,64,17,249,252,1753,17.35
645,"Marcin Gortat\gortama01","2014-15",30,"WAS","NBA",8.6,82,82,2453,439,775,439,772,0,3,123,175,180,537,717,97,49,110,100,191,1001,13.34
646,"A.C. Green\greenac01","1992-93",29,"LAL","NBA",8.6,82,55,2819,379,706,363,660,16,46,277,375,287,424,711,116,88,39,116,149,1051,14.03
647,"Hersey Hawkins\hawkihe01","1997-98",31,"SEA","NBA",8.6,82,82,2597,280,636,155,335,125,301,177,204,71,263,334,221,148,17,102,153,862,11.78
648,"Allan Houston\houstal01","1999-00",28,"NYK","NBA",8.6,82,82,3169,614,1271,508,1028,106,243,280,334,38,233,271,224,65,14,186,219,1614,15.71
649,"Dwight Howard\howardw01","2005-06",20,"ORL","NBA",8.6,82,81,3021,468,881,468,879,0,2,356,598,288,734,1022,125,65,115,217,277,1292,17.16
650,"Kawhi Leonard\leonaka01","2014-15",23,"SAS","NBA",8.6,64,64,2033,394,822,327,630,67,192,202,252,85,376,461,161,148,48,97,128,1057,17.15
651,"Rashard Lewis\lewisra02","2001-02",22,"SEA","NBA",8.6,71,70,2585,455,972,332,656,123,316,162,200,139,359,498,123,104,40,97,174,1195,15.47
652,"Corey Maggette\maggeco01","2003-04",24,"LAC","NBA",8.6,73,72,2628,453,1013,377,782,76,231,526,620,96,334,430,224,65,16,207,217,1508,18.46
653,"Anthony Mason\masonan01","1994-95",28,"NYK","NBA",8.6,77,11,2496,287,507,287,506,0,1,191,298,182,468,650,240,69,21,123,253,765,12.91
654,"Tracy McGrady\mcgratr01","2006-07",27,"HOU","NBA",8.6,71,71,2539,638,1480,512,1099,126,381,345,488,56,322,378,458,92,36,213,136,1747,21.1
655,"Brad Miller\millebr01","2004-05",28,"SAC","NBA",8.6,56,56,2089,319,609,314,590,5,19,233,287,139,382,521,220,69,68,82,181,876,18.48
656,"Yao Ming\mingya01","2005-06",25,"HOU","NBA",8.6,57,57,1949,467,900,467,899,0,1,337,395,148,433,581,85,30,94,147,195,1271,20.92
657,"Tony Parker\parketo01","2008-09",26,"SAS","NBA",8.6,72,71,2456,639,1263,620,1198,19,65,284,363,27,196,223,496,67,4,186,110,1581,19.82
658,"Scottie Pippen\pippesc01","1992-93",27,"CHI","NBA",8.6,81,81,3123,628,1327,606,1234,22,93,232,350,203,418,621,507,173,73,246,219,1510,19.91
659,"Luis Scola\scolalu01","2008-09",28,"HOU","NBA",8.6,82,82,2488,424,799,424,796,0,3,196,258,200,520,720,123,68,11,123,261,1044,13.16
660,"Jason Terry\terryja01","2007-08",30,"DAL","NBA",8.6,82,34,2579,471,1008,335,645,136,363,191,223,30,178,208,264,88,18,92,170,1269,13.51
661,"Jason Terry\terryja01","2001-02",24,"ATL","NBA",8.6,78,78,2967,524,1219,352,775,172,444,284,340,40,230,270,444,144,13,181,156,1504,18.07
662,"Kemba Walker\walkeke02","2017-18",27,"CHO","NBA",8.6,80,80,2736,588,1363,357,762,231,601,363,420,32,216,248,444,91,24,179,98,1770,19.33
663,"Clarence Weatherspoon\weathcl01","2000-01",30,"CLE","NBA",8.6,82,82,2774,347,692,347,692,0,0,230,291,223,573,796,103,85,105,112,171,924,13.45
664,"Chris Webber\webbech01","2001-02",28,"SAC","NBA",8.6,54,54,2071,532,1075,527,1056,5,19,253,338,150,396,546,258,90,76,158,181,1322,23.9
665,"Shareef Abdur-Rahim\abdursh01","2000-01",24,"VAN","NBA",8.5,81,81,3241,604,1280,592,1216,12,64,443,531,175,560,735,250,90,77,231,238,1663,19.58
666,"Bradley Beal\bealbr01","2016-17",23,"WAS","NBA",8.5,77,77,2684,637,1322,414,770,223,552,282,342,53,187,240,267,83,21,156,169,1779,19.03
667,"Mike Bibby\bibbymi01","2004-05",26,"SAC","NBA",8.5,80,80,3084,560,1264,429,900,131,364,320,413,77,255,332,541,124,30,203,191,1571,19.12
668,"Terrell Brandon\brandte01","2000-01",30,"MIN","NBA",8.5,78,78,2821,511,1134,478,1043,33,91,195,224,60,238,298,583,161,21,155,138,1250,17.33
669,"Marcus Camby\cambyma01","2007-08",33,"DEN","NBA",8.5,79,79,2758,286,635,280,615,6,20,143,202,230,807,1037,259,85,285,118,216,721,15.8
670,"Sam Cassell\cassesa01","2000-01",31,"MIL","NBA",8.5,76,75,2709,537,1132,507,1034,30,98,277,323,46,244,290,580,88,8,220,214,1381,18.43
671,"Dale Davis\davisda01","2001-02",32,"POR","NBA",8.5,78,77,2447,296,580,296,580,0,0,150,212,262,426,688,96,62,83,62,193,742,11.44
672,"Mike Dunleavy\dunlemi02","2007-08",27,"IND","NBA",8.5,82,82,2953,532,1117,367,728,165,389,336,403,59,365,424,288,86,31,190,208,1565,17.66
673,"Michael Finley\finlemi01","2000-01",27,"DAL","NBA",8.5,82,82,3443,711,1552,620,1289,91,263,252,325,109,316,425,360,118,32,190,174,1765,18.25
674,"Pau Gasol\gasolpa01","2002-03",22,"MEM","NBA",8.5,82,82,2948,569,1116,568,1106,1,10,416,565,192,528,720,229,34,148,213,220,1555,18.63
675,"Drew Gooden\goodedr01","2004-05",23,"CLE","NBA",8.5,82,80,2523,464,943,459,915,5,28,251,310,207,546,753,130,77,76,133,233,1184,14.74
676,"Draymond Green\greendr01","2014-15",24,"GSW","NBA",8.5,79,79,2490,339,765,228,436,111,329,132,200,114,533,647,291,123,99,133,253,921,14.54
677,"Hersey Hawkins\hawkihe01","1992-93",26,"PHI","NBA",8.5,81,81,2977,551,1172,429,865,122,307,419,487,91,255,346,317,137,30,180,189,1643,18.94
678,"Antawn Jamison\jamisan01","2002-03",26,"GSW","NBA",8.5,82,82,3226,691,1471,626,1262,65,209,375,475,195,383,578,156,76,45,177,197,1822,18.01
679,"Larry Johnson\johnsla02","1994-95",25,"CHH","NBA",8.5,81,81,3234,585,1219,504,1009,81,210,274,354,190,395,585,369,78,28,207,174,1525,18.07
680,"Jason Kidd\kiddja01","2008-09",35,"DAL","NBA",8.5,81,81,2886,257,618,126,295,131,323,86,105,85,415,500,702,160,39,185,168,731,15.71
681,"Jason Kidd\kiddja01","1999-00",26,"PHO","NBA",8.5,67,67,2616,350,855,294,689,56,166,203,245,96,387,483,678,134,28,226,148,959,19.48
682,"Kevin Love\loveke01","2015-16",27,"CLE","NBA",8.5,77,77,2424,409,977,251,538,158,439,258,314,149,613,762,186,58,41,142,159,1234,15.75
683,"Donyell Marshall\marshdo01","2000-01",27,"UTA","NBA",8.5,81,49,2326,427,849,386,721,41,128,205,273,172,394,566,133,85,78,128,196,1100,13.68
684,"Troy Murphy\murphtr01","2008-09",28,"IND","NBA",8.5,73,73,2482,364,767,203,409,161,358,152,184,146,715,861,172,58,34,114,226,1041,16.21
685,"Sam Perkins\perkisa01","1994-95",33,"SEA","NBA",8.5,82,37,2356,346,742,210,399,136,343,215,269,96,302,398,135,72,45,77,186,1043,12.17
686,"Rod Strickland\stricro02","1994-95",28,"POR","NBA",8.5,64,61,2267,441,946,395,823,46,123,283,380,73,244,317,562,123,9,209,118,1211,20.87
687,"Jason Terry\terryja01","2004-05",27,"DAL","NBA",8.5,80,57,2401,372,743,269,498,103,245,146,173,38,150,188,429,109,15,147,177,993,13.82
688,"Ben Wallace\wallabe01","2004-05",30,"DET","NBA",8.5,74,74,2671,295,651,294,642,1,9,130,304,292,610,902,123,106,176,82,159,721,13.38
689,"Rasheed Wallace\wallara01","2002-03",28,"POR","NBA",8.5,74,74,2684,515,1094,405,787,110,307,200,272,113,435,548,153,70,77,140,223,1340,16.24
690,"Mike Bibby\bibbymi01","2005-06",27,"SAC","NBA",8.4,82,82,3167,597,1382,405,885,192,497,342,403,29,211,240,444,82,10,199,169,1728,17.94
691,"Marc Gasol\gasolma01","2009-10",25,"MEM","NBA",8.4,69,69,2469,378,651,378,650,0,1,252,376,208,432,640,165,69,109,135,254,1008,16.97
692,"Pau Gasol\gasolpa01","2007-08",27,"TOT","NBA",8.4,66,66,2351,475,890,471,874,4,16,292,362,155,398,553,211,30,98,124,139,1246,18.98
693,"Joe Johnson\johnsjo02","2009-10",28,"ATL","NBA",8.4,76,76,2886,635,1386,506,1036,129,350,220,269,74,279,353,369,82,5,145,145,1619,18
694,"Kerry Kittles\kittlke01","1997-98",23,"NJN","NBA",8.4,77,76,2814,508,1154,398,891,110,263,202,250,132,230,362,176,132,37,106,152,1328,14.68
695,"Brevin Knight\knighbr01","1997-98",22,"CLE","NBA",8.4,80,76,2483,261,592,261,585,0,7,201,251,67,186,253,656,196,18,194,271,723,14.53
696,"Rashard Lewis\lewisra02","2004-05",25,"SEA","NBA",8.4,71,71,2697,532,1151,359,719,173,432,220,283,110,278,388,94,75,62,123,158,1457,16.6
697,"Grant Long\longgr01","1995-96",29,"ATL","NBA",8.4,82,82,3008,395,838,364,752,31,86,257,337,248,540,788,183,108,34,157,233,1078,14.54
698,"Kevin Martin\martike02","2007-08",24,"SAC","NBA",8.4,61,57,2216,417,914,310,648,107,266,502,578,48,225,273,129,62,5,131,150,1443,19.75
699,"Tracy McGrady\mcgratr01","2003-04",24,"ORL","NBA",8.4,67,67,2675,653,1566,479,1053,174,513,398,500,95,307,402,370,93,42,179,129,1878,23.05
700,"Alonzo Mourning\mournal01","1996-97",26,"MIA","NBA",8.4,66,65,2320,473,885,472,876,1,9,363,565,189,467,656,104,56,189,226,272,1310,20.04
701,"Steve Nash\nashst01","2000-01",26,"DAL","NBA",8.4,70,70,2387,386,792,297,573,89,219,231,258,46,177,223,509,72,5,205,158,1092,17.17
702,"Lamar Odom\odomla01","2003-04",24,"MIA","NBA",8.4,80,80,3003,485,1127,424,922,61,205,340,458,160,616,776,327,85,71,236,273,1371,17.54
703,"Dražen Petrović\petrodr01","1992-93",28,"NJN","NBA",8.4,70,67,2660,587,1134,512,967,75,167,315,362,42,148,190,247,94,13,204,237,1564,19.12
704,"David Robinson\robinda01","1998-99",33,"SAS","NBA",8.4,49,49,1554,268,527,268,526,0,1,239,363,148,344,492,103,69,119,108,143,775,18.06
705,"Arvydas Sabonis\sabonar01","1995-96",31,"POR","NBA",8.4,73,21,1735,394,723,355,619,39,104,231,305,147,441,588,130,64,78,154,211,1058,15.41
706,"Detlef Schrempf\schrede01","1993-94",31,"SEA","NBA",8.4,81,80,2728,445,903,423,835,22,68,300,390,144,310,454,275,73,9,173,273,1212,14.51
707,"Eric Snow\snower01","2002-03",29,"PHI","NBA",8.4,82,82,3108,361,799,354,767,7,32,325,379,71,230,301,544,133,11,194,235,1054,15.36
708,"David West\westda01","2007-08",27,"NOH","NBA",8.4,76,76,2870,629,1305,623,1280,6,25,300,353,180,495,675,177,62,99,165,208,1564,18.5
709,"Dominique Wilkins\wilkido01","1993-94",34,"TOT","NBA",8.4,74,74,2635,698,1588,613,1293,85,295,442,522,182,299,481,169,92,30,172,126,1923,20.03
710,"Deron Williams\willide01","2008-09",24,"UTA","NBA",8.4,68,68,2505,463,984,393,758,70,226,326,384,24,171,195,725,73,20,228,134,1322,21.58
711,"Jayson Williams\willija01","1997-98",29,"NJN","NBA",8.4,65,65,2343,321,645,321,641,0,4,195,293,443,440,883,67,45,49,95,236,837,14.68
712,"Nick Anderson\anderni01","1994-95",27,"ORL","NBA",8.3,76,76,2588,439,923,260,492,179,431,143,203,85,250,335,314,125,22,141,124,1200,15.79
713,"Vin Baker\bakervi01","1996-97",25,"MIL","NBA",8.3,78,78,3159,632,1251,617,1197,15,54,358,521,267,537,804,211,81,112,245,275,1637,20.23
714,"Sam Cassell\cassesa01","1997-98",28,"NJN","NBA",8.3,75,72,2606,510,1156,495,1076,15,80,436,507,73,155,228,603,121,20,269,262,1471,19.81
715,"Tyson Chandler\chandty01","2004-05",22,"CHI","NBA",8.3,80,10,2189,207,419,207,417,0,2,226,336,261,514,775,65,69,141,118,268,640,11.36
716,"Vinny Del Negro\delnevi01","1995-96",29,"SAS","NBA",8.3,82,82,2766,478,962,421,812,57,150,178,214,36,236,272,315,85,6,100,166,1191,13.57
717,"Tim Duncan\duncati01","2012-13",36,"SAS","NBA",8.3,69,69,2078,490,976,488,969,2,7,245,300,124,562,686,184,50,183,147,117,1227,18.83
718,"Derrick Favors\favorde01","2014-15",23,"UTA","NBA",8.3,74,74,2280,482,918,481,912,1,6,222,332,196,411,607,112,60,123,121,210,1187,15.68
719,"Michael Finley\finlemi01","1999-00",26,"DAL","NBA",8.3,82,82,3464,748,1636,649,1389,99,247,260,317,122,396,518,438,109,32,196,171,1855,19.9
720,"Jeff Foster\fosteje01","2003-04",27,"IND","NBA",8.3,82,79,1961,197,362,197,358,0,4,103,154,248,362,610,64,71,27,60,189,497,8.3
721,"Pau Gasol\gasolpa01","2011-12",31,"LAL","NBA",8.3,65,65,2430,459,917,452,890,7,27,204,261,183,495,678,237,37,88,142,127,1129,18.21
722,"Dwight Howard\howardw01","2016-17",31,"ATL","NBA",8.3,74,74,2199,388,613,388,611,0,2,226,424,296,644,940,104,64,92,170,203,1002,16.57
723,"Steve Kerr\kerrst01","1995-96",30,"CHI","NBA",8.3,82,0,1919,244,482,122,245,122,237,78,84,25,85,110,192,63,2,42,109,688,8.4
724,"Rashard Lewis\lewisra02","2005-06",26,"SEA","NBA",8.3,78,77,2876,538,1151,396,781,142,370,350,428,111,279,390,182,102,50,141,191,1568,17.52
725,"Reggie Lewis\lewisre01","1992-93",27,"BOS","NBA",8.3,80,80,3144,663,1410,649,1350,14,60,326,376,88,259,347,298,118,77,133,248,1666,18.04
726,"Andre Miller\millean02","2007-08",31,"PHI","NBA",8.3,82,82,3016,569,1156,566,1122,3,34,257,333,95,229,324,565,105,6,206,181,1398,17.32
727,"Brad Miller\millebr01","2001-02",25,"TOT","NBA",8.3,76,75,2263,366,733,363,726,3,7,297,383,252,369,621,152,76,41,115,244,1032,14.35
728,"Paul Millsap\millspa01","2014-15",29,"ATL","NBA",8.3,73,73,2390,443,930,366,714,77,216,255,337,139,431,570,223,130,69,166,201,1218,17.45
729,"Yao Ming\mingya01","2007-08",27,"HOU","NBA",8.3,55,55,2044,432,852,432,850,0,2,345,406,172,422,594,129,25,111,183,171,1209,21.67
730,"Paul Pierce\piercpa01","2009-10",32,"BOS","NBA",8.3,71,71,2411,409,867,300,604,109,263,369,433,39,271,310,218,84,31,166,196,1296,17.03
731,"Glen Rice\ricegl01","1995-96",28,"CHH","NBA",8.3,79,79,3142,610,1296,439,893,171,403,319,381,86,292,378,232,91,19,163,217,1710,18.23
732,"Karl-Anthony Towns\townska01","2015-16",20,"MIN","NBA",8.3,82,82,2627,625,1153,595,1065,30,88,223,275,229,629,858,161,58,138,183,245,1503,18.73
733,"Chris Webber\webbech01","1997-98",24,"WAS","NBA",8.3,71,71,2809,647,1341,582,1136,65,205,196,333,176,498,674,273,111,124,185,269,1555,20.83
734,"Carmelo Anthony\anthoca01","2007-08",23,"DEN","NBA",8.2,77,77,2806,728,1481,670,1317,58,164,464,590,178,393,571,259,98,39,253,253,1978,22.3
735,"Leandro Barbosa\barbole01","2006-07",24,"PHO","NBA",8.2,80,18,2613,529,1111,339,673,190,438,196,232,22,192,214,317,96,15,146,210,1444,15.97
736,"Shane Battier\battish01","2007-08",29,"HOU","NBA",8.2,80,78,2907,265,619,126,250,139,369,75,101,131,276,407,155,77,90,78,196,744,10.22
737,"Eric Bledsoe\bledser01","2018-19",29,"MIL","NBA",8.2,78,78,2272,470,971,346,594,124,377,177,236,82,280,362,430,116,29,165,156,1241,16.77
738,"P.J. Brown\brownpj01","2001-02",32,"CHH","NBA",8.2,80,80,2563,250,527,250,527,0,0,169,197,273,513,786,107,59,78,85,222,669,11.15
739,"Elden Campbell\campbel01","1995-96",27,"LAL","NBA",8.2,82,82,2699,447,888,447,883,0,5,249,349,162,461,623,181,88,212,137,300,1143,15.52
740,"Mike Conley\conlemi01","2013-14",26,"MEM","NBA",8.2,73,73,2446,463,1030,358,739,105,291,225,276,41,172,213,441,110,13,150,141,1256,16.61
741,"Baron Davis\davisba01","2001-02",22,"CHH","NBA",8.2,82,82,3318,559,1341,389,863,170,478,196,338,93,256,349,698,172,47,246,241,1484,18.84
742,"Danilo Gallinari\gallida01","2018-19",30,"LAC","NBA",8.2,68,68,2059,409,884,248,512,161,372,367,406,54,363,417,178,49,23,99,129,1346,18.11
743,"Marc Gasol\gasolma01","2011-12",27,"MEM","NBA",8.2,65,65,2370,357,740,356,728,1,12,237,317,120,459,579,204,62,121,121,201,952,16.4
744,"Draymond Green\greendr01","2016-17",26,"GSW","NBA",8.2,76,76,2471,272,650,191,387,81,263,151,213,98,501,599,533,154,106,184,217,776,16.39
745,"Antawn Jamison\jamisan01","2005-06",29,"WAS","NBA",8.2,82,80,3288,660,1494,513,1121,147,373,217,297,167,598,765,158,90,12,137,189,1684,16.89
746,"Kevin Johnson\johnske02","1995-96",29,"PHO","NBA",8.2,56,55,2007,342,674,321,617,21,57,342,398,42,179,221,517,82,13,170,144,1047,21.98
747,"Wesley Matthews\matthwe02","2013-14",27,"POR","NBA",8.2,82,82,2780,445,1009,244,498,201,511,252,301,51,238,289,197,76,14,110,176,1343,13.83
748,"Cuttino Mobley\moblecu01","2000-01",25,"HOU","NBA",8.2,79,49,3002,527,1214,437,962,90,252,394,474,83,314,397,195,84,26,165,169,1538,16.01
749,"Alonzo Mourning\mournal01","1992-93",22,"CHH","NBA",8.2,78,78,2644,572,1119,572,1116,0,3,495,634,263,542,805,76,27,271,236,286,1639,20.78
750,"Emeka Okafor\okafoem01","2008-09",26,"CHA","NBA",8.2,82,81,2691,433,772,433,772,0,0,219,369,275,552,827,53,48,136,144,247,1085,14.25
751,"Victor Oladipo\oladivi01","2017-18",25,"IND","NBA",8.2,75,75,2552,640,1342,479,908,161,434,294,368,47,343,390,323,177,57,219,175,1735,21.61
752,"Tony Parker\parketo01","2010-11",28,"SAS","NBA",8.2,78,78,2528,555,1069,530,999,25,70,233,303,30,208,238,513,90,3,200,135,1368,17.44
753,"Paul Pierce\piercpa01","1999-00",22,"BOS","NBA",8.2,73,72,2583,486,1099,390,819,96,280,359,450,83,313,396,221,152,62,178,237,1427,18.14
754,"Detlef Schrempf\schrede01","1995-96",33,"SEA","NBA",8.2,63,60,2200,360,740,287,561,73,179,287,370,73,255,328,276,56,8,146,179,1080,16.81
755,"Ben Simmons\simmobe01","2018-19",22,"PHI","NBA",8.2,79,79,2700,540,960,540,954,0,6,257,428,172,525,697,610,112,61,274,209,1337,21.18
756,"Kenny Smith\smithke01","1992-93",27,"HOU","NBA",8.2,82,82,2422,387,744,291,525,96,219,195,222,28,132,160,446,80,7,163,110,1065,14.02
757,"Steve Smith\smithst01","2000-01",31,"POR","NBA",8.2,81,36,2542,359,788,281,558,78,230,309,347,87,185,272,213,48,24,137,203,1105,12.4
758,"Tiago Splitter\splitti01","2012-13",28,"SAS","NBA",8.2,81,58,1997,315,563,315,561,0,2,208,285,144,371,515,130,63,64,100,161,838,11.65
759,"Kurt Thomas\thomaku01","2000-01",28,"NYK","NBA",8.2,77,29,2125,314,614,313,611,1,3,171,210,172,343,515,63,61,69,99,287,800,10.9
760,"Jonas Valančiūnas\valanjo01","2014-15",22,"TOR","NBA",8.2,80,80,2096,373,652,373,651,0,1,217,276,215,478,693,39,33,95,109,222,963,12.95
761,"Ben Wallace\wallabe01","2006-07",32,"CHI","NBA",8.2,77,77,2697,192,424,191,419,1,5,109,267,303,518,821,186,111,156,101,153,494,11.55
762,"Shareef Abdur-Rahim\abdursh01","2003-04",27,"TOT","NBA",8.1,85,56,2684,501,1054,492,1020,9,34,373,429,189,450,639,174,68,37,184,222,1384,15.24
763,"Derek Anderson\anderde01","2002-03",28,"POR","NBA",8.1,76,76,2556,355,832,239,501,116,331,231,269,53,211,264,325,90,16,128,141,1057,13.63
764,"B.J. Armstrong\armstbj01","1994-95",27,"CHI","NBA",8.1,82,82,2577,418,894,310,641,108,253,206,233,25,161,186,244,84,8,103,159,1150,12.38
765,"P.J. Brown\brownpj01","2003-04",34,"NOH","NBA",8.1,80,80,2753,339,712,339,711,0,1,158,185,237,453,690,155,78,73,101,203,836,12.2
766,"Kobe Bryant\bryanko01","2004-05",26,"LAL","NBA",8.1,66,66,2689,573,1324,442,937,131,387,542,664,95,297,392,398,86,53,270,174,1819,24.71
767,"Michael Cage\cagemi01","1995-96",34,"CLE","NBA",8.1,82,80,2631,220,396,220,395,0,1,50,92,288,441,729,53,87,79,54,215,490,9.21
768,"Clyde Drexler\drexlcl01","1996-97",34,"HOU","NBA",8.1,62,62,2271,397,899,278,564,119,335,201,268,118,255,373,354,119,36,156,151,1114,18.68
769,"Pau Gasol\gasolpa01","2003-04",23,"MEM","NBA",8.1,78,78,2458,506,1049,502,1034,4,15,365,511,206,394,600,198,44,132,187,185,1381,16.74
770,"Rudy Gobert\goberru01","2017-18",25,"UTA","NBA",8.1,56,56,1816,276,444,276,444,0,0,204,299,165,436,601,80,44,129,107,153,756,16.93
771,"Marcin Gortat\gortama01","2013-14",29,"WAS","NBA",8.1,81,80,2655,455,840,454,839,1,1,157,229,202,565,767,138,41,121,126,201,1068,14.35
772,"Richard Hamilton\hamilri01","2003-04",25,"DET","NBA",8.1,78,78,2772,530,1166,512,1098,18,68,297,342,78,201,279,310,103,17,210,222,1375,15.34
773,"Richard Hamilton\hamilri01","2006-07",28,"DET","NBA",8.1,75,75,2763,547,1170,503,1041,44,129,347,403,75,207,282,285,59,15,159,232,1485,16.59
774,"Anfernee Hardaway\hardaan01","1996-97",25,"ORL","NBA",8.1,59,59,2221,421,941,336,674,85,267,283,345,82,181,263,332,93,35,145,123,1210,19.49
775,"Zydrunas Ilgauskas\ilgauzy01","2004-05",29,"CLE","NBA",8.1,78,78,2615,458,979,456,972,2,7,402,503,299,373,672,100,53,165,191,313,1320,16.47
776,"Antawn Jamison\jamisan01","2008-09",32,"WAS","NBA",8.1,81,81,3096,674,1441,562,1122,112,319,341,452,196,525,721,153,95,25,125,218,1801,18.83
777,"Enes Kanter\kanteen01","2015-16",23,"OKC","NBA",8.1,82,1,1721,414,719,404,698,10,21,200,251,249,415,664,33,26,33,115,166,1038,12.41
778,"Jason Kidd\kiddja01","1998-99",25,"PHO","NBA",8.1,50,50,2060,310,698,265,575,45,123,181,239,87,252,339,539,114,19,150,108,846,21.97
779,"Corey Maggette\maggeco01","2004-05",25,"LAC","NBA",8.1,66,60,2436,425,986,374,818,51,168,563,657,70,324,394,225,70,8,195,191,1464,19.65
780,"Dikembe Mutombo\mutomdi01","2000-01",34,"TOT","NBA",8.1,75,75,2591,269,556,269,556,0,0,211,291,307,708,1015,76,29,203,144,204,749,14.21
781,"Dirk Nowitzki\nowitdi01","1999-00",21,"DAL","NBA",8.1,82,81,2938,515,1118,399,812,116,306,289,348,102,430,532,203,63,68,141,256,1435,15.86
782,"Tony Parker\parketo01","2004-05",22,"SAS","NBA",8.1,80,80,2735,539,1118,496,962,43,156,210,323,47,251,298,491,98,4,215,167,1331,16.03
783,"Gary Payton\paytoga01","2003-04",35,"LAL","NBA",8.1,82,82,2825,482,1024,427,859,55,165,180,252,72,270,342,449,96,19,151,169,1199,14.71
784,"Otto Porter\porteot01","2017-18",24,"WAS","NBA",8.1,77,77,2432,445,885,307,572,138,313,106,128,103,389,492,157,116,41,75,151,1134,14.74
785,"Steve Smith\smithst01","1993-94",24,"MIA","NBA",8.1,78,77,2776,491,1076,400,814,91,262,273,327,156,196,352,394,84,35,202,217,1346,16.57
786,"Latrell Sprewell\sprewla01","1996-97",26,"GSW","NBA",8.1,80,79,3353,649,1444,502,1029,147,415,493,585,58,308,366,507,132,45,322,153,1938,22.69
787,"Peja Stojaković\stojape01","2007-08",30,"NOH","NBA",8.1,77,77,2711,451,1026,220,502,231,524,130,140,64,267,331,96,57,10,61,127,1263,12.79
788,"Rod Strickland\stricro02","1997-98",31,"WAS","NBA",8.1,76,76,3020,490,1130,478,1082,12,48,357,492,112,293,405,801,126,25,266,182,1349,20.61
789,"Jeff Teague\teaguje01","2016-17",28,"IND","NBA",8.1,82,82,2657,402,909,312,657,90,252,360,415,33,297,330,639,100,32,216,165,1254,17.78
790,"Anderson Varejão\varejan01","2009-10",27,"CLE","NBA",8.1,76,7,2166,267,467,266,462,1,5,116,175,189,389,578,87,71,67,67,223,651,10.75
791,"Kemba Walker\walkeke02","2016-17",26,"CHO","NBA",8.1,79,79,2739,643,1449,403,847,240,602,304,359,45,263,308,434,85,22,168,119,1830,19.98
792,"David West\westda01","2013-14",33,"IND","NBA",8.1,80,80,2472,458,939,454,924,4,15,198,251,120,422,542,223,61,74,133,186,1118,13.85
793,"Trevor Ariza\arizatr01","2013-14",28,"WAS","NBA",8,77,77,2723,389,853,209,411,180,442,149,193,99,376,475,191,126,20,132,179,1107,14.44
794,"Darrell Armstrong\armstda01","1999-00",31,"ORL","NBA",8,82,82,2590,484,1119,347,716,137,403,225,247,65,205,270,501,169,9,248,137,1330,16.65
795,"Andris Biedriņš\biedran01","2007-08",21,"GSW","NBA",8,76,59,2078,340,543,340,543,0,0,116,187,256,488,744,75,56,94,85,262,796,13.1
796,"Chauncey Billups\billuch01","2010-11",34,"TOT","NBA",8,72,72,2310,339,794,193,431,146,363,384,419,25,165,190,387,71,14,177,146,1208,16.69
797,"Chris Bosh\boshch01","2013-14",29,"MIA","NBA",8,79,79,2531,492,953,418,735,74,218,223,272,98,424,522,87,80,78,125,192,1281,15.13
798,"P.J. Brown\brownpj01","2000-01",31,"CHH","NBA",8,80,79,2811,249,561,249,557,0,4,178,209,257,485,742,127,78,92,108,260,676,11.23
799,"Andrew Bynum\bynuman01","2011-12",24,"LAL","NBA",8,60,60,2112,444,796,443,791,1,5,234,338,192,517,709,85,27,116,152,104,1123,19.22
800,"Mike Conley\conlemi01","2018-19",31,"MEM","NBA",8,70,70,2342,490,1120,335,694,155,426,343,406,40,199,239,449,94,22,130,123,1478,19.77
801,"LaPhonso Ellis\ellisla01","1992-93",22,"DEN","NBA",8,82,82,2749,483,958,481,945,2,13,237,317,274,470,744,151,72,111,153,293,1205,15.23
802,"Derrick Favors\favorde01","2017-18",26,"UTA","NBA",8,77,77,2153,395,702,381,639,14,63,140,215,198,354,552,102,54,82,88,164,944,12.78
803,"Danny Granger\grangda01","2008-09",25,"IND","NBA",8,67,66,2424,571,1277,389,827,182,450,404,460,49,292,341,183,69,97,165,207,1728,21.51
804,"Horace Grant\grantho01","1995-96",30,"ORL","NBA",8,63,62,2286,347,677,346,671,1,6,152,207,178,402,580,170,62,74,64,144,847,15.15
805,"Blake Griffin\griffbl01","2018-19",29,"DET","NBA",8,75,75,2622,619,1341,430,819,189,522,414,550,100,465,565,402,52,28,253,199,1841,22.33
806,"Dwight Howard\howardw01","2013-14",28,"HOU","NBA",8,71,71,2396,473,800,471,793,2,7,349,638,231,635,866,131,60,128,229,240,1297,19.69
807,"Josh Howard\howarjo01","2007-08",27,"DAL","NBA",8,76,76,2757,567,1247,500,1037,67,210,312,384,120,412,532,164,59,32,114,202,1513,16.41
808,"Avery Johnson\johnsav01","1994-95",29,"SAS","NBA",8,82,82,3011,448,863,445,841,3,22,202,295,49,159,208,670,114,13,207,154,1101,16.03
809,"Eddie Jones\jonesed02","2004-05",33,"MIA","NBA",8,80,80,2839,351,820,209,438,142,382,174,216,38,367,405,212,86,38,99,251,1018,12.38
810,"Jason Kidd\kiddja01","1997-98",24,"PHO","NBA",8,82,82,3118,357,859,284,626,73,233,167,209,108,402,510,745,162,26,261,142,954,16.88
811,"Rashard Lewis\lewisra02","2000-01",21,"SEA","NBA",8,78,78,2720,426,887,303,602,123,285,176,213,143,398,541,125,91,45,129,191,1151,14.26
812,"Andre Miller\millean02","2000-01",24,"CLE","NBA",8,82,82,2848,452,999,435,935,17,64,375,450,94,266,360,657,119,28,265,229,1296,18.17
813,"Gheorghe Mureșan\muresgh01","1995-96",24,"WSB","NBA",8,76,76,2242,466,798,466,797,0,1,172,278,248,480,728,56,52,172,143,297,1104,15.69
814,"Shaquille O'Neal\onealsh01","1996-97",24,"LAL","NBA",8,51,51,1941,552,991,552,987,0,4,232,479,195,445,640,159,46,147,146,180,1336,25.11
815,"Tayshaun Prince\princta01","2006-07",26,"DET","NBA",8,82,82,3001,459,997,378,787,81,210,172,224,144,285,429,227,51,55,98,116,1171,12.88
816,"Michael Redd\reddmi01","2002-03",23,"MIL","NBA",8,82,14,2316,455,971,273,555,182,416,149,185,98,273,371,117,100,13,74,143,1241,13.03
817,"Mitch Richmond\richmmi01","1994-95",29,"SAC","NBA",8,82,82,3172,668,1497,512,1073,156,424,375,445,69,288,357,311,91,29,234,227,1867,18.66
818,"Clifford Robinson\robincl02","1995-96",29,"POR","NBA",8,78,76,2980,553,1306,375,835,178,471,360,542,123,320,443,190,86,68,194,248,1644,16.95
819,"Brandon Roy\roybr01","2007-08",23,"POR","NBA",8,74,74,2792,531,1170,458,955,73,215,281,373,81,267,348,430,79,16,136,147,1416,17.61
820,"Detlef Schrempf\schrede01","1996-97",34,"SEA","NBA",8,61,60,2192,356,724,299,563,57,161,253,316,87,307,394,266,63,16,150,151,1022,17.22
821,"Scott Skiles\skilesc01","1992-93",28,"ORL","NBA",8,78,78,3086,416,891,336,656,80,235,289,324,52,238,290,735,86,2,267,244,1201,18.56
822,"Latrell Sprewell\sprewla01","1993-94",23,"GSW","NBA",8,82,82,3533,613,1417,472,1026,141,391,353,456,80,321,401,385,180,76,226,158,1720,19.45
823,"John Stockton\stockjo01","1997-98",35,"UTA","NBA",8,64,64,1858,270,511,231,420,39,91,191,231,35,131,166,543,89,10,161,138,770,16.36
824,"Peja Stojaković\stojape01","2005-06",28,"TOT","NBA",8,71,71,2601,445,1018,283,614,162,404,238,260,79,336,415,136,45,10,103,171,1290,14.93
825,"Amar'e Stoudemire\stoudam01","2010-11",28,"NYK","NBA",8,78,78,2870,744,1482,734,1459,10,23,473,597,198,438,636,202,71,150,250,274,1971,22.48
826,"Wally Szczerbiak\szczewa02","2005-06",28,"TOT","NBA",8,72,71,2729,493,1012,391,757,102,255,278,310,77,236,313,213,40,19,136,150,1366,16.24
827,"Klay Thompson\thompkl01","2015-16",25,"GSW","NBA",8,80,80,2666,651,1386,375,736,276,650,193,221,35,271,306,166,60,49,138,152,1771,17.29
828,"Myles Turner\turnemy01","2016-17",20,"IND","NBA",8,81,81,2541,444,869,404,754,40,115,245,303,139,450,589,106,74,172,105,262,1173,15.1
829,"Anderson Varejão\varejan01","2008-09",26,"CLE","NBA",8,81,42,2306,270,504,270,502,0,2,154,250,166,415,581,81,75,66,80,239,694,10.14
830,"Metta World Peace\artesro01","2003-04",24,"IND","NBA",8,73,71,2714,468,1112,393,870,75,242,322,439,100,285,385,272,152,50,202,194,1333,16.8
831,"Ray Allen\allenra02","2009-10",34,"BOS","NBA",7.9,80,80,2819,464,973,319,574,145,399,231,253,45,208,253,210,64,25,129,182,1304,14.12
832,"Carmelo Anthony\anthoca01","2009-10",25,"DEN","NBA",7.9,69,69,2634,688,1502,629,1315,59,187,508,612,152,302,454,222,88,30,209,225,1943,22.77
833,"Carmelo Anthony\anthoca01","2010-11",26,"TOT","NBA",7.9,77,77,2751,684,1503,589,1252,95,251,507,605,118,445,563,221,68,46,206,224,1970,21.2
834,"Nicolas Batum\batumni01","2013-14",25,"POR","NBA",7.9,82,82,2956,381,819,236,417,145,402,163,203,116,495,611,420,75,57,208,156,1070,15.69
835,"Jimmy Butler\butleji01","2018-19",29,"TOT","NBA",7.9,65,65,2185,418,904,351,711,67,193,312,365,121,221,342,263,123,39,95,111,1215,18.45
836,"Tyson Chandler\chandty01","2006-07",24,"NOK","NBA",7.9,73,73,2525,292,468,292,467,0,1,106,201,320,584,904,66,37,129,126,244,690,13.37
837,"DeMarcus Cousins\couside01","2013-14",23,"SAC","NBA",7.9,71,71,2298,591,1191,591,1184,0,7,432,595,218,613,831,207,109,91,251,270,1614,22.56
838,"Kevin Durant\duranke01","2008-09",20,"OKC","NBA",7.9,74,74,2885,661,1390,564,1160,97,230,452,524,77,405,482,205,96,53,225,134,1871,21.66
839,"Derrick Favors\favorde01","2018-19",27,"UTA","NBA",7.9,76,70,1766,363,619,346,541,17,78,154,228,207,353,560,89,56,106,84,163,897,13.1
840,"Marc Gasol\gasolma01","2010-11",26,"MEM","NBA",7.9,81,81,2586,364,691,361,684,3,7,220,294,154,415,569,200,74,136,146,265,951,13.83
841,"Mark Jackson\jacksma01","1992-93",27,"LAC","NBA",7.9,82,81,3117,459,945,437,863,22,82,241,300,129,259,388,724,136,12,220,158,1181,18.12
842,"Eddie Jones\jonesed02","2000-01",29,"MIA","NBA",7.9,63,58,2282,388,871,298,633,90,238,228,270,75,217,292,171,110,58,135,183,1094,16.03
843,"Andrei Kirilenko\kirilan01","2005-06",24,"UTA","NBA",7.9,69,63,2604,336,730,300,613,36,117,346,495,161,391,552,299,102,220,203,162,1054,18.9
844,"Brook Lopez\lopezbr01","2009-10",21,"NJN","NBA",7.9,82,82,3027,563,1129,563,1127,0,2,416,509,270,439,709,187,55,139,204,251,1542,18.37
845,"Danny Manning\mannida01","1992-93",26,"LAC","NBA",7.9,79,77,2761,702,1379,694,1349,8,30,388,484,198,322,520,207,108,101,230,323,1800,20.36
846,"Alonzo Mourning\mournal01","1998-99",28,"MIA","NBA",7.9,46,46,1753,324,634,324,632,0,2,276,423,166,341,507,74,34,180,139,161,924,20.99
847,"Dikembe Mutombo\mutomdi01","1998-99",32,"ATL","NBA",7.9,50,50,1829,173,338,173,338,0,0,195,285,192,418,610,57,16,147,94,145,541,14.81
848,"Steve Nash\nashst01","2010-11",36,"PHO","NBA",7.9,75,75,2497,399,811,318,606,81,205,227,249,40,220,260,855,48,4,265,87,1106,19.23
849,"Bo Outlaw\outlabo01","2000-01",29,"ORL","NBA",7.9,80,69,2534,226,368,225,366,1,2,129,225,211,408,619,225,105,137,141,241,582,12.28
850,"Zach Randolph\randoza01","2012-13",31,"MEM","NBA",7.9,76,75,2607,471,1024,469,1001,2,23,225,300,310,544,854,108,61,31,150,180,1169,14.61
851,"Mitch Richmond\richmmi01","1997-98",32,"SAC","NBA",7.9,70,70,2569,543,1220,413,886,130,334,407,471,50,179,229,279,88,15,181,154,1623,19.23
852,"Steve Smith\smithst01","1995-96",26,"ATL","NBA",7.9,80,80,2856,494,1143,354,720,140,423,318,385,124,202,326,224,68,17,151,207,1446,14.8
853,"Otis Thorpe\thorpot01","1996-97",34,"DET","NBA",7.9,79,79,2661,419,787,419,785,0,2,198,303,226,396,622,133,59,17,145,298,1036,12.96
854,"Jonas Valančiūnas\valanjo01","2016-17",24,"TOR","NBA",7.9,80,80,2066,391,702,390,700,1,2,176,217,226,533,759,57,37,63,106,216,959,12.9
855,"John Wall\walljo01","2013-14",23,"WAS","NBA",7.9,82,82,2980,579,1337,471,1029,108,308,317,394,38,295,333,721,149,40,295,219,1583,20.28
856,"Russell Westbrook\westbru01","2011-12",23,"OKC","NBA",7.9,66,66,2331,578,1266,516,1070,62,196,340,413,96,205,301,362,112,21,239,147,1558,20.82
857,"Buck Williams\willibu01","1993-94",33,"POR","NBA",7.9,81,81,2636,291,524,291,523,0,1,201,296,315,528,843,80,58,47,111,239,783,12.08
858,"Shane Battier\battish01","2004-05",26,"MEM","NBA",7.8,80,72,2516,271,613,201,436,70,177,180,228,158,255,413,126,91,77,75,201,792,10.63
859,"Ronnie Brewer\brewero02","2007-08",22,"UTA","NBA",7.8,76,76,2088,354,634,343,584,11,50,195,257,97,121,218,134,129,19,69,110,914,11.98
860,"Andrew Bynum\bynuman01","2009-10",22,"LAL","NBA",7.8,65,65,1977,392,688,392,687,0,1,193,261,177,364,541,68,35,94,115,193,977,15.23
861,"Kenneth Faried\farieke01","2012-13",23,"DEN","NBA",7.8,80,80,2248,380,689,380,689,0,0,163,266,260,474,734,77,81,83,113,234,923,12.98
862,"Danny Green\greenda02","2014-15",27,"SAS","NBA",7.8,81,80,2312,322,738,131,281,191,457,111,127,54,289,343,158,101,87,93,163,946,11.87
863,"Anfernee Hardaway\hardaan01","1999-00",28,"PHO","NBA",7.8,60,60,2253,378,798,345,696,33,102,226,286,91,256,347,315,94,38,153,164,1015,17.73
864,"George Hill\hillge01","2013-14",27,"IND","NBA",7.8,76,76,2434,272,616,177,356,95,260,142,176,53,230,283,265,75,23,92,158,781,10.98
865,"Al Horford\horfoal01","2017-18",31,"BOS","NBA",7.8,72,72,2277,368,753,271,527,97,226,94,120,103,427,530,339,43,78,132,138,927,15.05
866,"Zydrunas Ilgauskas\ilgauzy01","2003-04",28,"CLE","NBA",7.8,81,81,2539,466,965,464,958,2,7,303,406,279,374,653,109,39,201,163,277,1237,15.11
867,"Al Jefferson\jeffeal01","2010-11",26,"UTA","NBA",7.8,82,82,2940,654,1319,654,1319,0,0,220,289,235,559,794,149,46,153,105,238,1528,17.24
868,"Al Jefferson\jeffeal01","2013-14",29,"CHA","NBA",7.8,73,73,2553,700,1376,697,1361,3,15,191,277,156,636,792,155,67,79,124,176,1594,19.51
869,"Rashard Lewis\lewisra02","2002-03",23,"SEA","NBA",7.8,77,77,3044,519,1149,444,932,75,217,283,345,152,351,503,133,99,35,143,205,1396,15.48
870,"Stephon Marbury\marbust01","2000-01",23,"NJN","NBA",7.8,67,67,2557,563,1277,453,942,110,335,362,458,53,152,205,506,79,5,197,150,1598,21.04
871,"Antonio McDyess\mcdyean01","2000-01",26,"DEN","NBA",7.8,70,70,2555,577,1165,577,1165,0,0,304,434,240,605,845,146,43,102,162,220,1458,19.66
872,"Chris Mills\millsch01","1995-96",26,"CLE","NBA",7.8,80,80,3060,454,971,375,761,79,210,218,263,112,331,443,188,73,52,121,241,1205,13.84
873,"Paul Millsap\millspa01","2011-12",26,"UTA","NBA",7.8,64,62,2100,426,861,419,830,7,31,202,255,180,383,563,150,118,52,112,222,1061,17.06
874,"Troy Murphy\murphtr01","2009-10",29,"IND","NBA",7.8,72,69,2344,384,813,256,480,128,333,154,193,129,608,737,150,72,34,100,175,1050,15.48
875,"Jusuf Nurkić\nurkiju01","2018-19",24,"POR","NBA",7.8,72,72,1974,420,826,417,797,3,29,282,365,243,505,748,233,71,103,168,250,1125,17.87
876,"Shaquille O'Neal\onealsh01","2008-09",36,"PHO","NBA",7.8,75,75,2252,512,841,512,840,0,1,309,519,187,446,633,126,49,108,168,253,1333,17.75
877,"Gary Payton\paytoga01","1992-93",24,"SEA","NBA",7.8,82,78,2548,476,963,469,929,7,34,151,196,95,186,281,399,177,21,148,250,1110,14.53
878,"Scottie Pippen\pippesc01","1999-00",34,"POR","NBA",7.8,82,82,2749,388,860,302,597,86,263,160,223,114,399,513,406,117,41,208,208,1022,14.45
879,"Dennis Rodman\rodmade01","1997-98",36,"CHI","NBA",7.8,80,66,2856,155,360,151,337,4,23,61,111,421,780,1201,230,47,18,147,238,375,10.83
880,"Steve Smith\smithst01","1994-95",25,"TOT","NBA",7.8,80,61,2665,428,1005,291,589,137,416,312,371,104,172,276,274,62,33,155,225,1305,14.2
881,"Rik Smits\smitsri01","1993-94",27,"IND","NBA",7.8,78,75,2113,493,923,493,922,0,1,238,300,135,348,483,156,49,82,151,281,1224,14.86
882,"John Wall\walljo01","2014-15",24,"WAS","NBA",7.8,79,79,2837,519,1166,454,949,65,217,284,362,36,330,366,792,138,45,304,180,1387,20.47
883,"Chris Webber\webbech01","1993-94",20,"GSW","NBA",7.8,76,76,2438,572,1037,572,1023,0,14,189,355,305,389,694,272,93,164,206,247,1333,19.02
884,"David West\westda01","2010-11",30,"NOH","NBA",7.8,70,70,2451,528,1040,526,1031,2,9,264,327,155,374,529,164,67,62,142,202,1322,17.38
885,"David West\westda01","2008-09",28,"NOH","NBA",7.8,76,76,2982,610,1292,604,1267,6,25,367,415,160,486,646,173,49,68,163,207,1593,18.28
886,"Marvin Williams\willima02","2015-16",29,"CHO","NBA",7.8,81,81,2338,338,747,186,369,152,378,120,144,127,394,521,110,58,77,62,133,948,11.7
887,"Kenny Anderson\anderke01","1995-96",25,"TOT","NBA",7.7,69,64,2344,349,834,257,578,92,256,260,338,63,140,203,575,111,14,146,178,1050,17.09
888,"Nick Anderson\anderni01","1992-93",25,"ORL","NBA",7.7,79,76,2920,594,1324,506,1075,88,249,298,402,122,355,477,265,128,56,164,200,1574,17.55
889,"Vince Carter\cartevi01","2007-08",31,"NJN","NBA",7.7,76,72,2959,587,1287,489,1014,98,273,350,429,112,341,453,389,93,33,181,241,1622,19.66
890,"Andre Drummond\drumman01","2014-15",21,"DET","NBA",7.7,82,82,2502,494,961,494,959,0,2,142,365,437,667,1104,55,73,153,120,285,1130,14.95
891,"Tim Duncan\duncati01","2010-11",34,"SAS","NBA",7.7,76,76,2156,419,838,419,834,0,4,184,257,169,509,678,203,50,146,122,119,1022,14.99
892,"Sean Elliott\elliose01","1995-96",27,"SAS","NBA",7.7,77,77,2901,525,1127,364,735,161,392,326,423,69,327,396,211,69,33,198,178,1537,17.11
893,"Marc Gasol\gasolma01","2016-17",32,"MEM","NBA",7.7,74,74,2531,532,1160,428,892,104,268,278,332,60,404,464,338,67,99,166,171,1446,18.7
894,"Brian Grant\grantbr01","2002-03",30,"MIA","NBA",7.7,82,82,2641,344,676,344,676,0,0,158,205,241,596,837,104,63,47,129,300,846,12.14
895,"Horace Grant\grantho01","1996-97",31,"ORL","NBA",7.7,67,67,2496,358,695,357,689,1,6,128,179,206,394,600,163,101,65,99,157,845,14.66
896,"Blake Griffin\griffbl01","2016-17",27,"LAC","NBA",7.7,61,61,2076,479,971,441,858,38,113,320,421,112,385,497,300,57,22,142,157,1316,20.8
897,"Richard Hamilton\hamilri01","2007-08",29,"DET","NBA",7.7,72,72,2424,499,1030,437,889,62,141,184,221,75,160,235,299,73,10,132,171,1244,15.15
898,"Dwight Howard\howardw01","2011-12",26,"ORL","NBA",7.7,54,54,2070,416,726,416,719,0,7,281,572,200,585,785,104,81,116,175,159,1113,22.29
899,"Larry Hughes\hughela01","2004-05",26,"WAS","NBA",7.7,61,61,2358,467,1086,408,877,59,209,352,453,74,308,382,285,176,18,153,168,1345,20.85
900,"Andre Iguodala\iguodan01","2006-07",23,"PHI","NBA",7.7,76,76,3062,443,991,395,836,48,155,452,551,77,357,434,432,152,33,261,200,1386,19.49
901,"Al Jefferson\jeffeal01","2007-08",23,"MIN","NBA",7.7,82,82,2919,721,1441,721,1436,0,5,284,394,308,603,911,117,74,119,167,222,1726,19.09
902,"Al Jefferson\jeffeal01","2012-13",28,"UTA","NBA",7.7,78,78,2578,611,1236,609,1219,2,17,167,217,156,564,720,164,80,89,105,170,1391,16.61
903,"Larry Johnson\johnsla02","1996-97",27,"NYK","NBA",7.7,76,76,2613,376,735,342,630,34,105,190,274,165,228,393,174,64,36,136,249,976,12.45
904,"Kerry Kittles\kittlke01","2002-03",28,"NJN","NBA",7.7,65,57,1951,332,711,254,492,78,219,106,135,52,200,252,170,101,30,55,110,848,12.51
905,"Kerry Kittles\kittlke01","2001-02",27,"NJN","NBA",7.7,82,82,2601,438,940,340,698,98,242,128,172,68,207,275,216,130,31,109,108,1102,12.37
906,"Carl Landry\landrca01","2009-10",26,"TOT","NBA",7.7,80,29,2469,499,931,498,928,1,3,344,427,188,280,468,66,55,63,136,234,1343,14.88
907,"Kawhi Leonard\leonaka01","2013-14",22,"SAS","NBA",7.7,66,65,1923,337,645,268,463,69,182,101,126,76,336,412,133,114,50,80,127,844,14
908,"Dan Majerle\majerda01","1994-95",29,"PHO","NBA",7.7,82,46,3091,438,1031,239,483,199,548,206,282,104,271,375,340,96,38,105,155,1281,14.81
909,"Paul Millsap\millspa01","2010-11",25,"UTA","NBA",7.7,76,76,2605,525,988,516,965,9,23,256,338,164,415,579,187,103,69,145,272,1315,17.29
910,"Paul Millsap\millspa01","2008-09",23,"UTA","NBA",7.7,76,38,2290,400,749,400,745,0,4,228,326,251,403,654,138,78,73,129,288,1028,14.63
911,"Lamar Odom\odomla01","2009-10",30,"LAL","NBA",7.7,82,38,2585,342,739,284,557,58,182,140,202,184,618,802,267,75,59,150,227,882,13.42
912,"Tony Parker\parketo01","2002-03",20,"SAS","NBA",7.7,82,82,2774,484,1043,402,800,82,243,219,290,33,183,216,432,71,4,198,174,1269,14.23
913,"Ricky Pierce\piercri01","1992-93",33,"SEA","NBA",7.7,77,72,2218,524,1071,482,958,42,113,313,352,58,134,192,220,100,7,160,167,1403,15.36
914,"Jeff Teague\teaguje01","2014-15",26,"ATL","NBA",7.7,73,72,2228,408,887,337,680,71,207,275,319,30,154,184,513,125,31,205,139,1162,17.34
915,"Isaiah Thomas\thomais02","2013-14",24,"SAC","NBA",7.7,72,54,2497,496,1096,369,732,127,364,346,407,47,163,210,454,93,8,213,185,1465,19.06
916,"Dwyane Wade\wadedw01","2011-12",30,"MIA","NBA",7.7,49,49,1625,416,837,401,781,15,56,235,297,73,164,237,225,82,63,129,110,1082,20.74
917,"Gerald Wallace\wallage01","2006-07",24,"CHA","NBA",7.7,72,71,2640,478,952,439,832,39,120,309,447,142,376,518,185,144,69,160,209,1304,18.09
918,"Jarrett Allen\allenja01","2018-19",20,"BRK","NBA",7.6,80,80,2096,335,568,329,523,6,45,197,278,191,481,672,110,43,120,103,184,873,13.12
919,"Nick Anderson\anderni01","1993-94",26,"ORL","NBA",7.6,81,81,2811,504,1054,403,740,101,314,168,250,113,363,476,294,134,33,165,148,1277,15.57
920,"Darrell Armstrong\armstda01","2001-02",33,"ORL","NBA",7.6,82,79,2730,347,828,208,430,139,398,182,205,83,236,319,453,157,10,175,166,1015,14.31
921,"Bradley Beal\bealbr01","2018-19",25,"WAS","NBA",7.6,82,82,3028,764,1609,555,1013,209,596,362,448,89,322,411,448,121,58,224,226,2099,22.97
922,"Chauncey Billups\billuch01","2001-02",25,"MIN","NBA",7.6,82,54,2355,348,823,224,508,124,315,207,234,35,191,226,450,66,17,138,169,1027,12.96
923,"Carlos Boozer\boozeca01","2011-12",30,"CHI","NBA",7.6,66,66,1948,448,842,448,841,0,1,95,137,114,450,564,125,63,24,115,168,991,14.5
924,"Elton Brand\brandel01","2002-03",23,"LAC","NBA",7.6,62,61,2454,451,899,451,898,0,1,244,356,283,420,703,157,71,158,161,204,1146,19.76
925,"Marcus Camby\cambyma01","2006-07",32,"DEN","NBA",7.6,70,70,2369,312,659,312,657,0,2,161,221,164,652,816,223,87,231,122,183,785,16.51
926,"Elden Campbell\campbel01","2001-02",33,"CHH","NBA",7.6,77,74,2156,384,794,384,792,0,2,306,384,133,397,530,102,60,137,138,264,1074,14.02
927,"Sam Cassell\cassesa01","2005-06",36,"LAC","NBA",7.6,78,75,2653,493,1112,423,922,70,190,289,335,40,247,287,491,74,11,175,225,1345,16.48
928,"Josh Childress\childjo01","2007-08",24,"ATL","NBA",7.6,76,0,2274,327,573,305,513,22,60,222,275,174,199,373,117,71,43,98,129,898,12.35
929,"Darren Collison\collida01","2017-18",30,"IND","NBA",7.6,69,64,2018,316,638,220,433,96,205,127,144,37,141,178,368,92,15,86,122,855,13.9
930,"DeMarcus Cousins\couside01","2016-17",26,"TOT","NBA",7.6,72,72,2465,647,1432,516,1069,131,363,517,670,152,642,794,332,100,93,269,278,1942,25.73
931,"Dale Ellis\ellisda01","1993-94",33,"SAS","NBA",7.6,77,75,2590,478,967,347,635,131,332,83,107,70,185,255,80,66,11,75,141,1170,11.77
932,"LaPhonso Ellis\ellisla01","1993-94",23,"DEN","NBA",7.6,79,79,2699,483,963,476,940,7,23,242,359,220,462,682,167,63,80,172,304,1215,15.14
933,"Michael Finley\finlemi01","2003-04",30,"DAL","NBA",7.6,72,72,2778,514,1159,364,789,150,370,164,193,78,247,325,212,84,39,83,118,1342,15.48
934,"Pau Gasol\gasolpa01","2001-02",21,"MEM","NBA",7.6,82,79,3007,551,1064,550,1059,1,5,338,477,238,492,730,223,41,169,224,195,1441,17.91
935,"Marcin Gortat\gortama01","2011-12",27,"PHO","NBA",7.6,66,66,2114,427,769,427,767,0,2,163,251,185,474,659,59,48,99,90,142,1017,15.7
936,"Richard Hamilton\hamilri01","2005-06",27,"DET","NBA",7.6,80,80,2825,649,1322,594,1202,55,120,256,303,84,172,256,275,52,16,173,207,1609,16.03
937,"Kirk Hinrich\hinriki01","2005-06",25,"CHI","NBA",7.6,81,81,2955,451,1078,325,737,126,341,256,314,29,259,288,514,94,21,188,251,1284,15.68
938,"Dwight Howard\howardw01","2012-13",27,"LAL","NBA",7.6,76,76,2722,470,813,469,807,1,6,355,721,251,694,945,108,84,186,225,291,1296,18.9
939,"Serge Ibaka\ibakase01","2010-11",21,"OKC","NBA",7.6,82,44,2216,335,617,335,616,0,1,138,184,214,408,622,22,31,198,71,267,808,11.29
940,"Joe Ingles\inglejo01","2017-18",30,"UTA","NBA",7.6,82,81,2578,335,718,131,254,204,464,66,83,24,320,344,392,90,20,159,178,940,13.18
941,"Mike James\jamesmi01","2005-06",30,"TOR","NBA",7.6,79,79,2925,576,1228,407,846,169,382,283,338,45,217,262,460,72,3,206,214,1604,18.4
942,"Richard Jefferson\jefferi01","2007-08",27,"NJN","NBA",7.6,82,82,3200,619,1328,542,1115,77,213,542,679,93,249,342,252,76,21,199,225,1857,18.59
943,"Joe Johnson\johnsjo02","2008-09",27,"ATL","NBA",7.6,79,79,3124,620,1420,471,1006,149,414,299,362,65,281,346,455,84,19,195,176,1688,18.62
944,"Joe Johnson\johnsjo02","2004-05",23,"PHO","NBA",7.6,82,82,3240,544,1179,367,809,177,370,135,180,120,302,422,291,79,24,148,167,1400,15.15
945,"Enes Kanter\kanteen01","2017-18",25,"NYK","NBA",7.6,71,71,1830,422,713,422,711,0,2,156,184,273,507,780,105,36,37,122,187,1000,15.58
946,"Kerry Kittles\kittlke01","2003-04",29,"NJN","NBA",7.6,82,82,2842,434,959,337,683,97,276,107,136,56,271,327,206,125,40,95,144,1072,12.08
947,"David Lee\leeda02","2013-14",30,"GSW","NBA",7.6,69,67,2288,513,981,513,980,0,1,231,296,182,461,643,147,48,26,152,206,1257,17.04
948,"Rashard Lewis\lewisra02","2006-07",27,"SEA","NBA",7.6,60,60,2348,463,1005,312,618,151,387,265,315,91,305,396,145,68,39,118,143,1342,19.31
949,"Jamaal Magloire\magloja01","2003-04",25,"NOH","NBA",7.6,82,82,2777,383,809,383,808,0,1,353,470,268,579,847,86,43,101,201,278,1119,14.29
950,"CJ McCollum\mccolcj01","2016-17",25,"POR","NBA",7.6,80,80,2796,692,1441,507,1002,185,439,268,294,60,229,289,285,72,42,172,202,1837,18.89
951,"Paul Millsap\millspa01","2012-13",27,"UTA","NBA",7.6,78,78,2375,429,875,416,836,13,39,264,356,177,377,554,201,102,80,138,232,1135,15.1
952,"Cuttino Mobley\moblecu01","2003-04",28,"HOU","NBA",7.6,80,80,3229,460,1081,296,661,164,420,176,217,40,322,362,258,107,33,180,179,1260,14.08
953,"Chris Mullin\mullich01","1997-98",34,"IND","NBA",7.6,82,82,2177,333,692,226,449,107,243,154,164,38,211,249,186,95,39,117,186,927,11.27
954,"Dikembe Mutombo\mutomdi01","1995-96",29,"DEN","NBA",7.6,74,74,2713,284,569,284,568,0,1,246,354,249,622,871,108,38,332,150,258,814,15.95
955,"Dirk Nowitzki\nowitdi01","2011-12",33,"DAL","NBA",7.6,62,62,2079,473,1034,395,822,78,212,318,355,46,372,418,136,42,30,117,129,1342,18.03
956,"Bo Outlaw\outlabo01","1997-98",26,"ORL","NBA",7.6,82,76,2953,301,543,300,539,1,4,180,313,255,382,637,216,107,181,175,260,783,13.53
957,"Chandler Parsons\parsoch01","2013-14",25,"HOU","NBA",7.6,74,74,2783,466,987,336,636,130,351,164,221,69,340,409,298,88,29,144,168,1226,15.94
958,"Domantas Sabonis\sabondo01","2018-19",22,"IND","NBA",7.6,74,5,1838,413,700,404,683,9,17,208,291,186,504,690,212,48,30,160,239,1043,15.92
959,"Damon Stoudamire\stoudda01","1996-97",23,"TOR","NBA",7.6,81,81,3311,564,1407,388,911,176,496,330,401,86,244,330,709,123,13,288,162,1634,19.84
960,"Otis Thorpe\thorpot01","1995-96",33,"DET","NBA",7.6,82,82,2841,452,853,452,849,0,4,257,362,211,477,688,158,53,39,195,300,1161,14.25
961,"Hedo Türkoğlu\turkohe01","2005-06",26,"ORL","NBA",7.6,78,59,2615,398,877,284,594,114,283,255,296,70,263,333,216,70,21,130,234,1165,13.63
962,"Jonas Valančiūnas\valanjo01","2017-18",25,"TOR","NBA",7.6,77,77,1727,390,687,360,613,30,74,170,211,183,477,660,81,29,69,115,192,980,13.46
963,"Rasheed Wallace\wallara01","1997-98",23,"POR","NBA",7.6,77,77,2896,466,875,458,836,8,39,184,278,132,346,478,195,75,88,167,268,1124,14.61
964,"Rasheed Wallace\wallara01","2007-08",33,"DET","NBA",7.6,77,76,2346,376,870,264,555,112,315,115,150,84,427,511,137,91,129,86,213,979,12.83
965,"David Wesley\wesleda01","2000-01",30,"CHH","NBA",7.6,82,82,3106,523,1239,426,981,97,258,271,339,64,160,224,361,128,16,171,220,1414,14.76
966,"Jerome Williams\willije01","1999-00",26,"DET","NBA",7.6,82,1,2102,257,456,257,453,0,3,175,284,277,512,789,68,95,21,105,196,689,11
967,"Micheal Williams\willimi02","1992-93",26,"MIN","NBA",7.6,76,76,2661,353,791,327,684,26,107,419,462,84,189,273,661,165,23,227,268,1151,19.4
968,"LaMarcus Aldridge\aldrila01","2013-14",28,"POR","NBA",7.5,69,69,2498,652,1423,649,1408,3,15,296,360,166,599,765,178,63,68,123,147,1603,20.05
969,"Kenny Anderson\anderke01","1993-94",23,"NJN","NBA",7.5,82,82,3135,576,1381,536,1249,40,132,346,423,89,233,322,784,158,15,266,201,1538,19.72
970,"B.J. Armstrong\armstbj01","1993-94",26,"CHI","NBA",7.5,82,82,2770,479,1007,419,872,60,135,194,227,28,142,170,323,80,9,131,147,1212,13
971,"B.J. Armstrong\armstbj01","1992-93",25,"CHI","NBA",7.5,82,74,2492,408,818,345,679,63,139,130,151,27,122,149,330,66,6,83,169,1009,11.61
972,"Brent Barry\barrybr01","1999-00",28,"SEA","NBA",7.5,80,74,2726,327,707,163,308,164,399,127,157,50,322,372,291,103,31,142,228,945,13.08
973,"Jon Barry\barryjo01","2001-02",32,"DET","NBA",7.5,82,6,1985,255,522,134,264,121,258,108,116,42,192,234,274,94,20,111,134,739,10.56
974,"Andrew Bogut\bogutan01","2009-10",25,"MIL","NBA",7.5,69,69,2229,473,910,473,908,0,2,149,237,208,493,701,127,39,175,131,222,1095,16.56
975,"Elton Brand\brandel01","1999-00",20,"CHI","NBA",7.5,81,80,2999,630,1306,630,1304,0,2,367,536,348,462,810,155,66,132,228,259,1627,18.37
976,"P.J. Brown\brownpj01","1997-98",28,"MIA","NBA",7.5,74,74,2362,278,590,278,590,0,0,151,197,235,400,635,103,66,98,97,264,707,11.45
977,"P.J. Brown\brownpj01","1996-97",27,"MIA","NBA",7.5,80,71,2592,300,656,300,654,0,2,161,220,239,431,670,92,85,98,113,283,761,11.05
978,"José Calderón\caldejo01","2008-09",27,"TOR","NBA",7.5,68,68,2333,320,644,238,442,82,202,151,154,16,178,194,607,74,7,143,114,873,16.62
979,"Vince Carter\cartevi01","2008-09",32,"NJN","NBA",7.5,80,80,2946,588,1345,437,953,151,392,335,410,74,336,410,376,82,38,166,234,1662,18.27
980,"Baron Davis\davisba01","2003-04",24,"NOH","NBA",7.5,67,66,2686,554,1402,367,820,187,582,237,352,66,221,287,501,158,27,215,178,1532,20.43
981,"Goran Dragić\dragigo01","2016-17",30,"MIA","NBA",7.5,73,73,2459,534,1124,417,835,117,289,298,377,62,217,279,423,89,13,212,199,1483,18.96
982,"Michael Finley\finlemi01","1997-98",24,"DAL","NBA",7.5,82,82,3394,675,1505,588,1261,87,244,326,416,150,288,438,405,132,30,219,163,1763,18.97
983,"Tim Hardaway\hardati01","1992-93",26,"GSW","NBA",7.5,66,66,2609,522,1168,420,859,102,309,273,367,60,203,263,699,116,12,220,152,1419,22.6
984,"Devin Harris\harride01","2008-09",25,"NJN","NBA",7.5,69,69,2494,455,1039,391,819,64,220,496,605,30,201,231,476,114,13,212,164,1470,20.72
985,"Al Horford\horfoal01","2018-19",32,"BOS","NBA",7.5,68,68,1973,387,723,314,520,73,203,78,95,120,338,458,283,59,86,102,126,925,15.7
986,"Allan Houston\houstal01","2000-01",29,"NYK","NBA",7.5,78,78,2858,542,1208,446,956,96,252,279,307,20,263,283,173,52,10,161,190,1459,14.26
987,"Andre Iguodala\iguodan01","2005-06",22,"PHI","NBA",7.5,82,82,3086,344,688,288,530,56,158,263,349,117,364,481,255,135,21,153,198,1007,14.01
988,"Mark Jackson\jacksma01","1997-98",32,"IND","NBA",7.5,82,82,2413,249,598,206,461,43,137,137,180,67,255,322,713,84,2,174,132,678,12.87
989,"Al Jefferson\jeffeal01","2011-12",27,"UTA","NBA",7.5,61,61,2075,516,1048,515,1044,1,4,137,177,133,452,585,134,47,101,62,155,1170,17.58
990,"Steve Kerr\kerrst01","1996-97",31,"CHI","NBA",7.5,82,0,1861,249,467,139,230,110,237,54,67,29,101,130,175,67,3,43,98,662,8.21
991,"Kyle Korver\korveky01","2014-15",33,"ATL","NBA",7.5,75,75,2418,292,600,71,151,221,449,106,118,15,289,304,196,52,42,107,140,911,12.58
992,"Christian Laettner\laettch01","1997-98",28,"ATL","NBA",7.5,74,49,2282,354,730,348,703,6,27,306,354,142,345,487,190,71,73,183,246,1020,14.61
993,"Raef LaFrentz\lafrera01","2004-05",28,"BOS","NBA",7.5,80,80,2196,341,688,259,463,82,225,120,148,154,399,553,98,42,99,70,262,884,11.61
994,"Greg Monroe\monrogr01","2015-16",25,"MIL","NBA",7.5,79,67,2314,491,941,491,940,0,1,228,308,218,478,696,178,72,67,129,163,1210,15.67
995,"Alonzo Mourning\mournal01","1997-98",27,"MIA","NBA",7.5,58,56,1939,403,732,403,732,0,0,309,465,193,365,558,52,40,130,179,208,1115,18.83
996,"Tony Parker\parketo01","2003-04",21,"SAS","NBA",7.5,75,75,2577,423,946,361,747,62,199,191,272,43,194,237,411,61,7,179,148,1099,13.63
997,"Dwight Powell\poweldw01","2018-19",27,"DAL","NBA",7.5,77,22,1662,290,486,251,359,39,127,196,254,140,271,411,112,44,50,67,201,815,11.55
998,"Tayshaun Prince\princta01","2007-08",27,"DET","NBA",7.5,82,82,2694,421,940,368,794,53,146,185,241,109,289,398,268,42,33,91,90,1080,11.95
999,"Tayshaun Prince\princta01","2003-04",23,"DET","NBA",7.5,82,80,2701,338,723,281,566,57,157,108,141,93,297,390,191,63,69,119,149,841,10.46
1000,"Clifford Robinson\robincl02","1993-94",27,"POR","NBA",7.5,82,64,2853,641,1404,628,1351,13,53,352,460,164,386,550,159,118,111,169,263,1647,17.13
1001,"Arvydas Sabonis\sabonar01","1996-97",32,"POR","NBA",7.5,69,68,1762,328,658,279,526,49,132,223,287,114,433,547,146,63,84,151,203,928,14.72
1002,"John Starks\starkjo01","1992-93",27,"NYK","NBA",7.5,80,51,2477,513,1199,405,863,108,336,263,331,54,150,204,404,91,12,173,234,1397,14.99
1003,"David West\westda01","2009-10",29,"NOH","NBA",7.5,81,81,2949,619,1226,612,1199,7,27,296,342,164,441,605,239,76,60,173,233,1541,17.77
1004,"Nick Anderson\anderni01","1995-96",28,"ORL","NBA",7.4,77,77,2717,400,904,232,474,168,430,166,240,92,323,415,279,121,46,141,135,1134,14.88
1005,"Shawn Bradley\bradlsh01","2002-03",30,"DAL","NBA",7.4,81,39,1731,201,375,201,374,0,1,141,175,151,325,476,54,65,170,67,242,543,9.38
1006,"José Calderón\caldejo01","2012-13",31,"TOT","NBA",7.4,73,58,2160,312,635,182,353,130,282,72,80,20,156,176,518,58,8,126,99,826,13.69
1007,"Vince Carter\cartevi01","2009-10",33,"ORL","NBA",7.4,75,74,2310,434,1015,315,691,119,324,257,306,33,260,293,236,53,18,106,189,1244,13.81
1008,"Antonio Davis\davisan01","1997-98",29,"IND","NBA",7.4,82,12,2191,254,528,254,525,0,3,277,398,192,368,560,61,45,72,103,234,785,10.13
1009,"Vlade Divac\divacvl01","1993-94",25,"LAL","NBA",7.4,79,73,2685,453,895,444,848,9,47,208,303,282,569,851,307,92,112,191,288,1123,17.28
1010,"Vlade Divac\divacvl01","2000-01",32,"SAC","NBA",7.4,81,81,2420,364,755,360,741,4,14,242,350,207,466,673,231,87,93,192,242,974,13.96
1011,"Andre Drummond\drumman01","2015-16",22,"DET","NBA",7.4,81,81,2666,552,1060,550,1054,2,6,208,586,395,803,1198,67,119,112,155,245,1314,16.85
1012,"Tim Duncan\duncati01","2013-14",37,"SAS","NBA",7.4,74,74,2158,444,906,444,901,0,5,231,316,158,563,721,220,43,139,159,134,1119,16.37
1013,"Richard Hamilton\hamilri01","2004-05",26,"DET","NBA",7.4,76,76,2926,510,1160,474,1042,36,118,368,429,74,221,295,372,77,13,217,232,1424,16.53
1014,"Ty Lawson\lawsoty01","2012-13",25,"DEN","NBA",7.4,73,71,2513,448,971,363,739,85,232,235,311,36,162,198,501,107,8,182,135,1216,16.82
1015,"David Lee\leeda02","2007-08",24,"NYK","NBA",7.4,81,29,2356,341,618,341,616,0,2,194,237,242,482,724,95,55,29,97,210,876,12.27
1016,"Stephon Marbury\marbust01","1999-00",22,"NJN","NBA",7.4,74,74,2881,569,1317,503,1084,66,233,436,536,61,179,240,622,112,15,270,195,1640,21.08
1017,"Shawn Marion\mariosh01","2007-08",29,"TOT","NBA",7.4,63,62,2315,400,787,334,589,66,198,106,150,136,507,643,138,125,85,86,150,972,17.49
1018,"Anthony Mason\masonan01","1992-93",26,"NYK","NBA",7.4,81,0,2482,316,629,316,629,0,0,199,292,231,409,640,170,43,19,137,240,831,11.25
1019,"Derrick McKey\mckeyde01","1994-95",28,"IND","NBA",7.4,81,81,2805,411,833,379,744,32,89,221,297,125,269,394,276,125,49,168,260,1075,14.02
1020,"Mike Miller\millemi01","2005-06",25,"MEM","NBA",7.4,74,9,2268,354,760,216,421,138,339,168,210,42,355,397,200,52,27,140,173,1014,13.2
1021,"Reggie Miller\millere01","2002-03",37,"IND","NBA",7.4,70,70,2117,281,637,168,319,113,318,207,230,21,151,172,170,62,4,66,89,882,11.31
1022,"Yao Ming\mingya01","2006-07",26,"HOU","NBA",7.4,48,48,1624,423,819,423,817,0,2,356,413,101,351,452,94,17,94,167,159,1202,23.01
1023,"Alonzo Mourning\mournal01","2001-02",31,"MIA","NBA",7.4,75,74,2455,447,866,446,863,1,3,283,431,182,450,632,87,27,186,182,258,1178,15.5
1024,"Mehmet Okur\okurme01","2008-09",29,"UTA","NBA",7.4,72,72,2409,431,888,341,686,90,202,273,334,124,433,557,120,54,53,132,219,1225,15.96
1025,"Brent Price\pricebr01","1995-96",27,"WSB","NBA",7.4,81,50,2042,252,534,113,233,139,301,167,191,38,190,228,416,78,4,153,184,810,12.23
1026,"Jason Richardson\richaja01","2007-08",27,"CHA","NBA",7.4,82,82,3149,648,1468,405,869,243,599,249,331,80,361,441,258,116,57,166,241,1788,18.29
1027,"Rodney Rogers\rogerro01","1999-00",28,"PHO","NBA",7.4,82,7,2286,428,881,313,619,115,262,159,249,138,309,447,170,94,47,163,290,1130,13.09
1028,"Bryon Russell\russebr01","1996-97",26,"UTA","NBA",7.4,81,81,2525,297,620,189,356,108,264,171,244,79,252,331,123,129,27,94,237,873,11.05
1029,"Lance Stephenson\stephla01","2013-14",23,"IND","NBA",7.4,78,78,2752,427,870,341,626,86,244,140,197,95,463,558,359,54,7,210,195,1080,14.77
1030,"Rod Strickland\stricro02","1992-93",26,"POR","NBA",7.4,78,35,2474,396,816,392,786,4,30,273,381,120,217,337,559,131,24,199,153,1069,16.5
1031,"Wally Szczerbiak\szczewa02","2000-01",23,"MIN","NBA",7.4,82,82,2856,469,920,443,843,26,77,181,208,133,314,447,260,59,33,138,226,1145,13.67
1032,"Jason Terry\terryja01","2002-03",25,"ATL","NBA",7.4,81,81,3081,488,1141,328,710,160,431,259,292,37,242,279,600,126,14,249,175,1395,17.85
1033,"Kemba Walker\walkeke02","2018-19",28,"CHO","NBA",7.4,82,82,2863,731,1684,471,953,260,731,380,450,52,309,361,484,102,34,211,131,2102,21.91
1034,"David West\westda01","2005-06",25,"NOK","NBA",7.4,74,74,2526,530,1036,527,1025,3,11,199,236,168,380,548,92,61,64,105,214,1262,15.18
1035,"Hot Rod Williams\williho01","1993-94",31,"CLE","NBA",7.4,76,72,2660,394,825,394,825,0,0,252,346,207,368,575,193,78,130,139,219,1040,14.69
1036,"Thaddeus Young\youngth01","2012-13",24,"PHI","NBA",7.4,76,76,2629,509,958,508,950,1,8,108,188,182,389,571,125,133,55,90,191,1127,14.68
1037,"Kenny Anderson\anderke01","1999-00",29,"BOS","NBA",7.3,82,82,2593,434,986,349,766,85,220,196,253,55,170,225,420,139,8,130,230,1149,13.88
1038,"Carmelo Anthony\anthoca01","2006-07",22,"DEN","NBA",7.3,65,65,2486,691,1453,651,1304,40,149,459,568,143,248,391,249,77,23,234,203,1881,23.39
1039,"Brent Barry\barrybr01","2002-03",31,"SEA","NBA",7.3,75,68,2480,264,577,146,284,118,293,128,161,48,253,301,384,113,15,142,199,774,13
1040,"Jamal Crawford\crawfja01","2009-10",29,"ATL","NBA",7.3,79,0,2460,496,1105,333,678,163,427,270,315,34,167,201,238,61,12,137,132,1425,14.54
1041,"Jae Crowder\crowdja01","2015-16",25,"BOS","NBA",7.3,73,73,2308,360,813,238,450,122,363,196,239,70,303,373,135,126,35,83,198,1038,13.56
1042,"Vlade Divac\divacvl01","2001-02",33,"SAC","NBA",7.3,80,80,2420,338,716,335,703,3,13,209,340,205,466,671,297,79,94,158,229,888,13.63
1043,"Vlade Divac\divacvl01","1996-97",28,"CHH","NBA",7.3,81,80,2840,418,847,407,800,11,47,177,259,241,484,725,301,103,180,193,277,1024,15.99
1044,"Kevin Garnett\garneke01","1996-97",20,"MIN","NBA",7.3,77,77,2995,549,1100,543,1079,6,21,205,272,190,428,618,236,105,163,175,199,1309,17.71
1045,"Kevin Garnett\garneke01","2009-10",33,"BOS","NBA",7.3,69,69,2060,402,772,401,767,1,5,185,221,78,428,506,185,68,57,101,170,990,15.01
1046,"Marcin Gortat\gortama01","2015-16",31,"WAS","NBA",7.3,75,74,2256,433,764,433,763,0,1,146,207,222,519,741,106,47,96,121,193,1012,14.81
1047,"Danny Granger\grangda01","2007-08",24,"IND","NBA",7.3,80,80,2876,537,1205,366,782,171,423,322,378,93,393,486,166,95,84,171,290,1567,17.25
1048,"Jerami Grant\grantje01","2018-19",24,"OKC","NBA",7.3,80,77,2612,409,823,294,530,115,293,157,221,96,321,417,79,61,100,67,214,1090,12.56
1049,"Richard Hamilton\hamilri01","2002-03",24,"DET","NBA",7.3,82,82,2640,570,1286,538,1167,32,119,440,528,88,230,318,208,64,13,200,249,1612,15.25
1050,"Tim Hardaway\hardati01","1995-96",29,"TOT","NBA",7.3,80,46,2534,419,992,281,613,138,379,241,305,35,194,229,640,132,17,235,201,1217,16.85
1051,"Grant Hill\hillgr01","1998-99",26,"DET","NBA",7.3,50,50,1852,384,802,384,788,0,14,285,379,65,290,355,300,80,27,184,114,1053,21.17
1052,"Dwight Howard\howardw01","2004-05",19,"ORL","NBA",7.3,82,82,2670,352,677,352,675,0,2,277,413,287,536,823,75,77,136,165,232,981,13.99
1053,"Andre Iguodala\iguodan01","2011-12",28,"PHI","NBA",7.3,62,62,2209,287,632,211,439,76,193,121,196,56,325,381,339,107,30,115,92,771,15.02
1054,"Amir Johnson\johnsam01","2012-13",25,"TOR","NBA",7.3,81,38,2325,336,606,331,593,5,13,136,187,227,384,611,122,81,110,117,301,813,12.23
1055,"Terrence Jones\joneste01","2013-14",22,"HOU","NBA",7.3,76,71,2078,386,712,355,611,31,101,118,195,162,366,528,87,53,99,71,139,921,12.38
1056,"Andrei Kirilenko\kirilan01","2001-02",20,"UTA","NBA",7.3,82,40,2151,285,633,260,533,25,100,285,371,149,253,402,94,116,159,108,156,880,11.83
1057,"Dan Majerle\majerda01","1993-94",28,"PHO","NBA",7.3,80,76,3207,476,1138,284,635,192,503,176,238,120,229,349,275,129,43,137,153,1320,14.75
1058,"Jamal Mashburn\mashbja01","2000-01",28,"CHH","NBA",7.3,76,76,2989,573,1388,470,1099,103,289,279,364,92,484,576,411,85,13,211,185,1528,17.94
1059,"Steve Nash\nashst01","2008-09",34,"PHO","NBA",7.3,74,74,2484,428,851,320,605,108,246,196,210,19,204,223,717,55,10,248,108,1160,18.69
1060,"Joakim Noah\noahjo01","2012-13",27,"CHI","NBA",7.3,66,64,2426,303,630,303,625,0,5,178,237,260,473,733,262,78,141,176,185,784,16.57
1061,"Charles Oakley\oaklech01","1992-93",29,"NYK","NBA",7.3,82,82,2230,219,431,219,430,0,1,127,176,288,420,708,126,85,15,124,289,565,9.73
1062,"Chris Paul\paulch01","2009-10",24,"NOH","NBA",7.3,45,45,1712,314,637,262,510,52,127,161,190,20,171,191,480,96,8,112,118,841,22.74
1063,"Jason Richardson\richaja01","2005-06",25,"GSW","NBA",7.3,75,75,2877,641,1438,458,961,183,477,276,410,105,333,438,232,97,37,167,206,1741,18.64
1064,"Jalen Rose\roseja01","2000-01",28,"IND","NBA",7.3,72,72,2943,567,1242,508,1068,59,174,285,344,37,322,359,435,65,43,211,230,1478,18.82
1065,"Jalen Rose\roseja01","1999-00",27,"IND","NBA",7.3,80,80,2978,563,1196,486,1000,77,196,254,307,42,345,387,320,84,49,188,234,1457,16.51
1066,"Jerry Stackhouse\stackje01","1999-00",25,"DET","NBA",7.3,82,82,3148,619,1447,536,1159,83,288,618,758,118,197,315,365,103,36,311,188,1939,19.85
1067,"Peja Stojaković\stojape01","2004-05",27,"SAC","NBA",7.3,66,66,2534,451,1016,277,583,174,433,253,275,62,223,285,138,79,12,102,157,1329,16.48
1068,"Wally Szczerbiak\szczewa02","2004-05",27,"MIN","NBA",7.3,81,37,2558,465,919,402,750,63,169,260,304,82,221,303,191,40,16,132,178,1253,13.39
1069,"Jason Terry\terryja01","2008-09",31,"DAL","NBA",7.3,74,11,2491,541,1168,374,712,167,456,198,225,39,138,177,251,97,20,119,141,1447,16.11
1070,"Tristan Thompson\thomptr01","2016-17",25,"CLE","NBA",7.3,78,78,2336,262,437,262,434,0,3,106,213,286,429,715,77,39,84,64,176,630,10.56
1071,"Hedo Türkoğlu\turkohe01","2008-09",29,"ORL","NBA",7.3,77,77,2815,423,1025,289,649,134,376,314,389,45,365,410,375,64,19,204,218,1294,15.84
1072,"Deron Williams\willide01","2010-11",26,"TOT","NBA",7.3,65,65,2465,428,975,323,658,105,317,348,412,40,220,260,667,79,15,230,190,1309,22.04
1073,"Shareef Abdur-Rahim\abdursh01","2001-02",25,"ATL","NBA",7.2,77,77,2980,598,1297,577,1227,21,70,419,523,198,498,696,239,98,81,250,214,1636,19.82
1074,"LaMarcus Aldridge\aldrila01","2016-17",31,"SAS","NBA",7.2,72,72,2335,500,1049,477,993,23,56,220,271,172,351,523,139,46,88,98,158,1243,15.31
1075,"LaMarcus Aldridge\aldrila01","2012-13",27,"POR","NBA",7.2,74,74,2790,638,1318,636,1304,2,14,282,348,175,495,670,192,62,91,143,187,1560,18.84
1076,"Travis Best\besttr01","2000-01",28,"IND","NBA",7.2,77,21,2457,347,788,310,691,37,97,187,226,38,184,222,473,110,11,127,246,918,13.34
1077,"Caron Butler\butleca01","2007-08",27,"WAS","NBA",7.2,58,58,2314,439,943,373,758,66,185,236,262,93,295,388,284,128,20,150,160,1180,20.36
1078,"Brian Cardinal\cardibr01","2003-04",26,"GSW","NBA",7.2,76,11,1634,220,466,165,342,55,124,238,271,100,217,317,103,66,20,84,206,733,10.01
1079,"Anthony Davis\davisan02","2015-16",22,"NOP","NBA",7.2,61,61,2164,560,1136,525,1028,35,108,326,430,130,497,627,116,78,125,121,148,1481,22.39
1080,"Antonio Davis\davisan01","2000-01",32,"TOR","NBA",7.2,78,77,2729,375,866,375,865,0,1,319,423,274,513,787,106,22,151,135,230,1069,13.95
1081,"Vlade Divac\divacvl01","1999-00",31,"SAC","NBA",7.2,82,81,2374,384,764,377,738,7,26,230,333,174,482,656,244,103,103,190,251,1005,14.52
1082,"Danilo Gallinari\gallida01","2012-13",24,"DEN","NBA",7.2,71,71,2309,364,871,229,509,135,362,286,348,65,302,367,176,64,36,111,130,1149,14.36
1083,"Taj Gibson\gibsota01","2017-18",32,"MIN","NBA",7.2,82,82,2726,425,737,418,702,7,35,142,185,194,390,584,99,62,59,89,218,999,12.71
1084,"Ron Harper\harpero01","1997-98",34,"CHI","NBA",7.2,82,82,2284,293,665,277,581,16,84,162,216,107,183,290,241,108,48,91,181,764,10
1085,"Kirk Hinrich\hinriki01","2004-05",24,"CHI","NBA",7.2,77,77,2800,445,1122,300,714,145,408,171,216,32,272,304,494,122,21,176,244,1206,15.39
1086,"Allan Houston\houstal01","2002-03",31,"NYK","NBA",7.2,82,82,3108,652,1465,474,1015,178,450,363,395,26,205,231,220,54,7,178,191,1845,16.74
1087,"Allen Iverson\iversal01","1998-99",23,"PHI","NBA",7.2,48,48,1990,435,1056,377,857,58,199,356,474,66,170,236,223,110,7,167,98,1284,21.6
1088,"Mark Jackson\jacksma01","1995-96",30,"IND","NBA",7.2,81,81,2643,296,626,232,477,64,149,150,191,66,241,307,635,100,5,201,153,806,14.08
1089,"LeBron James\jamesle01","2018-19",34,"LAL","NBA",7.2,55,55,1937,558,1095,447,768,111,327,278,418,57,408,465,454,72,33,197,94,1505,27.36
1090,"Eddie Jones\jonesed02","2005-06",34,"MEM","NBA",7.2,75,75,2437,292,722,159,348,133,374,168,215,35,244,279,177,131,27,93,201,885,11.51
1091,"Jason Kidd\kiddja01","2004-05",31,"NJN","NBA",7.2,66,65,2435,340,855,211,497,129,358,142,192,94,394,488,545,123,9,167,110,951,17.8
1092,"Jason Kidd\kiddja01","2003-04",30,"NJN","NBA",7.2,67,66,2450,368,959,274,666,94,293,206,249,85,343,428,618,122,14,214,110,1036,18.36
1093,"Wesley Matthews\matthwe02","2010-11",24,"POR","NBA",7.2,82,69,2758,440,979,286,601,154,378,266,315,48,210,258,164,102,9,138,195,1300,13.38
1094,"Paul Millsap\millspa01","2009-10",24,"UTA","NBA",7.2,82,8,2277,385,716,384,707,1,9,183,264,186,373,559,131,64,99,116,285,954,12.48
1095,"Chris Morris\morrich01","1992-93",27,"NJN","NBA",7.2,77,57,2302,436,907,419,831,17,76,197,248,227,227,454,106,144,52,119,171,1086,13.52
1096,"Eric Murdock\murdoer01","1993-94",25,"MIL","NBA",7.2,82,76,2533,477,1019,408,851,69,168,234,288,91,170,261,546,197,12,206,189,1257,17.13
1097,"Rasho Nesterović\nestera01","2003-04",27,"SAS","NBA",7.2,82,82,2353,328,700,328,700,0,0,54,114,257,376,633,114,51,165,107,247,710,10.08
1098,"Dirk Nowitzki\nowitdi01","2014-15",36,"DAL","NBA",7.2,77,77,2282,487,1062,383,788,104,274,255,289,44,413,457,143,39,33,82,160,1333,14.49
1099,"Gary Payton\paytoga01","1998-99",30,"SEA","NBA",7.2,50,50,2008,401,923,318,642,83,281,199,276,62,182,244,436,109,12,154,115,1084,21.75
1100,"Paul Pierce\piercpa01","2012-13",35,"BOS","NBA",7.2,77,77,2575,476,1092,331,710,145,382,333,423,45,442,487,370,84,30,214,210,1430,17.91
1101,"Zach Randolph\randoza01","2014-15",33,"MEM","NBA",7.2,71,71,2304,454,932,447,912,7,20,228,298,225,522,747,153,69,14,156,175,1143,15.9
1102,"Rajon Rondo\rondora01","2007-08",21,"BOS","NBA",7.2,77,77,2306,351,713,346,694,5,19,107,175,78,244,322,393,129,13,147,187,814,12.6
1103,"Rik Smits\smitsri01","1994-95",28,"IND","NBA",7.2,78,78,2381,558,1060,558,1058,0,2,284,377,192,409,601,111,40,79,189,278,1400,16.12
1104,"Beno Udrih\udrihbe01","2010-11",28,"SAC","NBA",7.2,79,64,2734,412,824,347,642,65,182,197,228,41,224,265,386,94,9,141,181,1086,14.41
1105,"Nick Van Exel\vanexni01","1996-97",25,"LAL","NBA",7.2,79,79,2937,432,1075,255,607,177,468,165,200,44,182,226,672,75,10,212,110,1206,15.89
1106,"Deron Williams\willide01","2006-07",22,"UTA","NBA",7.2,80,80,2950,494,1083,412,828,82,255,227,296,41,226,267,745,78,13,246,254,1297,17.8
1107,"Metta World Peace\artesro01","2002-03",23,"IND","NBA",7.2,69,67,2317,362,846,291,635,71,211,273,371,101,261,362,198,159,50,145,242,1068,15.34
1108,"Giannis Antetokounmpo\antetgi01","2015-16",21,"MIL","NBA",7.1,80,79,2823,513,1013,485,904,28,109,296,409,113,499,612,345,94,113,208,258,1350,18.25
1109,"Jimmy Butler\butleji01","2013-14",24,"CHI","NBA",7.1,67,67,2591,275,693,207,453,68,240,260,338,87,243,330,175,127,36,102,106,878,13.11
1110,"Dale Davis\davisda01","1999-00",30,"IND","NBA",7.1,74,72,2127,302,602,302,602,0,0,139,203,256,473,729,64,52,94,91,203,743,11.77
1111,"Dale Davis\davisda01","1997-98",28,"IND","NBA",7.1,78,78,2174,273,498,273,498,0,0,80,172,233,378,611,70,51,87,73,209,626,9.68
1112,"Derrick Favors\favorde01","2015-16",24,"UTA","NBA",7.1,62,59,1983,418,811,418,807,0,4,180,254,169,334,503,94,74,91,104,150,1016,15.98
1113,"Steve Francis\francst01","2003-04",26,"HOU","NBA",7.1,79,79,3194,450,1117,377,867,73,250,337,435,116,317,433,493,139,35,294,257,1310,17.1
1114,"Kevin Garnett\garneke01","2008-09",32,"BOS","NBA",7.1,57,57,1772,393,740,391,732,2,8,111,132,78,407,485,144,63,68,90,128,899,16.41
1115,"Pau Gasol\gasolpa01","2015-16",35,"CHI","NBA",7.1,72,72,2291,467,995,443,926,24,69,229,289,155,638,793,294,42,146,164,148,1187,18.34
1116,"Paul George\georgpa01","2016-17",26,"IND","NBA",7.1,75,75,2689,622,1348,427,852,195,496,336,374,58,434,492,251,119,27,220,206,1775,21.01
1117,"Horace Grant\grantho01","1997-98",32,"ORL","NBA",7.1,76,76,2803,393,857,393,850,0,7,135,199,228,390,618,172,81,79,88,180,921,12.59
1118,"Anfernee Hardaway\hardaan01","1993-94",22,"ORL","NBA",7.1,82,82,3015,509,1092,459,905,50,187,245,330,192,247,439,544,190,51,292,205,1313,18.3
1119,"James Harden\hardeja01","2010-11",21,"OKC","NBA",7.1,82,5,2189,298,684,185,360,113,324,289,343,42,213,255,176,92,24,106,207,998,11.6
1120,"Tobias Harris\harrito02","2018-19",26,"TOT","NBA",7.1,82,82,2847,611,1254,455,861,156,393,266,307,69,576,645,229,51,37,151,184,1644,18.16
1121,"Jrue Holiday\holidjr01","2017-18",27,"NOP","NBA",7.1,81,81,2927,615,1244,495,888,120,356,187,238,62,303,365,486,123,64,213,201,1537,19.08
1122,"Allan Houston\houstal01","1995-96",24,"DET","NBA",7.1,82,75,3072,564,1244,373,797,191,447,298,362,54,246,300,250,61,16,233,233,1617,16.02
1123,"DeAndre Jordan\jordade01","2018-19",30,"TOT","NBA",7.1,69,69,2047,286,446,286,446,0,0,186,264,225,677,902,156,42,73,153,167,758,15.83
1124,"Andrei Kirilenko\kirilan01","2007-08",26,"UTA","NBA",7.1,72,72,2217,275,544,231,428,44,116,198,257,121,218,339,285,86,109,140,165,792,13.82
1125,"Voshon Lenard\lenarvo01","1997-98",24,"MIA","NBA",7.1,81,81,2621,363,854,210,476,153,378,141,179,72,220,292,180,58,16,99,219,1020,10.67
1126,"Kyle Lowry\lowryky01","2014-15",28,"TOR","NBA",7.1,70,70,2414,430,1043,298,652,132,391,252,312,54,274,328,473,109,13,173,212,1244,17.75
1127,"Stephon Marbury\marbust01","2001-02",24,"PHO","NBA",7.1,82,80,3187,625,1413,554,1165,71,248,353,452,75,191,266,666,77,13,284,186,1674,18.95
1128,"Kenyon Martin\martike01","2002-03",25,"NJN","NBA",7.1,77,77,2628,509,1082,500,1039,9,43,256,392,164,476,640,185,98,70,192,294,1283,15.68
1129,"Chris Mullin\mullich01","1996-97",33,"GSW","NBA",7.1,79,63,2733,438,792,355,590,83,202,184,213,75,242,317,322,130,33,192,155,1143,15.92
1130,"Emeka Okafor\okafoem01","2006-07",24,"CHA","NBA",7.1,67,65,2329,394,740,394,740,0,0,175,295,258,499,757,80,57,172,111,210,963,16.28
1131,"Tony Parker\parketo01","2011-12",29,"SAS","NBA",7.1,60,60,1923,427,890,413,829,14,61,227,284,22,149,171,463,57,5,153,75,1095,17.88
1132,"Sam Perkins\perkisa01","1996-97",35,"SEA","NBA",7.1,81,4,1976,290,661,168,352,122,309,187,229,74,226,300,103,69,49,77,134,889,10.13
1133,"Bobby Phills\phillbo01","1995-96",26,"CLE","NBA",7.1,72,69,2530,386,826,293,615,93,211,186,240,62,199,261,271,102,27,126,192,1051,14.18
1134,"Paul Pierce\piercpa01","2003-04",26,"BOS","NBA",7.1,80,80,3099,602,1497,487,1113,115,384,517,631,69,453,522,410,131,52,303,234,1836,20.58
1135,"Zach Randolph\randoza01","2003-04",22,"POR","NBA",7.1,81,80,3067,663,1368,662,1363,1,5,299,393,242,609,851,163,68,41,247,227,1626,17.87
1136,"Clifford Robinson\robincl02","1997-98",31,"PHO","NBA",7.1,80,64,2359,429,895,402,811,27,84,248,360,152,258,410,170,92,90,140,249,1133,13.39
1137,"Arvydas Sabonis\sabonar01","1999-00",35,"POR","NBA",7.1,66,61,1688,302,598,295,579,7,19,167,198,97,416,513,118,43,78,97,184,778,12.93
1138,"John Salmons\salmojo01","2009-10",30,"TOT","NBA",7.1,81,56,2824,437,991,319,682,118,309,253,305,35,235,270,223,99,26,123,166,1245,13.41
1139,"Rod Strickland\stricro02","1995-96",29,"POR","NBA",7.1,67,63,2526,471,1023,433,912,38,111,276,423,89,208,297,640,97,16,255,135,1256,20.07
1140,"Jayson Tatum\tatumja01","2017-18",19,"BOS","NBA",7.1,80,80,2438,397,835,292,593,105,242,213,258,50,352,402,128,83,58,114,170,1112,13.03
1141,"Klay Thompson\thompkl01","2016-17",26,"GSW","NBA",7.1,78,78,2649,644,1376,376,729,268,647,186,218,49,236,285,160,66,40,128,139,1742,17.23
1142,"Sedale Threatt\threase01","1992-93",31,"LAL","NBA",7.1,82,82,2893,522,1028,508,975,14,53,177,215,47,226,273,564,142,11,173,248,1235,16.62
1143,"Nick Van Exel\vanexni01","1997-98",26,"LAL","NBA",7.1,64,46,2053,311,743,188,427,123,316,136,172,31,163,194,442,64,6,104,120,881,14.47
1144,"Rasheed Wallace\wallara01","2004-05",30,"DET","NBA",7.1,79,79,2687,467,1062,392,826,75,236,136,195,174,470,644,142,65,115,127,236,1145,13.51
1145,"Charlie Ward\wardch01","1997-98",27,"NYK","NBA",7.1,82,82,2317,235,516,154,301,81,215,91,113,32,242,274,466,144,37,175,195,642,11.85
1146,"LaMarcus Aldridge\aldrila01","2011-12",26,"POR","NBA",7,55,55,1994,483,943,481,932,2,11,223,274,150,292,442,134,51,45,111,153,1191,19.21
1147,"Ray Allen\allenra02","1997-98",22,"MIL","NBA",7,82,82,3287,563,1315,429,947,134,368,342,391,127,278,405,356,111,12,263,244,1602,17.29
1148,"B.J. Armstrong\armstbj01","1995-96",28,"GSW","NBA",7,82,64,2262,340,727,242,520,98,207,234,279,22,162,184,401,68,6,128,147,1012,12.78
1149,"Mookie Blaylock\blaylmo01","1992-93",25,"ATL","NBA",7,80,78,2820,414,964,296,649,118,315,123,169,89,191,280,671,203,23,187,156,1069,16.78
1150,"Eric Bledsoe\bledser01","2014-15",25,"PHO","NBA",7,81,81,2800,468,1046,380,774,88,272,353,441,72,351,423,493,127,45,274,189,1377,18.14
1151,"Jimmy Butler\butleji01","2012-13",23,"CHI","NBA",7,82,20,2134,239,512,199,407,40,105,187,233,136,192,328,115,78,31,62,97,705,8.97
1152,"Elden Campbell\campbel01","1996-97",28,"LAL","NBA",7,77,77,2516,442,942,441,938,1,4,263,370,207,408,615,126,46,117,130,276,1148,14.09
1153,"DeMarre Carroll\carrode01","2014-15",28,"ATL","NBA",7,70,69,2189,318,653,198,349,120,304,127,181,99,273,372,118,94,17,75,154,883,12.41
1154,"Vince Carter\cartevi01","2001-02",25,"TOR","NBA",7,60,60,2385,559,1307,438,994,121,313,245,307,138,175,313,239,94,43,154,191,1484,19.74
1155,"Doug Christie\chrisdo01","1996-97",26,"TOR","NBA",7,81,81,3127,396,949,249,566,147,383,237,306,85,347,432,315,201,45,200,245,1176,15.66
1156,"Dale Davis\davisda01","1993-94",24,"IND","NBA",7,66,64,2292,308,582,308,581,0,1,155,294,280,438,718,100,48,106,102,214,771,13.8
1157,"Vlade Divac\divacvl01","2002-03",34,"SAC","NBA",7,80,80,2384,305,655,299,630,6,25,179,251,157,417,574,274,83,105,152,239,795,12.6
1158,"Udonis Haslem\hasleud01","2005-06",25,"MIA","NBA",7,81,80,2491,300,591,300,589,0,2,157,199,167,467,634,95,50,17,80,216,757,10.23
1159,"Juwan Howard\howarju01","1996-97",23,"WSB","NBA",7,82,82,3324,638,1313,638,1311,0,2,294,389,202,450,652,311,93,23,246,259,1570,17.75
1160,"Joe Johnson\johnsjo02","2007-08",26,"ATL","NBA",7,82,82,3343,647,1497,478,1053,169,444,316,379,83,284,367,474,84,18,223,168,1779,18.78
1161,"Toni Kukoč\kukocto01","1997-98",29,"CHI","NBA",7,74,52,2235,383,841,320,667,63,174,155,219,121,206,327,314,76,37,154,149,984,13.18
1162,"Ty Lawson\lawsoty01","2014-15",27,"DEN","NBA",7,75,75,2665,404,926,334,721,70,205,265,363,42,192,234,720,92,9,185,128,1143,17.51
1163,"Brook Lopez\lopezbr01","2014-15",26,"BRK","NBA",7,72,44,2100,506,987,505,977,1,10,223,274,214,321,535,50,43,126,104,206,1236,15.38
1164,"Kyle Lowry\lowryky01","2010-11",24,"HOU","NBA",7,75,71,2563,345,809,216,466,129,343,192,251,89,220,309,500,102,23,158,207,1011,15.34
1165,"Corey Maggette\maggeco01","2006-07",27,"LAC","NBA",7,75,31,2291,367,808,354,743,13,65,519,633,90,352,442,208,65,14,201,244,1266,15.98
1166,"Kevin Martin\martike02","2012-13",29,"OKC","NBA",7,77,0,2136,350,778,192,407,158,371,219,246,31,147,178,106,72,8,101,138,1077,11.49
1167,"Andre Miller\millean02","2010-11",34,"POR","NBA",7,81,81,2650,388,844,384,807,4,37,249,292,97,205,302,566,114,12,197,171,1029,15.01
1168,"Andre Miller\millean02","2004-05",28,"DEN","NBA",7,82,82,2852,427,895,421,856,6,39,253,302,100,238,338,569,121,8,220,204,1113,15.83
1169,"Andre Miller\millean02","2009-10",33,"POR","NBA",7,82,66,2500,404,908,388,828,16,80,322,392,81,185,266,445,93,9,173,169,1146,14.16
1170,"Mike Miller\millemi01","2004-05",24,"MEM","NBA",7,76,51,2278,387,766,247,443,140,323,108,150,36,264,300,220,54,23,127,197,1022,12.74
1171,"Greg Monroe\monrogr01","2011-12",21,"DET","NBA",7,66,66,2082,407,781,407,780,0,1,201,272,239,398,637,152,83,46,161,180,1015,16.35
1172,"Charles Oakley\oaklech01","1997-98",34,"NYK","NBA",7,79,79,2734,307,698,307,692,0,6,97,114,218,506,724,201,123,22,126,280,711,11.48
1173,"Mehmet Okur\okurme01","2004-05",25,"UTA","NBA",7,82,25,2304,354,756,337,693,17,63,329,387,194,422,616,166,32,68,141,227,1054,13.24
1174,"Tony Parker\parketo01","2007-08",25,"SAS","NBA",7,69,68,2312,515,1043,498,977,17,66,248,347,30,191,221,411,55,8,164,93,1295,16.93
1175,"Chandler Parsons\parsoch01","2012-13",24,"HOU","NBA",7,76,76,2758,456,939,304,544,152,395,113,155,79,325,404,269,75,32,147,148,1177,14.9
1176,"Sam Perkins\perkisa01","1993-94",32,"SEA","NBA",7,81,41,2170,341,779,242,509,99,270,218,272,120,246,366,111,67,31,103,197,999,10.88
1177,"Paul Pierce\piercpa01","2011-12",34,"BOS","NBA",7,61,61,2075,394,890,294,617,100,273,293,344,37,280,317,274,70,26,173,147,1181,18.07
1178,"Tayshaun Prince\princta01","2005-06",25,"DET","NBA",7,82,82,2898,455,999,391,816,64,183,182,238,104,242,346,186,62,39,91,96,1156,11.88
1179,"Nikola Vučević\vucevni01","2014-15",24,"ORL","NBA",7,74,74,2529,631,1206,629,1200,2,6,164,218,238,572,810,147,54,54,148,220,1428,18.02
1180,"Ben Wallace\wallabe01","2000-01",26,"DET","NBA",7,80,80,2760,215,439,214,435,1,4,80,238,303,749,1052,123,107,186,117,192,511,12.13
1181,"David Wesley\wesleda01","2002-03",32,"NOH","NBA",7,73,73,2710,449,1037,315,721,134,316,185,237,38,137,175,251,109,9,132,173,1217,13.85
1182,"Shareef Abdur-Rahim\abdursh01","1997-98",21,"VAN","NBA",6.9,82,82,2950,653,1347,632,1296,21,51,502,640,227,354,581,213,89,76,257,201,1829,19.7
1183,"Ray Allen\allenra02","2003-04",28,"SEA","NBA",6.9,56,56,2152,447,1017,299,639,148,378,245,271,69,217,286,268,71,11,156,132,1287,20.07
1184,"D.J. Augustin\augusdj01","2018-19",31,"ORL","NBA",6.9,81,81,2269,318,677,187,366,131,311,181,209,41,162,203,426,52,4,128,115,948,12.65
1185,"Bradley Beal\bealbr01","2017-18",24,"WAS","NBA",6.9,82,82,2977,683,1484,484,954,199,530,292,369,61,302,363,373,96,36,214,160,1857,19.37
1186,"Mike Bibby\bibbymi01","2008-09",30,"ATL","NBA",6.9,79,79,2740,437,1005,270,577,167,428,135,171,38,240,278,392,98,11,128,145,1176,14.23
1187,"Chris Bosh\boshch01","2011-12",27,"MIA","NBA",6.9,57,57,2007,393,807,383,772,10,35,229,279,94,358,452,103,51,45,117,128,1025,16.36
1188,"P.J. Brown\brownpj01","2004-05",35,"NOH","NBA",6.9,82,78,2817,338,758,338,758,0,0,210,243,266,471,737,178,74,50,101,233,886,12.27
1189,"P.J. Brown\brownpj01","1999-00",30,"MIA","NBA",6.9,80,80,2302,322,671,322,670,0,1,120,159,216,384,600,145,65,61,100,264,764,10.71
1190,"Marcus Camby\cambyma01","2003-04",29,"DEN","NBA",6.9,72,72,2162,262,549,262,547,0,2,98,136,211,516,727,132,86,187,98,239,622,12.88
1191,"Samuel Dalembert\dalemsa01","2007-08",26,"PHI","NBA",6.9,82,82,2724,339,661,339,660,0,1,186,263,304,545,849,45,40,192,155,269,864,12.82
1192,"Samuel Dalembert\dalemsa01","2003-04",22,"PHI","NBA",6.9,82,53,2197,270,499,270,498,0,1,112,174,194,432,626,21,44,189,86,273,652,10.09
1193,"Dale Davis\davisda01","2002-03",33,"POR","NBA",6.9,78,78,2282,237,438,237,438,0,0,105,166,233,331,564,94,51,70,71,189,579,9.41
1194,"Dale Davis\davisda01","1992-93",23,"IND","NBA",6.9,82,82,2264,304,535,304,535,0,0,119,225,291,432,723,69,63,148,79,274,727,11.41
1195,"Bison Dele\delebi01","1997-98",28,"DET","NBA",6.9,78,78,2619,531,1040,530,1037,1,3,198,280,223,472,695,94,67,55,181,252,1261,14.9
1196,"Kevin Garnett\garneke01","2011-12",35,"BOS","NBA",6.9,60,60,1864,391,777,388,768,3,9,162,189,66,428,494,175,56,61,107,141,947,16.13
1197,"Pau Gasol\gasolpa01","2006-07",26,"MEM","NBA",6.9,59,59,2133,462,858,459,847,3,11,299,400,149,432,581,201,29,126,162,137,1226,21.36
1198,"Ben Gordon\gordobe01","2008-09",25,"CHI","NBA",6.9,82,76,2999,598,1315,425,893,173,422,330,382,52,231,283,279,71,22,200,184,1699,16.97
1199,"Danny Granger\grangda01","2010-11",27,"IND","NBA",6.9,79,79,2763,535,1260,378,853,157,407,395,466,87,338,425,203,89,62,206,213,1622,17.34
1200,"J.J. Hickson\hicksjj01","2012-13",24,"POR","NBA",6.9,80,80,2323,418,744,418,742,0,2,182,268,266,562,828,88,48,51,145,160,1018,13.83
1201,"Tyrone Hill\hillty01","1994-95",26,"CLE","NBA",6.9,70,67,2397,350,694,350,693,0,1,263,397,269,496,765,55,55,41,151,245,963,14.17
1202,"Jeff Hornacek\hornaje01","1993-94",30,"TOT","NBA",6.9,80,62,2820,472,1004,402,796,70,208,260,296,60,219,279,419,127,13,171,186,1274,16.08
1203,"Robert Horry\horryro01","2001-02",31,"LAL","NBA",6.9,81,23,2140,183,460,107,257,76,203,108,138,130,349,479,232,77,89,88,208,550,9.66
1204,"Andre Iguodala\iguodan01","2016-17",33,"GSW","NBA",6.9,76,0,1998,219,415,155,238,64,177,72,102,51,253,304,261,76,39,58,97,574,10.09
1205,"Allen Iverson\iversal01","1999-00",24,"PHI","NBA",6.9,70,70,2853,729,1733,640,1472,89,261,442,620,71,196,267,328,144,5,230,162,1989,21.15
1206,"Allen Iverson\iversal01","2001-02",26,"PHI","NBA",6.9,60,59,2622,665,1669,587,1401,78,268,475,585,44,225,269,331,168,13,237,102,1883,24.22
1207,"Reggie Jackson\jacksre01","2015-16",25,"DET","NBA",6.9,79,79,2424,540,1244,422,910,118,334,291,337,58,195,253,492,59,11,223,187,1489,16.81
1208,"Larry Johnson\johnsla02","1997-98",28,"NYK","NBA",6.9,70,70,2412,429,884,414,821,15,63,214,283,175,226,401,150,40,13,127,193,1087,13.24
1209,"Kerry Kittles\kittlke01","1996-97",22,"NJN","NBA",6.9,82,57,3012,507,1189,349,770,158,419,175,227,106,213,319,249,157,35,127,165,1347,14.39
1210,"Toni Kukoč\kukocto01","1996-97",28,"CHI","NBA",6.9,57,15,1610,285,605,235,454,50,151,134,174,94,167,261,256,60,29,91,97,754,13.9
1211,"Ty Lawson\lawsoty01","2011-12",24,"DEN","NBA",6.9,61,61,2124,374,767,301,567,73,200,178,216,54,173,227,401,82,6,149,94,999,17.28
1212,"David Lee\leeda02","2006-07",23,"NYK","NBA",6.9,58,12,1731,240,400,240,400,0,0,141,173,196,406,602,104,48,23,92,155,621,13.83
1213,"Corey Maggette\maggeco01","2007-08",28,"LAC","NBA",6.9,70,65,2502,458,1000,380,797,78,203,553,681,78,316,394,189,71,7,195,210,1547,19.21
1214,"Jeff McInnis\mcinnje01","2000-01",26,"LAC","NBA",6.9,81,81,2831,432,933,380,789,52,144,130,161,41,179,220,447,75,7,113,199,1046,12.77
1215,"Khris Middleton\middlkh01","2017-18",26,"MIL","NBA",6.9,82,82,2982,593,1272,447,865,146,407,320,362,45,384,429,328,119,21,191,270,1652,18.5
1216,"Cuttino Mobley\moblecu01","2002-03",27,"HOU","NBA",6.9,73,73,3044,463,1067,351,749,112,318,242,282,70,233,303,208,95,36,166,185,1280,14.92
1217,"Shaquille O'Neal\onealsh01","1995-96",23,"ORL","NBA",6.9,54,52,1946,592,1033,591,1031,1,2,249,511,182,414,596,155,34,115,155,193,1434,24.15
1218,"Lamar Odom\odomla01","2008-09",29,"LAL","NBA",6.9,78,32,2316,346,703,313,600,33,103,160,257,176,461,637,204,77,98,138,235,885,13.28
1219,"Sam Perkins\perkisa01","1992-93",31,"TOT","NBA",6.9,79,62,2351,381,799,357,728,24,71,250,305,163,361,524,156,60,82,108,225,1036,13.21
1220,"Sam Perkins\perkisa01","1995-96",34,"SEA","NBA",6.9,82,20,2169,325,797,196,434,129,363,191,241,101,266,367,120,83,48,82,174,970,10.6
1221,"Wesley Person\persowe01","2001-02",30,"CLE","NBA",6.9,78,78,2793,467,944,324,622,143,322,99,124,50,244,294,173,77,37,74,93,1176,13.25
1222,"Jason Richardson\richaja01","2010-11",30,"TOT","NBA",6.9,80,80,2715,472,1056,283,577,189,479,116,159,67,264,331,147,93,13,95,162,1249,12.73
1223,"Jonas Valančiūnas\valanjo01","2015-16",23,"TOR","NBA",6.9,60,59,1557,303,536,303,536,0,0,162,213,184,363,547,42,25,80,85,158,768,13.71
1224,"Chris Webber\webbech01","2002-03",29,"SAC","NBA",6.9,67,67,2622,661,1433,656,1412,5,21,215,354,160,544,704,364,106,88,215,204,1542,21.67
1225,"Thaddeus Young\youngth01","2018-19",30,"IND","NBA",6.9,81,81,2489,443,841,392,695,51,146,87,135,192,331,523,204,123,36,123,194,1024,13.5
1226,"Mahmoud Abdul-Rauf\abdulma02","1993-94",24,"DEN","NBA",6.8,80,78,2617,588,1279,546,1146,42,133,219,229,27,141,168,362,82,10,151,150,1437,14.78
1227,"Bam Adebayo\adebaba01","2018-19",21,"MIA","NBA",6.8,82,28,1913,280,486,277,471,3,15,166,226,165,432,597,184,71,65,121,203,729,11.72
1228,"Kenny Anderson\anderke01","1994-95",24,"NJN","NBA",6.8,72,70,2689,411,1031,314,737,97,294,348,414,73,177,250,680,103,14,225,184,1267,19.06
1229,"Charles Barkley\barklch01","1998-99",35,"HOU","NBA",6.8,42,40,1526,240,502,236,477,4,25,192,267,167,349,516,192,43,13,100,89,676,18.65
1230,"Brent Barry\barrybr01","2006-07",35,"SAS","NBA",6.8,75,28,1631,202,425,74,138,128,287,103,117,17,143,160,138,56,12,61,88,635,8.5
1231,"Raja Bell\bellra01","2005-06",29,"PHO","NBA",6.8,79,79,2959,425,930,228,484,197,446,115,146,44,209,253,207,76,22,89,248,1162,12.74
1232,"Bojan Bogdanović\bogdabo02","2018-19",29,"IND","NBA",6.8,81,81,2573,522,1051,358,665,164,386,246,305,33,300,333,161,69,1,134,138,1454,15.05
1233,"Matt Bonner\bonnema01","2008-09",28,"SAS","NBA",6.8,81,67,1928,266,536,148,268,118,268,17,23,97,289,386,82,47,26,37,190,667,8.31
1234,"Chris Bosh\boshch01","2004-05",20,"TOR","NBA",6.8,81,81,3017,473,1005,470,995,3,10,412,542,194,524,718,153,76,113,187,226,1361,16.59
1235,"Ronnie Brewer\brewero02","2008-09",23,"UTA","NBA",6.8,81,80,2605,421,828,399,743,22,85,247,352,101,199,300,179,138,30,110,128,1111,13.11
1236,"Dee Brown\brownde01","1994-95",26,"BOS","NBA",6.8,79,69,2792,437,977,311,650,126,327,236,277,63,186,249,301,110,49,146,181,1236,14.75
1237,"Marcus Camby\cambyma01","2009-10",35,"TOT","NBA",6.8,74,74,2314,238,501,236,494,2,7,78,122,249,622,871,186,95,146,91,161,556,12.96
1238,"Darren Collison\collida01","2018-19",31,"IND","NBA",6.8,76,76,2143,308,659,229,465,79,194,158,190,36,196,232,459,110,9,125,138,853,13.59
1239,"Mike Conley\conlemi01","2014-15",27,"MEM","NBA",6.8,70,70,2225,393,882,286,605,107,277,214,249,29,180,209,375,89,14,156,139,1107,15.4
1240,"Antonio Daniels\daniean01","2004-05",29,"SEA","NBA",6.8,75,2,2026,273,623,224,458,49,165,248,304,20,149,169,309,51,3,78,78,843,11.08
1241,"Dale Davis\davisda01","1994-95",25,"IND","NBA",6.8,74,70,2346,324,576,324,575,0,1,138,259,259,437,696,58,72,116,124,222,786,12.65
1242,"Vinny Del Negro\delnevi01","1994-95",28,"SAS","NBA",6.8,75,71,2360,372,766,306,604,66,162,128,162,28,164,192,226,61,14,56,179,938,11.24
1243,"Goran Dragić\dragigo01","2014-15",28,"TOT","NBA",6.8,78,78,2640,502,1002,412,743,90,259,181,234,81,193,274,350,78,15,173,195,1275,15.34
1244,"Clyde Drexler\drexlcl01","1997-98",35,"HOU","NBA",6.8,70,70,2473,452,1059,346,725,106,334,277,346,105,241,346,382,126,42,189,193,1287,18
1245,"Clyde Drexler\drexlcl01","1993-94",31,"POR","NBA",6.8,68,68,2334,473,1105,402,886,71,219,286,368,154,291,445,333,98,34,167,202,1303,17.92
1246,"Patrick Ewing\ewingpa01","1995-96",33,"NYK","NBA",6.8,76,76,2783,678,1456,674,1428,4,28,351,461,157,649,806,160,68,184,221,247,1711,20.4
1247,"Danilo Gallinari\gallida01","2016-17",28,"DEN","NBA",6.8,63,63,2134,335,750,209,426,126,324,349,387,39,286,325,135,40,15,82,93,1145,16.09
1248,"Pau Gasol\gasolpa01","2004-05",24,"MEM","NBA",6.8,56,53,1790,357,695,356,689,1,6,282,367,130,280,410,135,37,93,137,146,997,17.5
1249,"Armen Gilliam\gilliar01","1993-94",29,"NJN","NBA",6.8,82,5,1969,348,682,348,681,0,1,274,361,197,303,500,69,38,61,106,129,970,11.29
1250,"Marcin Gortat\gortama01","2016-17",32,"WAS","NBA",6.8,82,82,2556,390,674,390,672,0,2,103,159,238,611,849,121,40,61,119,213,883,12.83
1251,"Tobias Harris\harrito02","2016-17",24,"DET","NBA",6.8,82,48,2567,511,1063,402,749,109,314,190,226,63,353,416,142,60,39,96,133,1321,13.66
1252,"Brendan Haywood\haywobr01","2007-08",28,"WAS","NBA",6.8,80,80,2228,316,599,316,599,0,0,216,294,273,303,576,71,31,133,108,216,848,11.6
1253,"Al Horford\horfoal01","2008-09",22,"ATL","NBA",6.8,67,67,2242,312,594,312,593,0,1,149,205,145,479,624,163,53,95,103,190,773,14.07
1254,"Dwight Howard\howardw01","2017-18",32,"CHO","NBA",6.8,81,81,2463,506,911,505,904,1,7,334,582,255,757,1012,105,48,131,208,249,1347,17.66
1255,"Antawn Jamison\jamisan01","2006-07",30,"WAS","NBA",6.8,70,70,2662,512,1139,374,760,138,379,226,307,134,428,562,136,80,36,104,194,1388,16.98
1256,"Eddie Jones\jonesed02","1995-96",24,"LAL","NBA",6.8,70,66,2184,337,685,254,458,83,227,136,184,45,188,233,246,129,45,99,162,893,13.64
1257,"Shawn Kemp\kempsh01","1997-98",28,"CLE","NBA",6.8,80,80,2769,518,1164,516,1156,2,8,404,556,219,526,745,197,108,90,271,310,1442,17.26
1258,"Raef LaFrentz\lafrera01","2000-01",24,"DEN","NBA",6.8,78,74,2457,387,812,336,673,51,139,183,262,173,434,607,107,37,206,97,290,1008,13.61
1259,"Tim Legler\legleti01","1995-96",29,"WSB","NBA",6.8,77,0,1775,233,460,105,215,128,245,132,153,29,111,140,136,45,12,45,141,726,9.01
1260,"Voshon Lenard\lenarvo01","1996-97",23,"MIA","NBA",6.8,73,47,2111,314,684,131,242,183,442,86,105,38,179,217,161,50,18,109,168,897,10.94
1261,"Greg Monroe\monrogr01","2014-15",24,"DET","NBA",6.8,69,57,2137,423,853,423,853,0,0,252,336,229,475,704,142,78,34,149,148,1098,16.22
1262,"Dirk Nowitzki\nowitdi01","2015-16",37,"DAL","NBA",6.8,75,75,2364,498,1112,372,770,126,342,250,280,52,437,489,132,52,52,84,161,1372,15.43
1263,"Bo Outlaw\outlabo01","1999-00",28,"ORL","NBA",6.8,82,55,2326,204,339,204,336,0,3,82,162,202,323,525,245,113,148,133,203,490,10.98
1264,"Robert Parish\parisro01","1992-93",39,"BOS","NBA",6.8,79,79,2146,416,777,416,777,0,0,162,235,246,494,740,61,57,107,120,201,994,13.39
1265,"Scot Pollard\pollasc01","2001-02",26,"SAC","NBA",6.8,80,29,1881,197,358,197,358,0,0,115,166,188,377,565,53,70,76,68,202,509,8.79
1266,"Clifford Robinson\robincl02","1992-93",26,"POR","NBA",6.8,82,12,2575,632,1336,613,1259,19,77,287,416,165,377,542,182,98,163,173,287,1570,16.98
1267,"Bryon Russell\russebr01","2000-01",30,"UTA","NBA",6.8,78,46,2473,308,700,213,470,95,230,222,285,94,236,330,160,96,20,113,229,933,11.47
1268,"Thabo Sefolosha\sefolth01","2012-13",28,"OKC","NBA",6.8,81,81,2229,224,466,116,208,108,258,57,69,58,259,317,125,103,44,64,177,613,8.89
1269,"Rony Seikaly\seikaro01","1996-97",31,"ORL","NBA",6.8,74,68,2615,460,907,460,904,0,3,357,500,274,427,701,92,49,107,218,275,1277,16.72
1270,"Bobby Simmons\simmobo01","2004-05",24,"LAC","NBA",6.8,75,74,2799,474,1017,424,902,50,115,231,273,128,318,446,205,106,16,135,227,1229,15.05
1271,"Joe Smith\smithjo02","1995-96",20,"GSW","NBA",6.8,82,82,2821,469,1024,459,996,10,28,303,392,300,417,717,79,85,134,138,224,1251,14.72
1272,"Josh Smith\smithjo03","2011-12",26,"ATL","NBA",6.8,66,66,2329,504,1101,476,992,28,109,203,322,136,496,632,257,93,115,164,172,1239,18.61
1273,"Bryant Stith\stithbr01","1993-94",23,"DEN","NBA",6.8,82,82,2853,365,811,363,802,2,9,291,351,119,230,349,199,116,16,131,165,1023,11.99
1274,"Tristan Thompson\thomptr01","2014-15",23,"CLE","NBA",6.8,82,15,2194,267,488,267,488,0,0,159,248,274,383,657,39,34,61,83,189,693,9.63
1275,"Hedo Türkoğlu\turkohe01","2010-11",31,"TOT","NBA",6.8,81,72,2540,322,722,195,412,127,310,106,156,45,311,356,343,72,34,132,247,877,11.84
1276,"Russell Westbrook\westbru01","2018-19",30,"OKC","NBA",6.8,73,73,2630,630,1473,511,1062,119,411,296,451,109,698,807,784,142,33,325,245,1675,25.62
1277,"Gerald Wilkins\wilkige01","1993-94",30,"CLE","NBA",6.8,82,82,2768,446,975,362,763,84,212,194,250,106,197,303,255,105,38,131,186,1170,13.11
1278,"Harrison Barnes\barneha02","2014-15",22,"GSW","NBA",6.7,82,82,2318,316,656,229,441,87,215,108,150,117,336,453,116,61,19,71,146,827,9.93
1279,"Andris Biedriņš\biedran01","2006-07",20,"GSW","NBA",6.7,82,63,2382,348,581,348,581,0,0,87,167,251,511,762,88,67,136,119,304,783,12.34
1280,"Willie Cauley-Stein\caulewi01","2018-19",25,"SAC","NBA",6.7,81,81,2213,412,741,411,739,1,2,140,254,181,497,678,194,96,51,84,227,965,13.63
1281,"Tyrone Corbin\corbity01","1992-93",30,"UTA","NBA",6.7,82,58,2555,385,766,385,761,0,5,180,218,194,325,519,173,108,32,108,252,950,12.34
1282,"Jae Crowder\crowdja01","2016-17",26,"BOS","NBA",6.7,72,72,2335,333,720,176,326,157,394,176,217,48,367,415,155,73,23,80,161,999,13.55
1283,"Dale Davis\davisda01","1996-97",27,"IND","NBA",6.7,80,76,2589,370,688,370,688,0,0,92,215,301,471,772,59,60,77,108,233,832,11.41
1284,"Ed Davis\davised01","2015-16",26,"POR","NBA",6.7,81,0,1684,206,337,206,337,0,0,114,204,224,375,599,88,57,72,64,202,526,9.2
1285,"Clyde Drexler\drexlcl01","1995-96",33,"HOU","NBA",6.7,52,51,1997,331,764,253,529,78,235,265,338,97,276,373,302,105,24,134,153,1005,20.3
1286,"Andre Drummond\drumman01","2016-17",23,"DET","NBA",6.7,81,81,2409,483,911,481,904,2,7,137,355,345,770,1115,90,124,89,152,237,1105,15.66
1287,"Michael Finley\finlemi01","2002-03",29,"DAL","NBA",6.7,69,69,2642,507,1193,388,871,119,322,198,230,107,295,402,205,76,21,114,105,1331,15.67
1288,"Kendall Gill\gillke01","1993-94",25,"SEA","NBA",6.7,79,77,2435,429,969,391,849,38,120,215,275,91,177,268,275,151,32,143,194,1111,13.33
1289,"Armen Gilliam\gilliar01","1995-96",31,"NJN","NBA",6.7,78,76,2856,576,1216,576,1215,0,1,277,350,241,472,713,140,73,53,177,180,1429,16.31
1290,"Danny Granger\grangda01","2011-12",28,"IND","NBA",6.7,62,62,2062,391,941,268,618,123,323,254,291,79,228,307,109,62,40,110,144,1159,15.02
1291,"A.C. Green\greenac01","1994-95",31,"PHO","NBA",6.7,82,52,2687,311,617,268,490,43,127,251,343,194,475,669,127,55,31,114,146,916,12.25
1292,"Tom Gugliotta\guglito01","1996-97",27,"MIN","NBA",6.7,81,81,3131,592,1339,568,1246,24,93,464,566,187,515,702,335,130,89,293,237,1672,20.23
1293,"Tobias Harris\harrito02","2017-18",25,"TOT","NBA",6.7,80,80,2668,562,1221,379,776,183,445,179,216,58,379,437,192,71,35,105,164,1486,15.57
1294,"Brendan Haywood\haywobr01","2009-10",30,"TOT","NBA",6.7,77,67,2355,276,491,276,490,0,1,152,245,278,437,715,43,26,158,99,209,704,11.51
1295,"George Hill\hillge01","2009-10",23,"SAS","NBA",6.7,78,43,2276,353,738,278,550,75,188,183,237,42,163,205,226,69,26,101,222,964,11.47
1296,"Josh Howard\howarjo01","2005-06",25,"DAL","NBA",6.7,59,58,1915,350,743,323,680,27,63,196,267,123,248,371,111,68,26,79,167,923,14.01
1297,"Andre Iguodala\iguodan01","2009-10",26,"PHI","NBA",6.7,82,82,3193,496,1120,402,817,94,303,315,430,82,447,529,472,141,55,218,145,1401,18.18
1298,"Andre Iguodala\iguodan01","2010-11",27,"PHI","NBA",6.7,67,67,2469,338,759,277,578,61,181,208,300,61,326,387,422,101,38,138,109,945,16.27
1299,"Ersan İlyasova\ilyaser01","2012-13",25,"MIL","NBA",6.7,73,54,2012,371,803,276,589,95,214,125,157,154,366,520,117,68,36,75,185,962,12.58
1300,"Kyrie Irving\irvinky01","2013-14",21,"CLE","NBA",6.7,71,71,2496,532,1237,409,893,123,344,291,338,52,207,259,433,108,23,190,163,1478,18.83
1301,"Mark Jackson\jacksma01","1999-00",34,"IND","NBA",6.7,81,81,2190,246,570,157,349,89,221,79,98,63,233,296,650,76,10,174,111,660,12.45
1302,"Antawn Jamison\jamisan01","2000-01",24,"GSW","NBA",6.7,82,82,3394,800,1812,738,1607,62,205,382,534,280,435,715,164,114,28,199,225,2044,19.14
1303,"Avery Johnson\johnsav01","1997-98",32,"SAS","NBA",6.7,75,73,2674,321,671,319,658,2,13,122,168,30,120,150,591,84,18,165,140,766,13.02
1304,"Nikola Jokić\jokicni01","2015-16",20,"DEN","NBA",6.7,80,55,1733,307,600,279,516,28,84,154,190,181,379,560,189,79,50,104,208,796,11.93
1305,"Ty Lawson\lawsoty01","2010-11",23,"DEN","NBA",6.7,80,31,2103,346,688,277,517,69,171,172,225,67,142,209,377,80,4,137,133,933,12.49
1306,"Brook Lopez\lopezbr01","2018-19",30,"MIL","NBA",6.7,81,81,2322,355,786,168,274,187,512,112,133,33,363,396,98,51,179,82,189,1009,12.29
1307,"Jamaal Magloire\magloja01","2002-03",24,"NOH","NBA",6.7,82,82,2443,305,635,305,632,0,3,231,322,260,464,724,88,49,111,158,276,841,11.71
1308,"Kenyon Martin\martike01","2003-04",26,"NJN","NBA",6.7,65,62,2252,439,900,432,875,7,25,201,294,133,484,617,160,95,82,168,230,1086,17.01
1309,"Antonio McDyess\mcdyean01","2007-08",33,"DET","NBA",6.7,78,78,2285,293,600,293,598,0,2,97,156,204,462,666,89,61,53,75,246,683,10.04
1310,"Khris Middleton\middlkh01","2014-15",23,"MIL","NBA",6.7,79,58,2378,406,869,297,601,109,268,134,156,48,299,347,182,122,11,113,183,1055,12.61
1311,"Paul Millsap\millspa01","2013-14",28,"ATL","NBA",6.7,74,73,2482,483,1047,407,835,76,212,286,391,154,473,627,232,129,78,185,210,1328,18.15
1312,"Joakim Noah\noahjo01","2010-11",25,"CHI","NBA",6.7,48,48,1576,211,402,211,401,0,1,139,188,182,316,498,107,48,72,90,156,561,14.94
1313,"Andrés Nocioni\nocioan01","2005-06",26,"CHI","NBA",6.7,82,43,2239,383,831,290,593,93,238,204,242,89,411,500,117,40,52,120,252,1063,11.92
1314,"Mehmet Okur\okurme01","2007-08",28,"UTA","NBA",6.7,72,72,2390,374,841,260,547,114,294,185,230,132,424,556,145,55,29,104,236,1047,13.74
1315,"Ruben Patterson\patteru01","1999-00",24,"SEA","NBA",6.7,81,74,2097,354,661,342,634,12,27,222,321,218,216,434,126,94,40,144,190,942,11.91
1316,"Nikola Peković\pekovni01","2012-13",27,"MIN","NBA",6.7,62,62,1959,385,741,385,741,0,0,241,324,230,315,545,53,43,50,101,143,1011,15.26
1317,"Olden Polynice\polynol01","1994-95",30,"SAC","NBA",6.7,81,81,2534,376,691,375,690,1,1,124,194,277,448,725,62,48,52,113,238,877,11.52
1318,"Theo Ratliff\ratlith01","1997-98",24,"TOT","NBA",6.7,82,67,2447,306,597,306,597,0,0,197,281,221,326,547,57,50,258,116,292,809,11.82
1319,"J.J. Redick\redicjj01","2014-15",30,"LAC","NBA",6.7,78,78,2409,447,938,247,480,200,458,183,203,22,145,167,137,39,8,95,134,1277,12.8
1320,"J.J. Redick\redicjj01","2015-16",31,"LAC","NBA",6.7,75,75,2097,422,880,222,459,200,421,182,205,10,129,139,106,42,5,78,135,1226,12.6
1321,"Glenn Robinson\robingl01","2000-01",28,"MIL","NBA",6.7,76,74,2813,684,1460,629,1276,55,184,251,306,124,402,526,252,86,62,219,191,1674,18.68
1322,"Rony Seikaly\seikaro01","1993-94",28,"MIA","NBA",6.7,72,60,2410,392,803,392,801,0,2,304,422,244,496,740,136,59,100,195,279,1088,16.05
1323,"J.R. Smith\smithjr01","2012-13",27,"NYK","NBA",6.7,80,0,2678,527,1249,372,813,155,436,237,311,64,361,425,218,100,24,134,226,1446,14.9
1324,"Damon Stoudamire\stoudda01","2000-01",27,"POR","NBA",6.7,82,82,2655,406,935,324,716,82,219,172,207,69,234,303,468,106,8,191,202,1066,13.66
1325,"Klay Thompson\thompkl01","2013-14",23,"GSW","NBA",6.7,81,81,2868,559,1259,336,724,223,535,147,185,38,211,249,181,74,37,135,234,1488,14.09
1326,"Hedo Türkoğlu\turkohe01","2003-04",24,"SAS","NBA",6.7,80,44,2073,262,645,161,404,101,241,114,161,52,306,358,154,80,32,94,165,739,9.09
1327,"Jonas Valančiūnas\valanjo01","2013-14",21,"TOR","NBA",6.7,81,81,2282,359,676,359,675,0,1,198,260,226,488,714,57,24,71,136,249,916,11.86
1328,"Antoine Walker\walkean02","2001-02",25,"BOS","NBA",6.7,81,81,3406,666,1689,444,1044,222,645,240,324,150,564,714,407,122,38,251,237,1794,19.3
1329,"Lou Williams\willilo02","2017-18",31,"LAC","NBA",6.7,79,19,2589,582,1337,396,819,186,518,432,491,40,158,198,417,85,19,234,106,1782,19.3
1330,"Mo Williams\willima01","2009-10",27,"CLE","NBA",6.7,69,68,2359,378,855,219,484,159,371,177,198,28,178,206,368,70,21,173,170,1092,15.38
1331,"Metta World Peace\artesro01","2006-07",27,"SAC","NBA",6.7,70,65,2641,458,1040,365,780,93,260,307,415,102,352,454,235,149,43,146,205,1316,17.9
1332,"Rafer Alston\alstora01","2006-07",30,"HOU","NBA",6.6,82,82,3040,383,1020,191,491,192,529,130,177,29,253,282,444,129,10,170,195,1088,13.02
1333,"Trevor Ariza\arizatr01","2014-15",29,"HOU","NBA",6.6,82,82,2930,366,910,172,355,194,555,122,143,77,382,459,209,152,17,141,186,1048,12.72
1334,"Nicolas Batum\batumni01","2010-11",22,"POR","NBA",6.6,80,67,2522,367,807,249,465,118,342,138,164,109,252,361,123,68,49,83,194,990,11.18
1335,"Andrew Bynum\bynuman01","2010-11",23,"LAL","NBA",6.6,54,47,1500,237,413,237,413,0,0,138,209,170,338,508,73,19,106,74,140,612,13.64
1336,"Mike Conley\conlemi01","2010-11",23,"MEM","NBA",6.6,81,81,2872,423,953,343,736,80,217,181,247,32,215,247,528,144,18,176,182,1107,14.91
1337,"Stephen Curry\curryst01","2010-11",22,"GSW","NBA",6.6,74,74,2489,505,1053,354,711,151,342,212,227,52,234,286,432,109,20,226,233,1373,18.54
1338,"Antonio Daniels\daniean01","2000-01",25,"SAS","NBA",6.6,79,23,2060,275,588,201,405,74,183,121,156,26,137,163,304,61,14,109,120,745,9.85
1339,"Dale Davis\davisda01","2000-01",31,"POR","NBA",6.6,81,43,2162,242,487,242,483,0,4,96,152,233,373,606,103,44,76,67,199,580,8.95
1340,"Kevin Gamble\gamblke01","1992-93",27,"BOS","NBA",6.6,82,58,2541,459,906,407,767,52,139,123,149,46,200,246,226,86,37,81,185,1093,12.2
1341,"Armen Gilliam\gilliar01","1994-95",30,"NJN","NBA",6.6,82,30,2472,455,905,455,903,0,2,302,392,192,421,613,99,67,89,152,171,1212,14.25
1342,"Drew Gooden\goodedr01","2005-06",24,"CLE","NBA",6.6,79,79,2174,334,652,333,649,1,3,176,258,237,428,665,56,52,49,106,190,845,11.15
1343,"Jeff Green\greenje02","2009-10",23,"OKC","NBA",6.6,82,82,3043,485,1070,381,758,104,312,165,223,112,378,490,134,104,72,135,221,1239,13.48
1344,"Tobias Harris\harrito02","2015-16",23,"TOT","NBA",6.6,76,74,2513,417,889,337,650,80,239,202,243,96,414,510,169,65,40,108,153,1116,13.94
1345,"Grant Hill\hillgr01","2004-05",32,"ORL","NBA",6.6,67,67,2338,517,1015,514,1002,3,13,280,341,77,241,318,220,97,28,161,144,1317,17.71
1346,"Robert Horry\horryro01","1997-98",27,"LAL","NBA",6.6,72,71,2192,200,420,181,327,19,93,117,169,186,356,542,163,112,94,99,238,536,11.25
1347,"Dwight Howard\howardw01","2015-16",30,"HOU","NBA",6.6,71,71,2280,372,600,372,594,0,6,232,474,238,597,835,98,69,113,166,219,976,16.32
1348,"Andre Iguodala\iguodan01","2004-05",21,"PHI","NBA",6.6,82,82,2686,269,546,222,404,47,142,156,210,89,375,464,246,138,48,139,204,741,11.88
1349,"Zydrunas Ilgauskas\ilgauzy01","2006-07",31,"CLE","NBA",6.6,78,78,2130,385,793,385,792,0,1,155,192,242,357,599,123,48,98,141,257,925,12.2
1350,"Jim Jackson\jacksji01","2003-04",33,"HOU","NBA",6.6,80,80,3119,382,900,220,495,162,405,107,127,52,435,487,226,86,23,175,227,1033,12.54
1351,"Al Jefferson\jeffeal01","2006-07",22,"BOS","NBA",6.6,69,60,2319,453,882,453,881,0,1,201,295,237,519,756,88,48,106,136,232,1107,16.22
1352,"Richard Jefferson\jefferi01","2008-09",28,"MIL","NBA",6.6,82,82,2939,537,1222,421,930,116,292,417,518,57,317,374,199,66,14,165,252,1607,15.74
1353,"Kyle Korver\korveky01","2004-05",23,"PHI","NBA",6.6,82,57,2667,317,759,91,201,226,558,82,96,40,339,379,182,103,33,106,265,942,11.43
1354,"Christian Laettner\laettch01","2002-03",33,"WAS","NBA",6.6,76,66,2215,255,516,253,500,2,16,120,144,114,388,502,235,82,40,87,206,632,11.03
1355,"Grant Long\longgr01","1994-95",28,"TOT","NBA",6.6,81,79,2641,342,716,331,685,11,31,244,325,191,415,606,131,109,34,155,243,939,12.46
1356,"Kyle Lowry\lowryky01","2018-19",32,"TOR","NBA",6.6,65,65,2213,304,739,147,286,157,453,161,194,41,271,312,564,91,31,182,166,926,17.68
1357,"CJ McCollum\mccolcj01","2017-18",26,"POR","NBA",6.6,81,81,2923,667,1505,478,1029,189,476,209,250,53,268,321,272,77,35,151,168,1732,16.66
1358,"Tracy McGrady\mcgratr01","1999-00",20,"TOR","NBA",6.6,79,34,2462,459,1018,441,953,18,65,277,392,188,313,501,263,90,151,160,201,1213,15.42
1359,"Derrick McKey\mckeyde01","1992-93",26,"SEA","NBA",6.6,77,68,2439,387,780,347,668,40,112,220,297,121,206,327,197,105,58,152,208,1034,13.33
1360,"Reggie Miller\millere01","2004-05",39,"IND","NBA",6.6,66,66,2105,314,719,218,421,96,298,250,268,18,138,156,146,50,5,77,109,974,12.23
1361,"Greg Monroe\monrogr01","2010-11",20,"DET","NBA",6.6,80,48,2222,303,550,303,549,0,1,145,233,248,353,601,105,93,45,81,196,751,11.13
1362,"Jameer Nelson\nelsoja01","2010-11",28,"ORL","NBA",6.6,76,76,2319,374,838,255,541,119,297,130,162,37,189,226,456,75,3,194,209,997,13.6
1363,"Chris Paul\paulch01","2018-19",33,"HOU","NBA",6.6,58,58,1857,302,720,175,365,127,355,175,203,36,229,265,473,114,18,152,146,906,18.54
1364,"Scottie Pippen\pippesc01","1997-98",32,"CHI","NBA",6.6,44,44,1652,315,704,254,512,61,192,150,193,53,174,227,254,79,43,109,116,841,18.97
1365,"Dwight Powell\poweldw01","2017-18",26,"DAL","NBA",6.6,79,25,1672,255,430,227,346,28,84,133,185,135,309,444,91,67,32,59,186,671,9.9
1366,"Joel Przybilla\przybjo01","2008-09",29,"POR","NBA",6.6,82,43,1952,168,269,168,268,0,1,112,169,204,513,717,27,34,97,78,215,448,8.68
1367,"Julius Randle\randlju01","2017-18",23,"LAL","NBA",6.6,82,49,2190,504,904,494,859,10,45,305,425,181,473,654,210,43,45,213,274,1323,16.18
1368,"J.J. Redick\redicjj01","2017-18",33,"PHI","NBA",6.6,70,70,2116,404,879,211,419,193,460,197,218,9,169,178,210,35,6,103,123,1198,14.19
1369,"Jason Richardson\richaja01","2009-10",29,"PHO","NBA",6.6,79,76,2485,473,998,316,598,157,400,136,184,81,323,404,143,66,33,92,169,1239,13.43
1370,"Clifford Robinson\robincl02","1996-97",30,"POR","NBA",6.6,81,79,3077,444,1043,323,693,121,350,215,309,90,231,321,261,99,66,172,251,1224,13.46
1371,"Rajon Rondo\rondora01","2010-11",24,"BOS","NBA",6.6,68,68,2527,318,670,308,627,10,43,75,132,87,210,297,760,153,11,234,120,721,17.18
1372,"Dario Šarić\saricda01","2017-18",23,"PHI","NBA",6.6,78,73,2310,403,890,246,491,157,399,178,207,154,366,520,202,51,20,148,160,1141,13.87
1373,"Charles Smith\smithch01","1992-93",27,"NYK","NBA",6.6,81,68,2172,358,764,358,762,0,2,287,367,170,262,432,142,48,96,155,254,1003,11.94
1374,"Latrell Sprewell\sprewla01","1999-00",29,"NYK","NBA",6.6,82,82,3276,568,1305,524,1178,44,127,344,397,49,300,349,332,109,22,226,184,1524,16.01
1375,"Damon Stoudamire\stoudda01","2001-02",28,"POR","NBA",6.6,75,71,2796,369,918,265,623,104,295,174,196,78,214,292,490,67,7,149,153,1016,13.92
1376,"Kenny Thomas\thomake01","2003-04",26,"PHI","NBA",6.6,74,72,2699,381,813,380,808,1,5,243,323,261,489,750,111,82,33,172,219,1006,14.06
1377,"Anderson Varejão\varejan01","2006-07",24,"CLE","NBA",6.6,81,6,1932,191,401,191,392,0,9,165,268,191,354,545,75,76,52,67,269,547,8.45
1378,"Antoine Walker\walkean02","2000-01",24,"BOS","NBA",6.6,81,81,3396,711,1720,490,1117,221,603,249,348,151,568,719,445,138,49,301,251,1892,21.04
1379,"Lou Williams\willilo02","2014-15",28,"TOR","NBA",6.6,80,0,2016,375,928,223,481,152,447,340,395,24,127,151,164,88,10,101,103,1242,12.38
1380,"Steven Adams\adamsst01","2015-16",22,"OKC","NBA",6.5,80,80,2014,261,426,261,426,0,0,114,196,219,314,533,62,42,89,84,223,636,9.63
1381,"Steven Adams\adamsst01","2016-17",23,"OKC","NBA",6.5,80,80,2389,374,655,374,654,0,1,157,257,281,332,613,86,89,78,146,195,905,12.56
1382,"Ryan Anderson\anderry01","2012-13",24,"NOH","NBA",6.5,81,22,2503,472,1115,259,558,213,557,152,180,191,328,519,97,42,31,97,179,1309,12.9
1383,"Gilbert Arenas\arenagi01","2002-03",21,"GSW","NBA",6.5,82,82,2866,509,1180,400,867,109,313,370,468,97,289,386,514,124,17,290,260,1497,18.12
1384,"Mark Blount\blounma01","2003-04",28,"BOS","NBA",6.5,82,73,2402,342,604,342,604,0,0,159,221,207,382,589,75,80,106,150,253,843,11.88
1385,"Andrew Bogut\bogutan01","2013-14",29,"GSW","NBA",6.5,67,67,1769,235,375,235,375,0,0,22,64,182,489,671,112,47,121,97,210,492,11.72
1386,"Malcolm Brogdon\brogdma01","2018-19",26,"MIL","NBA",6.5,64,64,1832,378,748,274,504,104,244,141,152,65,223,288,205,46,13,91,102,1001,14.66
1387,"Derrick Coleman\colemde01","1999-00",32,"CHH","NBA",6.5,74,64,2347,446,979,395,838,51,141,296,377,124,508,632,175,34,130,173,195,1239,16.22
1388,"Antonio Davis\davisan01","2001-02",33,"TOR","NBA",6.5,77,77,2978,410,963,410,962,0,1,293,358,254,486,740,155,54,83,159,225,1113,14.2
1389,"Luol Deng\denglu01","2005-06",20,"CHI","NBA",6.5,78,56,2604,442,954,421,876,21,78,207,276,127,389,516,147,72,50,105,128,1112,12.94
1390,"Mike Dunleavy\dunlemi02","2013-14",33,"CHI","NBA",6.5,82,61,2584,333,774,210,450,123,324,140,164,46,299,345,186,64,46,108,163,929,10.67
1391,"Kenneth Faried\farieke01","2013-14",24,"DEN","NBA",6.5,80,77,2178,447,820,447,817,0,3,202,311,238,446,684,96,70,69,135,193,1096,13.95
1392,"Raymond Felton\feltora01","2009-10",25,"CHA","NBA",6.5,80,80,2643,388,846,328,690,60,156,132,173,53,235,288,446,123,22,168,172,968,13.51
1393,"Jeff Foster\fosteje01","2007-08",31,"IND","NBA",6.5,77,52,1884,205,373,205,370,0,3,86,145,264,404,668,129,56,32,62,221,496,9.47
1394,"Drew Gooden\goodedr01","2006-07",25,"CLE","NBA",6.5,80,80,2238,371,784,370,778,1,6,142,199,263,418,681,88,70,28,115,210,885,11.07
1395,"Danny Granger\grangda01","2006-07",23,"IND","NBA",6.5,82,57,2785,398,868,288,580,110,288,236,294,114,267,381,114,67,61,135,245,1142,12.35
1396,"Horace Grant\grantho01","2000-01",35,"LAL","NBA",6.5,77,77,2390,263,569,263,566,0,3,131,169,220,325,545,121,51,61,48,181,657,9.68
1397,"Devin Harris\harride01","2006-07",23,"DAL","NBA",6.5,80,61,2081,292,593,278,543,14,50,215,261,45,151,196,296,96,21,146,242,813,11.16
1398,"Hersey Hawkins\hawkihe01","1993-94",27,"CHH","NBA",6.5,82,82,2648,395,859,317,624,78,235,312,362,89,288,377,216,135,22,158,167,1180,14.26
1399,"Jeff Hornacek\hornaje01","1999-00",36,"UTA","NBA",6.5,77,77,2133,358,728,292,590,66,138,171,180,49,133,182,202,66,16,113,149,953,11.36
1400,"Adam Keefe\keefead01","1997-98",27,"UTA","NBA",6.5,80,75,2047,229,424,229,424,0,0,162,200,179,259,438,89,52,24,71,172,620,8.82
1401,"Kosta Koufos\koufoko01","2012-13",23,"DEN","NBA",6.5,81,81,1817,295,508,295,507,0,1,58,104,211,351,562,32,44,103,53,246,648,9.32
1402,"Rashard Lewis\lewisra02","2009-10",30,"ORL","NBA",6.5,72,72,2369,350,805,182,382,168,423,145,180,62,256,318,107,78,28,108,180,1013,12.16
1403,"Rashard Lewis\lewisra02","2003-04",24,"SEA","NBA",6.5,80,80,2931,535,1229,390,843,145,386,206,270,133,385,518,175,99,54,135,233,1421,15.2
1404,"Grant Long\longgr01","1992-93",26,"MIA","NBA",6.5,76,62,2728,397,847,391,821,6,26,261,341,197,371,568,182,104,31,133,264,1061,14.15
1405,"George Lynch\lynchge01","2000-01",30,"PHI","NBA",6.5,82,80,2649,274,616,259,559,15,57,123,171,200,390,590,139,99,30,109,222,686,9.74
1406,"Danny Manning\mannida01","1997-98",31,"PHO","NBA",6.5,70,11,1794,390,756,390,749,0,7,167,226,110,282,392,139,71,46,100,201,947,12.96
1407,"Josh McRoberts\mcrobjo01","2013-14",26,"CHA","NBA",6.5,78,78,2360,247,566,142,275,105,291,62,85,85,288,373,333,58,46,83,189,661,10.6
1408,"Brad Miller\millebr01","2007-08",31,"SAC","NBA",6.5,72,72,2513,337,728,309,638,28,90,262,309,167,514,681,264,69,74,164,247,964,15.95
1409,"Troy Murphy\murphtr01","2005-06",25,"GSW","NBA",6.5,74,74,2516,363,838,305,657,58,181,251,319,195,548,743,101,47,26,108,191,1035,13.51
1410,"Tracy Murray\murratr01","1997-98",26,"WAS","NBA",6.5,82,12,2227,449,1007,291,604,158,403,182,209,75,202,277,84,67,25,102,167,1238,11.66
1411,"Lamar Odom\odomla01","2000-01",21,"LAC","NBA",6.5,76,74,2836,481,1046,401,793,80,253,262,386,110,482,592,392,74,122,264,236,1304,18.23
1412,"Emeka Okafor\okafoem01","2010-11",28,"NOH","NBA",6.5,72,72,2287,300,524,300,523,0,1,145,258,230,454,684,42,40,127,119,230,745,12.29
1413,"Hakeem Olajuwon\olajuha01","1998-99",36,"HOU","NBA",6.5,50,50,1784,373,725,369,712,4,13,195,272,106,372,478,88,82,123,139,160,945,19.54
1414,"Anthony Parker\parkean01","2006-07",31,"TOR","NBA",6.5,73,73,2437,328,687,213,426,115,261,132,158,60,223,283,153,73,11,71,135,903,11.56
1415,"J.J. Redick\redicjj01","2009-10",25,"ORL","NBA",6.5,82,9,1808,243,553,132,279,111,274,191,222,17,138,155,158,28,4,63,118,788,8.4
1416,"Doc Rivers\riverdo01","1992-93",31,"NYK","NBA",6.5,77,45,1886,216,494,177,371,39,123,133,162,26,166,192,405,123,9,114,215,604,10.68
1417,"Luis Scola\scolalu01","2007-08",27,"HOU","NBA",6.5,82,39,2024,345,670,345,667,0,3,157,235,174,351,525,106,60,19,105,235,847,10.27
1418,"Rony Seikaly\seikaro01","1992-93",27,"MIA","NBA",6.5,72,64,2456,417,868,416,860,1,8,397,540,259,587,846,100,38,83,203,260,1232,17.2
1419,"Jerry Stackhouse\stackje01","2002-03",28,"WAS","NBA",6.5,70,70,2747,491,1201,420,956,71,245,455,518,61,197,258,316,65,28,193,130,1508,17.82
1420,"Jason Terry\terryja01","2009-10",32,"DAL","NBA",6.5,77,12,2540,456,1041,320,668,136,373,232,268,19,121,140,292,94,17,109,142,1280,14.1
1421,"Jason Terry\terryja01","2000-01",23,"ATL","NBA",6.5,82,77,3089,596,1367,472,1053,124,314,303,358,42,227,269,403,104,12,239,204,1619,16.84
1422,"Kurt Thomas\thomaku01","2001-02",29,"NYK","NBA",6.5,82,82,2771,463,938,462,932,1,6,216,265,214,533,747,87,71,79,153,341,1143,13.88
1423,"Keith Van Horn\vanhoke01","2002-03",27,"PHI","NBA",6.5,74,73,2337,459,952,394,776,65,176,193,240,159,365,524,93,63,30,150,251,1176,13.96
1424,"Chris Whitney\whitnch01","2001-02",30,"WAS","NBA",6.5,82,81,2171,274,656,143,333,131,323,154,175,11,141,152,314,72,6,85,182,833,10.14
1425,"Tyler Zeller\zellety01","2014-15",25,"BOS","NBA",6.5,82,59,1731,340,619,340,619,0,0,153,186,146,319,465,113,18,52,76,205,833,10.27
1426,"Ryan Anderson\anderry01","2010-11",22,"ORL","NBA",6.4,64,14,1424,226,525,92,184,134,341,95,117,129,226,355,52,30,38,49,137,681,9.85
1427,"Carmelo Anthony\anthoca01","2015-16",31,"NYK","NBA",6.4,72,72,2530,567,1307,462,997,105,310,334,403,98,458,556,299,62,38,176,180,1573,19.13
1428,"Darrell Armstrong\armstda01","1998-99",30,"ORL","NBA",6.4,50,15,1502,230,522,161,333,69,189,161,178,53,127,180,335,108,4,158,90,690,16.54
1429,"Muggsy Bogues\boguemu01","1993-94",29,"CHH","NBA",6.4,77,77,2746,354,751,352,739,2,12,125,155,78,235,313,780,133,2,171,147,835,16.16
1430,"Chris Bosh\boshch01","2015-16",31,"MIA","NBA",6.4,53,53,1778,358,767,277,545,81,222,213,268,48,342,390,128,36,34,78,101,1010,16.98
1431,"Dee Brown\brownde01","1992-93",24,"BOS","NBA",6.4,80,48,2254,328,701,302,619,26,82,192,242,45,201,246,461,138,32,136,203,874,13.45
1432,"Dee Brown\brownde01","1993-94",25,"BOS","NBA",6.4,77,76,2867,490,1021,460,925,30,96,182,219,63,237,300,347,156,47,126,207,1192,15.72
1433,"Elden Campbell\campbel01","2000-01",32,"CHH","NBA",6.4,78,78,2337,367,834,367,828,0,6,288,406,157,451,608,104,60,140,144,280,1022,12.97
1434,"Mike Conley\conlemi01","2011-12",24,"MEM","NBA",6.4,62,61,2174,296,684,236,525,60,159,136,158,22,134,156,404,136,11,125,133,788,14.64
1435,"Erick Dampier\dampier01","2006-07",31,"DAL","NBA",6.4,76,73,1915,209,334,209,334,0,0,119,191,217,349,566,44,24,82,107,239,537,9.17
1436,"Brad Daugherty\daughbr01","1993-94",28,"CLE","NBA",6.4,50,50,1838,296,606,296,606,0,0,256,326,128,380,508,149,41,36,110,145,848,17.76
1437,"Baron Davis\davisba01","2006-07",27,"GSW","NBA",6.4,63,62,2221,452,1030,367,750,85,280,275,369,51,225,276,509,135,29,193,181,1264,20.77
1438,"Luol Deng\denglu01","2015-16",30,"MIA","NBA",6.4,74,73,2394,339,745,251,489,88,256,145,192,108,335,443,140,74,29,81,122,911,11.84
1439,"Dale Ellis\ellisda01","1992-93",32,"SAS","NBA",6.4,82,76,2731,545,1092,426,795,119,297,157,197,81,231,312,107,78,18,111,179,1366,13.34
1440,"Steve Francis\francst01","1999-00",22,"HOU","NBA",6.4,77,77,2776,497,1117,390,807,107,310,287,365,152,257,409,507,118,29,306,231,1388,18.58
1441,"Channing Frye\fryech01","2009-10",26,"PHO","NBA",6.4,81,41,2190,317,703,145,311,172,392,98,121,66,361,427,113,64,74,73,263,904,11.05
1442,"Marc Gasol\gasolma01","2008-09",24,"MEM","NBA",6.4,82,75,2521,350,661,350,660,0,1,275,375,201,404,605,143,63,90,164,265,975,13.18
1443,"Pau Gasol\gasolpa01","2016-17",36,"SAS","NBA",6.4,64,39,1627,303,604,247,500,56,104,130,184,107,394,501,150,24,70,81,110,792,13.24
1444,"Rudy Gay\gayru01","2009-10",23,"MEM","NBA",6.4,80,80,3175,600,1288,534,1086,66,202,301,400,115,357,472,153,118,64,169,201,1567,16.56
1445,"Rudy Gobert\goberru01","2015-16",23,"UTA","NBA",6.4,61,60,1932,198,354,198,354,0,0,161,283,208,460,668,91,45,135,114,163,557,13.28
1446,"Marcin Gortat\gortama01","2010-11",26,"TOT","NBA",6.4,80,14,2032,338,603,337,599,1,4,140,193,148,483,631,70,36,91,81,188,817,11.38
1447,"Tim Hardaway\hardati01","2000-01",34,"MIA","NBA",6.4,77,77,2613,408,1042,219,525,189,517,145,181,26,178,204,483,90,6,189,155,1150,14.07
1448,"Derek Harper\harpede01","1994-95",33,"NYK","NBA",6.4,80,80,2716,337,756,231,464,106,292,139,192,31,163,194,458,79,10,151,219,919,12.34
1449,"Chuck Hayes\hayesch01","2006-07",23,"HOU","NBA",6.4,78,43,1714,192,335,192,335,0,0,55,89,204,317,521,47,70,18,64,281,439,7.58
1450,"Josh Howard\howarjo01","2004-05",24,"DAL","NBA",6.4,76,76,2446,377,793,343,678,34,115,170,232,169,315,484,109,116,49,122,211,958,12.49
1451,"Lindsey Hunter\hunteli01","1996-97",26,"DET","NBA",6.4,82,76,3023,421,1042,255,574,166,468,158,203,59,174,233,154,129,24,96,206,1166,11.39
1452,"Ersan İlyasova\ilyaser01","2011-12",24,"MIL","NBA",6.4,60,41,1655,294,597,243,485,51,112,143,183,196,333,529,71,42,44,76,133,782,13.33
1453,"Antawn Jamison\jamisan01","2001-02",25,"GSW","NBA",6.4,82,82,3033,614,1375,546,1165,68,210,323,440,211,345,556,161,70,45,161,187,1619,15.75
1454,"Ervin Johnson\johnser02","1997-98",30,"MIL","NBA",6.4,81,81,2261,253,471,253,471,0,0,143,238,242,443,685,59,79,158,117,321,649,10.96
1455,"Joe Johnson\johnsjo02","2011-12",30,"ATL","NBA",6.4,60,60,2127,423,931,298,609,125,322,158,186,53,168,221,232,48,13,116,75,1129,15.72
1456,"Enes Kanter\kanteen01","2014-15",22,"TOT","NBA",6.4,75,74,2135,482,928,466,883,16,45,183,234,277,394,671,55,36,29,145,189,1163,13.99
1457,"Jason Kidd\kiddja01","2010-11",37,"DAL","NBA",6.4,80,80,2653,215,596,82,205,133,391,67,77,35,316,351,655,134,29,179,119,630,13.1
1458,"Kyle Korver\korveky01","2012-13",31,"ATL","NBA",6.4,74,60,2259,277,601,88,187,189,414,67,78,23,270,293,146,70,37,70,170,810,10.96
1459,"Raef LaFrentz\lafrera01","2001-02",25,"TOT","NBA",6.4,78,76,2455,421,920,317,652,104,268,105,151,176,403,579,89,55,213,94,281,1051,13.53
1460,"Kevin Love\loveke01","2017-18",29,"CLE","NBA",6.4,59,59,1651,334,729,197,399,137,330,234,266,101,445,546,103,43,24,90,120,1039,16.95
1461,"Kevin Love\loveke01","2016-17",28,"CLE","NBA",6.4,60,60,1885,370,867,225,478,145,389,257,295,148,518,666,116,53,21,122,125,1142,18.05
1462,"Jamal Mashburn\mashbja01","1999-00",27,"MIA","NBA",6.4,76,76,2828,515,1158,403,880,112,278,186,239,64,317,381,298,79,14,180,215,1328,15.16
1463,"Anthony Mason\masonan01","2001-02",35,"MIL","NBA",6.4,82,82,3143,316,626,315,625,1,1,154,221,124,522,646,346,57,22,130,187,787,12.46
1464,"Reggie Miller\millere01","1998-99",33,"IND","NBA",6.4,50,50,1787,294,671,188,396,106,275,226,247,25,110,135,112,37,9,76,101,920,14.7
1465,"Paul Millsap\millspa01","2016-17",31,"ATL","NBA",6.4,69,67,2343,430,972,355,731,75,241,311,405,111,422,533,252,90,62,158,186,1246,17.72
1466,"Markieff Morris\morrima02","2013-14",24,"PHO","NBA",6.4,81,0,2153,411,845,377,737,34,108,259,327,139,346,485,144,68,51,147,232,1115,13.08
1467,"Troy Murphy\murphtr01","2002-03",22,"GSW","NBA",6.4,79,79,2510,338,749,335,735,3,14,244,290,228,578,806,106,65,30,111,246,923,12.63
1468,"Joakim Noah\noahjo01","2008-09",23,"CHI","NBA",6.4,80,55,1938,207,372,207,371,0,1,123,182,244,362,606,106,49,110,82,238,537,9.73
1469,"Jermaine O'Neal\onealje01","2000-01",22,"IND","NBA",6.4,81,80,2641,404,868,404,863,0,5,233,388,249,545,794,98,49,228,161,280,1041,13.92
1470,"Jermaine O'Neal\onealje01","2001-02",23,"IND","NBA",6.4,72,72,2707,543,1133,542,1119,1,14,284,413,188,569,757,118,45,166,174,269,1371,17.92
1471,"Zach Randolph\randoza01","2013-14",32,"MEM","NBA",6.4,79,79,2705,560,1198,558,1178,2,20,250,337,265,530,795,200,54,23,183,210,1372,15.83
1472,"Mitch Richmond\richmmi01","1993-94",28,"SAC","NBA",6.4,78,78,2897,635,1428,508,1116,127,312,426,511,70,216,286,313,103,17,216,211,1823,19.13
1473,"Josh Smith\smithjo03","2010-11",25,"ATL","NBA",6.4,77,77,2645,497,1041,446,887,51,154,229,316,134,523,657,255,99,120,197,217,1274,17.32
1474,"Steve Smith\smithst01","2001-02",32,"SAS","NBA",6.4,77,76,2211,310,682,194,436,116,246,159,181,45,148,193,151,54,15,108,158,895,10.13
1475,"John Stockton\stockjo01","1998-99",36,"UTA","NBA",6.4,50,50,1410,200,410,184,360,16,50,137,169,31,115,146,374,81,13,110,107,553,14.87
1476,"Nick Van Exel\vanexni01","2000-01",29,"DEN","NBA",6.4,71,70,2688,460,1112,325,754,135,358,204,249,44,197,241,600,61,18,165,109,1259,17.42
1477,"Nick Van Exel\vanexni01","1994-95",23,"LAL","NBA",6.4,80,80,2944,465,1107,282,596,183,511,235,300,27,196,223,660,97,6,220,157,1348,17.32
1478,"Gerald Wallace\wallage01","2005-06",23,"CHA","NBA",6.4,55,52,1895,317,589,303,539,14,50,188,306,123,289,412,96,138,115,99,150,836,17.34
1479,"Rasheed Wallace\wallara01","1996-97",22,"POR","NBA",6.4,62,56,1892,380,681,371,648,9,33,169,265,122,297,419,74,48,59,114,198,938,14.25
1480,"Delonte West\westde01","2008-09",25,"CLE","NBA",6.4,64,64,2152,285,624,194,396,91,228,90,108,31,172,203,226,94,13,92,125,751,11.93
1481,"Ray Allen\allenra02","2006-07",31,"SEA","NBA",6.3,55,55,2219,505,1153,340,710,165,443,279,309,57,190,247,228,82,11,154,113,1454,21.55
1482,"Matt Barnes\barnema02","2012-13",32,"LAC","NBA",6.3,80,4,2058,312,675,201,350,111,325,87,117,111,255,366,123,82,63,90,233,822,10.26
1483,"Brandon Bass\bassbr01","2010-11",25,"ORL","NBA",6.3,76,51,1980,332,645,332,643,0,2,190,233,134,290,424,57,27,52,97,159,854,10.41
1484,"Mike Bibby\bibbymi01","2001-02",23,"SAC","NBA",6.3,80,80,2659,446,985,395,847,51,138,155,193,37,185,222,403,87,15,134,133,1098,13
1485,"Shawn Bradley\bradlsh01","2000-01",28,"DAL","NBA",6.3,82,35,2001,219,447,218,441,1,6,140,178,160,448,608,38,36,228,88,256,579,9.8
1486,"Kobe Bryant\bryanko01","1997-98",19,"LAL","NBA",6.3,79,1,2056,391,913,316,693,75,220,363,457,79,163,242,199,74,40,157,180,1220,13.14
1487,"Caron Butler\butleca01","2005-06",25,"WAS","NBA",6.3,75,54,2708,494,1086,453,966,41,120,289,332,114,352,466,186,127,18,175,238,1318,15.93
1488,"José Calderón\caldejo01","2013-14",32,"DAL","NBA",6.3,81,81,2468,341,748,150,323,191,425,52,63,29,163,192,377,69,11,103,136,925,11.74
1489,"Ed Davis\davised01","2014-15",25,"LAL","NBA",6.3,79,24,1840,282,469,282,469,0,0,92,189,230,370,600,94,49,98,58,202,656,10.44
1490,"Luol Deng\denglu01","2012-13",27,"CHI","NBA",6.3,75,75,2903,466,1093,391,860,75,233,230,282,162,314,476,222,81,32,144,105,1237,14.49
1491,"DeMar DeRozan\derozde01","2018-19",29,"SAS","NBA",6.3,77,77,2688,631,1313,624,1268,7,45,366,441,54,408,462,475,86,36,199,177,1635,20.35
1492,"Michael Finley\finlemi01","1995-96",22,"PHO","NBA",6.3,82,72,3212,465,976,404,790,61,186,242,323,139,235,374,289,85,31,133,199,1233,14.17
1493,"Michael Finley\finlemi01","2001-02",28,"DAL","NBA",6.3,69,69,2754,569,1228,493,1004,76,224,210,251,90,270,360,230,65,25,117,144,1424,16.86
1494,"Derek Fisher\fishede01","2008-09",34,"LAL","NBA",6.3,82,82,2441,292,688,172,386,120,302,110,130,25,163,188,261,95,6,72,187,814,9.74
1495,"Danilo Gallinari\gallida01","2015-16",27,"DEN","NBA",6.3,53,53,1839,287,700,200,461,87,239,375,432,52,229,281,135,42,19,77,87,1036,16.98
1496,"Brian Grant\grantbr01","1997-98",25,"POR","NBA",6.3,61,49,1921,283,557,283,556,0,1,171,228,197,358,555,86,44,45,110,184,737,13.04
1497,"Derek Harper\harpede01","1995-96",34,"NYK","NBA",6.3,82,82,2893,436,939,315,614,121,325,156,206,32,170,202,352,131,5,178,201,1149,13.51
1498,"Ron Harper\harpero01","1995-96",32,"CHI","NBA",6.3,80,80,1886,234,501,206,397,28,104,98,139,74,139,213,208,105,32,73,137,594,8.48
1499,"Chuck Hayes\hayesch01","2010-11",27,"HOU","NBA",6.3,74,63,2079,244,463,244,461,0,2,94,142,219,380,599,202,79,49,86,200,582,11.22
1500,"Al Horford\horfoal01","2016-17",30,"BOS","NBA",6.3,68,68,2193,379,801,293,559,86,242,108,135,95,370,465,337,52,86,115,138,952,15.68
1501,"Jeff Hornacek\hornaje01","1992-93",29,"PHI","NBA",6.3,79,78,2860,582,1239,485,990,97,249,250,289,84,258,342,548,131,21,222,203,1511,19.33
1502,"Amir Johnson\johnsam01","2013-14",26,"TOR","NBA",6.3,77,72,2214,344,612,324,546,20,66,91,143,172,333,505,115,56,88,123,271,799,11.53
1503,"Avery Johnson\johnsav01","1999-00",34,"SAS","NBA",6.3,82,82,2571,402,850,401,841,1,9,114,155,33,125,158,491,76,18,140,150,919,11.75
1504,"Shawn Kemp\kempsh01","1998-99",29,"CLE","NBA",6.3,42,42,1475,277,575,276,573,1,2,307,389,131,257,388,101,48,45,127,159,862,20.07
1505,"Ty Lawson\lawsoty01","2013-14",26,"DEN","NBA",6.3,62,61,2222,347,806,275,604,72,202,324,406,40,175,215,543,100,10,200,113,1090,19.43
1506,"Brook Lopez\lopezbr01","2010-11",22,"NJN","NBA",6.3,82,82,2889,644,1309,644,1308,0,1,385,489,197,291,488,129,47,120,176,240,1673,16.94
1507,"Corey Maggette\maggeco01","2009-10",30,"GSW","NBA",6.3,70,49,2081,457,886,444,836,13,50,460,551,92,281,373,172,51,4,168,231,1387,17.67
1508,"Jamal Mashburn\mashbja01","1994-95",22,"DAL","NBA",6.3,80,80,2980,683,1566,570,1222,113,344,447,605,116,215,331,298,82,8,235,190,1926,18.35
1509,"Jason Maxiell\maxieja01","2007-08",24,"DET","NBA",6.3,82,7,1768,240,446,240,445,0,1,171,270,177,256,433,46,21,94,71,183,651,8.38
1510,"Terry Mills\millste01","1993-94",26,"DET","NBA",6.3,80,74,2773,588,1151,564,1078,24,73,181,227,193,479,672,177,64,62,153,309,1381,16.15
1511,"Alonzo Mourning\mournal01","1993-94",23,"CHH","NBA",6.3,60,59,2018,427,845,427,843,0,2,433,568,177,433,610,86,27,188,199,207,1287,21.25
1512,"Glen Rice\ricegl01","1992-93",25,"MIA","NBA",6.3,82,82,3082,582,1324,434,938,148,386,242,295,92,332,424,180,92,25,157,201,1554,15.17
1513,"Luis Scola\scolalu01","2009-10",29,"HOU","NBA",6.3,82,82,2671,560,1090,559,1085,1,5,208,267,175,530,705,169,63,26,163,246,1329,15.22
1514,"Joe Smith\smithjo02","2003-04",28,"MIL","NBA",6.3,76,76,2254,311,708,310,703,1,5,207,241,230,413,643,78,47,94,82,209,830,11.44
1515,"Myles Turner\turnemy01","2018-19",22,"IND","NBA",6.3,74,74,2119,380,780,304,584,76,196,148,201,101,430,531,115,60,199,100,195,984,14.34
1516,"Keith Van Horn\vanhoke01","2003-04",28,"TOT","NBA",6.3,72,62,2340,410,903,317,670,93,233,249,290,149,352,501,120,68,33,169,215,1162,14.62
1517,"Keith Van Horn\vanhoke01","2001-02",26,"NJN","NBA",6.3,81,81,2465,471,1089,370,796,101,293,156,195,137,472,609,164,63,42,146,221,1199,13.09
1518,"Loy Vaught\vaughlo01","1996-97",28,"LAC","NBA",6.3,82,82,2838,542,1084,540,1072,2,12,134,191,222,595,817,110,85,25,137,241,1220,14.16
1519,"Loy Vaught\vaughlo01","1995-96",27,"LAC","NBA",6.3,80,78,2966,571,1087,564,1068,7,19,149,205,204,604,808,112,87,40,158,241,1298,15.75
1520,"Martell Webster\webstma02","2012-13",26,"WAS","NBA",6.3,76,62,2200,281,636,142,307,139,329,168,198,53,241,294,143,49,17,90,166,869,10.56
1521,"David Wesley\wesleda01","1995-96",25,"BOS","NBA",6.3,82,53,2104,338,736,222,464,116,272,217,288,68,196,264,390,100,11,159,207,1009,13.25
1522,"Hassan Whiteside\whiteha01","2018-19",29,"MIA","NBA",6.3,72,53,1674,388,680,386,664,2,16,109,243,257,560,817,56,46,136,97,192,887,14.16
1523,"Thaddeus Young\youngth01","2011-12",23,"PHI","NBA",6.3,63,1,1755,348,687,347,683,1,4,111,144,137,188,325,74,64,41,55,127,808,11.55
1524,"Cody Zeller\zelleco01","2015-16",23,"CHO","NBA",6.3,73,60,1774,231,437,230,427,1,10,175,232,138,317,455,71,57,63,68,204,638,10.06
1525,"Shareef Abdur-Rahim\abdursh01","2005-06",29,"SAC","NBA",6.2,72,30,1961,332,632,327,610,5,22,218,278,106,251,357,149,48,42,108,227,887,12.19
1526,"Arron Afflalo\afflaar01","2010-11",25,"DEN","NBA",6.2,69,69,2324,312,627,207,379,105,248,138,163,45,206,251,168,34,31,71,153,867,11.83
1527,"Danny Ainge\aingeda01","1992-93",33,"PHO","NBA",6.2,80,0,2163,337,730,187,358,150,372,123,145,49,165,214,260,69,8,113,175,947,11.3
1528,"LaMarcus Aldridge\aldrila01","2007-08",22,"POR","NBA",6.2,76,76,2649,561,1160,560,1153,1,7,227,298,220,358,578,122,55,94,126,240,1350,15.41
1529,"Kyle Anderson\anderky01","2017-18",24,"SAS","NBA",6.2,74,67,1978,231,438,212,381,19,57,104,146,84,312,396,202,115,60,94,114,585,10.96
1530,"Giannis Antetokounmpo\antetgi01","2014-15",20,"MIL","NBA",6.2,81,71,2541,383,780,376,736,7,44,257,347,100,442,542,207,73,85,173,254,1030,13.52
1531,"Carmelo Anthony\anthoca01","2011-12",27,"NYK","NBA",6.2,55,55,1876,441,1025,373,822,68,203,295,367,88,256,344,200,62,24,144,156,1245,18.75
1532,"D.J. Augustin\augusdj01","2010-11",23,"CHA","NBA",6.2,82,82,2757,399,958,288,625,111,333,269,297,38,187,225,498,54,3,155,152,1178,14.03
1533,"D.J. Augustin\augusdj01","2013-14",26,"TOT","NBA",6.2,71,9,1939,298,718,165,386,133,332,201,227,15,115,130,313,53,3,125,147,930,12.15
1534,"Vin Baker\bakervi01","1995-96",24,"MIL","NBA",6.2,82,82,3319,699,1429,689,1381,10,48,321,479,263,545,808,212,68,91,216,272,1729,18.88
1535,"Will Barton\bartowi01","2017-18",27,"DEN","NBA",6.2,81,40,2683,465,1028,309,606,156,422,182,226,70,339,409,331,82,52,149,168,1268,15.19
1536,"Tony Battie\battito01","2001-02",25,"BOS","NBA",6.2,74,73,1819,211,390,211,388,0,2,88,130,184,297,481,35,60,67,51,219,510,8.49
1537,"Shane Battier\battish01","2002-03",24,"MEM","NBA",6.2,78,47,2383,275,569,189,353,86,216,120,145,128,217,345,105,102,88,68,207,756,10.68
1538,"Chris Bosh\boshch01","2003-04",19,"TOR","NBA",6.2,75,63,2510,327,712,322,698,5,14,202,288,191,366,557,78,59,106,107,215,861,11.59
1539,"Bruce Bowen\bowenbr01","2005-06",34,"SAS","NBA",6.2,82,82,2755,232,536,128,291,104,245,51,84,35,285,320,126,79,30,67,191,619,7.8
1540,"Kobe Bryant\bryanko01","2011-12",33,"LAL","NBA",6.2,58,58,2232,574,1336,487,1049,87,287,381,451,66,247,313,264,69,18,204,105,1616,21.97
1541,"Michael Cage\cagemi01","1992-93",31,"SEA","NBA",6.2,82,66,2156,219,416,219,415,0,1,61,130,268,391,659,69,76,46,59,183,499,8.39
1542,"Cedric Ceballos\cebalce01","1992-93",23,"PHO","NBA",6.2,74,46,1607,381,662,381,660,0,2,187,258,172,236,408,77,54,28,106,103,949,12.17
1543,"Samuel Dalembert\dalemsa01","2006-07",25,"PHI","NBA",6.2,82,82,2535,356,658,356,656,0,2,167,224,239,494,733,64,47,159,161,287,879,12.61
1544,"Dale Davis\davisda01","1995-96",26,"IND","NBA",6.2,78,77,2617,334,599,334,599,0,0,135,289,252,457,709,76,56,112,119,238,803,11.88
1545,"Boris Diaw\diawbo01","2009-10",27,"CHA","NBA",6.2,82,82,2906,373,773,307,567,66,206,113,147,131,293,424,325,60,57,178,219,925,12.4
1546,"Craig Ehlo\ehlocr01","1992-93",31,"CLE","NBA",6.2,82,73,2559,385,785,292,541,93,244,86,120,113,290,403,254,104,22,124,170,949,12.17
1547,"Dale Ellis\ellisda01","1995-96",35,"DEN","NBA",6.2,81,52,2626,459,959,309,595,150,364,136,179,88,227,315,139,57,7,98,191,1204,12.15
1548,"Joel Embiid\embiijo01","2017-18",23,"PHI","NBA",6.2,63,63,1912,510,1056,444,842,66,214,359,467,143,547,690,199,40,111,234,209,1445,22.22
1549,"Steve Francis\francst01","2004-05",27,"ORL","NBA",6.2,78,78,2978,563,1330,525,1203,38,127,499,606,126,324,450,547,112,28,317,273,1663,20.63
1550,"Dean Garrett\garrede01","1996-97",30,"MIN","NBA",6.2,68,47,1665,223,389,223,389,0,0,96,138,149,346,495,38,40,95,34,158,542,9.9
1551,"Danny Granger\grangda01","2009-10",26,"IND","NBA",6.2,62,62,2278,488,1139,330,701,158,438,363,428,67,275,342,171,94,51,157,183,1497,20.24
1552,"Roy Hibbert\hibbero01","2011-12",25,"IND","NBA",6.2,65,65,1937,332,668,332,667,0,1,170,239,213,359,572,108,32,128,128,195,834,13.81
1553,"George Hill\hillge01","2015-16",29,"IND","NBA",6.2,74,73,2524,326,739,198,425,128,314,114,150,58,240,298,259,83,17,101,149,894,12
1554,"Serge Ibaka\ibakase01","2011-12",22,"OKC","NBA",6.2,66,66,1792,262,490,261,487,1,3,78,118,193,305,498,28,33,241,79,179,603,11.66
1555,"Allen Iverson\iversal01","2006-07",31,"TOT","NBA",6.2,65,64,2761,581,1313,519,1116,62,197,485,610,23,170,193,468,123,13,268,95,1709,23.22
1556,"DeAndre Jordan\jordade01","2012-13",24,"LAC","NBA",6.2,82,82,2010,314,488,314,488,0,0,96,249,210,384,594,28,48,112,100,192,724,10.13
1557,"Michael Jordan\jordami01","2002-03",39,"WAS","NBA",6.2,82,67,3031,679,1527,663,1472,16,55,266,324,71,426,497,311,123,39,173,171,1640,16.91
1558,"Christian Laettner\laettch01","1995-96",26,"TOT","NBA",6.2,74,71,2495,442,907,433,868,9,39,324,396,184,354,538,197,71,71,187,276,1217,16.27
1559,"Christian Laettner\laettch01","1994-95",25,"MIN","NBA",6.2,81,80,2770,450,920,437,880,13,40,409,500,164,449,613,234,101,87,225,302,1322,17.19
1560,"Carl Landry\landrca01","2012-13",29,"GSW","NBA",6.2,81,2,1876,325,602,324,599,1,3,223,273,180,303,483,65,35,31,115,190,874,10.59
1561,"Kawhi Leonard\leonaka01","2012-13",21,"SAS","NBA",6.2,58,57,1810,260,526,195,352,65,174,104,126,63,283,346,93,97,32,62,99,689,12.74
1562,"Brook Lopez\lopezbr01","2015-16",27,"BRK","NBA",6.2,73,73,2457,591,1157,589,1143,2,14,317,403,204,369,573,147,58,124,175,215,1501,18.77
1563,"Ian Mahinmi\mahinia01","2015-16",29,"IND","NBA",6.2,71,71,1816,264,448,264,448,0,0,132,225,138,369,507,104,65,75,100,220,660,11.38
1564,"Wesley Matthews\matthwe02","2014-15",28,"POR","NBA",6.2,60,60,2024,337,752,164,307,173,445,109,145,38,184,222,139,77,10,81,132,956,13.67
1565,"Antonio McDyess\mcdyean01","1999-00",25,"DEN","NBA",6.2,81,81,2698,614,1211,614,1209,0,2,323,516,234,451,685,159,69,139,230,316,1551,17.57
1566,"Andre Miller\millean02","2005-06",29,"DEN","NBA",6.2,82,82,2937,404,872,399,845,5,27,313,424,92,259,351,674,106,18,256,213,1126,16.63
1567,"Terry Mills\millste01","1996-97",29,"DET","NBA",6.2,79,5,1997,312,702,137,287,175,415,58,70,68,309,377,99,35,27,85,161,857,9.62
1568,"Monte Morris\morrimo01","2018-19",23,"DEN","NBA",6.2,82,6,1970,346,702,252,475,94,227,65,81,35,159,194,297,73,4,52,102,851,10.4
1569,"Troy Murphy\murphtr01","2007-08",27,"IND","NBA",6.2,75,61,2106,315,693,221,457,94,236,192,241,108,435,543,165,49,32,96,217,916,12.55
1570,"Joakim Noah\noahjo01","2009-10",24,"CHI","NBA",6.2,64,54,1925,262,520,262,520,0,0,163,219,220,484,704,132,32,100,117,198,687,13.77
1571,"Shaquille O'Neal\onealsh01","2005-06",33,"MIA","NBA",6.2,59,58,1806,480,800,480,800,0,0,221,471,172,369,541,113,23,104,168,230,1181,18.72
1572,"Anthony Parker\parkean01","2007-08",32,"TOR","NBA",6.2,82,82,2634,395,829,262,525,133,304,102,125,50,284,334,183,79,17,87,157,1025,11.54
1573,"Kendrick Perkins\perkike01","2007-08",23,"BOS","NBA",6.2,78,78,1912,214,348,214,347,0,1,114,183,145,329,474,84,31,114,125,242,542,9.17
1574,"James Posey\poseyja01","2007-08",31,"BOS","NBA",6.2,74,2,1821,173,414,67,135,106,279,93,115,30,292,322,114,72,19,65,182,545,8.24
1575,"Tayshaun Prince\princta01","2008-09",28,"DET","NBA",6.2,82,82,3057,459,1020,403,879,56,141,189,243,128,348,476,253,44,51,101,104,1163,12.9
1576,"Michael Redd\reddmi01","2004-05",25,"MIL","NBA",6.2,75,75,2848,625,1418,521,1125,104,293,369,432,72,240,312,172,63,8,133,152,1723,16.92
1577,"Luke Ridnour\ridnolu01","2009-10",28,"MIL","NBA",6.2,82,0,1759,328,686,259,505,69,181,127,140,24,119,143,324,54,7,106,182,852,10.25
1578,"Dennis Rodman\rodmade01","1995-96",34,"CHI","NBA",6.2,64,57,2088,146,304,143,277,3,27,56,106,356,596,952,160,36,27,138,196,351,11.32
1579,"John Starks\starkjo01","1994-95",29,"NYK","NBA",6.2,80,78,2725,419,1062,202,451,217,611,168,228,34,185,219,411,92,4,160,257,1223,13.67
1580,"Amar'e Stoudemire\stoudam01","2002-03",20,"PHO","NBA",6.2,82,71,2570,392,830,390,820,2,10,320,484,250,471,721,78,62,87,189,269,1106,13.2
1581,"Wally Szczerbiak\szczewa02","1999-00",22,"MIN","NBA",6.2,73,53,2171,342,669,314,591,28,78,133,161,89,183,272,201,58,23,83,175,845,11.31
1582,"Gerald Wallace\wallage01","2010-11",28,"TOT","NBA",6.2,71,63,2693,386,851,324,665,62,186,279,374,111,458,569,173,105,63,152,183,1113,15.94
1583,"Rasheed Wallace\wallara01","2006-07",32,"DET","NBA",6.2,75,72,2419,357,843,253,547,104,296,108,137,90,453,543,127,75,118,94,225,926,12.41
1584,"Rasheed Wallace\wallara01","2003-04",29,"TOT","NBA",6.2,68,66,2390,425,974,343,726,82,248,156,212,102,357,459,156,61,122,119,190,1088,14.6
1585,"Thaddeus Young\youngth01","2010-11",22,"PHI","NBA",6.2,82,1,2135,458,847,452,825,6,22,123,174,153,281,434,82,90,26,99,170,1045,11.64
1586,"Carmelo Anthony\anthoca01","2003-04",19,"DEN","NBA",6.1,82,82,2995,624,1465,555,1251,69,214,408,525,183,315,498,227,97,41,247,225,1725,16.9
1587,"Trevor Ariza\arizatr01","2008-09",23,"LAL","NBA",6.1,82,20,1999,274,596,213,405,61,191,120,169,111,241,352,145,137,24,87,166,729,9.73
1588,"Brent Barry\barrybr01","2004-05",33,"SAS","NBA",6.1,81,8,1742,194,459,94,179,100,280,113,135,29,161,190,178,39,20,64,123,601,7.43
1589,"Bruce Bowen\bowenbr01","2004-05",33,"SAS","NBA",6.1,82,82,2627,251,598,149,345,102,253,71,112,50,235,285,126,55,39,57,175,675,7.62
1590,"Elton Brand\brandel01","2011-12",32,"PHI","NBA",6.1,60,60,1732,287,581,287,580,0,1,85,116,145,284,429,97,58,97,65,176,659,12
1591,"Elton Brand\brandel01","2000-01",21,"CHI","NBA",6.1,74,74,2906,578,1215,578,1213,0,2,334,472,285,461,746,240,71,118,219,243,1490,19.4
1592,"Robert Covington\covinro01","2017-18",27,"PHI","NBA",6.1,80,80,2532,345,836,142,286,203,550,116,136,55,378,433,156,137,72,126,238,1009,12.8
1593,"Erick Dampier\dampier01","2008-09",33,"DAL","NBA",6.1,80,80,1836,182,280,182,280,0,0,90,141,216,349,565,77,24,95,74,191,454,8.51
1594,"Anthony Davis\davisan02","2012-13",19,"NOH","NBA",6.1,64,60,1846,349,676,349,670,0,6,169,225,165,357,522,63,75,112,89,158,867,14.33
1595,"Antonio Davis\davisan01","1999-00",31,"TOR","NBA",6.1,79,78,2479,313,712,313,712,0,0,284,371,235,461,696,105,38,100,121,267,910,12.18
1596,"Vlade Divac\divacvl01","1995-96",27,"LAL","NBA",6.1,79,79,2470,414,807,411,789,3,18,189,295,198,481,679,261,76,131,199,274,1020,15.19
1597,"Sean Elliott\elliose01","1992-93",24,"SAS","NBA",6.1,70,70,2604,451,918,414,814,37,104,268,337,85,237,322,265,68,28,152,132,1207,15.99
1598,"Rudy Fernández\fernaru01","2008-09",23,"POR","NBA",6.1,78,4,1993,268,630,109,232,159,398,120,143,47,160,207,159,69,12,86,111,815,9.53
1599,"Danilo Gallinari\gallida01","2010-11",22,"TOT","NBA",6.1,62,60,2104,265,640,162,347,103,293,337,391,59,246,305,104,51,27,83,144,970,14.05
1600,"Rudy Gay\gayru01","2014-15",28,"SAC","NBA",6.1,68,67,2408,508,1116,429,896,79,220,337,393,98,301,399,250,71,41,183,157,1432,18.62
1601,"Draymond Green\greendr01","2017-18",27,"GSW","NBA",6.1,70,70,2287,281,619,204,363,77,256,134,173,75,460,535,508,95,91,202,185,773,16.64
1602,"Gerald Green\greenge01","2013-14",28,"PHO","NBA",6.1,82,48,2330,448,1006,244,496,204,510,195,230,48,227,275,122,70,42,145,220,1295,12.81
1603,"Matt Harpring\harprma01","2001-02",25,"PHI","NBA",6.1,81,81,2541,386,838,365,769,21,69,165,222,203,370,573,107,70,5,127,201,958,10.87
1604,"Roy Hibbert\hibbero01","2012-13",26,"IND","NBA",6.1,79,79,2269,385,859,384,855,1,4,166,224,296,360,656,113,39,206,162,279,937,12.55
1605,"Nenê Hilário\hilarne01","2003-04",21,"DEN","NBA",6.1,77,77,2504,334,630,334,628,0,2,240,352,154,349,503,168,116,41,183,280,908,13.24
1606,"George Hill\hillge01","2010-11",24,"SAS","NBA",6.1,76,5,2148,287,633,210,429,77,204,233,270,24,175,199,193,66,21,99,153,884,11
1607,"Fred Hoiberg\hoibefr01","2003-04",31,"MIN","NBA",6.1,79,3,1804,178,383,102,211,76,172,98,116,21,247,268,109,66,10,44,136,530,7.37
1608,"Allan Houston\houstal01","1997-98",26,"NYK","NBA",6.1,82,82,2848,571,1277,489,1064,82,213,285,335,43,231,274,212,63,24,200,207,1509,14.16
1609,"Serge Ibaka\ibakase01","2018-19",29,"TOR","NBA",6.1,74,51,2010,464,877,415,708,49,169,135,177,156,445,601,99,29,103,114,211,1112,14.56
1610,"Zydrunas Ilgauskas\ilgauzy01","2007-08",32,"CLE","NBA",6.1,73,73,2222,417,879,417,878,0,1,195,243,263,419,682,104,34,120,135,247,1029,14.04
1611,"Mark Jackson\jacksma01","1996-97",31,"TOT","NBA",6.1,82,82,3054,289,679,223,501,66,178,168,213,91,304,395,935,97,12,274,161,812,16.49
1612,"Chris Kaman\kamanch01","2005-06",23,"LAC","NBA",6.1,78,78,2560,369,706,369,704,0,2,194,252,187,563,750,79,45,108,176,269,932,13.31
1613,"Steve Kerr\kerrst01","1993-94",28,"CHI","NBA",6.1,82,0,2036,287,577,235,453,52,124,83,97,26,105,131,210,75,3,57,97,709,8.42
1614,"Dan Majerle\majerda01","1999-00",34,"MIA","NBA",6.1,69,69,2308,170,422,60,118,110,304,56,69,27,306,333,206,89,17,62,156,506,9.44
1615,"Khris Middleton\middlkh01","2015-16",24,"MIL","NBA",6.1,79,79,2852,507,1142,364,781,143,361,277,312,44,258,302,331,131,19,180,204,1434,16.71
1616,"Khris Middleton\middlkh01","2018-19",27,"MIL","NBA",6.1,77,77,2393,506,1148,327,674,179,474,216,258,50,411,461,331,80,7,174,172,1407,16.75
1617,"Paul Millsap\millspa01","2018-19",33,"DEN","NBA",6.1,70,65,1895,322,665,264,506,58,159,181,249,153,352,505,141,83,54,95,183,883,13.44
1618,"Sam Mitchell\mitchsa01","1997-98",34,"MIN","NBA",6.1,81,33,2239,371,800,356,757,15,43,243,292,118,267,385,107,64,22,66,200,1000,10.83
1619,"Eric Murdock\murdoer01","1992-93",24,"MIL","NBA",6.1,79,78,2437,438,936,407,817,31,119,231,296,95,189,284,603,174,7,207,177,1138,17.05
1620,"Fabricio Oberto\obertfa01","2007-08",32,"SAS","NBA",6.1,82,64,1644,180,296,180,295,0,1,37,61,153,277,430,95,37,20,51,203,397,6.61
1621,"Bo Outlaw\outlabo01","1996-97",25,"LAC","NBA",6.1,82,25,2195,254,417,254,409,0,8,117,232,174,280,454,157,94,142,107,227,625,10.65
1622,"Patrick Patterson\pattepa01","2014-15",25,"TOR","NBA",6.1,81,4,2156,240,535,135,252,105,283,63,80,127,306,433,155,60,44,54,149,648,9.08
1623,"Mason Plumlee\plumlma01","2015-16",25,"POR","NBA",6.1,82,82,2084,267,517,267,513,0,4,215,335,201,427,628,226,68,85,154,253,749,11.99
1624,"Julius Randle\randlju01","2018-19",24,"NOP","NBA",6.1,73,49,2232,571,1089,504,894,67,195,356,487,162,472,634,229,52,45,208,246,1565,20.22
1625,"Michael Redd\reddmi01","2006-07",27,"MIL","NBA",6.1,53,53,2036,477,1025,360,719,117,306,345,416,42,154,196,124,63,9,122,78,1416,20.67
1626,"Mitchell Robinson\robinmi01","2018-19",20,"NYK","NBA",6.1,66,19,1360,202,291,202,291,0,0,81,135,177,246,423,37,52,161,35,217,485,10.61
1627,"Ricky Rubio\rubiori01","2016-17",26,"MIN","NBA",6.1,75,75,2469,261,650,201,454,60,196,254,285,68,237,305,682,128,10,195,202,836,16.1
1628,"Joe Smith\smithjo02","2001-02",26,"MIN","NBA",6.1,72,63,1922,297,581,295,578,2,3,171,206,152,301,453,82,39,59,86,250,767,10.89
1629,"Kenny Smith\smithke01","1993-94",28,"HOU","NBA",6.1,78,78,2209,341,711,252,491,89,220,135,155,24,114,138,327,59,4,126,121,906,11.32
1630,"Kenny Smith\smithke01","1994-95",29,"HOU","NBA",6.1,81,81,2030,287,593,145,262,142,331,126,148,27,128,155,323,71,10,123,109,842,11.1
1631,"Rik Smits\smitsri01","1997-98",31,"IND","NBA",6.1,73,69,2085,514,1038,514,1035,0,3,188,240,127,378,505,101,40,88,134,243,1216,14.36
1632,"Eric Snow\snower01","1999-00",26,"PHI","NBA",6.1,82,80,2866,257,597,246,552,11,45,126,177,42,219,261,624,140,8,162,243,651,12.22
1633,"Damon Stoudamire\stoudda01","1999-00",26,"POR","NBA",6.1,78,78,2372,386,894,306,682,80,212,122,145,61,182,243,405,77,1,149,173,974,12.2
1634,"Amar'e Stoudemire\stoudam01","2008-09",26,"PHO","NBA",6.1,53,53,1948,404,749,401,742,3,7,323,387,116,314,430,104,49,57,150,163,1134,20.37
1635,"Jeff Teague\teaguje01","2012-13",24,"ATL","NBA",6.1,80,78,2628,439,974,350,726,89,248,199,226,25,155,180,579,117,28,230,181,1166,15.79
1636,"Isaiah Thomas\thomais02","2014-15",25,"TOT","NBA",6.1,67,1,1726,335,797,206,451,129,346,302,348,33,120,153,284,57,5,143,150,1101,14.61
1637,"P.J. Tucker\tuckepj01","2013-14",28,"PHO","NBA",6.1,81,81,2490,265,615,191,424,74,191,156,201,161,368,529,141,110,23,102,204,760,10.54
1638,"David Wesley\wesleda01","1996-97",26,"BOS","NBA",6.1,74,73,2991,456,974,353,688,103,286,225,288,67,197,264,537,162,13,211,221,1240,18.49
1639,"David Wesley\wesleda01","1999-00",29,"CHH","NBA",6.1,82,82,2760,407,955,319,707,88,248,214,275,39,186,225,463,109,11,159,186,1116,13.62
1640,"Russell Westbrook\westbru01","2009-10",21,"OKC","NBA",6.1,82,82,2813,485,1160,462,1056,23,104,329,422,143,258,401,652,108,34,268,204,1322,17.26
1641,"Buck Williams\willibu01","1992-93",32,"POR","NBA",6.1,82,82,2498,270,528,270,527,0,1,138,214,232,458,690,75,81,61,101,270,678,10.22
1642,"Buck Williams\willibu01","1994-95",34,"POR","NBA",6.1,82,82,2422,309,604,308,602,1,2,138,205,251,418,669,78,67,69,119,254,757,10.59
1643,"Lou Williams\willilo02","2011-12",25,"PHI","NBA",6.1,64,0,1682,318,782,235,553,83,229,237,292,30,125,155,221,53,18,71,90,956,12.44
1644,"Lou Williams\willilo02","2016-17",30,"TOT","NBA",6.1,81,1,1994,428,998,265,552,163,446,402,457,26,176,202,239,80,20,160,92,1421,14.98
1645,"Marvin Williams\willima02","2008-09",22,"ATL","NBA",6.1,61,59,2093,285,622,230,467,55,155,220,273,110,272,382,81,57,39,70,127,845,13.05
1646,"Brandan Wright\wrighbr03","2014-15",27,"TOT","NBA",6.1,75,7,1449,233,363,233,360,0,3,78,112,128,193,321,41,50,94,34,102,544,8.57
1647,"Chris Andersen\anderch01","2013-14",35,"MIA","NBA",6,72,0,1396,177,275,174,263,3,12,120,169,129,250,379,19,32,97,53,162,477,8.34
1648,"Trevor Ariza\arizatr01","2016-17",31,"HOU","NBA",6,80,80,2773,326,798,135,243,191,555,93,126,54,404,458,175,147,20,73,133,936,12.02
1649,"Vincent Askew\askewvi01","1993-94",27,"SEA","NBA",6,80,3,1690,273,567,267,536,6,31,175,211,60,124,184,194,73,19,70,145,727,9.01
1650,"Earl Boykins\boykiea01","2004-05",28,"DEN","NBA",6,82,5,2162,340,824,284,658,56,166,279,303,37,106,143,372,78,12,121,122,1015,11.81
1651,"Vince Carter\cartevi01","2012-13",36,"DAL","NBA",6,81,3,2093,372,855,210,456,162,399,182,223,58,276,334,194,74,44,106,226,1088,12.3
1652,"Vince Carter\cartevi01","2003-04",27,"TOR","NBA",6,73,73,2785,608,1457,515,1214,93,243,336,417,95,254,349,348,88,65,223,212,1645,18.53
1653,"John Collins\collijo01","2018-19",21,"ATL","NBA",6,61,59,1829,465,831,410,673,55,158,203,266,219,376,595,121,22,39,120,199,1188,18.67
1654,"DeMarcus Cousins\couside01","2014-15",24,"SAC","NBA",6,59,59,2013,498,1066,496,1058,2,8,423,541,185,562,747,210,90,103,254,241,1421,24.32
1655,"Erick Dampier\dampier01","2007-08",32,"DAL","NBA",6,72,64,1755,178,277,178,277,0,0,84,146,207,332,539,63,24,106,80,226,440,9.03
1656,"Antonio Davis\davisan01","1995-96",27,"IND","NBA",6,82,14,2092,236,482,235,480,1,2,246,345,188,313,501,43,33,66,87,248,719,9.1
1657,"Clyde Drexler\drexlcl01","1992-93",30,"POR","NBA",6,49,49,1671,350,816,319,683,31,133,245,292,126,183,309,278,95,37,115,159,976,19.7
1658,"Joe Dumars\dumarjo01","1995-96",32,"DET","NBA",6,67,40,2193,255,598,134,300,121,298,162,197,28,110,138,265,43,3,97,106,793,11.17
1659,"Dale Ellis\ellisda01","1997-98",37,"SEA","NBA",6,79,0,1939,348,700,221,426,127,274,111,142,51,133,184,89,60,5,74,128,934,9.75
1660,"Monta Ellis\ellismo01","2010-11",25,"GSW","NBA",6,80,80,3227,726,1611,589,1232,137,379,340,431,44,237,281,450,168,23,252,203,1929,20.84
1661,"Marc Gasol\gasolma01","2018-19",34,"TOT","NBA",6,79,72,2436,390,870,291,597,99,273,192,253,80,547,627,349,84,86,155,217,1071,15.61
1662,"Pau Gasol\gasolpa01","2017-18",37,"SAS","NBA",6,77,63,1812,287,627,244,507,43,120,158,209,129,490,619,238,24,79,108,121,775,12
1663,"Rudy Gay\gayru01","2011-12",25,"MEM","NBA",6,65,65,2422,485,1067,431,894,54,173,208,263,130,287,417,147,95,55,161,138,1232,16.31
1664,"Paul George\georgpa01","2011-12",21,"IND","NBA",6,66,66,1958,281,639,191,405,90,234,146,182,56,314,370,158,108,38,117,191,798,12.76
1665,"Ron Harper\harpero01","1992-93",29,"LAC","NBA",6,80,77,2970,542,1203,490,1017,52,186,307,399,117,308,425,360,177,73,222,212,1443,17.89
1666,"Udonis Haslem\hasleud01","2009-10",29,"MIA","NBA",6,78,0,2177,312,632,312,632,0,0,147,193,167,462,629,52,30,23,75,174,771,9.86
1667,"Alan Henderson\hendeal01","1997-98",25,"ATL","NBA",6,69,33,2000,365,753,362,747,3,6,253,388,200,242,442,73,42,36,110,175,986,12.26
1668,"Rodney Hood\hoodro01","2015-16",23,"UTA","NBA",6,79,79,2541,408,972,247,523,161,449,172,200,38,229,267,213,73,16,125,202,1149,12.16
1669,"Juwan Howard\howarju01","2002-03",29,"DEN","NBA",6,77,77,2730,567,1261,565,1257,2,4,282,351,181,404,585,234,77,27,189,239,1418,15.95
1670,"Joe Ingles\inglejo01","2018-19",31,"UTA","NBA",6,82,82,2568,359,802,170,319,189,483,87,123,35,295,330,469,98,20,193,180,994,13.83
1671,"Mark Jackson\jacksma01","2001-02",36,"NYK","NBA",6,82,82,2367,260,592,181,397,79,195,87,110,56,253,309,605,74,1,150,162,686,12.05
1672,"Richard Jefferson\jefferi01","2009-10",29,"SAS","NBA",6,81,70,2520,362,775,303,588,59,187,211,287,58,298,356,158,45,40,105,178,994,11.01
1673,"Joe Johnson\johnsjo02","2005-06",24,"ATL","NBA",6,82,82,3340,632,1395,504,1035,128,360,261,330,98,237,335,536,103,31,267,187,1653,18.73
1674,"Eddie Jones\jonesed02","2002-03",31,"MIA","NBA",6,47,47,1789,291,688,193,447,98,241,189,230,35,191,226,173,64,31,85,137,869,16.69
1675,"Eddie Jones\jonesed02","1998-99",27,"TOT","NBA",6,50,50,1881,260,595,212,453,48,142,212,271,50,144,194,186,125,58,93,128,780,16.35
1676,"Andrei Kirilenko\kirilan01","2012-13",31,"MIN","NBA",6,64,64,2034,284,560,249,440,35,120,188,250,102,260,362,177,96,62,119,82,791,14
1677,"Andrei Kirilenko\kirilan01","2009-10",28,"UTA","NBA",6,58,35,1681,244,482,218,393,26,89,174,234,76,188,264,158,83,71,79,102,688,13.33
1678,"David Lee\leeda02","2010-11",27,"GSW","NBA",6,73,73,2634,496,978,495,975,1,3,210,267,217,497,714,233,74,31,170,211,1203,16.96
1679,"Kevon Looney\looneke01","2018-19",22,"GSW","NBA",6,80,24,1481,217,347,216,337,1,10,65,105,194,223,417,123,46,53,51,211,500,8.3
1680,"Donyell Marshall\marshdo01","2004-05",31,"TOR","NBA",6,65,2,1645,262,592,111,229,151,363,72,91,95,333,428,81,57,46,42,136,747,11.49
1681,"Donyell Marshall\marshdo01","2002-03",29,"CHI","NBA",6,78,53,2378,421,918,388,831,33,87,167,221,234,465,699,137,95,85,135,234,1042,13.8
1682,"CJ McCollum\mccolcj01","2015-16",24,"POR","NBA",6,80,80,2780,641,1431,444,959,197,472,187,226,47,212,259,341,97,23,196,187,1666,17.01
1683,"Antonio McDyess\mcdyean01","2006-07",32,"DET","NBA",6,82,3,1729,284,540,284,540,0,0,96,139,165,331,496,72,61,65,75,240,664,9
1684,"Nate McMillan\mcmilna01","1993-94",29,"SEA","NBA",6,73,8,1887,177,396,125,263,52,133,31,55,50,233,283,387,216,22,126,201,437,11.46
1685,"Jameer Nelson\nelsoja01","2008-09",26,"ORL","NBA",6,42,42,1309,267,531,185,350,82,181,86,97,20,125,145,226,51,3,83,123,702,16.71
1686,"Zaza Pachulia\pachuza01","2015-16",31,"DAL","NBA",6,76,69,2004,219,470,219,467,0,3,212,276,249,469,718,128,64,22,119,181,650,11.04
1687,"Mason Plumlee\plumlma01","2016-17",26,"TOT","NBA",6,81,64,2148,334,623,334,617,0,6,174,300,170,435,605,284,69,92,134,226,842,13.13
1688,"David Robinson\robinda01","2002-03",37,"SAS","NBA",6,64,64,1676,197,420,197,420,0,0,152,214,163,345,508,61,52,111,83,126,546,10.65
1689,"Dennis Rodman\rodmade01","1996-97",35,"CHI","NBA",6,55,54,1947,128,286,123,267,5,19,50,88,320,563,883,170,32,19,111,172,311,12.08
1690,"Derrick Rose\rosede01","2011-12",23,"CHI","NBA",6,39,39,1375,302,695,248,522,54,173,194,239,26,105,131,307,35,28,119,52,852,20.26
1691,"Derrick Rose\rosede01","2009-10",21,"CHI","NBA",6,78,78,2871,672,1373,656,1313,16,60,259,338,65,228,293,469,57,27,217,96,1619,18.16
1692,"Bryon Russell\russebr01","1997-98",27,"UTA","NBA",6,82,7,2219,226,525,153,311,73,214,213,278,78,248,326,101,90,31,81,229,738,9.12
1693,"Larry Sanders\sandela01","2012-13",24,"MIL","NBA",6,71,55,1937,306,605,306,603,0,2,84,136,224,448,672,83,53,201,87,233,696,12.6
1694,"Jeff Teague\teaguje01","2011-12",23,"ATL","NBA",6,66,66,2183,320,672,269,523,51,149,140,185,21,138,159,321,106,37,134,145,831,13.5
1695,"Otis Thorpe\thorpot01","1992-93",30,"HOU","NBA",6,72,69,2357,385,690,385,688,0,2,153,256,219,370,589,181,43,19,151,234,923,13.49
1696,"Clarence Weatherspoon\weathcl01","1993-94",23,"PHI","NBA",6,82,82,3147,602,1246,598,1229,4,17,298,430,254,578,832,192,100,116,195,152,1506,17.93
1697,"Bonzi Wells\wellsbo01","2001-02",25,"POR","NBA",6,74,69,2348,487,1039,421,867,66,172,215,290,121,323,444,204,113,25,191,208,1255,15.45
1698,"Chris Wilcox\wilcoch01","2006-07",24,"SEA","NBA",6,82,81,2586,433,819,433,813,0,6,240,351,178,451,629,82,70,38,127,248,1106,13.01
1699,"Eric Williams\willier01","2002-03",30,"BOS","NBA",6,82,79,2350,254,575,217,465,37,110,201,268,143,239,382,140,86,19,97,234,746,9.37
1700,"Kevin Willis\willike02","1992-93",30,"ATL","NBA",6,80,80,2878,616,1218,609,1189,7,29,196,300,335,693,1028,165,68,41,213,264,1435,17.63
1701,"Kevin Willis\willike02","1997-98",35,"HOU","NBA",6,81,74,2528,531,1041,530,1034,1,7,242,305,232,447,679,78,55,38,170,235,1305,14.46
1702,"Rafer Alston\alstora01","2003-04",27,"MIA","NBA",5.9,82,28,2581,287,764,126,330,161,434,103,134,26,200,226,372,114,18,128,212,838,10.77
1703,"Chris Andersen\anderch01","2009-10",31,"DEN","NBA",5.9,76,0,1695,142,251,142,248,0,3,164,236,147,336,483,33,42,143,59,171,448,8.67
1704,"Matt Barnes\barnema02","2009-10",29,"ORL","NBA",5.9,81,58,2097,271,557,205,350,66,207,108,146,106,339,445,134,59,30,112,185,716,9.52
1705,"Shane Battier\battish01","2003-04",25,"MEM","NBA",5.9,79,1,1947,242,543,177,357,65,186,120,164,102,201,303,101,101,58,56,187,669,8.88
1706,"Marco Belinelli\belinma01","2013-14",27,"SAS","NBA",5.9,80,25,2016,337,695,211,402,126,293,111,131,18,208,226,179,50,7,95,130,911,10.27
1707,"Bismack Biyombo\biyombi01","2015-16",23,"TOR","NBA",5.9,82,22,1808,156,288,156,287,0,1,142,226,182,473,655,29,19,133,71,225,454,8.24
1708,"Muggsy Bogues\boguemu01","1992-93",28,"CHH","NBA",5.9,81,80,2833,331,730,325,704,6,26,140,168,51,247,298,711,161,5,154,179,808,14.81
1709,"Carlos Boozer\boozeca01","2002-03",21,"CLE","NBA",5.9,81,54,2049,331,618,331,617,0,1,148,192,202,407,609,106,59,50,103,224,810,11.16
1710,"Marcus Camby\cambyma01","1999-00",25,"NYK","NBA",5.9,59,11,1548,226,471,225,469,1,2,148,221,174,287,461,49,43,116,72,204,601,11.45
1711,"Clint Capela\capelca01","2016-17",22,"HOU","NBA",5.9,65,59,1551,362,563,362,563,0,0,94,177,178,348,526,63,34,79,87,179,818,13.53
1712,"Derrick Coleman\colemde01","2001-02",34,"PHI","NBA",5.9,58,58,2080,331,735,303,652,28,83,185,227,167,342,509,98,42,51,119,158,875,14.24
1713,"Darren Collison\collida01","2013-14",26,"LAC","NBA",5.9,80,35,2069,324,694,253,505,71,189,192,224,47,141,188,297,93,15,132,150,911,11.61
1714,"Antonio Daniels\daniean01","2001-02",26,"SAS","NBA",5.9,82,13,2175,269,612,212,416,57,196,158,210,23,153,176,228,48,12,70,104,753,8.51
1715,"Luol Deng\denglu01","2009-10",24,"CHI","NBA",5.9,70,69,2651,473,1014,441,931,32,83,252,330,131,381,512,143,66,61,134,129,1230,15.6
1716,"Gorgui Dieng\dienggo01","2015-16",26,"MIN","NBA",5.9,82,39,2220,308,579,302,559,6,20,205,248,157,428,585,143,94,96,140,219,827,12.48
1717,"Vlade Divac\divacvl01","1997-98",29,"CHH","NBA",5.9,64,41,1805,267,536,264,522,3,14,130,188,183,335,518,172,83,94,114,179,667,13.31
1718,"Joe Dumars\dumarjo01","1997-98",34,"DET","NBA",5.9,72,72,2326,329,791,171,365,158,426,127,154,14,90,104,253,44,2,84,99,943,10.75
1719,"Tim Duncan\duncati01","2011-12",35,"SAS","NBA",5.9,58,58,1634,361,733,361,729,0,4,173,249,110,410,520,132,38,88,97,98,895,15.45
1720,"Craig Ehlo\ehlocr01","1993-94",32,"ATL","NBA",5.9,82,0,2147,316,708,239,487,77,221,112,154,71,208,279,273,136,26,130,161,821,10.88
1721,"Matt Geiger\geigema01","1997-98",28,"CHH","NBA",5.9,78,42,1839,358,709,357,698,1,11,168,236,196,325,521,78,68,87,111,191,885,11.49
1722,"Kendall Gill\gillke01","1997-98",29,"NJN","NBA",5.9,81,81,2733,418,974,392,873,26,101,225,327,112,279,391,200,156,64,124,268,1087,12.7
1723,"Brian Grant\grantbr01","1998-99",26,"POR","NBA",5.9,48,46,1525,183,382,183,382,0,0,184,226,173,297,470,67,21,34,96,136,550,12.89
1724,"Danny Green\greenda02","2012-13",25,"SAS","NBA",5.9,80,80,2201,297,663,120,250,177,413,67,79,36,208,244,141,92,54,94,124,838,10.18
1725,"Danny Green\greenda02","2018-19",31,"TOR","NBA",5.9,80,80,2216,293,630,95,195,198,435,37,44,60,257,317,126,73,53,75,171,821,10.24
1726,"Al Harrington\harrial01","2003-04",23,"IND","NBA",5.9,79,15,2441,421,909,400,832,21,77,185,252,163,345,508,131,80,22,163,250,1048,11.94
1727,"Buddy Hield\hieldbu01","2018-19",26,"SAC","NBA",5.9,82,82,2615,623,1360,345,709,278,651,171,193,106,306,412,205,58,33,146,202,1695,16.74
1728,"George Hill\hillge01","2016-17",30,"UTA","NBA",5.9,49,49,1544,289,606,195,373,94,233,157,196,23,144,167,204,50,11,85,114,829,15.76
1729,"Grant Hill\hillgr01","2007-08",35,"PHO","NBA",5.9,70,68,2222,358,712,325,608,33,104,170,196,74,279,353,203,65,56,96,153,919,13.44
1730,"Fred Hoiberg\hoibefr01","2000-01",28,"CHI","NBA",5.9,74,37,2247,217,495,114,245,103,250,136,157,21,287,308,263,98,12,74,155,673,11.06
1731,"Robert Horry\horryro01","1993-94",23,"HOU","NBA",5.9,81,81,2370,322,702,278,566,44,136,115,157,128,312,440,231,119,75,137,186,803,11.52
1732,"Mark Jackson\jacksma01","2000-01",35,"TOT","NBA",5.9,83,82,2588,244,583,174,376,70,207,73,93,63,242,305,661,84,7,175,139,631,11.88
1733,"Richard Jefferson\jefferi01","2010-11",30,"SAS","NBA",5.9,81,81,2459,304,642,169,335,135,307,148,195,54,256,310,107,38,34,93,164,891,9.94
1734,"Amir Johnson\johnsam01","2015-16",28,"BOS","NBA",5.9,79,76,1800,249,426,239,383,10,43,69,121,178,327,505,138,52,83,94,214,577,9.7
1735,"Steve Kerr\kerrst01","1994-95",29,"CHI","NBA",5.9,82,0,1839,261,495,172,325,89,170,63,81,20,99,119,151,44,3,48,114,674,7.61
1736,"Jason Kidd\kiddja01","2007-08",34,"TOT","NBA",5.9,80,80,2906,305,793,186,481,119,312,135,165,94,506,600,806,136,26,266,165,864,17.22
1737,"Kyle Korver\korveky01","2013-14",32,"ATL","NBA",5.9,71,71,2408,289,609,104,217,185,392,87,94,22,260,282,208,70,24,102,147,850,12.42
1738,"Raef LaFrentz\lafrera01","1999-00",23,"DEN","NBA",5.9,81,80,2435,392,879,332,696,60,183,162,236,170,471,641,97,42,180,96,292,1006,12.47
1739,"Carl Landry\landrca01","2008-09",25,"HOU","NBA",5.9,69,0,1467,240,418,239,415,1,3,157,193,124,219,343,39,26,31,68,166,638,9.26
1740,"Stephon Marbury\marbust01","2006-07",29,"NYK","NBA",5.9,74,74,2748,395,952,272,607,123,345,297,386,36,177,213,403,71,10,179,185,1210,15.02
1741,"JaVale McGee\mcgeeja01","2018-19",31,"LAL","NBA",5.9,75,62,1671,400,641,399,629,1,12,96,152,195,371,566,52,47,148,108,208,897,13.32
1742,"Aaron McKie\mckieaa01","2000-01",28,"PHI","NBA",5.9,76,33,2394,338,714,285,544,53,170,149,194,33,278,311,377,106,8,203,178,878,13.1
1743,"Andre Miller\millean02","2006-07",30,"TOT","NBA",5.9,80,79,2966,424,909,419,874,5,35,222,283,97,255,352,625,110,10,222,184,1075,15.99
1744,"Greg Monroe\monrogr01","2012-13",22,"DET","NBA",5.9,81,81,2687,514,1058,514,1054,0,4,270,392,236,541,777,281,105,55,234,190,1298,16.85
1745,"Greg Monroe\monrogr01","2013-14",23,"DET","NBA",5.9,82,82,2690,504,1015,504,1014,0,1,241,367,256,504,760,171,91,47,166,205,1249,15.09
1746,"Steve Nash\nashst01","2011-12",37,"PHO","NBA",5.9,62,62,1961,295,555,240,414,55,141,127,142,26,160,186,664,38,8,229,53,772,17.39
1747,"Mehmet Okur\okurme01","2003-04",24,"DET","NBA",5.9,71,33,1580,251,542,233,494,18,48,162,209,160,261,421,69,36,63,101,138,682,9.59
1748,"Greg Ostertag\ostergr01","1996-97",23,"UTA","NBA",5.9,77,70,1818,210,408,210,404,0,4,139,205,180,385,565,27,24,152,74,233,559,9.17
1749,"Tony Parker\parketo01","2013-14",31,"SAS","NBA",5.9,68,68,1997,456,914,431,847,25,67,197,243,17,138,155,388,36,9,151,86,1134,15.21
1750,"Nikola Peković\pekovni01","2013-14",28,"MIN","NBA",5.9,54,54,1663,379,701,379,701,0,0,186,249,206,262,468,50,30,23,84,129,944,15.7
1751,"Morris Peterson\petermo01","2005-06",28,"TOR","NBA",5.9,82,77,3140,478,1096,301,648,177,448,241,294,65,316,381,190,104,15,126,223,1374,14.35
1752,"Dino Rađa\radjadi01","1993-94",26,"BOS","NBA",5.9,80,47,2303,491,942,491,941,0,1,226,301,191,386,577,114,70,67,149,276,1208,14.28
1753,"J.J. Redick\redicjj01","2018-19",34,"PHI","NBA",5.9,76,63,2379,452,1027,212,422,240,605,228,255,20,166,186,206,32,17,101,129,1372,14.28
1754,"Nate Robinson\robinna01","2012-13",28,"CHI","NBA",5.9,82,23,2086,399,921,258,573,141,348,135,169,29,155,184,358,85,10,144,207,1074,12.09
1755,"Nate Robinson\robinna01","2008-09",24,"NYK","NBA",5.9,74,11,2209,449,1028,324,643,125,385,249,296,98,192,290,301,95,6,139,206,1272,15.39
1756,"Ricky Rubio\rubiori01","2013-14",23,"MIN","NBA",5.9,82,82,2638,255,670,211,537,44,133,227,283,61,281,342,704,191,11,221,218,781,14.88
1757,"Damon Stoudamire\stoudda01","2003-04",30,"POR","NBA",5.9,82,82,3118,408,1018,252,591,156,427,127,145,52,256,308,500,99,9,180,173,1099,13.67
1758,"Jeff Teague\teaguje01","2015-16",27,"ATL","NBA",5.9,79,78,2255,434,988,324,713,110,275,261,312,33,181,214,470,97,24,218,167,1239,15.56
1759,"Bonzi Wells\wellsbo01","2000-01",24,"POR","NBA",5.9,75,46,1995,387,726,370,676,17,50,159,240,120,247,367,208,94,20,169,203,950,12.86
1760,"David West\westda01","2011-12",31,"IND","NBA",5.9,66,66,1925,349,716,347,707,2,9,142,176,118,315,433,140,52,46,93,160,842,12.46
1761,"Reggie Williams\willire01","1992-93",28,"DEN","NBA",5.9,79,79,2722,535,1167,502,1045,33,122,238,296,132,296,428,295,126,76,194,284,1341,16.1
1762,"Al-Farouq Aminu\aminual01","2018-19",28,"POR","NBA",5.8,81,81,2292,257,593,161,313,96,280,150,173,112,498,610,104,68,33,72,143,760,10.45
1763,"Deandre Ayton\aytonde01","2018-19",20,"PHO","NBA",5.8,71,70,2183,509,870,509,866,0,4,141,189,223,506,729,125,61,67,126,209,1159,17.2
1764,"Vin Baker\bakervi01","1994-95",23,"MIL","NBA",5.8,82,82,3361,594,1229,587,1205,7,24,256,432,289,557,846,296,86,116,221,277,1451,17.94
1765,"Brent Barry\barrybr01","2000-01",29,"SEA","NBA",5.8,67,20,1778,198,401,89,172,109,229,84,103,33,178,211,225,80,14,86,126,589,10.62
1766,"Tony Battie\battito01","2002-03",26,"BOS","NBA",5.8,67,62,1683,199,369,198,364,1,5,88,118,148,285,433,49,33,81,48,197,487,8.86
1767,"Nicolas Batum\batumni01","2012-13",24,"POR","NBA",5.8,73,73,2807,352,833,187,389,165,444,178,210,97,315,412,360,91,83,190,139,1047,15.86
1768,"Raja Bell\bellra01","2006-07",30,"PHO","NBA",5.8,78,78,2917,410,950,205,454,205,496,118,152,48,203,251,196,50,22,83,233,1143,11.94
1769,"Steve Blake\blakest01","2008-09",28,"POR","NBA",5.8,69,69,2188,277,647,137,319,140,328,63,75,28,145,173,348,69,4,108,126,757,11.52
1770,"Carlos Boozer\boozeca01","2010-11",29,"CHI","NBA",5.8,59,59,1882,431,845,431,845,0,0,171,244,130,435,565,145,45,18,149,186,1033,16.44
1771,"Michael Cage\cagemi01","1994-95",33,"CLE","NBA",5.8,82,21,2040,177,340,177,338,0,2,53,88,203,361,564,56,61,67,56,149,407,7.3
1772,"Marcus Camby\cambyma01","2004-05",30,"DEN","NBA",5.8,66,66,2015,279,600,279,596,0,4,125,173,131,530,661,152,61,199,103,177,683,14.04
1773,"DeMarre Carroll\carrode01","2013-14",27,"ATL","NBA",5.8,73,73,2341,302,642,205,374,97,268,109,141,107,296,403,134,108,21,79,188,810,11.59
1774,"Chris Childs\childch01","1995-96",28,"NJN","NBA",5.8,78,54,2408,324,778,229,519,95,259,259,304,51,194,245,548,111,8,230,246,1002,14.96
1775,"Antonio Daniels\daniean01","2003-04",28,"SEA","NBA",5.8,71,32,1512,187,398,145,282,42,116,155,184,23,119,142,298,45,6,61,64,571,9.44
1776,"Luol Deng\denglu01","2011-12",26,"CHI","NBA",5.8,54,54,2129,311,755,232,540,79,215,127,165,77,273,350,157,56,36,96,81,828,13.7
1777,"Derek Fisher\fishede01","2005-06",31,"GSW","NBA",5.8,82,36,2589,364,887,247,592,117,295,244,293,36,175,211,352,125,8,156,237,1089,12.87
1778,"JaMychal Green\greenja01","2016-17",26,"MEM","NBA",5.8,77,75,2101,250,500,195,355,55,145,134,167,167,377,544,84,47,34,94,248,689,10.04
1779,"Andre Iguodala\iguodan01","2013-14",30,"GSW","NBA",5.8,63,63,2040,220,458,158,283,62,175,86,132,53,240,293,263,95,18,100,103,588,11.84
1780,"Ersan İlyasova\ilyaser01","2009-10",22,"MIL","NBA",5.8,81,31,1898,323,729,242,488,81,241,113,158,157,360,517,84,53,23,71,251,840,9.58
1781,"Antawn Jamison\jamisan01","2009-10",33,"TOT","NBA",5.8,66,64,2406,478,1036,393,789,85,247,194,300,136,419,555,84,71,21,91,179,1235,15.53
1782,"Brandon Jennings\jennibr01","2012-13",23,"MIL","NBA",5.8,80,80,2897,497,1247,324,786,173,461,230,281,59,187,246,521,125,10,203,155,1397,16.22
1783,"Tyler Johnson\johnsty01","2016-17",24,"MIA","NBA",5.8,73,0,2178,357,824,264,574,93,250,195,254,50,243,293,233,84,44,90,176,1002,12.87
1784,"Enes Kanter\kanteen01","2016-17",24,"OKC","NBA",5.8,72,0,1533,402,737,397,699,5,38,224,285,195,287,482,67,32,38,123,154,1033,13.22
1785,"Michael Kidd-Gilchrist\kiddgmi01","2016-17",23,"CHO","NBA",5.8,81,81,2349,295,618,294,609,1,9,152,194,156,409,565,114,81,77,56,187,743,10.52
1786,"Raef LaFrentz\lafrera01","2002-03",26,"DAL","NBA",5.8,69,43,1611,266,514,219,398,47,116,60,88,125,205,330,54,35,91,46,264,639,9.32
1787,"Damian Lillard\lillada01","2012-13",22,"POR","NBA",5.8,82,82,3167,553,1288,368,785,185,503,271,321,42,215,257,531,74,19,243,172,1562,17.36
1788,"Brook Lopez\lopezbr01","2008-09",20,"NJN","NBA",5.8,82,75,2501,448,844,448,842,0,2,172,217,225,440,665,86,44,151,147,257,1068,13.59
1789,"Robin Lopez\lopezro01","2015-16",27,"NYK","NBA",5.8,82,82,2219,357,662,357,661,0,1,128,161,268,334,602,114,16,129,133,182,842,11.4
1790,"George Lynch\lynchge01","1999-00",29,"PHI","NBA",5.8,75,75,2416,297,644,282,608,15,36,113,183,216,366,582,136,119,38,120,231,722,11.14
1791,"George McCloud\mccloge01","1995-96",28,"DAL","NBA",5.8,79,63,2846,530,1281,273,603,257,678,180,224,116,263,379,212,113,38,166,212,1497,15.62
1792,"Tracy McGrady\mcgratr01","2007-08",28,"HOU","NBA",5.8,66,62,2440,548,1307,462,1012,86,295,245,358,42,297,339,387,68,30,160,91,1427,17.9
1793,"Larry Nance\nancela02","2017-18",25,"TOT","NBA",5.8,66,27,1421,240,413,238,401,2,12,91,137,161,291,452,82,88,38,51,172,573,10.82
1794,"Emeka Okafor\okafoem01","2007-08",25,"CHA","NBA",5.8,82,82,2718,460,860,460,860,0,0,213,374,255,621,876,70,62,138,164,241,1133,14.74
1795,"Smush Parker\parkesm01","2005-06",24,"LAL","NBA",5.8,82,82,2773,348,779,228,451,120,328,125,180,37,234,271,302,140,16,147,213,941,12
1796,"Tony Parker\parketo01","2015-16",33,"SAS","NBA",5.8,72,72,1980,350,710,323,645,27,65,130,171,17,159,176,379,54,11,131,114,857,12.24
1797,"Mason Plumlee\plumlma01","2018-19",28,"DEN","NBA",5.8,82,17,1731,262,442,260,432,2,10,111,198,165,359,524,243,66,76,126,252,637,10.93
1798,"Michael Redd\reddmi01","2007-08",28,"MIL","NBA",5.8,72,71,2702,550,1243,420,884,130,359,402,490,85,224,309,247,65,13,181,120,1632,18.3
1799,"Jason Richardson\richaja01","2008-09",28,"TOT","NBA",5.8,72,71,2410,465,974,336,649,129,325,153,199,77,242,319,146,76,28,95,146,1212,14.21
1800,"Quentin Richardson\richaqu01","2004-05",24,"PHO","NBA",5.8,79,78,2839,407,1045,181,414,226,631,136,184,91,388,479,158,96,27,102,197,1176,12.72
1801,"Quentin Richardson\richaqu01","2009-10",29,"MIA","NBA",5.8,76,75,2082,242,561,100,203,142,358,52,71,64,310,374,93,70,18,62,169,678,8.84
1802,"Isaiah Rider\rideris01","1997-98",26,"POR","NBA",5.8,74,66,2786,551,1302,416,882,135,420,221,267,99,247,346,231,55,19,187,188,1458,15.09
1803,"Dennis Rodman\rodmade01","1994-95",33,"SAS","NBA",5.8,49,26,1568,137,240,137,238,0,2,75,111,274,549,823,97,31,23,98,159,349,13.58
1804,"Ricky Rubio\rubiori01","2015-16",25,"MIN","NBA",5.8,76,76,2323,219,586,157,396,62,190,266,314,40,286,326,658,162,10,193,201,766,15.58
1805,"Arvydas Sabonis\sabonar01","1998-99",34,"POR","NBA",5.8,50,48,1349,232,478,225,454,7,24,135,175,88,305,393,119,34,63,85,147,606,13.34
1806,"Detlef Schrempf\schrede01","1998-99",36,"SEA","NBA",5.8,50,39,1765,259,549,225,463,34,86,200,243,77,293,370,184,41,26,103,152,752,15.8
1807,"J.R. Smith\smithjr01","2008-09",23,"DEN","NBA",5.8,81,18,2245,424,950,244,497,180,453,205,272,43,254,297,227,78,14,150,190,1233,13.29
1808,"Josh Smith\smithjo03","2007-08",22,"ATL","NBA",5.8,81,81,2873,518,1133,493,1034,25,99,333,469,161,506,667,272,123,227,245,269,1394,18.43
1809,"Jerry Stackhouse\stackje01","2001-02",27,"DET","NBA",5.8,76,76,2685,524,1319,438,1019,86,300,495,577,77,238,315,403,77,37,266,163,1629,18.34
1810,"John Starks\starkjo01","1996-97",31,"NYK","NBA",5.8,77,1,2042,369,856,219,449,150,407,173,225,36,169,205,217,90,11,158,196,1061,11.95
1811,"John Starks\starkjo01","1993-94",28,"NYK","NBA",5.8,59,54,2057,410,977,297,640,113,337,187,248,37,148,185,348,95,6,184,191,1120,16.82
1812,"Clarence Weatherspoon\weathcl01","1995-96",25,"PHI","NBA",5.8,78,75,3096,491,1015,491,1013,0,2,318,426,237,516,753,158,112,108,179,214,1300,17.21
1813,"David Wesley\wesleda01","1997-98",27,"CHH","NBA",5.8,81,81,2845,383,864,324,694,59,170,229,288,49,164,213,529,140,30,226,229,1054,14.76
1814,"Reggie Williams\willire01","1994-95",30,"DEN","NBA",5.8,74,70,2198,388,846,303,580,85,266,132,174,94,235,329,231,114,67,124,264,993,13.42
1815,"Dorell Wright\wrighdo01","2010-11",25,"GSW","NBA",5.8,82,82,3147,485,1146,291,630,194,516,180,228,88,343,431,242,124,63,133,171,1344,14.96
1816,"Brent Barry\barrybr01","2003-04",32,"SEA","NBA",5.7,59,53,1803,215,427,101,175,114,252,91,110,21,183,204,342,85,16,139,121,635,14.1
1817,"Carlos Boozer\boozeca01","2012-13",31,"CHI","NBA",5.7,79,79,2546,544,1140,544,1138,0,2,193,264,175,596,771,179,66,28,176,239,1281,15.08
1818,"Josh Childress\childjo01","2005-06",22,"ATL","NBA",5.7,74,10,2249,278,504,246,439,32,65,154,201,134,253,387,131,86,39,101,184,742,11.37
1819,"Doug Christie\chrisdo01","2003-04",33,"SAC","NBA",5.7,82,82,2780,317,688,268,546,49,142,148,172,69,260,329,347,151,41,155,186,831,12.45
1820,"Bimbo Coles\colesbi01","1992-93",24,"MIA","NBA",5.7,81,37,2232,318,686,276,549,42,137,177,220,58,108,166,373,80,11,108,199,855,11.11
1821,"DeMarcus Cousins\couside01","2015-16",25,"SAC","NBA",5.7,65,65,2246,601,1332,531,1122,70,210,476,663,158,589,747,214,101,92,249,236,1748,24.54
1822,"Ed Davis\davised01","2018-19",29,"BRK","NBA",5.7,81,1,1446,186,302,186,300,0,2,100,162,216,478,694,61,35,33,64,226,472,8.5
1823,"Ricky Davis\davisri01","2006-07",27,"MIN","NBA",5.7,81,81,3021,506,1089,383,779,123,310,239,285,54,261,315,385,80,23,210,189,1374,15.89
1824,"Vinny Del Negro\delnevi01","1993-94",27,"SAS","NBA",5.7,77,56,1949,309,634,294,591,15,43,140,170,27,134,161,320,64,1,102,168,773,10.31
1825,"Gorgui Dieng\dienggo01","2016-17",27,"MIN","NBA",5.7,82,82,2653,332,661,316,618,16,43,136,167,188,459,647,158,88,95,107,254,816,12.17
1826,"Spencer Dinwiddie\dinwisp01","2017-18",24,"BRK","NBA",5.7,80,58,2306,324,838,183,405,141,433,218,268,40,219,259,524,68,23,128,186,1007,13.56
1827,"Goran Dragić\dragigo01","2012-13",26,"PHO","NBA",5.7,77,77,2581,401,906,313,630,88,276,244,326,60,178,238,569,124,26,212,214,1134,16.4
1828,"Blue Edwards\edwarbl01","1992-93",27,"MIL","NBA",5.7,82,81,2729,554,1083,517,977,37,106,237,300,123,259,382,214,129,45,175,242,1382,15.65
1829,"Derek Fisher\fishede01","2007-08",33,"LAL","NBA",5.7,82,82,2249,339,777,227,501,112,276,166,188,24,146,170,239,86,3,90,188,956,10.52
1830,"Jeff Foster\fosteje01","2005-06",29,"IND","NBA",5.7,63,37,1581,138,250,138,246,0,4,96,159,224,350,574,50,41,27,64,191,372,8.75
1831,"Evan Fournier\fournev01","2015-16",23,"ORL","NBA",5.7,79,71,2566,429,929,273,539,156,390,199,238,33,192,225,213,96,2,133,214,1213,13.36
1832,"Taj Gibson\gibsota01","2013-14",28,"CHI","NBA",5.7,82,8,2351,429,896,429,889,0,7,211,281,200,358,558,91,41,112,150,207,1069,12.09
1833,"Manu Ginóbili\ginobma01","2013-14",36,"SAS","NBA",5.7,68,3,1550,294,627,204,369,90,258,160,188,30,172,202,293,70,17,139,128,838,12.84
1834,"Ron Harper\harpero01","1996-97",33,"CHI","NBA",5.7,76,74,1740,177,406,109,218,68,188,58,82,46,147,193,191,86,38,50,138,480,7.64
1835,"Udonis Haslem\hasleud01","2008-09",28,"MIA","NBA",5.7,75,75,2560,333,643,333,643,0,0,128,170,169,449,618,85,43,25,82,204,794,11.03
1836,"Luther Head\headlu01","2006-07",24,"HOU","NBA",5.7,80,10,2211,306,700,129,299,177,401,83,105,31,221,252,194,76,5,137,133,872,10.15
1837,"Tyrone Hill\hillty01","1999-00",31,"PHI","NBA",5.7,68,65,2155,318,656,318,655,0,1,179,259,220,405,625,52,64,27,124,243,815,12.06
1838,"Tyrone Hill\hillty01","1993-94",25,"CLE","NBA",5.7,57,20,1447,216,398,216,396,0,2,171,256,184,315,499,46,53,35,78,193,603,12.04
1839,"Jrue Holiday\holidjr01","2010-11",20,"PHI","NBA",5.7,82,82,2901,446,999,365,777,81,222,172,209,68,264,332,531,120,29,218,203,1145,15.29
1840,"Robert Horry\horryro01","1999-00",29,"LAL","NBA",5.7,76,0,1685,159,363,130,269,29,94,89,113,133,228,361,118,84,80,73,189,436,7.93
1841,"David Lee\leeda02","2016-17",33,"SAS","NBA",5.7,79,10,1477,248,420,248,420,0,0,80,113,149,292,441,124,31,40,82,125,576,8.74
1842,"Jamaal Magloire\magloja01","2001-02",23,"CHH","NBA",5.7,82,8,1549,228,414,228,413,0,1,243,333,153,308,461,31,27,86,118,201,699,9.24
1843,"Desmond Mason\masonde01","2003-04",26,"MIL","NBA",5.7,82,31,2534,409,867,400,828,9,39,356,463,93,266,359,152,60,24,148,191,1183,12.48
1844,"Antonio McDyess\mcdyean01","2004-05",30,"DET","NBA",5.7,77,8,1797,307,598,307,597,0,1,126,192,177,305,482,71,46,52,93,204,740,9.65
1845,"Derrick McKey\mckeyde01","1995-96",29,"IND","NBA",5.7,75,75,2440,346,712,329,644,17,68,170,221,123,238,361,262,83,44,143,246,879,12.54
1846,"Nikola Mirotić\mirotni01","2014-15",23,"CHI","NBA",5.7,82,3,1654,253,624,154,311,99,313,228,284,63,341,404,97,54,54,89,172,833,9.71
1847,"Cuttino Mobley\moblecu01","2001-02",26,"HOU","NBA",5.7,74,74,3116,595,1358,446,981,149,377,267,314,63,237,300,187,109,37,180,189,1606,17.03
1848,"Jamario Moon\moonja01","2007-08",27,"TOR","NBA",5.7,78,75,2166,279,575,239,453,40,122,63,85,92,392,484,90,80,108,51,152,661,9.92
1849,"Mikki Moore\mooremi01","2006-07",31,"NJN","NBA",5.7,79,55,2082,308,506,308,505,0,1,160,235,145,258,403,74,46,60,113,261,776,10.33
1850,"Anthony Morrow\morroan01","2014-15",29,"OKC","NBA",5.7,74,0,1806,285,615,144,290,141,325,79,89,40,155,195,60,54,11,38,135,790,8.8
1851,"Timofey Mozgov\mozgoti01","2014-15",28,"TOT","NBA",5.7,81,80,2045,314,566,312,560,2,6,155,216,203,388,591,55,33,97,116,227,785,10.69
1852,"Billy Owens\owensbi01","1993-94",24,"GSW","NBA",5.7,79,72,2738,492,971,489,956,3,15,199,326,230,410,640,326,83,60,214,269,1186,15.97
1853,"Zach Randolph\randoza01","2006-07",25,"POR","NBA",5.7,68,67,2425,600,1286,586,1238,14,48,394,481,199,489,688,147,53,15,215,184,1608,19.92
1854,"Glen Rice\ricegl01","2000-01",33,"NYK","NBA",5.7,75,25,2212,331,752,249,541,82,211,155,182,61,246,307,89,41,13,96,179,899,9.73
1855,"Jason Richardson\richaja01","2004-05",24,"GSW","NBA",5.7,72,72,2724,610,1368,485,998,125,370,214,309,125,299,424,281,105,32,169,156,1559,18.07
1856,"Jalen Rose\roseja01","2001-02",29,"TOT","NBA",5.7,83,83,3153,663,1458,574,1212,89,246,281,335,43,330,373,355,78,45,201,251,1696,17.18
1857,"Latrell Sprewell\sprewla01","2003-04",33,"MIN","NBA",5.7,82,82,3100,518,1266,419,967,99,299,240,295,56,254,310,286,88,21,158,101,1375,13.43
1858,"John Starks\starkjo01","1995-96",30,"NYK","NBA",5.7,81,71,2491,375,846,232,450,143,396,131,174,31,206,237,315,103,11,156,226,1024,12.23
1859,"Damon Stoudamire\stoudda01","2004-05",31,"POR","NBA",5.7,81,70,2762,457,1165,276,675,181,490,182,199,56,254,310,458,86,2,164,158,1277,14.44
1860,"Tristan Thompson\thomptr01","2013-14",22,"CLE","NBA",5.7,82,82,2594,363,761,363,760,0,1,235,339,269,485,754,72,42,35,108,188,961,11.59
1861,"Nick Van Exel\vanexni01","1995-96",24,"LAL","NBA",5.7,74,74,2513,396,950,252,547,144,403,163,204,29,152,181,509,70,10,156,115,1099,14.62
1862,"Nikola Vučević\vucevni01","2012-13",22,"ORL","NBA",5.7,77,77,2559,461,889,461,886,0,3,86,126,273,644,917,143,61,79,141,218,1008,14.77
1863,"John Wall\walljo01","2015-16",25,"WAS","NBA",5.7,77,77,2784,572,1349,457,1021,115,328,272,344,42,337,379,789,145,59,318,159,1531,21.78
1864,"Delonte West\westde01","2005-06",22,"BOS","NBA",5.7,71,71,2418,333,684,249,466,84,218,86,101,57,232,289,329,84,46,133,197,836,13.33
1865,"Marvin Williams\willima02","2009-10",23,"ATL","NBA",5.7,81,81,2468,302,664,262,532,40,132,176,215,106,310,416,93,66,46,72,160,820,9.75
1866,"Marvin Williams\willima02","2007-08",21,"ATL","NBA",5.7,80,80,2765,424,918,423,908,1,10,336,409,119,338,457,137,81,33,127,225,1185,13.32
1867,"Willie Anderson\anderwi01","1993-94",27,"SAS","NBA",5.6,80,79,2488,394,837,372,769,22,68,145,171,68,174,242,347,71,46,153,187,955,11.99
1868,"Stacey Augmon\augmost01","1995-96",27,"ATL","NBA",5.6,77,49,2294,362,738,361,734,1,4,251,317,137,167,304,137,106,31,138,188,976,11.99
1869,"Dana Barros\barroda01","1997-98",30,"BOS","NBA",5.6,80,15,1686,281,609,181,363,100,246,122,144,28,125,153,286,83,6,107,124,784,10.12
1870,"Dana Barros\barroda01","1995-96",28,"BOS","NBA",5.6,80,25,2328,379,806,229,438,150,368,130,147,21,171,192,306,58,3,120,116,1038,12.12
1871,"Jon Barry\barryjo01","2002-03",33,"DET","NBA",5.6,80,0,1473,191,424,104,210,87,214,86,100,33,147,180,206,63,14,81,104,555,7.72
1872,"Mike Bibby\bibbymi01","1999-00",21,"VAN","NBA",5.6,82,82,3155,459,1031,382,819,77,212,195,250,73,233,306,665,132,15,247,171,1190,16.59
1873,"Mike Bibby\bibbymi01","2002-03",24,"SAC","NBA",5.6,55,55,1835,329,700,273,563,56,137,161,187,34,113,147,285,72,8,127,93,875,15.31
1874,"Mookie Blaylock\blaylmo01","1997-98",30,"ATL","NBA",5.6,70,69,2700,368,938,278,604,90,334,95,134,81,260,341,469,183,21,176,122,921,15.12
1875,"Eric Bledsoe\bledser01","2017-18",28,"TOT","NBA",5.6,74,74,2322,468,989,343,629,125,360,252,317,51,233,284,370,149,42,216,185,1313,18.01
1876,"Terrell Brandon\brandte01","1994-95",24,"CLE","NBA",5.6,67,41,1961,341,762,293,641,48,121,159,186,35,151,186,363,107,14,144,118,889,13.83
1877,"Thomas Bryant\bryanth01","2018-19",21,"WAS","NBA",5.6,72,53,1496,309,502,276,403,33,99,107,137,113,341,454,92,25,67,60,126,758,11.61
1878,"Scott Burrell\burresc01","1994-95",24,"CHH","NBA",5.6,65,62,2014,277,593,181,358,96,235,100,144,96,272,368,161,75,40,85,187,750,12.17
1879,"Darren Collison\collida01","2012-13",25,"DAL","NBA",5.6,81,47,2372,341,724,293,588,48,136,242,275,31,188,219,415,100,8,173,139,972,13.24
1880,"Hubert Davis\davishu01","1995-96",25,"NYK","NBA",5.6,74,14,1773,275,566,148,299,127,267,112,129,35,88,123,103,31,8,63,120,789,8.84
1881,"Vlade Divac\divacvl01","1992-93",24,"LAL","NBA",5.6,82,69,2525,397,819,376,744,21,75,235,341,220,509,729,232,128,140,214,311,1050,15.53
1882,"Jared Dudley\dudleja01","2010-11",25,"PHO","NBA",5.6,82,15,2140,300,629,195,376,105,253,162,218,111,207,318,108,87,20,77,139,867,10.1
1883,"Kenneth Faried\farieke01","2014-15",25,"DEN","NBA",5.6,75,71,2086,373,736,372,728,1,8,199,288,242,426,668,89,62,57,118,211,946,13.01
1884,"Danny Ferry\ferryda01","1996-97",30,"CLE","NBA",5.6,82,48,2633,341,794,227,510,114,284,74,87,82,255,337,151,56,32,94,245,870,9.32
1885,"De'Aaron Fox\foxde01","2018-19",21,"SAC","NBA",5.6,81,81,2546,505,1102,419,870,86,232,303,417,43,261,304,590,133,45,227,204,1399,18.31
1886,"Danilo Gallinari\gallida01","2009-10",21,"NYK","NBA",5.6,81,74,2747,392,927,206,439,186,488,251,307,65,333,398,135,75,58,110,191,1221,13.28
1887,"Kevin Garnett\garneke01","2012-13",36,"BOS","NBA",5.6,68,68,2022,422,850,420,834,2,16,158,201,75,455,530,159,78,62,110,154,1004,14.78
1888,"Marc Gasol\gasolma01","2013-14",29,"MEM","NBA",5.6,59,59,1970,336,711,334,700,2,11,185,241,84,340,424,215,59,76,111,150,859,15.35
1889,"Horace Grant\grantho01","2001-02",36,"ORL","NBA",5.6,76,76,2210,264,515,264,515,0,0,80,111,159,322,481,104,57,49,51,118,608,9.17
1890,"Devin Harris\harride01","2007-08",24,"TOT","NBA",5.6,64,61,2022,321,693,265,526,56,167,248,301,28,145,173,369,90,10,161,190,946,15.51
1891,"Juwan Howard\howarju01","1995-96",22,"WSB","NBA",5.6,81,81,3294,733,1500,729,1487,4,13,319,426,188,472,660,360,67,39,303,269,1789,19.75
1892,"Lindsey Hunter\hunteli01","1999-00",29,"DET","NBA",5.6,82,82,2919,379,892,211,503,168,389,117,154,35,215,250,327,129,22,145,216,1043,12.55
1893,"Serge Ibaka\ibakase01","2014-15",25,"OKC","NBA",5.6,64,64,2116,374,786,297,581,77,205,92,110,135,364,499,55,30,155,97,194,917,13.84
1894,"Andre Iguodala\iguodan01","2012-13",29,"DEN","NBA",5.6,80,80,2779,396,879,305,592,91,287,155,270,82,341,423,433,139,52,206,127,1038,14.79
1895,"Zydrunas Ilgauskas\ilgauzy01","2008-09",33,"CLE","NBA",5.6,65,65,1765,342,724,327,685,15,39,139,174,157,333,490,64,28,84,90,183,838,12.02
1896,"Jarrett Jack\jackja01","2012-13",29,"GSW","NBA",5.6,79,4,2349,387,857,305,654,82,203,167,198,21,222,243,439,60,11,157,134,1023,13.14
1897,"Amir Johnson\johnsam01","2010-11",23,"TOR","NBA",5.6,72,54,1853,281,495,281,494,0,1,126,160,189,272,461,81,53,88,69,263,688,11.06
1898,"DeAndre Jordan\jordade01","2011-12",23,"LAC","NBA",5.6,66,66,1798,206,326,206,325,0,1,74,141,202,344,546,17,30,134,74,189,486,10.11
1899,"Robin Lopez\lopezro01","2012-13",24,"NOH","NBA",5.6,82,82,2136,384,719,384,719,0,0,161,207,226,236,462,64,32,128,110,167,929,11.12
1900,"Kyle Lowry\lowryky01","2012-13",26,"TOR","NBA",5.6,68,52,2020,250,623,149,344,101,279,190,239,56,265,321,435,94,24,157,218,791,14.4
1901,"Todd MacCulloch\maccuto01","2001-02",26,"NJN","NBA",5.6,62,61,1502,247,465,247,465,0,0,110,164,157,221,378,78,24,89,66,181,604,10.45
1902,"Don MacLean\macledo01","1993-94",24,"WSB","NBA",5.6,75,69,2487,517,1030,514,1009,3,21,328,398,140,327,467,160,47,22,152,169,1365,15.79
1903,"Shawn Marion\mariosh01","2010-11",32,"DAL","NBA",5.6,80,27,2253,434,834,429,801,5,33,126,164,168,383,551,110,68,50,130,144,999,12.17
1904,"O.J. Mayo\mayooj01","2009-10",22,"MEM","NBA",5.6,82,82,3113,542,1183,406,828,136,355,212,262,61,250,311,242,98,17,176,174,1432,14.69
1905,"CJ McCollum\mccolcj01","2018-19",27,"POR","NBA",5.6,70,70,2375,571,1243,404,798,167,445,159,192,62,220,282,207,55,28,106,172,1468,16.36
1906,"Antonio McDyess\mcdyean01","2008-09",34,"DET","NBA",5.6,62,30,1866,268,525,268,525,0,0,60,86,185,422,607,83,41,50,51,191,596,11.33
1907,"Nate McMillan\mcmilna01","1992-93",28,"SEA","NBA",5.6,73,25,1977,213,459,188,394,25,65,95,134,84,222,306,384,173,33,139,240,546,12.08
1908,"Patty Mills\millspa02","2013-14",25,"SAS","NBA",5.6,81,2,1527,309,666,174,348,135,318,73,82,34,135,169,149,68,9,63,114,826,8.96
1909,"Greg Monroe\monrogr01","2016-17",26,"MIL","NBA",5.6,81,0,1823,387,726,387,722,0,4,177,239,167,365,532,187,92,38,140,168,951,12.78
1910,"Jameer Nelson\nelsoja01","2007-08",25,"ORL","NBA",5.6,69,62,1961,283,603,219,449,64,154,125,151,28,215,243,383,63,4,141,167,755,12.56
1911,"Joakim Noah\noahjo01","2014-15",29,"CHI","NBA",5.6,67,67,2049,190,427,190,425,0,2,105,174,219,427,646,312,48,74,123,203,485,12.11
1912,"Jermaine O'Neal\onealje01","2009-10",31,"MIA","NBA",5.6,70,70,1991,394,745,394,743,0,2,162,225,124,362,486,92,25,95,125,212,950,13.02
1913,"Charles Oakley\oaklech01","1995-96",32,"NYK","NBA",5.6,53,51,1775,211,448,204,422,7,26,175,210,162,298,460,137,58,14,104,195,604,13.37
1914,"Mehmet Okur\okurme01","2009-10",30,"UTA","NBA",5.6,73,73,2149,355,775,273,562,82,213,196,239,132,383,515,119,38,81,127,223,988,13.07
1915,"Ruben Patterson\patteru01","2001-02",26,"POR","NBA",5.6,75,13,1765,319,619,310,583,9,36,192,274,155,143,298,107,79,37,114,140,839,10.66
1916,"Kendrick Perkins\perkike01","2008-09",24,"BOS","NBA",5.6,76,76,2253,276,478,276,476,0,2,96,160,204,415,619,96,22,150,165,253,648,11.05
1917,"Jakob Pöltl\poeltja01","2017-18",22,"TOR","NBA",5.6,82,0,1524,253,384,252,382,1,2,60,101,165,228,393,57,39,100,85,212,567,8.4
1918,"Otto Porter\porteot01","2015-16",22,"WAS","NBA",5.6,75,73,2276,339,717,241,450,98,267,95,126,97,294,391,120,105,32,70,163,871,11.47
1919,"Terry Porter\portete01","1999-00",36,"SAS","NBA",5.6,68,8,1613,207,463,117,256,90,207,137,170,24,167,191,221,50,9,100,79,641,9.91
1920,"Theo Ratliff\ratlith01","1999-00",26,"PHI","NBA",5.6,57,56,1795,247,491,247,491,0,0,182,236,140,295,435,36,32,171,108,185,676,13.34
1921,"Josh Richardson\richajo01","2018-19",25,"MIA","NBA",5.6,73,73,2539,423,1026,259,566,164,460,199,231,54,209,263,298,79,34,113,200,1209,14.57
1922,"Quentin Richardson\richaqu01","2001-02",21,"LAC","NBA",5.6,81,0,2152,400,926,267,577,133,349,143,187,113,221,334,128,78,21,102,142,1076,10.94
1923,"Terry Rozier\roziete01","2017-18",23,"BOS","NBA",5.6,80,16,2068,316,800,163,398,153,402,115,149,63,313,376,232,80,19,80,123,900,10.74
1924,"Bryon Russell\russebr01","1998-99",28,"UTA","NBA",5.6,50,50,1770,217,468,165,321,52,147,136,171,65,201,266,74,76,15,76,154,622,12.24
1925,"John Salmons\salmojo01","2008-09",29,"TOT","NBA",5.6,79,74,2959,516,1093,390,791,126,302,288,347,59,274,333,249,83,24,165,182,1446,16.09
1926,"Ramon Sessions\sessira01","2008-09",22,"MIL","NBA",5.6,79,39,2173,345,775,339,741,6,34,281,354,64,205,269,452,83,7,152,158,977,13.36
1927,"Bryant Stith\stithbr01","1994-95",24,"DEN","NBA",5.6,81,51,2329,312,661,292,593,20,68,267,324,95,173,268,153,91,18,110,142,911,10.72
1928,"Otis Thorpe\thorpot01","1994-95",32,"TOT","NBA",5.6,70,35,2096,385,681,385,674,0,7,167,281,202,356,558,112,41,28,132,224,937,13.3
1929,"Ben Wallace\wallabe01","1999-00",25,"ORL","NBA",5.6,81,81,1959,168,334,168,334,0,0,54,114,211,454,665,67,72,130,67,162,390,8.34
1930,"Micheal Williams\willimi02","1993-94",27,"MIN","NBA",5.6,71,66,2206,314,687,304,642,10,45,333,397,67,154,221,512,118,24,203,193,971,16.5
1931,"Cody Zeller\zelleco01","2016-17",24,"CHO","NBA",5.6,62,58,1725,253,443,253,442,0,1,133,196,135,270,405,99,62,58,65,189,639,11.92
1932,"Mahmoud Abdul-Rauf\abdulma02","1995-96",26,"DEN","NBA",5.5,57,53,2029,414,955,293,646,121,309,146,157,26,112,138,389,64,3,115,117,1095,17.22
1933,"Rafer Alston\alstora01","2004-05",28,"TOR","NBA",5.5,80,78,2717,403,974,264,585,139,389,191,258,42,237,279,514,118,7,170,212,1136,14.79
1934,"Greg Anthony\anthogr01","1993-94",26,"NYK","NBA",5.5,80,36,1994,225,571,177,411,48,160,130,168,43,146,189,365,114,13,127,163,628,9.47
1935,"Ömer Aşık\asikom01","2012-13",26,"HOU","NBA",5.5,82,82,2464,332,614,332,613,0,1,168,299,275,681,956,75,46,87,173,223,832,12.49
1936,"Leandro Barbosa\barbole01","2007-08",25,"PHO","NBA",5.5,82,12,2421,472,1021,308,599,164,422,175,213,40,191,231,216,75,18,117,195,1283,13.09
1937,"Andrew Bogut\bogutan01","2005-06",21,"MIL","NBA",5.5,82,77,2348,323,606,323,603,0,3,122,194,189,384,573,192,49,68,125,259,768,11.03
1938,"Aaron Brooks\brookaa01","2009-10",25,"HOU","NBA",5.5,82,82,2919,575,1331,366,806,209,525,245,298,54,161,215,434,69,14,232,199,1604,16.46
1939,"Andrew Bynum\bynuman01","2008-09",21,"LAL","NBA",5.5,50,50,1446,281,502,281,502,0,0,152,215,137,261,398,71,18,90,85,157,714,14.79
1940,"Marcus Camby\cambyma01","2005-06",31,"DEN","NBA",5.5,56,54,1857,302,649,301,638,1,11,111,156,132,536,668,115,79,184,92,158,716,16.43
1941,"Elden Campbell\campbel01","1999-00",31,"CHH","NBA",5.5,78,77,2538,370,829,370,823,0,6,247,358,168,422,590,129,56,150,127,269,987,12.79
1942,"Antoine Carr\carran01","1992-93",31,"SAS","NBA",5.5,71,46,1947,379,705,379,700,0,5,174,224,107,281,388,97,35,87,96,264,932,12.52
1943,"Cedric Ceballos\cebalce01","1993-94",24,"PHO","NBA",5.5,53,43,1602,425,795,425,786,0,9,160,221,153,191,344,91,59,23,93,124,1010,16.52
1944,"Josh Childress\childjo01","2006-07",23,"ATL","NBA",5.5,55,13,2024,261,518,235,441,26,77,167,210,123,217,340,127,58,36,80,118,715,13.59
1945,"Tyrone Corbin\corbity01","1997-98",35,"ATL","NBA",5.5,79,79,2699,328,747,279,606,49,141,101,128,78,284,362,173,105,7,86,197,806,9.86
1946,"Michael Dickerson\dickemi01","1999-00",24,"VAN","NBA",5.5,82,82,3103,554,1270,435,979,119,291,269,324,78,201,279,208,116,45,165,226,1496,14.77
1947,"Kenneth Faried\farieke01","2015-16",26,"DEN","NBA",5.5,67,64,1694,349,626,348,624,1,2,136,222,235,346,581,79,32,60,91,169,835,12.89
1948,"Danny Ferry\ferryda01","1995-96",29,"CLE","NBA",5.5,82,79,2680,422,919,279,556,143,363,103,134,71,238,309,191,57,37,122,233,1090,11.5
1949,"Michael Finley\finlemi01","2004-05",31,"DAL","NBA",5.5,64,64,2358,387,907,271,622,116,285,113,136,45,217,262,169,48,18,60,123,1003,12.46
1950,"Derek Fisher\fishede01","2001-02",27,"LAL","NBA",5.5,70,35,1974,274,666,130,317,144,349,94,111,15,131,146,181,66,9,62,121,786,9.71
1951,"Rudy Gay\gayru01","2010-11",24,"MEM","NBA",5.5,54,54,2152,409,869,352,725,57,144,194,241,82,254,336,153,91,58,135,131,1069,18.12
1952,"Matt Harpring\harprma01","2004-05",28,"UTA","NBA",5.5,78,55,2584,418,855,409,812,9,43,245,315,196,284,480,142,70,16,133,250,1090,12.86
1953,"Montrezl Harrell\harremo01","2017-18",24,"LAC","NBA",5.5,76,3,1293,348,548,347,541,1,7,139,222,103,203,306,74,36,52,68,143,836,10.59
1954,"Gary Harris\harriga01","2017-18",23,"DEN","NBA",5.5,67,65,2304,440,908,284,514,156,394,134,162,37,139,176,194,122,15,119,119,1170,15.49
1955,"Joe Harris\harrijo01","2018-19",27,"BRK","NBA",5.5,76,76,2293,374,748,191,362,183,386,110,133,52,239,291,181,38,17,121,182,1041,12.51
1956,"Grant Hill\hillgr01","2009-10",37,"PHO","NBA",5.5,81,81,2430,336,703,301,623,35,80,205,251,74,371,445,193,60,36,108,165,912,11.53
1957,"Tyrone Hill\hillty01","2000-01",32,"PHI","NBA",5.5,76,75,2363,278,587,278,586,0,1,172,273,239,448,687,48,37,27,127,242,728,9.9
1958,"Al Horford\horfoal01","2007-08",21,"ATL","NBA",5.5,81,77,2540,333,668,333,663,0,5,155,212,248,537,785,124,60,76,137,267,821,12.07
1959,"Serge Ibaka\ibakase01","2015-16",26,"OKC","NBA",5.5,78,78,2500,416,869,356,685,60,184,91,121,141,392,533,66,38,148,108,211,983,11.92
1960,"Bobby Jackson\jacksbo01","2002-03",29,"SAC","NBA",5.5,59,26,1676,340,732,251,497,89,235,126,149,57,162,219,182,71,3,106,126,895,13.52
1961,"Brandon Jennings\jennibr01","2011-12",22,"MIL","NBA",5.5,66,66,2331,469,1121,340,733,129,388,193,239,49,177,226,365,104,22,146,114,1260,16.82
1962,"Andrei Kirilenko\kirilan01","2004-05",23,"UTA","NBA",5.5,41,37,1349,207,420,184,343,23,77,203,259,89,166,255,132,67,136,90,101,640,18.61
1963,"Kawhi Leonard\leonaka01","2011-12",20,"SAS","NBA",5.5,64,39,1534,199,404,158,295,41,109,68,88,104,223,327,70,85,24,44,88,507,9.02
1964,"Dan Majerle\majerda01","1995-96",30,"CLE","NBA",5.5,82,15,2367,303,748,157,334,146,414,120,169,70,235,305,214,81,34,93,131,872,10.08
1965,"Kevin Martin\martike02","2005-06",22,"SAC","NBA",5.5,72,41,1913,262,546,196,367,66,179,188,222,58,203,261,97,55,9,81,138,778,10.01
1966,"Jamal Murray\murraja01","2017-18",20,"DEN","NBA",5.5,81,80,2565,479,1062,314,626,165,436,229,253,82,215,297,274,79,28,172,173,1352,14.81
1967,"Emeka Okafor\okafoem01","2009-10",27,"NOH","NBA",5.5,82,82,2370,348,656,348,656,0,0,154,274,251,491,742,55,54,127,111,218,850,11.71
1968,"Kelly Olynyk\olynyke01","2017-18",26,"MIA","NBA",5.5,76,22,1779,316,636,210,356,106,280,134,174,89,342,431,207,62,35,147,222,872,12.38
1969,"Chandler Parsons\parsoch01","2014-15",26,"DAL","NBA",5.5,66,66,2186,383,829,251,482,132,347,139,193,64,259,323,161,69,19,96,140,1037,13.83
1970,"Ruben Patterson\patteru01","2000-01",25,"SEA","NBA",5.5,76,22,2059,370,749,368,713,2,36,246,361,183,199,382,161,103,45,155,176,988,12.71
1971,"Chuck Person\persoch01","1995-96",31,"SAS","NBA",5.5,80,16,2131,308,705,118,242,190,463,67,104,76,337,413,100,49,26,91,197,873,9.88
1972,"Eric Piatkowski\piatker01","2000-01",30,"LAC","NBA",5.5,81,40,2144,291,672,171,375,120,297,158,181,54,187,241,96,46,19,76,123,860,8.89
1973,"Paul Pierce\piercpa01","2014-15",37,"WAS","NBA",5.5,73,73,1914,293,656,175,353,118,303,164,210,45,249,294,144,46,24,92,160,868,10.81
1974,"Dennis Rodman\rodmade01","1992-93",31,"DET","NBA",5.5,62,55,2410,183,429,168,356,15,73,87,163,367,765,1132,102,48,45,103,201,468,13.13
1975,"Luis Scola\scolalu01","2010-11",30,"HOU","NBA",5.5,74,74,2412,569,1129,569,1126,0,3,214,290,147,459,606,185,48,44,147,227,1352,16.35
1976,"Malik Sealy\sealyma01","1999-00",29,"MIN","NBA",5.5,82,61,2392,371,780,361,745,10,35,177,218,119,233,352,197,76,19,110,197,929,10.77
1977,"J.R. Smith\smithjr01","2015-16",30,"CLE","NBA",5.5,77,77,2362,353,850,149,340,204,510,45,71,43,174,217,130,81,21,59,204,955,9.93
1978,"Joe Smith\smithjo02","2004-05",29,"MIL","NBA",5.5,74,73,2265,319,621,319,620,0,1,175,228,179,362,541,67,43,38,79,222,813,11.05
1979,"Eric Snow\snower01","2003-04",30,"PHI","NBA",5.5,82,82,2966,295,715,293,697,2,18,252,316,62,219,281,563,97,6,187,213,844,12.73
1980,"Eric Snow\snower01","2001-02",28,"PHI","NBA",5.5,61,61,2225,276,624,273,597,3,27,183,227,33,182,215,400,95,9,138,167,738,14.12
1981,"Latrell Sprewell\sprewla01","1995-96",25,"GSW","NBA",5.5,78,78,3064,515,1202,424,920,91,282,352,446,124,256,380,328,127,45,222,150,1473,17.18
1982,"Lance Stephenson\stephla01","2012-13",22,"IND","NBA",5.5,78,72,2278,275,598,213,410,62,188,75,115,47,257,304,223,81,16,109,162,687,9.39
1983,"Kenny Thomas\thomake01","2005-06",28,"SAC","NBA",5.5,82,55,2293,305,604,305,603,0,1,138,204,199,419,618,168,72,39,135,196,748,10.79
1984,"Tim Thomas\thomati01","2000-01",23,"MIL","NBA",5.5,76,16,2086,326,758,219,498,107,260,195,253,79,234,313,138,78,45,114,194,954,11.34
1985,"Gary Trent\trentga01","1996-97",22,"POR","NBA",5.5,82,28,1918,361,674,361,663,0,11,160,229,156,272,428,87,48,35,129,186,882,10.14
1986,"Beno Udrih\udrihbe01","2009-10",27,"SAC","NBA",5.5,79,41,2477,415,841,340,642,75,199,118,141,38,181,219,372,89,10,136,166,1023,13.1
1987,"Keith Van Horn\vanhoke01","1999-00",24,"NJN","NBA",5.5,80,80,2782,559,1257,475,1029,84,228,333,393,200,476,676,158,64,60,245,258,1535,16.77
1988,"Loy Vaught\vaughlo01","1994-95",26,"LAC","NBA",5.5,80,79,2966,609,1185,602,1152,7,33,176,248,261,511,772,139,104,29,166,243,1401,16.46
1989,"Loy Vaught\vaughlo01","1993-94",25,"LAC","NBA",5.5,75,56,2118,373,695,373,690,0,5,131,182,218,438,656,74,76,22,96,221,877,12.33
1990,"Dwyane Wade\wadedw01","2013-14",32,"MIA","NBA",5.5,54,53,1775,415,761,406,729,9,32,189,258,60,181,241,252,79,29,161,106,1028,18.63
1991,"Charlie Ward\wardch01","1999-00",29,"NYK","NBA",5.5,72,69,1986,189,447,87,183,102,264,48,58,22,206,228,300,95,16,102,176,528,9.64
1992,"Clarence Weatherspoon\weathcl01","2002-03",32,"NYK","NBA",5.5,79,19,2024,186,414,186,414,0,0,149,194,214,385,599,68,69,36,63,174,521,8.47
1993,"Alvin Williams\willial02","2002-03",28,"TOR","NBA",5.5,78,78,2638,396,905,348,759,48,146,187,239,55,190,245,416,111,21,128,170,1027,13.41
1994,"Metta World Peace\artesro01","2008-09",29,"HOU","NBA",5.5,69,55,2452,416,1037,263,654,153,383,196,262,65,294,359,229,105,24,140,155,1181,14.79
1995,"Thaddeus Young\youngth01","2017-18",29,"IND","NBA",5.5,81,81,2607,421,864,363,683,58,181,55,92,184,328,512,152,135,36,105,175,955,12.04
1996,"Thaddeus Young\youngth01","2008-09",20,"PHI","NBA",5.5,75,71,2580,475,960,419,796,56,164,139,189,139,238,377,86,100,23,118,165,1145,12.93
1997,"Shareef Abdur-Rahim\abdursh01","2004-05",28,"POR","NBA",5.4,54,49,1867,337,670,322,631,15,39,220,254,123,269,392,111,49,26,117,150,909,15.98
1998,"Ray Allen\allenra02","2012-13",37,"MIA","NBA",5.4,79,0,2035,292,651,153,319,139,332,140,158,40,177,217,135,67,15,103,129,863,9.82
1999,"Chris Andersen\anderch01","2008-09",30,"DEN","NBA",5.4,71,1,1460,160,292,158,282,2,10,130,181,163,279,442,31,41,175,69,174,452,9.2
2000,"Trevor Ariza\arizatr01","2015-16",30,"HOU","NBA",5.4,81,81,2859,357,859,172,360,185,499,126,161,67,299,366,188,160,26,113,177,1025,12.45
2001,"Andris Biedriņš\biedran01","2008-09",22,"GSW","NBA",5.4,62,58,1863,308,533,308,532,0,1,119,216,223,470,693,121,63,96,110,236,735,15.14
2002,"Bojan Bogdanović\bogdabo02","2017-18",28,"IND","NBA",5.4,80,80,2464,404,852,249,466,155,386,178,205,30,240,270,119,55,8,106,129,1141,11.84
2003,"Andrew Bogut\bogutan01","2010-11",26,"MIL","NBA",5.4,65,65,2297,367,742,367,738,0,4,96,217,199,521,720,131,47,168,125,217,830,14.67
2004,"Andrew Bogut\bogutan01","2015-16",31,"GSW","NBA",5.4,70,66,1451,175,279,174,278,1,1,24,50,121,371,492,162,33,114,83,221,375,9.46
2005,"Bruce Bowen\bowenbr01","2003-04",32,"SAS","NBA",5.4,82,82,2624,211,502,134,290,77,212,66,114,45,208,253,113,84,33,90,166,565,6.9
2006,"Ronnie Brewer\brewero02","2010-11",25,"CHI","NBA",5.4,81,1,1781,205,427,199,400,6,27,87,133,55,207,262,140,106,22,55,82,503,7.31
2007,"José Calderón\caldejo01","2006-07",25,"TOR","NBA",5.4,77,11,1614,263,505,238,430,25,75,117,143,21,113,134,387,63,5,110,136,668,10.39
2008,"Tyson Chandler\chandty01","2005-06",23,"CHI","NBA",5.4,79,50,2121,160,283,160,282,0,1,97,193,265,449,714,81,41,104,123,298,417,8.87
2009,"John Collins\collijo01","2017-18",20,"ATL","NBA",5.4,74,26,1785,314,545,298,498,16,47,133,186,176,365,541,98,47,80,105,215,777,12
2010,"Jamal Crawford\crawfja01","2012-13",32,"LAC","NBA",5.4,76,0,2230,445,1016,296,620,149,396,216,248,22,106,128,193,79,13,146,71,1255,12.94
2011,"Austin Croshere\croshau01","1999-00",24,"IND","NBA",5.4,81,14,1885,288,653,225,479,63,174,196,231,135,381,516,89,44,60,121,203,835,10.29
2012,"Ed Davis\davised01","2012-13",23,"TOT","NBA",5.4,81,28,1631,260,482,260,482,0,0,103,167,152,308,460,63,38,85,63,191,623,8.51
2013,"Luol Deng\denglu01","2014-15",29,"MIA","NBA",5.4,72,72,2421,369,787,291,567,78,220,191,251,103,273,376,139,65,22,108,109,1007,12.61
2014,"Tyreke Evans\evansty01","2009-10",20,"SAC","NBA",5.4,72,72,2677,533,1165,497,1024,36,141,348,465,66,314,380,414,109,26,216,204,1450,19.03
2015,"Raymond Felton\feltora01","2010-11",26,"TOT","NBA",5.4,75,54,2737,427,1005,311,676,116,329,194,241,48,221,269,625,125,11,221,150,1164,17.2
2016,"Michael Finley\finlemi01","1998-99",25,"DAL","NBA",5.4,50,50,2051,389,876,344,740,45,136,186,226,69,194,263,218,66,15,107,96,1009,17.39
2017,"Jeff Foster\fosteje01","2004-05",28,"IND","NBA",5.4,61,43,1594,168,324,168,319,0,5,90,142,205,345,550,43,46,12,55,186,426,9.02
2018,"Kevin Garnett\garneke01","1998-99",22,"MIN","NBA",5.4,47,47,1780,414,900,410,886,4,14,145,206,166,323,489,202,78,83,135,152,977,20.45
2019,"Taj Gibson\gibsota01","2015-16",30,"CHI","NBA",5.4,73,55,1936,263,500,263,497,0,3,101,146,206,298,504,106,47,77,78,180,627,10.15
2020,"Aaron Gordon\gordoaa01","2015-16",20,"ORL","NBA",5.4,78,37,1863,274,579,232,437,42,142,129,193,154,353,507,128,59,55,66,153,719,10.1
2021,"Jerami Grant\grantje01","2017-18",23,"OKC","NBA",5.4,81,1,1647,244,456,212,346,32,110,162,240,86,233,319,57,31,77,54,155,682,8.41
2022,"Tom Gugliotta\guglito01","1998-99",29,"PHO","NBA",5.4,43,43,1563,277,573,275,566,2,7,173,218,131,250,381,121,59,21,88,110,729,17.01
2023,"Tim Hardaway\hardati01","1998-99",32,"MIA","NBA",5.4,48,48,1772,301,752,189,441,112,311,121,149,15,137,152,352,57,6,131,102,835,16.38
2024,"Al Harrington\harrial01","2007-08",27,"GSW","NBA",5.4,81,59,2190,401,923,248,515,153,408,147,190,107,332,439,132,74,16,90,266,1102,11.76
2025,"Gordon Hayward\haywago01","2012-13",22,"UTA","NBA",5.4,72,27,2104,336,773,234,527,102,246,243,294,51,174,225,213,58,38,120,125,1017,12.69
2026,"Roy Hibbert\hibbero01","2013-14",27,"IND","NBA",5.4,81,81,2409,331,754,329,749,2,5,207,269,202,336,538,91,29,182,148,269,871,10.94
2027,"George Hill\hillge01","2014-15",28,"IND","NBA",5.4,43,36,1267,255,535,186,342,69,193,113,143,25,154,179,220,44,14,69,111,692,15.97
2028,"Grant Hill\hillgr01","1994-95",22,"DET","NBA",5.4,70,69,2678,508,1064,504,1037,4,27,374,511,125,320,445,353,124,62,202,203,1394,19.86
2029,"Jrue Holiday\holidjr01","2018-19",28,"NOP","NBA",5.4,67,67,2402,547,1159,429,796,118,363,208,271,75,259,334,518,109,54,210,148,1420,21.57
2030,"Kris Humphries\humphkr01","2010-11",25,"NJN","NBA",5.4,74,44,2061,307,583,307,582,0,1,127,191,225,546,771,84,33,80,103,168,741,11.98
2031,"Bobby Jackson\jacksbo01","2001-02",28,"SAC","NBA",5.4,81,3,1750,334,754,255,535,79,219,149,184,82,169,251,164,73,11,93,145,896,9.68
2032,"Jim Jackson\jacksji01","1995-96",25,"DAL","NBA",5.4,82,82,2820,569,1308,448,975,121,333,345,418,173,237,410,235,47,22,191,165,1604,15.58
2033,"Antawn Jamison\jamisan01","2004-05",28,"WAS","NBA",5.4,68,68,2605,519,1189,448,981,71,208,225,296,160,359,519,154,55,16,118,151,1334,15.62
2034,"Enes Kanter\kanteen01","2018-19",26,"TOT","NBA",5.4,67,31,1640,375,683,365,649,10,34,155,197,257,402,659,116,32,26,118,167,915,14.4
2035,"Jason Kidd\kiddja01","2012-13",39,"NYK","NBA",5.4,76,48,2043,152,409,38,84,114,325,40,48,50,273,323,249,125,25,76,125,458,8.89
2036,"Nenad Krstić\krstine01","2005-06",22,"NJN","NBA",5.4,80,80,2469,447,881,446,877,1,4,185,265,182,331,513,88,32,63,133,297,1080,11.91
2037,"Bill Laimbeer\laimbbi01","1992-93",35,"DET","NBA",5.4,79,41,1933,292,574,282,547,10,27,93,104,110,309,419,127,46,40,59,212,687,9.22
2038,"Jeremy Lin\linje01","2012-13",24,"HOU","NBA",5.4,82,82,2640,396,897,309,640,87,257,216,275,32,215,247,497,134,29,236,205,1095,14.67
2039,"Andre Miller\millean02","2012-13",36,"DEN","NBA",5.4,82,11,2151,303,632,286,568,17,64,163,194,60,178,238,484,73,11,172,159,786,11.79
2040,"Chris Mills\millsch01","1994-95",25,"CLE","NBA",5.4,80,79,2814,359,855,265,615,94,240,174,213,99,267,366,154,59,35,120,242,986,10.66
2041,"Marcus Morris\morrima03","2015-16",26,"DET","NBA",5.4,80,80,2856,410,945,302,647,108,298,203,271,91,313,404,201,67,23,140,170,1131,12.4
2042,"Ruben Patterson\patteru01","2006-07",31,"MIL","NBA",5.4,81,53,2508,475,867,472,848,3,19,241,376,190,250,440,232,110,25,199,232,1194,14.68
2043,"Gary Payton\paytoga01","2004-05",36,"BOS","NBA",5.4,77,77,2541,339,725,297,596,42,129,153,201,48,188,236,469,88,12,148,121,873,13
2044,"Paul Pierce\piercpa01","2006-07",29,"BOS","NBA",5.4,47,46,1740,373,850,266,575,107,275,320,402,39,238,277,194,48,13,152,122,1173,21.24
2045,"Scot Pollard\pollasc01","2000-01",25,"SAC","NBA",5.4,77,8,1658,185,395,185,393,0,2,128,171,173,292,465,47,48,97,66,206,498,7.96
2046,"Terry Porter\portete01","1993-94",30,"POR","NBA",5.4,77,34,2074,348,836,238,554,110,282,204,234,45,170,215,401,79,18,166,132,1010,13.12
2047,"Terry Porter\portete01","2000-01",37,"SAS","NBA",5.4,80,42,1678,197,440,110,235,87,205,92,116,24,177,201,251,52,11,104,88,573,8.12
2048,"James Posey\poseyja01","2002-03",26,"TOT","NBA",5.4,83,71,2518,309,752,239,523,70,229,205,246,90,336,426,184,106,15,144,197,893,10.72
2049,"Theo Ratliff\ratlith01","1998-99",25,"PHI","NBA",5.4,50,50,1627,197,419,197,419,0,0,166,229,139,268,407,30,45,149,92,180,560,13.07
2050,"Josh Richardson\richajo01","2017-18",24,"MIA","NBA",5.4,81,81,2689,399,885,272,549,127,336,120,142,69,216,285,231,121,75,140,199,1045,12.66
2051,"Luke Ridnour\ridnolu01","2004-05",23,"SEA","NBA",5.4,82,82,2571,299,739,232,561,67,178,159,180,55,149,204,483,94,23,149,185,824,11.56
2052,"Clifford Robinson\robincl02","2000-01",34,"PHO","NBA",5.4,82,82,2751,501,1186,411,937,90,249,253,357,105,229,334,237,87,82,186,258,1345,13.63
2053,"Rodney Rogers\rogerro01","2001-02",30,"TOT","NBA",5.4,77,8,1880,356,756,268,521,88,235,117,149,129,219,348,112,66,29,108,226,917,10.67
2054,"Michael Smith\smithmi02","1996-97",24,"SAC","NBA",5.4,81,52,2526,202,375,202,375,0,0,128,258,257,512,769,191,82,60,130,251,532,10.66
2055,"Kurt Thomas\thomaku01","2002-03",30,"NYK","NBA",5.4,81,81,2577,497,1028,495,1025,2,3,138,184,160,477,637,162,81,97,138,344,1134,13.73
2056,"Wayman Tisdale\tisdawa01","1993-94",29,"SAC","NBA",5.4,79,77,2557,552,1102,552,1102,0,0,215,266,159,401,560,139,37,52,124,290,1319,14.46
2057,"Anderson Varejão\varejan01","2013-14",31,"CLE","NBA",5.4,65,29,1800,227,459,227,452,0,7,92,135,187,442,629,140,69,39,72,164,546,11.45
2058,"David West\westda01","2015-16",35,"SAS","NBA",5.4,78,19,1404,244,448,241,441,3,7,63,80,72,237,309,143,44,55,68,142,554,8.17
2059,"Alvin Williams\willial02","2000-01",26,"TOR","NBA",5.4,82,34,2394,330,767,297,659,33,108,109,145,50,162,212,407,123,26,103,171,802,10.9
2060,"Deron Williams\willide01","2013-14",29,"BRK","NBA",5.4,64,58,2059,322,716,224,448,98,268,173,216,15,153,168,392,93,13,143,148,915,15.14
2061,"Jason Williams\willija02","2003-04",28,"MEM","NBA",5.4,72,68,2115,290,713,170,349,120,364,82,98,25,122,147,492,92,5,136,97,782,12.38
2062,"Jerome Williams\willije01","2002-03",29,"TOR","NBA",5.4,71,63,2346,267,535,266,529,1,6,156,281,231,419,650,95,116,26,98,197,691,11.75
2063,"Walt Williams\williwa02","1996-97",26,"TOR","NBA",5.4,73,73,2647,419,982,244,545,175,437,186,243,103,264,367,197,97,62,174,282,1199,14.82
2064,"Arron Afflalo\afflaar01","2013-14",28,"ORL","NBA",5.3,73,73,2552,464,1011,336,711,128,300,274,336,32,230,262,248,35,3,146,136,1330,15.05
2065,"Arron Afflalo\afflaar01","2011-12",26,"DEN","NBA",5.3,62,62,2086,329,699,241,478,88,221,197,247,40,157,197,149,36,13,85,134,943,12.8
2066,"Rafer Alston\alstora01","2008-09",32,"TOT","NBA",5.3,77,76,2447,316,820,204,489,112,331,156,208,33,194,227,406,108,10,140,135,900,11.97
2067,"Derek Anderson\anderde01","2001-02",27,"POR","NBA",5.3,70,27,1860,247,612,162,384,85,228,178,208,47,142,189,216,68,8,87,113,757,10.23
2068,"Derek Anderson\anderde01","1997-98",23,"CLE","NBA",5.3,66,13,1839,239,586,222,502,17,84,275,315,55,132,187,227,86,13,128,136,770,11.64
2069,"Nick Anderson\anderni01","1997-98",30,"ORL","NBA",5.3,58,44,1701,343,754,266,540,77,214,127,199,98,199,297,119,72,23,85,98,890,13.12
2070,"Trevor Ariza\arizatr01","2017-18",32,"HOU","NBA",5.3,67,67,2269,268,651,98,189,170,462,76,89,33,261,294,105,98,13,52,132,782,10.84
2071,"Darrell Armstrong\armstda01","2003-04",35,"NOH","NBA",5.3,79,22,2247,291,736,156,307,135,429,123,144,63,163,226,311,133,16,155,148,840,11.2
2072,"Brandon Bass\bassbr01","2014-15",29,"BOS","NBA",5.3,82,43,1929,344,683,335,651,9,32,169,214,139,259,398,104,41,32,83,140,866,9.79
2073,"Patrick Beverley\beverpa01","2016-17",28,"HOU","NBA",5.3,67,67,2058,228,543,118,255,110,288,73,95,95,298,393,281,99,25,100,222,639,12.11
2074,"Mike Bibby\bibbymi01","2000-01",22,"VAN","NBA",5.3,82,82,3190,525,1157,417,872,108,285,143,188,47,257,304,685,107,12,248,148,1301,17.07
2075,"Eric Bledsoe\bledser01","2016-17",27,"PHO","NBA",5.3,66,66,2176,449,1034,345,724,104,310,388,458,52,268,320,418,91,31,224,164,1390,20.47
2076,"P.J. Brown\brownpj01","1995-96",26,"NJN","NBA",5.3,81,81,2942,354,798,351,783,3,15,204,265,215,345,560,165,79,100,133,249,915,11.88
2077,"Caron Butler\butleca01","2006-07",26,"WAS","NBA",5.3,63,63,2474,451,975,433,903,18,72,283,328,147,320,467,233,134,17,181,188,1203,18.71
2078,"Caron Butler\butleca01","2004-05",24,"LAL","NBA",5.3,77,77,2746,441,991,403,866,38,125,275,319,146,304,450,146,110,23,125,213,1195,13.88
2079,"Kentavious Caldwell-Pope\caldwke01","2017-18",24,"LAL","NBA",5.3,74,74,2458,340,798,181,383,159,415,153,194,60,327,387,162,106,16,97,145,992,12.68
2080,"Kentavious Caldwell-Pope\caldwke01","2015-16",22,"DET","NBA",5.3,76,76,2789,403,960,289,591,114,369,185,228,70,212,282,138,110,17,105,167,1105,11.95
2081,"Kelvin Cato\catoke01","2001-02",27,"HOU","NBA",5.3,75,73,1917,190,326,190,325,0,1,113,194,176,349,525,29,40,95,53,208,493,8.6
2082,"Keon Clark\clarkke01","2001-02",26,"TOR","NBA",5.3,81,31,2185,380,775,380,770,0,5,155,230,182,421,603,88,58,122,140,258,915,11.61
2083,"Mike Conley\conlemi01","2015-16",28,"MEM","NBA",5.3,56,56,1761,294,696,216,481,78,215,191,229,26,138,164,342,67,16,84,100,857,15.28
2084,"Jamal Crawford\crawfja01","2013-14",33,"LAC","NBA",5.3,69,24,2094,421,1011,260,565,161,446,279,322,34,124,158,223,59,12,135,120,1282,14.67
2085,"Antonio Daniels\daniean01","2005-06",30,"WAS","NBA",5.3,80,17,2283,230,550,207,449,23,101,284,336,19,153,172,284,52,8,89,96,767,9.73
2086,"Vlade Divac\divacvl01","2003-04",35,"SAC","NBA",5.3,81,81,2317,314,668,312,655,2,13,170,260,136,327,463,432,57,77,173,222,800,12.6
2087,"Goran Dragić\dragigo01","2017-18",31,"MIA","NBA",5.3,75,75,2378,484,1075,373,775,111,300,217,271,54,253,307,359,63,12,166,180,1296,15.48
2088,"Jared Dudley\dudleja01","2009-10",24,"PHO","NBA",5.3,82,1,1991,225,490,105,228,120,262,104,138,99,182,281,115,81,16,68,162,674,8.45
2089,"Landry Fields\fieldla01","2010-11",22,"NYK","NBA",5.3,82,81,2541,299,602,213,383,86,219,113,147,105,416,521,155,80,17,107,114,797,10.86
2090,"Rick Fox\foxri01","1997-98",28,"LAL","NBA",5.3,82,82,2709,363,771,277,506,86,265,171,230,78,280,358,276,100,48,201,309,983,12.62
2091,"Channing Frye\fryech01","2013-14",30,"PHO","NBA",5.3,82,82,2312,336,778,176,346,160,432,78,95,73,343,416,98,60,63,89,245,910,10.15
2092,"Armen Gilliam\gilliar01","1997-98",33,"MIL","NBA",5.3,82,25,2114,327,676,327,672,0,4,267,333,146,293,439,104,65,37,148,177,921,10.87
2093,"Eric Gordon\gordoer01","2010-11",22,"LAC","NBA",5.3,56,56,2112,427,949,321,658,106,291,287,348,45,119,164,244,71,18,151,115,1247,18.73
2094,"Brian Grant\grantbr01","1994-95",22,"SAC","NBA",5.3,80,59,2289,413,809,412,805,1,4,231,363,207,391,598,99,49,116,163,276,1058,13.04
2095,"Tom Gugliotta\guglito01","1995-96",26,"MIN","NBA",5.3,78,78,2835,473,1004,447,918,26,86,289,374,176,514,690,238,139,96,234,265,1261,17.46
2096,"Nenê Hilário\hilarne01","2006-07",24,"DEN","NBA",5.3,64,42,1715,294,516,294,515,0,1,195,283,150,299,449,77,62,59,127,209,783,13.14
2097,"Grant Hill\hillgr01","2008-09",36,"PHO","NBA",5.3,82,68,2445,390,745,366,669,24,76,181,224,64,341,405,186,90,54,126,182,985,12.47
2098,"Jeff Hornacek\hornaje01","1998-99",35,"UTA","NBA",5.3,48,48,1435,214,449,180,368,34,81,125,140,33,127,160,192,52,14,82,95,587,12.76
2099,"Kris Humphries\humphkr01","2011-12",26,"NJN","NBA",5.3,62,62,2162,323,671,323,671,0,0,209,278,233,448,681,90,50,74,119,173,855,14.9
2100,"Kyrie Irving\irvinky01","2012-13",20,"CLE","NBA",5.3,59,59,2048,484,1070,375,791,109,279,248,290,34,182,216,350,89,21,191,146,1325,20.13
2101,"Kyle Korver\korveky01","2011-12",30,"CHI","NBA",5.3,65,7,1469,178,412,60,141,118,271,55,66,26,133,159,112,36,15,53,110,529,7.63
2102,"Jeremy Lamb\lambje01","2018-19",26,"CHO","NBA",5.3,79,55,2250,431,979,316,649,115,330,231,260,65,369,434,172,88,32,80,140,1208,13.77
2103,"Kevin Love\loveke01","2008-09",20,"MIN","NBA",5.3,81,37,2048,316,688,314,669,2,19,265,336,274,460,734,84,35,50,118,205,899,11.58
2104,"Dan Majerle\majerda01","1997-98",32,"MIA","NBA",5.3,72,22,1928,184,439,73,144,111,295,40,51,48,220,268,157,68,15,65,139,519,8.01
2105,"Matt Maloney\malonma01","1996-97",25,"HOU","NBA",5.3,82,82,2386,271,615,117,234,154,381,71,93,19,141,160,303,82,1,122,125,767,9.69
2106,"Stephon Marbury\marbust01","1998-99",21,"TOT","NBA",5.3,49,49,1895,378,883,312,686,66,197,222,278,37,105,142,437,59,8,164,125,1044,20.04
2107,"Stephon Marbury\marbust01","1997-98",20,"MIN","NBA",5.3,82,81,3112,513,1237,418,933,95,304,329,450,58,172,230,704,104,7,256,222,1450,17.5
2108,"Shawn Marion\mariosh01","2012-13",34,"DAL","NBA",5.3,67,67,2010,355,690,332,617,23,73,79,101,146,379,525,163,75,47,103,111,812,13.35
2109,"Kenyon Martin\martike01","2004-05",27,"DEN","NBA",5.3,70,67,2272,444,907,444,895,0,12,199,308,146,365,511,170,100,78,149,228,1087,15.2
2110,"Kevin Martin\martike02","2013-14",30,"MIN","NBA",5.3,68,68,2177,440,1023,325,726,115,297,303,340,34,169,203,121,66,6,106,123,1298,14.4
2111,"JaVale McGee\mcgeeja01","2010-11",23,"WAS","NBA",5.3,79,75,2193,332,604,332,601,0,3,134,230,223,411,634,38,41,193,102,232,798,11.72
2112,"Aaron McKie\mckieaa01","1995-96",23,"POR","NBA",5.3,81,73,2259,337,722,299,605,38,117,152,199,86,218,304,205,92,21,135,205,864,10.45
2113,"Andre Miller\millean02","1999-00",23,"CLE","NBA",5.3,82,36,2093,339,755,329,706,10,49,226,292,85,195,280,476,84,17,166,194,914,12.63
2114,"Mike Miller\millemi01","2000-01",20,"ORL","NBA",5.3,82,62,2390,368,845,220,481,148,364,91,128,66,261,327,140,51,19,97,200,975,9.87
2115,"Oliver Miller\milleol01","1993-94",23,"PHO","NBA",5.3,69,30,1786,277,455,275,446,2,9,80,137,140,336,476,244,83,156,164,230,636,13.9
2116,"Cuttino Mobley\moblecu01","2005-06",30,"LAC","NBA",5.3,79,74,2979,429,1008,346,763,83,245,229,273,50,291,341,238,93,36,145,208,1170,13.16
2117,"Gheorghe Mureșan\muresgh01","1996-97",25,"WSB","NBA",5.3,73,69,1849,327,541,327,541,0,0,123,199,141,340,481,29,43,96,117,230,777,11.25
2118,"Troy Murphy\murphtr01","2004-05",24,"GSW","NBA",5.3,70,69,2375,392,947,333,799,59,148,233,319,251,505,756,97,53,33,108,190,1076,14.03
2119,"Travis Outlaw\outlatr01","2008-09",24,"POR","NBA",5.3,81,6,2246,385,850,296,614,89,236,175,242,70,261,331,83,47,57,94,168,1034,10.41
2120,"Olden Polynice\polynol01","1995-96",31,"SAC","NBA",5.3,81,80,2441,431,818,430,815,1,3,122,203,257,507,764,58,52,66,127,250,985,12.31
2121,"Clifford Robinson\robincl02","1998-99",32,"PHO","NBA",5.3,50,35,1740,299,629,241,490,58,139,163,234,69,158,227,128,75,59,88,153,819,15.33
2122,"Ricky Rubio\rubiori01","2017-18",27,"UTA","NBA",5.3,77,77,2254,346,827,250,554,96,273,220,254,44,307,351,410,121,11,207,206,1008,14.42
2123,"Bobby Simmons\simmobo01","2005-06",25,"MIL","NBA",5.3,75,74,2538,366,808,261,558,105,250,165,200,91,242,333,172,86,21,123,254,1002,12.31
2124,"Marcus Smart\smartma01","2018-19",24,"BOS","NBA",5.3,80,60,2200,239,567,113,221,126,346,104,129,57,177,234,321,143,28,123,201,708,10.97
2125,"Jason Terry\terryja01","2010-11",33,"DAL","NBA",5.3,82,10,2564,492,1091,365,740,127,351,182,214,24,129,153,334,93,13,167,140,1293,13.54
2126,"Klay Thompson\thompkl01","2018-19",28,"GSW","NBA",5.3,78,78,2652,655,1402,414,803,241,599,129,158,37,262,299,186,84,47,115,157,1680,16.87
2127,"Anthony Tolliver\tollian01","2017-18",32,"DET","NBA",5.3,79,14,1757,219,472,60,107,159,365,106,133,50,191,241,90,32,21,58,144,703,8.3
2128,"Samaki Walker\walkesa01","2001-02",25,"LAL","NBA",5.3,69,63,1655,187,365,187,365,0,0,86,129,129,352,481,64,28,88,53,170,460,8.53
2129,"Hassan Whiteside\whiteha01","2014-15",25,"MIA","NBA",5.3,48,32,1142,243,387,243,387,0,0,78,156,145,337,482,6,27,123,58,129,564,13.94
2130,"Hassan Whiteside\whiteha01","2017-18",28,"MIA","NBA",5.3,54,54,1364,312,578,310,576,2,2,128,182,174,444,618,54,37,94,92,131,754,15.56
2131,"Hot Rod Williams\williho01","1994-95",32,"CLE","NBA",5.3,74,73,2641,366,810,365,805,1,5,196,286,173,334,507,192,83,101,149,211,929,13.02
2132,"Hot Rod Williams\williho01","1996-97",34,"PHO","NBA",5.3,68,66,2137,204,416,204,414,0,2,133,198,178,384,562,100,67,88,66,176,541,10.72
2133,"Metta World Peace\artesro01","2009-10",30,"LAL","NBA",5.3,77,77,2605,306,740,201,444,105,296,128,186,99,232,331,234,106,21,121,165,845,10.95
2134,"Ray Allen\allenra02","1998-99",23,"MIL","NBA",5.2,50,50,1719,303,673,229,465,74,208,176,195,57,155,212,178,53,7,122,117,856,15.32
2135,"Kenny Anderson\anderke01","2001-02",31,"BOS","NBA",5.2,76,76,2430,312,716,303,683,9,33,98,132,57,218,275,403,141,10,119,210,731,11.59
2136,"Ryan Anderson\anderry01","2016-17",28,"HOU","NBA",5.2,72,72,2116,323,773,119,267,204,506,129,150,112,218,330,68,31,14,55,142,979,10.82
2137,"Shane Battier\battish01","2008-09",30,"HOU","NBA",5.2,60,59,2031,145,354,54,117,91,237,55,67,52,233,285,137,48,54,49,114,436,8.95
2138,"Nicolas Batum\batumni01","2014-15",26,"POR","NBA",5.2,71,71,2380,240,600,140,291,100,309,84,98,62,354,416,341,78,40,132,106,664,11.91
2139,"Andrew Bogut\bogutan01","2014-15",30,"GSW","NBA",5.2,67,65,1583,200,355,200,355,0,0,22,42,141,402,543,180,39,113,106,188,422,10.55
2140,"Corey Brewer\breweco01","2013-14",27,"MIN","NBA",5.2,81,81,2609,388,807,329,596,59,211,163,227,63,144,207,135,151,30,105,210,998,11.26
2141,"Kobe Bryant\bryanko01","1998-99",20,"LAL","NBA",5.2,50,50,1896,362,779,335,678,27,101,245,292,53,211,264,190,72,50,157,153,996,18.45
2142,"Marcus Camby\cambyma01","2008-09",34,"LAC","NBA",5.2,62,55,1925,254,496,253,492,1,4,132,182,161,529,690,127,51,132,93,129,641,14.25
2143,"Cedric Ceballos\cebalce01","1994-95",25,"LAL","NBA",5.2,58,54,2029,497,977,439,831,58,146,209,292,169,295,464,105,60,19,143,131,1261,18.54
2144,"Mario Chalmers\chalmma01","2008-09",22,"MIA","NBA",5.2,82,82,2626,278,662,164,351,114,311,148,193,37,191,228,403,160,8,165,240,818,12.03
2145,"Mario Chalmers\chalmma01","2012-13",26,"MIA","NBA",5.2,77,77,2068,227,529,104,228,123,301,89,112,19,152,171,273,118,12,119,196,666,9.91
2146,"Darren Collison\collida01","2015-16",28,"SAC","NBA",5.2,74,15,2219,377,776,290,559,87,217,194,226,28,141,169,318,76,4,130,142,1035,13.5
2147,"Nick Collison\collini01","2012-13",32,"OKC","NBA",5.2,81,2,1583,176,296,176,292,0,4,60,78,123,210,333,121,51,30,69,197,412,6.89
2148,"Samuel Dalembert\dalemsa01","2009-10",28,"PHI","NBA",5.2,82,80,2124,285,523,285,523,0,0,97,133,239,545,784,64,42,151,123,252,667,11.06
2149,"Antonio Davis\davisan01","1996-97",28,"IND","NBA",5.2,82,28,2335,308,641,307,627,1,14,241,362,190,408,598,65,42,84,141,260,858,10.6
2150,"Dewayne Dedmon\dedmode01","2016-17",27,"SAS","NBA",5.2,76,37,1330,161,259,161,259,0,0,65,93,129,367,496,44,37,61,61,180,387,7.47
2151,"Vlade Divac\divacvl01","1998-99",30,"SAC","NBA",5.2,50,50,1761,262,557,251,514,11,43,179,255,140,361,501,215,44,51,131,166,714,16.58
2152,"Chris Duhon\duhonch01","2005-06",23,"CHI","NBA",5.2,74,38,2155,215,538,115,260,100,278,117,143,28,192,220,373,70,3,117,152,647,10.37
2153,"Tim Duncan\duncati01","2015-16",39,"SAS","NBA",5.2,61,60,1536,215,441,215,439,0,2,92,131,115,332,447,163,47,78,90,125,522,11.12
2154,"Mike Dunleavy\dunlemi02","2003-04",23,"GSW","NBA",5.2,75,69,2336,323,720,229,466,94,254,137,185,87,355,442,220,68,13,143,169,877,11.88
2155,"LaPhonso Ellis\ellisla01","2000-01",30,"MIN","NBA",5.2,82,5,1948,298,642,291,620,7,22,169,214,199,295,494,93,67,74,108,290,772,9.82
2156,"Derek Fisher\fishede01","2002-03",28,"LAL","NBA",5.2,82,82,2829,339,775,254,563,85,212,100,125,40,199,239,298,93,15,94,195,863,10.41
2157,"Rick Fox\foxri01","1996-97",27,"BOS","NBA",5.2,76,75,2650,433,950,332,672,101,278,207,263,114,280,394,286,167,40,178,279,1174,15.96
2158,"Dan Gadzuric\gadzuda01","2004-05",26,"MIL","NBA",5.2,81,81,1783,243,451,243,451,0,0,107,199,261,413,674,30,47,106,81,224,593,9.25
2159,"Taj Gibson\gibsota01","2010-11",25,"CHI","NBA",5.2,80,19,1742,234,502,233,494,1,8,100,148,162,296,458,58,39,106,71,203,569,7.86
2160,"Horace Grant\grantho01","1999-00",34,"SEA","NBA",5.2,76,76,2688,266,599,266,595,0,4,80,111,167,424,591,188,55,60,61,192,612,9.89
2161,"A.C. Green\greenac01","1997-98",34,"DAL","NBA",5.2,82,68,2649,242,534,242,530,0,4,116,162,219,449,668,123,78,27,68,157,600,9.2
2162,"Jeff Green\greenje02","2014-15",28,"TOT","NBA",5.2,78,70,2454,416,967,319,675,97,292,239,287,64,264,328,134,53,34,108,147,1168,12.05
2163,"Tom Gugliotta\guglito01","1999-00",30,"PHO","NBA",5.2,54,54,1767,310,645,309,637,1,8,117,151,141,284,425,124,80,31,106,152,738,13.99
2164,"Brendan Haywood\haywobr01","2004-05",25,"WAS","NBA",5.2,68,68,1865,239,427,239,427,0,0,159,261,202,262,464,57,52,114,96,218,637,11.03
2165,"Fred Hoiberg\hoibefr01","2004-05",32,"MIN","NBA",5.2,76,0,1272,139,284,69,139,70,145,89,102,32,149,181,85,50,15,20,105,437,6.33
2166,"Mike James\jamesmi01","2003-04",28,"TOT","NBA",5.2,81,55,2196,272,657,166,376,106,281,103,127,28,206,234,339,96,3,124,156,753,10.14
2167,"Avery Johnson\johnsav01","1992-93",27,"SAS","NBA",5.2,75,49,2030,256,510,256,502,0,8,144,182,20,126,146,561,85,16,145,141,656,12.45
2168,"Ervin Johnson\johnser02","1996-97",29,"DEN","NBA",5.2,82,82,2599,243,467,243,465,0,2,96,156,231,682,913,71,65,227,118,288,582,11.79
2169,"DeAndre Jordan\jordade01","2010-11",22,"LAC","NBA",5.2,80,66,2047,234,341,234,340,0,1,98,217,207,368,575,42,41,142,101,255,566,9.66
2170,"Danny Manning\mannida01","1996-97",30,"PHO","NBA",5.2,77,17,2134,426,795,419,759,7,36,181,251,137,332,469,173,81,74,161,268,1040,13.86
2171,"Shawn Marion\mariosh01","2008-09",30,"TOT","NBA",5.2,69,68,2470,382,788,372,735,10,53,117,147,180,409,589,139,88,66,105,132,891,13.73
2172,"Desmond Mason\masonde01","2002-03",25,"TOT","NBA",5.2,80,40,2763,457,1017,436,945,21,72,212,283,154,369,523,163,67,32,115,210,1147,12.53
2173,"Paul Millsap\millspa01","2007-08",22,"UTA","NBA",5.2,82,2,1702,253,502,253,498,0,4,155,229,167,293,460,81,72,73,87,269,661,9.09
2174,"Donovan Mitchell\mitchdo01","2017-18",21,"UTA","NBA",5.2,79,71,2638,595,1362,408,812,187,550,239,297,52,244,296,291,118,27,215,213,1616,16.92
2175,"Cuttino Mobley\moblecu01","1999-00",24,"HOU","NBA",5.2,81,8,2496,437,1016,333,724,104,292,299,353,59,229,288,208,87,32,186,171,1277,13.45
2176,"Dikembe Mutombo\mutomdi01","2006-07",40,"HOU","NBA",5.2,75,33,1289,85,153,85,153,0,0,60,87,164,324,488,13,22,76,38,156,230,5.67
2177,"Rasho Nesterović\nestera01","2002-03",26,"MIN","NBA",5.2,77,77,2337,400,762,400,760,0,2,61,95,146,358,504,114,39,116,99,256,861,11.37
2178,"Ken Norman\normake01","1992-93",28,"LAC","NBA",5.2,76,71,2477,498,975,488,937,10,38,131,220,209,362,571,165,59,58,125,156,1137,13.97
2179,"Kendrick Perkins\perkike01","2009-10",25,"BOS","NBA",5.2,78,78,2154,314,522,314,519,0,3,163,280,155,440,595,80,26,132,165,219,791,11.75
2180,"Elliot Perry\perryel01","1994-95",25,"PHO","NBA",5.2,82,51,1977,306,588,281,528,25,60,158,195,51,100,151,394,156,4,163,142,795,12.02
2181,"Wesley Person\persowe01","1996-97",25,"PHO","NBA",5.2,80,42,2326,409,903,238,489,171,414,91,114,68,224,292,123,86,20,76,102,1080,11.31
2182,"Paul Pierce\piercpa01","2013-14",36,"BRK","NBA",5.2,75,68,2098,321,712,209,412,112,300,256,310,26,322,348,178,86,31,153,190,1010,13.2
2183,"Terry Porter\portete01","1997-98",34,"MIN","NBA",5.2,82,8,1786,259,577,167,344,92,233,167,195,37,131,168,271,63,16,104,103,777,9.71
2184,"James Posey\poseyja01","2006-07",30,"MIA","NBA",5.2,71,19,1919,186,432,89,173,97,259,81,98,66,291,357,94,71,23,55,193,550,8.6
2185,"Theo Ratliff\ratlith01","2000-01",27,"PHI","NBA",5.2,50,50,1800,228,457,228,457,0,0,165,217,125,288,413,58,30,187,126,165,621,14.76
2186,"Theo Ratliff\ratlith01","2003-04",30,"TOT","NBA",5.2,85,83,2664,266,549,266,549,0,0,140,217,195,419,614,71,54,307,120,300,672,10.91
2187,"J.J. Redick\redicjj01","2011-12",27,"ORL","NBA",5.2,65,22,1765,248,584,136,316,112,268,143,157,18,132,150,164,27,6,68,92,751,9.87
2188,"Jason Richardson\richaja01","2003-04",23,"GSW","NBA",5.2,78,78,2936,563,1284,486,1011,77,273,258,377,124,400,524,226,86,41,196,182,1461,15.67
2189,"Mitch Richmond\richmmi01","1999-00",34,"WAS","NBA",5.2,74,69,2397,447,1049,354,808,93,241,298,340,37,176,213,185,110,13,154,191,1285,14.14
2190,"Malik Rose\rosema01","2002-03",28,"SAS","NBA",5.2,79,13,1933,289,630,287,625,2,5,242,306,148,358,506,124,57,40,170,206,822,10.7
2191,"Detlef Schrempf\schrede01","1999-00",37,"POR","NBA",5.2,77,6,1662,187,433,166,381,21,52,179,215,79,253,332,197,37,17,100,182,574,8.45
2192,"Bryant Stith\stithbr01","1995-96",25,"DEN","NBA",5.2,82,77,2810,379,911,338,763,41,148,320,379,125,275,400,241,114,16,157,187,1119,12.97
2193,"Bob Sura\surabo01","1996-97",23,"CLE","NBA",5.2,82,23,2269,253,587,200,423,53,164,196,319,76,232,308,390,90,33,181,218,755,11.04
2194,"Wally Szczerbiak\szczewa02","2002-03",25,"MIN","NBA",5.2,52,42,1836,351,729,290,584,61,145,150,173,53,188,241,136,44,22,87,123,913,15.09
2195,"Jeff Teague\teaguje01","2013-14",25,"ATL","NBA",5.2,79,79,2542,456,1040,382,815,74,225,318,376,34,174,208,528,89,17,232,158,1304,16.32
2196,"Kurt Thomas\thomaku01","1999-00",27,"NYK","NBA",5.2,80,21,1971,270,535,269,532,1,3,100,128,144,361,505,82,51,42,105,278,641,8.79
2197,"Kurt Thomas\thomaku01","2004-05",32,"NYK","NBA",5.2,80,80,2855,424,901,422,897,2,4,66,84,170,661,831,160,70,79,99,310,916,12.72
2198,"Tristan Thompson\thomptr01","2012-13",21,"CLE","NBA",5.2,82,82,2564,390,799,390,796,0,3,177,291,306,467,773,108,60,71,123,234,957,12.23
2199,"Hedo Türkoğlu\turkohe01","2001-02",22,"SAC","NBA",5.2,80,10,1970,290,687,227,516,63,171,167,230,63,300,363,163,57,31,81,184,810,9.47
2200,"Nikola Vučević\vucevni01","2015-16",25,"ORL","NBA",5.2,65,60,2037,533,1046,531,1037,2,9,113,150,174,402,576,179,53,70,123,173,1181,17
2201,"David Wesley\wesleda01","2004-05",34,"TOT","NBA",5.2,80,79,2774,334,840,216,525,118,315,162,189,38,190,228,265,96,9,113,215,948,10.77
2202,"David West\westda01","2006-07",26,"NOK","NBA",5.2,52,52,1900,377,792,369,767,8,25,187,227,126,298,424,114,42,38,98,143,949,16.3
2203,"Russell Westbrook\westbru01","2013-14",25,"OKC","NBA",5.2,46,46,1412,346,791,278,577,68,214,242,293,55,208,263,319,88,7,177,104,1002,21.47
2204,"Aaron Williams\williaa01","2000-01",29,"NJN","NBA",5.2,82,25,2336,297,650,297,648,0,2,244,310,211,379,590,88,59,113,132,319,838,11.11
2205,"Alvin Williams\willial02","2001-02",27,"TOR","NBA",5.2,82,82,2927,403,971,341,778,62,193,103,140,58,223,281,468,135,26,150,191,971,12.57
2206,"Lou Williams\willilo02","2009-10",23,"PHI","NBA",5.2,64,38,1912,318,677,248,471,70,206,192,233,25,162,187,268,80,15,106,110,898,13.87
2207,"Lorenzen Wright\wrighlo02","2004-05",29,"MEM","NBA",5.2,80,77,2287,320,683,320,680,0,3,131,198,177,436,613,87,58,69,100,251,771,10.08
2208,"Mahmoud Abdul-Rauf\abdulma02","1992-93",23,"DEN","NBA",5.1,81,81,2710,633,1407,563,1210,70,197,217,232,51,174,225,344,84,8,187,179,1553,15.26
2209,"Tony Allen\allento01","2012-13",31,"MEM","NBA",5.1,79,79,2109,284,638,281,614,3,24,134,187,121,242,363,98,119,44,94,211,705,9.04
2210,"Chucky Atkins\atkinch01","2001-02",27,"DET","NBA",5.1,79,62,2285,368,790,230,454,138,336,83,120,31,127,158,263,72,11,128,177,957,10.93
2211,"Stacey Augmon\augmost01","1994-95",26,"ATL","NBA",5.1,76,76,2362,397,876,390,850,7,26,252,346,157,211,368,197,100,47,152,163,1053,12.88
2212,"D.J. Augustin\augusdj01","2008-09",21,"CHA","NBA",5.1,72,12,1908,267,621,159,375,108,246,208,233,17,116,133,250,42,2,119,140,850,10.88
2213,"Brandon Bass\bassbr01","2013-14",28,"BOS","NBA",5.1,82,73,2266,352,725,350,719,2,6,205,239,161,309,470,87,36,71,102,190,911,10.55
2214,"Shane Battier\battish01","2010-11",32,"TOT","NBA",5.1,82,59,2375,229,509,127,242,102,267,64,93,90,283,373,185,69,81,79,158,624,9.17
2215,"Travis Best\besttr01","1999-00",27,"IND","NBA",5.1,82,0,1691,271,561,236,468,35,93,156,190,16,126,142,272,76,5,107,204,733,9.29
2216,"Bruce Bowen\bowenbr01","2002-03",31,"SAS","NBA",5.1,82,82,2566,223,479,122,250,101,229,36,89,59,180,239,113,66,42,72,195,583,7.14
2217,"Shawn Bradley\bradlsh01","1999-00",27,"DAL","NBA",5.1,77,54,1901,266,555,265,550,1,5,114,149,160,337,497,60,71,190,74,260,647,10.33
2218,"Terrell Brandon\brandte01","1997-98",27,"MIL","NBA",5.1,50,48,1784,339,731,308,638,31,93,132,156,23,153,176,387,111,17,145,120,841,18.39
2219,"P.J. Brown\brownpj01","1998-99",29,"MIA","NBA",5.1,50,50,1611,229,477,229,477,0,0,113,146,115,231,346,66,46,48,69,166,571,11.59
2220,"Caron Butler\butleca01","2002-03",22,"MIA","NBA",5.1,78,78,2858,429,1032,395,925,34,107,309,375,135,262,397,213,137,31,192,230,1201,13.98
2221,"José Calderón\caldejo01","2011-12",30,"TOR","NBA",5.1,53,53,1799,218,477,159,318,59,159,60,68,19,141,160,468,47,3,104,94,555,14.07
2222,"Doug Christie\chrisdo01","1999-00",29,"TOR","NBA",5.1,73,73,2264,311,764,212,489,99,275,182,216,63,222,285,321,102,43,144,167,903,13.01
2223,"Derrick Coleman\colemde01","1994-95",27,"NJN","NBA",5.1,56,54,2103,371,875,343,755,28,120,376,490,167,424,591,187,35,94,172,162,1146,19.72
2224,"Dell Curry\curryde01","1995-96",31,"CHH","NBA",5.1,82,29,2371,441,974,277,568,164,406,146,171,68,196,264,176,108,25,130,173,1192,12.57
2225,"Goran Dragić\dragigo01","2011-12",25,"HOU","NBA",5.1,66,28,1752,277,600,209,398,68,202,153,190,53,115,168,351,85,10,157,166,775,12.97
2226,"Jared Dudley\dudleja01","2011-12",26,"PHO","NBA",5.1,65,60,2020,312,643,232,434,80,209,119,164,95,206,301,112,49,19,72,107,823,11.4
2227,"Mike Dunleavy\dunlemi02","2006-07",26,"TOT","NBA",5.1,82,49,2580,384,850,314,626,70,224,211,269,84,347,431,228,84,22,149,203,1049,12.39
2228,"Kevin Edwards\edwarke01","1993-94",28,"NJN","NBA",5.1,82,82,2727,471,1028,436,929,35,99,167,217,94,187,281,232,120,34,135,150,1144,12.33
2229,"Mario Elie\eliema01","1992-93",29,"POR","NBA",5.1,82,7,1757,240,524,195,395,45,129,183,214,59,157,216,177,74,20,89,145,708,8.82
2230,"Derrick Favors\favorde01","2013-14",22,"UTA","NBA",5.1,73,73,2201,390,747,390,746,0,1,190,284,199,438,637,91,75,108,129,236,970,14.17
2231,"Rick Fox\foxri01","2000-01",31,"LAL","NBA",5.1,82,77,2291,287,646,169,346,118,300,95,122,80,245,325,262,70,29,136,225,787,10.27
2232,"Rick Fox\foxri01","1995-96",26,"BOS","NBA",5.1,81,81,2588,421,928,322,656,99,272,196,254,158,292,450,369,113,41,216,290,1137,14.97
2233,"Pat Garrity\garripa01","2001-02",25,"ORL","NBA",5.1,80,43,2406,327,767,158,371,169,396,61,73,77,261,338,99,61,28,68,230,884,9.48
2234,"Taj Gibson\gibsota01","2018-19",33,"MIN","NBA",5.1,70,57,1686,304,537,293,503,11,34,134,177,172,286,458,84,53,39,73,186,753,11.48
2235,"Aaron Gordon\gordoaa01","2018-19",23,"ORL","NBA",5.1,78,78,2633,470,1046,349,699,121,347,185,253,129,445,574,289,57,56,162,172,1246,15.42
2236,"Ben Gordon\gordobe01","2007-08",24,"CHI","NBA",5.1,72,27,2291,464,1069,322,723,142,346,266,293,40,181,221,213,55,8,150,171,1336,14.73
2237,"Danny Granger\grangda01","2005-06",22,"IND","NBA",5.1,78,17,1765,221,478,191,385,30,93,115,148,131,253,384,90,58,62,80,211,587,8.28
2238,"Tim Hardaway\hardati01","1994-95",28,"GSW","NBA",5.1,62,62,2321,430,1007,262,563,168,444,219,288,46,144,190,578,88,12,214,155,1247,20.38
2239,"Lucious Harris\harrilu01","2001-02",31,"NJN","NBA",5.1,74,0,1553,249,537,205,419,44,118,133,158,49,158,207,116,53,6,61,99,675,8.24
2240,"Udonis Haslem\hasleud01","2006-07",26,"MIA","NBA",5.1,79,79,2483,353,717,353,713,0,4,138,203,188,466,654,97,49,26,110,236,844,10.81
2241,"Grant Hill\hillgr01","2006-07",34,"ORL","NBA",5.1,65,64,2009,342,660,340,648,2,12,248,324,53,184,237,138,61,25,144,146,934,13.05
2242,"Troy Hudson\hudsotr01","2002-03",26,"MIN","NBA",5.1,79,74,2600,409,956,312,690,97,266,208,231,42,141,183,452,60,7,182,160,1123,13.45
2243,"Serge Ibaka\ibakase01","2016-17",27,"TOT","NBA",5.1,79,79,2422,471,982,347,665,124,317,107,125,129,409,538,75,41,124,105,215,1173,13.45
2244,"Serge Ibaka\ibakase01","2017-18",28,"TOR","NBA",5.1,76,76,2093,379,784,272,487,107,297,94,118,78,400,478,62,29,99,90,209,959,11.65
2245,"Andre Iguodala\iguodan01","2014-15",31,"GSW","NBA",5.1,77,0,2069,231,496,157,284,74,212,68,114,44,213,257,228,89,25,88,100,604,9.09
2246,"LeBron James\jamesle01","2003-04",19,"CLE","NBA",5.1,79,79,3122,622,1492,559,1275,63,217,347,460,99,333,432,465,130,58,273,149,1654,18.76
2247,"Amir Johnson\johnsam01","2014-15",27,"TOR","NBA",5.1,75,72,1979,298,519,279,473,19,46,79,129,159,297,456,117,44,59,110,225,694,10.39
2248,"Ervin Johnson\johnser02","2000-01",33,"MIL","NBA",5.1,82,19,1981,108,198,108,198,0,0,50,93,205,408,613,40,44,97,47,257,266,6.57
2249,"James Johnson\johnsja01","2016-17",29,"MIA","NBA",5.1,76,5,2085,368,769,281,513,87,256,152,215,66,310,376,276,76,86,171,197,975,13.66
2250,"Joe Johnson\johnsjo02","2006-07",25,"ATL","NBA",5.1,57,57,2359,536,1139,417,827,119,312,235,314,53,186,239,249,60,11,176,115,1426,20.16
2251,"Joe Johnson\johnsjo02","2012-13",31,"BRK","NBA",5.1,72,72,2642,445,1052,297,657,148,395,132,161,53,165,218,253,49,14,123,99,1170,12.82
2252,"Kevin Johnson\johnske02","1992-93",26,"PHO","NBA",5.1,49,47,1643,282,565,281,557,1,8,226,276,30,74,104,384,85,19,151,100,791,18.31
2253,"Larry Johnson\johnsla02","1999-00",30,"NYK","NBA",5.1,70,68,2281,282,652,224,478,58,174,128,167,87,293,380,175,42,7,94,205,750,10.17
2254,"Kyle Korver\korveky01","2010-11",29,"CHI","NBA",5.1,82,0,1649,242,557,122,268,120,289,77,87,12,138,150,124,35,20,60,156,681,7.07
2255,"Christian Laettner\laettch01","1999-00",30,"DET","NBA",5.1,82,82,2443,379,801,372,777,7,24,237,292,175,378,553,186,83,45,186,326,1002,12.64
2256,"Grant Long\longgr01","1993-94",27,"MIA","NBA",5.1,69,59,2201,300,672,299,666,1,6,187,238,190,305,495,170,89,26,125,244,788,12.19
2257,"Robin Lopez\lopezro01","2014-15",26,"POR","NBA",5.1,59,59,1638,234,437,234,436,0,1,98,127,190,204,394,55,16,84,73,122,566,10.39
2258,"Jeff McInnis\mcinnje01","2001-02",27,"LAC","NBA",5.1,81,80,3030,463,1121,388,887,75,234,183,219,45,168,213,500,63,6,147,202,1184,13.24
2259,"Aaron McKie\mckieaa01","2002-03",30,"PHI","NBA",5.1,80,40,2374,286,666,249,554,37,112,112,134,61,289,350,278,131,9,109,177,721,10.4
2260,"Nate McMillan\mcmilna01","1994-95",30,"SEA","NBA",5.1,80,18,2070,166,397,113,242,53,155,34,58,65,237,302,421,165,53,126,275,419,10.19
2261,"Jodie Meeks\meeksjo01","2010-11",23,"PHI","NBA",5.1,74,64,2062,242,570,104,222,138,348,152,170,21,150,171,78,63,4,60,97,774,8.83
2262,"Brad Miller\millebr01","2008-09",32,"TOT","NBA",5.1,70,43,2100,292,614,269,558,23,56,224,272,150,395,545,234,52,36,130,223,831,13.68
2263,"Chris Mills\millsch01","1997-98",28,"NYK","NBA",5.1,80,29,2183,292,675,252,538,40,137,152,189,120,288,408,133,45,30,107,218,776,9.1
2264,"Patty Mills\millspa02","2016-17",28,"SAS","NBA",5.1,80,8,1754,273,621,126,266,147,355,66,80,24,117,141,280,65,3,101,109,759,9.34
2265,"Jamal Murray\murraja01","2018-19",21,"DEN","NBA",5.1,75,74,2447,513,1173,361,759,152,414,189,223,65,252,317,363,67,27,158,153,1367,16.06
2266,"Morris Peterson\petermo01","2004-05",27,"TOR","NBA",5.1,82,61,2510,356,848,227,513,129,335,188,226,71,269,340,169,91,18,93,219,1029,11.23
2267,"Scottie Pippen\pippesc01","2000-01",35,"POR","NBA",5.1,64,60,2133,269,596,205,410,64,186,119,161,70,263,333,294,94,35,154,158,721,13.31
2268,"Scot Pollard\pollasc01","1999-00",24,"SAC","NBA",5.1,76,5,1336,149,283,149,283,0,0,114,159,168,236,404,43,55,59,50,213,412,7.15
2269,"Jakob Pöltl\poeltja01","2018-19",23,"SAS","NBA",5.1,77,24,1273,187,290,187,290,0,0,49,92,178,232,410,93,29,68,48,124,423,7.58
2270,"Olden Polynice\polynol01","1993-94",29,"TOT","NBA",5.1,68,65,2402,346,662,346,660,0,2,97,191,299,510,809,41,42,67,78,189,789,12.76
2271,"Donald Royal\royaldo01","1992-93",26,"ORL","NBA",5.1,77,0,1636,194,391,194,388,0,3,318,390,116,179,295,80,36,25,113,179,706,9.2
2272,"Latrell Sprewell\sprewla01","2000-01",30,"NYK","NBA",5.1,77,77,3017,524,1219,483,1084,41,135,275,351,49,298,347,269,106,28,218,159,1364,14.84
2273,"Jason Terry\terryja01","2003-04",26,"ATL","NBA",5.1,81,78,3018,499,1196,353,775,146,421,215,260,49,287,336,437,124,16,229,192,1359,15.79
2274,"Kemba Walker\walkeke02","2013-14",23,"CHA","NBA",5.1,73,73,2614,449,1143,340,816,109,327,282,337,39,267,306,447,86,32,169,128,1289,16.3
2275,"Rasheed Wallace\wallara01","2008-09",34,"DET","NBA",5.1,66,63,2123,302,720,189,401,113,319,78,101,56,434,490,91,62,86,59,197,795,11.89
2276,"Clarence Weatherspoon\weathcl01","1999-00",29,"MIA","NBA",5.1,78,2,1615,215,419,215,419,0,0,135,183,128,321,449,93,51,49,100,165,565,8.57
2277,"Spud Webb\webbsp01","1993-94",30,"SAC","NBA",5.1,79,62,2567,373,810,318,646,55,164,204,251,44,178,222,528,93,23,168,182,1005,14.38
2278,"Spud Webb\webbsp01","1994-95",31,"SAC","NBA",5.1,76,76,2458,302,689,254,544,48,145,226,242,29,145,174,468,75,8,185,148,878,13
2279,"Lou Williams\willilo02","2010-11",24,"PHI","NBA",5.1,75,0,1747,323,795,235,542,88,253,293,356,32,117,149,252,47,17,102,128,1027,11.59
2280,"Lou Williams\willilo02","2018-19",32,"LAC","NBA",5.1,75,1,1993,484,1138,379,847,105,291,425,485,40,182,222,402,57,11,181,80,1498,17.41
2281,"Walt Williams\williwa02","1995-96",25,"TOT","NBA",5.1,73,73,2169,359,808,245,515,114,293,163,232,99,220,319,230,85,58,151,238,995,13.15
2282,"Walt Williams\williwa02","1994-95",24,"SAC","NBA",5.1,77,77,2739,445,998,342,702,103,296,266,364,100,245,345,316,123,63,243,265,1259,15.92
2283,"Corliss Williamson\willico02","2001-02",28,"DET","NBA",5.1,78,7,1701,411,806,410,801,1,5,240,298,117,202,319,94,49,26,137,226,1063,11.55
2284,"Brandan Wright\wrighbr03","2013-14",26,"DAL","NBA",5.1,58,0,1077,224,331,224,331,0,0,77,106,102,142,244,31,32,55,35,94,525,9.67
2285,"Mahmoud Abdul-Rauf\abdulma02","1994-95",25,"DEN","NBA",5,73,43,2082,472,1005,389,790,83,215,138,156,32,105,137,263,77,9,119,126,1165,13.22
2286,"Rafer Alston\alstora01","2007-08",31,"HOU","NBA",5,74,74,2526,364,924,221,517,143,407,98,137,28,232,260,392,98,18,160,139,969,12.72
2287,"Carmelo Anthony\anthoca01","2008-09",24,"DEN","NBA",5,66,66,2277,535,1207,472,1037,63,170,371,468,106,344,450,222,75,24,199,195,1504,19.11
2288,"Ömer Aşık\asikom01","2014-15",28,"NOP","NBA",5,76,76,1982,213,412,213,412,0,0,131,225,244,504,748,72,29,54,95,144,557,9.64
2289,"Leandro Barbosa\barbole01","2008-09",26,"PHO","NBA",5,70,11,1705,366,759,276,519,90,240,171,194,34,147,181,162,82,7,93,115,993,12.45
2290,"Nicolas Batum\batumni01","2015-16",27,"CHO","NBA",5,70,70,2448,372,873,233,474,139,399,163,192,55,373,428,403,65,43,205,114,1046,16.01
2291,"Muggsy Bogues\boguemu01","1996-97",32,"CHH","NBA",5,65,65,1880,204,443,144,299,60,144,54,64,25,116,141,469,82,2,108,114,522,11.66
2292,"Vince Carter\cartevi01","1998-99",22,"TOR","NBA",5,50,49,1760,345,766,326,700,19,66,204,268,94,189,283,149,55,77,110,140,913,16.31
2293,"Bimbo Coles\colesbi01","1995-96",27,"TOT","NBA",5,81,55,2615,318,777,230,523,88,254,168,211,49,211,260,422,94,17,171,253,892,11.89
2294,"Nick Collison\collini01","2008-09",28,"OKC","NBA",5,71,40,1831,243,428,243,426,0,2,98,136,181,308,489,66,51,50,73,239,584,9.78
2295,"Tyrone Corbin\corbity01","1996-97",34,"ATL","NBA",5,70,65,2305,253,600,179,392,74,208,86,108,76,218,294,124,90,7,85,176,666,9.11
2296,"Jamal Crawford\crawfja01","2007-08",27,"NYK","NBA",5,80,80,3190,570,1391,394,897,176,494,329,381,37,170,207,398,81,17,192,144,1645,16.66
2297,"Dell Curry\curryde01","1993-94",29,"CHH","NBA",5,82,0,2173,533,1171,381,793,152,378,117,134,71,191,262,221,98,27,120,161,1335,13.39
2298,"Antonio Davis\davisan01","1993-94",25,"IND","NBA",5,81,4,1732,216,425,216,424,0,1,194,302,190,315,505,55,45,84,107,189,626,8.84
2299,"Ed Davis\davised01","2017-18",28,"POR","NBA",5,78,0,1471,170,292,170,291,0,1,74,111,183,392,575,40,32,52,66,188,414,7.55
2300,"Ricky Davis\davisri01","2005-06",26,"TOT","NBA",5,78,78,3207,584,1304,511,1062,73,242,275,345,65,286,351,394,91,17,213,190,1516,17.02
2301,"Terry Dehere\deherte01","1995-96",24,"LAC","NBA",5,82,10,2018,315,686,176,370,139,316,247,327,41,102,143,350,54,16,191,239,1016,12.16
2302,"Michael Finley\finlemi01","2005-06",32,"SAS","NBA",5,77,18,2038,286,695,176,416,110,279,98,115,31,216,247,116,37,7,62,97,780,8.09
2303,"Rudy Gay\gayru01","2007-08",21,"MEM","NBA",5,81,81,3000,625,1355,491,968,134,387,248,316,140,359,499,158,111,79,190,230,1632,17.07
2304,"Manu Ginóbili\ginobma01","2008-09",31,"SAS","NBA",5,44,7,1181,223,491,154,282,69,209,168,190,24,174,198,157,64,16,88,90,683,15.55
2305,"Harvey Grant\grantha01","1992-93",27,"WSB","NBA",5,72,72,2667,560,1149,559,1139,1,10,218,300,133,279,412,205,72,44,90,168,1339,15.79
2306,"A.C. Green\greenac01","1999-00",36,"LAL","NBA",5,82,82,1929,173,387,172,383,1,4,66,95,160,326,486,80,53,18,53,127,413,6.29
2307,"Tom Gugliotta\guglito01","1997-98",28,"MIN","NBA",5,41,41,1582,319,635,317,618,2,17,183,223,106,250,356,167,61,22,109,102,823,20.14
2308,"Anfernee Hardaway\hardaan01","1998-99",27,"ORL","NBA",5,50,50,1944,301,717,261,577,40,140,149,211,74,210,284,266,111,23,150,111,791,16.23
2309,"Brendan Haywood\haywobr01","2002-03",23,"WAS","NBA",5,81,69,1930,173,339,173,339,0,0,155,245,192,212,404,29,32,119,65,225,501,7.33
2310,"Nenê Hilário\hilarne01","2002-03",20,"DEN","NBA",5,80,53,2258,321,619,321,616,0,3,197,341,208,283,491,149,127,65,181,295,839,11.87
2311,"Zydrunas Ilgauskas\ilgauzy01","2002-03",27,"CLE","NBA",5,81,81,2432,495,1122,495,1117,0,5,400,512,240,371,611,127,56,152,210,274,1390,15.48
2312,"Joe Ingles\inglejo01","2016-17",29,"UTA","NBA",5,82,26,1972,204,451,81,172,123,279,50,68,23,238,261,225,96,8,107,163,581,8.58
2313,"Kyrie Irving\irvinky01","2015-16",23,"CLE","NBA",5,53,53,1667,394,879,310,617,84,262,169,191,44,113,157,249,56,18,124,107,1041,16.61
2314,"Reggie Jackson\jacksre01","2018-19",28,"DET","NBA",5,82,82,2289,441,1047,267,576,174,471,204,236,45,171,216,344,55,9,148,208,1260,13.16
2315,"Stephen Jackson\jacksst02","2009-10",31,"TOT","NBA",5,81,81,3129,600,1418,471,1025,129,393,338,434,78,323,401,300,132,43,259,197,1667,17.39
2316,"Amir Johnson\johnsam01","2016-17",29,"BOS","NBA",5,80,77,1608,213,370,186,304,27,66,67,100,118,248,366,140,51,62,77,211,520,8.4
2317,"James Johnson\johnsja01","2017-18",30,"MIA","NBA",5,73,41,1943,309,614,252,429,57,185,113,162,61,297,358,280,70,51,141,192,788,12.43
2318,"Eddie Jones\jonesed02","1994-95",23,"LAL","NBA",5,64,58,1981,342,744,251,498,91,246,122,169,79,170,249,128,131,41,75,175,897,13.17
2319,"Christian Laettner\laettch01","1992-93",23,"MIN","NBA",5,81,81,2823,503,1061,499,1021,4,40,462,553,171,537,708,223,105,83,275,290,1472,18.48
2320,"David Lee\leeda02","2011-12",28,"GSW","NBA",5,57,57,2121,464,922,464,917,0,5,219,280,171,374,545,162,54,22,149,179,1147,18.66
2321,"Corey Maggette\maggeco01","2002-03",23,"LAC","NBA",5,64,57,2006,343,773,281,596,62,177,325,405,77,245,322,123,55,16,147,194,1073,14.35
2322,"Shawn Marion\mariosh01","2009-10",31,"DAL","NBA",5,75,75,2385,395,778,392,759,3,19,105,139,158,319,477,107,69,61,99,141,898,11.67
2323,"Donyell Marshall\marshdo01","2001-02",28,"UTA","NBA",5,58,42,1750,343,661,330,619,13,42,160,226,158,285,443,101,50,67,124,150,859,14.69
2324,"Kenyon Martin\martike01","2007-08",30,"DEN","NBA",5,71,71,2159,376,699,374,688,2,11,123,212,105,356,461,90,88,85,91,235,877,12.64
2325,"Derrick McKey\mckeyde01","1993-94",27,"IND","NBA",5,76,76,2613,355,710,346,679,9,31,192,254,129,273,402,327,111,49,228,248,911,14.03
2326,"Mike Miller\millemi01","2007-08",27,"MEM","NBA",5,70,70,2474,414,824,259,465,155,359,164,212,51,416,467,240,35,16,182,145,1147,15.97
2327,"Donovan Mitchell\mitchdo01","2018-19",22,"UTA","NBA",5,77,77,2598,661,1530,473,1011,188,519,319,396,59,257,316,322,106,31,218,208,1829,19.11
2328,"Jameer Nelson\nelsoja01","2009-10",27,"ORL","NBA",5,65,64,1860,317,706,231,480,86,226,98,116,26,168,194,353,48,2,139,147,818,12.58
2329,"Dirk Nowitzki\nowitdi01","2012-13",34,"DAL","NBA",5,53,47,1661,343,728,278,571,65,157,166,193,37,326,363,132,38,37,70,93,917,15.76
2330,"Hakeem Olajuwon\olajuha01","2000-01",38,"HOU","NBA",5,58,55,1545,283,568,283,567,0,1,123,198,124,307,431,72,70,88,81,141,689,12.57
2331,"Greg Ostertag\ostergr01","2003-04",30,"UTA","NBA",5,78,51,2153,208,437,208,436,0,1,113,195,221,357,578,123,30,139,99,228,529,9.21
2332,"Zaza Pachulia\pachuza01","2011-12",27,"ATL","NBA",5,58,44,1640,169,339,169,339,0,0,117,158,154,303,457,79,55,29,81,172,455,10.04
2333,"Bobby Phills\phillbo01","1996-97",27,"CLE","NBA",5,69,65,2375,328,766,243,550,85,216,125,174,63,182,245,233,113,21,135,174,866,12.03
2334,"Terry Porter\portete01","1998-99",35,"MIA","NBA",5,50,1,1365,172,370,114,229,58,141,123,148,13,127,140,146,48,11,74,97,525,10.77
2335,"Isaiah Rider\rideris01","1996-97",25,"POR","NBA",5,76,68,2563,456,983,357,726,99,257,212,261,94,210,304,198,45,19,212,199,1223,13.37
2336,"D'Angelo Russell\russeda01","2018-19",22,"BRK","NBA",5,81,81,2448,659,1517,425,882,234,635,160,205,53,262,315,563,100,20,253,141,1712,18.89
2337,"Tomáš Satoranský\satorto01","2017-18",26,"WAS","NBA",5,73,30,1643,201,384,154,283,47,101,75,96,72,161,233,286,52,15,83,131,524,9.36
2338,"Dennis Scott\scottde01","1993-94",25,"ORL","NBA",5,82,37,2283,384,949,229,561,155,388,123,159,54,164,218,216,81,32,93,161,1046,10.52
2339,"J.R. Smith\smithjr01","2010-11",25,"DEN","NBA",5,79,6,1968,341,784,217,466,124,318,163,221,45,277,322,175,92,16,100,173,969,11.24
2340,"Rik Smits\smitsri01","1995-96",29,"IND","NBA",5,63,63,1901,466,894,465,889,1,5,231,293,119,314,433,110,21,45,160,226,1164,15.91
2341,"Rodney Stuckey\stuckro01","2010-11",24,"DET","NBA",5,70,54,2183,363,827,337,737,26,90,330,381,70,146,216,361,76,10,155,177,1082,15
2342,"Jayson Tatum\tatumja01","2018-19",20,"BOS","NBA",5,79,79,2455,466,1036,350,725,116,311,195,228,70,407,477,168,84,57,122,168,1243,14.22
2343,"Isaiah Thomas\thomais02","2012-13",23,"SAC","NBA",5,79,62,2122,366,832,251,511,115,321,253,287,29,132,161,316,67,3,140,167,1100,12.72
2344,"Kurt Thomas\thomaku01","2003-04",31,"NYK","NBA",5,80,75,2548,392,829,392,826,0,3,106,127,145,517,662,149,56,80,132,298,890,11.74
2345,"P.J. Tucker\tuckepj01","2018-19",33,"HOU","NBA",5,82,82,2802,207,523,61,136,146,387,41,59,121,358,479,96,132,39,63,252,601,8.89
2346,"Antoine Walker\walkean02","1999-00",23,"BOS","NBA",5,82,82,3003,648,1506,575,1221,73,285,311,445,199,453,652,305,117,32,259,263,1680,17.62
2347,"Rasheed Wallace\wallara01","1998-99",24,"POR","NBA",5,49,18,1414,242,476,229,445,13,31,131,179,57,184,241,60,48,54,80,175,628,12.18
2348,"Clarence Weatherspoon\weathcl01","1996-97",26,"PHI","NBA",5,82,82,2949,398,811,397,805,1,6,206,279,219,460,679,140,74,86,137,187,1003,13.04
2349,"Martell Webster\webstma02","2013-14",27,"WAS","NBA",5,78,13,2157,254,587,108,215,146,372,105,125,38,184,222,97,41,15,58,150,759,8.33
2350,"Aaron Williams\williaa01","2001-02",30,"NJN","NBA",5,82,13,1546,231,439,231,437,0,2,130,186,115,224,339,77,29,76,79,212,592,7.64
2351,"Jerome Williams\willije01","2001-02",28,"TOR","NBA",5,68,32,1641,190,388,190,388,0,0,138,204,165,221,386,75,78,25,68,153,518,8.8
2352,"Marvin Williams\willima02","2016-17",30,"CHO","NBA",5,76,76,2295,297,704,173,350,124,354,131,150,89,411,500,106,58,53,60,134,849,11.01
2353,"Marvin Williams\willima02","2017-18",31,"CHO","NBA",5,78,78,2006,258,563,132,258,126,305,102,123,74,296,370,96,56,38,66,116,744,9.52
2354,"Ray Allen\allenra02","1996-97",21,"MIL","NBA",4.9,82,81,2532,390,908,273,610,117,298,205,249,97,229,326,210,75,10,149,218,1102,11.76
2355,"Shandon Anderson\andersh01","1999-00",26,"HOU","NBA",4.9,82,82,2700,368,778,289,553,79,225,194,253,91,293,384,239,96,32,194,182,1009,12.53
2356,"Carmelo Anthony\anthoca01","2004-05",20,"DEN","NBA",4.9,75,75,2608,530,1230,488,1072,42,158,456,573,141,285,426,194,68,30,224,229,1558,16.77
2357,"Darrell Armstrong\armstda01","2002-03",34,"ORL","NBA",4.9,82,23,2350,263,643,185,411,78,232,165,188,91,204,295,323,135,13,160,167,769,11.01
2358,"Chucky Atkins\atkinch01","2006-07",32,"MEM","NBA",4.9,75,23,2064,310,715,194,409,116,306,252,311,18,121,139,346,50,4,127,136,988,12.51
2359,"Harrison Barnes\barneha02","2015-16",23,"GSW","NBA",4.9,66,59,2042,295,633,213,419,82,214,102,134,77,248,325,117,41,10,57,136,774,10.55
2360,"Brent Barry\barrybr01","1995-96",24,"LAC","NBA",4.9,79,44,1898,283,597,160,301,123,296,111,137,38,130,168,230,95,22,120,196,800,10.42
2361,"Andray Blatche\blatcan01","2012-13",26,"BRK","NBA",4.9,82,8,1555,346,676,343,654,3,22,148,216,161,256,417,85,86,54,123,163,843,10.14
2362,"Keith Bogans\boganke01","2007-08",27,"ORL","NBA",4.9,82,35,2198,241,588,93,179,148,409,81,110,42,224,266,104,59,10,53,164,711,7.68
2363,"Primož Brezec\brezepr01","2004-05",25,"CHA","NBA",4.9,72,72,2276,387,756,387,756,0,0,164,220,226,305,531,86,33,55,106,183,938,12.3
2364,"Kwame Brown\brownkw01","2003-04",21,"WAS","NBA",4.9,74,57,2239,288,589,287,587,1,2,228,334,178,372,550,112,66,52,140,144,805,11.71
2365,"Michael Cage\cagemi01","1993-94",32,"SEA","NBA",4.9,82,42,1708,171,314,171,313,0,1,36,74,164,280,444,45,77,38,51,179,378,6.39
2366,"Tyson Chandler\chandty01","2013-14",31,"NYK","NBA",4.9,55,55,1662,191,322,191,321,0,1,98,155,159,370,529,59,36,63,71,145,480,11.66
2367,"Jason Collins\collija04","2003-04",25,"NJN","NBA",4.9,78,78,2220,163,384,163,382,0,2,136,184,143,257,400,153,67,56,97,251,462,7.85
2368,"Samuel Dalembert\dalemsa01","2013-14",32,"DAL","NBA",4.9,80,68,1614,214,377,214,376,0,1,101,137,200,341,541,38,41,94,90,210,529,8.58
2369,"Glen Davis\davisgl01","2010-11",25,"BOS","NBA",4.9,78,13,2298,359,801,357,786,2,15,195,265,101,324,425,92,78,30,85,231,915,10.3
2370,"Boris Diaw\diawbo01","2013-14",31,"SAS","NBA",4.9,79,24,1974,302,580,257,468,45,112,68,92,74,252,326,222,44,32,121,140,717,9.8
2371,"Gorgui Dieng\dienggo01","2014-15",25,"MIN","NBA",4.9,73,49,2193,259,512,258,506,1,6,191,244,223,386,609,146,71,126,126,188,710,12.86
2372,"Luka Dončić\doncilu01","2018-19",19,"DAL","NBA",4.9,72,72,2318,506,1186,338,672,168,514,346,485,86,477,563,429,77,25,247,137,1526,20.31
2373,"Mike Dunleavy\dunlemi02","2004-05",24,"GSW","NBA",4.9,79,79,2570,408,905,301,629,107,276,134,172,97,338,435,203,79,26,132,198,1057,12.47
2374,"Monta Ellis\ellismo01","2013-14",28,"DAL","NBA",4.9,82,82,3023,576,1278,507,1069,69,209,339,430,38,257,295,471,141,23,264,197,1560,17.86
2375,"Maurice Evans\evansma01","2007-08",29,"TOT","NBA",4.9,75,47,1720,262,545,181,336,81,209,59,83,92,126,218,81,46,10,40,142,664,7.66
2376,"Pat Garrity\garripa01","2002-03",26,"ORL","NBA",4.9,81,53,2584,312,744,151,337,161,407,83,100,72,234,306,121,62,20,77,255,868,9.24
2377,"Marcin Gortat\gortama01","2017-18",33,"WAS","NBA",4.9,82,82,2075,290,560,290,560,0,0,110,163,181,442,623,151,40,61,99,175,690,10.13
2378,"Brian Grant\grantbr01","2003-04",31,"MIA","NBA",4.9,76,76,2303,289,613,289,612,0,1,86,110,174,350,524,69,51,35,82,254,664,8.87
2379,"Blake Griffin\griffbl01","2017-18",28,"TOT","NBA",4.9,58,58,1970,436,996,325,674,111,322,259,330,73,355,428,334,41,18,165,139,1242,19.82
2380,"Gordon Hayward\haywago01","2011-12",21,"UTA","NBA",4.9,66,58,2015,267,586,212,427,55,159,193,232,59,171,230,207,53,41,109,106,782,11.84
2381,"Gordon Hayward\haywago01","2018-19",28,"BOS","NBA",4.9,72,18,1863,296,635,219,404,77,231,156,187,51,271,322,244,62,23,105,104,825,12
2382,"John Henson\hensojo01","2017-18",27,"MIL","NBA",4.9,76,69,1970,287,502,286,495,1,7,90,158,150,363,513,114,45,109,84,202,665,10.62
2383,"Tyrone Hill\hillty01","1992-93",24,"GSW","NBA",4.9,74,66,2070,251,494,251,490,0,4,138,221,255,499,754,68,41,40,92,320,640,10.54
2384,"Robert Horry\horryro01","1995-96",25,"HOU","NBA",4.9,71,71,2634,300,732,158,344,142,388,111,143,97,315,412,281,116,109,160,197,853,14.11
2385,"Eddie House\houseed01","2008-09",30,"BOS","NBA",4.9,81,0,1479,249,560,98,220,151,340,42,53,11,146,157,92,61,7,55,113,691,7.25
2386,"Juwan Howard\howarju01","2001-02",28,"TOT","NBA",4.9,81,72,2635,462,1005,462,1003,0,2,261,343,223,389,612,169,46,47,152,265,1185,13.28
2387,"Juwan Howard\howarju01","2006-07",33,"HOU","NBA",4.9,80,38,2123,309,665,309,665,0,0,155,188,138,332,470,131,29,8,112,205,773,9.15
2388,"Jim Jackson\jacksji01","1994-95",24,"DAL","NBA",4.9,51,51,1982,484,1026,449,916,35,110,306,380,120,140,260,191,28,12,160,92,1309,20.17
2389,"Reggie Jackson\jacksre01","2013-14",23,"OKC","NBA",4.9,80,36,2277,403,916,320,671,83,245,158,177,43,270,313,331,85,9,168,142,1047,12.6
2390,"Reggie Jackson\jacksre01","2014-15",24,"TOT","NBA",4.9,77,40,2268,432,996,360,755,72,241,181,218,56,271,327,462,62,9,186,167,1117,14.29
2391,"Al Jefferson\jeffeal01","2008-09",24,"MIN","NBA",4.9,50,50,1836,485,975,485,971,0,4,186,252,172,376,548,79,39,83,92,141,1156,20.25
2392,"Ervin Johnson\johnser02","1999-00",32,"MIL","NBA",4.9,80,74,2129,144,279,144,278,0,1,95,157,233,415,648,44,81,127,80,298,383,8.5
2393,"Joe Johnson\johnsjo02","2013-14",32,"BRK","NBA",4.9,79,79,2575,462,1018,300,614,162,404,159,195,48,222,270,216,47,10,120,129,1245,12.86
2394,"Larry Johnson\johnsla02","1998-99",29,"NYK","NBA",4.9,49,48,1639,210,458,177,366,33,92,134,164,91,193,284,119,34,10,89,147,587,11.76
2395,"Brevin Knight\knighbr01","2005-06",30,"CHA","NBA",4.9,69,67,2351,308,772,305,759,3,13,252,314,35,188,223,610,157,4,164,202,871,16.01
2396,"Jeremy Lamb\lambje01","2017-18",25,"CHO","NBA",4.9,80,18,1967,380,832,286,578,94,254,179,208,49,275,324,186,61,32,93,138,1033,11.68
2397,"Andrew Lang\langan01","1994-95",28,"ATL","NBA",4.9,82,63,2340,320,677,318,674,2,3,152,188,154,302,456,72,45,144,108,271,794,9.91
2398,"Grant Long\longgr01","1998-99",32,"ATL","NBA",4.9,50,13,1380,151,359,148,341,3,18,184,235,100,196,296,53,57,16,74,143,489,10.03
2399,"Brook Lopez\lopezbr01","2016-17",28,"BRK","NBA",4.9,75,75,2222,555,1172,421,785,134,387,295,364,121,282,403,176,38,124,184,192,1539,17.63
2400,"Kevin Love\loveke01","2009-10",21,"MIN","NBA",4.9,60,22,1714,291,646,256,540,35,106,225,276,227,431,658,136,43,23,117,136,842,15.06
2401,"Kyle Lowry\lowryky01","2011-12",25,"HOU","NBA",4.9,47,38,1510,210,513,131,302,79,211,171,198,37,176,213,310,73,14,130,133,670,16.36
2402,"Kenyon Martin\martike01","2001-02",24,"NJN","NBA",4.9,73,73,2504,445,962,430,895,15,67,181,267,113,275,388,192,90,121,172,261,1086,13.98
2403,"Anthony Mason\masonan01","1993-94",27,"NYK","NBA",4.9,73,12,1903,206,433,206,432,0,1,116,161,158,269,427,151,31,9,107,190,528,8.26
2404,"JaVale McGee\mcgeeja01","2012-13",25,"DEN","NBA",4.9,79,0,1433,303,527,302,526,1,1,110,186,158,223,381,24,30,157,90,184,717,9.47
2405,"Jeff McInnis\mcinnje01","2003-04",29,"TOT","NBA",4.9,70,57,2365,334,747,288,620,46,127,114,143,33,143,176,430,72,6,120,163,828,12.5
2406,"Josh McRoberts\mcrobjo01","2010-11",23,"IND","NBA",4.9,72,51,1597,211,386,188,326,23,60,88,119,109,273,382,150,47,57,93,165,533,9.44
2407,"Jamario Moon\moonja01","2008-09",28,"TOT","NBA",4.9,80,60,2068,222,474,157,291,65,183,68,80,58,307,365,95,86,60,43,133,577,8.37
2408,"Chris Mullin\mullich01","1992-93",29,"GSW","NBA",4.9,46,46,1902,474,930,414,797,60,133,183,226,42,190,232,166,68,41,139,76,1191,22.13
2409,"Lamond Murray\murrala01","1997-98",24,"LAC","NBA",4.9,79,65,2579,473,984,419,831,54,153,220,294,172,312,484,142,118,54,171,193,1220,14.43
2410,"Tracy Murray\murratr01","1995-96",24,"TOR","NBA",4.9,82,37,2458,496,1092,345,734,151,358,182,219,114,238,352,131,87,40,132,208,1325,13.31
2411,"Larry Nance\nancela02","2018-19",26,"CLE","NBA",4.9,67,30,1795,249,479,216,381,33,98,96,134,168,384,552,214,100,40,97,192,627,13.06
2412,"Jameer Nelson\nelsoja01","2005-06",23,"ORL","NBA",4.9,62,33,1784,347,719,277,554,70,165,141,181,39,141,180,302,70,9,148,174,905,14.26
2413,"Jermaine O'Neal\onealje01","2005-06",27,"IND","NBA",4.9,51,47,1802,380,805,377,795,3,10,261,368,102,374,476,133,27,117,151,177,1024,18.86
2414,"Victor Oladipo\oladivi01","2015-16",23,"ORL","NBA",4.9,72,52,2379,425,970,327,688,98,282,205,247,48,297,345,282,116,54,153,174,1153,15.51
2415,"Anthony Parker\parkean01","2009-10",34,"CLE","NBA",4.9,81,81,2289,206,475,98,214,108,261,75,95,30,201,231,157,63,18,71,151,595,7.59
2416,"Morris Peterson\petermo01","2003-04",26,"TOR","NBA",4.9,82,29,2148,238,587,112,247,126,340,76,94,35,226,261,113,88,14,69,206,678,7.76
2417,"Morris Peterson\petermo01","2001-02",24,"TOR","NBA",4.9,63,56,1988,336,768,252,537,84,231,127,169,91,132,223,153,73,11,86,174,883,11.75
2418,"Paul Pierce\piercpa01","1998-99",21,"BOS","NBA",4.9,48,47,1632,284,647,200,443,84,204,139,195,117,192,309,115,82,50,113,139,791,15.63
2419,"Scottie Pippen\pippesc01","1998-99",33,"HOU","NBA",4.9,50,50,2011,261,604,189,392,72,212,132,183,63,260,323,293,98,37,159,118,726,16.91
2420,"Leon Powe\powele01","2008-09",25,"BOS","NBA",4.9,70,7,1227,177,338,177,338,0,0,184,267,145,200,345,46,24,38,76,192,538,8
2421,"Bryant Reeves\reevebr01","1997-98",24,"VAN","NBA",4.9,74,74,2527,492,941,492,937,0,4,223,316,196,389,585,155,39,80,156,278,1207,15.48
2422,"Rajon Rondo\rondora01","2011-12",25,"BOS","NBA",4.9,53,53,1957,256,572,246,530,10,42,108,181,62,195,257,620,95,3,193,99,630,17.67
2423,"Derrick Rose\rosede01","2008-09",20,"CHI","NBA",4.9,81,80,3000,574,1208,558,1136,16,72,197,250,96,221,317,512,66,18,202,125,1361,15.9
2424,"Arvydas Sabonis\sabonar01","2002-03",38,"POR","NBA",4.9,78,1,1209,172,361,169,355,3,6,129,164,88,247,335,142,61,49,75,141,476,7.78
2425,"Josh Smith\smithjo03","2008-09",23,"ATL","NBA",4.9,69,69,2421,418,849,392,762,26,87,211,359,134,364,498,169,94,111,161,184,1073,15.59
2426,"Erick Strickland\stricer01","1999-00",26,"DAL","NBA",4.9,68,67,2025,316,730,243,544,73,186,162,195,69,254,323,211,105,13,102,190,867,12.65
2427,"Rod Strickland\stricro02","2001-02",35,"MIA","NBA",4.9,76,64,2294,316,714,308,688,8,26,154,201,49,183,232,463,82,11,159,114,794,11.95
2428,"Bob Sura\surabo01","1999-00",26,"CLE","NBA",4.9,73,45,2216,356,815,234,483,122,332,175,251,50,238,288,284,91,19,148,201,1009,13.27
2429,"Jeff Teague\teaguje01","2017-18",29,"MIN","NBA",4.9,70,70,2311,354,794,270,566,84,228,202,239,24,185,209,492,102,23,177,171,994,15.87
2430,"Klay Thompson\thompkl01","2017-18",27,"GSW","NBA",4.9,73,73,2506,575,1179,346,658,229,521,82,98,31,246,277,185,55,34,128,117,1461,16.14
2431,"P.J. Tucker\tuckepj01","2014-15",29,"PHO","NBA",4.9,78,63,2383,261,596,174,344,87,252,104,143,114,388,502,122,107,23,96,179,713,10.18
2432,"Hedo Türkoğlu\turkohe01","2006-07",27,"ORL","NBA",4.9,73,73,2268,345,823,236,542,109,281,171,219,57,236,293,233,70,16,143,221,970,11.98
2433,"Nick Van Exel\vanexni01","1999-00",28,"DEN","NBA",4.9,79,79,2950,473,1213,340,812,133,401,196,240,34,277,311,714,68,11,221,148,1275,16.42
2434,"Charlie Villanueva\villach01","2008-09",24,"MIL","NBA",4.9,78,47,2095,487,1089,398,831,89,258,201,240,154,366,520,137,50,56,138,254,1264,13.77
2435,"Dwyane Wade\wadedw01","2015-16",34,"MIA","NBA",4.9,74,73,2258,540,1183,533,1139,7,44,322,406,82,220,302,344,79,42,203,116,1409,16.67
2436,"Marvin Williams\willima02","2011-12",25,"ATL","NBA",4.9,57,37,1500,203,470,145,321,58,149,115,146,76,218,294,71,47,18,39,84,579,9.57
2437,"Corliss Williamson\willico02","2002-03",29,"DET","NBA",4.9,82,1,2061,374,826,372,815,2,11,237,300,147,211,358,104,44,27,126,238,987,9.9
2438,"Dorell Wright\wrighdo01","2012-13",27,"PHI","NBA",4.9,79,8,1783,237,599,102,238,135,361,120,141,42,260,302,150,62,35,64,98,729,8.97
2439,"Ryan Anderson\anderry01","2017-18",29,"HOU","NBA",4.8,66,50,1725,207,480,76,141,131,339,72,93,94,237,331,60,24,21,42,126,617,8.61
2440,"Greg Anthony\anthogr01","1995-96",28,"VAN","NBA",4.8,69,68,2096,324,781,234,510,90,271,229,297,29,145,174,476,116,11,160,137,967,15.21
2441,"Shane Battier\battish01","2001-02",23,"MEM","NBA",4.8,78,78,3097,412,961,309,685,103,276,198,283,180,238,418,216,121,81,155,215,1125,13.84
2442,"Nicolas Batum\batumni01","2011-12",23,"POR","NBA",4.8,59,34,1791,289,641,182,367,107,274,133,159,81,190,271,84,57,60,90,105,818,12.55
2443,"Patrick Beverley\beverpa01","2018-19",30,"LAC","NBA",4.8,78,49,2137,194,477,82,195,112,282,96,123,76,312,388,300,67,43,85,265,596,10.14
2444,"Mike Bibby\bibbymi01","2009-10",31,"ATL","NBA",4.8,80,80,2195,268,644,142,320,126,324,68,79,20,164,184,310,67,3,90,157,730,9.27
2445,"DeJuan Blair\blairde01","2010-11",21,"SAS","NBA",4.8,81,65,1734,292,583,292,581,0,2,90,137,215,350,565,77,95,42,113,213,674,9.48
2446,"Andrew Bogut\bogutan01","2007-08",23,"MIL","NBA",4.8,78,78,2720,465,910,465,903,0,7,189,322,245,518,763,199,64,135,172,254,1119,15.61
2447,"Avery Bradley\bradlav01","2015-16",25,"BOS","NBA",4.8,76,72,2536,456,1019,309,612,147,407,96,123,48,172,220,158,117,19,109,164,1155,12.4
2448,"Greg Buckner\buckngr01","2004-05",28,"DEN","NBA",4.8,70,41,1522,160,303,111,182,49,121,63,81,66,142,208,133,75,6,49,169,432,7.6
2449,"Andrew Bynum\bynuman01","2007-08",20,"LAL","NBA",4.8,35,25,1008,189,297,189,297,0,0,82,118,105,251,356,61,12,72,52,98,460,16.02
2450,"Mario Chalmers\chalmma01","2013-14",27,"MIA","NBA",4.8,73,73,2178,254,560,167,334,87,226,121,163,41,173,214,357,119,16,162,210,716,11.98
2451,"Erick Dampier\dampier01","2005-06",30,"DAL","NBA",4.8,82,36,1934,171,347,171,347,0,0,127,215,273,367,640,51,27,106,115,263,469,7.95
2452,"Hubert Davis\davishu01","1994-95",24,"NYK","NBA",4.8,82,4,1697,296,617,165,329,131,288,97,120,30,80,110,150,35,11,87,146,820,8.4
2453,"Todd Day\dayto01","1994-95",25,"MIL","NBA",4.8,82,81,2717,445,1049,282,631,163,418,257,341,95,227,322,134,104,63,157,283,1310,13.3
2454,"Carlos Delfino\delfica01","2009-10",27,"MIL","NBA",4.8,75,66,2279,299,732,165,367,134,365,93,119,51,343,394,202,80,21,119,138,825,10.87
2455,"Boris Diaw\diawbo01","2010-11",28,"CHA","NBA",4.8,82,82,2778,381,774,303,548,78,226,84,123,105,309,414,337,74,46,166,190,924,12.52
2456,"Spencer Dinwiddie\dinwisp01","2018-19",25,"BRK","NBA",4.8,68,4,1914,366,828,242,458,124,370,287,356,26,140,166,311,40,17,152,187,1143,14.97
2457,"Jared Dudley\dudleja01","2012-13",27,"PHO","NBA",4.8,79,50,2170,313,669,207,398,106,271,129,162,79,166,245,203,75,8,101,128,861,10.45
2458,"Chris Duhon\duhonch01","2006-07",24,"CHI","NBA",4.8,78,30,1906,197,483,109,238,88,245,76,101,23,146,169,310,69,6,105,150,558,8.29
2459,"Kevin Durant\duranke01","2014-15",26,"OKC","NBA",4.8,27,27,913,238,467,174,308,64,159,146,171,16,162,178,110,24,25,74,40,686,23.48
2460,"Mario Elie\eliema01","1994-95",31,"HOU","NBA",4.8,81,13,1896,243,487,163,286,80,201,144,171,50,146,196,189,65,12,104,158,710,9.13
2461,"Patrick Ewing\ewingpa01","1999-00",37,"NYK","NBA",4.8,62,62,2035,361,775,361,773,0,2,207,283,140,464,604,58,36,84,142,196,929,14.15
2462,"Jamie Feick\feickja01","1999-00",25,"NJN","NBA",4.8,81,17,2241,181,423,178,420,3,3,94,133,264,491,755,68,43,38,59,206,459,7.89
2463,"Rudy Gay\gayru01","2013-14",27,"TOT","NBA",4.8,73,73,2531,537,1179,472,982,65,197,318,387,113,324,437,209,95,56,224,171,1457,17.45
2464,"Taj Gibson\gibsota01","2014-15",29,"CHI","NBA",4.8,62,17,1692,254,506,254,506,0,0,132,184,162,234,396,71,36,75,77,162,640,10.7
2465,"Ryan Gomes\gomesry01","2007-08",25,"MIN","NBA",4.8,82,74,2434,392,857,333,678,59,179,190,229,133,342,475,145,65,10,96,154,1033,11.44
2466,"Brian Grant\grantbr01","2001-02",29,"MIA","NBA",4.8,72,72,2256,286,610,286,608,0,2,101,119,168,407,575,137,48,31,122,236,673,10.4
2467,"A.C. Green\greenac01","1996-97",33,"TOT","NBA",4.8,83,73,2492,234,484,233,464,1,20,128,197,222,434,656,69,70,16,74,145,597,8.63
2468,"Jeff Green\greenje02","2010-11",24,"TOT","NBA",4.8,75,51,2427,368,820,304,609,64,211,198,244,73,287,360,108,53,37,99,210,998,11.35
2469,"Tim Hardaway\hardati02","2016-17",24,"ATL","NBA",4.8,79,30,2154,415,912,266,495,149,417,164,214,35,189,224,182,55,15,106,103,1143,11.81
2470,"Tobias Harris\harrito02","2014-15",22,"ORL","NBA",4.8,68,63,2369,442,949,355,710,87,239,193,245,73,357,430,124,69,36,115,134,1164,14.83
2471,"Jason Hart\hartja01","2004-05",26,"CHA","NBA",4.8,74,27,1887,257,573,222,478,35,95,157,200,18,185,203,367,99,14,102,167,706,11.32
2472,"Udonis Haslem\hasleud01","2003-04",23,"MIA","NBA",4.8,75,24,1795,205,447,205,444,0,3,140,183,189,284,473,51,33,24,74,197,550,7.69
2473,"Tyrone Hill\hillty01","1997-98",29,"MIL","NBA",4.8,57,56,2064,208,418,208,417,0,1,155,255,212,396,608,88,67,30,106,230,571,12.53
2474,"Robert Horry\horryro01","2002-03",32,"LAL","NBA",4.8,80,26,2343,184,476,133,299,51,177,103,134,181,333,514,233,96,61,112,247,522,9.47
2475,"Jarrett Jack\jackja01","2009-10",26,"TOR","NBA",4.8,82,43,2243,323,671,241,472,82,199,203,241,30,192,222,413,60,6,163,151,931,12.41
2476,"Jarrett Jack\jackja01","2006-07",23,"POR","NBA",4.8,79,79,2651,320,705,257,525,63,180,243,279,18,190,208,417,86,9,187,202,946,13.08
2477,"Stephen Jackson\jacksst02","2002-03",24,"SAS","NBA",4.8,80,58,2254,356,818,261,521,95,297,139,183,66,220,286,183,125,30,176,202,946,11.08
2478,"Eddie Johnson\johnsed03","1992-93",33,"SEA","NBA",4.8,82,0,1869,463,991,446,935,17,56,234,257,124,148,272,135,36,4,134,173,1177,10.99
2479,"Kevin Johnson\johnske02","1994-95",28,"PHO","NBA",4.8,47,35,1352,246,523,242,497,4,26,234,289,32,83,115,360,47,18,105,88,730,16.98
2480,"Fred Jones\jonesfr01","2004-05",25,"IND","NBA",4.8,77,14,2268,275,647,188,418,87,229,176,207,34,208,242,196,61,31,114,171,813,10.06
2481,"Courtney Lee\leeco01","2014-15",29,"MEM","NBA",4.8,77,74,2354,288,643,198,419,90,224,111,129,21,157,178,151,75,12,78,129,777,9.03
2482,"Wesley Matthews\matthwe02","2011-12",25,"POR","NBA",4.8,66,53,2228,314,763,185,426,129,337,147,171,56,168,224,113,96,15,73,148,904,11.53
2483,"Luc Mbah a Moute\mbahalu01","2010-11",24,"MIL","NBA",4.8,79,52,2093,198,428,198,421,0,7,133,188,169,251,420,68,72,28,77,180,529,7.52
2484,"Aaron McKie\mckieaa01","2003-04",31,"PHI","NBA",4.8,75,41,2112,265,577,190,405,75,172,84,111,45,208,253,195,85,23,103,142,689,9.59
2485,"Mike Miller\millemi01","2006-07",26,"MEM","NBA",4.8,70,69,2740,465,1010,263,512,202,498,161,203,52,326,378,298,54,18,179,138,1293,16.88
2486,"Patty Mills\millspa02","2015-16",27,"SAS","NBA",4.8,81,3,1662,260,612,137,292,123,320,47,58,27,131,158,226,59,6,76,102,690,7.97
2487,"Alonzo Mourning\mournal01","2005-06",35,"MIA","NBA",4.8,65,20,1302,188,315,188,314,0,1,133,224,125,234,359,11,13,173,79,177,509,9.43
2488,"Eduardo Nájera\najered01","2006-07",30,"DEN","NBA",4.8,75,36,1658,204,354,203,342,1,12,88,123,131,179,310,64,73,26,56,207,497,7.69
2489,"Steve Nash\nashst01","1997-98",23,"PHO","NBA",4.8,76,9,1664,268,584,187,389,81,195,74,86,32,128,160,262,63,4,98,145,691,9.18
2490,"Dirk Nowitzki\nowitdi01","2017-18",39,"DAL","NBA",4.8,77,77,1900,346,758,208,421,138,337,97,108,22,416,438,120,43,45,51,146,927,11.22
2491,"Kyle O'Quinn\oquinky01","2017-18",27,"NYK","NBA",4.8,77,10,1387,224,384,220,367,4,17,98,127,121,349,470,158,36,98,100,192,550,9.9
2492,"Zaza Pachulia\pachuza01","2006-07",22,"ATL","NBA",4.8,72,47,2026,291,614,291,613,0,1,293,373,199,301,500,106,77,36,162,267,875,12.58
2493,"Mason Plumlee\plumlma01","2014-15",24,"BRK","NBA",4.8,82,45,1743,280,489,280,486,0,3,157,317,175,337,512,74,65,63,106,207,717,9.61
2494,"Zach Randolph\randoza01","2002-03",21,"POR","NBA",4.8,77,11,1301,264,515,264,510,0,5,122,161,139,204,343,41,42,14,62,141,650,7.76
2495,"J.J. Redick\redicjj01","2016-17",32,"LAC","NBA",4.8,78,78,2198,396,890,195,422,201,468,180,202,11,160,171,110,54,13,98,125,1173,11.64
2496,"Glenn Robinson\robingl01","1999-00",27,"MIL","NBA",4.8,81,81,2909,690,1461,604,1224,86,237,227,283,107,378,485,193,78,41,223,212,1693,16.79
2497,"Jalen Rose\roseja01","2004-05",32,"TOR","NBA",4.8,81,65,2710,527,1159,419,885,108,274,333,390,44,232,276,209,63,10,180,190,1495,14.8
2498,"Brandon Roy\roybr01","2006-07",22,"POR","NBA",4.8,57,55,2015,349,765,294,619,55,146,202,241,58,192,250,230,67,10,116,139,955,15.41
2499,"John Salley\sallejo01","1993-94",29,"MIA","NBA",4.8,76,45,1910,208,436,206,433,2,3,164,225,132,275,407,135,56,78,94,260,582,9.26
2500,"Charles Smith\smithch01","1994-95",29,"NYK","NBA",4.8,76,58,2150,352,747,345,716,7,31,255,322,144,180,324,120,49,95,147,286,966,11.66
2501,"Bryant Stith\stithbr01","2000-01",30,"BOS","NBA",4.8,78,74,2504,245,611,154,369,91,242,175,207,65,219,284,168,93,14,90,182,756,9.58
2502,"Peja Stojaković\stojape01","1999-00",22,"SAC","NBA",4.8,74,11,1749,321,717,221,450,100,267,135,153,74,202,276,106,52,7,88,97,877,9.97
2503,"Jared Sullinger\sullija01","2015-16",23,"BOS","NBA",4.8,81,73,1915,351,806,322,703,29,103,103,161,194,479,673,187,75,47,102,209,834,11.05
2504,"Bob Sura\surabo01","2004-05",31,"HOU","NBA",4.8,61,59,1922,215,504,160,349,55,155,141,188,79,258,337,317,65,7,147,168,626,12.57
2505,"Stromile Swift\swiftst01","2003-04",24,"MEM","NBA",4.8,77,10,1528,268,571,267,567,1,4,190,262,141,237,378,38,56,118,88,188,727,9.38
2506,"Keith Van Horn\vanhoke01","1997-98",22,"NJN","NBA",4.8,62,62,2325,446,1047,377,823,69,224,258,305,142,266,408,106,64,25,164,216,1219,15.56
2507,"Kemba Walker\walkeke02","2012-13",22,"CHA","NBA",4.8,82,82,2859,526,1244,419,912,107,332,296,371,60,223,283,471,160,31,200,153,1455,16.94
2508,"Gerald Wallace\wallage01","2011-12",29,"TOT","NBA",4.8,58,58,2076,287,632,241,482,46,150,180,225,87,299,386,164,85,36,111,145,800,14.38
2509,"David Wesley\wesleda01","1998-99",28,"CHH","NBA",4.8,50,50,1848,243,545,182,375,61,170,159,191,23,138,161,322,100,10,142,130,706,16.11
2510,"Aaron Williams\williaa01","1999-00",28,"WAS","NBA",4.8,81,0,1545,235,450,235,447,0,3,146,201,159,250,409,58,41,92,80,234,616,8.43
2511,"Buck Williams\willibu01","1996-97",36,"NYK","NBA",4.8,74,4,1496,175,326,175,325,0,1,115,179,166,231,397,53,40,38,79,204,465,7.35
2512,"Jason Williams\willija02","2005-06",30,"MIA","NBA",4.8,59,56,1874,268,606,161,318,107,288,85,98,6,133,139,287,53,5,100,101,728,12.18
2513,"Jerome Williams\willije01","1998-99",25,"DET","NBA",4.8,50,10,1154,124,248,124,248,0,0,107,159,158,191,349,23,63,7,41,108,355,8.68
2514,"Reggie Williams\willire01","1993-94",29,"DEN","NBA",4.8,82,68,2654,418,1014,354,784,64,230,165,225,98,294,392,300,117,66,163,288,1065,12.54
2515,"Ray Allen\allenra02","2011-12",36,"BOS","NBA",4.7,46,42,1565,226,493,120,259,106,234,97,106,14,128,142,109,49,8,68,83,655,12.7
2516,"Tony Allen\allento01","2010-11",29,"MEM","NBA",4.7,72,31,1494,251,492,247,469,4,23,137,182,70,123,193,104,129,44,86,161,643,9.59
2517,"Carmelo Anthony\anthoca01","2016-17",32,"NYK","NBA",4.7,74,74,2538,602,1389,451,968,151,421,304,365,62,376,438,213,60,34,153,198,1659,17.72
2518,"Carlos Arroyo\arroyca01","2003-04",24,"UTA","NBA",4.7,71,71,2008,339,768,301,651,38,117,181,225,41,144,185,355,63,5,156,165,897,12.2
2519,"Dana Barros\barroda01","1993-94",26,"PHI","NBA",4.7,81,70,2519,412,878,277,524,135,354,116,145,28,168,196,424,107,5,167,96,1075,13.57
2520,"Brandon Bass\bassbr01","2011-12",26,"BOS","NBA",4.7,59,39,1868,303,632,303,632,0,0,132,163,95,270,365,55,34,54,65,135,738,11.2
2521,"Brandon Bass\bassbr01","2012-13",27,"BOS","NBA",4.7,81,69,2239,286,589,286,587,0,2,129,150,129,296,425,84,44,64,80,188,701,8.79
2522,"Mookie Blaylock\blaylmo01","1998-99",31,"ATL","NBA",4.7,48,48,1763,247,651,170,400,77,251,69,91,45,179,224,278,99,9,115,61,640,13.83
2523,"Elden Campbell\campbel01","1997-98",29,"LAL","NBA",4.7,81,28,1784,289,624,288,622,1,2,237,342,143,312,455,78,35,102,115,209,816,9.82
2524,"Sam Cassell\cassesa01","1994-95",25,"HOU","NBA",4.7,82,1,1882,253,593,190,402,63,191,214,254,38,173,211,405,94,14,167,209,783,11.28
2525,"Keon Clark\clarkke01","2002-03",27,"SAC","NBA",4.7,80,11,1780,226,451,226,447,0,4,84,128,138,313,451,80,38,150,94,227,536,8.41
2526,"Jason Collins\collija04","2002-03",24,"NJN","NBA",4.7,81,66,1900,140,338,140,334,0,4,180,236,136,232,368,87,47,44,85,252,460,6.7
2527,"Nick Collison\collini01","2009-10",29,"OKC","NBA",4.7,75,5,1557,182,309,181,305,1,4,74,107,152,232,384,38,37,48,63,230,439,7.11
2528,"DeMarcus Cousins\couside01","2017-18",27,"NOP","NBA",4.7,48,48,1737,406,864,302,570,104,294,294,394,105,512,617,257,79,76,242,183,1210,26.8
2529,"Eddy Curry\curryed01","2006-07",24,"NYK","NBA",4.7,81,81,2849,585,1016,584,1015,1,1,405,659,195,376,571,68,34,40,295,265,1576,16.48
2530,"Stephen Curry\curryst01","2009-10",21,"GSW","NBA",4.7,80,77,2896,528,1143,362,763,166,380,177,200,48,308,356,472,152,19,243,252,1399,17.99
2531,"Bison Dele\delebi01","1993-94",24,"DEN","NBA",4.7,80,1,1507,251,464,251,461,0,3,137,211,138,308,446,50,49,87,104,221,639,8.85
2532,"DeMar DeRozan\derozde01","2012-13",23,"TOR","NBA",4.7,82,82,3013,548,1231,514,1111,34,120,355,427,48,272,320,204,76,24,151,173,1485,14.36
2533,"Boris Diaw\diawbo01","2008-09",26,"TOT","NBA",4.7,81,59,2754,448,884,373,703,75,181,101,147,118,314,432,333,61,53,215,202,1072,13.8
2534,"Goran Dragić\dragigo01","2015-16",29,"MIA","NBA",4.7,72,72,2363,417,875,353,670,64,205,120,165,54,223,277,419,71,17,185,188,1018,14.46
2535,"Chris Dudley\dudlech02","1995-96",30,"POR","NBA",4.7,80,61,1924,162,358,162,357,0,1,80,157,239,481,720,37,41,100,79,251,404,7.65
2536,"Michael Finley\finlemi01","2006-07",33,"SAS","NBA",4.7,82,16,1823,273,663,169,377,104,286,90,98,34,189,223,108,32,16,46,76,740,7.19
2537,"Channing Frye\fryech01","2010-11",27,"PHO","NBA",4.7,77,64,2541,358,829,187,390,171,439,89,107,65,448,513,96,46,79,73,272,976,11.76
2538,"Matt Geiger\geigema01","1998-99",29,"PHI","NBA",4.7,50,40,1540,266,555,265,550,1,5,141,177,137,225,362,58,39,40,101,157,674,12.6
2539,"Taj Gibson\gibsota01","2009-10",24,"CHI","NBA",4.7,82,70,2204,311,629,311,629,0,0,113,175,226,385,611,70,50,104,114,282,735,9.88
2540,"Eric Gordon\gordoer01","2017-18",29,"HOU","NBA",4.7,69,30,2154,415,970,197,362,218,608,195,241,25,145,170,154,44,27,130,116,1243,13.77
2541,"Brian Grant\grantbr01","1995-96",23,"SAC","NBA",4.7,78,75,2398,427,842,423,825,4,17,262,358,175,370,545,127,40,103,185,269,1120,13.87
2542,"Jeff Green\greenje02","2012-13",26,"BOS","NBA",4.7,81,17,2252,376,806,306,624,70,182,214,265,55,263,318,128,56,68,132,175,1036,11.39
2543,"Matt Harpring\harprma01","2006-07",30,"UTA","NBA",4.7,77,2,1965,322,656,309,617,13,39,237,309,117,236,353,99,52,11,118,232,894,10.45
2544,"Matt Harpring\harprma01","2005-06",29,"UTA","NBA",4.7,71,32,1944,322,678,308,639,14,39,227,313,158,210,368,98,59,14,109,202,885,11.12
2545,"Lucious Harris\harrilu01","2002-03",32,"NJN","NBA",4.7,77,25,1973,298,721,251,585,47,136,152,189,63,169,232,155,53,8,71,95,795,8.5
2546,"Allan Houston\houstal01","1996-97",25,"NYK","NBA",4.7,81,81,2681,437,1032,289,648,148,384,175,218,43,197,240,179,41,18,167,233,1197,11.2
2547,"Allan Houston\houstal01","2001-02",30,"NYK","NBA",4.7,77,77,2914,568,1301,432,955,136,346,295,339,37,215,252,190,54,10,170,182,1567,15.07
2548,"Al Jefferson\jeffeal01","2014-15",30,"CHO","NBA",4.7,65,61,1992,486,1010,484,1005,2,5,108,165,99,449,548,113,47,84,68,139,1082,14.63
2549,"Richard Jefferson\jefferi01","2001-02",21,"NJN","NBA",4.7,79,9,1917,270,591,257,535,13,56,189,265,85,208,293,140,64,48,107,211,742,9.1
2550,"James Jones\jonesja02","2010-11",30,"MIA","NBA",4.7,81,8,1549,146,346,23,59,123,287,60,72,23,137,160,43,29,19,21,129,475,5.22
2551,"Kerry Kittles\kittlke01","1999-00",25,"NJN","NBA",4.7,62,61,1896,305,698,209,458,96,240,101,127,46,179,225,142,79,19,56,120,807,11.48
2552,"Linas Kleiza\kleizli01","2007-08",23,"DEN","NBA",4.7,79,13,1889,311,659,217,382,94,277,164,213,92,241,333,95,44,19,89,181,880,9.88
2553,"Toni Kukoč\kukocto01","2000-01",32,"TOT","NBA",4.7,65,19,1597,275,582,205,425,70,157,101,160,66,193,259,199,48,11,111,98,721,10.75
2554,"Courtney Lee\leeco01","2013-14",28,"TOT","NBA",4.7,79,47,1973,295,614,223,420,72,194,99,112,29,158,187,115,65,28,73,127,761,8.66
2555,"Kevin Martin\martike02","2008-09",25,"SAC","NBA",4.7,51,46,1947,341,811,226,534,115,277,457,527,29,154,183,138,61,8,146,116,1254,20.22
2556,"Desmond Mason\masonde01","2001-02",24,"SEA","NBA",4.7,75,20,2420,357,769,341,710,16,59,201,237,92,259,351,104,67,27,104,170,931,10.94
2557,"Roger Mason\masonro01","2008-09",28,"SAS","NBA",4.7,82,71,2496,349,822,183,428,166,394,105,118,16,235,251,173,40,12,100,160,969,9.73
2558,"Wesley Matthews\matthwe02","2012-13",26,"POR","NBA",4.7,69,69,2403,352,808,183,383,169,425,149,187,35,156,191,174,90,18,109,172,1022,12.79
2559,"Luc Mbah a Moute\mbahalu01","2009-10",23,"MIL","NBA",4.7,73,62,1866,177,369,171,352,6,17,93,133,171,229,400,81,60,39,70,181,453,7.58
2560,"Paul Millsap\millspa01","2006-07",21,"UTA","NBA",4.7,82,1,1472,209,398,208,395,1,3,140,208,183,240,423,62,67,74,94,236,559,8.15
2561,"Donatas Motiejūnas\motiedo01","2014-15",24,"HOU","NBA",4.7,71,62,2037,353,700,304,567,49,133,100,166,137,284,421,130,56,34,123,203,855,11.54
2562,"Chris Mullin\mullich01","1993-94",30,"GSW","NBA",4.7,62,39,2324,410,869,355,718,55,151,165,219,64,281,345,315,107,53,178,114,1040,17.37
2563,"Dikembe Mutombo\mutomdi01","2004-05",38,"HOU","NBA",4.7,80,2,1212,108,217,108,217,0,0,106,143,150,276,426,10,16,101,51,135,322,5.78
2564,"Jusuf Nurkić\nurkiju01","2017-18",23,"POR","NBA",4.7,79,79,2088,480,951,480,944,0,7,172,273,189,519,708,143,64,111,183,247,1132,14.47
2565,"Jermaine O'Neal\onealje01","2006-07",28,"IND","NBA",4.7,69,69,2459,498,1141,498,1134,0,7,343,447,153,508,661,167,50,182,203,232,1339,18.21
2566,"Lamar Odom\odomla01","2006-07",27,"LAL","NBA",4.7,56,56,2202,319,681,265,499,54,182,198,283,102,445,547,270,53,32,163,182,890,17.68
2567,"Lamar Odom\odomla01","2004-05",25,"LAL","NBA",4.7,64,64,2320,366,774,330,657,36,117,207,298,134,519,653,238,42,65,161,211,975,16.54
2568,"Kelly Olynyk\olynyke01","2018-19",27,"MIA","NBA",4.7,79,36,1812,261,564,148,245,113,319,152,185,72,303,375,140,53,37,114,183,787,10.26
2569,"Zaza Pachulia\pachuza01","2016-17",32,"GSW","NBA",4.7,70,70,1268,164,307,164,305,0,2,98,126,140,270,410,132,59,33,87,166,426,8.63
2570,"Will Perdue\perduwi01","1994-95",29,"CHI","NBA",4.7,78,78,1592,254,459,254,458,0,1,113,194,211,311,522,90,26,56,116,220,621,9.05
2571,"Will Perdue\perduwi01","1997-98",32,"SAS","NBA",4.7,79,30,1491,162,295,162,294,0,1,70,133,177,358,535,57,22,50,81,137,394,6.81
2572,"Mason Plumlee\plumlma01","2013-14",23,"BRK","NBA",4.7,70,22,1275,199,302,199,299,0,3,122,195,99,209,308,60,49,55,77,171,520,8.74
2573,"Joel Przybilla\przybjo01","2004-05",25,"POR","NBA",4.7,76,50,1858,199,333,199,333,0,0,90,174,178,410,588,74,24,163,98,239,488,9.55
2574,"Glenn Robinson\robingl01","1996-97",24,"MIL","NBA",4.7,80,79,3114,669,1438,606,1258,63,180,288,364,130,372,502,248,103,68,269,225,1689,18.06
2575,"Glenn Robinson\robingl01","2001-02",29,"MIL","NBA",4.7,66,63,2346,536,1147,478,969,58,178,236,282,70,336,406,168,97,41,174,173,1366,17.65
2576,"Rodney Rogers\rogerro01","2000-01",29,"PHO","NBA",4.7,82,3,2183,377,876,321,687,56,189,188,247,94,265,359,180,97,47,157,269,998,11.12
2577,"Domantas Sabonis\sabondo01","2017-18",21,"IND","NBA",4.7,74,19,1810,340,661,327,624,13,37,168,224,165,407,572,151,40,32,137,220,861,12.28
2578,"Tomáš Satoranský\satorto01","2018-19",27,"WAS","NBA",4.7,80,54,2164,257,530,193,368,64,162,131,160,82,197,279,399,82,13,120,172,709,11.39
2579,"Pascal Siakam\siakapa01","2017-18",23,"TOR","NBA",4.7,81,5,1679,253,498,224,366,29,132,54,87,79,285,364,159,62,42,67,166,589,8.35
2580,"Joe Smith\smithjo02","1999-00",24,"MIN","NBA",4.7,78,9,1975,289,623,288,622,1,1,195,258,186,298,484,88,45,85,119,302,774,10.1
2581,"Felton Spencer\spencfe01","1993-94",26,"UTA","NBA",4.7,79,79,2210,256,507,256,507,0,0,165,272,235,423,658,43,41,67,127,304,677,9.66
2582,"Jerry Stackhouse\stackje01","1997-98",23,"TOT","NBA",4.7,79,37,2545,424,975,377,780,47,195,354,450,105,161,266,241,89,59,224,175,1249,13.96
2583,"Damon Stoudamire\stoudda01","1997-98",24,"TOT","NBA",4.7,71,71,2839,448,1091,357,787,91,304,238,287,87,211,298,580,113,7,223,150,1225,17.8
2584,"Myles Turner\turnemy01","2017-18",21,"IND","NBA",4.7,65,62,1836,306,639,250,482,56,157,160,206,93,324,417,87,38,118,96,186,828,12.82
2585,"Fred VanVleet\vanvlfr01","2017-18",23,"TOR","NBA",4.7,76,0,1520,232,545,124,284,108,261,84,101,25,159,184,243,68,19,74,130,656,9.02
2586,"Antoine Walker\walkean02","1997-98",21,"BOS","NBA",4.7,82,82,3268,722,1705,631,1413,91,292,305,473,270,566,836,273,142,60,292,262,1840,19.24
2587,"Ben Wallace\wallabe01","2009-10",35,"DET","NBA",4.7,69,67,1975,158,292,158,290,0,2,65,160,245,352,597,105,86,84,64,131,381,9.55
2588,"Hakim Warrick\warriha01","2008-09",26,"MEM","NBA",4.7,82,7,2029,340,693,335,670,5,23,266,374,129,277,406,66,48,39,98,170,951,10.28
2589,"Jason Williams\willija02","2002-03",27,"MEM","NBA",4.7,76,76,2407,333,859,190,455,143,404,110,131,25,187,212,631,91,10,168,130,919,14.04
2590,"Lou Williams\willilo02","2015-16",29,"LAL","NBA",4.7,67,35,1907,283,693,173,373,110,320,352,424,31,138,169,167,62,19,107,107,1028,13.24
2591,"Metta World Peace\artesro01","2007-08",28,"SAC","NBA",4.7,57,54,2172,436,962,352,741,84,221,212,295,101,227,328,199,133,38,148,159,1168,18.7
2592,"Shareef Abdur-Rahim\abdursh01","1998-99",22,"VAN","NBA",4.6,50,50,2021,386,893,375,857,11,36,369,439,114,260,374,172,69,55,186,137,1152,20.62
2593,"Michael Adams\adamsmi01","1992-93",30,"WSB","NBA",4.6,70,70,2499,365,831,297,619,68,212,237,277,52,188,240,526,100,4,175,146,1035,16.43
2594,"Greg Anthony\anthogr01","1992-93",25,"NYK","NBA",4.6,70,35,1699,174,419,170,389,4,30,107,159,42,128,170,398,113,12,104,141,459,9.75
2595,"Vincent Askew\askewvi01","1994-95",28,"SEA","NBA",4.6,71,1,1721,248,504,217,410,31,94,176,238,65,116,181,176,49,13,85,191,703,9.55
2596,"Harrison Barnes\barneha02","2016-17",24,"DAL","NBA",4.6,79,79,2803,599,1280,521,1058,78,222,242,281,93,301,394,116,65,15,102,128,1518,14.69
2597,"Nicolas Batum\batumni01","2016-17",28,"CHO","NBA",4.6,77,77,2617,393,975,258,570,135,405,243,284,46,435,481,456,86,29,194,109,1164,16.11
2598,"Michael Beasley\beaslmi01","2009-10",21,"MIA","NBA",4.6,78,78,2328,468,1040,440,938,28,102,192,240,123,375,498,100,80,49,131,221,1156,12.56
2599,"David Benoit\benoida01","1994-95",26,"UTA","NBA",4.6,71,67,1841,285,587,247,472,38,115,132,157,96,272,368,58,45,47,75,183,740,9.84
2600,"DeJuan Blair\blairde01","2009-10",20,"SAS","NBA",4.6,82,23,1494,275,495,275,493,0,2,88,161,200,326,526,65,50,39,112,224,638,8.6
2601,"Primož Brezec\brezepr01","2005-06",26,"CHA","NBA",4.6,79,79,2165,409,791,409,789,0,2,164,224,181,259,440,45,19,32,85,227,982,10.34
2602,"Scott Brooks\brooksc01","1992-93",27,"HOU","NBA",4.6,82,0,1516,183,385,142,286,41,99,112,135,22,77,99,243,79,3,72,136,519,7.37
2603,"P.J. Brown\brownpj01","1994-95",25,"NJN","NBA",4.6,80,63,2466,254,570,250,546,4,24,139,207,178,309,487,135,69,135,80,262,651,9.74
2604,"Rasual Butler\butlera01","2008-09",29,"NOH","NBA",4.6,82,74,2614,348,803,208,444,140,359,86,110,49,222,271,75,51,61,59,159,922,9.07
2605,"Matt Carroll\carroma01","2006-07",26,"CHA","NBA",4.6,72,47,1878,285,658,174,391,111,267,188,208,35,172,207,91,53,9,73,176,869,10
2606,"Kelvin Cato\catoke01","2003-04",29,"HOU","NBA",4.6,69,67,1743,161,360,161,360,0,0,96,142,153,319,472,72,52,96,84,203,418,8.27
2607,"Josh Childress\childjo01","2004-05",21,"ATL","NBA",4.6,80,44,2376,302,642,289,586,13,56,190,231,195,287,482,151,74,35,106,184,807,10.74
2608,"Nick Collison\collini01","2006-07",26,"SEA","NBA",4.6,82,56,2378,318,636,318,634,0,2,154,199,229,437,666,82,48,66,123,289,790,10.63
2609,"Seth Curry\curryse01","2016-17",26,"DAL","NBA",4.6,70,42,2029,338,703,201,381,137,322,85,100,25,154,179,189,79,7,92,126,898,11.76
2610,"Tony Delk\delkto01","2002-03",29,"BOS","NBA",4.6,67,39,1873,233,560,113,256,120,304,68,87,41,191,232,146,72,10,69,124,654,9.28
2611,"Tony Delk\delkto01","2000-01",27,"PHO","NBA",4.6,82,11,2288,383,923,329,755,54,168,185,235,76,185,261,160,75,17,101,171,1005,9.7
2612,"Boris Diaw\diawbo01","2006-07",24,"PHO","NBA",4.6,73,59,2268,306,569,291,524,15,45,82,120,91,226,317,352,28,38,154,177,709,11.58
2613,"Sherman Douglas\douglsh01","1996-97",30,"MIL","NBA",4.6,79,79,2316,306,610,268,496,38,114,114,171,57,136,193,427,78,10,153,191,764,11.36
2614,"Jared Dudley\dudleja01","2015-16",30,"WAS","NBA",4.6,81,41,2098,233,487,133,249,100,238,72,98,54,232,286,170,75,18,80,190,638,8.65
2615,"Mario Elie\eliema01","1999-00",36,"SAS","NBA",4.6,79,79,2217,195,457,121,271,74,186,126,149,48,201,249,193,73,9,130,156,590,8.26
2616,"Monta Ellis\ellismo01","2012-13",27,"MIL","NBA",4.6,82,82,3076,597,1436,503,1108,94,328,289,374,45,271,316,496,169,36,254,164,1577,17.61
2617,"Tyreke Evans\evansty01","2014-15",25,"NOP","NBA",4.6,79,76,2690,521,1165,452,938,69,227,202,291,82,334,416,521,100,37,246,198,1313,16.8
2618,"Kenneth Faried\farieke01","2011-12",22,"DEN","NBA",4.6,46,39,1037,181,309,181,309,0,0,109,164,142,210,352,36,34,47,54,116,471,11.7
2619,"Randy Foye\foyera01","2013-14",30,"DEN","NBA",4.6,81,78,2485,361,875,172,377,189,498,157,185,36,196,232,287,67,39,145,205,1068,12.06
2620,"Chris Gatling\gatlich01","1995-96",28,"TOT","NBA",4.6,71,2,1427,326,567,326,566,0,1,139,207,129,288,417,43,36,40,95,217,791,10.68
2621,"Kendall Gill\gillke01","1994-95",26,"SEA","NBA",4.6,73,58,2125,392,858,329,687,63,171,155,209,99,191,290,192,117,28,138,186,1002,12.65
2622,"Eric Gordon\gordoer01","2008-09",20,"LAC","NBA",4.6,78,65,2677,411,901,280,564,131,337,299,350,45,156,201,215,78,35,164,172,1252,14.09
2623,"Gary Harris\harriga01","2016-17",22,"DEN","NBA",4.6,57,56,1782,320,637,213,382,107,255,104,134,48,130,178,164,71,8,76,92,851,13.75
2624,"Carl Herrera\herreca01","1992-93",26,"HOU","NBA",4.6,81,12,1800,240,444,240,442,0,2,125,176,148,306,454,61,47,35,92,190,605,8.22
2625,"Robert Horry\horryro01","2004-05",34,"SAS","NBA",4.6,75,16,1396,157,375,106,237,51,138,86,109,91,177,268,80,67,60,69,138,451,6.86
2626,"Robert Horry\horryro01","2003-04",33,"SAS","NBA",4.6,81,1,1290,141,348,100,240,41,108,69,107,108,164,272,101,48,49,55,165,392,5.57
2627,"Juwan Howard\howarju01","1997-98",24,"WAS","NBA",4.6,64,64,2559,463,991,463,989,0,2,258,358,161,288,449,208,82,23,185,225,1184,16.54
2628,"Lindsey Hunter\hunteli01","2000-01",30,"MIL","NBA",4.6,82,5,2002,298,783,146,376,152,407,77,96,32,137,169,222,102,12,68,172,825,8.8
2629,"Marc Jackson\jacksma02","2004-05",30,"PHI","NBA",4.6,81,23,1976,340,731,340,729,0,2,289,349,184,222,406,81,32,18,131,171,969,10.28
2630,"Stephen Jackson\jacksst02","2007-08",29,"GSW","NBA",4.6,73,73,2855,488,1204,306,703,182,501,308,370,67,251,318,300,92,29,197,171,1466,17.03
2631,"Al Jefferson\jeffeal01","2009-10",25,"MIN","NBA",4.6,76,76,2463,560,1125,560,1121,0,4,181,266,180,523,703,137,63,98,136,205,1301,15.95
2632,"Adam Keefe\keefead01","1995-96",25,"UTA","NBA",4.6,82,0,1708,180,346,180,342,0,4,139,201,176,279,455,64,51,41,88,174,499,7.45
2633,"Andrei Kirilenko\kirilan01","2008-09",27,"UTA","NBA",4.6,67,10,1831,256,570,236,497,20,73,244,311,84,235,319,175,83,77,121,127,776,12.53
2634,"Kyle Korver\korveky01","2006-07",25,"PHI","NBA",4.6,74,1,2288,372,845,240,538,132,307,191,209,30,229,259,105,57,20,117,188,1067,11.69
2635,"Kyle Korver\korveky01","2005-06",24,"PHI","NBA",4.6,82,43,2563,327,761,143,323,184,438,101,119,27,243,270,163,65,26,98,224,939,10.19
2636,"Shaun Livingston\livinsh01","2015-16",30,"GSW","NBA",4.6,78,3,1520,203,379,201,367,2,12,80,93,42,127,169,237,57,27,78,140,488,7.8
2637,"Darrick Martin\martida01","1996-97",25,"LAC","NBA",4.6,82,64,1820,292,718,201,484,91,234,218,250,26,87,113,339,57,2,127,165,893,10.19
2638,"Wesley Matthews\matthwe02","2009-10",23,"UTA","NBA",4.6,82,48,2025,273,565,210,400,63,165,160,193,50,141,191,124,64,15,93,152,769,8.62
2639,"Antonio McDyess\mcdyean01","2005-06",31,"DET","NBA",4.6,82,0,1733,285,560,285,558,0,2,68,122,156,280,436,90,46,48,76,220,638,7.99
2640,"Andre Miller\millean02","2002-03",26,"LAC","NBA",4.6,80,80,2913,377,928,354,820,23,108,311,391,84,232,316,537,99,11,206,203,1088,14.58
2641,"Cuttino Mobley\moblecu01","2006-07",31,"LAC","NBA",4.6,78,73,2841,388,882,287,636,101,246,200,239,52,215,267,198,92,24,145,186,1077,12.22
2642,"Nazr Mohammed\mohamna01","2004-05",27,"TOT","NBA",4.6,77,59,1933,289,602,289,601,0,1,153,227,247,339,586,34,58,86,108,236,731,10.03
2643,"Mikki Moore\mooremi01","2007-08",32,"SAC","NBA",4.6,82,79,2385,282,489,282,487,0,2,134,182,160,334,494,84,35,46,110,310,698,9.43
2644,"Markieff Morris\morrima02","2014-15",25,"PHO","NBA",4.6,82,82,2581,512,1100,455,921,57,179,177,232,110,396,506,192,101,39,170,245,1258,13.85
2645,"Greg Oden\odengr01","2008-09",21,"POR","NBA",4.6,61,39,1314,198,351,198,351,0,0,144,226,169,255,424,31,25,69,87,238,540,9.92
2646,"Dwight Powell\poweldw01","2016-17",25,"DAL","NBA",4.6,77,3,1333,194,377,173,303,21,74,107,141,93,213,306,49,61,39,34,135,516,7.29
2647,"Michael Redd\reddmi01","2001-02",22,"MIL","NBA",4.6,67,8,1417,294,609,206,411,88,198,91,115,77,147,224,91,42,7,57,96,767,9.69
2648,"Rajon Rondo\rondora01","2015-16",29,"SAC","NBA",4.6,72,72,2537,355,782,293,612,62,170,87,150,77,358,435,839,141,10,278,175,859,18.58
2649,"Dennis Scott\scottde01","1994-95",26,"ORL","NBA",4.6,62,10,1499,283,645,133,293,150,352,86,114,25,121,146,131,45,14,57,119,802,10.6
2650,"Tiago Splitter\splitti01","2011-12",27,"SAS","NBA",4.6,59,2,1121,212,343,212,343,0,0,125,181,93,213,306,65,21,47,87,134,549,10.05
2651,"John Starks\starkjo01","1997-98",32,"NYK","NBA",4.6,82,10,2188,372,947,242,549,130,398,185,235,48,182,230,219,78,5,143,205,1059,10.39
2652,"Bob Sura\surabo01","2003-04",30,"TOT","NBA",4.6,80,18,1663,202,485,181,406,21,79,171,226,100,226,326,233,62,14,105,158,596,8.51
2653,"Kenny Thomas\thomake01","2002-03",25,"TOT","NBA",4.6,66,42,1978,260,559,260,559,0,0,147,197,185,344,529,112,62,28,116,169,667,11.08
2654,"Tyrus Thomas\thomaty01","2008-09",22,"CHI","NBA",4.6,79,61,2175,308,683,305,674,3,9,238,304,148,360,508,77,91,151,129,220,857,11.77
2655,"Dwyane Wade\wadedw01","2003-04",22,"MIA","NBA",4.6,61,56,2126,371,798,355,745,16,53,233,312,85,162,247,275,86,34,196,140,991,15.58
2656,"Gerald Wallace\wallage01","2007-08",25,"CHA","NBA",4.6,62,59,2376,408,908,337,687,71,221,313,428,58,315,373,216,131,58,180,189,1200,18.61
2657,"Metta World Peace\artesro01","2012-13",33,"LAL","NBA",4.6,75,66,2530,332,824,191,412,141,412,124,169,101,271,372,112,122,42,98,198,929,11.27
2658,"Thaddeus Young\youngth01","2016-17",28,"IND","NBA",4.6,74,74,2237,362,687,317,569,45,118,45,86,131,317,448,122,113,29,95,135,814,11.61
2659,"Chris Andersen\anderch01","2004-05",26,"NOH","NBA",4.5,67,2,1430,191,358,191,355,0,3,131,190,137,273,410,71,14,100,64,144,513,9.15
2660,"Chucky Atkins\atkinch01","2004-05",30,"LAL","NBA",4.5,82,82,2903,388,910,212,455,176,455,163,203,31,166,197,358,73,2,151,181,1115,12.45
2661,"Malik Beasley\beaslma01","2018-19",22,"DEN","NBA",4.5,81,18,1879,349,737,186,332,163,405,56,66,35,165,200,97,55,10,55,116,917,9.22
2662,"Raja Bell\bellra01","2007-08",31,"PHO","NBA",4.5,75,75,2646,317,753,141,314,176,439,79,91,47,227,274,168,54,27,65,220,889,10.45
2663,"Nemanja Bjelica\bjeline01","2018-19",30,"SAC","NBA",4.5,77,70,1788,284,593,181,336,103,257,70,92,125,319,444,147,54,56,82,197,741,10.45
2664,"Earl Boykins\boykiea01","2006-07",30,"TOT","NBA",4.5,66,23,2031,323,769,228,530,95,239,220,245,49,90,139,291,56,2,120,92,961,13.01
2665,"Jaylen Brown\brownja02","2017-18",21,"BOS","NBA",4.5,70,70,2152,373,803,252,497,121,306,150,233,66,280,346,114,70,26,124,181,1017,12.53
2666,"Caron Butler\butleca01","2008-09",28,"WAS","NBA",4.5,67,67,2585,491,1085,426,875,65,210,345,402,118,296,414,290,106,20,210,165,1392,19.32
2667,"Kentavious Caldwell-Pope\caldwke01","2016-17",23,"DET","NBA",4.5,76,75,2529,370,928,217,491,153,437,154,185,55,193,248,193,89,12,86,118,1047,11.38
2668,"Tom Chambers\chambto01","1992-93",33,"PHO","NBA",4.5,73,0,1723,320,716,309,688,11,28,241,288,96,249,345,101,43,23,92,212,892,10.52
2669,"Rex Chapman\chapmre01","1997-98",30,"PHO","NBA",4.5,68,67,2263,408,956,288,645,120,311,146,187,30,143,173,203,71,14,116,102,1082,12.53
2670,"Derrick Coleman\colemde01","2002-03",35,"PHI","NBA",4.5,64,35,1742,223,498,201,431,22,67,134,171,151,299,450,87,53,69,96,171,602,10.47
2671,"Nick Collison\collini01","2007-08",27,"SEA","NBA",4.5,78,35,2223,322,641,322,639,0,2,123,167,254,476,730,113,47,60,118,250,767,11.41
2672,"Mike Conley\conlemi01","2008-09",21,"MEM","NBA",4.5,82,61,2508,323,730,235,513,88,217,161,197,25,251,276,354,90,8,143,146,895,11.62
2673,"Brian Cook\cookbr01","2005-06",25,"LAL","NBA",4.5,81,46,1535,261,511,225,427,36,84,84,101,88,186,274,74,37,32,61,205,642,7.44
2674,"Jamal Crawford\crawfja01","2005-06",25,"NYK","NBA",4.5,79,27,2555,366,879,265,586,101,293,295,357,36,212,248,301,87,15,175,150,1128,13.19
2675,"Erick Dampier\dampier01","2004-05",29,"DAL","NBA",4.5,59,56,1609,202,367,202,364,0,3,138,228,183,318,501,51,15,80,102,205,542,10.8
2676,"Antonio Daniels\daniean01","2007-08",32,"WAS","NBA",4.5,71,63,2161,205,447,188,373,17,74,170,219,23,180,203,340,69,2,91,78,597,10.37
2677,"Baron Davis\davisba01","2002-03",23,"NOH","NBA",4.5,50,47,1889,332,798,233,515,99,283,93,131,56,130,186,320,91,22,140,148,856,16.4
2678,"Baron Davis\davisba01","2009-10",30,"LAC","NBA",4.5,75,73,2523,412,1015,330,719,82,296,239,291,52,214,266,598,126,43,211,210,1145,16.79
2679,"Dale Davis\davisda01","1998-99",29,"IND","NBA",4.5,50,50,1374,161,302,161,302,0,0,76,123,155,261,416,22,20,57,43,115,398,9.48
2680,"Luol Deng\denglu01","2013-14",28,"TOT","NBA",4.5,63,63,2213,371,860,314,671,57,189,212,268,99,262,361,183,62,9,114,111,1011,13.9
2681,"Andre Drummond\drumman01","2012-13",19,"DET","NBA",4.5,60,10,1243,208,342,207,340,1,2,59,159,169,288,457,30,59,95,57,144,476,10.15
2682,"Mike Dunleavy\dunlemi02","2010-11",30,"IND","NBA",4.5,61,44,1683,240,520,138,266,102,254,100,125,28,248,276,105,40,30,69,107,682,10.64
2683,"Howard Eisley\eisleho01","2002-03",30,"NYK","NBA",4.5,82,76,2243,262,628,131,291,131,337,89,105,24,162,186,444,71,9,149,222,744,10.55
2684,"Mario Elie\eliema01","1998-99",35,"SAS","NBA",4.5,47,37,1291,156,331,116,224,40,107,103,119,36,101,137,89,46,12,61,91,455,9.59
2685,"Wayne Ellington\ellinwa01","2017-18",30,"MIA","NBA",4.5,77,2,2041,285,700,58,121,227,579,67,78,23,195,218,79,53,8,52,94,864,8.89
2686,"Kenneth Faried\farieke01","2016-17",27,"DEN","NBA",4.5,61,34,1296,228,416,228,410,0,6,131,189,183,279,462,55,43,40,59,124,587,10.79
2687,"Danny Fortson\fortsda01","2001-02",25,"GSW","NBA",4.5,77,76,2216,309,722,308,718,1,4,245,308,290,609,899,127,44,17,160,255,864,12.49
2688,"Jeff Foster\fosteje01","2006-07",30,"IND","NBA",4.5,75,43,1740,122,260,122,259,0,1,78,122,253,356,609,57,62,37,70,202,322,7.23
2689,"Chris Gatling\gatlich01","1993-94",26,"GSW","NBA",4.5,82,23,1296,271,461,271,460,0,1,129,208,143,254,397,41,40,63,84,223,671,8.5
2690,"Matt Geiger\geigema01","1993-94",24,"MIA","NBA",4.5,72,0,1199,202,352,201,347,1,5,116,149,119,184,303,32,36,29,61,201,521,7.53
2691,"Taj Gibson\gibsota01","2011-12",26,"CHI","NBA",4.5,63,0,1284,200,404,200,404,0,0,84,135,135,197,332,47,27,81,60,131,484,8.1
2692,"Manu Ginóbili\ginobma01","2012-13",35,"SAS","NBA",4.5,60,0,1393,229,539,146,304,83,235,164,206,30,171,201,274,80,13,132,114,705,12.73
2693,"Danny Green\greenda02","2011-12",24,"SAS","NBA",4.5,66,38,1522,211,477,109,243,102,234,79,100,54,174,228,86,58,46,67,107,603,8.89
2694,"Draymond Green\greendr01","2013-14",23,"GSW","NBA",4.5,82,12,1797,187,459,132,294,55,165,82,123,86,323,409,152,102,72,91,231,511,8.18
2695,"Richard Hamilton\hamilri01","2008-09",30,"DET","NBA",4.5,67,51,2279,466,1043,396,853,70,190,223,263,44,163,207,297,40,4,133,176,1225,14.91
2696,"James Harden\hardeja01","2009-10",20,"OKC","NBA",4.5,76,0,1738,233,578,140,330,93,248,194,240,47,197,244,137,80,20,106,200,753,9.35
2697,"Spencer Hawes\hawessp01","2013-14",25,"TOT","NBA",4.5,80,78,2470,403,883,275,575,128,308,119,152,131,529,660,240,44,94,173,237,1053,14.06
2698,"Spencer Hawes\hawessp01","2012-13",24,"PHI","NBA",4.5,82,40,2233,376,811,345,724,31,87,122,157,173,417,590,183,24,113,131,233,905,11.47
2699,"Mark Jackson\jacksma01","1994-95",29,"IND","NBA",4.5,82,67,2402,239,566,212,479,27,87,119,153,73,233,306,616,105,16,210,148,624,11.95
2700,"Amir Johnson\johnsam01","2009-10",22,"TOR","NBA",4.5,82,5,1453,208,334,208,330,0,4,95,149,154,241,395,48,44,66,63,255,511,7.57
2701,"Anthony Johnson\johnsan02","2005-06",31,"IND","NBA",4.5,75,53,1981,267,603,216,448,51,155,106,141,31,137,168,324,63,22,115,132,691,9.79
2702,"Cory Joseph\josepco01","2014-15",23,"SAS","NBA",4.5,79,14,1444,207,411,191,367,16,44,105,143,44,148,192,188,46,17,67,105,535,7.36
2703,"Andrei Kirilenko\kirilan01","2010-11",29,"UTA","NBA",4.5,64,62,1999,253,542,217,444,36,98,208,270,100,227,327,192,81,74,117,113,750,13.2
2704,"Brandon Knight\knighbr03","2014-15",23,"TOT","NBA",4.5,63,61,2035,375,888,250,567,125,321,195,223,28,216,244,330,90,10,189,114,1070,16.08
2705,"Brevin Knight\knighbr01","2004-05",29,"CHA","NBA",4.5,66,61,1944,248,587,245,567,3,20,167,196,21,149,170,591,131,5,147,192,666,14.53
2706,"Alex Len\lenal01","2017-18",24,"PHO","NBA",4.5,69,13,1395,214,378,213,375,1,3,158,231,175,343,518,82,27,61,78,158,587,10.33
2707,"Jon Leuer\leuerjo01","2016-17",27,"DET","NBA",4.5,75,34,1944,310,646,261,479,49,167,98,113,102,300,402,111,31,26,66,145,767,9.61
2708,"Jodie Meeks\meeksjo01","2013-14",26,"LAL","NBA",4.5,77,70,2556,413,892,251,488,162,404,221,258,30,164,194,138,111,4,111,119,1209,13.29
2709,"Mike Miller\millemi01","2001-02",21,"ORL","NBA",4.5,63,53,2123,351,802,235,499,116,303,138,181,49,224,273,198,47,23,108,145,956,13.15
2710,"Nazr Mohammed\mohamna01","2005-06",28,"SAS","NBA",4.5,80,30,1389,190,377,190,377,0,0,113,144,163,255,418,40,21,49,91,220,493,6.79
2711,"Marcus Morris\morrima03","2018-19",29,"BOS","NBA",4.5,75,53,2091,377,844,231,455,146,389,146,173,76,382,458,109,43,25,92,181,1046,12.2
2712,"Timofey Mozgov\mozgoti01","2013-14",27,"DEN","NBA",4.5,82,30,1770,285,545,281,521,4,24,196,260,171,357,528,62,27,100,122,213,770,10.1
2713,"Troy Murphy\murphtr01","2006-07",26,"TOT","NBA",4.5,68,48,1852,266,581,208,434,58,147,108,145,100,314,414,126,46,42,78,196,698,10.47
2714,"Charles Oakley\oaklech01","1994-95",31,"NYK","NBA",4.5,50,49,1567,192,393,189,381,3,12,119,150,155,290,445,126,60,7,103,179,506,12.53
2715,"Emeka Okafor\okafoem01","2012-13",30,"WAS","NBA",4.5,79,77,2052,328,687,328,687,0,0,109,191,199,493,692,93,45,77,107,145,765,10.42
2716,"Hakeem Olajuwon\olajuha01","1997-98",35,"HOU","NBA",4.5,47,45,1633,306,633,306,630,0,3,160,212,116,344,460,143,84,96,126,152,772,18.42
2717,"Nikola Peković\pekovni01","2011-12",26,"MIN","NBA",4.5,47,35,1264,256,454,256,454,0,0,139,187,181,165,346,31,29,31,87,98,651,13.34
2718,"Sam Perkins\perkisa01","1997-98",36,"SEA","NBA",4.5,81,0,1675,196,471,109,249,87,222,101,128,53,202,255,113,62,29,62,158,580,7.18
2719,"Eric Piatkowski\piatker01","2001-02",31,"LAC","NBA",4.5,71,64,1718,207,471,96,233,111,238,101,113,43,141,184,112,41,12,64,110,626,8.11
2720,"Kristaps Porziņģis\porzikr01","2016-17",21,"NYK","NBA",4.5,66,65,2164,443,985,331,671,112,314,198,252,111,364,475,97,47,129,118,244,1196,16.02
2721,"Dino Rađa\radjadi01","1994-95",27,"BOS","NBA",4.5,66,48,2147,450,919,450,918,0,1,233,307,149,424,573,111,60,86,159,232,1133,16.17
2722,"J.J. Redick\redicjj01","2012-13",28,"TOT","NBA",4.5,78,13,2379,382,880,217,429,165,451,171,190,17,154,171,296,38,9,138,117,1100,12.17
2723,"J.J. Redick\redicjj01","2010-11",26,"ORL","NBA",4.5,59,5,1513,197,447,110,228,87,219,112,128,6,107,113,102,29,3,53,80,593,8.48
2724,"Thabo Sefolosha\sefolth01","2015-16",31,"ATL","NBA",4.5,75,11,1758,188,372,146,248,42,124,62,99,52,282,334,107,85,37,68,109,480,7.99
2725,"Scott Skiles\skilesc01","1994-95",30,"WSB","NBA",4.5,62,62,2077,265,583,169,355,96,228,179,202,26,133,159,452,70,6,172,135,805,15.29
2726,"Rodney Stuckey\stuckro01","2011-12",25,"DET","NBA",4.5,55,48,1644,256,597,223,493,33,104,267,320,38,104,142,210,44,10,106,124,812,13.27
2727,"Wally Szczerbiak\szczewa02","2008-09",31,"CLE","NBA",4.5,74,5,1527,179,398,110,230,69,168,90,106,43,189,232,82,28,10,55,130,517,6.61
2728,"Etan Thomas\thomaet01","2003-04",25,"WAS","NBA",4.5,79,15,1901,257,526,257,526,0,0,191,295,183,345,528,68,36,123,113,219,705,9.86
2729,"Kurt Thomas\thomaku01","2008-09",36,"SAS","NBA",4.5,79,10,1404,153,304,153,302,0,2,37,45,134,271,405,66,34,58,42,170,343,5.96
2730,"Sedale Threatt\threase01","1993-94",32,"LAL","NBA",4.5,81,20,2278,411,852,406,819,5,33,138,155,28,125,153,344,110,19,106,186,965,11.75
2731,"Wayman Tisdale\tisdawa01","1992-93",28,"SAC","NBA",4.5,76,75,2283,544,1068,544,1066,0,2,175,231,127,373,500,108,52,47,117,277,1263,14.09
2732,"Kemba Walker\walkeke02","2014-15",24,"CHO","NBA",4.5,62,58,2119,378,981,293,701,85,280,234,283,35,185,220,318,89,31,100,92,1075,15.18
2733,"John Wall\walljo01","2012-13",22,"WAS","NBA",4.5,49,42,1602,324,735,312,690,12,45,246,306,35,161,196,373,65,37,157,117,906,18.93
2734,"Clarence Weatherspoon\weathcl01","1997-98",27,"TOT","NBA",4.5,79,49,2325,268,608,268,608,0,0,200,277,198,396,594,89,85,74,119,194,736,10.42
2735,"Hot Rod Williams\williho01","1992-93",30,"CLE","NBA",4.5,67,13,2055,263,560,263,560,0,0,212,296,127,288,415,152,48,105,116,171,738,12.11
2736,"Jason Williams\willija02","2009-10",34,"ORL","NBA",4.5,82,18,1703,189,426,105,205,84,221,31,41,7,119,126,298,53,3,87,65,493,7.08
2737,"Jerome Williams\willije01","1997-98",24,"DET","NBA",4.5,77,3,1305,151,288,151,287,0,1,108,166,170,209,379,48,51,10,60,144,410,6.35
2738,"Mo Williams\willima01","2007-08",25,"MIL","NBA",4.5,66,66,2410,441,919,352,688,89,231,166,194,37,193,230,419,78,10,182,188,1137,17.11
2739,"Delon Wright\wrighde01","2017-18",25,"TOR","NBA",4.5,69,4,1433,201,432,145,279,56,153,97,117,45,153,198,200,72,33,78,81,555,9.27
2740,"Thaddeus Young\youngth01","2007-08",19,"PHI","NBA",4.5,74,22,1554,264,490,258,471,6,19,76,103,120,192,312,58,73,8,64,126,610,8.19
2741,"Kenny Anderson\anderke01","1992-93",22,"NJN","NBA",4.4,55,55,2010,370,850,363,825,7,25,180,232,51,175,226,449,96,11,153,140,927,17.59
2742,"Keith Askins\askinke01","1995-96",28,"MIA","NBA",4.4,75,14,1897,157,391,58,154,99,237,45,57,113,211,324,121,48,61,82,271,458,7.3
2743,"Vin Baker\bakervi01","1993-94",22,"MIL","NBA",4.4,82,63,2560,435,869,434,864,1,5,234,411,277,344,621,163,60,114,162,231,1105,13.44
2744,"Shane Battier\battish01","2012-13",34,"MIA","NBA",4.4,72,20,1786,152,362,16,46,136,316,32,38,37,128,165,72,41,55,34,149,472,6.57
2745,"Patrick Beverley\beverpa01","2015-16",27,"HOU","NBA",4.4,71,63,2041,258,594,134,284,124,310,60,88,73,177,250,239,94,26,91,234,700,10.64
2746,"Mike Bibby\bibbymi01","2006-07",28,"SAC","NBA",4.4,82,82,2784,471,1166,298,685,173,481,288,347,39,224,263,388,88,6,197,139,1403,14.89
2747,"Matt Bonner\bonnema01","2010-11",30,"SAS","NBA",4.4,66,1,1432,172,371,67,141,105,230,32,43,60,179,239,60,26,21,27,110,481,7.03
2748,"Bruce Bowen\bowenbr01","2007-08",36,"SAS","NBA",4.4,81,81,2448,174,428,84,213,90,215,45,69,33,201,234,91,54,22,46,177,483,5.8
2749,"P.J. Brown\brownpj01","2005-06",36,"NOK","NBA",4.4,75,73,2380,269,583,269,583,0,0,139,168,182,365,547,90,46,50,90,216,677,9.7
2750,"Clint Capela\capelca01","2015-16",21,"HOU","NBA",4.4,77,35,1471,231,397,231,396,0,1,80,211,194,300,494,47,59,92,60,190,542,8.55
2751,"Derrick Coleman\colemde01","1997-98",30,"PHI","NBA",4.4,59,58,2135,356,867,330,769,26,98,302,391,149,438,587,145,46,68,157,144,1040,16.44
2752,"Tyrone Corbin\corbity01","1993-94",31,"UTA","NBA",4.4,82,17,2149,268,588,262,559,6,29,117,144,150,239,389,122,99,24,92,212,659,8.54
2753,"DeMarcus Cousins\couside01","2012-13",22,"SAC","NBA",4.4,75,74,2289,482,1036,478,1014,4,22,312,423,222,524,746,199,108,55,225,269,1280,17.17
2754,"Jae Crowder\crowdja01","2018-19",28,"UTA","NBA",4.4,80,11,2166,318,797,145,275,173,522,142,197,60,324,384,133,64,31,85,170,951,10.38
2755,"Baron Davis\davisba01","2004-05",25,"TOT","NBA",4.4,46,32,1581,291,752,173,398,118,354,185,243,32,143,175,362,81,14,131,126,885,18.83
2756,"Baron Davis\davisba01","2005-06",26,"GSW","NBA",4.4,54,48,1971,335,861,233,537,102,324,195,289,45,191,236,480,89,14,159,165,967,18.33
2757,"Ricky Davis\davisri01","2003-04",24,"TOT","NBA",4.4,79,27,2474,446,950,394,810,52,140,196,273,77,281,358,259,96,22,189,171,1140,13.4
2758,"Luol Deng\denglu01","2007-08",22,"CHI","NBA",4.4,63,59,2128,429,896,421,874,8,22,204,265,136,258,394,155,57,29,120,117,1070,14.82
2759,"Boris Diaw\diawbo01","2012-13",30,"SAS","NBA",4.4,75,20,1709,179,332,149,254,30,78,47,65,66,188,254,180,52,27,84,143,435,7.54
2760,"Joe Dumars\dumarjo01","1993-94",30,"DET","NBA",4.4,69,69,2591,505,1118,381,798,124,320,276,330,35,116,151,261,63,4,159,118,1410,16.18
2761,"Mike Dunleavy\dunlemi02","2011-12",31,"MIL","NBA",4.4,55,3,1445,239,504,156,296,83,208,116,143,29,175,204,117,28,8,58,87,677,11.02
2762,"Mike Dunleavy\dunlemi02","2012-13",32,"MIL","NBA",4.4,75,3,1943,276,624,148,325,128,299,105,128,31,260,291,145,39,35,90,135,785,9.74
2763,"Howard Eisley\eisleho01","2000-01",28,"DAL","NBA",4.4,82,40,2426,265,675,158,406,107,269,104,126,23,174,197,295,99,12,102,218,741,9.25
2764,"Tyreke Evans\evansty01","2012-13",23,"SAC","NBA",4.4,65,61,2016,366,765,321,632,45,133,210,271,56,231,287,229,90,27,128,133,987,14.73
2765,"Derrick Favors\favorde01","2012-13",21,"UTA","NBA",4.4,77,8,1787,274,568,274,563,0,5,179,260,184,362,546,75,67,130,129,247,727,10.85
2766,"Michael Finley\finlemi01","2008-09",35,"SAS","NBA",4.4,81,77,2336,301,689,170,370,131,319,51,62,26,244,270,114,37,17,61,82,784,8.08
2767,"Danny Fortson\fortsda01","1998-99",22,"DEN","NBA",4.4,50,38,1417,191,386,191,383,0,3,168,231,210,371,581,32,31,22,77,212,550,12.64
2768,"Steve Francis\francst01","2001-02",24,"HOU","NBA",4.4,57,56,2343,420,1007,352,797,68,210,326,422,102,299,401,362,71,25,221,172,1234,20.37
2769,"Kevin Garnett\garneke01","1995-96",19,"MIN","NBA",4.4,80,43,2293,361,735,353,707,8,28,105,149,175,326,501,145,86,131,110,189,835,11.59
2770,"Rudy Gay\gayru01","2018-19",32,"SAS","NBA",4.4,69,51,1842,376,746,302,562,74,184,120,147,63,407,470,182,54,34,114,159,946,13.86
2771,"Drew Gooden\goodedr01","2009-10",28,"TOT","NBA",4.4,70,33,1755,288,602,287,594,1,8,186,216,207,335,542,47,41,58,108,194,763,11.09
2772,"Ben Gordon\gordobe01","2005-06",22,"CHI","NBA",4.4,80,47,2482,486,1152,320,770,166,382,211,268,43,176,219,240,75,5,180,238,1349,13.1
2773,"A.C. Green\greenac01","1995-96",32,"PHO","NBA",4.4,82,36,2113,215,444,201,392,14,52,168,237,166,388,554,72,45,23,79,141,612,8.45
2774,"Tyler Hansbrough\hansbty01","2012-13",27,"IND","NBA",4.4,81,8,1366,176,407,176,404,0,3,216,300,161,212,373,36,29,18,78,152,568,6.62
2775,"Chuck Hayes\hayesch01","2007-08",24,"HOU","NBA",4.4,79,44,1575,113,221,113,218,0,3,11,24,132,295,427,91,85,43,62,212,237,5.97
2776,"Grant Hill\hillgr01","2010-11",38,"PHO","NBA",4.4,80,80,2409,399,825,354,711,45,114,213,257,77,261,338,200,64,35,134,184,1056,12.3
2777,"Jordan Hill\hilljo01","2013-14",26,"LAL","NBA",4.4,72,32,1500,286,521,286,520,0,1,124,181,194,341,535,54,29,64,75,172,696,10.4
2778,"Juwan Howard\howarju01","2000-01",27,"TOT","NBA",4.4,81,81,2974,583,1218,583,1215,0,3,296,383,171,401,572,224,75,37,242,292,1462,15.98
2779,"Andre Iguodala\iguodan01","2015-16",32,"GSW","NBA",4.4,65,1,1732,176,368,122,214,54,154,51,83,52,211,263,219,73,19,79,102,457,9.26
2780,"Ersan İlyasova\ilyaser01","2015-16",28,"TOT","NBA",4.4,74,56,1881,280,661,184,402,96,259,111,154,144,259,403,67,52,33,71,171,767,9.22
2781,"Jim Jackson\jacksji01","1996-97",26,"TOT","NBA",4.4,77,77,2831,444,1029,358,782,86,247,252,310,132,279,411,316,86,32,208,194,1226,14.99
2782,"Stephen Jackson\jacksst02","2005-06",27,"IND","NBA",4.4,81,81,2910,472,1148,355,809,117,339,268,341,48,264,312,225,104,43,203,195,1329,13.6
2783,"Stephen Jackson\jacksst02","2003-04",25,"ATL","NBA",4.4,80,78,2940,536,1261,391,834,145,427,233,297,97,273,370,244,142,20,223,216,1450,15.39
2784,"Jonas Jerebko\jerebjo01","2009-10",22,"DET","NBA",4.4,80,73,2232,290,603,254,488,36,115,125,176,194,284,478,58,79,29,82,230,741,9.32
2785,"Jason Kidd\kiddja01","1996-97",23,"TOT","NBA",4.4,55,45,1964,213,529,152,364,61,165,112,165,64,185,249,496,124,20,142,114,599,15.95
2786,"Andrei Kirilenko\kirilan01","2006-07",25,"UTA","NBA",4.4,70,70,2049,197,418,181,343,16,75,174,239,88,241,329,202,74,144,135,172,584,11.31
2787,"Nenad Krstić\krstine01","2004-05",21,"NJN","NBA",4.4,75,57,1965,281,570,281,568,0,2,185,255,161,240,401,77,32,63,112,280,747,9.64
2788,"Courtney Lee\leeco01","2008-09",23,"ORL","NBA",4.4,77,42,1939,243,540,161,337,82,203,78,94,18,160,178,91,76,14,69,157,646,7.53
2789,"Jeremy Lin\linje01","2013-14",25,"HOU","NBA",4.4,71,33,2054,295,662,213,433,82,229,218,265,34,153,187,294,68,27,176,166,890,12.58
2790,"Shaun Livingston\livinsh01","2013-14",28,"BRK","NBA",4.4,76,54,1974,235,487,234,481,1,6,158,191,67,179,246,245,93,31,105,172,629,9.91
2791,"Xavier McDaniel\mcdanxa01","1992-93",29,"BOS","NBA",4.4,82,27,2215,457,924,451,902,6,22,191,241,168,321,489,163,72,51,171,249,1111,12.74
2792,"Cuttino Mobley\moblecu01","2004-05",29,"TOT","NBA",4.4,66,64,2388,408,932,258,590,150,342,168,205,45,184,229,188,74,30,133,152,1134,14.37
2793,"E'Twaun Moore\mooreet01","2017-18",28,"NOP","NBA",4.4,82,80,2586,423,832,295,531,128,301,48,68,57,181,238,187,79,12,102,182,1022,11.15
2794,"Tracy Murray\murratr01","1996-97",25,"WSB","NBA",4.4,82,1,1814,288,678,182,378,106,300,135,161,84,169,253,78,69,19,86,150,817,8.36
2795,"Johnny Newman\newmajo01","1995-96",32,"MIL","NBA",4.4,82,82,2690,321,649,260,487,61,162,186,232,66,134,200,154,90,15,108,257,889,10.16
2796,"Moochie Norris\norrimo01","2000-01",27,"HOU","NBA",4.4,82,6,1654,184,413,159,324,25,89,151,194,44,154,198,283,69,2,107,84,544,8.04
2797,"Bo Outlaw\outlabo01","2002-03",31,"PHO","NBA",4.4,80,20,1800,153,278,153,276,0,2,72,116,134,234,368,112,50,71,76,194,378,6.9
2798,"Elfrid Payton\paytoel01","2016-17",22,"ORL","NBA",4.4,82,58,2412,430,912,390,766,40,146,146,211,89,298,387,529,88,40,178,177,1046,14.57
2799,"Will Perdue\perduwi01","1996-97",31,"SAS","NBA",4.4,65,34,1918,233,410,233,410,0,0,99,171,251,387,638,38,32,102,87,184,565,11.19
2800,"Kristaps Porziņģis\porzikr01","2015-16",20,"NYK","NBA",4.4,72,72,2047,373,886,292,643,81,243,201,240,132,394,526,94,53,134,121,205,1028,13.39
2801,"Luke Ridnour\ridnolu01","2005-06",24,"SEA","NBA",4.4,79,77,2625,334,799,291,650,43,149,199,227,47,188,235,550,123,22,162,178,910,13.8
2802,"Clifford Robinson\robincl02","2002-03",36,"DET","NBA",4.4,81,69,2825,372,935,285,676,87,259,161,238,81,237,318,268,87,88,158,259,992,11.34
2803,"Malik Rose\rosema01","2001-02",27,"SAS","NBA",4.4,82,1,1725,293,633,292,621,1,12,185,257,172,320,492,61,70,42,140,208,772,9.22
2804,"Luis Scola\scolalu01","2014-15",34,"IND","NBA",4.4,81,16,1659,300,642,295,622,5,20,158,226,138,388,526,105,47,18,94,192,763,9.26
2805,"Luis Scola\scolalu01","2012-13",32,"PHO","NBA",4.4,82,67,2184,432,915,429,899,3,16,181,230,158,383,541,182,67,35,126,257,1048,12.15
2806,"Ramon Sessions\sessira01","2010-11",24,"CLE","NBA",4.4,81,38,2133,362,776,359,761,3,15,348,423,46,209,255,419,60,8,178,93,1075,13.67
2807,"Kyle Singler\singlky01","2013-14",25,"DET","NBA",4.4,82,36,2337,269,602,175,356,94,246,152,184,116,187,303,75,61,38,79,211,784,8.76
2808,"Scott Skiles\skilesc01","1993-94",29,"ORL","NBA",4.4,82,46,2303,276,644,208,479,68,165,195,222,42,147,189,503,47,2,193,171,815,11.46
2809,"Ish Smith\smithis01","2017-18",29,"DET","NBA",4.4,82,35,2043,389,801,354,700,35,101,81,116,27,197,224,360,64,20,108,140,894,10.91
2810,"Joe Smith\smithjo02","2000-01",25,"DET","NBA",4.4,69,59,1941,308,765,308,760,0,5,231,287,160,331,491,79,47,50,88,258,847,10.81
2811,"Joe Smith\smithjo02","1996-97",21,"GSW","NBA",4.4,80,80,3086,587,1293,575,1247,12,46,307,377,261,418,679,125,74,86,192,244,1493,16.1
2812,"Josh Smith\smithjo03","2006-07",21,"ATL","NBA",4.4,72,72,2647,436,993,398,841,38,152,268,387,165,456,621,236,101,207,227,241,1178,17.63
2813,"Steve Smith\smithst01","1998-99",29,"ATL","NBA",4.4,36,36,1314,217,540,170,401,47,139,191,225,50,101,151,118,36,11,99,100,672,15.39
2814,"Amar'e Stoudemire\stoudam01","2003-04",21,"PHO","NBA",4.4,55,53,2025,411,865,410,860,1,5,310,435,157,339,496,78,64,89,177,188,1133,18.57
2815,"Derek Strong\stronde01","1997-98",29,"ORL","NBA",4.4,58,8,1638,259,617,259,613,0,4,218,279,152,275,427,51,31,24,74,122,736,10.99
2816,"Kenny Thomas\thomake01","2001-02",24,"HOU","NBA",4.4,72,71,2484,396,829,396,813,0,16,223,336,158,358,516,137,85,66,143,195,1015,13.63
2817,"Jamaal Tinsley\tinslja01","2003-04",25,"IND","NBA",4.4,52,43,1378,153,370,76,163,77,207,49,67,28,108,136,303,84,17,110,132,432,11.33
2818,"Nick Van Exel\vanexni01","2001-02",30,"TOT","NBA",4.4,72,46,2496,501,1226,382,876,119,350,201,251,28,226,254,478,44,11,156,104,1322,15.72
2819,"Nikola Vučević\vucevni01","2013-14",23,"ORL","NBA",4.4,57,57,1812,353,696,353,696,0,0,105,137,185,441,626,104,60,47,112,169,811,15.23
2820,"Chris Webber\webbech01","2005-06",32,"PHI","NBA",4.4,75,75,2893,617,1422,596,1345,21,77,263,348,184,557,741,256,103,62,182,219,1518,18.1
2821,"Martell Webster\webstma02","2009-10",23,"POR","NBA",4.4,82,49,2005,259,639,135,307,124,332,126,155,47,221,268,62,45,40,60,153,768,7.76
2822,"Chris Wilcox\wilcoch01","2005-06",23,"TOT","NBA",4.4,77,24,1529,257,450,257,448,0,2,112,153,118,292,410,52,33,34,72,183,626,8.5
2823,"Lou Williams\willilo02","2007-08",21,"PHI","NBA",4.4,80,0,1862,319,752,264,599,55,153,227,290,41,126,167,253,81,13,125,130,920,10.38
2824,"Walt Williams\williwa02","1999-00",29,"HOU","NBA",4.4,76,66,1859,312,681,210,420,102,261,101,123,69,237,306,157,49,44,113,190,827,10.24
2825,"Corliss Williamson\willico02","1997-98",24,"SAC","NBA",4.4,79,75,2819,561,1134,561,1125,0,9,279,443,162,284,446,230,76,48,199,252,1401,15.38
2826,"Metta World Peace\artesro01","2010-11",31,"LAL","NBA",4.4,82,82,2410,261,658,178,425,83,233,92,136,100,167,267,175,124,36,90,181,697,8.56
2827,"Arron Afflalo\afflaar01","2009-10",24,"DEN","NBA",4.3,82,75,2221,272,585,164,336,108,249,72,98,59,193,252,138,46,30,74,225,724,8.26
2828,"Vincent Askew\askewvi01","1995-96",29,"SEA","NBA",4.3,69,2,1725,215,436,186,350,29,86,123,161,65,153,218,163,47,15,96,178,582,8.79
2829,"Keith Askins\askinke01","1996-97",29,"MIA","NBA",4.3,78,30,1773,138,319,69,147,69,172,39,58,86,185,271,75,53,19,59,196,384,5.58
2830,"Matt Barnes\barnema02","2011-12",31,"LAL","NBA",4.3,63,16,1440,175,387,129,249,46,138,95,128,97,247,344,126,35,48,73,152,491,9.07
2831,"Matt Barnes\barnema02","2014-15",34,"LAC","NBA",4.3,76,74,2271,277,624,141,248,136,376,74,95,51,251,302,114,67,50,87,240,764,9.63
2832,"Brent Barry\barrybr01","2005-06",34,"SAS","NBA",4.3,74,5,1259,156,345,76,143,80,202,39,59,29,130,159,123,39,27,52,99,431,6.1
2833,"Will Barton\bartowi01","2015-16",25,"DEN","NBA",4.3,82,1,2353,425,983,313,658,112,325,216,268,59,417,476,203,71,39,139,147,1178,13.05
2834,"Brandon Bass\bassbr01","2007-08",22,"DAL","NBA",4.3,79,1,1557,246,493,246,489,0,4,162,197,120,227,347,58,22,48,82,150,654,7.95
2835,"Shane Battier\battish01","2009-10",31,"HOU","NBA",4.3,67,62,2168,178,447,77,168,101,279,77,106,74,238,312,164,53,76,64,139,534,9.35
2836,"Trevor Booker\booketr01","2015-16",28,"UTA","NBA",4.3,79,2,1632,190,388,178,347,12,41,71,106,166,286,452,84,59,41,81,169,463,7.35
2837,"Trevor Booker\booketr01","2013-14",26,"WAS","NBA",4.3,72,45,1553,222,403,222,401,0,2,47,76,149,230,379,64,41,45,58,131,491,7.71
2838,"Sam Bowie\bowiesa01","1992-93",31,"NJN","NBA",4.3,79,65,2092,287,638,285,632,2,6,141,181,158,398,556,127,32,128,120,226,717,10.15
2839,"Elden Campbell\campbel01","1998-99",30,"TOT","NBA",4.3,49,33,1459,222,465,222,464,0,1,172,269,126,271,397,69,39,73,80,159,616,13.01
2840,"Antoine Carr\carran01","1994-95",33,"UTA","NBA",4.3,78,4,1677,290,546,289,542,1,4,165,201,81,184,265,67,24,68,87,253,746,8.84
2841,"Vince Carter\cartevi01","2013-14",37,"DAL","NBA",4.3,81,0,1973,330,811,184,440,146,371,161,196,67,217,284,212,61,35,108,209,967,10.68
2842,"Kelvin Cato\catoke01","2004-05",30,"ORL","NBA",4.3,62,50,1525,160,297,160,297,0,0,112,143,102,314,416,40,55,82,64,170,432,9.4
2843,"Mario Chalmers\chalmma01","2011-12",25,"MIA","NBA",4.3,64,64,1825,223,498,122,238,101,260,80,101,16,155,171,222,97,11,142,166,627,10.75
2844,"Darren Collison\collida01","2010-11",23,"IND","NBA",4.3,79,79,2360,398,870,357,746,41,124,202,232,40,185,225,403,87,14,194,109,1039,13.24
2845,"Allen Crabbe\crabbal01","2015-16",23,"POR","NBA",4.3,81,8,2105,311,678,199,393,112,285,98,113,27,189,216,99,63,16,64,192,832,8.71
2846,"Eddy Curry\curryed01","2004-05",22,"CHI","NBA",4.3,63,60,1808,393,730,393,730,0,0,226,314,116,222,338,37,21,58,163,202,1012,13.42
2847,"Antonio Daniels\daniean01","2006-07",31,"WAS","NBA",4.3,80,8,1761,172,389,153,326,19,63,208,250,18,133,151,290,39,9,69,79,571,8.24
2848,"Monta Ellis\ellismo01","2015-16",30,"IND","NBA",4.3,81,81,2734,436,1021,349,739,87,282,162,206,42,229,271,383,150,37,203,174,1121,13.77
2849,"Reggie Evans\evansre01","2012-13",32,"BRK","NBA",4.3,80,56,1967,125,261,125,261,0,0,113,222,260,628,888,43,74,13,111,199,363,8.19
2850,"Raymond Felton\feltora01","2008-09",24,"CHA","NBA",4.3,82,81,3086,442,1083,383,876,59,207,219,272,54,256,310,553,126,30,228,191,1162,14.85
2851,"T.J. Ford\fordtj01","2008-09",25,"IND","NBA",4.3,74,49,2258,413,913,378,809,35,104,245,281,59,200,259,392,89,16,180,180,1106,14.81
2852,"T.J. Ford\fordtj01","2006-07",23,"TOR","NBA",4.3,75,71,2243,393,902,372,833,21,69,240,293,53,183,236,595,101,8,231,186,1047,15.59
2853,"Danny Fortson\fortsda01","2004-05",28,"SEA","NBA",4.3,62,0,1047,118,226,118,226,0,0,227,258,157,191,348,8,15,7,91,265,463,8.13
2854,"Rick Fox\foxri01","2001-02",32,"LAL","NBA",4.3,82,82,2289,255,605,190,397,65,208,70,85,90,299,389,283,67,21,132,244,645,9.18
2855,"Matt Geiger\geigema01","1995-96",26,"CHH","NBA",4.3,77,50,2349,357,666,354,658,3,8,149,205,201,448,649,60,46,63,137,290,866,11.84
2856,"Draymond Green\greendr01","2018-19",28,"GSW","NBA",4.3,66,66,2065,188,422,141,257,47,165,63,91,60,421,481,454,95,70,169,197,486,13.77
2857,"Tim Hardaway\hardati01","1999-00",33,"MIA","NBA",4.3,52,52,1672,246,638,152,382,94,256,110,133,25,125,150,385,49,4,119,112,696,13.84
2858,"Al Harrington\harrial01","2006-07",26,"TOT","NBA",4.3,78,78,2563,495,1083,368,790,127,293,168,242,151,345,496,149,65,24,169,269,1285,13.84
2859,"Alan Henderson\hendeal01","1999-00",27,"ATL","NBA",4.3,82,82,2775,429,930,428,920,1,10,224,334,265,306,571,77,81,54,139,233,1083,11.72
2860,"J.J. Hickson\hicksjj01","2009-10",21,"CLE","NBA",4.3,81,73,1691,289,522,289,521,0,1,111,163,110,290,400,40,36,39,92,132,689,8.27
2861,"Richaun Holmes\holmeri01","2018-19",25,"PHO","NBA",4.3,70,4,1184,222,365,222,365,0,0,128,175,115,216,331,60,42,79,52,194,572,9.4
2862,"Mike James\jamesmi01","2004-05",29,"TOT","NBA",4.3,74,5,1859,331,751,231,492,100,259,109,145,35,173,208,263,65,6,106,174,871,10.81
2863,"Antawn Jamison\jamisan01","2012-13",36,"LAL","NBA",4.3,76,6,1636,267,575,183,342,84,233,94,136,109,253,362,50,30,22,53,124,712,8.22
2864,"Popeye Jones\jonespo01","2001-02",31,"WAS","NBA",4.3,79,40,1920,222,508,218,497,4,11,106,130,233,345,578,127,50,19,88,209,554,8.37
2865,"Jason Kidd\kiddja01","1995-96",22,"DAL","NBA",4.3,81,81,3034,493,1293,360,897,133,396,229,331,203,350,553,783,175,26,328,155,1348,19.28
2866,"Christian Laettner\laettch01","2000-01",31,"TOT","NBA",4.3,78,48,1663,277,551,273,538,4,13,170,204,118,247,365,124,71,46,137,242,728,9.94
2867,"Raef LaFrentz\lafrera01","2005-06",29,"BOS","NBA",4.3,82,63,2033,238,552,126,266,112,286,51,75,80,326,406,115,29,72,65,273,639,8.05
2868,"Robin Lopez\lopezro01","2016-17",28,"CHI","NBA",4.3,81,81,2271,382,775,382,773,0,2,75,104,244,276,520,80,18,117,91,151,839,9.9
2869,"Kyle Lowry\lowryky01","2009-10",23,"HOU","NBA",4.3,68,0,1651,184,464,147,328,37,136,215,260,91,156,247,305,60,9,116,173,620,10.73
2870,"Karl Malone\malonka01","2003-04",40,"LAL","NBA",4.3,42,42,1373,193,400,193,399,0,1,168,225,61,306,367,163,50,20,103,116,554,15.55
2871,"Shawn Marion\mariosh01","2013-14",35,"DAL","NBA",4.3,76,76,2409,341,708,283,546,58,162,51,65,132,365,497,124,90,37,95,125,791,10.89
2872,"Desmond Mason\masonde01","2004-05",27,"MIL","NBA",4.3,80,71,2893,478,1079,477,1071,1,8,420,524,85,227,312,217,58,27,164,198,1377,14.06
2873,"Aaron McKie\mckieaa01","1999-00",27,"PHI","NBA",4.3,82,14,1952,244,593,200,472,44,121,121,146,47,199,246,240,108,18,113,194,653,8.69
2874,"Sam Mitchell\mitchsa01","1995-96",32,"MIN","NBA",4.3,78,42,2145,303,618,302,600,1,18,237,291,107,232,339,74,49,26,87,220,844,9.82
2875,"Eric Murdock\murdoer01","1994-95",26,"MIL","NBA",4.3,75,32,2158,338,814,248,574,90,240,211,267,48,166,214,482,113,12,194,139,977,14.19
2876,"Steve Nash\nashst01","2012-13",38,"LAL","NBA",4.3,50,50,1627,236,475,179,345,57,130,107,116,26,116,142,333,30,5,126,70,636,14.35
2877,"Nerlens Noel\noelne01","2018-19",24,"OKC","NBA",4.3,77,2,1055,162,276,162,276,0,0,54,79,127,198,325,45,66,96,48,166,378,6.94
2878,"Chandler Parsons\parsoch01","2015-16",27,"DAL","NBA",4.3,61,51,1799,320,651,216,400,104,251,93,136,29,256,285,169,46,21,95,114,837,12.87
2879,"James Posey\poseyja01","1999-00",23,"DEN","NBA",4.3,81,77,2052,230,536,148,316,82,220,120,150,85,232,317,146,98,33,95,207,662,8.85
2880,"Leon Powe\powele01","2007-08",24,"BOS","NBA",4.3,56,5,809,154,269,154,268,0,1,137,193,95,132,227,15,15,16,43,127,445,7.56
2881,"Joel Przybilla\przybjo01","2007-08",28,"POR","NBA",4.3,77,67,1819,144,250,144,249,0,1,83,122,195,454,649,27,13,93,95,234,371,7.72
2882,"Zach Randolph\randoza01","2015-16",34,"MEM","NBA",4.3,68,53,2016,431,907,425,881,6,26,172,216,179,350,529,142,43,13,105,146,1040,13.57
2883,"Luke Ridnour\ridnolu01","2012-13",31,"MIN","NBA",4.3,82,82,2474,367,811,301,599,66,212,139,164,41,165,206,311,82,15,130,187,939,10.98
2884,"Clifford Robinson\robincl02","2001-02",35,"DET","NBA",4.3,80,80,2855,454,1069,339,765,115,304,143,206,79,307,386,202,89,95,151,243,1166,12.82
2885,"Terrence Ross\rosste01","2018-19",27,"ORL","NBA",4.3,81,0,2150,440,1027,223,461,217,566,126,144,27,253,280,135,72,29,90,119,1223,12
2886,"John Salmons\salmojo01","2010-11",31,"MIL","NBA",4.3,73,70,2554,373,898,290,679,83,219,195,240,27,239,266,252,72,28,137,157,1024,12.34
2887,"Ramon Sessions\sessira01","2013-14",27,"TOT","NBA",4.3,83,19,2214,330,769,295,645,35,124,326,404,38,165,203,340,49,9,148,90,1021,11.54
2888,"Darius Songaila\songada01","2004-05",26,"SAC","NBA",4.3,81,21,1668,257,488,257,485,0,3,94,111,125,219,344,114,51,18,70,206,608,7.94
2889,"Tiago Splitter\splitti01","2013-14",29,"SAS","NBA",4.3,59,50,1271,181,346,181,343,0,3,121,173,123,240,363,90,29,31,75,117,483,9.34
2890,"Damon Stoudamire\stoudda01","1995-96",22,"TOR","NBA",4.3,70,70,2865,481,1129,348,792,133,337,236,296,59,222,281,653,98,19,267,166,1331,19.86
2891,"Isaiah Thomas\thomais02","2011-12",22,"SAC","NBA",4.3,65,37,1656,256,571,173,352,83,219,154,185,48,120,168,266,53,8,105,121,749,11.56
2892,"Kenny Thomas\thomake01","2004-05",27,"TOT","NBA",4.3,73,58,2167,367,781,366,776,1,5,173,227,184,351,535,152,67,17,131,227,908,12.13
2893,"Klay Thompson\thompkl01","2012-13",22,"GSW","NBA",4.3,82,82,2936,508,1205,297,679,211,526,132,157,32,274,306,183,86,45,157,237,1359,13.13
2894,"Fred VanVleet\vanvlfr01","2018-19",24,"TOR","NBA",4.3,64,28,1760,246,600,134,304,112,296,97,115,21,146,167,307,57,20,82,110,701,11.33
2895,"David West\westda01","2014-15",34,"IND","NBA",4.3,66,66,1895,323,686,319,666,4,20,119,161,108,341,449,223,48,48,120,160,769,12.4
2896,"Doug West\westdo01","1992-93",25,"MIN","NBA",4.3,80,80,3104,646,1249,644,1226,2,23,249,296,89,158,247,235,85,21,165,279,1543,15.89
2897,"Jason Williams\willija02","2006-07",31,"MIA","NBA",4.3,61,55,1865,235,569,135,274,100,295,94,103,18,123,141,322,58,1,100,68,664,11.42
2898,"Jason Williams\willija02","2004-05",29,"MEM","NBA",4.3,71,68,1952,266,644,159,314,107,330,80,101,19,103,122,399,75,5,130,91,719,10.88
2899,"Jerome Williams\willije01","2003-04",30,"TOT","NBA",4.3,68,44,1637,158,336,158,328,0,8,106,155,177,298,475,72,90,8,74,134,422,8.33
2900,"Marvin Williams\willima02","2014-15",28,"CHO","NBA",4.3,78,37,2035,210,495,115,230,95,265,62,87,58,328,386,100,69,36,60,146,577,7.99
2901,"Delon Wright\wrighde01","2018-19",26,"TOT","NBA",4.3,75,13,1699,242,558,192,390,50,168,119,150,68,198,266,248,88,30,77,103,653,9.81
2902,"Dorell Wright\wrighdo01","2009-10",24,"MIA","NBA",4.3,72,1,1496,194,419,133,262,61,157,61,69,50,185,235,91,52,32,53,94,510,7.27
2903,"Bam Adebayo\adebaba01","2017-18",20,"MIA","NBA",4.2,69,19,1368,174,340,174,333,0,7,129,179,118,263,381,101,32,41,66,138,477,8.3
2904,"Jarrett Allen\allenja01","2017-18",19,"BRK","NBA",4.2,72,31,1441,234,397,229,382,5,15,114,147,144,244,388,49,28,88,82,147,587,9.29
2905,"Tony Allen\allento01","2011-12",30,"MEM","NBA",4.2,58,57,1525,210,448,202,422,8,26,140,175,98,135,233,79,104,33,94,142,568,10.34
2906,"Al-Farouq Aminu\aminual01","2017-18",27,"POR","NBA",4.2,69,67,2072,230,582,105,243,125,339,59,80,97,428,525,84,79,40,79,136,644,10.09
2907,"Nick Anderson\anderni01","1996-97",29,"ORL","NBA",4.2,63,61,2163,288,725,145,320,143,405,38,94,66,238,304,182,120,32,86,160,757,11.65
2908,"Shandon Anderson\andersh01","1997-98",24,"UTA","NBA",4.2,82,2,1602,269,500,262,468,7,32,136,185,86,141,227,89,66,18,91,145,681,7.94
2909,"Andrea Bargnani\bargnan01","2009-10",24,"TOR","NBA",4.2,80,80,2799,537,1143,416,818,121,325,181,234,105,388,493,93,25,111,120,215,1376,14.18
2910,"Jon Barry\barryjo01","1999-00",30,"SAC","NBA",4.2,62,1,1281,161,346,95,192,66,154,107,116,38,121,159,150,75,7,85,104,495,9.07
2911,"Patrick Beverley\beverpa01","2013-14",25,"HOU","NBA",4.2,56,55,1751,199,481,107,226,92,255,83,102,72,124,196,151,77,23,66,174,573,10.46
2912,"Matt Bonner\bonnema01","2004-05",24,"TOR","NBA",4.2,82,0,1553,247,463,208,371,39,92,56,71,108,177,285,48,39,19,40,220,589,6.8
2913,"Bruce Bowen\bowenbr01","2000-01",29,"MIA","NBA",4.2,82,72,2685,211,581,108,274,103,307,98,161,45,200,245,132,83,53,74,269,623,7.15
2914,"Shawn Bradley\bradlsh01","1998-99",26,"DAL","NBA",4.2,49,33,1294,167,348,167,344,0,4,86,115,130,262,392,40,35,159,56,153,420,11.48
2915,"Chucky Brown\brownch01","1995-96",27,"HOU","NBA",4.2,82,82,2019,300,555,299,547,1,8,104,150,134,307,441,89,47,38,94,163,705,8.91
2916,"P.J. Brown\brownpj01","1993-94",24,"NJN","NBA",4.2,79,54,1950,167,402,166,396,1,6,115,152,188,305,493,93,71,93,72,177,450,7.84
2917,"Reggie Bullock\bullore01","2017-18",26,"DET","NBA",4.2,62,52,1732,267,546,142,265,125,281,39,49,27,127,154,95,47,13,47,70,698,9.72
2918,"Andrew Bynum\bynuman01","2006-07",19,"LAL","NBA",4.2,82,53,1793,247,443,247,440,0,3,143,214,139,345,484,94,12,128,115,249,637,9.25
2919,"José Calderón\caldejo01","2009-10",28,"TOR","NBA",4.2,68,39,1817,274,568,206,397,68,171,83,104,23,119,142,404,47,7,99,135,699,11.68
2920,"Elden Campbell\campbel01","1993-94",25,"LAL","NBA",4.2,76,74,2253,373,808,373,806,0,2,188,273,167,352,519,86,64,146,98,241,934,12.07
2921,"Vince Carter\cartevi01","2002-03",26,"TOR","NBA",4.2,43,42,1471,355,760,310,629,45,131,129,160,59,129,188,143,48,41,74,121,884,17.06
2922,"Kelvin Cato\catoke01","1999-00",25,"HOU","NBA",4.2,65,32,1581,216,402,216,398,0,4,135,208,102,287,389,26,33,124,71,175,567,9.79
2923,"Rex Chapman\chapmre01","1995-96",28,"MIA","NBA",4.2,56,50,1865,289,679,164,342,125,337,83,113,22,123,145,166,45,10,79,117,786,11.44
2924,"Doug Christie\chrisdo01","1998-99",28,"TOR","NBA",4.2,50,50,1768,252,650,203,489,49,161,207,246,59,148,207,187,113,26,119,111,760,14.7
2925,"Keon Clark\clarkke01","1999-00",24,"DEN","NBA",4.2,81,20,1850,286,528,285,520,1,8,121,176,162,343,505,71,45,114,125,231,694,9.79
2926,"Speedy Claxton\claxtsp01","2003-04",25,"GSW","NBA",4.2,60,29,1595,224,524,220,502,4,22,182,224,38,118,156,267,97,9,102,146,634,11.54
2927,"Jarron Collins\collija03","2003-04",25,"UTA","NBA",4.2,81,31,1732,147,295,147,294,0,1,188,262,117,199,316,77,26,18,79,255,482,6.46
2928,"DeMarcus Cousins\couside01","2011-12",21,"SAC","NBA",4.2,64,62,1950,448,999,446,985,2,14,262,373,265,438,703,102,93,75,170,257,1160,17.09
2929,"Allen Crabbe\crabbal01","2016-17",24,"POR","NBA",4.2,79,7,2254,303,647,169,345,134,302,105,124,19,207,226,94,54,20,62,171,845,9.24
2930,"Jamal Crawford\crawfja01","2004-05",24,"NYK","NBA",4.2,70,67,2688,437,1097,252,585,185,512,182,216,33,170,203,302,92,19,148,135,1241,14.75
2931,"Marquis Daniels\daniema01","2005-06",25,"DAL","NBA",4.2,62,29,1766,246,512,242,493,4,19,138,183,81,143,224,172,67,13,100,143,634,10.36
2932,"Hubert Davis\davishu01","1993-94",23,"NYK","NBA",4.2,56,27,1333,238,505,185,373,53,132,85,103,23,44,67,165,40,4,76,118,614,9.53
2933,"Ricky Davis\davisri01","2004-05",25,"BOS","NBA",4.2,82,11,2696,481,1041,420,861,61,180,286,351,66,183,249,246,89,27,205,174,1309,13.74
2934,"Sherman Douglas\douglsh01","1994-95",28,"BOS","NBA",4.2,65,43,2048,365,769,345,687,20,82,204,296,48,122,170,446,80,2,162,152,954,15.18
2935,"Toney Douglas\douglto01","2010-11",24,"NYK","NBA",4.2,81,9,1971,314,755,171,372,143,383,85,107,65,179,244,244,89,4,89,177,856,9.93
2936,"Chris Duhon\duhonch01","2008-09",26,"NYK","NBA",4.2,79,78,2906,287,681,160,356,127,325,179,209,45,201,246,566,72,7,221,126,880,13.64
2937,"Mike Dunleavy\dunlemi02","2005-06",25,"GSW","NBA",4.2,81,68,2578,331,816,257,556,74,260,196,252,78,321,399,237,60,32,120,199,932,10.85
2938,"Mario Elie\eliema01","1993-94",30,"HOU","NBA",4.2,67,8,1606,208,466,152,299,56,167,154,179,28,153,181,208,50,8,109,124,626,9.65
2939,"Tyreke Evans\evansty01","2017-18",28,"MEM","NBA",4.2,52,32,1607,366,809,252,523,114,286,164,209,44,221,265,269,57,17,117,96,1010,17.99
2940,"Raymond Felton\feltora01","2012-13",28,"NYK","NBA",4.2,68,68,2313,377,882,284,624,93,258,101,128,51,143,194,372,94,14,155,130,948,13.42
2941,"Michael Finley\finlemi01","2007-08",34,"SAS","NBA",4.2,82,61,2204,315,761,183,404,132,357,64,80,27,227,254,114,29,10,56,93,826,7.69
2942,"Jeff Foster\fosteje01","2001-02",25,"IND","NBA",4.2,82,48,1786,177,394,175,379,2,15,111,182,206,350,556,70,71,38,79,232,467,7.35
2943,"Jeff Foster\fosteje01","2008-09",32,"IND","NBA",4.2,74,26,1828,177,353,175,346,2,7,96,146,215,293,508,130,53,49,88,229,452,8.61
2944,"Francisco García\garcifr01","2007-08",26,"SAC","NBA",4.2,79,20,2096,348,752,235,463,113,289,162,208,52,212,264,128,96,50,128,232,971,11.29
2945,"Devean George\georgde01","2001-02",24,"LAL","NBA",4.2,82,1,1759,215,523,149,345,66,178,85,126,78,225,303,111,71,42,66,190,581,7.12
2946,"Manu Ginóbili\ginobma01","2011-12",34,"SAS","NBA",4.2,34,7,792,150,285,98,159,52,126,88,101,18,98,116,151,24,12,64,56,440,14.11
2947,"Manu Ginóbili\ginobma01","2002-03",25,"SAS","NBA",4.2,69,5,1431,174,397,123,249,51,148,126,171,47,114,161,138,96,17,100,170,525,8.23
2948,"Ryan Gomes\gomesry01","2006-07",24,"BOS","NBA",4.2,73,60,2275,338,723,322,681,16,42,189,233,125,282,407,119,48,13,105,169,881,10.9
2949,"Danny Green\greenda02","2015-16",28,"SAS","NBA",4.2,79,79,2062,211,561,95,212,116,349,34,46,48,255,303,141,79,64,75,141,572,7.63
2950,"Danny Green\greenda02","2013-14",26,"SAS","NBA",4.2,68,59,1651,218,505,86,187,132,318,50,63,25,204,229,104,65,61,76,107,618,9.1
2951,"Jeff Green\greenje02","2008-09",22,"OKC","NBA",4.2,78,78,2873,476,1068,380,821,96,247,242,307,120,399,519,155,81,33,173,202,1290,14.45
2952,"Maurice Harkless\harklma01","2016-17",23,"POR","NBA",4.2,77,69,2223,314,624,246,430,68,194,77,124,125,216,341,88,85,70,86,214,773,10.06
2953,"Devin Harris\harride01","2011-12",28,"UTA","NBA",4.2,63,63,1741,241,542,164,329,77,213,156,209,12,100,112,316,64,13,122,136,715,11.9
2954,"Devin Harris\harride01","2014-15",31,"DAL","NBA",4.2,76,3,1685,219,524,124,258,95,266,132,162,13,122,135,237,78,14,85,147,665,8.97
2955,"Devin Harris\harride01","2010-11",27,"TOT","NBA",4.2,71,70,2254,343,813,285,633,58,180,335,402,17,152,169,503,70,7,207,163,1079,15.7
2956,"Roy Hibbert\hibbero01","2014-15",28,"IND","NBA",4.2,76,76,1926,317,710,317,708,0,2,168,204,156,384,540,84,18,125,107,216,802,10.5
2957,"Jrue Holiday\holidjr01","2011-12",21,"PHI","NBA",4.2,65,65,2196,360,834,295,663,65,171,94,120,57,155,212,290,103,18,135,137,879,12.8
2958,"Robert Horry\horryro01","1994-95",24,"HOU","NBA",4.2,64,61,2074,240,537,154,310,86,227,86,113,81,243,324,216,94,76,122,161,652,12.33
2959,"Andre Iguodala\iguodan01","2018-19",35,"GSW","NBA",4.2,68,13,1578,151,302,103,158,48,144,39,67,48,204,252,216,61,51,52,95,389,8.46
2960,"Brandon Jennings\jennibr01","2009-10",20,"MIL","NBA",4.2,82,82,2671,451,1216,306,828,145,388,223,273,49,233,282,470,105,18,200,191,1270,13.89
2961,"Keith Jennings\jennike01","1994-95",26,"GSW","NBA",4.2,80,24,1722,190,425,115,221,75,204,134,153,26,122,148,373,95,2,120,133,589,9.71
2962,"Joe Johnson\johnsjo02","2010-11",29,"ATL","NBA",4.2,72,72,2554,514,1161,425,861,89,300,195,243,59,232,291,338,47,7,146,131,1312,15.15
2963,"Tyler Johnson\johnsty01","2017-18",25,"MIA","NBA",4.2,72,39,2052,309,711,190,387,119,324,106,129,34,214,248,165,60,34,81,148,843,10.53
2964,"Popeye Jones\jonespo01","1996-97",26,"TOR","NBA",4.2,79,61,2421,258,537,257,524,1,13,99,121,270,410,680,84,58,39,116,269,616,9.5
2965,"Jason Kapono\kaponja01","2006-07",25,"MIA","NBA",4.2,67,35,1767,278,563,170,353,108,210,66,74,26,154,180,81,38,2,70,135,730,9.13
2966,"Kyle Korver\korveky01","2007-08",26,"TOT","NBA",4.2,75,0,1732,255,575,144,279,111,296,119,130,21,151,172,101,42,29,75,192,740,8.49
2967,"Nenad Krstić\krstine01","2009-10",26,"OKC","NBA",4.2,76,76,1741,281,560,280,555,1,5,76,106,134,249,383,52,32,45,58,177,639,7.9
2968,"Courtney Lee\leeco01","2016-17",31,"NYK","NBA",4.2,77,74,2459,321,704,213,435,108,269,85,98,53,206,259,179,81,24,69,141,835,10.29
2969,"Jeff Malone\malonje01","1993-94",32,"TOT","NBA",4.2,77,73,2560,525,1081,518,1069,7,12,205,247,51,148,199,125,40,5,85,123,1262,11.81
2970,"Donyell Marshall\marshdo01","2005-06",32,"CLE","NBA",4.2,81,0,2077,265,671,137,276,128,395,92,123,105,387,492,60,59,41,90,160,750,8.65
2971,"Donyell Marshall\marshdo01","1997-98",24,"GSW","NBA",4.2,73,73,2611,451,1090,388,889,63,201,158,216,210,418,628,159,95,73,147,226,1123,14.05
2972,"Kevin Martin\martike02","2009-10",26,"TOT","NBA",4.2,46,43,1633,289,693,219,483,70,210,298,340,29,135,164,111,46,6,92,96,946,16.37
2973,"O.J. Mayo\mayooj01","2012-13",25,"DAL","NBA",4.2,82,82,2913,461,1026,319,677,142,349,191,233,36,255,291,361,93,23,210,195,1255,14.42
2974,"Antonio McDyess\mcdyean01","1998-99",24,"DEN","NBA",4.2,50,50,1937,415,882,414,873,1,9,230,338,168,369,537,82,73,115,138,175,1061,19.84
2975,"Mike Miller\millemi01","2008-09",28,"MIN","NBA",4.2,73,47,2356,264,548,179,323,85,225,109,149,73,410,483,326,30,31,145,139,722,12.34
2976,"Marcus Morris\morrima03","2013-14",24,"PHO","NBA",4.2,82,1,1800,288,651,189,391,99,260,121,159,84,235,319,88,72,18,95,157,796,8.71
2977,"Rasho Nesterović\nestera01","2004-05",28,"SAS","NBA",4.2,70,70,1785,198,430,198,430,0,0,14,30,184,275,459,71,31,117,73,207,410,7.54
2978,"Greg Ostertag\ostergr01","1999-00",26,"UTA","NBA",4.2,81,3,1606,124,267,124,266,0,1,119,187,172,310,482,18,20,172,79,196,367,6.77
2979,"Zaza Pachulia\pachuza01","2014-15",30,"MIL","NBA",4.2,73,45,1730,240,529,240,526,0,3,126,160,197,303,500,178,80,21,133,170,606,10.1
2980,"James Posey\poseyja01","2008-09",32,"NOH","NBA",4.2,75,0,2140,216,524,100,210,116,314,120,146,38,324,362,82,58,21,79,216,668,8.69
2981,"James Posey\poseyja01","2005-06",29,"MIA","NBA",4.2,67,63,1914,159,395,42,105,117,290,48,61,33,286,319,89,54,20,58,196,483,7.8
2982,"Mark Price\pricema01","1994-95",30,"CLE","NBA",4.2,48,34,1375,253,612,150,359,103,253,148,162,25,87,112,335,35,4,142,50,757,15.44
2983,"Vladimir Radmanović\radmavl01","2003-04",23,"SEA","NBA",4.2,77,38,2321,345,812,205,435,140,377,95,127,104,302,406,142,80,42,109,187,925,11.08
2984,"Andre Roberson\roberan03","2016-17",25,"OKC","NBA",4.2,79,79,2376,215,463,170,279,45,184,47,111,98,305,403,79,94,79,51,204,522,7.9
2985,"Terrence Ross\rosste01","2013-14",22,"TOR","NBA",4.2,81,62,2159,318,751,157,343,161,408,82,98,43,209,252,79,64,27,88,183,879,8.8
2986,"Josh Smith\smithjo03","2012-13",27,"ATL","NBA",4.2,76,76,2683,550,1182,489,981,61,201,166,321,133,506,639,321,94,136,226,175,1327,17.46
2987,"Marreese Speights\speigma01","2016-17",29,"LAC","NBA",4.2,82,2,1286,244,548,141,271,103,277,120,137,88,285,373,65,23,41,69,229,711,8.1
2988,"Ronny Turiaf\turiaro01","2007-08",25,"LAL","NBA",4.2,78,21,1458,188,397,188,396,0,1,140,186,95,211,306,128,28,108,72,199,516,7.83
2989,"Jonas Valančiūnas\valanjo01","2018-19",26,"TOT","NBA",4.2,49,27,1091,301,538,287,490,14,48,147,185,106,313,419,70,19,53,90,146,763,15.6
2990,"Loy Vaught\vaughlo01","1992-93",24,"LAC","NBA",4.2,79,4,1653,313,616,312,612,1,4,116,155,164,328,492,54,55,39,83,172,743,9.35
2991,"Andrew Wiggins\wiggian01","2016-17",21,"MIN","NBA",4.2,82,82,3048,709,1570,606,1281,103,289,412,542,102,226,328,189,82,30,187,183,1933,17.46
2992,"Steven Adams\adamsst01","2014-15",21,"OKC","NBA",4.1,70,67,1771,217,399,217,397,0,2,103,205,199,324,523,66,38,86,99,222,537,9.39
2993,"Ray Allen\allenra02","2013-14",38,"MIA","NBA",4.1,73,9,1936,240,543,124,234,116,309,105,116,23,182,205,143,54,8,84,115,701,8.96
2994,"Tony Allen\allento01","2014-15",33,"MEM","NBA",4.1,63,41,1648,225,455,215,426,10,29,79,126,103,177,280,86,129,30,86,166,539,9.74
2995,"Greg Anthony\anthogr01","1999-00",32,"POR","NBA",4.1,82,3,1548,169,416,81,183,88,233,88,114,17,116,133,208,59,9,85,143,514,6.64
2996,"D.J. Augustin\augusdj01","2017-18",30,"ORL","NBA",4.1,75,36,1760,244,540,130,268,114,272,164,189,30,130,160,287,54,0,123,94,766,10.59
2997,"Kelenna Azubuike\azubuke01","2008-09",25,"GSW","NBA",4.1,74,51,2375,392,845,298,635,94,210,185,229,112,258,370,117,57,50,95,183,1063,12.6
2998,"Brandon Bass\bassbr01","2008-09",23,"DAL","NBA",4.1,81,0,1574,252,508,252,502,0,6,182,210,129,238,367,43,27,55,86,140,686,8.18
2999,"Brandon Bass\bassbr01","2015-16",30,"LAL","NBA",4.1,66,0,1342,174,317,174,315,0,2,125,148,104,181,285,74,33,55,42,125,473,8.32
3000,"Aron Baynes\baynear01","2015-16",29,"DET","NBA",4.1,81,1,1233,194,384,194,382,0,2,126,165,140,244,384,51,21,52,67,151,514,6.84
3001,"Kent Bazemore\bazemke01","2015-16",26,"ATL","NBA",4.1,75,68,2083,320,725,211,420,109,305,123,151,28,351,379,171,98,38,138,176,872,11.7
3002,"Benoit Benjamin\benjabe01","1993-94",29,"NJN","NBA",4.1,77,74,1817,283,589,283,589,0,0,152,214,135,364,499,44,35,90,97,198,718,9.38
3003,"Travis Best\besttr01","1996-97",24,"IND","NBA",4.1,76,46,2064,274,620,217,465,57,155,149,197,36,130,166,318,98,5,153,221,754,10.54
3004,"Eric Bledsoe\bledser01","2013-14",24,"PHO","NBA",4.1,43,40,1416,265,556,215,416,50,140,183,237,27,175,202,235,69,14,143,99,763,18.19
3005,"Anthony Bonner\bonnean01","1993-94",25,"NYK","NBA",4.1,73,38,1402,162,288,162,288,0,0,50,105,150,194,344,88,76,13,89,175,374,6.84
3006,"Matt Bonner\bonnema01","2005-06",25,"TOR","NBA",4.1,78,6,1710,209,467,107,224,102,243,63,76,86,198,284,56,49,31,32,216,583,7.15
3007,"Carlos Boozer\boozeca01","2004-05",23,"UTA","NBA",4.1,51,51,1772,361,693,361,692,0,1,187,268,141,316,457,144,41,24,137,179,909,17.2
3008,"Bruce Bowen\bowenbr01","2006-07",35,"SAS","NBA",4.1,82,82,2464,189,467,100,235,89,232,43,73,23,200,223,117,62,25,65,175,510,6.06
3009,"Earl Boykins\boykiea01","2003-04",27,"DEN","NBA",4.1,82,3,1849,321,766,266,595,55,171,142,162,42,101,143,295,51,3,100,84,839,9.02
3010,"Malcolm Brogdon\brogdma01","2016-17",24,"MIL","NBA",4.1,75,28,1982,290,635,212,442,78,193,109,126,47,166,213,317,84,12,113,140,767,11.08
3011,"DeMarre Carroll\carrode01","2017-18",31,"BRK","NBA",4.1,73,73,2180,325,785,180,394,145,391,188,246,105,374,479,147,59,30,103,165,983,12.53
3012,"Tyson Chandler\chandty01","2016-17",34,"PHO","NBA",4.1,47,46,1298,153,228,153,228,0,0,91,124,153,386,539,30,33,24,65,126,397,12.17
3013,"Calbert Cheaney\cheanca01","1997-98",26,"WAS","NBA",4.1,82,82,2841,448,981,433,928,15,53,139,215,82,242,324,173,96,36,104,264,1050,10.78
3014,"Jamal Crawford\crawfja01","2003-04",23,"CHI","NBA",4.1,80,73,2811,509,1318,344,797,165,521,200,240,46,237,283,405,111,29,193,161,1383,14.7
3015,"Austin Croshere\croshau01","2005-06",30,"IND","NBA",4.1,50,26,1148,132,285,78,145,54,140,90,102,62,203,265,62,22,7,48,105,408,8.66
3016,"Austin Croshere\croshau01","2004-05",29,"IND","NBA",4.1,73,22,1827,188,497,143,323,45,174,226,256,103,272,375,98,48,17,104,154,647,8.78
3017,"Samuel Dalembert\dalemsa01","2011-12",30,"HOU","NBA",4.1,65,45,1446,200,395,200,394,0,1,90,113,158,298,456,33,37,111,82,162,490,9.3
3018,"Erick Dampier\dampier01","2002-03",27,"GSW","NBA",4.1,82,82,1978,259,522,259,520,0,2,155,222,248,295,543,58,27,154,112,242,673,9.48
3019,"DeSagana Diop\diopde01","2005-06",24,"DAL","NBA",4.1,81,45,1510,75,154,74,152,1,2,39,72,145,229,374,23,44,146,36,253,190,5.07
3020,"Chris Dudley\dudlech02","1994-95",29,"POR","NBA",4.1,82,82,2245,181,446,181,445,0,1,85,183,325,439,764,34,43,126,81,286,447,7.67
3021,"Jared Dudley\dudleja01","2014-15",29,"MIL","NBA",4.1,72,22,1717,198,423,124,231,74,192,48,67,45,175,220,130,72,11,62,113,518,7.67
3022,"Chris Duhon\duhonch01","2004-05",22,"CHI","NBA",4.1,82,73,2177,172,488,78,223,94,265,49,67,23,190,213,398,82,3,119,205,487,7.99
3023,"Mike Dunleavy\dunlemi02","2014-15",34,"CHI","NBA",4.1,63,63,1838,209,481,102,218,107,263,70,87,28,220,248,114,39,21,60,123,595,9.01
3024,"Danny Ferry\ferryda01","2000-01",34,"SAS","NBA",4.1,80,29,1688,178,375,108,219,70,156,22,30,55,168,223,71,28,21,50,169,448,5.44
3025,"Daniel Gibson\gibsoda01","2007-08",21,"CLE","NBA",4.1,58,26,1765,201,465,83,197,118,268,85,105,30,104,134,145,47,14,76,163,605,9.72
3026,"Armen Gilliam\gilliar01","1996-97",32,"MIL","NBA",4.1,80,25,2050,246,522,246,522,0,0,199,259,136,361,497,53,61,40,105,206,691,9.06
3027,"Horace Grant\grantho01","1998-99",33,"ORL","NBA",4.1,50,50,1660,198,456,198,454,0,2,47,70,117,234,351,90,46,60,44,99,443,9.7
3028,"Montrezl Harrell\harremo01","2016-17",23,"HOU","NBA",4.1,58,14,1064,225,345,224,338,1,7,76,121,81,138,219,64,20,42,44,126,527,9.3
3029,"Lucious Harris\harrilu01","1994-95",24,"DAL","NBA",4.1,79,31,1695,280,610,225,468,55,142,136,170,85,135,220,132,58,14,77,105,751,8.49
3030,"Tobias Harris\harrito02","2013-14",21,"ORL","NBA",4.1,61,36,1850,332,716,300,590,32,126,197,244,88,336,424,82,41,24,78,143,893,12.96
3031,"Roy Hibbert\hibbero01","2009-10",23,"IND","NBA",4.1,81,69,2035,387,782,384,776,3,6,169,224,177,287,464,158,30,131,145,285,946,11.72
3032,"Nenê Hilário\hilarne01","2016-17",34,"HOU","NBA",4.1,67,8,1198,245,397,242,388,3,9,116,197,95,187,282,65,56,39,73,163,609,9.53
3033,"Kirk Hinrich\hinriki01","2003-04",23,"CHI","NBA",4.1,76,66,2706,318,823,174,454,144,369,135,168,42,217,259,517,101,21,204,276,915,13.61
3034,"Rondae Hollis-Jefferson\holliro01","2017-18",23,"BRK","NBA",4.1,68,59,1920,342,724,329,670,13,54,249,316,101,358,459,167,65,48,121,145,946,13.95
3035,"Kris Humphries\humphkr01","2013-14",28,"BOS","NBA",4.1,69,30,1376,231,461,231,459,0,2,117,144,127,282,409,67,31,61,64,136,579,9.02
3036,"Ersan İlyasova\ilyaser01","2016-17",29,"TOT","NBA",4.1,82,52,2142,384,890,242,488,142,402,161,207,115,366,481,141,58,23,116,211,1071,11.57
3037,"Kyrie Irving\irvinky01","2011-12",19,"CLE","NBA",4.1,51,51,1558,350,747,277,564,73,183,171,196,44,147,191,275,54,20,160,110,944,17.41
3038,"Allen Iverson\iversal01","1996-97",21,"PHI","NBA",4.1,76,74,3045,625,1504,470,1049,155,455,382,544,115,197,312,567,157,24,337,233,1787,21.25
3039,"Jarrett Jack\jackja01","2008-09",25,"IND","NBA",4.1,82,53,2716,386,853,308,632,78,221,224,263,44,232,276,338,88,17,184,179,1074,12.96
3040,"Jaren Jackson\jacksja01","1997-98",30,"SAS","NBA",4.1,82,45,2226,258,654,146,357,112,297,94,118,55,155,210,156,60,8,104,222,722,7.52
3041,"Mark Jackson\jacksma01","1993-94",28,"LAC","NBA",4.1,79,79,2711,331,732,295,605,36,127,167,211,107,241,348,678,120,6,232,115,865,15.26
3042,"Stephen Jackson\jacksst02","2006-07",28,"TOT","NBA",4.1,75,69,2479,409,944,309,633,100,311,243,299,61,161,222,287,84,34,183,200,1161,13.85
3043,"Amir Johnson\johnsam01","2017-18",30,"PHI","NBA",4.1,74,18,1171,140,260,130,228,10,32,52,85,123,207,330,118,45,44,55,192,342,6.66
3044,"Avery Johnson\johnsav01","1993-94",28,"GSW","NBA",4.1,82,70,2332,356,724,356,712,0,12,178,253,41,135,176,433,113,8,172,160,890,12.05
3045,"James Johnson\johnsja01","2014-15",27,"TOR","NBA",4.1,70,17,1370,238,404,227,353,11,51,67,102,61,196,257,95,54,70,79,155,554,8.92
3046,"Joe Johnson\johnsjo02","2014-15",33,"BRK","NBA",4.1,80,80,2791,446,1025,325,688,121,337,141,176,53,331,384,292,59,14,137,120,1154,12.85
3047,"Larry Johnson\johnsla02","2000-01",31,"NYK","NBA",4.1,65,65,2105,246,598,195,435,51,163,102,128,90,273,363,127,39,29,97,209,645,9.35
3048,"Adam Keefe\keefead01","1994-95",24,"UTA","NBA",4.1,75,0,1270,172,298,172,298,0,0,117,173,135,192,327,30,36,25,62,141,461,6.72
3049,"Kyle Korver\korveky01","2015-16",34,"ATL","NBA",4.1,80,80,2401,268,616,110,219,158,397,45,54,14,246,260,164,60,35,98,161,739,8.93
3050,"Christian Laettner\laettch01","1993-94",24,"MIN","NBA",4.1,70,67,2428,396,883,390,858,6,25,375,479,160,442,602,307,87,86,259,264,1173,18.21
3051,"Carl Landry\landrca01","2010-11",27,"TOT","NBA",4.1,76,26,2008,345,687,345,683,0,4,213,288,165,182,347,63,40,32,109,196,903,10.2
3052,"Rashard Lewis\lewisra02","1999-00",20,"SEA","NBA",4.1,82,8,1575,275,566,235,446,40,120,84,123,127,209,336,70,62,36,78,163,674,7.84
3053,"Shawn Marion\mariosh01","1999-00",21,"PHO","NBA",4.1,51,38,1260,222,471,218,449,4,22,72,85,105,227,332,69,38,53,51,113,520,10.39
3054,"Jamal Mashburn\mashbja01","1997-98",25,"MIA","NBA",4.1,48,48,1729,251,577,214,455,37,122,184,231,72,164,236,132,43,14,108,137,723,13.34
3055,"Jason Maxiell\maxieja01","2008-09",25,"DET","NBA",4.1,78,4,1408,184,320,184,319,0,1,84,158,169,155,324,24,25,63,45,157,452,6.25
3056,"Walter McCarty\mccarwa01","2002-03",28,"BOS","NBA",4.1,82,8,1949,173,418,82,170,91,248,61,98,64,224,288,106,78,28,67,188,498,6.67
3057,"JaVale McGee\mcgeeja01","2011-12",24,"TOT","NBA",4.1,61,45,1535,307,552,307,552,0,0,77,167,163,314,477,31,35,132,87,166,691,11.99
3058,"Tracy McGrady\mcgratr01","2005-06",26,"HOU","NBA",4.1,47,47,1745,410,1011,337,777,73,234,254,340,46,261,307,225,59,41,120,88,1147,19.93
3059,"Jeff McInnis\mcinnje01","2004-05",30,"CLE","NBA",4.1,76,69,2651,377,915,286,651,91,264,130,160,32,125,157,391,56,1,117,177,975,11.4
3060,"Jodie Meeks\meeksjo01","2011-12",24,"PHI","NBA",4.1,66,50,1644,191,467,94,201,97,266,77,85,17,144,161,54,40,3,29,82,556,6.77
3061,"Patty Mills\millspa02","2017-18",29,"SAS","NBA",4.1,82,36,2107,280,682,126,268,154,414,105,118,26,128,154,229,55,11,106,128,819,8.94
3062,"Eric Montross\montrer01","1994-95",23,"BOS","NBA",4.1,78,75,2315,307,575,307,574,0,1,167,263,196,370,566,36,29,61,112,299,781,10.08
3063,"Markieff Morris\morrima02","2016-17",27,"WAS","NBA",4.1,76,76,2374,406,889,335,693,71,196,180,215,107,386,493,126,82,42,129,254,1063,12.97
3064,"Chris Mullin\mullich01","1998-99",35,"IND","NBA",4.1,50,50,1179,177,371,104,214,73,157,80,92,25,135,160,81,47,13,60,101,507,9.8
3065,"Eric Murdock\murdoer01","1997-98",29,"MIA","NBA",4.1,82,1,1395,177,419,149,328,28,91,125,156,39,117,156,219,103,13,104,173,507,7.32
3066,"Gheorghe Mureșan\muresgh01","1994-95",23,"WSB","NBA",4.1,73,58,1720,303,541,303,541,0,0,124,175,179,309,488,38,48,127,115,259,730,11.11
3067,"Lamond Murray\murrala01","2001-02",28,"CLE","NBA",4.1,71,68,2312,430,986,329,748,101,238,215,263,81,291,372,157,70,43,141,148,1176,14.05
3068,"Boštjan Nachbar\nachbbo01","2006-07",26,"NJN","NBA",4.1,76,1,1532,226,495,114,230,112,265,132,164,27,226,253,61,30,26,69,183,696,8.15
3069,"Eduardo Nájera\najered01","2007-08",31,"DEN","NBA",4.1,78,3,1664,174,368,121,221,53,147,63,89,113,224,337,95,69,40,59,199,464,7.23
3070,"Rasho Nesterović\nestera01","2001-02",25,"MIN","NBA",4.1,82,82,2218,324,657,324,656,0,1,39,71,200,334,534,75,45,109,94,262,687,8.92
3071,"Rasho Nesterović\nestera01","2006-07",30,"TOR","NBA",4.1,80,73,1676,230,421,230,420,0,1,34,50,115,245,360,74,37,84,56,193,494,7.21
3072,"Andrés Nocioni\nocioan01","2006-07",27,"CHI","NBA",4.1,53,31,1406,273,584,193,375,80,209,123,145,42,259,301,57,27,24,104,164,749,12.16
3073,"Fabricio Oberto\obertfa01","2006-07",31,"SAS","NBA",4.1,79,33,1365,158,281,158,281,0,0,33,51,131,237,368,68,25,24,69,213,349,5.63
3074,"Kelly Olynyk\olynyke01","2016-17",25,"BOS","NBA",4.1,75,6,1538,260,508,192,316,68,192,90,123,73,288,361,148,43,29,96,207,678,9.66
3075,"Kelly Olynyk\olynyke01","2015-16",24,"BOS","NBA",4.1,69,8,1395,253,556,168,346,85,210,96,128,72,209,281,105,52,33,74,163,687,9.38
3076,"Tony Parker\parketo01","2014-15",32,"SAS","NBA",4.1,68,68,1953,404,832,366,743,38,89,130,166,15,114,129,335,44,2,146,108,976,12.83
3077,"Patrick Patterson\pattepa01","2012-13",23,"TOT","NBA",4.1,71,41,1775,319,623,268,491,51,132,48,63,113,224,337,81,31,40,61,138,737,9.48
3078,"Gary Payton\paytoga01","2005-06",37,"MIA","NBA",4.1,81,25,2305,230,547,164,317,66,230,100,126,34,199,233,257,71,10,102,169,626,8.34
3079,"Anthony Peeler\peelean01","1999-00",30,"MIN","NBA",4.1,82,22,2073,316,725,231,470,85,255,87,109,58,174,232,195,62,10,85,171,804,8.69
3080,"Byron Scott\scottby01","1996-97",35,"LAL","NBA",4.1,79,8,1440,163,379,90,191,73,188,127,151,21,97,118,99,46,16,53,72,526,6.2
3081,"Thabo Sefolosha\sefolth01","2010-11",26,"OKC","NBA",4.1,79,79,2049,157,333,129,231,28,102,59,79,65,281,346,111,97,38,55,171,401,7.12
3082,"Brian Skinner\skinnbr01","2002-03",26,"PHI","NBA",4.1,77,9,1381,182,331,182,331,0,0,97,161,136,230,366,19,47,53,62,176,461,6.76
3083,"Joe Smith\smithjo02","2007-08",32,"TOT","NBA",4.1,77,36,1726,312,653,312,650,0,3,154,204,163,238,401,66,34,47,71,186,778,9.08
3084,"Jerry Stackhouse\stackje01","2006-07",32,"DAL","NBA",4.1,67,8,1615,280,654,218,492,62,162,182,215,39,106,145,187,51,10,117,78,804,10.33
3085,"DeShawn Stevenson\stevede01","2007-08",26,"WAS","NBA",4.1,82,82,2564,301,780,143,367,158,413,157,197,37,198,235,252,65,15,102,110,917,10.02
3086,"Amar'e Stoudemire\stoudam01","2011-12",29,"NYK","NBA",4.1,47,47,1543,316,654,311,633,5,21,186,243,106,261,367,52,38,45,112,138,823,15.35
3087,"Rod Strickland\stricro02","1998-99",32,"WAS","NBA",4.1,44,43,1632,251,603,239,561,12,42,176,236,56,156,212,434,76,5,142,91,690,18.46
3088,"Derek Strong\stronde01","1996-97",28,"ORL","NBA",4.1,82,21,2004,262,586,262,573,0,13,175,218,174,345,519,73,47,20,102,196,699,8.49
3089,"Bob Sura\surabo01","2001-02",28,"GSW","NBA",4.1,78,5,1780,250,590,208,457,42,133,236,328,89,167,256,275,88,17,133,160,778,10.55
3090,"Kurt Thomas\thomaku01","2007-08",35,"TOT","NBA",4.1,70,48,1584,195,396,195,395,0,1,53,80,130,377,507,67,56,57,46,188,443,8.27
3091,"Tim Thomas\thomati01","2003-04",26,"TOT","NBA",4.1,66,65,2089,363,813,290,619,73,194,171,218,64,256,320,124,64,20,116,196,970,12.43
3092,"T.J. Warren\warretj01","2016-17",23,"PHO","NBA",4.1,66,59,2048,403,814,377,716,26,98,119,154,125,214,339,75,76,39,57,175,951,12.42
3093,"Andrew Wiggins\wiggian01","2015-16",20,"MIN","NBA",4.1,81,81,2845,594,1294,537,1104,57,190,430,565,105,186,291,164,78,46,182,165,1675,15.98
3094,"Deron Williams\willide01","2011-12",27,"NJN","NBA",4.1,55,55,1999,391,961,276,619,115,342,257,305,23,160,183,481,67,20,219,121,1154,20.17
3095,"Corliss Williamson\willico02","2003-04",30,"DET","NBA",4.1,79,0,1574,304,602,304,602,0,0,144,197,88,168,256,57,30,20,113,204,752,7.81
3096,"Brandan Wright\wrighbr03","2012-13",25,"DAL","NBA",4.1,64,16,1149,241,404,241,401,0,3,59,96,85,175,260,38,26,76,34,78,541,8.59
3097,"Thaddeus Young\youngth01","2015-16",27,"BRK","NBA",4.1,73,73,2407,495,963,488,933,7,30,105,163,176,484,660,135,112,37,136,182,1102,15.06
3098,"Al-Farouq Aminu\aminual01","2015-16",25,"POR","NBA",4,82,82,2341,299,719,173,370,126,349,115,156,98,401,499,138,72,53,120,171,839,10.3
3099,"Isaac Austin\austiis01","1996-97",27,"MIA","NBA",4,82,17,1881,321,639,321,636,0,3,150,226,136,342,478,101,45,43,161,244,792,9.51
3100,"Jerryd Bayless\bayleje01","2012-13",24,"MEM","NBA",4,80,4,1765,260,621,189,420,71,201,102,122,22,154,176,264,59,17,120,168,693,8.5
3101,"Bradley Beal\bealbr01","2013-14",20,"WAS","NBA",4,73,73,2530,481,1149,343,806,138,343,149,189,54,219,273,243,71,18,128,153,1249,13.48
3102,"Charlie Bell\bellch01","2006-07",27,"MIL","NBA",4,82,64,2848,426,974,299,613,127,361,131,168,57,181,238,247,97,4,104,213,1110,11.61
3103,"Dāvis Bertāns\bertada01","2018-19",26,"SAS","NBA",4,76,12,1632,204,453,59,115,145,338,53,60,23,241,264,100,35,33,43,133,606,7.91
3104,"Mike Bibby\bibbymi01","2010-11",32,"TOT","NBA",4,80,68,2285,248,576,95,228,153,348,39,62,17,178,195,265,50,9,101,175,688,8.68
3105,"Bismack Biyombo\biyombi01","2014-15",22,"CHO","NBA",4,64,21,1243,101,186,101,186,0,0,102,175,159,248,407,16,18,99,52,140,304,6.97
3106,"DeJuan Blair\blairde01","2011-12",22,"SAS","NBA",4,64,62,1363,269,504,269,503,0,1,73,119,154,197,351,78,59,12,92,168,611,9.53
3107,"Andrew Bogut\bogutan01","2006-07",22,"MIL","NBA",4,66,66,2258,348,629,347,624,1,5,112,194,168,416,584,198,49,35,150,216,809,13.95
3108,"Matt Bonner\bonnema01","2011-12",31,"SAS","NBA",4,65,2,1326,154,350,49,100,105,250,16,21,29,185,214,61,15,21,14,68,429,6.18
3109,"José Calderón\caldejo01","2015-16",34,"NYK","NBA",4,72,72,2024,209,455,125,252,84,203,42,48,22,207,229,298,63,7,87,135,544,9.37
3110,"Kentavious Caldwell-Pope\caldwke01","2018-19",25,"LAL","NBA",4,82,23,2035,325,756,174,321,151,435,137,158,48,190,238,110,73,13,65,137,938,9.57
3111,"Vince Carter\cartevi01","2016-17",40,"MEM","NBA",4,73,15,1799,193,490,81,194,112,296,88,115,36,191,227,133,60,36,50,163,586,7.92
3112,"Cedric Ceballos\cebalce01","1999-00",30,"DAL","NBA",4,69,25,2064,447,1002,403,868,44,134,209,248,172,290,462,90,56,24,125,165,1147,13.47
3113,"Doug Christie\chrisdo01","1997-98",27,"TOR","NBA",4,78,78,2939,458,1071,358,764,100,307,271,327,94,310,404,282,190,57,228,198,1287,16.5
3114,"Mike Conley\conlemi01","2009-10",22,"MEM","NBA",4,80,80,2569,369,830,287,618,82,212,139,187,30,161,191,425,109,12,170,178,959,12.47
3115,"Robert Covington\covinro01","2014-15",24,"PHI","NBA",4,70,49,1956,299,756,132,310,167,446,178,217,65,251,316,105,97,31,128,189,943,11.95
3116,"Samuel Dalembert\dalemsa01","2008-09",27,"PHI","NBA",4,82,82,2036,216,434,216,432,0,2,91,124,214,487,701,18,33,146,117,248,523,8.79
3117,"Erick Dampier\dampier01","1997-98",22,"GSW","NBA",4,82,82,2656,352,791,352,789,0,2,267,399,272,443,715,94,39,139,175,281,971,12.11
3118,"Antonio Davis\davisan01","1998-99",30,"IND","NBA",4,49,1,1271,164,348,164,348,0,0,135,192,116,228,344,33,22,42,50,136,463,9.68
3119,"Ed Davis\davised01","2010-11",21,"TOR","NBA",4,65,17,1602,215,373,215,373,0,0,71,128,168,294,462,40,39,67,48,183,501,9.26
3120,"Dewayne Dedmon\dedmode01","2018-19",29,"ATL","NBA",4,64,52,1609,259,526,176,309,83,217,92,113,105,375,480,90,69,71,84,214,693,12.4
3121,"Bison Dele\delebi01","1995-96",26,"LAC","NBA",4,65,65,2157,416,766,415,760,1,6,196,267,149,343,492,122,70,55,190,226,1029,15.72
3122,"Carlos Delfino\delfica01","2007-08",25,"TOR","NBA",4,82,0,1928,251,632,131,318,120,314,116,156,66,293,359,145,69,11,75,177,738,8.56
3123,"DeMar DeRozan\derozde01","2014-15",25,"TOR","NBA",4,60,60,2100,409,990,384,902,25,88,361,434,41,236,277,210,73,11,137,122,1204,16.4
3124,"Sherman Douglas\douglsh01","1997-98",31,"NJN","NBA",4,80,11,1699,255,515,241,469,14,46,115,172,52,83,135,319,55,7,110,156,639,8.69
3125,"Monta Ellis\ellismo01","2006-07",21,"GSW","NBA",4,77,53,2638,480,1010,441,867,39,143,273,358,62,181,243,319,132,21,221,210,1272,15.46
3126,"Adonal Foyle\foylead01","2002-03",27,"GSW","NBA",4,82,0,1787,185,345,185,344,0,1,70,104,176,314,490,37,40,205,73,214,440,8.1
3127,"Marc Gasol\gasolma01","2017-18",33,"MEM","NBA",4,73,73,2408,434,1033,325,713,109,320,281,337,78,514,592,305,54,101,194,185,1258,17.28
3128,"Chris Gatling\gatlich01","1999-00",32,"TOT","NBA",4,85,0,1811,365,802,347,732,18,70,266,373,154,348,502,71,82,23,169,246,1014,10.64
3129,"Rudy Gay\gayru01","2012-13",26,"TOT","NBA",4,75,74,2687,521,1253,437,993,84,260,240,295,99,362,461,202,113,53,198,182,1366,15.35
3130,"Taj Gibson\gibsota01","2016-17",31,"TOT","NBA",4,78,71,1989,365,709,362,696,3,13,113,158,158,327,485,73,41,65,105,163,846,10.38
3131,"Harvey Grant\grantha01","1995-96",30,"POR","NBA",4,76,75,2394,314,679,293,612,21,67,60,110,117,244,361,111,60,43,82,173,709,8.57
3132,"Harvey Grant\grantha01","1994-95",29,"POR","NBA",4,75,14,1771,286,621,278,595,8,26,103,146,103,181,284,82,56,53,62,163,683,8.13
3133,"Richard Hamilton\hamilri01","2001-02",23,"WAS","NBA",4,63,57,2203,472,1084,456,1042,16,42,300,337,73,143,216,171,38,14,132,136,1260,14.75
3134,"Derek Harper\harpede01","1993-94",32,"TOT","NBA",4,82,55,2204,303,744,230,541,73,203,112,163,20,121,141,334,125,8,135,163,791,9.66
3135,"Ron Harper\harpero01","1999-00",36,"LAL","NBA",4,80,78,2042,212,531,179,425,33,106,100,147,96,241,337,270,85,39,132,164,557,8.59
3136,"Gary Harris\harriga01","2015-16",21,"DEN","NBA",4,76,76,2439,359,765,254,468,105,297,109,133,54,166,220,147,97,18,98,143,932,10.93
3137,"Joe Harris\harrijo01","2017-18",26,"BRK","NBA",4,78,14,1975,305,621,155,263,150,358,86,104,51,209,260,128,35,20,91,153,846,9.86
3138,"Trenton Hassell\hassetr01","2003-04",24,"MIN","NBA",4,81,74,2264,177,381,173,368,4,13,48,61,68,189,257,133,36,54,46,200,406,5.86
3139,"Nenê Hilário\hilarne01","2012-13",30,"WAS","NBA",4,61,49,1659,285,594,285,593,0,1,196,269,101,306,407,177,55,37,139,171,766,13.16
3140,"George Hill\hillge01","2011-12",25,"IND","NBA",4,50,9,1274,168,380,114,233,54,147,91,117,31,120,151,145,42,17,52,98,481,9.75
3141,"Kirk Hinrich\hinriki01","2009-10",29,"CHI","NBA",4,74,53,2481,308,753,204,473,104,280,85,113,24,236,260,330,85,24,113,204,805,11.17
3142,"Lindsey Hunter\hunteli01","1997-98",27,"DET","NBA",4,71,67,2505,316,826,231,561,85,265,145,196,61,186,247,224,123,10,110,174,862,10.92
3143,"Lindsey Hunter\hunteli01","1998-99",28,"DET","NBA",4,49,49,1755,228,524,169,371,59,153,67,89,26,142,168,193,86,8,92,126,582,12.07
3144,"Ersan İlyasova\ilyaser01","2014-15",27,"MIL","NBA",4,58,36,1319,263,557,189,367,74,190,69,107,80,197,277,56,36,19,45,149,669,9.8
3145,"Ersan İlyasova\ilyaser01","2017-18",30,"TOT","NBA",4,69,43,1729,277,613,186,360,91,253,105,135,118,287,405,90,61,26,72,157,750,10.49
3146,"Jonathan Isaac\isaacjo01","2018-19",21,"ORL","NBA",4,75,64,1996,262,611,176,345,86,266,110,135,99,312,411,80,59,98,75,143,720,9.8
3147,"Amir Johnson\johnsam01","2011-12",24,"TOR","NBA",4,64,43,1553,196,340,194,335,2,5,58,84,149,259,408,79,33,69,94,209,452,9.09
3148,"Anthony Johnson\johnsan02","2004-05",30,"IND","NBA",4,63,36,1747,203,456,162,348,41,108,85,113,32,147,179,302,59,15,96,144,532,10.08
3149,"Fred Jones\jonesfr01","2003-04",24,"IND","NBA",4,81,2,1508,123,311,96,222,27,89,124,149,25,101,126,173,65,18,73,132,397,5.77
3150,"James Jones\jonesja02","2005-06",25,"PHO","NBA",4,75,24,1772,243,581,133,296,110,285,103,121,44,209,253,57,38,49,35,142,699,7.94
3151,"Shawn Kemp\kempsh01","1999-00",30,"CLE","NBA",4,82,82,2492,484,1160,482,1154,2,6,493,635,231,494,725,138,100,96,291,371,1463,16.36
3152,"Nenad Krstić\krstine01","2010-11",27,"TOT","NBA",4,71,67,1571,231,452,231,452,0,0,113,146,124,211,335,27,26,25,56,184,575,7.52
3153,"Toni Kukoč\kukocto01","2002-03",34,"MIL","NBA",4,63,0,1704,249,577,154,314,95,263,137,194,67,199,266,230,81,29,122,134,730,12.25
3154,"Voshon Lenard\lenarvo01","2003-04",30,"DEN","NBA",4,73,70,2233,394,933,288,644,106,289,144,182,46,154,200,151,61,12,101,177,1038,10.72
3155,"Kenyon Martin\martike01","2008-09",31,"DEN","NBA",4,66,66,2111,318,648,304,610,14,38,119,197,81,314,395,132,96,74,104,201,769,12.27
3156,"Luc Mbah a Moute\mbahalu01","2008-09",22,"MIL","NBA",4,82,52,2114,227,491,227,487,0,4,140,192,189,298,487,87,87,45,100,204,594,8.47
3157,"Ron Mercer\mercero01","1997-98",21,"BOS","NBA",4,80,62,2662,515,1145,512,1117,3,28,188,224,109,171,280,176,125,17,132,213,1221,12.29
3158,"Chris Mihm\mihmch01","2005-06",26,"LAL","NBA",4,59,56,1541,230,459,230,459,0,0,144,201,137,236,373,61,16,73,83,214,604,10.35
3159,"C.J. Miles\milescj01","2016-17",29,"IND","NBA",4,76,29,1776,281,647,112,238,169,409,84,93,30,199,229,48,46,25,40,151,815,8.68
3160,"Brad Miller\millebr01","2009-10",33,"CHI","NBA",4,82,37,1950,250,581,213,449,37,132,182,220,83,316,399,154,44,29,107,189,719,8.89
3161,"Mike Miller\millemi01","2002-03",22,"TOT","NBA",4,65,52,2186,373,859,264,559,109,300,156,186,46,295,341,170,42,21,125,173,1011,13.22
3162,"Chris Mills\millsch01","1993-94",24,"CLE","NBA",4,79,18,2022,284,677,246,555,38,122,137,176,134,267,401,128,54,50,89,232,743,8.94
3163,"Nikola Mirotić\mirotni01","2017-18",26,"TOT","NBA",4,55,14,1494,306,684,171,326,135,358,112,137,59,346,405,80,44,39,62,108,859,14.22
3164,"Chris Morris\morrich01","1994-95",29,"NJN","NBA",4,71,49,2131,351,856,245,539,106,317,142,195,181,221,402,147,86,51,117,155,950,12.05
3165,"Marcus Morris\morrima03","2014-15",25,"PHO","NBA",4,81,35,2045,331,763,219,450,112,313,71,113,73,312,385,133,63,16,73,188,845,9.23
3166,"Chris Mullin\mullich01","1995-96",32,"GSW","NBA",4,55,19,1617,269,539,210,389,59,150,137,160,44,115,159,194,75,32,122,127,734,13.67
3167,"Eduardo Nájera\najered01","2002-03",26,"DAL","NBA",4,48,12,1103,129,231,129,230,0,1,62,91,90,133,223,47,40,22,23,129,320,7.83
3168,"Eduardo Nájera\najered01","2001-02",25,"DAL","NBA",4,62,11,1357,150,300,150,298,0,2,100,148,149,193,342,38,56,30,40,156,400,7.6
3169,"Jameer Nelson\nelsoja01","2006-07",24,"ORL","NBA",4,77,77,2331,376,875,311,681,65,194,183,221,50,186,236,330,73,5,184,225,1000,12.01
3170,"Nerlens Noel\noelne01","2014-15",20,"PHI","NBA",4,75,71,2311,302,653,302,653,0,0,140,230,185,426,611,128,133,142,146,208,744,12.51
3171,"Nerlens Noel\noelne01","2016-17",22,"TOT","NBA",4,51,19,1047,184,309,184,308,0,1,77,111,93,201,294,50,65,50,51,126,445,10.61
3172,"Steve Novak\novakst01","2012-13",29,"NYK","NBA",4,81,1,1641,178,430,29,79,149,351,30,33,17,135,152,35,28,8,12,97,535,5.22
3173,"Emeka Okafor\okafoem01","2004-05",22,"CHA","NBA",4,73,73,2600,448,1003,448,1002,0,1,209,343,275,520,795,64,62,125,125,214,1105,14.26
3174,"Victor Oladipo\oladivi01","2016-17",24,"OKC","NBA",4,67,67,2222,412,932,285,580,127,352,116,154,39,252,291,176,78,21,119,155,1067,13.38
3175,"Robert Parish\parisro01","1993-94",40,"BOS","NBA",4,74,74,1987,356,725,356,725,0,0,154,208,141,401,542,82,42,96,108,190,866,11.66
3176,"Jabari Parker\parkeja01","2016-17",21,"MIL","NBA",4,51,50,1728,399,814,334,636,65,178,162,218,79,235,314,142,50,22,93,111,1025,17.31
3177,"Wesley Person\persowe01","1995-96",24,"PHO","NBA",4,82,47,2609,390,877,273,564,117,313,148,192,56,265,321,138,55,22,89,148,1045,10.55
3178,"Bobby Phills\phillbo01","1994-95",25,"CLE","NBA",4,80,79,2500,338,816,319,761,19,55,183,235,90,175,265,180,115,25,113,206,878,9.82
3179,"Ricky Pierce\piercri01","1993-94",34,"SEA","NBA",4,51,0,1022,272,577,266,545,6,32,189,211,29,54,83,91,42,5,64,84,739,11.32
3180,"Ed Pinckney\pincked01","1993-94",30,"BOS","NBA",4,76,35,1524,151,289,151,289,0,0,92,125,160,318,478,62,58,44,62,131,394,7.4
3181,"Miles Plumlee\plumlmi01","2013-14",25,"PHO","NBA",4,80,79,1964,286,553,286,553,0,0,74,132,198,428,626,43,50,90,111,185,646,9.29
3182,"Mark Price\pricema01","1996-97",32,"GSW","NBA",4,70,49,1876,263,589,151,306,112,283,155,171,36,143,179,342,67,3,161,100,793,12.28
3183,"Theo Ratliff\ratlith01","2002-03",29,"ATL","NBA",4,81,81,2518,276,595,276,595,0,0,154,214,154,453,607,73,56,262,137,271,706,11.22
3184,"Dino Rađa\radjadi01","1995-96",28,"BOS","NBA",4,53,52,1984,426,852,426,852,0,0,191,275,113,409,522,83,48,81,117,161,1043,18.02
3185,"Pooh Richardson\richapo01","1992-93",26,"IND","NBA",4,74,73,2396,337,703,334,674,3,29,92,124,63,204,267,573,94,12,167,132,769,13.64
3186,"Luke Ridnour\ridnolu01","2010-11",29,"MIN","NBA",4,71,66,2159,319,681,238,497,81,184,121,137,37,162,199,384,89,10,158,146,840,13.08
3187,"Eddie Robinson\robined01","2000-01",24,"CHH","NBA",4,67,6,1201,216,407,214,403,2,4,64,88,60,138,198,59,50,32,43,66,498,7.21
3188,"Glenn Robinson\robingl01","1998-99",26,"MIL","NBA",4,47,47,1579,347,756,316,677,31,79,140,161,73,203,276,100,46,41,106,114,865,15.35
3189,"Carlos Rogers\rogerca01","1996-97",25,"TOR","NBA",4,56,3,1397,212,404,187,338,25,66,102,170,120,184,304,37,42,69,53,140,551,10.06
3190,"Thabo Sefolosha\sefolth01","2009-10",25,"OKC","NBA",4,82,82,2348,194,441,153,310,41,131,60,89,76,311,387,145,97,46,90,154,489,7.7
3191,"Greg Smith\smithgr02","2012-13",22,"HOU","NBA",4,70,10,1110,170,274,170,273,0,1,81,130,111,210,321,25,18,40,41,175,421,6.71
3192,"Marreese Speights\speigma01","2014-15",27,"GSW","NBA",4,76,9,1207,318,646,313,628,5,18,150,178,109,216,325,72,20,34,82,189,791,8.93
3193,"Tiago Splitter\splitti01","2014-15",30,"SAS","NBA",4,52,35,1030,169,303,169,303,0,0,90,120,91,161,252,78,35,37,60,103,428,9.38
3194,"Latrell Sprewell\sprewla01","1992-93",22,"GSW","NBA",4,77,69,2741,449,968,376,770,73,198,211,283,79,192,271,295,126,52,203,166,1182,14.71
3195,"Rodney Stuckey\stuckro01","2014-15",28,"IND","NBA",4,71,36,1874,332,754,277,613,55,141,177,216,36,212,248,219,56,10,118,131,896,11.28
3196,"Jared Sullinger\sullija01","2014-15",22,"BOS","NBA",4,58,49,1566,311,708,259,524,52,184,96,129,147,294,441,134,44,42,78,153,770,12.57
3197,"Jason Terry\terryja01","2012-13",35,"BOS","NBA",4,79,24,2124,281,648,158,317,123,331,114,131,19,140,159,198,66,11,102,110,799,9.2
3198,"Jason Thompson\thompja02","2009-10",23,"SAC","NBA",4,75,58,2357,370,784,369,774,1,10,198,277,224,413,637,124,41,73,139,279,939,12.54
3199,"Marcus Thornton\thornma01","2009-10",22,"NOH","NBA",4,73,17,1872,398,883,281,570,117,313,144,177,72,139,211,114,58,11,76,127,1057,11.16
3200,"Gary Trent\trentga01","1998-99",24,"DAL","NBA",4,45,23,1362,287,602,287,597,0,5,145,235,127,224,351,77,29,23,66,122,719,13.68
3201,"Evan Turner\turneev01","2015-16",27,"BOS","NBA",4,81,12,2271,343,753,323,670,20,83,148,179,50,347,397,359,80,28,169,139,854,11.87
3202,"Nick Van Exel\vanexni01","2002-03",31,"DAL","NBA",4,73,1,2026,342,831,224,519,118,312,110,144,35,173,208,312,42,4,123,86,912,10.96
3203,"Nikola Vučević\vucevni01","2016-17",26,"ORL","NBA",4,75,55,2163,483,1031,460,956,23,75,107,160,176,603,779,208,76,74,117,180,1096,15.08
3204,"Hakim Warrick\warriha01","2009-10",27,"TOT","NBA",4,76,6,1557,265,550,264,543,1,7,202,274,127,187,314,52,24,18,80,126,733,8.21
3205,"C.J. Watson\watsocj01","2014-15",30,"IND","NBA",4,57,21,1422,181,417,111,242,70,175,138,167,18,145,163,208,57,9,100,107,570,10.75
3206,"Clarence Weatherspoon\weathcl01","1998-99",28,"MIA","NBA",4,49,3,1040,141,264,141,264,0,0,115,143,72,171,243,34,28,17,61,107,397,8.54
3207,"Chris Webber\webbech01","1994-95",21,"WSB","NBA",4,54,52,2067,464,938,424,793,40,145,117,233,200,318,518,256,83,85,167,186,1085,20.31
3208,"Bonzi Wells\wellsbo01","2002-03",26,"POR","NBA",4,75,65,2396,437,990,399,860,38,130,226,313,98,296,394,246,123,18,215,220,1138,14.01
3209,"Chris Whitney\whitnch01","1999-00",28,"WAS","NBA",4,82,15,1627,217,521,121,266,96,255,112,132,20,114,134,313,55,5,107,166,642,8.38
3210,"Marvin Williams\willima02","2010-11",24,"ATL","NBA",4,65,52,1865,246,537,209,427,37,110,147,174,68,245,313,88,34,23,62,104,676,9.61
3211,"Nick Anderson\anderni01","1998-99",31,"ORL","NBA",3.9,47,39,1581,253,640,157,363,96,277,99,162,51,226,277,91,64,15,83,72,701,12.3
3212,"Ryan Anderson\anderry01","2015-16",27,"NOP","NBA",3.9,66,7,2008,397,929,266,571,131,358,199,228,131,265,396,73,38,25,90,109,1124,13.42
3213,"Shandon Anderson\andersh01","2000-01",27,"HOU","NBA",3.9,82,82,2396,263,590,217,420,46,170,138,188,72,261,333,189,82,40,131,202,710,9.24
3214,"Andrea Bargnani\bargnan01","2008-09",23,"TOR","NBA",3.9,78,59,2453,431,958,312,667,119,291,221,266,70,346,416,94,34,97,135,242,1202,13.08
3215,"Jon Barry\barryjo01","2004-05",35,"TOT","NBA",3.9,69,2,1505,161,368,90,203,71,165,62,71,26,133,159,167,60,9,67,95,455,7.32
3216,"Aron Baynes\baynear01","2014-15",28,"SAS","NBA",3.9,70,17,1122,185,327,184,323,1,4,90,104,109,209,318,35,16,22,65,162,461,6.91
3217,"David Benoit\benoida01","1995-96",27,"UTA","NBA",3.9,81,63,1961,255,581,191,389,64,192,87,112,90,293,383,82,43,49,71,166,661,7.83
3218,"Terrell Brandon\brandte01","1992-93",22,"CLE","NBA",3.9,82,8,1622,297,621,284,579,13,42,118,143,37,142,179,302,79,27,107,122,725,9.51
3219,"Corey Brewer\breweco01","2012-13",26,"DEN","NBA",3.9,82,2,2003,375,883,284,576,91,307,149,216,55,180,235,124,118,23,102,154,990,9.88
3220,"Ronnie Brewer\brewero02","2011-12",26,"CHI","NBA",3.9,66,43,1635,190,445,171,376,19,69,56,100,72,159,231,137,72,21,59,64,455,7.23
3221,"Jason Caffey\caffeja01","1996-97",23,"CHI","NBA",3.9,75,19,1405,205,385,205,384,0,1,139,211,135,166,301,89,25,9,97,149,549,7.29
3222,"Sam Cassell\cassesa01","1996-97",27,"TOT","NBA",3.9,61,44,1714,337,783,256,552,81,231,212,251,47,135,182,305,77,19,168,200,967,15
3223,"Sam Cassell\cassesa01","1995-96",26,"HOU","NBA",3.9,61,0,1682,289,658,216,448,73,210,235,285,51,137,188,278,53,4,157,166,886,13.88
3224,"Willie Cauley-Stein\caulewi01","2017-18",24,"SAC","NBA",3.9,73,58,2044,388,773,385,761,3,12,153,247,131,379,510,172,77,67,109,185,932,13.11
3225,"Tom Chambers\chambto01","1993-94",34,"UTA","NBA",3.9,80,0,1838,329,748,315,703,14,45,221,281,87,239,326,79,40,32,89,232,893,9.06
3226,"Tyson Chandler\chandty01","2002-03",20,"CHI","NBA",3.9,75,68,1827,257,484,257,484,0,0,177,291,169,345,514,76,37,106,135,220,691,10.39
3227,"Wilson Chandler\chandwi01","2010-11",23,"TOT","NBA",3.9,72,49,2401,429,953,317,633,112,320,130,161,75,333,408,120,48,94,104,199,1100,13.24
3228,"Rex Chapman\chapmre01","1993-94",26,"WSB","NBA",3.9,60,59,2025,431,865,367,700,64,165,168,206,57,89,146,185,59,8,117,83,1094,14.97
3229,"Calbert Cheaney\cheanca01","1996-97",25,"WSB","NBA",3.9,79,79,2411,369,730,365,700,4,30,95,137,70,198,268,114,77,18,94,226,837,9.28
3230,"Chris Childs\childch01","1996-97",29,"NYK","NBA",3.9,65,61,2076,211,510,141,329,70,181,113,149,22,169,191,398,78,11,180,213,605,11.67
3231,"Jarron Collins\collija03","2005-06",27,"UTA","NBA",3.9,79,41,1730,129,280,129,280,0,0,157,219,134,199,333,97,36,27,61,252,415,6.35
3232,"Jason Collins\collija04","2004-05",26,"NJN","NBA",3.9,80,80,2542,186,451,184,445,2,6,137,209,153,335,488,105,71,71,91,322,511,7.88
3233,"Darren Collison\collida01","2016-17",29,"SAC","NBA",3.9,68,64,2063,340,714,267,539,73,175,147,171,23,129,152,312,67,9,114,119,900,12.93
3234,"Nick Collison\collini01","2004-05",24,"SEA","NBA",3.9,82,4,1396,190,354,190,351,0,3,83,118,156,220,376,32,34,50,62,252,463,6.33
3235,"Pat Connaughton\connapa01","2018-19",26,"MIL","NBA",3.9,61,2,1261,163,350,97,150,66,200,29,40,61,197,258,122,33,25,33,81,421,7.8
3236,"Jae Crowder\crowdja01","2014-15",24,"TOT","NBA",3.9,82,17,1647,229,545,168,337,61,208,109,141,72,221,293,94,72,25,49,137,628,7.29
3237,"Samuel Dalembert\dalemsa01","2004-05",23,"PHI","NBA",3.9,72,60,1785,250,477,250,477,0,0,89,148,187,355,542,35,46,121,114,241,589,9.77
3238,"Antonio Davis\davisan01","2004-05",36,"CHI","NBA",3.9,72,62,1843,193,419,193,419,0,0,115,152,152,276,428,80,27,41,96,147,501,7.68
3239,"Dale Davis\davisda01","2003-04",34,"POR","NBA",3.9,76,37,1682,133,281,133,281,0,0,65,106,158,240,398,72,43,62,40,154,331,6.15
3240,"Ed Davis\davised01","2011-12",22,"TOR","NBA",3.9,66,9,1534,172,335,172,334,0,1,71,106,134,304,438,60,40,63,67,156,415,8.13
3241,"Richard Dumas\dumasri02","1992-93",23,"PHO","NBA",3.9,48,32,1320,302,576,301,573,1,3,152,215,100,123,223,60,85,39,92,127,757,14.44
3242,"Pervis Ellison\ellispe01","1992-93",25,"WSB","NBA",3.9,49,48,1701,341,655,341,651,0,4,170,242,138,295,433,117,45,108,110,154,852,17.89
3243,"Jordan Farmar\farmajo01","2007-08",21,"LAL","NBA",3.9,82,0,1690,291,631,177,324,114,307,53,78,39,144,183,225,77,5,108,105,749,8.84
3244,"Danny Ferry\ferryda01","1994-95",28,"CLE","NBA",3.9,82,6,1290,223,500,129,267,94,233,74,84,30,113,143,96,27,22,59,131,614,6.29
3245,"Michael Finley\finlemi01","1996-97",23,"TOT","NBA",3.9,83,54,2790,475,1071,374,791,101,280,198,245,88,284,372,224,68,24,164,138,1249,12.78
3246,"Derek Fisher\fishede01","2006-07",32,"UTA","NBA",3.9,82,61,2287,258,675,210,519,48,156,262,307,30,119,149,274,83,6,120,234,826,9.48
3247,"Derek Fisher\fishede01","2009-10",35,"LAL","NBA",3.9,82,82,2227,212,558,134,334,78,224,113,132,25,145,170,201,90,9,78,202,615,7.4
3248,"Danilo Gallinari\gallida01","2014-15",26,"DEN","NBA",3.9,59,27,1426,228,568,121,267,107,301,171,191,31,187,218,83,47,20,57,94,734,10.61
3249,"Danilo Gallinari\gallida01","2011-12",23,"DEN","NBA",3.9,43,40,1351,193,466,133,283,60,183,182,209,28,174,202,116,42,23,68,86,628,13.68
3250,"Chris Gatling\gatlich01","1996-97",29,"TOT","NBA",3.9,47,1,1283,327,623,326,617,1,6,236,329,134,236,370,28,39,31,120,138,891,16.53
3251,"Chris Gatling\gatlich01","1994-95",27,"GSW","NBA",3.9,58,22,1470,324,512,324,511,0,1,148,250,144,299,443,51,39,52,117,184,796,14.05
3252,"Harvey Grant\grantha01","1993-94",28,"POR","NBA",3.9,77,73,2112,356,774,354,767,2,7,84,131,109,242,351,107,70,49,56,179,798,9.08
3253,"Jeff Green\greenje02","2017-18",31,"CLE","NBA",3.9,78,13,1828,295,618,242,448,53,170,203,234,60,186,246,99,41,34,75,149,846,9.63
3254,"Adrian Griffin\griffad01","1999-00",25,"BOS","NBA",3.9,72,47,1927,175,413,159,356,16,57,119,158,128,244,372,177,116,15,93,222,485,9.02
3255,"Eddie Griffin\griffed01","2002-03",20,"HOU","NBA",3.9,77,66,1890,271,678,207,486,64,192,58,94,138,323,461,86,52,111,76,136,664,8.54
3256,"Tyler Hansbrough\hansbty01","2011-12",26,"IND","NBA",3.9,66,0,1442,194,479,194,478,0,1,226,278,113,177,290,30,54,9,65,159,614,8.07
3257,"Al Harrington\harrial01","2002-03",22,"IND","NBA",3.9,82,37,2467,389,896,376,850,13,46,211,274,159,352,511,125,71,33,163,280,1002,10.87
3258,"Al Harrington\harrial01","2008-09",28,"TOT","NBA",3.9,73,56,2546,532,1212,361,742,171,470,234,295,99,356,455,102,88,22,161,227,1469,15.97
3259,"Brendan Haywood\haywobr01","2005-06",26,"WAS","NBA",3.9,79,70,1879,222,432,222,432,0,0,131,224,200,267,467,46,30,104,97,232,575,8.18
3260,"Jordan Hill\hilljo01","2015-16",28,"IND","NBA",3.9,73,11,1513,278,549,278,548,0,1,89,125,156,295,451,87,36,37,92,155,645,9.05
3261,"Eddie House\houseed01","2007-08",29,"BOS","NBA",3.9,78,2,1480,217,531,100,233,117,298,33,36,19,148,167,152,59,10,76,114,584,6.89
3262,"Larry Hughes\hughela01","2006-07",28,"CLE","NBA",3.9,70,68,2596,381,953,307,731,74,222,209,309,41,226,267,256,89,26,154,164,1045,12.62
3263,"Lindsey Hunter\hunteli01","1995-96",25,"DET","NBA",3.9,80,48,2138,239,628,122,339,117,289,84,120,44,150,194,188,84,18,80,185,679,7.83
3264,"Brandon Jennings\jennibr01","2013-14",24,"DET","NBA",3.9,80,79,2728,423,1135,269,678,154,457,241,321,59,185,244,609,101,8,215,157,1241,15.18
3265,"Brandon Jennings\jennibr01","2010-11",21,"MIL","NBA",3.9,63,61,2169,361,926,263,623,98,303,199,246,42,192,234,305,95,21,146,131,1019,14.5
3266,"Avery Johnson\johnsav01","1998-99",33,"SAS","NBA",3.9,50,50,1672,218,461,217,449,1,12,50,88,22,96,118,369,51,11,112,101,487,12.01
3267,"Ervin Johnson\johnser02","1995-96",28,"SEA","NBA",3.9,81,60,1519,180,352,179,349,1,3,85,127,129,304,433,48,40,129,98,245,446,7.31
3268,"Larry Johnson\johnsla02","1993-94",24,"CHH","NBA",3.9,51,51,1757,346,672,341,651,5,21,137,197,143,305,448,184,29,14,116,131,834,16.17
3269,"Damon Jones\jonesda01","2003-04",27,"MIL","NBA",3.9,82,26,2016,210,524,112,251,98,273,55,72,15,155,170,478,30,4,103,92,573,8.77
3270,"Kosta Koufos\koufoko01","2017-18",28,"SAC","NBA",3.9,71,13,1391,222,389,222,389,0,0,33,74,149,323,472,87,47,32,49,146,477,8.4
3271,"Courtney Lee\leeco01","2017-18",32,"NYK","NBA",3.9,76,69,2310,343,755,230,477,113,278,114,124,30,194,224,180,80,17,84,109,913,10.86
3272,"Courtney Lee\leeco01","2015-16",30,"TOT","NBA",3.9,79,65,2334,290,639,208,422,82,217,99,118,29,176,205,136,85,28,72,134,761,8.91
3273,"Trey Lyles\lylestr01","2017-18",22,"DEN","NBA",3.9,73,2,1391,270,550,187,332,83,218,101,143,55,292,347,91,30,34,61,111,724,9.4
3274,"George Lynch\lynchge01","1993-94",23,"LAL","NBA",3.9,71,46,1762,291,573,291,568,0,5,99,166,220,190,410,96,102,27,87,177,681,10.16
3275,"Corey Maggette\maggeco01","2000-01",21,"LAC","NBA",3.9,69,9,1359,225,487,208,431,17,56,223,288,88,203,291,82,35,9,106,140,690,9.1
3276,"Stephon Marbury\marbust01","2005-06",28,"NYK","NBA",3.9,60,60,2193,349,774,316,670,33,104,246,326,25,150,175,382,63,4,157,143,977,15.77
3277,"Vernon Maxwell\maxweve01","1992-93",27,"HOU","NBA",3.9,71,68,2251,349,858,229,497,120,361,164,228,29,192,221,297,86,8,140,124,982,12.44
3278,"Aaron McKie\mckieaa01","2001-02",29,"PHI","NBA",3.9,48,16,1471,220,490,169,362,51,128,96,122,26,166,192,179,56,14,93,74,587,12.28
3279,"Mike Miller\millemi01","2003-04",23,"MEM","NBA",3.9,65,65,1770,270,616,190,401,80,215,102,141,42,174,216,232,59,14,107,162,722,10.78
3280,"Mike Miller\millemi01","2013-14",33,"MEM","NBA",3.9,82,4,1707,213,443,106,210,107,233,46,56,30,177,207,130,26,5,77,95,579,6.75
3281,"Mike Miller\millemi01","2009-10",29,"WAS","NBA",3.9,54,50,1805,217,433,135,262,82,171,70,85,55,281,336,212,39,12,115,131,586,12.85
3282,"Nikola Mirotić\mirotni01","2015-16",24,"CHI","NBA",3.9,66,38,1646,248,609,113,263,135,346,146,181,58,304,362,100,58,46,102,151,777,11.23
3283,"Marcus Morris\morrima03","2016-17",27,"DET","NBA",3.9,79,79,2565,421,1007,303,650,118,357,145,185,77,289,366,160,52,25,87,168,1105,11.14
3284,"Rasho Nesterović\nestera01","2007-08",31,"TOR","NBA",3.9,71,39,1486,257,467,256,464,1,3,37,49,130,212,342,82,20,52,60,132,552,8.08
3285,"Steve Novak\novakst01","2011-12",28,"NYK","NBA",3.9,54,0,1020,161,337,28,55,133,282,22,26,9,95,104,12,16,9,21,59,477,6.97
3286,"Kyle O'Quinn\oquinky01","2016-17",26,"NYK","NBA",3.9,79,8,1229,215,413,213,396,2,17,64,83,157,282,439,117,36,104,76,174,496,8.25
3287,"Zaza Pachulia\pachuza01","2005-06",21,"ATL","NBA",3.9,78,78,2452,307,681,307,679,0,2,297,404,264,349,613,129,89,39,180,286,911,12.39
3288,"Zaza Pachulia\pachuza01","2008-09",24,"ATL","NBA",3.9,77,26,1473,159,320,159,317,0,3,163,230,173,263,436,57,35,26,91,208,481,7.29
3289,"Eric Piatkowski\piatker01","1997-98",27,"LAC","NBA",3.9,67,35,1740,257,568,151,309,106,259,140,170,70,166,236,85,51,12,80,137,760,9.95
3290,"Theo Ratliff\ratlith01","1996-97",23,"DET","NBA",3.9,76,38,1292,179,337,179,337,0,0,81,116,109,147,256,13,29,111,56,181,439,6.3
3291,"Fred Roberts\roberfr01","1992-93",32,"MIL","NBA",3.9,79,5,1488,226,428,214,399,12,29,135,169,91,146,237,118,57,27,67,138,599,7.97
3292,"Rodney Rogers\rogerro01","1994-95",23,"DEN","NBA",3.9,80,77,2142,375,769,325,621,50,148,179,275,132,253,385,161,95,46,173,281,979,11.83
3293,"Byron Scott\scottby01","1994-95",33,"IND","NBA",3.9,80,1,1528,265,583,186,380,79,203,193,227,18,133,151,108,61,13,119,123,802,8.66
3294,"Craig Smith\smithcr01","2006-07",23,"MIN","NBA",3.9,82,5,1537,246,463,246,457,0,6,116,186,149,267,416,49,51,18,74,223,608,7.54
3295,"Jared Sullinger\sullija01","2013-14",21,"BOS","NBA",3.9,74,44,2041,384,899,328,691,56,208,158,203,241,360,601,118,35,49,119,251,982,11.9
3296,"Tim Thomas\thomati01","2006-07",29,"LAC","NBA",3.9,76,24,2054,299,723,163,367,136,356,102,144,63,315,378,171,55,28,106,228,836,10.24
3297,"Jason Thompson\thompja02","2011-12",25,"SAC","NBA",3.9,64,47,1657,237,443,237,441,0,2,109,181,166,277,443,79,43,44,68,149,583,10.08
3298,"P.J. Tucker\tuckepj01","2017-18",32,"HOU","NBA",3.9,82,34,2281,172,441,57,131,115,310,43,60,93,364,457,77,78,26,74,205,502,7.17
3299,"Ime Udoka\udokaim01","2006-07",29,"POR","NBA",3.9,75,75,2144,237,514,148,295,89,219,66,89,95,184,279,112,71,17,73,207,629,8.37
3300,"Jonas Valančiūnas\valanjo01","2012-13",20,"TOR","NBA",3.9,62,57,1482,204,366,204,366,0,0,146,185,121,251,372,45,17,78,94,188,554,9.93
3301,"Charlie Villanueva\villach01","2005-06",21,"TOR","NBA",3.9,81,36,2361,435,940,365,726,70,214,113,160,181,340,521,88,60,63,99,247,1053,11.41
3302,"Antoine Walker\walkean02","2003-04",27,"DAL","NBA",3.9,82,82,2840,483,1129,401,824,82,305,103,186,198,486,684,369,65,65,202,212,1151,14.18
3303,"Charlie Ward\wardch01","2000-01",30,"NYK","NBA",3.9,61,33,1492,155,373,88,198,67,175,56,70,32,127,159,273,70,10,112,132,433,9.18
3304,"Spud Webb\webbsp01","1992-93",29,"SAC","NBA",3.9,69,68,2335,342,789,305,654,37,135,279,328,44,149,193,481,104,6,194,177,1000,15.75
3305,"Dominique Wilkins\wilkido01","1994-95",35,"BOS","NBA",3.9,77,64,2423,496,1169,384,880,112,289,266,340,157,244,401,166,61,14,173,130,1370,13.87
3306,"Buck Williams\willibu01","1995-96",35,"POR","NBA",3.9,70,10,1672,192,384,190,381,2,3,125,187,159,245,404,42,40,47,90,187,511,7.97
3307,"Scott Williams\willisc01","1992-93",24,"CHI","NBA",3.9,71,5,1369,166,356,166,349,0,7,90,126,168,283,451,68,55,66,73,230,422,7.8
3308,"Scott Williams\willisc01","1999-00",31,"MIL","NBA",3.9,68,46,1488,213,426,213,426,0,0,94,129,177,271,448,28,40,66,65,230,520,8.5
3309,"Cody Zeller\zelleco01","2018-19",26,"CHO","NBA",3.9,49,47,1243,190,345,184,323,6,22,111,141,110,223,333,102,38,41,62,164,497,12.06
3310,"Darrell Arthur\arthuda01","2010-11",22,"MEM","NBA",3.8,80,9,1609,310,624,310,618,0,6,109,134,115,227,342,53,52,63,88,228,729,8.45
3311,"Leandro Barbosa\barbole01","2005-06",23,"PHO","NBA",3.8,57,11,1592,273,567,186,371,87,196,111,147,31,119,150,158,48,6,89,145,744,11.66
3312,"Harrison Barnes\barneha02","2017-18",25,"DAL","NBA",3.8,77,77,2634,537,1208,418,875,119,333,259,313,77,391,468,152,49,14,118,94,1452,14.96
3313,"Tony Battie\battito01","2005-06",29,"ORL","NBA",3.8,82,82,2215,280,552,280,546,0,6,89,134,145,312,457,49,46,69,88,250,649,8.15
3314,"Tony Battie\battito01","1999-00",23,"BOS","NBA",3.8,82,4,1505,219,459,218,451,1,8,102,151,152,258,410,63,47,70,67,249,541,7.22
3315,"Steve Blake\blakest01","2007-08",27,"POR","NBA",3.8,81,78,2424,261,640,140,342,121,298,49,64,31,164,195,413,55,4,113,133,692,9.47
3316,"Greg Buckner\buckngr01","2005-06",29,"DEN","NBA",3.8,73,27,1758,181,417,95,174,86,243,43,55,31,178,209,127,87,20,52,180,491,7.4
3317,"Elden Campbell\campbel01","1994-95",26,"LAL","NBA",3.8,73,59,2076,360,785,360,784,0,1,193,290,168,277,445,92,69,132,98,246,913,11.95
3318,"DeMarre Carroll\carrode01","2016-17",30,"TOR","NBA",3.8,72,72,1882,220,550,111,230,109,320,89,117,63,212,275,74,81,27,54,143,638,8.22
3319,"Anthony Carter\cartean01","2007-08",32,"DEN","NBA",3.8,70,67,1960,218,476,173,347,45,129,64,85,27,173,200,388,107,28,124,172,545,10.98
3320,"Vince Carter\cartevi01","2010-11",34,"TOT","NBA",3.8,73,63,2051,389,891,273,570,116,321,128,173,54,221,275,146,67,20,90,193,1022,11.36
3321,"Sam Cassell\cassesa01","2004-05",35,"MIN","NBA",3.8,59,38,1522,319,687,292,584,27,103,134,155,25,132,157,301,36,14,109,160,799,12.82
3322,"Kelvin Cato\catoke01","2002-03",28,"HOU","NBA",3.8,73,5,1247,133,256,133,252,0,4,66,124,132,296,428,20,38,85,56,176,332,6.38
3323,"Willie Cauley-Stein\caulewi01","2015-16",22,"SAC","NBA",3.8,66,39,1412,191,339,191,337,0,2,81,125,134,218,352,37,48,66,46,146,463,8.26
3324,"Mario Chalmers\chalmma01","2015-16",29,"TOT","NBA",3.8,61,7,1373,182,444,136,295,46,149,218,262,24,133,157,230,88,13,110,181,628,11.37
3325,"Tyson Chandler\chandty01","2015-16",33,"PHO","NBA",3.8,66,60,1618,183,314,183,313,0,1,106,171,175,401,576,64,36,44,93,145,472,9.72
3326,"Darren Collison\collida01","2011-12",24,"IND","NBA",3.8,60,56,1878,230,523,196,429,34,94,127,153,30,157,187,287,49,14,114,101,621,11.18
3327,"Darren Collison\collida01","2014-15",27,"SAC","NBA",3.8,45,45,1565,260,550,200,389,60,161,145,184,19,124,143,252,67,14,112,95,725,16.42
3328,"Dell Curry\curryde01","1996-97",32,"CHH","NBA",3.8,68,20,2078,384,836,258,540,126,296,114,142,40,171,211,118,60,14,93,147,1008,11.79
3329,"Antonio Davis\davisan01","2003-04",35,"TOT","NBA",3.8,80,79,2570,266,660,266,660,0,0,176,230,207,464,671,137,37,65,114,206,708,9.72
3330,"Matthew Dellavedova\dellama01","2015-16",25,"CLE","NBA",3.8,76,14,1867,207,511,109,272,98,239,57,66,33,129,162,337,44,9,116,178,569,8.44
3331,"Boris Diaw\diawbo01","2015-16",33,"SAS","NBA",3.8,76,4,1386,202,383,177,314,25,69,56,76,58,175,233,176,26,21,97,102,485,7.19
3332,"DeSagana Diop\diopde01","2006-07",25,"DAL","NBA",3.8,81,9,1480,71,151,71,150,0,1,48,86,166,272,438,30,40,113,63,244,190,5.1
3333,"Mario Elie\eliema01","1997-98",34,"HOU","NBA",3.8,73,59,1988,206,456,151,267,55,189,145,174,39,117,156,221,81,8,100,115,612,9.14
3334,"Mario Elie\eliema01","1995-96",32,"HOU","NBA",3.8,45,16,1385,180,357,139,230,41,127,98,115,47,108,155,138,45,11,59,93,499,11.68
3335,"Maurice Evans\evansma01","2008-09",30,"ATL","NBA",3.8,80,25,1840,208,482,110,234,98,248,60,73,88,155,243,54,50,10,43,163,574,6.33
3336,"Reggie Evans\evansre01","2004-05",24,"SEA","NBA",3.8,79,79,1881,131,275,131,273,0,2,125,234,254,482,736,58,58,15,104,202,387,7.68
3337,"Rudy Fernández\fernaru01","2010-11",25,"POR","NBA",3.8,78,3,1821,213,575,97,214,116,361,126,146,37,135,172,193,87,14,88,134,668,8.25
3338,"Derek Fisher\fishede01","1997-98",23,"LAL","NBA",3.8,82,36,1760,164,378,133,297,31,81,115,152,38,155,193,333,75,5,119,126,474,7.91
3339,"Bryn Forbes\forbebr01","2018-19",25,"SAS","NBA",3.8,82,81,2293,361,791,185,378,176,413,69,78,18,221,239,175,45,4,80,159,967,10
3340,"Rudy Gay\gayru01","2015-16",29,"SAC","NBA",3.8,70,70,2379,466,1007,392,792,74,215,198,254,103,353,456,120,100,51,139,184,1204,15.22
3341,"Daniel Gibson\gibsoda01","2008-09",22,"CLE","NBA",3.8,75,0,1795,206,527,98,244,108,283,66,86,31,124,155,132,44,16,61,163,586,6.68
3342,"Manu Ginóbili\ginobma01","2015-16",38,"SAS","NBA",3.8,58,0,1134,197,435,127,256,70,179,91,112,26,120,146,177,66,11,99,99,555,9.95
3343,"Eric Gordon\gordoer01","2016-17",28,"HOU","NBA",3.8,75,15,2323,412,1016,166,355,246,661,147,175,29,172,201,188,48,41,121,150,1217,12.64
3344,"Blake Griffin\griffbl01","2015-16",26,"LAC","NBA",3.8,35,35,1170,301,603,295,585,6,18,141,194,51,243,294,170,28,17,83,95,749,20.07
3345,"Tom Gugliotta\guglito01","1993-94",24,"WSB","NBA",3.8,78,78,2795,540,1159,500,1011,40,148,213,311,189,539,728,276,172,51,247,174,1333,17.83
3346,"Tyler Hansbrough\hansbty01","2010-11",25,"IND","NBA",3.8,70,29,1535,285,613,285,611,0,2,197,253,145,221,366,41,37,15,76,160,767,9.32
3347,"Al Harrington\harrial01","2005-06",25,"ATL","NBA",3.8,76,76,2782,551,1220,485,1029,66,191,243,350,132,391,523,238,85,14,195,301,1411,15.86
3348,"Othella Harrington\harriot01","2002-03",29,"NYK","NBA",3.8,74,64,1850,225,443,225,443,0,0,123,150,165,311,476,62,12,23,90,231,573,8.16
3349,"Brendan Haywood\haywobr01","2003-04",24,"WAS","NBA",3.8,77,59,1484,200,388,200,387,0,1,137,234,186,201,387,43,32,100,80,154,537,7.71
3350,"Cedric Henderson\hendece02","1997-98",22,"CLE","NBA",3.8,82,71,2527,348,725,348,721,0,4,136,190,71,254,325,168,96,45,165,238,832,9.97
3351,"Kirk Hinrich\hinriki01","2013-14",33,"CHI","NBA",3.8,73,61,2116,243,619,158,377,85,242,95,125,31,161,192,286,80,26,120,203,666,9.49
3352,"Jrue Holiday\holidjr01","2016-17",26,"NOP","NBA",3.8,67,61,2190,405,893,305,612,100,281,119,168,46,218,264,488,100,44,194,133,1029,16.78
3353,"Richaun Holmes\holmeri01","2016-17",23,"PHI","NBA",3.8,57,17,1193,230,412,203,335,27,77,72,103,94,217,311,58,42,55,55,136,559,10.45
3354,"Allan Houston\houstal01","1994-95",23,"DET","NBA",3.8,76,39,1996,398,859,240,486,158,373,147,171,29,138,167,164,61,14,113,182,1101,11.86
3355,"Larry Hughes\hughela01","2003-04",25,"WAS","NBA",3.8,61,61,2061,401,1009,322,777,79,232,267,335,96,230,326,148,95,26,152,147,1148,15.12
3356,"Kris Humphries\humphkr01","2014-15",29,"WAS","NBA",3.8,64,17,1345,211,446,211,439,0,7,87,117,118,298,416,57,34,25,46,130,509,8.23
3357,"Ersan İlyasova\ilyaser01","2010-11",23,"MIL","NBA",3.8,60,34,1505,221,507,185,386,36,121,93,104,105,260,365,56,51,24,63,159,571,9.22
3358,"Jarrett Jack\jackja01","2011-12",28,"NOH","NBA",3.8,45,39,1530,266,583,227,471,39,112,129,148,23,153,176,285,31,9,106,93,700,15.51
3359,"Mark Jackson\jacksma01","1998-99",33,"IND","NBA",3.8,49,49,1382,138,329,106,226,32,103,65,79,33,151,184,386,42,3,99,58,373,11.84
3360,"Joe Johnson\johnsjo02","2016-17",35,"UTA","NBA",3.8,78,14,1843,273,626,167,368,106,258,63,77,33,210,243,144,36,18,69,93,715,8.04
3361,"Steve Kerr\kerrst01","1997-98",32,"CHI","NBA",3.8,50,0,1119,137,302,80,172,57,130,45,49,14,63,77,96,26,5,27,71,376,6.91
3362,"Jerome Kersey\kerseje01","1996-97",34,"LAL","NBA",3.8,70,44,1766,194,449,177,384,17,65,71,118,112,251,363,89,119,49,74,219,476,8.3
3363,"Michael Kidd-Gilchrist\kiddgmi01","2014-15",21,"CHO","NBA",3.8,55,52,1587,224,482,224,482,0,0,150,214,109,307,416,77,30,38,63,115,598,10.94
3364,"Jon Koncak\koncajo01","1993-94",30,"ATL","NBA",3.8,82,78,1823,159,369,159,366,0,3,24,36,83,282,365,102,63,125,44,236,342,6.22
3365,"Kyle Kuzma\kuzmaky01","2017-18",22,"LAL","NBA",3.8,77,37,2401,468,1039,309,605,159,434,147,208,88,395,483,141,49,34,140,160,1242,13.54
3366,"Brook Lopez\lopezbr01","2017-18",29,"LAL","NBA",3.8,74,72,1735,369,793,257,468,112,325,111,158,74,220,294,126,30,98,98,195,961,11.34
3367,"Donyell Marshall\marshdo01","1999-00",26,"GSW","NBA",3.8,64,51,2071,331,840,282,702,49,138,199,255,189,448,637,167,68,68,123,180,910,14.36
3368,"Donyell Marshall\marshdo01","2006-07",33,"CLE","NBA",3.8,81,0,1360,209,493,114,222,95,271,53,80,86,237,323,46,39,43,67,130,566,6.47
3369,"Kenyon Martin\martike01","2005-06",28,"DEN","NBA",3.8,56,49,1546,297,600,292,578,5,22,121,170,93,260,353,79,43,52,72,171,720,12.06
3370,"George McCloud\mccloge01","1999-00",32,"DEN","NBA",3.8,78,11,2118,266,638,159,355,107,283,148,181,72,213,285,246,48,26,134,180,787,10.08
3371,"T.J. McConnell\mccontj01","2017-18",25,"PHI","NBA",3.8,76,1,1706,210,421,183,359,27,62,31,39,37,189,226,303,92,13,112,122,478,8.79
3372,"T.J. McConnell\mccontj01","2016-17",24,"PHI","NBA",3.8,81,51,2133,236,512,225,457,11,55,73,90,39,212,251,534,134,10,159,139,556,11.12
3373,"Brad Miller\millebr01","1999-00",23,"CHH","NBA",3.8,55,4,961,135,293,135,291,0,2,153,195,113,180,293,45,23,35,48,111,423,8.21
3374,"Oliver Miller\milleol01","1995-96",25,"TOR","NBA",3.8,76,72,2516,418,795,418,784,0,11,146,221,177,385,562,219,108,143,202,277,982,15.12
3375,"Terry Mills\millste01","1992-93",25,"DET","NBA",3.8,81,46,2183,494,1072,484,1036,10,36,201,254,176,296,472,111,44,50,142,282,1199,11.98
3376,"Terry Mills\millste01","1999-00",32,"DET","NBA",3.8,82,78,1842,214,488,119,246,95,242,25,34,50,340,390,85,38,24,46,242,548,6.81
3377,"Nikola Mirotić\mirotni01","2016-17",25,"CHI","NBA",3.8,70,15,1679,258,625,129,248,129,377,99,128,61,323,384,75,53,55,80,128,744,9.94
3378,"Chris Morris\morrich01","1993-94",28,"NJN","NBA",3.8,50,27,1349,203,454,150,307,53,147,85,118,91,137,228,83,55,49,52,120,544,10.66
3379,"Tracy Murray\murratr01","1999-00",28,"WAS","NBA",3.8,80,8,1831,290,670,177,407,113,263,120,141,63,208,271,72,45,24,84,185,813,8.4
3380,"Dikembe Mutombo\mutomdi01","2003-04",37,"NYK","NBA",3.8,65,56,1494,141,295,141,295,0,0,81,119,145,292,437,25,17,123,54,141,363,7.59
3381,"Joakim Noah\noahjo01","2007-08",22,"CHI","NBA",3.8,74,31,1534,177,367,177,366,0,1,134,194,174,242,416,84,68,64,89,173,488,8.32
3382,"Jermaine O'Neal\onealje01","2004-05",26,"IND","NBA",3.8,44,41,1530,386,854,385,848,1,6,295,391,85,303,388,82,25,88,131,173,1068,20.12
3383,"Mehmet Okur\okurme01","2002-03",23,"DET","NBA",3.8,72,9,1366,180,423,142,311,38,112,96,131,117,218,335,71,25,39,66,167,494,6.83
3384,"Kevin Ollie\ollieke01","2002-03",30,"TOT","NBA",3.8,82,5,1897,199,441,197,435,2,6,134,178,25,157,182,291,69,5,72,122,534,7.76
3385,"Greg Ostertag\ostergr01","2000-01",27,"UTA","NBA",3.8,81,3,1491,139,281,138,279,1,2,84,151,164,251,415,22,22,142,63,215,363,6.15
3386,"Greg Ostertag\ostergr01","1998-99",25,"UTA","NBA",3.8,48,48,1340,99,208,99,208,0,0,75,121,105,243,348,23,12,131,45,140,273,8.49
3387,"Tony Parker\parketo01","2001-02",19,"SAS","NBA",3.8,77,72,2267,268,639,207,450,61,189,108,160,33,164,197,334,89,7,151,166,705,9.75
3388,"Cherokee Parks\parksch02","1997-98",25,"MIN","NBA",3.8,79,43,1703,224,449,224,448,0,1,110,169,140,297,437,53,36,86,66,237,558,7.82
3389,"Patrick Patterson\pattepa01","2013-14",24,"TOT","NBA",3.8,65,13,1533,225,489,170,338,55,151,50,71,117,225,342,78,55,37,65,159,555,8.72
3390,"Anthony Peeler\peelean01","2001-02",32,"MIN","NBA",3.8,82,0,2060,288,684,177,401,111,283,50,58,37,169,206,177,61,11,76,137,737,7.87
3391,"Wesley Person\persowe01","1994-95",23,"PHO","NBA",3.8,78,56,1800,309,638,193,372,116,266,80,101,67,134,201,105,48,24,79,149,814,8.99
3392,"Morris Peterson\petermo01","2007-08",30,"NOH","NBA",3.8,76,76,1796,215,516,102,229,113,287,65,85,36,170,206,67,47,7,41,125,608,6.66
3393,"Scottie Pippen\pippesc01","2002-03",37,"POR","NBA",3.8,64,58,1911,265,597,227,464,38,133,121,148,57,221,278,285,105,25,164,149,689,12.49
3394,"James Posey\poseyja01","2000-01",24,"DEN","NBA",3.8,82,82,2255,243,590,178,373,65,217,115,141,125,306,431,163,93,40,102,226,666,9.11
3395,"Vladimir Radmanović\radmavl01","2005-06",25,"TOT","NBA",3.8,77,27,1974,262,643,124,289,138,354,93,114,64,294,358,136,61,29,93,210,755,9.36
3396,"Theo Ratliff\ratlith01","1995-96",22,"DET","NBA",3.8,75,2,1305,128,230,128,229,0,1,85,120,110,187,297,13,16,116,56,144,341,5.9
3397,"Pooh Richardson\richapo01","1995-96",29,"LAC","NBA",3.8,63,61,2013,281,664,187,419,94,245,78,105,35,123,158,340,77,13,95,134,734,12.03
3398,"Jalen Rose\roseja01","1994-95",22,"DEN","NBA",3.8,81,37,1798,227,500,191,386,36,114,173,234,57,160,217,389,65,22,160,206,663,10.11
3399,"Malik Rose\rosema01","2003-04",29,"SAS","NBA",3.8,67,13,1256,173,404,173,401,0,3,183,225,110,210,320,69,36,24,112,164,529,7.88
3400,"Donald Royal\royaldo01","1993-94",27,"ORL","NBA",3.8,74,0,1357,174,347,174,345,0,2,199,269,94,154,248,61,50,16,76,121,547,7.42
3401,"Dennis Scott\scottde01","1996-97",28,"ORL","NBA",3.8,66,62,2166,298,749,151,376,147,373,80,101,40,163,203,139,74,19,81,138,823,10.23
3402,"Ramon Sessions\sessira01","2015-16",29,"WAS","NBA",3.8,82,5,1667,280,592,244,481,36,111,214,283,25,178,203,239,46,5,115,102,810,9.49
3403,"Lionel Simmons\simmoli01","1992-93",24,"SAC","NBA",3.8,69,68,2502,468,1055,467,1044,1,11,298,364,156,339,495,312,95,38,196,197,1235,17.32
3404,"Lionel Simmons\simmoli01","1993-94",25,"SAC","NBA",3.8,75,74,2702,436,996,430,979,6,17,251,323,168,394,562,305,104,50,183,189,1129,15.4
3405,"Rik Smits\smitsri01","1999-00",33,"IND","NBA",3.8,79,79,1852,431,890,431,889,0,1,156,211,94,307,401,85,20,100,108,249,1018,10.83
3406,"Eric Snow\snower01","2000-01",27,"PHI","NBA",3.8,50,50,1740,182,435,177,416,5,19,122,154,27,139,166,369,77,7,124,123,491,13.06
3407,"Eric Snow\snower01","1998-99",25,"PHI","NBA",3.8,48,48,1716,149,348,144,327,5,21,110,150,25,137,162,301,100,1,111,149,413,12.28
3408,"Marreese Speights\speigma01","2008-09",21,"PHI","NBA",3.8,79,2,1263,252,502,250,494,2,8,102,132,123,170,293,30,27,56,46,181,608,6.96
3409,"Peja Stojaković\stojape01","2008-09",31,"NOH","NBA",3.8,61,59,2089,287,719,142,335,145,384,93,104,44,220,264,75,52,3,51,101,812,10.35
3410,"Amar'e Stoudemire\stoudam01","2013-14",31,"NYK","NBA",3.8,65,21,1466,311,558,311,558,0,0,150,203,112,208,320,34,23,37,91,159,772,10.54
3411,"Erick Strickland\stricer01","2001-02",28,"BOS","NBA",3.8,79,4,1643,190,488,95,241,95,247,131,155,22,191,213,184,56,1,94,145,606,7.61
3412,"Rodney Stuckey\stuckro01","2008-09",22,"DET","NBA",3.8,79,65,2517,401,913,378,835,23,78,233,290,69,206,275,387,78,11,173,217,1058,12.95
3413,"Mike Sweetney\sweetmi01","2004-05",22,"NYK","NBA",3.8,77,28,1509,237,446,237,445,0,1,176,235,169,249,418,44,27,28,108,224,650,8.49
3414,"Mirza Teletović\teletmi01","2015-16",30,"PHO","NBA",3.8,79,1,1686,332,777,151,317,181,460,120,155,55,247,302,89,32,21,84,159,965,9.74
3415,"Jason Terry\terryja01","2011-12",34,"DAL","NBA",3.8,63,1,2000,357,830,219,465,138,365,98,111,16,133,149,226,73,11,127,69,950,12.78
3416,"Kurt Thomas\thomaku01","1995-96",23,"MIA","NBA",3.8,74,42,1655,274,547,274,545,0,2,118,178,122,317,439,46,47,36,98,271,666,8.77
3417,"Tim Thomas\thomati01","1999-00",22,"MIL","NBA",3.8,80,1,2093,347,753,284,571,63,182,188,243,100,232,332,113,59,31,129,227,945,10.34
3418,"Marcus Thornton\thornma01","2011-12",24,"SAC","NBA",3.8,51,51,1780,352,803,245,493,107,310,141,163,84,104,188,98,71,12,84,111,952,14.61
3419,"Sedale Threatt\threase01","1994-95",33,"LAL","NBA",3.8,59,2,1384,217,437,181,342,36,95,88,111,21,103,124,248,54,12,70,139,558,10.43
3420,"Greivis Vásquez\vasqugr01","2012-13",26,"NOH","NBA",3.8,78,78,2685,438,1012,355,769,83,243,124,154,43,294,337,704,66,6,247,190,1083,15.84
3421,"Ben Wallace\wallabe01","2008-09",34,"CLE","NBA",3.8,56,53,1314,69,155,69,155,0,0,27,64,136,226,362,44,48,75,34,82,165,6.17
3422,"Luke Walton\waltolu01","2006-07",26,"LAL","NBA",3.8,60,60,1982,264,557,216,433,48,124,108,145,87,215,302,257,60,21,118,117,684,12.67
3423,"C.J. Watson\watsocj01","2012-13",28,"BRK","NBA",3.8,80,8,1521,192,459,104,245,88,214,71,91,38,107,145,161,66,12,69,123,543,6.7
3424,"Jason Williams\willija02","2000-01",25,"SAC","NBA",3.8,77,77,2290,281,690,183,379,98,311,60,76,19,166,185,416,94,9,160,114,720,10.5
3425,"Jayson Williams\willija01","1995-96",27,"NJN","NBA",3.8,80,6,1858,279,660,277,653,2,7,161,272,342,461,803,47,35,57,106,238,721,9.44
3426,"Marvin Williams\willima02","2018-19",32,"CHO","NBA",3.8,75,75,2133,275,652,135,270,140,382,66,86,76,331,407,92,71,61,47,156,756,9.9
3427,"Kevin Willis\willike02","1996-97",34,"HOU","NBA",3.8,75,32,1964,350,728,348,714,2,14,140,202,146,415,561,71,42,32,119,216,842,10.48
3428,"Cody Zeller\zelleco01","2014-15",22,"CHO","NBA",3.8,62,45,1487,172,373,171,372,1,1,127,164,97,265,362,100,34,49,62,156,472,8.84
3429,"Lavoy Allen\allenla01","2015-16",26,"IND","NBA",3.7,79,28,1599,191,370,191,370,0,0,46,73,162,262,424,76,26,42,69,147,428,6.49
3430,"Kenny Anderson\anderke01","1997-98",27,"TOT","NBA",3.7,61,56,1858,268,674,211,514,57,160,153,194,39,134,173,345,87,1,143,135,746,12.51
3431,"Carmelo Anthony\anthoca01","2017-18",33,"OKC","NBA",3.7,78,78,2501,472,1168,303,694,169,474,148,193,67,386,453,103,47,49,99,197,1261,12.16
3432,"Ryan Arcidiacono\arcidry01","2018-19",24,"CHI","NBA",3.7,81,32,1961,187,418,106,201,81,217,89,102,27,192,219,269,65,4,63,171,544,8.21
3433,"Carlos Arroyo\arroyca01","2009-10",30,"MIA","NBA",3.7,72,35,1585,178,375,171,350,7,25,76,90,26,104,130,225,36,6,54,102,439,6.83
3434,"Stacey Augmon\augmost01","1992-93",24,"ATL","NBA",3.7,73,66,2112,397,792,397,788,0,4,227,307,141,146,287,170,91,18,157,141,1021,12.75
3435,"Matt Barnes\barnema02","2006-07",26,"GSW","NBA",3.7,76,23,1813,275,628,169,338,106,290,90,123,91,259,350,156,73,41,105,188,746,9.92
3436,"Nicolas Batum\batumni01","2008-09",20,"POR","NBA",3.7,79,76,1454,161,361,99,193,62,168,42,52,84,136,220,74,50,40,50,139,426,5.72
3437,"Nicolas Batum\batumni01","2018-19",30,"CHO","NBA",3.7,75,72,2354,253,562,137,264,116,298,77,89,71,319,390,247,71,43,117,140,699,11.09
3438,"Bradley Beal\bealbr01","2014-15",21,"WAS","NBA",3.7,63,59,2107,363,851,257,592,106,259,130,166,57,184,241,194,76,18,123,136,962,12.98
3439,"Marco Belinelli\belinma01","2017-18",31,"TOT","NBA",3.7,80,2,1947,337,764,188,369,149,395,148,163,20,131,151,148,66,12,94,91,971,10.04
3440,"Raja Bell\bellra01","2003-04",27,"UTA","NBA",3.7,82,4,2020,329,805,267,639,62,166,195,248,60,181,241,107,63,13,111,262,915,8.6
3441,"Chauncey Billups\billuch01","2000-01",24,"MIN","NBA",3.7,77,33,1790,248,587,175,393,73,194,144,171,32,126,158,260,51,11,111,178,713,9.02
3442,"Andray Blatche\blatcan01","2013-14",27,"BRK","NBA",3.7,73,7,1618,321,674,306,620,15,54,164,221,120,270,390,112,75,38,110,166,821,10.83
3443,"Eric Bledsoe\bledser01","2012-13",23,"LAC","NBA",3.7,76,12,1553,253,568,222,490,31,78,106,134,78,147,225,233,109,55,137,112,643,9.68
3444,"Muggsy Bogues\boguemu01","1999-00",35,"TOR","NBA",3.7,80,5,1731,157,358,140,307,17,51,79,87,25,110,135,299,65,4,59,119,410,6.88
3445,"Matt Bonner\bonnema01","2009-10",29,"SAS","NBA",3.7,65,8,1161,166,372,76,141,90,231,35,48,52,162,214,68,30,24,39,109,457,6.74
3446,"Josh Boone\boonejo01","2007-08",23,"NJN","NBA",3.7,70,53,1773,238,434,238,434,0,0,99,217,192,317,509,55,36,61,68,155,575,9.14
3447,"Terrell Brandon\brandte01","2001-02",31,"MIN","NBA",3.7,32,28,962,155,365,151,342,4,23,83,84,17,76,93,264,52,6,43,49,397,15.04
3448,"Ronnie Brewer\brewero02","2009-10",24,"TOT","NBA",3.7,58,53,1742,209,429,201,398,8,31,85,133,45,142,187,154,91,15,53,80,511,9.64
3449,"Frank Brickowski\brickfr01","1992-93",33,"MIL","NBA",3.7,66,64,2075,456,836,448,810,8,26,195,268,120,285,405,196,80,44,202,235,1115,16.56
3450,"Devin Brown\brownde02","2004-05",26,"SAS","NBA",3.7,67,0,1238,173,409,128,288,45,121,103,130,37,139,176,92,39,12,53,83,494,6.69
3451,"Scott Burrell\burresc01","1997-98",27,"CHI","NBA",3.7,80,3,1096,159,375,108,231,51,144,47,64,80,118,198,65,64,37,50,131,416,5.31
3452,"José Calderón\caldejo01","2010-11",29,"TOR","NBA",3.7,68,55,2102,262,596,205,440,57,156,88,103,30,172,202,605,81,7,148,143,669,13.84
3453,"Marcus Camby\cambyma01","2010-11",36,"POR","NBA",3.7,59,51,1540,117,294,117,293,0,1,43,70,182,424,606,121,40,92,62,140,277,9.13
3454,"Marcus Camby\cambyma01","1996-97",22,"TOR","NBA",3.7,63,38,1897,375,778,373,764,2,14,183,264,131,263,394,97,66,130,134,214,935,14.13
3455,"Chris Childs\childch01","1997-98",30,"NYK","NBA",3.7,68,0,1599,149,354,122,267,27,87,104,126,29,133,162,268,56,6,103,179,429,8.01
3456,"Keon Clark\clarkke01","2000-01",25,"TOT","NBA",3.7,81,3,1720,249,519,249,518,0,1,142,240,136,298,434,72,32,154,90,244,640,8.65
3457,"Speedy Claxton\claxtsp01","2004-05",26,"TOT","NBA",3.7,62,47,1866,257,611,246,550,11,61,187,254,37,147,184,374,109,8,119,184,712,13.07
3458,"Erick Dampier\dampier01","2009-10",34,"DAL","NBA",3.7,55,47,1280,133,213,132,210,1,3,61,101,128,272,400,31,15,77,61,153,328,8.49
3459,"Glen Davis\davisgl01","2008-09",23,"BOS","NBA",3.7,76,16,1637,199,450,197,445,2,5,130,178,121,180,301,69,53,19,71,230,530,6.72
3460,"Dewayne Dedmon\dedmode01","2017-18",28,"ATL","NBA",3.7,62,46,1542,250,477,200,336,50,141,67,86,100,389,489,90,40,51,86,162,617,11.45
3461,"Vinny Del Negro\delnevi01","1997-98",31,"SAS","NBA",3.7,54,38,1721,211,479,194,440,17,39,74,93,13,139,152,183,39,6,53,113,513,9.01
3462,"Keyon Dooling\doolike01","2008-09",28,"NJN","NBA",3.7,77,18,2074,261,598,162,363,99,235,127,154,24,131,155,270,71,8,105,135,748,9.75
3463,"Keyon Dooling\doolike01","2007-08",27,"ORL","NBA",3.7,72,1,1334,198,423,176,358,22,65,163,193,7,94,101,133,36,5,61,131,581,7.29
3464,"Derek Fisher\fishede01","2010-11",36,"LAL","NBA",3.7,82,82,2297,206,529,143,370,63,159,83,103,14,138,152,224,99,8,70,192,558,7.13
3465,"Derek Fisher\fishede01","2004-05",30,"GSW","NBA",3.7,74,32,2222,297,755,189,464,108,291,175,203,38,180,218,301,76,4,129,176,877,11.25
3466,"Randy Foye\foyera01","2012-13",29,"UTA","NBA",3.7,82,72,2249,293,738,115,304,178,434,118,144,17,110,127,167,66,27,92,190,882,8.84
3467,"Channing Frye\fryech01","2016-17",33,"CLE","NBA",3.7,74,15,1398,238,520,101,185,137,335,63,74,37,253,290,45,33,37,53,138,676,8.23
3468,"Channing Frye\fryech01","2011-12",28,"PHO","NBA",3.7,64,59,1669,255,613,164,350,91,263,73,82,71,308,379,88,42,70,63,176,674,10.12
3469,"Lawrence Funderburke\fundela01","1999-00",29,"SAC","NBA",3.7,75,1,1026,184,352,184,350,0,2,115,163,98,136,234,33,32,20,40,91,483,6.05
3470,"Dan Gadzuric\gadzuda01","2003-04",25,"MIL","NBA",3.7,75,0,1260,183,349,183,348,0,1,58,118,126,220,346,28,51,105,45,186,424,6.82
3471,"Marc Gasol\gasolma01","2015-16",31,"MEM","NBA",3.7,52,52,1791,328,707,326,704,2,3,203,245,58,304,362,196,50,70,118,141,861,16.57
3472,"Pau Gasol\gasolpa01","2012-13",32,"LAL","NBA",3.7,49,42,1655,270,579,262,551,8,28,125,178,111,310,421,200,24,61,104,93,673,14.89
3473,"Kendall Gill\gillke01","1999-00",31,"NJN","NBA",3.7,76,75,2355,396,956,376,878,20,78,181,255,82,201,283,210,139,41,89,211,993,11.59
3474,"Manu Ginóbili\ginobma01","2014-15",37,"SAS","NBA",3.7,70,0,1587,251,589,162,331,89,258,147,204,28,183,211,293,67,20,154,138,738,11.05
3475,"Aaron Gordon\gordoaa01","2016-17",21,"ORL","NBA",3.7,80,72,2298,393,865,316,598,77,267,156,217,116,289,405,150,65,40,89,172,1019,11.33
3476,"Devin Harris\harride01","2005-06",22,"DAL","NBA",3.7,56,4,1275,190,405,185,384,5,21,169,236,26,99,125,177,53,16,84,121,554,9.96
3477,"Juwan Howard\howarju01","2005-06",32,"HOU","NBA",3.7,80,80,2537,394,859,394,855,0,4,154,191,168,367,535,112,49,8,133,235,942,10.38
3478,"Larry Hughes\hughela01","2002-03",24,"WAS","NBA",3.7,67,56,2137,346,741,317,662,29,79,136,186,67,241,308,205,86,24,136,149,857,12.33
3479,"Serge Ibaka\ibakase01","2009-10",20,"OKC","NBA",3.7,73,0,1323,201,370,200,368,1,2,58,92,138,259,397,10,25,97,68,194,461,7.23
3480,"James Jones\jonesja02","2007-08",27,"POR","NBA",3.7,58,3,1276,143,327,52,122,91,205,86,98,43,118,161,34,24,15,28,96,463,7.06
3481,"Jumaine Jones\jonesju01","2004-05",25,"LAL","NBA",3.7,76,23,1830,210,486,108,225,102,261,55,75,107,291,398,65,44,24,49,165,577,7.61
3482,"Popeye Jones\jonespo01","1995-96",25,"DAL","NBA",3.7,68,68,2322,327,733,313,694,14,39,102,133,260,477,737,132,54,27,109,262,770,12.29
3483,"Jason Kidd\kiddja01","1994-95",21,"DAL","NBA",3.7,79,79,2668,330,857,260,600,70,257,192,275,152,278,430,607,151,24,250,146,922,15.01
3484,"Kyle Korver\korveky01","2016-17",35,"TOT","NBA",3.7,67,22,1753,239,515,77,156,162,359,38,42,7,179,186,110,34,21,69,107,678,9.13
3485,"Kyle Korver\korveky01","2008-09",27,"UTA","NBA",3.7,78,2,1874,245,560,142,293,103,267,112,127,35,223,258,137,47,30,90,170,705,8.62
3486,"Carl Landry\landrca01","2007-08",24,"HOU","NBA",3.7,42,0,711,135,219,135,218,0,1,72,109,96,111,207,21,17,7,26,98,342,8.27
3487,"Ty Lawson\lawsoty01","2009-10",22,"DEN","NBA",3.7,65,8,1318,201,390,167,307,34,83,106,140,42,82,124,203,48,2,82,89,542,8.88
3488,"Tyronn Lue\luety01","2004-05",27,"TOT","NBA",3.7,70,49,2007,295,654,240,499,55,155,142,165,14,135,149,322,33,0,105,168,787,10.8
3489,"Tyronn Lue\luety01","2002-03",25,"WAS","NBA",3.7,75,24,1986,248,573,188,397,60,176,91,104,22,127,149,263,47,1,77,151,647,8.42
3490,"Stephon Marbury\marbust01","1996-97",19,"MIN","NBA",3.7,67,64,2324,355,871,253,583,102,288,245,337,54,130,184,522,67,19,210,159,1057,16
3491,"Shawn Marion\mariosh01","2011-12",33,"DAL","NBA",3.7,63,63,1919,288,646,268,578,20,68,74,93,145,320,465,132,67,36,98,87,670,11.05
3492,"Wesley Matthews\matthwe02","2015-16",29,"DAL","NBA",3.7,78,78,2644,331,854,142,329,189,525,126,146,27,211,238,151,78,17,78,179,977,10.18
3493,"Nate McMillan\mcmilna01","1995-96",31,"SEA","NBA",3.7,55,14,1261,100,238,54,117,46,121,29,41,41,169,210,197,95,18,75,143,275,8.6
3494,"Terry Mills\millste01","1995-96",28,"DET","NBA",3.7,82,5,1656,283,675,201,468,82,207,121,157,108,244,352,98,42,20,98,197,769,8.06
3495,"Terry Mills\millste01","1994-95",27,"DET","NBA",3.7,72,69,2514,417,933,308,648,109,285,175,219,124,434,558,160,68,33,144,253,1118,14.45
3496,"Sam Mitchell\mitchsa01","1994-95",31,"IND","NBA",3.7,81,12,1377,201,413,200,403,1,10,126,174,95,148,243,61,43,20,54,206,529,6.15
3497,"Nazr Mohammed\mohamna01","2003-04",26,"TOT","NBA",3.7,80,24,1611,246,472,246,472,0,0,100,169,178,296,474,36,55,52,96,195,592,7.98
3498,"Timofey Mozgov\mozgoti01","2015-16",29,"CLE","NBA",3.7,76,48,1326,203,359,202,352,1,7,68,95,110,227,337,33,22,57,71,159,475,6.76
3499,"Rasho Nesterović\nestera01","2005-06",29,"SAS","NBA",3.7,80,51,1515,172,334,172,332,0,2,18,30,114,195,309,33,21,88,53,209,362,5.27
3500,"Johnny Newman\newmajo01","1993-94",30,"TOT","NBA",3.7,81,18,1697,313,664,289,574,24,90,182,225,86,94,180,72,69,27,90,196,832,8.46
3501,"Johnny Newman\newmajo01","1992-93",29,"CHH","NBA",3.7,64,27,1471,279,534,267,489,12,45,194,240,72,71,143,117,45,19,90,154,764,10.64
3502,"Lucas Nogueira\noguelu01","2016-17",24,"TOR","NBA",3.7,57,6,1088,103,156,100,144,3,12,44,67,82,162,244,42,52,89,46,137,253,7.32
3503,"Charles Oakley\oaklech01","2000-01",37,"TOR","NBA",3.7,78,77,2767,305,786,294,737,11,49,127,152,142,599,741,264,76,48,139,258,748,11.55
3504,"Kelly Oubre\oubreke01","2017-18",22,"WAS","NBA",3.7,81,11,2231,318,790,192,421,126,369,191,233,59,304,363,98,80,35,90,234,953,10.23
3505,"Billy Owens\owensbi01","1997-98",28,"SAC","NBA",3.7,78,78,2348,338,728,312,658,26,70,116,197,170,412,582,219,93,38,153,231,818,11.76
3506,"Anthony Peeler\peelean01","1995-96",26,"LAL","NBA",3.7,73,12,1608,272,602,167,348,105,254,61,86,45,92,137,118,59,10,56,139,710,8.09
3507,"Wesley Person\persowe01","1999-00",28,"CLE","NBA",3.7,79,38,2056,280,654,174,404,106,250,61,77,44,223,267,146,40,19,60,119,727,8.06
3508,"Ed Pinckney\pincked01","1995-96",32,"TOT","NBA",3.7,74,47,1710,171,335,171,332,0,3,136,179,189,269,458,72,64,28,77,156,478,8.27
3509,"Scottie Pippen\pippesc01","2001-02",36,"POR","NBA",3.7,62,60,1996,246,599,192,422,54,177,113,146,77,244,321,363,101,35,171,162,659,13.43
3510,"Terry Porter\portete01","1995-96",32,"MIN","NBA",3.7,82,40,2072,269,608,198,382,71,226,164,209,36,176,212,452,89,15,173,154,773,11.44
3511,"Vladimir Radmanović\radmavl01","2004-05",24,"SEA","NBA",3.7,63,0,1856,266,650,138,321,128,329,81,103,52,237,289,86,57,31,80,172,741,10.13
3512,"Jason Richardson\richaja01","2002-03",22,"GSW","NBA",3.7,82,82,2698,476,1161,353,827,123,334,207,271,111,267,378,247,90,23,179,201,1282,12.98
3513,"Ricky Rubio\rubiori01","2018-19",28,"UTA","NBA",3.7,68,67,1899,295,730,216,476,79,254,195,228,33,210,243,416,91,10,180,180,864,13.89
3514,"Arvydas Sabonis\sabonar01","2000-01",36,"POR","NBA",3.7,61,42,1299,247,516,246,501,1,15,121,156,51,280,331,91,40,62,85,137,616,10.15
3515,"John Salmons\salmojo01","2007-08",28,"SAC","NBA",3.7,81,41,2517,381,799,342,679,39,120,214,260,76,273,349,208,93,31,170,171,1015,12.22
3516,"Dennis Schröder\schrode01","2016-17",23,"ATL","NBA",3.7,79,78,2485,548,1214,448,920,100,294,218,255,42,206,248,499,74,16,258,149,1414,16.48
3517,"Ramon Sessions\sessira01","2011-12",25,"TOT","NBA",3.7,64,23,1707,242,565,199,468,43,97,194,248,33,181,214,354,44,3,141,100,721,12.19
3518,"J.R. Smith\smithjr01","2014-15",29,"TOT","NBA",3.7,70,51,2080,315,755,152,329,163,426,54,72,30,188,218,195,82,22,97,163,847,10.83
3519,"J.R. Smith\smithjr01","2006-07",21,"DEN","NBA",3.7,63,24,1471,284,644,135,262,149,382,102,126,30,113,143,91,49,9,85,147,819,10.29
3520,"J.R. Smith\smithjr01","2013-14",28,"NYK","NBA",3.7,74,37,2421,396,955,207,475,189,480,90,138,35,261,296,219,65,20,108,196,1071,12.06
3521,"J.R. Smith\smithjr01","2007-08",22,"DEN","NBA",3.7,74,0,1421,311,674,154,284,157,390,128,178,43,109,152,128,62,12,112,144,907,10.28
3522,"Joe Smith\smithjo02","1998-99",23,"MIN","NBA",3.7,43,42,1418,223,522,223,519,0,3,142,188,154,200,354,68,32,66,66,147,588,13.04
3523,"Michael Smith\smithmi02","1994-95",22,"SAC","NBA",3.7,82,0,1736,220,406,220,404,0,2,127,262,174,312,486,67,61,49,106,235,567,7.97
3524,"Rod Strickland\stricro02","1999-00",33,"WAS","NBA",3.7,69,67,2188,327,762,326,741,1,21,214,305,73,186,259,519,94,18,187,147,869,14.54
3525,"Stromile Swift\swiftst01","2001-02",22,"MEM","NBA",3.7,68,14,1805,293,611,293,608,0,3,217,305,161,269,430,50,53,113,122,178,803,11.71
3526,"Maurice Taylor\tayloma01","2003-04",27,"HOU","NBA",3.7,75,10,2081,367,765,367,763,0,2,128,174,131,253,384,107,43,47,149,253,862,10.12
3527,"Isiah Thomas\thomais01","1992-93",31,"DET","NBA",3.7,79,79,2922,526,1258,465,1060,61,198,278,377,71,161,232,671,123,18,284,222,1391,17.46
3528,"Otis Thorpe\thorpot01","1998-99",36,"WAS","NBA",3.7,49,38,1539,240,440,240,438,0,2,74,106,96,238,334,101,42,19,88,196,554,12.02
3529,"Sedale Threatt\threase01","1995-96",34,"LAL","NBA",3.7,82,8,1687,241,526,181,357,60,169,54,71,20,75,95,269,68,11,74,178,596,7.55
3530,"Jamaal Tinsley\tinslja01","2002-03",24,"IND","NBA",3.7,73,69,2237,220,556,174,390,46,166,80,112,58,202,260,548,125,18,192,201,566,12.02
3531,"Keith Van Horn\vanhoke01","1998-99",23,"NJN","NBA",3.7,42,42,1576,322,752,306,699,16,53,256,298,114,244,358,65,43,53,133,134,916,18.34
3532,"Sasha Vujačić\vujacsa01","2008-09",24,"LAL","NBA",3.7,80,0,1293,155,401,74,178,81,223,70,76,19,116,135,113,77,7,35,154,461,5.69
3533,"Charlie Ward\wardch01","2002-03",32,"NYK","NBA",3.7,66,6,1465,165,414,64,147,101,267,41,53,25,152,177,306,78,11,95,146,472,9.3
3534,"Hakim Warrick\warriha01","2006-07",24,"MEM","NBA",3.7,82,43,2152,373,712,373,704,0,8,299,388,130,290,420,75,43,30,161,232,1045,11.52
3535,"Delonte West\westde01","2006-07",23,"BOS","NBA",3.7,69,47,2219,306,717,241,539,65,178,168,197,32,176,208,304,74,34,140,152,845,12.29
3536,"Aaron Williams\williaa01","2002-03",31,"NJN","NBA",3.7,81,0,1597,199,439,199,438,0,1,102,130,137,194,331,88,27,57,85,206,500,6.44
3537,"Deron Williams\willide01","2015-16",31,"DAL","NBA",3.7,65,63,2106,321,775,224,493,97,282,179,206,19,171,190,378,61,14,150,155,918,13.92
3538,"Hot Rod Williams\williho01","1997-98",35,"PHO","NBA",3.7,71,30,1333,95,202,95,202,0,0,65,93,107,205,312,49,33,60,29,138,255,5.27
3539,"Reggie Williams\willire02","2010-11",24,"GSW","NBA",3.7,80,9,1626,268,572,166,331,102,241,100,134,45,171,216,121,28,3,57,124,738,7.9
3540,"Walt Williams\williwa02","1998-99",28,"POR","NBA",3.7,48,16,1044,147,347,84,203,63,144,89,107,36,107,143,80,37,28,63,101,446,8.84
3541,"Metta World Peace\artesro01","2005-06",26,"TOT","NBA",3.7,56,56,2207,350,867,272,614,78,253,206,305,75,211,286,203,122,41,131,164,984,15.8
3542,"Lorenzen Wright\wrighlo02","2005-06",30,"MEM","NBA",3.7,78,58,1689,194,406,194,404,0,2,66,117,142,253,395,48,52,46,67,201,454,6.45
3543,"Chris Andersen\anderch01","2014-15",36,"MIA","NBA",3.6,60,20,1132,120,207,116,194,4,13,76,114,76,223,299,43,26,61,40,88,320,7.11
3544,"Derek Anderson\anderde01","2003-04",29,"POR","NBA",3.6,51,46,1810,230,612,151,353,79,259,155,188,26,156,182,228,66,3,90,79,694,12.65
3545,"Chucky Atkins\atkinch01","2005-06",31,"TOT","NBA",3.6,71,41,1713,226,573,129,299,97,274,129,163,23,97,120,198,43,2,87,152,678,8.24
3546,"Isaac Austin\austiis01","1997-98",28,"TOT","NBA",3.6,78,50,2266,406,871,406,863,0,8,243,363,199,358,557,175,61,56,206,231,1055,12.89
3547,"Marvin Bagley\baglema01","2018-19",19,"SAC","NBA",3.6,62,4,1567,356,706,326,610,30,96,181,262,162,309,471,62,33,59,98,120,923,13.63
3548,"Harrison Barnes\barneha02","2018-19",26,"TOT","NBA",3.6,77,77,2533,431,1027,257,586,174,441,229,278,57,304,361,115,50,13,98,122,1265,12.76
3549,"Raja Bell\bellra01","2008-09",32,"TOT","NBA",3.6,67,66,2315,299,684,185,413,114,271,87,102,41,202,243,142,50,8,86,166,799,10.24
3550,"Keith Bogans\boganke01","2010-11",30,"CHI","NBA",3.6,82,82,1461,124,307,34,70,90,237,21,32,19,129,148,101,38,9,41,113,359,4.43
3551,"Trevor Booker\booketr01","2014-15",27,"UTA","NBA",3.6,79,5,1564,226,464,197,380,29,84,86,148,139,258,397,83,43,41,88,144,567,7.55
3552,"Chris Bosh\boshch01","2014-15",30,"MIA","NBA",3.6,44,44,1556,343,745,280,577,63,168,179,232,46,264,310,95,41,25,95,69,928,17.53
3553,"Elton Brand\brandel01","2013-14",34,"ATL","NBA",3.6,73,15,1414,179,332,179,330,0,2,61,94,97,264,361,74,40,88,60,192,419,7.44
3554,"Aaron Brooks\brookaa01","2008-09",24,"HOU","NBA",3.6,80,35,1998,316,783,203,474,113,309,149,172,33,124,157,238,46,8,125,152,894,9.3
3555,"Kwame Brown\brownkw01","2005-06",23,"LAL","NBA",3.6,72,49,1978,204,388,204,387,0,1,128,235,182,291,473,72,27,46,100,196,536,8.36
3556,"Mark Bryant\bryanma01","1995-96",30,"HOU","NBA",3.6,71,9,1587,242,446,242,444,0,2,127,177,131,220,351,52,31,19,85,234,611,8.4
3557,"Caron Butler\butleca01","2012-13",32,"LAC","NBA",3.6,78,78,1879,305,720,177,390,128,330,75,90,41,182,223,78,51,11,72,139,813,8.04
3558,"Marcus Camby\cambyma01","2011-12",37,"TOT","NBA",3.6,59,53,1352,128,287,126,282,2,5,29,64,157,373,530,107,50,85,57,126,287,8.81
3559,"Omri Casspi\casspom01","2015-16",27,"SAC","NBA",3.6,69,21,1880,299,622,187,348,112,274,103,159,58,352,410,95,56,17,94,154,813,11.21
3560,"Wilson Chandler\chandwi01","2014-15",27,"DEN","NBA",3.6,78,75,2471,418,975,279,569,139,406,110,142,96,379,475,134,58,29,110,231,1085,11.78
3561,"Nick Collison\collini01","2010-11",30,"OKC","NBA",3.6,71,2,1524,137,242,137,242,0,0,55,73,119,197,316,69,42,31,55,210,329,6.28
3562,"Nick Collison\collini01","2013-14",33,"OKC","NBA",3.6,81,0,1353,134,241,130,224,4,17,66,93,116,177,293,104,30,28,71,187,338,5.58
3563,"Jamal Crawford\crawfja01","2014-15",34,"LAC","NBA",3.6,64,4,1703,332,839,213,475,119,364,227,252,18,106,124,158,59,14,92,108,1010,12.1
3564,"Samuel Dalembert\dalemsa01","2005-06",24,"PHI","NBA",3.6,66,52,1761,196,369,196,368,0,1,93,132,159,382,541,25,34,160,107,244,485,10.14
3565,"Antonio Daniels\daniean01","1999-00",24,"SAS","NBA",3.6,68,1,1195,163,344,141,278,22,66,72,101,16,70,86,177,55,5,58,73,420,6.61
3566,"Terry Davis\daviste01","1997-98",30,"WAS","NBA",3.6,74,66,1705,127,256,127,255,0,1,69,119,209,271,480,30,41,24,56,193,323,6.02
3567,"Boris Diaw\diawbo01","2014-15",32,"SAS","NBA",3.6,81,15,1984,291,632,237,463,54,169,72,93,78,270,348,233,36,23,126,148,708,8.99
3568,"LaPhonso Ellis\ellisla01","1996-97",26,"DEN","NBA",3.6,55,49,2002,445,1014,350,755,95,259,218,282,107,279,386,131,44,41,117,181,1203,17.53
3569,"Monta Ellis\ellismo01","2014-15",29,"DAL","NBA",3.6,80,80,2699,602,1354,521,1070,81,284,228,303,34,156,190,329,148,25,198,197,1513,15.6
3570,"Danny Ferry\ferryda01","1992-93",26,"CLE","NBA",3.6,76,1,1461,220,459,186,377,34,82,99,113,81,198,279,137,29,49,83,171,573,7.96
3571,"Rick Fox\foxri01","2002-03",33,"LAL","NBA",3.6,76,75,2181,262,621,157,341,105,280,52,69,64,259,323,253,69,14,121,215,681,9.6
3572,"Steve Francis\francst01","2005-06",28,"TOT","NBA",3.6,70,60,2393,333,765,308,682,25,83,314,399,74,216,290,345,74,17,214,204,1005,14.46
3573,"Drew Gooden\goodedr01","2011-12",30,"MIL","NBA",3.6,56,46,1469,287,657,271,602,16,55,176,208,130,233,363,144,46,34,109,112,766,12.93
3574,"Jeff Green\greenje02","2018-19",32,"WAS","NBA",3.6,77,44,2097,326,687,215,367,111,320,183,206,57,252,309,137,43,39,101,160,946,11.38
3575,"Othella Harrington\harriot01","2004-05",31,"CHI","NBA",3.6,70,28,1271,217,424,217,424,0,0,127,177,106,186,292,56,24,18,84,188,561,7.48
3576,"Chuck Hayes\hayesch01","2009-10",26,"HOU","NBA",3.6,82,82,1773,161,329,161,329,0,0,36,66,151,314,465,139,73,43,74,219,358,6.91
3577,"Gordon Hayward\haywago01","2013-14",23,"UTA","NBA",3.6,77,77,2800,426,1032,341,752,85,280,311,381,62,329,391,400,110,40,212,155,1248,16.14
3578,"Gerald Henderson\hendege02","2013-14",26,"CHA","NBA",3.6,77,77,2461,403,930,363,815,40,115,235,309,31,279,310,199,51,32,113,159,1081,11.67
3579,"Gerald Henderson\hendege02","2014-15",27,"CHO","NBA",3.6,80,72,2315,370,847,325,711,45,136,184,217,36,237,273,206,51,22,110,135,969,10.38
3580,"John Henson\hensojo01","2014-15",24,"MIL","NBA",3.6,67,11,1228,196,346,196,346,0,0,78,137,124,188,312,59,28,135,87,152,470,8.53
3581,"Roy Hibbert\hibbero01","2010-11",24,"IND","NBA",3.6,81,80,2244,410,890,410,886,0,4,205,275,182,428,610,166,33,142,185,256,1025,12.72
3582,"Kirk Hinrich\hinriki01","2007-08",27,"CHI","NBA",3.6,75,72,2380,330,797,246,557,84,240,118,142,28,216,244,452,87,19,157,224,862,12.54
3583,"Robert Horry\horryro01","1992-93",22,"HOU","NBA",3.6,79,79,2330,323,682,311,635,12,47,143,200,113,279,392,191,80,83,156,210,801,10.87
3584,"Robert Horry\horryro01","2005-06",35,"SAS","NBA",3.6,63,3,1182,112,292,59,148,53,144,44,68,71,171,242,79,43,51,41,115,321,6.07
3585,"Dwight Howard\howardw01","2014-15",29,"HOU","NBA",3.6,41,41,1223,251,423,250,421,1,2,143,271,110,321,431,50,28,53,115,137,646,16.38
3586,"Juwan Howard\howarju01","2003-04",30,"ORL","NBA",3.6,81,77,2877,529,1169,529,1168,0,1,318,393,171,399,570,158,54,22,178,284,1376,14.16
3587,"Anthony Johnson\johnsan02","2003-04",29,"IND","NBA",3.6,73,7,1598,167,411,126,289,41,122,75,94,28,102,130,202,64,8,75,138,450,6.64
3588,"Magic Johnson\johnsma02","1995-96",36,"LAL","NBA",3.6,32,9,958,137,294,115,236,22,58,172,201,40,143,183,220,26,13,103,48,468,17.74
3589,"Popeye Jones\jonespo01","1994-95",24,"DAL","NBA",3.6,80,80,2385,372,839,371,827,1,12,80,124,329,515,844,163,35,27,124,267,825,10.93
3590,"Popeye Jones\jonespo01","1993-94",23,"DAL","NBA",3.6,81,47,1773,195,407,195,406,0,1,78,107,299,306,605,99,61,31,94,246,468,7.94
3591,"Tyus Jones\jonesty01","2017-18",21,"MIN","NBA",3.6,82,11,1467,150,328,105,199,45,129,71,81,16,116,132,232,95,6,59,110,416,6.79
3592,"Chris Kaman\kamanch01","2007-08",25,"LAC","NBA",3.6,56,55,2083,338,700,338,696,0,4,202,265,173,538,711,107,33,155,164,179,878,17.84
3593,"Frank Kaminsky\kaminfr01","2017-18",24,"CHO","NBA",3.6,79,4,1835,307,716,203,442,104,274,155,194,46,242,288,129,36,19,66,95,873,9.29
3594,"Linas Kleiza\kleizli01","2008-09",24,"DEN","NBA",3.6,82,7,1824,289,646,202,379,87,267,148,204,92,235,327,64,31,14,82,155,813,8.18
3595,"Kyle Lowry\lowryky01","2008-09",22,"TOT","NBA",3.6,77,21,1679,189,434,164,336,25,98,181,226,26,163,189,275,69,17,117,146,584,8.92
3596,"Jeff Malone\malonje01","1992-93",31,"UTA","NBA",3.6,79,59,2558,595,1205,592,1196,3,9,236,277,31,142,173,128,42,4,125,117,1429,12.79
3597,"Jamal Mashburn\mashbja01","1996-97",24,"TOT","NBA",3.6,69,51,2164,286,743,196,466,90,277,160,228,69,225,294,204,78,12,114,186,822,10.67
3598,"Antonio McDyess\mcdyean01","1995-96",21,"DEN","NBA",3.6,76,75,2280,427,881,427,877,0,4,166,243,229,343,572,75,54,114,154,250,1020,12.61
3599,"Chris Mihm\mihmch01","2004-05",25,"LAL","NBA",3.6,75,75,1870,280,552,280,550,0,2,175,258,197,305,502,50,14,108,110,237,735,10.04
3600,"C.J. Miles\milescj01","2014-15",27,"IND","NBA",3.6,70,40,1841,329,827,175,381,154,446,130,161,18,196,214,75,60,26,73,132,942,9.98
3601,"Darius Miles\milesda01","2003-04",22,"TOT","NBA",3.6,79,56,2079,365,753,358,713,7,40,124,193,112,247,359,162,67,61,130,168,861,10.37
3602,"Nazr Mohammed\mohamna01","2009-10",32,"CHA","NBA",3.6,58,29,984,189,342,189,342,0,0,81,125,114,190,304,28,15,43,53,105,459,8
3603,"Kelly Olynyk\olynyke01","2014-15",23,"BOS","NBA",3.6,64,13,1423,251,528,190,353,61,175,93,136,92,211,303,109,64,39,98,213,656,10.29
3604,"Bo Outlaw\outlabo01","2003-04",32,"MEM","NBA",3.6,82,1,1606,159,312,159,308,0,4,61,116,125,217,342,90,73,70,69,170,379,6.39
3605,"Jabari Parker\parkeja01","2015-16",20,"MIL","NBA",3.6,76,72,2408,443,899,434,864,9,35,175,228,123,272,395,130,69,29,116,154,1070,12.3
3606,"Tony Parker\parketo01","2009-10",27,"SAS","NBA",3.6,56,50,1728,349,716,339,682,10,34,186,246,7,128,135,317,29,8,149,96,894,14.62
3607,"Patrick Patterson\pattepa01","2015-16",26,"TOR","NBA",3.6,79,0,2020,204,493,98,200,106,293,29,34,77,265,342,94,53,32,65,128,543,7.03
3608,"Chuck Person\persoch01","1994-95",30,"SAS","NBA",3.6,81,1,2033,317,750,145,305,172,445,66,102,49,209,258,106,45,12,102,198,872,8.52
3609,"Morris Peterson\petermo01","2000-01",23,"TOR","NBA",3.6,80,49,1809,290,673,227,508,63,165,104,145,112,147,259,105,63,20,78,164,747,7.87
3610,"Eric Piatkowski\piatker01","2002-03",32,"LAC","NBA",3.6,62,26,1360,210,446,130,245,80,201,101,122,44,112,156,70,33,9,56,92,601,8.31
3611,"Mickaël Piétrus\pietrmi01","2006-07",24,"GSW","NBA",3.6,72,38,1937,286,586,193,346,93,240,136,210,81,246,327,62,48,55,105,220,801,10.23
3612,"Mickaël Piétrus\pietrmi01","2009-10",27,"ORL","NBA",3.6,75,24,1687,233,539,117,233,116,306,69,109,39,176,215,49,53,31,69,138,651,7.28
3613,"Mason Plumlee\plumlma01","2017-18",27,"DEN","NBA",3.6,74,26,1439,221,368,221,367,0,1,82,179,132,268,400,142,49,81,103,184,524,9.2
3614,"Tayshaun Prince\princta01","2012-13",32,"TOT","NBA",3.6,82,81,2631,359,820,321,726,38,94,96,130,72,292,364,196,48,25,89,86,852,9.22
3615,"Willie Reed\reedwi02","2016-17",26,"MIA","NBA",3.6,71,5,1031,162,285,161,281,1,4,49,88,129,203,332,26,18,47,31,137,374,5.99
3616,"Rajon Rondo\rondora01","2017-18",31,"NOP","NBA",3.6,65,63,1705,231,494,181,344,50,150,25,46,31,232,263,533,70,10,151,119,537,12.78
3617,"Jalen Rose\roseja01","2002-03",30,"CHI","NBA",3.6,82,82,3351,642,1583,509,1224,133,359,399,467,68,283,351,395,72,23,285,271,1816,17.59
3618,"Terrence Ross\rosste01","2015-16",24,"TOR","NBA",3.6,73,7,1747,270,626,139,287,131,339,49,62,21,164,185,56,54,25,46,120,720,7.8
3619,"Donald Royal\royaldo01","1994-95",28,"ORL","NBA",3.6,70,68,1841,206,434,206,430,0,4,223,299,83,196,279,198,45,16,125,156,635,9.85
3620,"John Salley\sallejo01","1994-95",30,"MIA","NBA",3.6,75,50,1955,197,395,197,395,0,0,153,207,110,226,336,123,47,85,97,279,547,8.73
3621,"John Salmons\salmojo01","2006-07",27,"SAC","NBA",3.6,79,19,2135,236,517,196,405,40,112,159,204,47,217,264,254,73,27,119,177,671,9.63
3622,"Landry Shamet\shamela01","2018-19",21,"TOT","NBA",3.6,79,27,1802,240,557,73,161,167,396,75,93,21,113,134,117,37,10,45,155,722,7.6
3623,"Josh Smith\smithjo03","2005-06",20,"ATL","NBA",3.6,80,73,2559,329,774,295,664,34,110,210,292,176,355,531,191,64,208,162,260,902,12.68
3624,"Michael Smith\smithmi02","2000-01",28,"WAS","NBA",3.6,79,29,1610,106,218,106,217,0,1,89,154,172,390,562,101,57,37,62,156,301,6.88
3625,"Damon Stoudamire\stoudda01","1998-99",25,"POR","NBA",3.6,50,50,1673,249,629,205,487,44,142,89,122,41,126,167,312,49,4,110,81,631,12.28
3626,"Amar'e Stoudemire\stoudam01","2014-15",32,"TOT","NBA",3.6,59,15,1245,273,490,273,486,0,4,134,186,110,219,329,45,29,38,78,161,680,10.92
3627,"Jason Terry\terryja01","2014-15",37,"HOU","NBA",3.6,77,18,1641,188,446,62,123,126,323,39,48,15,106,121,147,66,19,74,116,541,6.9
3628,"Jason Thompson\thompja02","2012-13",26,"SAC","NBA",3.6,82,81,2285,374,745,374,742,0,3,143,206,172,377,549,84,48,61,101,227,891,10.52
3629,"P.J. Tucker\tuckepj01","2016-17",31,"TOT","NBA",3.6,81,21,2236,199,482,129,286,70,196,72,93,117,354,471,99,116,19,66,196,540,8.16
3630,"Ronny Turiaf\turiaro01","2008-09",26,"GSW","NBA",3.6,79,26,1696,186,366,186,363,0,3,98,124,88,272,360,166,34,168,70,243,470,8.73
3631,"Beno Udrih\udrihbe01","2014-15",32,"MEM","NBA",3.6,79,12,1494,246,505,220,408,26,97,87,102,20,123,143,220,46,8,89,88,605,7.68
3632,"Greivis Vásquez\vasqugr01","2013-14",27,"TOT","NBA",3.6,79,23,1779,277,658,168,369,109,289,95,108,20,153,173,323,31,5,128,143,758,9.28
3633,"Nikola Vučević\vucevni01","2017-18",27,"ORL","NBA",3.6,57,57,1683,399,840,335,636,64,204,77,94,101,422,523,191,56,62,109,144,939,16.6
3634,"Sasha Vujačić\vujacsa01","2007-08",23,"LAL","NBA",3.6,72,0,1279,219,482,101,212,118,270,76,91,19,135,154,72,36,5,52,107,632,7.33
3635,"Antoine Walker\walkean02","2005-06",29,"MIA","NBA",3.6,82,19,2199,391,898,254,515,137,383,81,129,103,318,421,166,47,30,150,187,1000,10.5
3636,"Ben Wallace\wallabe01","2007-08",33,"TOT","NBA",3.6,72,72,2205,138,352,138,348,0,4,72,169,234,370,604,105,88,117,67,121,348,8.38
3637,"Ben Wallace\wallabe01","1998-99",24,"WAS","NBA",3.6,46,16,1231,115,199,115,199,0,0,47,132,137,247,384,18,50,90,36,111,277,9.32
3638,"Rasheed Wallace\wallara01","2009-10",35,"BOS","NBA",3.6,79,13,1780,266,650,184,360,82,290,96,125,42,283,325,80,80,70,63,222,710,8.42
3639,"Charlie Ward\wardch01","1996-97",26,"NYK","NBA",3.6,79,21,1763,133,337,85,183,48,154,95,125,45,175,220,326,83,15,147,188,409,7.9
3640,"Clarence Weatherspoon\weathcl01","1994-95",24,"PHI","NBA",3.6,76,76,2991,543,1238,539,1217,4,21,283,377,144,382,526,215,115,67,191,195,1373,15.91
3641,"Chris Webber\webbech01","1998-99",25,"SAC","NBA",3.6,42,42,1719,378,778,374,744,4,34,79,174,149,396,545,173,60,89,148,145,839,20.69
3642,"Jiří Welsch\welscji01","2003-04",24,"BOS","NBA",3.6,81,68,2179,262,612,193,431,69,181,153,206,60,236,296,183,101,7,129,176,746,9.3
3643,"David Wesley\wesleda01","2005-06",35,"HOU","NBA",3.6,71,59,2372,226,561,127,290,99,271,151,187,24,154,178,204,59,6,120,212,702,9.33
3644,"Derrick White\whitede01","2018-19",24,"SAS","NBA",3.6,67,55,1728,260,543,212,401,48,142,95,123,35,212,247,263,67,47,97,145,663,11.32
3645,"Deron Williams\willide01","2014-15",30,"BRK","NBA",3.6,68,55,2114,298,771,211,534,87,237,201,241,29,208,237,448,64,17,154,157,884,13.7
3646,"Derrick Williams\willide02","2015-16",24,"NYK","NBA",3.6,80,9,1435,254,565,210,415,44,150,194,256,47,249,296,75,29,9,61,69,746,7.92
3647,"Corliss Williamson\willico02","1999-00",26,"SAC","NBA",3.6,76,76,1707,311,622,311,622,0,0,163,212,122,168,290,82,38,19,110,192,785,8.94
3648,"Kevin Willis\willike02","1994-95",32,"TOT","NBA",3.6,67,63,2390,473,1015,470,1000,3,15,205,297,227,505,732,86,60,36,162,215,1154,15.43
3649,"Cole Aldrich\aldrico01","2015-16",27,"LAC","NBA",3.5,60,5,800,134,225,134,225,0,0,60,84,86,202,288,50,47,68,64,139,328,7.66
3650,"Kyle Anderson\anderky01","2015-16",22,"SAS","NBA",3.5,78,11,1245,138,295,126,258,12,37,62,83,25,219,244,123,60,29,59,97,350,5.82
3651,"Ryan Anderson\anderry01","2014-15",26,"NOP","NBA",3.5,61,5,1675,291,729,169,370,122,359,129,151,108,187,295,55,33,20,62,113,833,10.39
3652,"Greg Anthony\anthogr01","1996-97",29,"VAN","NBA",3.5,65,44,1863,199,507,111,269,88,238,130,178,25,159,184,407,129,4,129,122,616,12.49
3653,"Vin Baker\bakervi01","1999-00",28,"SEA","NBA",3.5,79,75,2849,514,1129,512,1121,2,8,281,412,227,378,605,148,47,66,213,288,1311,14.08
3654,"Matt Barnes\barnema02","2013-14",33,"LAC","NBA",3.5,63,40,1735,231,527,134,244,97,283,66,90,60,232,292,125,56,28,85,185,625,9.82
3655,"Dana Barros\barroda01","1992-93",25,"SEA","NBA",3.5,69,2,1243,214,474,150,305,64,169,49,59,18,89,107,151,63,3,58,78,541,7.31
3656,"Nicolas Batum\batumni01","2009-10",21,"POR","NBA",3.5,37,25,918,139,268,85,136,54,132,43,51,32,109,141,44,24,25,27,83,375,9.96
3657,"Nicolas Batum\batumni01","2017-18",29,"CHO","NBA",3.5,64,64,1981,270,650,178,376,92,274,108,130,57,249,306,349,65,23,131,72,740,13
3658,"Patrick Beverley\beverpa01","2014-15",26,"HOU","NBA",3.5,56,55,1727,204,532,89,209,115,323,45,60,67,170,237,192,59,23,83,182,568,10.28
3659,"Mookie Blaylock\blaylmo01","2000-01",33,"GSW","NBA",3.5,69,59,2352,317,801,244,576,73,225,53,76,71,201,272,462,163,20,128,134,760,13.42
3660,"Devin Booker\bookede01","2018-19",22,"PHO","NBA",3.5,64,64,2242,586,1255,451,841,135,414,393,454,39,226,265,433,56,13,264,200,1700,23.53
3661,"Carlos Boozer\boozeca01","2005-06",24,"UTA","NBA",3.5,33,19,1025,219,399,219,399,0,0,99,137,73,212,285,88,30,8,69,105,537,16.4
3662,"Earl Boykins\boykiea01","2002-03",26,"GSW","NBA",3.5,68,0,1321,199,464,170,387,29,77,173,200,35,53,88,221,38,4,73,75,600,8.45
3663,"Shawn Bradley\bradlsh01","1994-95",22,"PHI","NBA",3.5,82,59,2365,315,693,315,690,0,3,148,232,243,416,659,53,54,274,142,338,778,11.36
3664,"Elton Brand\brandel01","2009-10",30,"PHI","NBA",3.5,76,57,2297,412,858,412,857,0,1,172,233,179,282,461,109,82,80,131,232,996,12.3
3665,"Devin Brown\brownde02","2006-07",28,"NOK","NBA",3.5,58,49,1662,233,555,152,328,81,227,123,155,55,196,251,149,44,9,91,139,670,10.64
3666,"Kwame Brown\brownkw01","2010-11",28,"CHA","NBA",3.5,66,50,1714,194,375,194,375,0,0,136,231,147,303,450,43,26,39,69,174,524,8.55
3667,"Caron Butler\butleca01","2009-10",29,"TOT","NBA",3.5,74,74,2783,450,1051,408,906,42,145,264,315,104,357,461,156,116,24,160,193,1206,14.27
3668,"Jason Caffey\caffeja01","2000-01",27,"MIL","NBA",3.5,70,33,1460,179,367,179,367,0,0,142,211,135,218,353,53,38,25,77,184,500,7.44
3669,"Marcus Camby\cambyma01","1998-99",24,"NYK","NBA",3.5,46,0,945,136,261,136,261,0,0,57,103,102,151,253,12,29,74,39,131,329,8.1
3670,"Brian Cardinal\cardibr01","2004-05",27,"MEM","NBA",3.5,58,16,1433,160,432,116,307,44,125,158,181,63,162,225,114,88,19,83,172,522,9.41
3671,"Wilson Chandler\chandwi01","2016-17",29,"DEN","NBA",3.5,71,33,2197,433,939,323,613,110,326,141,194,103,357,460,141,51,30,114,172,1117,13.61
3672,"Nick Collison\collini01","2011-12",31,"OKC","NBA",3.5,63,0,1307,120,201,120,200,0,1,44,62,119,155,274,82,33,28,61,153,284,6.41
3673,"Dante Cunningham\cunnida01","2012-13",25,"MIN","NBA",3.5,80,9,2010,314,671,314,665,0,6,67,103,142,266,408,67,84,38,56,153,695,8.21
3674,"Eddy Curry\curryed01","2002-03",20,"CHI","NBA",3.5,81,48,1571,335,573,335,573,0,0,179,287,116,237,353,37,18,62,137,226,849,9.47
3675,"Vinny Del Negro\delnevi01","1992-93",26,"SAS","NBA",3.5,73,31,1526,218,430,212,406,6,24,101,117,19,144,163,291,44,1,92,146,543,8.72
3676,"Carlos Delfino\delfica01","2012-13",30,"HOU","NBA",3.5,67,5,1689,251,620,93,199,158,421,48,56,18,202,220,135,68,9,72,114,708,9.37
3677,"Carlos Delfino\delfica01","2010-11",28,"MIL","NBA",3.5,49,40,1590,200,513,95,229,105,284,60,75,24,176,200,112,76,8,57,72,565,10.61
3678,"Dan Dickau\dickada01","2004-05",26,"TOT","NBA",3.5,71,46,2090,306,756,221,511,85,245,190,228,34,146,180,347,76,4,145,201,887,12.09
3679,"Chris Dudley\dudlech02","1996-97",31,"POR","NBA",3.5,81,14,1840,126,293,126,293,0,0,65,137,204,389,593,41,39,96,80,247,317,6.24
3680,"Sean Elliott\elliose01","1998-99",30,"SAS","NBA",3.5,50,50,1509,208,507,169,388,39,119,106,140,35,178,213,117,26,17,71,104,561,9.61
3681,"Danny Fortson\fortsda01","1999-00",23,"BOS","NBA",3.5,55,5,856,140,265,140,265,0,0,139,189,141,225,366,29,20,5,67,180,419,8.36
3682,"Channing Frye\fryech01","2005-06",22,"NYK","NBA",3.5,65,14,1572,305,640,302,631,3,9,189,229,138,236,374,53,30,47,97,200,802,10.92
3683,"Kenny Gattison\gattike01","1993-94",29,"CHH","NBA",3.5,77,18,1644,233,445,233,445,0,0,126,195,105,253,358,95,59,46,79,229,592,8.4
3684,"Ben Gordon\gordobe01","2004-05",21,"CHI","NBA",3.5,82,3,2002,434,1056,300,725,134,331,233,270,55,160,215,164,53,10,186,224,1235,11.16
3685,"Brian Grant\grantbr01","1999-00",27,"POR","NBA",3.5,63,14,1322,173,352,172,350,1,2,112,166,121,223,344,64,32,28,84,166,459,7.84
3686,"Adrian Griffin\griffad01","2001-02",27,"DAL","NBA",3.5,58,34,1383,179,359,163,305,16,54,41,49,68,161,229,106,75,12,42,142,415,8.3
3687,"Tom Gugliotta\guglito01","1994-95",25,"TOT","NBA",3.5,77,63,2568,371,837,311,651,60,186,174,252,165,407,572,279,132,62,189,203,976,14.37
3688,"Al Harrington\harrial01","2009-10",29,"NYK","NBA",3.5,72,15,2195,448,1030,308,621,140,409,240,317,88,317,405,110,62,26,132,209,1276,14.2
3689,"Udonis Haslem\hasleud01","2011-12",31,"MIA","NBA",3.5,64,10,1589,151,357,151,357,0,0,83,102,117,353,470,42,35,24,60,142,385,7.14
3690,"Hersey Hawkins\hawkihe01","1998-99",32,"SEA","NBA",3.5,50,34,1644,171,408,116,228,55,180,119,132,51,150,201,123,80,18,80,90,516,11.05
3691,"Luther Head\headlu01","2007-08",25,"HOU","NBA",3.5,73,17,1379,206,477,127,252,79,225,66,81,18,117,135,138,44,9,70,75,557,6.85
3692,"Luther Head\headlu01","2005-06",23,"HOU","NBA",3.5,80,27,2310,254,630,141,317,113,313,86,123,33,233,266,215,89,9,119,169,707,8.81
3693,"Solomon Hill\hillso01","2014-15",23,"IND","NBA",3.5,82,78,2381,251,634,183,426,68,208,159,193,70,244,314,184,66,18,115,177,729,8.6
3694,"Josh Howard\howarjo01","2003-04",23,"DAL","NBA",3.5,67,29,1589,229,532,209,466,20,66,97,138,149,219,368,97,69,54,67,168,575,8.95
3695,"Bobby Jackson\jacksbo01","2005-06",32,"MEM","NBA",3.5,71,15,1775,286,748,157,416,129,332,107,146,44,179,223,195,61,1,101,155,808,9.45
3696,"Jonas Jerebko\jerebjo01","2014-15",27,"TOT","NBA",3.5,75,0,1230,169,379,115,239,54,140,56,66,93,189,282,71,46,18,44,135,448,6.23
3697,"Kevin Johnson\johnske02","1997-98",31,"PHO","NBA",3.5,50,12,1290,155,347,151,321,4,26,162,186,35,129,164,245,27,8,101,57,476,11.1
3698,"Cory Joseph\josepco01","2018-19",27,"IND","NBA",3.5,82,9,2063,226,548,171,377,55,171,30,43,39,240,279,321,94,22,80,131,537,8.35
3699,"Cory Joseph\josepco01","2015-16",24,"TOR","NBA",3.5,80,4,2046,257,585,227,475,30,110,133,174,39,171,210,250,63,20,102,131,677,8.62
3700,"Maxi Kleber\klebima01","2018-19",27,"DAL","NBA",3.5,71,18,1502,175,386,98,168,77,218,58,74,90,239,329,70,36,78,54,143,485,7.74
3701,"Kosta Koufos\koufoko01","2015-16",26,"SAC","NBA",3.5,78,14,1482,236,444,236,444,0,0,57,104,169,254,423,33,40,70,48,185,529,7.37
3702,"Kosta Koufos\koufoko01","2013-14",24,"MEM","NBA",3.5,80,22,1349,227,459,227,459,0,0,60,93,160,258,418,39,32,71,67,182,514,6.83
3703,"Voshon Lenard\lenarvo01","2000-01",27,"DEN","NBA",3.5,80,58,2331,336,846,189,464,147,382,153,192,47,184,231,190,65,18,102,170,972,10.02
3704,"Jeremy Lin\linje01","2015-16",27,"CHO","NBA",3.5,78,13,2048,300,728,224,502,76,226,238,292,42,211,253,235,58,42,150,165,914,10.97
3705,"Luc Longley\longllu01","1995-96",27,"CHI","NBA",3.5,62,62,1641,242,502,242,502,0,0,80,103,104,214,318,119,22,84,114,223,564,9.54
3706,"George Lynch\lynchge01","2002-03",32,"NOH","NBA",3.5,81,32,1497,147,359,119,280,28,79,41,74,139,214,353,104,66,19,52,136,363,5.56
3707,"Dan Majerle\majerda01","1998-99",33,"MIA","NBA",3.5,48,48,1624,118,298,50,95,68,203,33,46,21,187,208,150,38,7,55,100,337,8.36
3708,"Dan Majerle\majerda01","1996-97",31,"MIA","NBA",3.5,36,26,1264,141,347,73,146,68,201,40,59,45,117,162,116,54,14,50,75,390,11.27
3709,"Danny Manning\mannida01","1993-94",27,"TOT","NBA",3.5,68,66,2520,586,1201,583,1184,3,17,228,341,131,334,465,261,99,82,233,260,1403,18.77
3710,"Vernon Maxwell\maxweve01","1993-94",28,"HOU","NBA",3.5,75,73,2571,380,976,260,573,120,403,143,191,42,187,229,380,125,20,185,143,1023,12.92
3711,"O.J. Mayo\mayooj01","2011-12",24,"MEM","NBA",3.5,66,0,1771,300,736,200,461,100,275,133,172,30,180,210,169,71,23,124,137,833,10.78
3712,"JaVale McGee\mcgeeja01","2016-17",29,"GSW","NBA",3.5,77,10,739,208,319,208,316,0,3,56,111,100,144,244,17,19,67,40,109,472,6.3
3713,"Aaron McKie\mckieaa01","1996-97",24,"TOT","NBA",3.5,83,11,1625,150,365,109,262,41,103,92,110,40,181,221,161,77,22,90,130,433,6.31
3714,"Patty Mills\millspa02","2018-19",30,"SAS","NBA",3.5,82,1,1908,282,663,123,259,159,404,88,103,24,158,182,245,49,10,93,129,811,9.2
3715,"Nikola Mirotić\mirotni01","2018-19",27,"TOT","NBA",3.5,46,25,1245,238,542,122,224,116,318,105,124,60,279,339,55,31,34,48,107,697,13.78
3716,"Anthony Morrow\morroan01","2009-10",24,"GSW","NBA",3.5,69,37,2018,329,703,189,396,140,307,101,114,61,198,259,104,65,16,84,158,899,11.39
3717,"Alonzo Mourning\mournal01","2006-07",36,"MIA","NBA",3.5,77,43,1572,238,425,238,425,0,0,185,308,126,224,350,18,13,178,129,219,661,9.09
3718,"Lee Nailon\nailole01","2001-02",26,"CHH","NBA",3.5,79,41,1912,369,764,368,762,1,2,112,150,103,188,291,94,59,17,96,175,851,8.88
3719,"Larry Nance\nancela02","2016-17",24,"LAL","NBA",3.5,63,7,1442,190,361,180,325,10,36,59,80,120,249,369,96,82,39,56,149,449,9.33
3720,"Gary Neal\nealga01","2010-11",26,"SAS","NBA",3.5,80,1,1685,285,632,156,324,129,308,84,104,21,175,196,96,27,4,78,148,783,7.78
3721,"Jameer Nelson\nelsoja01","2011-12",29,"ORL","NBA",3.5,57,57,1706,259,606,172,375,87,231,71,88,29,152,181,325,38,5,135,130,676,12.11
3722,"Johnny Newman\newmajo01","1999-00",36,"NJN","NBA",3.5,82,9,1763,278,623,206,433,72,190,192,229,39,115,154,65,53,11,89,207,820,7.9
3723,"Victor Oladipo\oladivi01","2014-15",22,"ORL","NBA",3.5,72,71,2573,473,1086,389,838,84,248,262,320,51,251,302,295,120,19,204,187,1292,16.09
3724,"Bo Outlaw\outlabo01","2001-02",30,"TOT","NBA",3.5,83,36,1928,166,299,165,297,1,2,43,102,147,217,364,127,70,92,96,205,376,6.97
3725,"Scott Padgett\padgesc01","2001-02",25,"UTA","NBA",3.5,75,1,1295,188,395,139,282,49,113,75,102,111,174,285,82,43,13,69,140,500,6.82
3726,"Sam Perkins\perkisa01","1999-00",38,"IND","NBA",3.5,81,0,1620,184,441,95,223,89,218,80,97,64,225,289,68,31,33,63,136,537,6.33
3727,"Bobby Phills\phillbo01","1993-94",24,"CLE","NBA",3.5,72,53,1531,242,514,241,502,1,12,113,157,71,141,212,133,67,12,63,135,598,7.93
3728,"Terry Porter\portete01","2001-02",38,"SAS","NBA",3.5,72,0,1294,136,321,77,179,59,142,68,83,12,152,164,205,45,16,85,89,399,6.78
3729,"Bobby Portis\portibo01","2017-18",22,"CHI","NBA",3.5,73,4,1643,382,811,302,588,80,223,120,156,159,339,498,123,50,23,103,130,964,12.14
3730,"Vladimir Radmanović\radmavl01","2007-08",27,"LAL","NBA",3.5,65,41,1483,198,437,103,203,95,234,52,65,56,159,215,123,46,12,73,147,543,8.27
3731,"Julius Randle\randlju01","2016-17",22,"LAL","NBA",3.5,74,73,2132,377,773,360,710,17,63,204,282,150,486,636,264,49,37,173,248,975,14.43
3732,"Khalid Reeves\reevekh01","1994-95",22,"MIA","NBA",3.5,67,17,1462,206,465,139,294,67,171,140,196,52,134,186,288,77,10,132,139,619,10.65
3733,"J.R. Reid\reidjr01","1994-95",26,"SAS","NBA",3.5,81,37,1566,201,396,200,394,1,2,160,233,120,273,393,55,60,32,113,230,563,7.59
3734,"Quentin Richardson\richaqu01","2006-07",26,"NYK","NBA",3.5,49,47,1621,228,545,131,287,97,258,83,120,65,287,352,108,36,7,70,133,636,12
3735,"Glenn Robinson\robingl01","1995-96",23,"MIL","NBA",3.5,82,82,3249,627,1382,537,1119,90,263,316,389,136,368,504,293,95,42,282,236,1660,17.63
3736,"Terrence Ross\rosste01","2016-17",25,"TOT","NBA",3.5,78,24,1955,326,746,184,355,142,391,64,77,18,188,206,88,87,33,68,143,858,9.17
3737,"Brandon Rush\rushbr01","2011-12",26,"GSW","NBA",3.5,65,1,1717,235,469,136,250,99,219,65,82,33,218,251,88,35,58,68,64,634,9.7
3738,"Dario Šarić\saricda01","2018-19",24,"TOT","NBA",3.5,81,41,2023,304,696,186,373,118,323,132,150,126,331,457,127,45,9,97,182,858,9.98
3739,"Craig Smith\smithcr01","2007-08",24,"MIN","NBA",3.5,77,11,1547,297,528,297,519,0,9,133,200,123,230,353,60,36,17,89,217,727,8.84
3740,"Steve Smith\smithst01","1992-93",23,"MIA","NBA",3.5,48,43,1610,279,619,226,487,53,132,155,197,56,141,197,267,50,16,129,148,766,15.72
3741,"Jerry Stackhouse\stackje01","2004-05",30,"DAL","NBA",3.5,56,7,1617,274,662,242,542,32,120,253,298,38,145,183,127,53,10,106,104,833,12.2
3742,"Daniel Theis\theisda01","2017-18",25,"BOS","NBA",3.5,63,3,936,126,233,108,175,18,58,61,81,90,184,274,56,30,48,56,157,331,6.71
3743,"Daniel Theis\theisda01","2018-19",26,"BOS","NBA",3.5,66,2,908,146,266,120,199,26,67,56,76,87,138,225,68,21,42,33,161,374,6.46
3744,"Marcus Thornton\thornma01","2010-11",23,"TOT","NBA",3.5,73,23,1775,350,807,262,567,88,240,145,184,61,197,258,135,64,9,93,110,933,10.42
3745,"P.J. Tucker\tuckepj01","2015-16",30,"PHO","NBA",3.5,82,80,2540,239,582,171,376,68,206,106,142,165,347,512,177,106,20,111,202,652,9.45
3746,"Keith Van Horn\vanhoke01","2004-05",29,"TOT","NBA",3.5,62,16,1502,257,564,203,422,54,142,128,157,89,205,294,75,36,21,81,170,696,9.89
3747,"Jacque Vaughn\vaughja01","2001-02",26,"ATL","NBA",3.5,82,16,1856,206,438,182,384,24,54,104,126,18,150,168,349,65,2,112,183,540,8.35
3748,"Charlie Villanueva\villach01","2009-10",25,"DET","NBA",3.5,78,16,1848,363,827,264,545,99,282,106,130,85,280,365,53,48,55,74,223,931,9.71
3749,"Dwyane Wade\wadedw01","2014-15",33,"MIA","NBA",3.5,62,62,1971,509,1084,480,982,29,102,284,370,58,161,219,299,73,21,209,105,1331,18.16
3750,"John Wall\walljo01","2011-12",21,"WAS","NBA",3.5,66,66,2386,378,894,375,852,3,42,317,402,48,252,300,530,95,57,255,137,1076,18.08
3751,"Clarence Weatherspoon\weathcl01","2001-02",31,"NYK","NBA",3.5,56,41,1728,189,452,189,452,0,0,116,146,149,311,460,60,37,48,47,132,494,9.6
3752,"Martell Webster\webstma02","2007-08",21,"POR","NBA",3.5,75,70,2132,277,656,154,339,123,317,122,166,54,242,296,90,42,28,83,159,799,9.01
3753,"Bill Wennington\wennibi01","1993-94",30,"CHI","NBA",3.5,76,0,1371,235,482,235,480,0,2,72,88,117,236,353,70,43,29,75,214,542,7.18
3754,"David West\westda01","2017-18",37,"GSW","NBA",3.5,73,0,999,216,378,213,370,3,8,60,79,64,174,238,138,47,75,80,120,495,8.23
3755,"Gerald Wilkins\wilkige01","1992-93",29,"CLE","NBA",3.5,80,35,2079,361,797,345,739,16,58,152,181,74,140,214,183,78,18,94,154,890,9.62
3756,"Jerome Williams\willije01","2000-01",27,"TOT","NBA",3.5,59,2,1182,136,294,136,291,0,3,100,135,133,249,382,45,57,20,63,124,372,7.83
3757,"Brandan Wright\wrighbr03","2011-12",24,"DAL","NBA",3.5,49,0,791,144,233,144,232,0,1,52,82,62,112,174,13,22,63,21,61,340,7.5
3758,"Thaddeus Young\youngth01","2013-14",25,"PHI","NBA",3.5,79,78,2718,582,1283,492,991,90,292,163,229,166,310,476,182,167,36,165,213,1417,15.64
3759,"Danny Ainge\aingeda01","1994-95",35,"PHO","NBA",3.4,74,1,1374,194,422,116,208,78,214,105,130,25,84,109,210,46,7,79,155,571,7.9
3760,"LaMarcus Aldridge\aldrila01","2006-07",21,"POR","NBA",3.4,63,22,1392,241,479,241,477,0,2,83,115,144,168,312,24,22,73,43,186,565,8.38
3761,"Rafer Alston\alstora01","2005-06",29,"HOU","NBA",3.4,63,63,2431,280,738,178,426,102,312,99,143,36,219,255,425,101,15,157,194,761,13.49
3762,"Greg Anderson\andergr01","1993-94",29,"DET","NBA",3.4,77,47,1624,201,370,200,367,1,3,88,154,183,388,571,51,55,68,94,234,491,8.48
3763,"Joel Anthony\anthojo01","2011-12",29,"MIA","NBA",3.4,64,51,1349,85,152,85,152,0,0,49,71,100,150,250,9,36,84,45,126,219,5.3
3764,"Trevor Ariza\arizatr01","2006-07",21,"ORL","NBA",3.4,57,7,1278,200,371,200,364,0,7,106,171,98,151,249,65,59,19,84,134,506,9.08
3765,"Trevor Ariza\arizatr01","2010-11",25,"NOH","NBA",3.4,75,75,2600,303,762,221,491,82,271,138,197,61,347,408,162,120,31,118,180,826,10.78
3766,"D.J. Augustin\augusdj01","2014-15",27,"TOT","NBA",3.4,82,14,1964,258,647,175,401,83,246,178,205,20,141,161,353,49,3,145,93,777,9.5
3767,"Kelenna Azubuike\azubuke01","2007-08",24,"GSW","NBA",3.4,81,17,1732,261,587,190,392,71,195,99,138,107,217,324,75,45,34,58,159,692,7.66
3768,"Dana Barros\barroda01","1998-99",31,"BOS","NBA",3.4,50,16,1156,168,371,104,211,64,160,64,73,16,89,105,208,52,5,88,64,464,10.22
3769,"Michael Beasley\beaslmi01","2008-09",20,"MIA","NBA",3.4,81,19,2009,452,957,419,876,33,81,186,241,110,329,439,83,41,37,121,184,1123,11.27
3770,"Marco Belinelli\belinma01","2010-11",24,"NOH","NBA",3.4,80,69,1957,302,691,168,367,134,324,98,125,17,134,151,92,38,6,77,146,836,7.87
3771,"Travis Best\besttr01","2001-02",29,"TOT","NBA",3.4,74,21,1747,228,518,207,459,21,59,104,116,20,131,151,324,89,7,99,173,581,9.27
3772,"DeJuan Blair\blairde01","2013-14",24,"DAL","NBA",3.4,78,13,1214,210,393,210,391,0,2,77,121,139,229,368,70,60,21,77,192,497,7.17
3773,"Andray Blatche\blatcan01","2009-10",23,"WAS","NBA",3.4,81,36,2256,478,999,465,955,13,44,174,234,158,351,509,170,85,71,182,218,1143,13.19
3774,"Carlos Boozer\boozeca01","2013-14",32,"CHI","NBA",3.4,76,76,2141,447,980,447,978,0,2,148,193,137,495,632,118,53,22,154,216,1042,12.11
3775,"Elton Brand\brandel01","2012-13",33,"DAL","NBA",3.4,72,18,1527,226,478,226,477,0,1,66,93,130,300,430,70,50,90,57,192,518,8.29
3776,"Dee Brown\brownde01","1997-98",29,"TOT","NBA",3.4,72,12,1719,246,562,138,291,108,271,58,71,24,128,152,154,82,23,73,123,658,8.67
3777,"Shannon Brown\brownsh01","2009-10",24,"LAL","NBA",3.4,82,7,1700,253,592,191,403,62,189,99,121,30,153,183,108,57,31,67,129,667,6.98
3778,"Chase Budinger\budinch01","2010-11",22,"HOU","NBA",3.4,78,22,1738,279,656,190,382,89,274,118,138,52,229,281,127,41,18,67,114,765,8.52
3779,"Matt Bullard\bullama01","1992-93",25,"HOU","NBA",3.4,79,4,1356,213,494,122,251,91,243,58,74,66,156,222,110,30,11,57,129,575,6.47
3780,"Tyson Chandler\chandty01","2008-09",26,"NOH","NBA",3.4,45,45,1445,160,283,160,283,0,0,77,133,163,230,393,22,15,56,70,144,397,10.38
3781,"Jamal Crawford\crawfja01","2010-11",30,"ATL","NBA",3.4,76,0,2297,368,874,249,525,119,349,222,260,22,108,130,241,57,14,145,97,1077,11.64
3782,"Austin Croshere\croshau01","2003-04",28,"IND","NBA",3.4,77,0,1051,119,307,63,163,56,144,93,104,60,183,243,52,24,14,55,101,387,4.97
3783,"Dante Cunningham\cunnida01","2011-12",24,"MEM","NBA",3.4,64,5,1124,144,279,144,277,0,2,45,69,91,155,246,37,42,34,29,98,333,5.87
3784,"Dell Curry\curryde01","1992-93",28,"CHH","NBA",3.4,80,0,2094,498,1102,403,865,95,237,136,157,51,235,286,180,87,23,129,150,1227,12.37
3785,"Dale Davis\davisda01","2004-05",35,"TOT","NBA",3.4,61,28,1307,112,234,112,234,0,0,60,99,152,223,375,47,32,65,43,162,284,6.72
3786,"Hubert Davis\davishu01","1997-98",27,"DAL","NBA",3.4,81,30,2378,350,767,249,537,101,230,97,116,34,135,169,157,43,5,88,117,898,8.86
3787,"Andrew DeClercq\declean01","1997-98",24,"BOS","NBA",3.4,81,49,1523,169,340,169,339,0,1,101,168,180,212,392,59,85,49,84,277,439,6.9
3788,"Dale Ellis\ellisda01","1994-95",34,"DEN","NBA",3.4,81,3,1996,351,774,245,511,106,263,110,127,56,166,222,57,37,9,81,142,918,8.42
3789,"Cristiano Felício\feliccr01","2016-17",24,"CHI","NBA",3.4,66,0,1040,128,221,128,221,0,0,60,93,124,187,311,40,25,17,33,110,316,5.89
3790,"Raymond Felton\feltora01","2007-08",23,"CHA","NBA",3.4,79,79,2972,412,997,356,797,56,200,260,325,37,199,236,583,96,12,213,184,1140,15.04
3791,"Landry Fields\fieldla01","2011-12",23,"NYK","NBA",3.4,66,62,1894,236,513,205,392,31,121,77,137,59,219,278,169,79,17,102,99,580,9.27
3792,"Adonal Foyle\foylead01","2004-05",29,"GSW","NBA",3.4,78,50,1700,156,311,156,311,0,0,40,72,165,264,429,56,26,159,58,201,352,6.82
3793,"Langston Galloway\gallola01","2018-19",27,"DET","NBA",3.4,80,4,1745,228,587,93,207,135,380,81,96,49,122,171,85,37,8,24,135,672,6.46
3794,"Kevin Gamble\gamblke01","1994-95",29,"MIA","NBA",3.4,77,0,1223,220,450,181,352,39,98,87,111,29,93,122,119,52,10,49,130,566,6.76
3795,"Devean George\georgde01","2003-04",26,"LAL","NBA",3.4,82,48,1951,233,571,168,385,65,186,73,96,87,245,332,112,81,38,88,189,604,7.4
3796,"Marcin Gortat\gortama01","2012-13",28,"PHO","NBA",3.4,61,61,1876,295,566,295,563,0,3,90,138,128,388,516,75,40,98,99,127,680,12.3
3797,"Marcin Gortat\gortama01","2009-10",25,"ORL","NBA",3.4,81,0,1088,121,227,121,224,0,3,51,75,104,237,341,17,17,70,46,138,293,4.78
3798,"Danny Green\greenda02","2016-17",29,"SAS","NBA",3.4,68,68,1807,176,449,58,138,118,311,27,32,31,193,224,124,70,57,76,120,497,7.9
3799,"Tyler Hansbrough\hansbty01","2014-15",29,"TOR","NBA",3.4,74,8,1058,86,165,85,158,1,7,97,139,106,159,265,21,30,15,20,141,270,4.5
3800,"Maurice Harkless\harklma01","2018-19",25,"POR","NBA",3.4,60,53,1415,189,388,156,268,33,120,49,73,77,192,269,74,67,53,45,163,460,8.63
3801,"Josh Hart\hartjo01","2017-18",22,"LAL","NBA",3.4,63,23,1461,176,375,98,178,78,197,66,94,42,221,263,80,47,16,47,107,496,8.13
3802,"Brendan Haywood\haywobr01","2006-07",27,"WAS","NBA",3.4,77,49,1740,198,355,198,355,0,0,115,210,195,282,477,47,34,88,90,208,511,8.09
3803,"Willy Hernangómez\hernawi01","2016-17",22,"NYK","NBA",3.4,72,22,1324,246,465,242,450,4,15,91,125,170,332,502,96,41,36,100,150,587,9.45
3804,"Jrue Holiday\holidjr01","2015-16",25,"NOP","NBA",3.4,65,23,1831,410,935,323,676,87,259,182,216,27,168,195,391,88,22,167,148,1089,16
3805,"Jrue Holiday\holidjr01","2014-15",24,"NOP","NBA",3.4,40,37,1303,238,534,187,399,51,135,65,76,32,103,135,274,63,23,91,110,592,15.85
3806,"Richard Jefferson\jefferi01","2006-07",26,"NJN","NBA",3.4,55,53,1956,303,665,251,520,52,145,239,326,48,192,240,148,34,8,120,123,897,13.77
3807,"Jonas Jerebko\jerebjo01","2017-18",30,"UTA","NBA",3.4,74,19,1134,159,341,94,184,65,157,46,57,53,193,246,42,24,12,27,127,429,5.54
3808,"Avery Johnson\johnsav01","1996-97",31,"SAS","NBA",3.4,76,76,2472,327,685,321,659,6,26,140,203,32,115,147,513,96,15,146,158,800,12.51
3809,"Damon Jones\jonesda01","2005-06",29,"CLE","NBA",3.4,82,7,2089,190,491,50,120,140,371,32,50,14,119,133,169,37,1,55,112,552,5.93
3810,"Cory Joseph\josepco01","2016-17",25,"TOR","NBA",3.4,80,22,2003,299,661,251,526,48,135,94,122,51,184,235,265,66,13,108,140,740,9.25
3811,"Jerome Kersey\kerseje01","1992-93",30,"POR","NBA",3.4,65,50,1719,281,642,273,614,8,28,116,183,126,280,406,121,80,41,84,181,686,10.43
3812,"Kyle Korver\korveky01","2017-18",36,"CLE","NBA",3.4,73,4,1574,222,484,58,108,164,376,64,72,9,156,165,88,31,27,55,130,672,8.17
3813,"Toni Kukoč\kukocto01","1999-00",31,"TOT","NBA",3.4,56,31,1784,297,728,253,560,44,168,192,265,75,198,273,265,77,28,146,112,830,14.31
3814,"Tim Legler\legleti01","1993-94",27,"DAL","NBA",3.4,79,0,1322,231,528,179,389,52,139,142,169,36,92,128,120,52,13,60,133,656,7.14
3815,"Alex Len\lenal01","2014-15",21,"PHO","NBA",3.4,69,44,1518,179,353,178,350,1,3,73,104,142,312,454,32,34,105,74,213,432,8.05
3816,"Luc Longley\longllu01","1997-98",29,"CHI","NBA",3.4,58,58,1703,277,609,277,609,0,0,109,148,113,228,341,161,34,62,130,206,663,11.35
3817,"Kyle Lowry\lowryky01","2007-08",21,"MEM","NBA",3.4,82,9,2089,256,592,220,452,36,140,243,348,41,209,250,296,92,22,127,185,791,10.39
3818,"Corey Maggette\maggeco01","2010-11",31,"MIL","NBA",3.4,67,18,1401,253,559,225,481,28,78,271,325,44,197,241,84,21,5,127,175,805,10.04
3819,"Ian Mahinmi\mahinia01","2011-12",25,"DAL","NBA",3.4,61,12,1139,130,238,130,237,0,1,94,147,108,181,289,12,38,31,50,176,354,6.59
3820,"Danny Manning\mannida01","1994-95",28,"PHO","NBA",3.4,46,19,1510,340,622,334,601,6,21,136,202,97,179,276,154,41,57,121,176,822,17.29
3821,"Boban Marjanović\marjabo01","2015-16",27,"SAS","NBA",3.4,54,4,508,105,174,105,174,0,0,87,114,73,121,194,21,12,23,29,54,297,6.05
3822,"Jamal Mashburn\mashbja01","2001-02",29,"CHH","NBA",3.4,40,40,1601,303,744,262,632,41,112,211,241,31,211,242,171,45,6,110,80,858,17.8
3823,"Roger Mason\masonro01","2007-08",27,"WAS","NBA",3.4,80,9,1708,266,600,136,273,130,327,62,71,17,113,130,134,40,18,69,140,724,7.56
3824,"O.J. Mayo\mayooj01","2008-09",21,"MEM","NBA",3.4,82,82,3120,562,1283,417,905,145,378,247,281,56,252,308,262,91,13,226,204,1516,15.07
3825,"Darius Miles\milesda01","2001-02",20,"LAC","NBA",3.4,82,6,2227,309,642,306,623,3,19,158,255,109,344,453,184,71,103,160,184,779,10.58
3826,"Brad Miller\millebr01","2000-01",24,"CHI","NBA",3.4,57,45,1434,168,386,167,381,1,5,168,226,144,275,419,107,33,38,73,176,505,10.19
3827,"Oliver Miller\milleol01","1999-00",29,"PHO","NBA",3.4,51,9,1088,137,233,137,233,0,0,49,73,87,174,261,68,42,80,74,132,323,8.92
3828,"Nazr Mohammed\mohamna01","2007-08",30,"TOT","NBA",3.4,82,29,1650,272,528,272,527,0,1,95,163,194,300,494,72,45,60,101,230,639,8.37
3829,"Greg Monroe\monrogr01","2017-18",27,"TOT","NBA",3.4,51,14,1040,218,386,218,386,0,0,88,119,109,241,350,114,44,23,94,95,524,11.93
3830,"Mike Muscala\muscami01","2016-17",25,"ATL","NBA",3.4,70,3,1237,170,337,124,227,46,110,49,64,76,164,240,95,30,41,55,97,435,6.89
3831,"Johnny Newman\newmajo01","2000-01",37,"NJN","NBA",3.4,82,17,2049,291,695,232,519,59,176,254,297,34,142,176,115,63,10,106,229,895,8.89
3832,"Greg Ostertag\ostergr01","2002-03",29,"UTA","NBA",3.4,81,74,1926,169,326,169,326,0,0,100,196,180,323,503,55,20,147,104,235,438,7.43
3833,"Anthony Parker\parkean01","2008-09",33,"TOR","NBA",3.4,80,71,2637,321,754,227,513,94,241,121,145,45,272,317,269,100,15,114,145,857,10.92
3834,"Chandler Parsons\parsoch01","2011-12",23,"HOU","NBA",3.4,63,57,1804,248,549,188,371,60,178,43,78,90,210,300,134,73,29,81,142,599,9.63
3835,"Ruben Patterson\patteru01","2004-05",29,"POR","NBA",3.4,70,36,1957,319,601,317,576,2,25,169,282,126,147,273,138,106,21,143,164,809,11.39
3836,"Anthony Peeler\peelean01","2002-03",33,"MIN","NBA",3.4,82,39,2245,252,609,165,397,87,212,39,50,40,201,241,244,72,13,82,161,630,7.91
3837,"Will Perdue\perduwi01","1995-96",30,"SAS","NBA",3.4,80,22,1396,173,331,173,330,0,1,67,125,175,310,485,33,28,75,86,183,413,6.56
3838,"Vitaly Potapenko\potapvi01","2000-01",25,"BOS","NBA",3.4,82,7,1901,248,521,248,521,0,0,115,158,206,289,495,64,52,23,105,228,611,7.8
3839,"Pablo Prigioni\prigipa01","2013-14",36,"NYK","NBA",3.4,66,27,1283,88,191,23,51,65,140,11,12,36,93,129,228,67,2,60,132,252,6.56
3840,"J.R. Reid\reidjr01","1992-93",24,"TOT","NBA",3.4,83,25,1887,283,595,283,590,0,5,214,280,120,336,456,80,47,31,125,266,780,9.13
3841,"Isaiah Rider\rideris01","1995-96",24,"MIN","NBA",3.4,75,68,2594,560,1206,458,931,102,275,248,296,99,210,309,213,48,23,201,204,1470,15.57
3842,"Luke Ridnour\ridnolu01","2008-09",27,"MIL","NBA",3.4,72,50,2033,250,621,195,464,55,157,133,153,33,185,218,365,92,16,128,200,688,10.99
3843,"Andre Roberson\roberan03","2015-16",24,"OKC","NBA",3.4,70,70,1553,136,274,104,171,32,103,33,54,79,172,251,47,53,42,35,133,337,5.81
3844,"Alvin Robertson\roberal01","1992-93",30,"TOT","NBA",3.4,69,54,2006,247,539,207,417,40,122,84,128,107,162,269,263,155,18,133,218,618,11.32
3845,"Malik Rose\rosema01","1999-00",25,"SAS","NBA",3.4,74,3,1341,176,385,175,382,1,3,143,198,133,202,335,47,35,52,99,232,496,6.94
3846,"Luis Scola\scolalu01","2011-12",31,"HOU","NBA",3.4,66,66,2067,436,888,436,885,0,3,153,198,122,306,428,140,35,24,153,214,1025,13.35
3847,"Bobby Simmons\simmobo01","2008-09",28,"NJN","NBA",3.4,71,44,1729,198,441,81,179,117,262,43,58,72,205,277,92,50,10,62,186,556,7.78
3848,"Rik Smits\smitsri01","1998-99",32,"IND","NBA",3.4,49,49,1271,310,633,310,631,0,2,108,132,73,202,275,52,18,52,75,159,728,12.25
3849,"Tony Snell\snellto01","2016-17",25,"MIL","NBA",3.4,80,80,2336,246,541,102,186,144,355,47,58,22,226,248,96,55,14,55,125,683,7.87
3850,"Tim Thomas\thomati01","1997-98",20,"PHI","NBA",3.4,77,48,1779,306,684,244,513,62,171,171,231,107,181,288,90,54,17,118,185,845,9.2
3851,"Hedo Türkoğlu\turkohe01","2004-05",25,"ORL","NBA",3.4,67,11,1757,328,782,235,537,93,245,188,225,62,171,233,153,41,18,119,140,937,11.34
3852,"Hedo Türkoğlu\turkohe01","2009-10",30,"TOR","NBA",3.4,74,69,2272,276,674,168,385,108,289,175,226,42,301,343,304,55,32,125,220,835,11.9
3853,"Nick Van Exel\vanexni01","1993-94",22,"LAL","NBA",3.4,81,80,2700,413,1049,290,685,123,364,150,192,47,191,238,466,85,8,145,154,1099,12.66
3854,"Dwyane Wade\wadedw01","2016-17",35,"CHI","NBA",3.4,60,59,1792,414,955,369,810,45,145,223,281,63,207,270,228,86,41,138,112,1096,15.87
3855,"T.J. Warren\warretj01","2017-18",24,"PHO","NBA",3.4,65,65,2142,529,1063,509,973,20,90,193,255,125,208,333,85,65,41,85,149,1271,15.39
3856,"Hakim Warrick\warriha01","2010-11",28,"PHO","NBA",3.4,80,6,1416,228,446,227,435,1,11,212,294,88,208,296,69,32,9,79,100,669,7.75
3857,"Chris Webber\webbech01","2006-07",33,"TOT","NBA",3.4,61,60,1821,289,639,285,628,4,11,102,160,124,313,437,188,60,41,107,143,684,11.87
3858,"Chris Webber\webbech01","2004-05",31,"TOT","NBA",3.4,67,67,2370,555,1283,540,1239,15,44,181,228,130,482,612,318,94,53,182,214,1306,18.05
3859,"Bonzi Wells\wellsbo01","2005-06",29,"SAC","NBA",3.4,52,41,1684,284,613,274,568,10,45,129,190,142,259,401,144,94,25,126,156,707,14.23
3860,"Mark West\westma01","1992-93",32,"PHO","NBA",3.4,82,82,1558,175,285,175,285,0,0,86,166,153,305,458,29,16,103,93,243,436,6.9
3861,"Chris Wilcox\wilcoch01","2007-08",25,"SEA","NBA",3.4,62,55,1739,334,638,334,635,0,3,160,248,126,307,433,74,46,36,103,174,828,12.52
3862,"Dominique Wilkins\wilkido01","1996-97",37,"SAS","NBA",3.4,63,26,1945,397,953,327,714,70,239,281,350,169,233,402,119,39,31,135,100,1145,14.51
3863,"Aaron Williams\williaa01","2003-04",32,"NJN","NBA",3.4,72,7,1337,172,342,171,339,1,3,105,155,101,193,294,81,34,46,89,187,450,6.94
3864,"Lou Williams\willilo02","2008-09",22,"PHI","NBA",3.4,81,0,1919,336,844,273,624,63,220,304,385,36,129,165,242,85,14,151,128,1039,10.87
3865,"Scott Williams\willisc01","2000-01",32,"MIL","NBA",3.4,66,31,1272,171,361,170,357,1,4,60,70,97,267,364,35,48,32,41,178,403,6.9
3866,"Dorell Wright\wrighdo01","2011-12",26,"GSW","NBA",3.4,61,61,1650,222,526,117,234,105,292,80,98,60,218,278,94,58,26,51,97,629,9.76
3867,"Al-Farouq Aminu\aminual01","2014-15",24,"DAL","NBA",3.3,74,3,1366,147,357,113,233,34,124,84,118,114,228,342,59,70,62,55,137,412,6.74
3868,"Derek Anderson\anderde01","1999-00",25,"LAC","NBA",3.3,64,58,2201,377,860,322,682,55,178,271,309,80,178,258,220,90,11,167,149,1080,15.13
3869,"Joel Anthony\anthojo01","2010-11",28,"MIA","NBA",3.3,75,11,1463,53,99,53,99,0,0,47,73,104,162,266,24,10,93,36,194,153,3.9
3870,"J.J. Barea\bareajo01","2017-18",33,"DAL","NBA",3.3,69,10,1603,303,690,188,377,115,313,80,102,15,186,201,434,35,3,143,83,801,12.34
3871,"Will Barton\bartowi01","2016-17",26,"DEN","NBA",3.3,60,19,1705,295,666,208,431,87,235,143,190,58,201,259,206,48,28,97,110,820,12.81
3872,"Tony Battie\battito01","1998-99",22,"BOS","NBA",3.3,50,15,1121,147,283,147,280,0,3,41,61,96,204,300,53,29,71,45,159,335,8.47
3873,"Shane Battier\battish01","2011-12",33,"MIA","NBA",3.3,65,10,1499,113,292,51,109,62,183,23,37,56,100,156,82,64,33,37,105,311,5.43
3874,"Charlie Bell\bellch01","2005-06",26,"MIL","NBA",3.3,59,6,1283,180,410,109,242,71,168,63,89,21,99,120,130,59,5,41,126,494,7.97
3875,"Travis Best\besttr01","1997-98",25,"IND","NBA",3.3,82,0,1547,201,480,180,410,21,70,112,131,28,94,122,281,85,5,111,193,535,7.39
3876,"Steve Blake\blakest01","2009-10",29,"TOT","NBA",3.3,80,38,2159,217,522,101,228,116,294,36,48,21,166,187,380,58,6,128,123,586,8.82
3877,"Mookie Blaylock\blaylmo01","1999-00",32,"GSW","NBA",3.3,73,72,2459,327,837,226,536,101,301,67,95,55,215,270,489,146,22,143,122,822,13.25
3878,"Aaron Brooks\brookaa01","2014-15",30,"CHI","NBA",3.3,82,21,1885,344,817,223,504,121,313,145,174,32,134,166,261,54,15,157,189,954,10.02
3879,"Scott Brooks\brooksc01","1993-94",28,"HOU","NBA",3.3,73,0,1225,142,289,119,228,23,61,74,85,10,92,102,149,51,2,55,98,381,5.87
3880,"Wilson Chandler\chandwi01","2017-18",30,"DEN","NBA",3.3,74,71,2346,281,631,193,385,88,246,88,114,102,296,398,159,43,39,92,156,738,9.99
3881,"Rex Chapman\chapmre01","1996-97",29,"PHO","NBA",3.3,65,33,1833,332,749,222,435,110,314,124,149,25,156,181,182,52,7,96,108,898,11.59
3882,"Derrick Coleman\colemde01","1996-97",29,"PHI","NBA",3.3,57,54,2102,364,836,332,717,32,119,272,365,157,416,573,193,50,75,184,164,1032,17.93
3883,"Jarron Collins\collija03","2001-02",23,"UTA","NBA",3.3,70,68,1440,158,343,158,342,0,1,134,181,138,158,296,58,29,22,56,234,450,6.54
3884,"Jamal Crawford\crawfja01","2008-09",28,"TOT","NBA",3.3,65,65,2479,419,1022,277,628,142,394,300,344,23,170,193,288,57,13,148,92,1280,16.3
3885,"Jamal Crawford\crawfja01","2015-16",35,"LAC","NBA",3.3,79,5,2126,379,939,262,595,117,344,245,271,20,125,145,183,52,12,113,122,1120,10.76
3886,"Dell Curry\curryde01","1994-95",30,"CHH","NBA",3.3,69,0,1718,343,778,189,417,154,361,95,111,41,127,168,113,55,18,98,144,935,10.65
3887,"Eddy Curry\curryed01","2005-06",23,"NYK","NBA",3.3,72,69,1865,336,597,336,597,0,0,307,486,145,287,432,19,28,56,179,239,979,12.18
3888,"Sherman Douglas\douglsh01","1995-96",29,"TOT","NBA",3.3,79,66,2335,345,685,305,575,40,110,160,219,55,125,180,436,63,5,194,163,890,12.26
3889,"Tyus Edney\edneyty01","1995-96",22,"SAC","NBA",3.3,80,60,2481,305,740,252,596,53,144,197,252,63,138,201,491,89,3,192,203,860,11.96
3890,"Craig Ehlo\ehlocr01","1995-96",34,"ATL","NBA",3.3,79,8,1758,253,591,171,370,82,221,81,103,65,191,256,138,85,9,104,138,669,8.08
3891,"Wayne Ellington\ellinwa01","2016-17",29,"MIA","NBA",3.3,62,13,1500,231,555,82,161,149,394,37,43,18,114,132,70,35,4,30,70,648,7.89
3892,"Patrick Ewing\ewingpa01","1998-99",36,"NYK","NBA",3.3,38,38,1300,247,568,247,566,0,2,163,231,74,303,377,43,30,100,99,105,657,16.1
3893,"Dorian Finney-Smith\finnedo01","2018-19",25,"DAL","NBA",3.3,81,26,1985,228,528,149,274,79,254,73,103,138,251,389,95,69,36,74,186,608,7.83
3894,"T.J. Ford\fordtj01","2007-08",24,"TOR","NBA",3.3,51,26,1199,246,524,231,473,15,51,110,125,23,77,100,313,54,0,102,93,617,12.86
3895,"Evan Fournier\fournev01","2017-18",25,"ORL","NBA",3.3,57,57,1837,368,802,241,467,127,335,150,173,23,157,180,165,47,16,95,138,1013,14.65
3896,"Langston Galloway\gallola01","2015-16",24,"NYK","NBA",3.3,82,7,2033,231,588,154,364,77,224,86,114,43,245,288,207,77,22,61,177,625,7.89
3897,"Rudy Gay\gayru01","2008-09",22,"MEM","NBA",3.3,79,78,2945,572,1262,487,1020,85,242,264,344,109,328,437,135,98,59,203,221,1493,15.38
3898,"Taj Gibson\gibsota01","2012-13",27,"CHI","NBA",3.3,65,5,1459,214,441,214,437,0,4,89,131,125,220,345,61,27,90,76,166,517,8.43
3899,"Shai Gilgeous-Alexander\gilgesh01","2018-19",20,"LAC","NBA",3.3,82,73,2174,341,716,290,577,51,139,156,195,57,175,232,270,96,45,141,175,889,11.19
3900,"Drew Gooden\goodedr01","2007-08",26,"TOT","NBA",3.3,69,65,2122,332,740,332,734,0,6,162,215,175,415,590,81,48,53,122,203,826,11.56
3901,"Marcin Gortat\gortama01","2008-09",24,"ORL","NBA",3.3,63,3,794,106,187,105,186,1,1,26,45,96,190,286,14,18,53,25,111,239,5.11
3902,"Jerian Grant\grantje02","2017-18",25,"CHI","NBA",3.3,74,26,1686,209,503,148,316,61,187,140,188,31,141,172,342,63,8,89,132,619,9.57
3903,"Jeff Green\greenje02","2013-14",27,"BOS","NBA",3.3,82,82,2805,482,1171,347,775,135,396,283,356,54,326,380,138,57,47,165,180,1382,12.98
3904,"Devin Harris\harride01","2012-13",29,"ATL","NBA",3.3,58,34,1421,194,443,117,213,77,230,112,154,6,110,116,197,64,13,88,103,577,10.09
3905,"Gerald Henderson\hendege02","2012-13",25,"CHA","NBA",3.3,68,58,2133,382,855,349,755,33,100,258,313,55,195,250,177,68,34,108,149,1055,13.28
3906,"John Henson\hensojo01","2013-14",23,"MIL","NBA",3.3,70,23,1856,344,639,344,638,0,1,91,177,171,326,497,113,41,116,114,185,779,11.93
3907,"J.J. Hickson\hicksjj01","2013-14",25,"DEN","NBA",3.3,69,52,1859,332,654,332,646,0,8,150,290,206,426,632,96,47,51,128,177,814,12.11
3908,"Jrue Holiday\holidjr01","2012-13",22,"PHI","NBA",3.3,78,78,2926,555,1288,464,1041,91,247,182,242,89,240,329,625,123,32,292,170,1383,17.87
3909,"Jaren Jackson\jacksja02","2018-19",19,"MEM","NBA",3.3,58,56,1515,298,589,247,447,51,142,151,197,73,199,272,64,52,82,98,220,798,12.92
3910,"Šarūnas Jasikevičius\jasiksa01","2005-06",29,"IND","NBA",3.3,75,15,1557,170,429,84,193,86,236,121,133,19,134,153,227,40,4,116,108,547,7.64
3911,"Brandon Jennings\jennibr01","2014-15",25,"DET","NBA",3.3,41,41,1173,218,543,142,332,76,211,120,143,21,83,104,272,44,4,90,64,632,14.85
3912,"Jonas Jerebko\jerebjo01","2011-12",24,"DET","NBA",3.3,64,13,1468,212,453,180,347,32,106,100,124,96,212,308,43,41,21,66,162,556,8.17
3913,"Jonas Jerebko\jerebjo01","2018-19",31,"GSW","NBA",3.3,73,6,1218,163,355,94,167,69,188,64,80,72,216,288,96,27,18,43,137,459,6.73
3914,"Joe Johnson\johnsjo02","2003-04",22,"PHO","NBA",3.3,82,77,3331,555,1291,472,1019,83,272,174,232,80,305,385,362,93,26,199,177,1367,14.4
3915,"Jumaine Jones\jonesju01","2001-02",22,"CLE","NBA",3.3,81,36,2142,287,640,235,472,52,168,45,68,125,365,490,116,75,46,79,184,671,8.8
3916,"Michael Jordan\jordami01","2001-02",38,"WAS","NBA",3.3,60,53,2093,551,1324,541,1271,10,53,263,333,50,289,339,310,85,26,162,119,1375,18.27
3917,"Chris Kaman\kamanch01","2014-15",32,"POR","NBA",3.3,74,13,1398,283,549,283,549,0,0,72,102,149,335,484,65,18,54,108,140,638,8.78
3918,"Frank Kaminsky\kaminfr01","2015-16",22,"CHO","NBA",3.3,81,3,1708,215,525,147,323,68,202,108,148,69,266,335,98,38,43,58,126,606,7.15
3919,"Adam Keefe\keefead01","1992-93",22,"ATL","NBA",3.3,82,6,1549,188,376,188,375,0,1,166,237,171,261,432,80,57,16,100,195,542,7.59
3920,"Michael Kidd-Gilchrist\kiddgmi01","2017-18",24,"CHO","NBA",3.3,74,74,1850,282,560,282,558,0,2,117,171,84,218,302,71,51,32,53,143,681,8.43
3921,"Travis Knight\knightr01","1996-97",22,"LAL","NBA",3.3,71,14,1156,140,275,140,275,0,0,62,100,130,189,319,39,31,58,49,170,342,5.87
3922,"Kosta Koufos\koufoko01","2014-15",25,"MEM","NBA",3.3,81,3,1348,182,358,182,358,0,0,55,85,121,305,426,37,29,63,69,148,419,6.16
3923,"Jeremy Lamb\lambje01","2013-14",21,"OKC","NBA",3.3,78,0,1538,263,609,175,362,88,247,51,64,27,162,189,115,56,26,61,143,665,7.29
3924,"Courtney Lee\leeco01","2012-13",27,"BOS","NBA",3.3,78,39,1941,246,530,188,374,58,156,62,72,31,159,190,143,89,21,84,139,612,7.89
3925,"Shaun Livingston\livinsh01","2014-15",29,"GSW","NBA",3.3,78,2,1468,198,396,198,394,0,2,65,91,43,140,183,259,49,20,102,110,461,7.31
3926,"Corey Maggette\maggeco01","2001-02",22,"LAC","NBA",3.3,63,52,1615,235,530,189,391,46,139,201,251,54,177,231,112,41,19,116,155,717,10.24
3927,"Corey Maggette\maggeco01","2008-09",29,"GSW","NBA",3.3,51,19,1588,292,634,268,539,24,95,342,415,49,233,282,92,44,8,120,192,950,16.09
3928,"Ian Mahinmi\mahinia01","2013-14",27,"IND","NBA",3.3,77,1,1248,91,189,91,188,0,1,90,145,107,150,257,24,41,72,58,207,272,4.74
3929,"Lauri Markkanen\markkla01","2017-18",20,"CHI","NBA",3.3,68,68,2020,374,862,229,461,145,401,140,166,79,429,508,79,39,40,83,103,1033,13.15
3930,"Kenyon Martin\martike01","2009-10",32,"DEN","NBA",3.3,58,58,1986,283,620,275,591,8,29,93,167,142,404,546,109,72,61,91,186,667,12.52
3931,"Kevin Martin\martike02","2011-12",28,"HOU","NBA",3.3,40,40,1264,222,537,144,312,78,225,160,179,13,93,106,110,28,3,70,70,682,13.42
3932,"George McCloud\mccloge01","1998-99",31,"PHO","NBA",3.3,48,16,1245,142,324,73,158,69,166,75,87,34,128,162,79,45,14,49,128,428,8.92
3933,"Tracy McGrady\mcgratr01","1998-99",19,"TOR","NBA",3.3,49,2,1106,168,385,160,350,8,35,114,157,120,158,278,113,52,66,80,94,458,10.76
3934,"Darko Miličić\milicda01","2006-07",21,"ORL","NBA",3.3,80,16,1913,249,548,249,547,0,1,141,230,145,292,437,90,44,140,124,219,639,8.74
3935,"Sam Mitchell\mitchsa01","1996-97",33,"MIN","NBA",3.3,82,5,2044,269,603,265,578,4,25,224,295,112,214,326,79,51,20,93,232,766,8.22
3936,"Nazr Mohammed\mohamna01","2001-02",24,"ATL","NBA",3.3,82,73,2168,329,713,329,712,0,1,137,222,242,409,651,33,63,61,118,252,795,9.55
3937,"Chris Morris\morrich01","1995-96",30,"UTA","NBA",3.3,66,33,1424,265,606,202,409,63,197,98,127,100,129,229,77,63,20,71,140,691,8.84
3938,"Markieff Morris\morrima02","2017-18",28,"WAS","NBA",3.3,73,73,1968,330,687,254,480,76,207,105,128,75,334,409,142,56,38,127,216,841,11.35
3939,"Lamond Murray\murrala01","1999-00",26,"CLE","NBA",3.3,74,72,2365,460,1019,409,880,51,139,204,268,127,296,423,132,105,36,184,208,1175,13.67
3940,"Ira Newble\newblir01","2002-03",28,"ATL","NBA",3.3,73,45,1931,231,467,199,383,32,84,70,90,86,185,271,99,50,26,69,174,564,7.77
3941,"Andrés Nocioni\nocioan01","2007-08",28,"CHI","NBA",3.3,82,27,2021,379,877,253,531,126,346,196,243,48,294,342,95,25,43,133,245,1080,10.45
3942,"Royce O'Neale\onealro01","2018-19",25,"UTA","NBA",3.3,82,16,1671,163,343,95,167,68,176,32,42,22,263,285,124,54,24,70,172,426,6.33
3943,"Zaza Pachulia\pachuza01","2017-18",33,"GSW","NBA",3.3,69,57,972,149,264,149,263,0,1,75,93,89,232,321,109,38,17,72,122,373,7.18
3944,"Patrick Patterson\pattepa01","2016-17",27,"TOR","NBA",3.3,65,8,1599,154,384,60,131,94,253,43,60,62,231,293,76,40,23,38,120,445,7.04
3945,"Wesley Person\persowe01","2002-03",31,"MEM","NBA",3.3,66,44,1941,274,601,174,370,100,231,79,97,24,168,192,112,42,19,56,64,727,9.38
3946,"Olden Polynice\polynol01","1996-97",32,"SAC","NBA",3.3,82,82,2893,442,967,442,961,0,6,141,251,272,500,772,178,46,80,166,298,1025,12.39
3947,"Tayshaun Prince\princta01","2010-11",30,"DET","NBA",3.3,78,78,2562,473,1001,439,903,34,98,118,168,78,251,329,215,30,41,82,90,1098,11.63
3948,"Željko Rebrača\rebraze01","2001-02",29,"DET","NBA",3.3,74,4,1179,189,374,189,374,0,0,135,175,84,206,290,38,28,73,84,192,513,7.2
3949,"Glen Rice\ricegl01","2002-03",35,"HOU","NBA",3.3,62,26,1532,196,457,95,203,101,254,63,83,28,126,154,65,23,5,55,99,556,7.1
3950,"Mitch Richmond\richmmi01","1998-99",33,"WAS","NBA",3.3,50,50,1912,331,803,261,582,70,221,251,293,30,142,172,122,64,10,136,121,983,15.23
3951,"Luke Ridnour\ridnolu01","2011-12",30,"MIN","NBA",3.3,53,53,1750,242,550,193,398,49,152,106,119,19,122,141,252,56,16,96,136,639,12.18
3952,"Rodney Rogers\rogerro01","1997-98",26,"LAC","NBA",3.3,76,70,2499,426,935,354,723,72,212,225,328,155,269,424,202,93,38,193,242,1149,13.87
3953,"Jalen Rose\roseja01","1997-98",25,"IND","NBA",3.3,82,0,1706,290,607,265,534,25,73,166,228,28,167,195,155,56,14,132,171,771,8.41
3954,"Malik Rose\rosema01","2000-01",26,"SAS","NBA",3.3,57,9,1219,160,368,157,351,3,17,114,160,95,213,308,48,59,40,74,148,437,8.22
3955,"Luis Scola\scolalu01","2015-16",35,"TOR","NBA",3.3,76,76,1636,269,598,204,437,65,161,61,84,84,276,360,66,46,27,68,178,664,7.88
3956,"Byron Scott\scottby01","1992-93",31,"LAL","NBA",3.3,58,53,1677,296,659,252,524,44,135,156,184,27,107,134,157,55,13,70,98,792,11.47
3957,"Thabo Sefolosha\sefolth01","2016-17",32,"ATL","NBA",3.3,62,42,1596,174,395,133,275,41,120,55,75,54,216,270,107,96,31,58,97,444,8.54
3958,"Michael Smith\smithmi02","1999-00",27,"WAS","NBA",3.3,46,46,1145,108,192,108,191,0,1,73,101,121,210,331,56,27,23,45,127,289,8.72
3959,"Rik Smits\smitsri01","1996-97",30,"IND","NBA",3.3,52,52,1518,356,733,354,725,2,8,173,217,105,256,361,67,22,59,126,175,887,14.49
3960,"Stromile Swift\swiftst01","2002-03",23,"MEM","NBA",3.3,67,26,1478,235,489,235,487,0,2,177,245,114,270,384,45,55,104,99,152,647,10.21
3961,"Kurt Thomas\thomaku01","2005-06",33,"PHO","NBA",3.3,53,50,1411,190,391,190,391,0,0,75,92,102,313,415,57,23,54,57,193,455,9.76
3962,"Anthony Tolliver\tollian01","2010-11",25,"MIN","NBA",3.3,65,4,1362,141,313,94,198,47,115,105,131,92,203,295,82,28,28,49,145,434,7.44
3963,"Gary Trent\trentga01","2002-03",28,"MIN","NBA",3.3,80,22,1222,208,389,208,387,0,2,60,101,106,185,291,77,32,23,59,142,476,6.11
3964,"Anderson Varejão\varejan01","2012-13",30,"CLE","NBA",3.3,25,25,901,138,289,138,284,0,5,77,102,138,223,361,84,37,14,44,68,353,17.84
3965,"Jake Voskuhl\voskuja01","2003-04",26,"PHO","NBA",3.3,66,43,1606,152,300,152,300,0,0,134,181,123,220,343,57,42,25,77,258,438,7.68
3966,"Dwyane Wade\wadedw01","2007-08",26,"MIA","NBA",3.3,51,49,1954,439,937,417,860,22,77,354,467,45,169,214,354,87,37,224,137,1254,23.04
3967,"Hakim Warrick\warriha01","2007-08",25,"MEM","NBA",3.3,75,30,1754,328,653,315,605,13,48,183,260,123,233,356,53,36,28,85,156,852,9.74
3968,"C.J. Watson\watsocj01","2008-09",24,"GSW","NBA",3.3,77,18,1883,257,562,209,442,48,120,168,193,39,153,192,206,96,4,92,137,730,9.73
3969,"Clarence Weatherspoon\weathcl01","1992-93",22,"PHI","NBA",3.3,82,82,2654,494,1053,493,1049,1,4,291,408,179,410,589,147,85,67,176,188,1280,14.2
3970,"Delonte West\westde01","2009-10",26,"CLE","NBA",3.3,60,3,1500,194,436,169,359,25,77,115,142,29,140,169,196,55,28,90,86,528,9.48
3971,"Jahidi White\whiteja01","2001-02",25,"WAS","NBA",3.3,71,69,1346,150,279,150,279,0,0,83,154,159,285,444,17,25,75,65,163,383,6.85
3972,"Corliss Williamson\willico02","2004-05",31,"TOT","NBA",3.3,72,9,1527,273,584,273,582,0,2,195,244,104,155,259,78,38,15,86,218,741,8.73
3973,"Trae Young\youngtr01","2018-19",20,"ATL","NBA",3.3,81,81,2503,525,1256,369,774,156,482,343,414,64,237,301,653,72,15,308,140,1549,18.66
3974,"Alexis Ajinça\ajincal01","2014-15",26,"NOP","NBA",3.2,68,8,957,181,329,181,329,0,0,81,99,104,211,315,47,21,51,69,151,443,7.26
3975,"Chris Andersen\anderch01","2010-11",32,"DEN","NBA",3.2,45,0,732,82,137,82,136,0,1,86,135,75,144,219,20,23,58,25,79,250,7.39
3976,"Trevor Ariza\arizatr01","2009-10",24,"HOU","NBA",3.2,72,71,2629,394,999,258,592,136,407,148,228,78,325,403,276,126,40,161,162,1072,13.98
3977,"Darrell Armstrong\armstda01","2006-07",38,"IND","NBA",3.2,81,4,1275,156,377,84,163,72,214,73,93,34,101,135,191,70,6,76,102,457,6.29
3978,"Gustavo Ayón\ayongu01","2011-12",26,"NOH","NBA",3.2,54,24,1088,140,261,140,260,0,1,39,63,86,179,265,74,53,46,46,118,319,7.88
3979,"J.J. Barea\bareajo01","2010-11",26,"DAL","NBA",3.2,81,2,1669,285,649,219,460,66,189,133,157,29,130,159,317,30,1,136,136,769,9.08
3980,"Harrison Barnes\barneha02","2013-14",21,"GSW","NBA",3.2,78,24,2204,271,679,205,489,66,190,130,181,66,245,311,116,65,20,84,158,738,8.14
3981,"Marco Belinelli\belinma01","2016-17",30,"CHO","NBA",3.2,74,0,1778,264,615,162,332,102,283,150,168,14,164,178,147,44,9,70,90,780,9.09
3982,"Bismack Biyombo\biyombi01","2013-14",21,"CHA","NBA",3.2,77,9,1072,88,144,88,144,0,0,46,89,105,261,366,8,7,86,40,124,222,4.65
3983,"Terrell Brandon\brandte01","1998-99",28,"TOT","NBA",3.2,36,34,1217,212,507,200,460,12,47,65,78,27,107,134,309,63,10,74,82,501,15.71
3984,"Mark Bryant\bryanma01","1992-93",27,"POR","NBA",3.2,80,24,1396,186,370,186,369,0,1,104,148,132,192,324,41,37,23,65,226,476,6.06
3985,"Alec Burks\burksal01","2013-14",22,"UTA","NBA",3.2,78,12,2193,380,831,330,688,50,143,279,373,59,198,257,212,69,14,149,190,1089,12.2
3986,"Scott Burrell\burresc01","1999-00",29,"NJN","NBA",3.2,74,9,1336,165,419,83,187,82,232,39,50,65,191,256,72,67,44,38,173,451,6.35
3987,"Calbert Cheaney\cheanca01","1995-96",24,"WSB","NBA",3.2,70,70,2324,426,905,374,751,52,154,151,214,67,172,239,154,67,18,129,205,1055,12.14
3988,"Calbert Cheaney\cheanca01","1994-95",23,"WSB","NBA",3.2,78,71,2651,512,1129,416,846,96,283,173,213,105,216,321,177,80,21,151,215,1293,13.31
3989,"Bimbo Coles\colesbi01","1993-94",25,"MIA","NBA",3.2,76,4,1726,233,519,213,420,20,99,102,131,50,109,159,263,75,12,107,132,588,8.39
3990,"Allen Crabbe\crabbal01","2017-18",25,"BRK","NBA",3.2,75,68,2197,337,827,136,295,201,532,115,135,28,296,324,117,47,35,78,168,990,10.95
3991,"Austin Croshere\croshau01","2000-01",25,"IND","NBA",3.2,81,23,1874,276,701,206,494,70,207,200,231,123,264,387,92,36,50,136,180,822,8.88
3992,"Michael Curry\currymi01","1996-97",28,"DET","NBA",3.2,81,2,1217,99,221,76,144,23,77,97,108,23,96,119,43,31,12,28,128,318,3.9
3993,"Marquis Daniels\daniema01","2003-04",23,"DAL","NBA",3.2,56,15,1039,203,411,192,375,11,36,60,78,66,80,146,116,53,12,44,51,477,8.29
3994,"Todd Day\dayto01","1996-97",27,"BOS","NBA",3.2,81,27,2277,398,999,272,651,126,348,256,331,109,221,330,117,108,48,127,208,1178,11.89
3995,"DeMar DeRozan\derozde01","2010-11",21,"TOR","NBA",3.2,82,82,2851,539,1154,534,1102,5,52,327,402,75,240,315,148,85,31,144,217,1410,13.71
3996,"Joe Dumars\dumarjo01","1998-99",35,"DET","NBA",3.2,38,38,1116,144,350,55,129,89,221,51,61,12,56,68,134,23,2,53,51,428,10.05
3997,"Wayne Ellington\ellinwa01","2012-13",25,"TOT","NBA",3.2,78,21,1661,226,529,132,289,94,240,68,75,25,141,166,104,45,3,57,81,614,6.64
3998,"Maurice Evans\evansma01","2005-06",27,"DET","NBA",3.2,80,1,1139,154,341,111,225,43,116,52,65,76,87,163,60,41,15,39,122,403,4.74
3999,"Duane Ferrell\ferredu01","1993-94",28,"ATL","NBA",3.2,72,13,1155,184,379,183,370,1,9,144,184,62,67,129,65,44,16,64,85,513,6.36
4000,"Evan Fournier\fournev01","2018-19",26,"ORL","NBA",3.2,81,81,2553,468,1069,315,619,153,450,137,170,38,220,258,295,71,12,154,225,1226,12.85
4001,"Rick Fox\foxri01","1999-00",30,"LAL","NBA",3.2,82,1,1473,206,498,147,317,59,181,63,78,63,135,198,138,52,26,87,203,534,6.19
4002,"Rick Fox\foxri01","1993-94",24,"BOS","NBA",3.2,82,53,2096,340,728,307,628,33,100,174,230,105,250,355,217,81,52,158,244,887,11
4003,"Randy Foye\foyera01","2011-12",28,"LAC","NBA",3.2,65,48,1682,256,644,129,315,127,329,73,85,25,113,138,146,46,24,73,130,712,8.91
4004,"Channing Frye\fryech01","2007-08",24,"POR","NBA",3.2,78,20,1342,221,453,218,443,3,10,85,109,107,247,354,57,29,27,55,208,530,6.68
4005,"Kenny Gattison\gattike01","1992-93",28,"CHH","NBA",3.2,75,5,1475,203,384,203,381,0,3,102,169,108,245,353,68,48,55,64,237,508,7.59
4006,"Kendall Gill\gillke01","1995-96",27,"TOT","NBA",3.2,47,46,1683,246,524,220,445,26,79,138,176,72,160,232,260,64,24,131,131,656,15.49
4007,"Eric Gordon\gordoer01","2009-10",21,"LAC","NBA",3.2,62,60,2229,352,784,233,463,119,321,222,299,25,135,160,186,69,14,144,96,1045,14.18
4008,"A.C. Green\greenac01","2000-01",37,"MIA","NBA",3.2,82,1,1411,144,324,144,318,0,6,79,111,107,206,313,39,30,8,45,119,367,4.55
4009,"Eddie Griffin\griffed01","2004-05",22,"MIN","NBA",3.2,70,0,1492,202,522,135,318,67,204,56,78,128,325,453,53,23,118,55,120,527,7.96
4010,"Maurice Harkless\harklma01","2017-18",24,"POR","NBA",3.2,59,36,1264,147,297,98,179,49,118,42,59,46,116,162,53,48,43,40,103,385,6.93
4011,"Al Harrington\harrial01","2011-12",31,"DEN","NBA",3.2,64,1,1761,345,773,244,470,101,303,119,176,72,318,390,88,58,12,112,181,910,12
4012,"Udonis Haslem\hasleud01","2012-13",32,"MIA","NBA",3.2,75,59,1414,129,251,129,251,0,0,32,45,97,307,404,38,30,15,45,173,290,5.19
4013,"Nenê Hilário\hilarne01","2013-14",31,"WAS","NBA",3.2,53,37,1560,299,594,298,589,1,5,155,266,65,229,294,153,64,47,117,164,754,13.87
4014,"Nenê Hilário\hilarne01","2004-05",22,"DEN","NBA",3.2,55,18,1317,194,386,194,384,0,2,140,212,104,221,325,84,50,48,94,167,528,10.53
4015,"George Hill\hillge01","2017-18",31,"TOT","NBA",3.2,67,60,1812,236,513,151,308,85,205,110,140,42,139,181,186,61,27,88,128,667,10.04
4016,"Josh Howard\howarjo01","2008-09",28,"DAL","NBA",3.2,52,51,1663,353,783,295,615,58,168,172,220,59,204,263,83,55,30,89,135,936,14.41
4017,"Juwan Howard\howarju01","2004-05",31,"HOU","NBA",3.2,61,47,1624,244,541,244,540,0,1,97,115,126,220,346,94,32,5,79,143,585,8.79
4018,"Andre Iguodala\iguodan01","2017-18",34,"GSW","NBA",3.2,64,7,1622,148,320,115,203,33,117,55,87,50,196,246,210,54,38,67,99,384,8.32
4019,"Jarrett Jack\jackja01","2007-08",24,"POR","NBA",3.2,82,16,2229,267,620,202,430,65,190,215,248,31,203,234,313,61,1,178,129,814,10.34
4020,"Jim Jackson\jacksji01","2004-05",34,"TOT","NBA",3.2,64,27,1987,248,582,126,287,122,295,54,58,33,236,269,183,35,5,115,153,672,9.94
4021,"DerMarr Johnson\johnsde03","2004-05",24,"DEN","NBA",3.2,71,40,1232,185,371,132,223,53,148,80,101,43,108,151,75,43,18,65,140,503,6.72
4022,"Jerome Kersey\kerseje01","1993-94",31,"POR","NBA",3.2,78,6,1276,203,469,202,461,1,8,101,135,130,201,331,75,71,49,63,213,508,6.89
4023,"Negele Knight\knighne01","1993-94",26,"TOT","NBA",3.2,65,18,1438,225,475,221,454,4,21,141,174,28,75,103,197,34,11,94,121,595,8.62
4024,"Toni Kukoč\kukocto01","1993-94",25,"CHI","NBA",3.2,75,8,1808,313,726,281,608,32,118,156,210,98,199,297,252,81,33,167,122,814,10.78
4025,"Ty Lawson\lawsoty01","2016-17",29,"SAC","NBA",3.2,69,24,1732,237,522,203,404,34,118,173,217,44,135,179,334,74,6,129,119,681,11.25
4026,"Courtney Lee\leeco01","2011-12",26,"HOU","NBA",3.2,58,26,1757,251,580,164,363,87,217,71,86,26,133,159,88,68,22,64,106,660,9.6
4027,"David Lee\leeda02","2014-15",31,"GSW","NBA",3.2,49,4,904,160,313,160,311,0,2,68,104,81,176,257,85,31,26,49,83,388,8.78
4028,"Alex Len\lenal01","2018-19",25,"ATL","NBA",3.2,77,31,1544,320,648,246,444,74,204,140,216,158,266,424,86,27,69,97,200,854,10.43
4029,"Robin Lopez\lopezro01","2009-10",21,"PHO","NBA",3.2,51,31,986,171,291,171,291,0,0,88,125,104,144,248,7,10,53,41,117,430,8.45
4030,"George McCloud\mccloge01","1996-97",29,"TOT","NBA",3.2,64,28,1493,238,578,139,324,99,254,83,101,36,143,179,109,61,8,61,126,658,8.69
4031,"Antonio McDyess\mcdyean01","2009-10",35,"SAS","NBA",3.2,77,50,1617,205,428,205,426,0,2,36,57,149,306,455,83,43,32,79,147,446,6.82
4032,"Marcus Morris\morrima03","2017-18",28,"BOS","NBA",3.2,54,21,1447,262,611,176,377,86,234,124,154,43,246,289,72,35,12,65,100,734,11.27
4033,"Dejounte Murray\murrade01","2017-18",21,"SAS","NBA",3.2,81,48,1743,270,609,261,575,9,34,105,148,110,349,459,231,97,31,134,151,654,9.66
4034,"Shabazz Napier\napiesh01","2017-18",26,"POR","NBA",3.2,74,10,1535,223,531,141,313,82,218,116,138,26,144,170,150,81,14,90,84,644,8.33
4035,"Ken Norman\normake01","1994-95",30,"ATL","NBA",3.2,74,27,1879,388,856,290,571,98,285,64,140,103,259,362,94,34,20,96,154,938,9.76
4036,"Lamar Odom\odomla01","1999-00",20,"LAC","NBA",3.2,76,70,2767,449,1024,390,860,59,164,302,420,159,436,595,317,91,95,258,291,1259,17
4037,"Travis Outlaw\outlatr01","2007-08",23,"POR","NBA",3.2,82,6,2186,417,964,377,863,40,101,218,294,96,280,376,106,59,63,107,173,1092,10.75
4038,"Billy Owens\owensbi01","1994-95",25,"MIA","NBA",3.2,70,60,2296,403,820,401,798,2,22,194,313,203,299,502,246,80,30,204,205,1002,14.51
4039,"Billy Owens\owensbi01","1995-96",26,"TOT","NBA",3.2,62,51,1982,323,673,318,655,5,18,157,247,143,268,411,204,49,38,164,192,808,13.11
4040,"Ruben Patterson\patteru01","2002-03",27,"POR","NBA",3.2,78,17,1655,254,516,251,496,3,20,138,220,120,144,264,101,73,29,117,161,649,8.03
4041,"Anthony Peeler\peelean01","2000-01",31,"MIN","NBA",3.2,75,41,2126,308,732,208,476,100,256,75,87,44,148,192,192,91,18,105,166,791,9.49
4042,"Elliot Perry\perryel01","1996-97",27,"MIL","NBA",3.2,82,3,1595,217,458,168,321,49,137,79,106,24,100,124,247,98,3,111,117,562,7.8
4043,"Morris Peterson\petermo01","2002-03",25,"TOR","NBA",3.2,82,80,2949,421,1073,305,729,116,344,195,247,97,266,363,188,88,32,128,232,1153,11.42
4044,"Bobby Phills\phillbo01","1997-98",28,"CHH","NBA",3.2,62,61,1887,246,552,202,438,44,114,106,140,59,157,216,187,81,18,108,181,642,10.5
4045,"Olden Polynice\polynol01","1999-00",35,"UTA","NBA",3.2,82,79,1819,203,398,202,396,1,2,28,90,166,287,453,37,30,84,70,260,435,6.2
4046,"Quincy Pondexter\pondequ01","2012-13",24,"MEM","NBA",3.2,59,1,1243,128,299,68,147,60,152,59,75,43,89,132,61,35,6,42,95,375,5.85
4047,"Otto Porter\porteot01","2018-19",25,"TOT","NBA",3.2,56,43,1683,299,643,195,387,104,256,78,96,54,260,314,120,82,31,65,108,780,13.49
4048,"Kristaps Porziņģis\porzikr01","2017-18",22,"NYK","NBA",3.2,48,48,1553,390,889,300,661,90,228,218,275,62,254,316,57,36,115,93,141,1088,18.37
4049,"Pablo Prigioni\prigipa01","2012-13",35,"NYK","NBA",3.2,78,18,1263,100,220,47,86,53,134,22,25,41,102,143,236,69,2,86,127,275,5.8
4050,"Tayshaun Prince\princta01","2009-10",29,"DET","NBA",3.2,49,49,1664,282,580,255,507,27,73,70,98,71,177,248,161,34,22,60,77,661,12.61
4051,"Zach Randolph\randoza01","2016-17",35,"MEM","NBA",3.2,73,5,1786,433,964,412,870,21,94,141,193,182,416,598,122,38,10,99,136,1028,11.99
4052,"Michael Redd\reddmi01","2008-09",29,"MIL","NBA",3.2,33,32,1203,249,547,179,356,70,191,131,161,24,83,107,88,35,2,53,45,699,16.5
4053,"Stanley Roberts\roberst01","1992-93",22,"LAC","NBA",3.2,77,76,1816,375,711,375,711,0,0,120,246,181,297,478,59,34,141,121,332,870,10.87
4054,"Glenn Robinson\robingl01","1994-95",22,"MIL","NBA",3.2,80,76,2958,636,1410,550,1142,86,268,397,499,169,344,513,197,115,22,313,234,1755,18.19
4055,"Nate Robinson\robinna01","2006-07",22,"NYK","NBA",3.2,64,5,1356,227,523,144,310,83,213,108,139,55,97,152,90,50,6,72,160,645,8.36
4056,"Nate Robinson\robinna01","2007-08",23,"NYK","NBA",3.2,72,17,1883,331,782,234,490,97,292,154,196,51,171,222,212,60,1,103,186,913,10.82
4057,"Rajon Rondo\rondora01","2012-13",26,"BOS","NBA",3.2,38,38,1423,225,465,213,415,12,50,60,93,43,169,212,420,70,9,148,96,522,19.17
4058,"Quinton Ross\rossqu01","2006-07",25,"LAC","NBA",3.2,81,43,1700,177,379,175,369,2,10,68,87,60,130,190,86,70,32,33,179,424,5.56
4059,"Terry Rozier\roziete01","2018-19",24,"BOS","NBA",3.2,79,14,1791,258,666,139,329,119,337,73,93,32,275,307,231,68,21,68,101,708,8.91
4060,"Mike Scott\scottmi01","2015-16",27,"ATL","NBA",3.2,75,0,1146,176,376,114,218,62,158,50,63,53,153,206,78,25,17,42,102,464,5.87
4061,"Malik Sealy\sealyma01","1996-97",26,"LAC","NBA",3.2,80,79,2456,373,942,294,720,79,222,254,290,59,179,238,165,124,45,154,185,1079,11.51
4062,"Malik Sealy\sealyma01","1997-98",27,"DET","NBA",3.2,77,10,1641,216,505,207,464,9,41,150,182,48,171,219,100,65,20,79,156,591,7.11
4063,"Brian Shaw\shawbr01","1993-94",27,"MIA","NBA",3.2,77,52,2037,278,667,205,451,73,216,64,89,104,246,350,385,71,21,173,195,693,10.68
4064,"Marcus Smart\smartma01","2016-17",22,"BOS","NBA",3.2,79,24,2399,269,749,175,417,94,332,203,250,78,227,305,364,125,34,159,192,835,11.71
4065,"Tony Snell\snellto01","2018-19",27,"MIL","NBA",3.2,74,12,1304,163,361,82,157,81,204,37,42,29,128,157,68,26,18,23,90,444,5.45
4066,"Latrell Sprewell\sprewla01","2002-03",32,"NYK","NBA",3.2,74,73,2859,454,1127,320,767,134,360,173,218,45,240,285,332,102,22,172,134,1215,14.24
4067,"Maurice Taylor\tayloma01","2000-01",24,"HOU","NBA",3.2,69,69,1972,390,797,390,793,0,4,119,162,109,269,378,104,28,38,125,208,899,10.99
4068,"Kurt Thomas\thomaku01","2010-11",38,"CHI","NBA",3.2,52,37,1178,95,186,94,185,1,1,20,32,75,226,301,60,32,42,42,164,211,6.5
4069,"Marcus Thornton\thornma01","2012-13",25,"SAC","NBA",3.2,72,8,1726,332,774,191,395,141,379,111,126,50,131,181,91,61,4,68,105,916,9.73
4070,"Anthony Tolliver\tollian01","2013-14",28,"CHA","NBA",3.2,64,9,1298,129,307,27,60,102,247,33,41,33,135,168,42,19,15,23,82,393,5.51
4071,"Ronny Turiaf\turiaro01","2010-11",28,"NYK","NBA",3.2,64,21,1141,103,163,103,163,0,0,61,98,64,143,207,92,35,73,41,160,267,6.45
4072,"Ekpe Udoh\udohek01","2017-18",30,"UTA","NBA",3.2,63,3,810,60,120,60,119,0,1,42,56,68,82,150,53,43,74,20,105,162,4.58
4073,"Noah Vonleh\vonleno01","2018-19",23,"NYK","NBA",3.2,68,57,1722,207,440,161,303,46,137,111,156,113,415,528,129,46,51,88,174,571,10.46
4074,"Luke Walton\waltolu01","2007-08",27,"LAL","NBA",3.2,74,31,1729,215,478,187,394,28,84,77,109,85,206,291,218,60,18,100,133,535,8.31
4075,"C.J. Watson\watsocj01","2013-14",29,"IND","NBA",3.2,63,5,1193,146,334,93,189,53,145,69,88,19,82,101,107,60,8,60,66,414,6.54
4076,"Jahidi White\whiteja01","1999-00",23,"WAS","NBA",3.2,80,59,1537,228,450,228,450,0,0,113,211,202,351,553,15,31,83,94,234,569,7.84
4077,"Chris Whitney\whitnch01","1996-97",25,"WSB","NBA",3.2,82,1,1117,139,330,81,167,58,163,94,113,13,91,104,182,49,4,68,100,430,5.7
4078,"Mo Williams\willima01","2006-07",24,"MIL","NBA",3.2,68,68,2472,468,1049,389,821,79,228,159,186,54,275,329,416,85,6,203,201,1174,16.59
4079,"Corliss Williamson\willico02","2000-01",27,"TOT","NBA",3.2,69,40,1686,325,647,325,645,0,2,151,237,110,211,321,61,50,21,110,185,801,9.85
4080,"Lorenzen Wright\wrighlo02","2000-01",25,"ATL","NBA",3.2,71,46,1988,363,811,363,809,0,2,155,216,180,355,535,87,42,63,125,232,881,11.2
4081,"Lorenzen Wright\wrighlo02","1996-97",21,"LAC","NBA",3.2,77,51,1936,236,491,235,487,1,4,88,150,206,265,471,49,48,60,79,211,561,7.79
4082,"Lorenzen Wright\wrighlo02","2003-04",28,"MEM","NBA",3.2,65,46,1674,257,586,257,581,0,5,96,131,144,301,445,71,45,58,77,192,610,9.26
4083,"Nick Young\youngni01","2016-17",31,"LAL","NBA",3.2,60,60,1556,272,633,102,212,170,421,77,90,25,113,138,58,37,14,36,137,791,9.9
4084,"Ivica Zubac\zubaciv01","2018-19",21,"TOT","NBA",3.2,59,37,1040,212,379,212,379,0,0,101,126,115,247,362,63,14,51,70,137,525,9.71
4085,"Michael Adams\adamsmi01","1993-94",31,"WSB","NBA",3.1,70,67,2337,285,698,230,507,55,191,224,270,37,146,183,480,96,6,167,140,849,13.79
4086,"Tony Allen\allento01","2016-17",35,"MEM","NBA",3.1,71,66,1914,274,595,259,541,15,54,80,130,166,225,391,98,115,29,100,178,643,9.53
4087,"Al-Farouq Aminu\aminual01","2012-13",22,"NOH","NBA",3.1,76,71,2066,225,474,221,455,4,19,101,137,139,446,585,103,92,51,116,153,555,9.64
4088,"Al-Farouq Aminu\aminual01","2013-14",23,"NOP","NBA",3.1,80,65,2045,234,494,221,446,13,48,91,137,129,367,496,114,82,38,88,147,572,8.6
4089,"Ryan Anderson\anderry01","2009-10",21,"ORL","NBA",3.1,63,6,911,169,388,91,177,78,211,71,82,70,132,202,37,25,14,56,81,487,6.67
4090,"Joel Anthony\anthojo01","2009-10",27,"MIA","NBA",3.1,80,16,1322,76,159,76,159,0,0,66,92,123,126,249,12,20,109,45,158,218,4.14
4091,"Trevor Ariza\arizatr01","2012-13",27,"WAS","NBA",3.1,56,15,1471,188,451,112,242,76,209,78,95,44,222,266,113,72,20,84,72,530,9.9
4092,"Dāvis Bertāns\bertada01","2017-18",25,"SAS","NBA",3.1,77,10,1086,161,366,67,114,94,252,40,49,18,135,153,74,26,28,36,93,456,5.44
4093,"Tarik Black\blackta01","2014-15",23,"TOT","NBA",3.1,63,39,1196,157,273,157,272,0,1,65,118,142,226,368,42,19,24,48,158,379,7.01
4094,"Corie Blount\blounco01","2001-02",33,"PHI","NBA",3.1,72,21,1426,115,251,115,250,0,1,29,45,149,219,368,44,49,26,52,176,259,5.11
4095,"Trevor Booker\booketr01","2016-17",29,"BRK","NBA",3.1,71,43,1754,305,591,280,513,25,78,74,110,143,428,571,138,75,28,127,152,709,11.58
4096,"Ryan Bowen\bowenry01","2001-02",26,"DEN","NBA",3.1,75,21,1686,147,307,146,295,1,12,69,92,134,165,299,52,75,41,41,171,364,6.11
4097,"Avery Bradley\bradlav01","2016-17",26,"BOS","NBA",3.1,55,55,1835,359,775,251,498,108,277,68,93,65,269,334,122,68,11,88,141,894,14.18
4098,"Corey Brewer\breweco01","2014-15",28,"TOT","NBA",3.1,80,17,2087,343,805,280,570,63,235,168,226,80,217,297,173,114,19,131,173,917,10.43
4099,"Shannon Brown\brownsh01","2010-11",25,"LAL","NBA",3.1,82,0,1568,273,643,199,431,74,212,92,101,35,122,157,96,67,16,75,124,712,7.02
4100,"Greg Buckner\buckngr01","2002-03",26,"PHI","NBA",3.1,75,5,1514,185,398,170,343,15,55,65,81,72,144,216,96,72,16,62,203,450,6.34
4101,"Chase Budinger\budinch01","2009-10",21,"HOU","NBA",3.1,74,4,1488,249,565,157,316,92,249,67,87,38,182,220,88,34,11,48,85,657,7.36
4102,"Reggie Bullock\bullore01","2018-19",27,"TOT","NBA",3.1,63,60,1879,245,594,97,201,148,393,73,85,22,151,173,129,40,12,65,109,711,9.47
4103,"DeMarre Carroll\carrode01","2018-19",32,"BRK","NBA",3.1,67,8,1703,227,575,121,265,106,310,184,242,68,281,349,85,31,10,73,114,744,9.64
4104,"DeMarre Carroll\carrode01","2012-13",26,"UTA","NBA",3.1,66,12,1111,149,324,129,254,20,70,75,98,87,101,188,61,58,24,34,119,393,6.2
4105,"Wilson Chandler\chandwi01","2012-13",25,"DEN","NBA",3.1,43,8,1079,210,455,158,329,52,126,88,111,45,173,218,58,45,12,60,119,560,11.57
4106,"Wilson Chandler\chandwi01","2008-09",21,"NYK","NBA",3.1,82,70,2735,455,1054,352,740,103,314,171,215,91,354,445,170,71,75,139,250,1184,12.57
4107,"Wilson Chandler\chandwi01","2013-14",26,"DEN","NBA",3.1,62,55,1927,307,738,185,387,122,351,110,152,58,236,294,114,46,31,79,193,846,11.3
4108,"Marty Conlon\conloma01","1994-95",27,"MIL","NBA",3.1,82,3,2064,344,647,336,618,8,29,119,194,160,266,426,110,42,18,123,218,815,9.41
4109,"Robert Covington\covinro01","2016-17",26,"PHI","NBA",3.1,67,67,2119,292,732,155,320,137,412,143,174,92,344,436,102,127,69,131,203,864,13.09
4110,"Jamal Crawford\crawfja01","2006-07",26,"NYK","NBA",3.1,59,36,2198,354,886,251,564,103,322,228,272,44,145,189,259,57,8,162,114,1039,14.62
4111,"Andrew DeClercq\declean01","1998-99",25,"TOT","NBA",3.1,47,32,1102,138,276,138,276,0,0,95,141,104,151,255,31,50,29,54,161,371,8.69
4112,"Sam Dekker\dekkesa01","2016-17",22,"HOU","NBA",3.1,77,2,1419,203,429,143,242,60,187,38,68,94,190,284,76,38,21,41,83,504,6.39
4113,"Vinny Del Negro\delnevi01","1996-97",30,"SAS","NBA",3.1,72,53,2243,365,781,321,641,44,140,112,129,39,171,210,231,59,7,92,131,886,10.95
4114,"Mario Elie\eliema01","2000-01",37,"PHO","NBA",3.1,68,67,1506,104,246,68,146,36,100,55,69,38,117,155,131,58,12,60,112,299,5.63
4115,"Dale Ellis\ellisda01","1996-97",36,"DEN","NBA",3.1,82,51,2940,477,1151,285,623,192,528,215,263,99,194,293,165,60,7,146,178,1361,12.49
4116,"Francisco Elson\elsonfr01","2006-07",30,"SAS","NBA",3.1,70,41,1332,144,282,144,280,0,2,62,80,81,255,336,55,31,59,86,184,350,6.4
4117,"James Ennis\ennisja01","2016-17",26,"MEM","NBA",3.1,64,28,1501,146,321,95,184,51,137,86,110,69,190,259,64,46,19,59,165,429,7.2
4118,"James Ennis\ennisja01","2017-18",27,"TOT","NBA",3.1,72,22,1604,182,384,131,231,51,153,97,116,73,151,224,71,47,18,56,134,512,7.05
4119,"Maurice Evans\evansma01","2009-10",31,"ATL","NBA",3.1,79,5,1317,175,393,118,224,57,169,46,61,59,95,154,48,34,17,20,125,453,4.85
4120,"Tyreke Evans\evansty01","2013-14",24,"NOP","NBA",3.1,72,22,2028,391,897,370,802,21,95,239,310,76,265,341,363,84,21,175,155,1042,14.32
4121,"Derek Fisher\fishede01","1999-00",25,"LAL","NBA",3.1,78,22,1803,167,483,115,317,52,166,105,145,22,121,143,216,80,3,75,150,491,6.34
4122,"Derek Fisher\fishede01","2013-14",39,"OKC","NBA",3.1,81,0,1428,141,361,53,132,88,229,55,71,12,110,122,117,70,3,49,157,425,5.25
4123,"Randy Foye\foyera01","2008-09",25,"MIN","NBA",3.1,70,61,2494,399,981,288,673,111,308,230,272,34,180,214,303,72,26,150,201,1139,14.04
4124,"Lawrence Funderburke\fundela01","1998-99",28,"SAC","NBA",3.1,47,2,936,167,299,166,294,1,5,85,120,101,121,222,30,22,23,52,77,420,8.75
4125,"Chris Gatling\gatlich01","1992-93",25,"GSW","NBA",3.1,70,11,1248,249,462,249,456,0,6,150,207,129,191,320,40,44,53,102,197,648,9.12
4126,"Rudy Gay\gayru01","2017-18",31,"SAS","NBA",3.1,57,6,1231,253,537,216,419,37,118,112,145,76,215,291,73,46,38,78,98,655,10.65
4127,"Ryan Gomes\gomesry01","2005-06",23,"BOS","NBA",3.1,61,33,1376,173,355,170,346,3,9,112,149,102,196,298,58,35,5,55,83,461,7.63
4128,"Jeff Green\greenje02","2015-16",29,"TOT","NBA",3.1,80,41,2253,354,824,287,611,67,213,164,220,74,258,332,138,58,40,93,164,939,9.96
4129,"Tim Hardaway\hardati02","2013-14",21,"NYK","NBA",3.1,81,1,1875,294,687,164,329,130,358,106,128,19,102,121,66,44,7,47,144,824,7.35
4130,"Lucious Harris\harrilu01","2000-01",30,"NJN","NBA",3.1,73,50,2071,265,624,219,492,46,132,107,139,71,217,288,135,74,16,64,127,683,8.69
4131,"Brendan Haywood\haywobr01","2001-02",22,"WAS","NBA",3.1,62,2,1266,109,221,109,221,0,0,97,160,143,179,322,29,21,91,50,158,315,6.65
4132,"Alan Henderson\hendeal01","1998-99",26,"ATL","NBA",3.1,38,37,1142,187,423,187,422,0,1,100,149,100,150,250,28,33,19,58,96,474,10.5
4133,"Alan Henderson\hendeal01","2004-05",32,"DAL","NBA",3.1,78,10,1203,116,220,116,218,0,2,41,76,164,184,348,21,29,37,49,149,273,4.62
4134,"Kirk Hinrich\hinriki01","2012-13",32,"CHI","NBA",3.1,60,60,1764,159,422,88,240,71,182,70,98,16,142,158,314,63,25,99,192,459,9.66
4135,"Allan Houston\houstal01","2003-04",32,"NYK","NBA",3.1,50,50,1799,340,781,253,579,87,202,157,172,20,101,121,99,38,2,102,105,924,13.29
4136,"Bobby Jackson\jacksbo01","2000-01",27,"SAC","NBA",3.1,79,7,1648,231,526,192,422,39,104,65,88,74,172,246,161,87,7,103,139,566,7.39
4137,"Bobby Jackson\jacksbo01","2003-04",30,"SAC","NBA",3.1,50,0,1185,263,592,182,373,81,219,82,109,55,119,174,105,49,8,63,106,689,11.33
4138,"Jaren Jackson\jacksja01","1999-00",32,"SAS","NBA",3.1,81,12,1691,186,488,78,182,108,306,33,51,34,147,181,118,54,7,66,157,513,5.59
4139,"Stephen Jackson\jacksst02","2004-05",26,"IND","NBA",3.1,51,49,1806,330,819,227,533,103,286,190,229,44,206,250,119,64,14,123,154,953,14.77
4140,"Antawn Jamison\jamisan01","2011-12",35,"CLE","NBA",3.1,65,65,2151,421,1044,330,777,91,267,185,271,123,285,408,131,51,43,90,164,1118,13.19
4141,"Richard Jefferson\jefferi01","2011-12",31,"TOT","NBA",3.1,63,44,1748,203,488,90,219,113,269,59,85,26,193,219,88,37,19,50,121,578,8.04
4142,"Jared Jeffries\jeffrja01","2005-06",24,"WAS","NBA",3.1,77,77,1951,187,415,171,365,16,50,99,168,164,215,379,148,58,50,99,223,489,7.71
4143,"Eddie Jones\jonesed02","2006-07",35,"TOT","NBA",3.1,64,41,1594,178,422,100,200,78,222,59,75,31,159,190,109,68,10,47,124,493,7.65
4144,"Cory Joseph\josepco01","2017-18",26,"IND","NBA",3.1,82,17,2210,256,604,189,414,67,190,70,94,39,224,263,260,80,18,87,141,649,8.52
4145,"Michael Kidd-Gilchrist\kiddgmi01","2013-14",20,"CHA","NBA",3.1,62,62,1502,167,353,166,344,1,9,113,184,109,215,324,52,43,39,60,145,448,7.67
4146,"Jon Koncak\koncajo01","1992-93",29,"ATL","NBA",3.1,78,65,1975,124,267,121,259,3,8,24,50,100,327,427,140,75,100,52,264,275,6.94
4147,"Toni Kukoč\kukocto01","2003-04",35,"MIL","NBA",3.1,73,0,1522,211,506,162,338,49,168,145,199,60,211,271,200,59,21,110,110,616,8.86
4148,"Kyle Kuzma\kuzmaky01","2018-19",23,"LAL","NBA",3.1,70,68,2314,496,1087,368,665,128,422,188,250,60,322,382,178,41,26,133,170,1308,15.1
4149,"Jake Layman\laymaja01","2018-19",24,"POR","NBA",3.1,71,33,1327,216,424,157,243,59,181,50,71,56,161,217,53,31,30,46,116,541,7.02
4150,"Courtney Lee\leeco01","2009-10",24,"NJN","NBA",3.1,71,66,2375,338,775,262,550,76,225,133,153,60,192,252,121,93,20,76,130,885,10.74
4151,"Luc Longley\longllu01","1996-97",28,"CHI","NBA",3.1,59,59,1472,221,485,221,483,0,2,95,120,121,211,332,141,23,66,111,191,537,9.77
4152,"Anthony Mason\masonan01","2002-03",36,"MIL","NBA",3.1,65,58,2119,191,393,191,392,0,1,84,117,90,326,416,209,32,12,79,147,466,9.34
4153,"Wesley Matthews\matthwe02","2016-17",30,"DAL","NBA",3.1,73,73,2495,333,847,159,368,174,479,146,179,18,241,259,210,77,15,102,161,986,11.66
4154,"Luc Mbah a Moute\mbahalu01","2016-17",30,"LAC","NBA",3.1,80,76,1787,191,378,148,268,43,110,59,87,44,126,170,39,81,35,46,122,484,6.07
4155,"Jodie Meeks\meeksjo01","2014-15",27,"DET","NBA",3.1,60,0,1462,222,534,148,322,74,212,145,160,12,92,104,79,59,6,57,76,663,8.87
4156,"C.J. Miles\milescj01","2015-16",28,"IND","NBA",3.1,64,24,1464,259,634,117,247,142,387,93,124,25,150,175,63,53,29,70,142,753,9.18
4157,"Oliver Miller\milleol01","1994-95",24,"DET","NBA",3.1,64,22,1558,232,418,229,405,3,13,78,124,162,313,475,93,60,116,115,217,545,11.3
4158,"Ronald Murray\murraro01","2008-09",29,"ATL","NBA",3.1,80,2,1975,355,795,268,553,87,242,177,233,22,146,168,158,88,17,128,173,974,10.19
4159,"Dikembe Mutombo\mutomdi01","2005-06",39,"HOU","NBA",3.1,64,23,955,50,95,50,95,0,0,69,91,100,206,306,4,17,57,35,128,169,4.62
4160,"Tyrone Nesby\nesbyty01","1998-99",23,"LAC","NBA",3.1,50,36,1288,182,405,147,309,35,96,104,133,57,118,175,82,77,20,53,143,503,9.98
4161,"Shaquille O'Neal\onealsh01","2009-10",37,"CLE","NBA",3.1,53,53,1240,262,463,262,462,0,1,112,226,93,262,355,80,15,62,105,169,636,11.84
4162,"Zaza Pachulia\pachuza01","2010-11",26,"ATL","NBA",3.1,79,7,1244,107,232,107,232,0,0,135,179,119,214,333,58,34,22,69,184,349,5.51
4163,"Robert Pack\packro01","1992-93",23,"DEN","NBA",3.1,77,1,1579,285,606,284,598,1,8,239,311,52,108,160,335,81,10,185,182,810,11.14
4164,"Sasha Pavlović\pavloal01","2006-07",23,"CLE","NBA",3.1,67,28,1534,222,490,162,342,60,148,100,126,23,135,158,105,55,17,102,145,604,8.1
4165,"Elliot Perry\perryel01","1995-96",26,"PHO","NBA",3.1,81,26,1668,261,549,237,490,24,59,151,194,34,102,136,353,87,5,146,140,697,9.78
4166,"Ricky Pierce\piercri01","1995-96",36,"IND","NBA",3.1,76,2,1404,264,590,229,486,35,104,174,205,40,96,136,101,57,6,93,188,737,7.94
4167,"Vitaly Potapenko\potapvi01","2001-02",26,"BOS","NBA",3.1,79,9,1343,137,301,137,301,0,0,89,120,167,180,347,30,37,18,63,174,363,5.12
4168,"Dwight Powell\poweldw01","2015-16",24,"DAL","NBA",3.1,69,2,992,146,296,144,280,2,16,105,142,84,189,273,44,36,24,40,118,399,6.21
4169,"Zach Randolph\randoza01","2004-05",23,"POR","NBA",3.1,46,37,1603,332,741,332,735,0,6,207,254,142,300,442,86,34,17,112,112,871,16.29
4170,"Mitch Richmond\richmmi01","1992-93",27,"SAC","NBA",3.1,45,45,1728,371,782,323,652,48,130,197,233,18,136,154,221,53,9,130,137,987,18.87
4171,"Glenn Robinson\robingl01","1997-98",25,"MIL","NBA",3.1,56,56,2294,534,1136,509,1071,25,65,215,266,82,225,307,158,69,34,200,164,1308,18.43
4172,"Rodney Rogers\rogerro01","2003-04",32,"NJN","NBA",3.1,69,15,1409,207,505,157,353,50,152,75,98,100,207,307,137,59,27,98,183,539,8.05
4173,"Byron Scott\scottby01","1993-94",32,"IND","NBA",3.1,67,2,1197,256,548,229,474,27,74,157,195,19,91,110,133,62,9,103,80,696,9.03
4174,"Craig Smith\smithcr01","2008-09",25,"MIN","NBA",3.1,74,31,1460,289,514,289,513,0,1,168,248,98,186,284,79,31,19,105,184,746,9.23
4175,"Ish Smith\smithis01","2016-17",28,"DET","NBA",3.1,81,32,1955,329,749,301,644,28,105,72,102,21,214,235,418,61,33,112,127,758,10.17
4176,"Michael Smith\smithmi02","1995-96",23,"SAC","NBA",3.1,65,0,1384,144,238,143,237,1,1,68,177,143,246,389,110,47,46,72,166,357,7.94
4177,"DeShawn Stevenson\stevede01","2006-07",25,"WAS","NBA",3.1,82,82,2419,347,753,273,570,74,183,152,216,55,161,216,218,65,19,119,155,920,10.04
4178,"Gary Trent\trentga01","1997-98",23,"TOT","NBA",3.1,54,20,1360,241,505,237,493,4,12,144,212,123,215,338,72,35,27,94,161,630,10.84
4179,"Ronny Turiaf\turiaro01","2006-07",24,"LAL","NBA",3.1,72,1,1087,147,268,147,267,0,1,89,134,88,171,259,63,17,78,52,202,383,6.33
4180,"Jeff Turner\turneje01","1992-93",30,"ORL","NBA",3.1,75,20,1479,231,437,221,420,10,17,56,70,74,178,252,107,19,9,66,192,528,6.8
4181,"Myles Turner\turnemy01","2015-16",19,"IND","NBA",3.1,60,30,1367,264,530,261,516,3,14,88,121,68,264,332,41,25,86,67,158,619,9.79
4182,"Beno Udrih\udrihbe01","2004-05",22,"SAS","NBA",3.1,80,2,1149,173,390,115,248,58,142,67,89,16,67,83,150,41,10,77,96,471,5.56
4183,"Charlie Villanueva\villach01","2010-11",26,"DET","NBA",3.1,76,11,1666,313,708,188,385,125,323,89,116,50,245,295,48,42,42,66,175,840,8.97
4184,"Gerald Wallace\wallage01","2012-13",30,"BRK","NBA",3.1,69,68,2076,182,458,136,295,46,163,121,190,69,250,319,181,97,46,110,118,531,9.26
4185,"Charlie Ward\wardch01","1998-99",28,"NYK","NBA",3.1,50,50,1556,135,334,82,185,53,149,55,78,23,149,172,271,103,8,131,105,378,11.12
4186,"C.J. Watson\watsocj01","2009-10",25,"GSW","NBA",3.1,65,15,1788,247,528,202,383,45,145,128,166,28,141,169,180,103,8,69,124,667,10.51
4187,"Bonzi Wells\wellsbo01","1999-00",23,"POR","NBA",3.1,66,0,1162,236,480,216,427,20,53,88,129,78,104,182,97,69,12,97,153,580,8.18
4188,"Bonzi Wells\wellsbo01","2004-05",28,"MEM","NBA",3.1,69,19,1489,272,617,236,513,36,104,141,188,49,180,229,80,85,27,90,165,721,9.14
4189,"Chris Wilcox\wilcoch01","2012-13",30,"BOS","NBA",3.1,61,7,830,110,153,110,152,0,1,39,58,55,125,180,22,32,28,34,125,259,5.37
4190,"Eric Williams\willier01","2003-04",31,"TOT","NBA",3.1,71,36,1886,231,598,196,471,35,127,215,283,65,221,286,120,70,9,88,180,712,8.92
4191,"Lorenzo Williams\willilo01","1994-95",25,"DAL","NBA",3.1,82,81,2383,145,304,145,304,0,0,38,101,291,399,690,124,52,148,105,306,328,8.13
4192,"Monty Williams\willimo01","1999-00",28,"ORL","NBA",3.1,75,23,1501,263,538,261,533,2,5,123,166,96,154,250,106,46,17,109,187,651,7.93
4193,"Scott Williams\willisc01","1994-95",26,"PHI","NBA",3.1,77,43,1781,206,434,206,427,0,7,79,107,173,312,485,59,71,40,84,237,491,7.7
4194,"Shammond Williams\willish01","2002-03",27,"TOT","NBA",3.1,78,11,1881,228,579,135,318,93,261,78,102,24,147,171,266,77,6,114,140,627,8.19
4195,"Kevin Willis\willike02","2000-01",38,"TOT","NBA",3.1,78,22,1830,304,690,303,684,1,6,113,147,177,355,532,50,57,52,87,216,722,8.82
4196,"Lorenzen Wright\wrighlo02","1997-98",22,"LAC","NBA",3.1,69,38,2067,241,542,241,540,0,2,141,214,180,426,606,55,55,87,81,237,623,10.26
4197,"Thaddeus Young\youngth01","2014-15",26,"TOT","NBA",3.1,76,68,2434,451,968,413,853,38,115,131,200,127,284,411,173,124,25,117,171,1071,12.81
4198,"Victor Alexander\alexavi01","1992-93",23,"GSW","NBA",3,72,59,1753,344,667,334,645,10,22,111,162,132,288,420,93,34,53,120,218,809,10.6
4199,"OG Anunoby\anunoog01","2017-18",20,"TOR","NBA",3,74,62,1481,163,346,90,149,73,197,39,62,44,140,184,55,52,14,45,130,438,5.75
4200,"Matt Barnes\barnema02","2010-11",30,"LAL","NBA",3,53,0,1020,131,279,97,172,34,107,60,77,73,155,228,71,39,22,58,127,356,7.58
4201,"Matt Barnes\barnema02","2008-09",28,"PHO","NBA",3,77,40,2082,285,674,168,333,117,341,101,136,79,342,421,212,52,26,130,209,788,10.43
4202,"Aron Baynes\baynear01","2017-18",31,"BOS","NBA",3,81,67,1485,210,446,207,425,3,21,59,78,130,304,434,93,22,51,80,200,482,6.7
4203,"Aron Baynes\baynear01","2016-17",30,"DET","NBA",3,75,2,1163,143,279,143,279,0,0,79,94,111,222,333,32,17,39,50,166,365,5.61
4204,"Bradley Beal\bealbr01","2012-13",19,"WAS","NBA",3,56,46,1745,282,687,191,451,91,236,125,159,43,168,211,137,50,29,90,113,780,11.59
4205,"Marco Belinelli\belinma01","2012-13",26,"CHI","NBA",3,73,27,1882,241,610,162,389,79,221,141,168,13,127,140,148,44,6,82,140,702,7.79
4206,"Chauncey Billups\billuch01","1997-98",21,"TOT","NBA",3,80,70,2216,280,749,173,424,107,325,226,266,62,128,190,314,107,4,174,172,893,10.88
4207,"Andray Blatche\blatcan01","2007-08",21,"WAS","NBA",3,82,15,1675,254,536,251,523,3,13,107,154,164,261,425,92,53,114,112,258,618,8.45
4208,"Trevor Booker\booketr01","2011-12",24,"WAS","NBA",3,50,32,1261,181,341,180,339,1,2,56,93,119,206,325,40,48,43,58,138,419,9.48
4209,"Shawn Bradley\bradlsh01","1995-96",23,"TOT","NBA",3,79,68,2329,387,873,386,869,1,4,169,246,221,417,638,63,49,288,179,286,944,12.74
4210,"Shawn Bradley\bradlsh01","1996-97",24,"TOT","NBA",3,73,70,2288,406,905,406,897,0,8,149,228,221,390,611,52,40,248,134,237,961,13.05
4211,"J.R. Bremer\bremejr01","2002-03",22,"BOS","NBA",3,64,41,1503,171,464,70,178,101,286,85,111,18,127,145,164,38,3,59,80,528,7.41
4212,"Jaylen Brown\brownja02","2018-19",22,"BOS","NBA",3,74,25,1913,368,792,273,516,95,276,133,202,65,248,313,100,69,32,99,186,964,11.02
4213,"Chase Budinger\budinch01","2011-12",23,"HOU","NBA",3,58,9,1298,208,471,120,252,88,219,54,70,38,179,217,74,29,7,55,65,558,8.23
4214,"Matt Carroll\carroma01","2007-08",27,"CHA","NBA",3,80,18,2016,252,589,147,348,105,241,111,138,33,193,226,73,46,19,58,187,720,7.48
4215,"Jordan Clarkson\clarkjo01","2017-18",25,"TOT","NBA",3,81,2,1888,430,954,318,636,112,318,152,190,57,160,217,221,58,6,127,107,1124,11.32
4216,"Speedy Claxton\claxtsp01","2005-06",27,"NOK","NBA",3,71,3,2019,304,736,287,673,17,63,246,320,39,154,193,339,108,6,154,177,871,12.32
4217,"Jason Collins\collija04","2001-02",23,"NJN","NBA",3,77,9,1407,117,278,116,276,1,2,115,164,132,169,301,81,29,47,72,173,350,5.48
4218,"Torrey Craig\craigto01","2018-19",28,"DEN","NBA",3,75,37,1503,160,362,99,174,61,188,49,70,89,174,263,72,37,46,44,175,430,6.09
4219,"Terry Cummings\cummite01","1995-96",34,"MIL","NBA",3,81,13,1777,270,584,269,577,1,7,104,160,162,283,445,89,56,30,69,263,645,7.89
4220,"Dante Cunningham\cunnida01","2016-17",29,"NOP","NBA",3,66,35,1649,174,359,103,178,71,181,16,27,56,221,277,37,39,28,28,100,435,6.73
4221,"Eddy Curry\curryed01","2003-04",21,"CHI","NBA",3,73,63,2154,417,840,416,839,1,1,235,350,143,308,451,68,24,83,177,258,1070,12.51
4222,"Ricky Davis\davisri01","2002-03",23,"CLE","NBA",3,79,76,3131,602,1470,528,1266,74,204,348,465,97,293,390,436,125,36,277,180,1626,17.75
4223,"Luol Deng\denglu01","2008-09",23,"CHI","NBA",3,49,46,1665,265,591,257,571,8,20,152,191,80,215,295,94,60,25,72,85,690,12.82
4224,"Luol Deng\denglu01","2004-05",19,"CHI","NBA",3,61,45,1663,280,645,249,528,31,117,120,162,92,230,322,135,48,27,118,98,711,10.57
4225,"Boris Diaw\diawbo01","2007-08",25,"PHO","NBA",3,82,19,2308,308,646,295,605,13,41,96,129,97,281,378,317,61,39,155,166,725,10.3
4226,"DeSagana Diop\diopde01","2007-08",26,"TOT","NBA",3,79,23,1295,94,180,94,180,0,0,38,70,160,232,392,40,26,88,58,146,226,5.03
4227,"Michael Doleac\doleami01","1999-00",22,"ORL","NBA",3,81,29,1335,242,535,241,533,1,2,80,95,89,245,334,63,29,34,65,224,565,6.32
4228,"Howard Eisley\eisleho01","1999-00",27,"UTA","NBA",3,82,5,2096,282,675,222,512,60,163,84,102,23,147,170,347,59,9,132,223,708,8.75
4229,"Sean Elliott\elliose01","2000-01",32,"SAS","NBA",3,52,34,1229,147,339,92,210,55,129,60,84,17,153,170,81,23,25,51,80,409,7.43
4230,"Reggie Evans\evansre01","2002-03",22,"SEA","NBA",3,67,60,1365,66,140,66,140,0,0,80,154,167,278,445,34,38,11,52,173,212,5.35
4231,"Patrick Ewing\ewingpa01","1997-98",35,"NYK","NBA",3,26,26,848,203,403,203,401,0,2,134,186,59,206,265,28,16,58,77,74,540,19.25
4232,"Derrick Favors\favorde01","2011-12",20,"UTA","NBA",3,65,9,1376,222,445,222,445,0,0,126,194,158,267,425,43,38,65,103,145,570,9.29
4233,"Rudy Fernández\fernaru01","2009-10",24,"POR","NBA",3,62,2,1441,160,423,62,157,98,266,85,98,35,129,164,127,62,11,72,87,503,7.9
4234,"Yogi Ferrell\ferreyo01","2017-18",24,"DAL","NBA",3,82,21,2282,311,730,177,371,134,359,82,103,26,223,249,201,64,9,78,153,838,9.19
4235,"Jeff Foster\fosteje01","2010-11",34,"IND","NBA",3,56,3,940,80,167,80,164,0,3,27,48,160,190,350,46,24,31,26,127,187,5.56
4236,"Channing Frye\fryech01","2015-16",32,"TOT","NBA",3,70,32,1200,152,347,61,112,91,235,30,35,35,199,234,71,29,28,43,127,425,6.18
4237,"Jorge Garbajosa\garbajo01","2006-07",29,"TOR","NBA",3,67,60,1909,222,529,156,336,66,193,57,78,48,282,330,125,78,15,64,90,567,8.73
4238,"Francisco García\garcifr01","2010-11",29,"SAC","NBA",3,58,34,1386,207,475,126,251,81,224,65,76,24,109,133,71,51,49,45,126,560,8.52
4239,"Pau Gasol\gasolpa01","2013-14",33,"LAL","NBA",3,60,60,1884,425,885,421,871,4,14,187,254,124,456,580,201,27,92,141,124,1041,17.15
4240,"Manu Ginóbili\ginobma01","2016-17",39,"SAS","NBA",3,69,0,1291,171,439,82,212,89,227,86,107,28,129,157,183,82,16,96,119,517,8.03
4241,"Anthony Goldwire\goldwan01","1997-98",26,"DEN","NBA",3,82,32,2212,269,636,206,472,63,164,150,186,40,107,147,277,86,7,85,149,751,9.06
4242,"Joey Graham\grahajo01","2006-07",24,"TOR","NBA",3,79,21,1319,192,388,183,357,9,31,110,131,55,193,248,44,30,4,49,161,503,5.86
4243,"Tyler Hansbrough\hansbty01","2013-14",28,"TOR","NBA",3,64,4,978,93,196,93,194,0,2,126,185,120,167,287,17,28,19,47,132,312,5.57
4244,"Othella Harrington\harriot01","1999-00",26,"VAN","NBA",3,82,82,2677,420,830,420,828,0,2,236,298,196,367,563,97,36,58,217,287,1076,12.29
4245,"Othella Harrington\harriot01","2001-02",28,"NYK","NBA",3,77,4,1563,237,450,237,448,0,2,122,172,125,224,349,37,30,36,95,250,596,7.49
4246,"Juan Hernangómez\hernaju01","2018-19",23,"DEN","NBA",3,70,25,1358,138,314,72,133,66,181,66,86,64,201,265,55,27,24,37,94,408,6.05
4247,"Nenê Hilário\hilarne01","2014-15",32,"WAS","NBA",3,67,58,1693,307,601,306,596,1,5,122,202,84,261,345,123,66,22,124,180,737,10.64
4248,"Kirk Hinrich\hinriki01","2010-11",30,"TOT","NBA",3,72,51,2157,278,623,203,435,75,188,106,126,21,161,182,288,75,17,121,185,737,10.63
4249,"Ersan İlyasova\ilyaser01","2018-19",31,"MIL","NBA",3,67,7,1231,167,381,109,221,58,160,61,74,94,208,302,52,32,20,48,172,453,6.73
4250,"Bobby Jackson\jacksbo01","2007-08",34,"TOT","NBA",3,72,5,1389,204,506,123,280,81,226,64,81,33,148,181,139,45,5,59,96,553,6.83
4251,"Amir Johnson\johnsam01","2007-08",20,"DET","NBA",3,62,0,764,92,165,92,165,0,0,37,55,87,148,235,29,24,82,39,141,221,5.34
4252,"Avery Johnson\johnsav01","2001-02",36,"TOT","NBA",3,68,13,1352,207,432,207,427,0,5,121,163,14,55,69,286,40,9,76,86,535,8.42
4253,"Ervin Johnson\johnser02","1998-99",31,"MIL","NBA",3,50,7,1027,96,189,96,189,0,0,64,105,120,200,320,19,29,57,47,151,256,7.12
4254,"James Johnson\johnsja01","2013-14",26,"MEM","NBA",3,52,4,956,143,308,121,221,22,87,76,90,60,106,166,111,42,57,66,102,384,8.58
4255,"Joe Johnson\johnsjo02","2001-02",20,"TOT","NBA",3,77,60,1916,251,584,213,454,38,130,41,53,75,182,257,179,59,20,71,114,581,7.39
4256,"Damon Jones\jonesda01","2007-08",31,"CLE","NBA",3,67,3,1336,151,363,36,87,115,276,20,28,5,67,72,126,19,1,36,66,437,5.62
4257,"Jumaine Jones\jonesju01","2005-06",26,"CHA","NBA",3,76,42,2089,298,736,183,401,115,335,88,121,105,271,376,63,68,22,74,200,799,8.79
4258,"Terrence Jones\joneste01","2014-15",23,"HOU","NBA",3,33,24,889,158,299,145,262,13,37,57,94,78,142,220,36,18,59,37,78,386,12.05
4259,"Tyus Jones\jonesty01","2018-19",22,"MIN","NBA",3,68,23,1560,185,446,145,320,40,126,58,69,23,111,134,327,81,5,47,78,468,8.71
4260,"Jason Kidd\kiddja01","2011-12",38,"DAL","NBA",3,48,48,1379,99,273,20,50,79,223,22,28,15,183,198,264,82,10,91,83,299,10.38
4261,"Travis Knight\knightr01","1997-98",23,"BOS","NBA",3,74,21,1503,193,438,178,383,15,55,81,103,146,219,365,104,54,82,87,253,482,7.76
4262,"Zach LaVine\lavinza01","2016-17",21,"MIN","NBA",3,47,47,1749,326,710,206,400,120,310,117,140,19,141,160,139,41,10,85,104,889,15.37
4263,"David Lee\leeda02","2015-16",32,"TOT","NBA",3,55,5,903,178,335,178,334,0,1,71,93,101,204,305,84,22,28,66,114,427,8.68
4264,"Alex Len\lenal01","2016-17",23,"PHO","NBA",3,77,34,1560,230,463,227,451,3,12,150,208,156,354,510,44,38,98,102,242,613,9.08
4265,"Voshon Lenard\lenarvo01","1999-00",26,"MIA","NBA",3,53,13,1434,228,560,139,332,89,228,84,106,37,116,153,136,41,15,80,127,629,9.95
4266,"Meyers Leonard\leoname01","2018-19",26,"POR","NBA",3,61,2,878,132,242,82,131,50,111,43,51,49,184,233,75,13,9,43,105,357,6.59
4267,"Rashard Lewis\lewisra02","2010-11",31,"TOT","NBA",3,57,52,1824,252,582,165,338,87,244,77,96,71,219,290,92,52,30,87,159,668,10.65
4268,"Corey Maggette\maggeco01","2005-06",26,"LAC","NBA",3,32,13,943,167,375,143,304,24,71,212,256,28,141,169,66,19,4,78,95,570,15.38
4269,"Šarūnas Marčiulionis\marcisa01","1992-93",28,"GSW","NBA",3,30,8,836,178,328,175,313,3,15,162,213,40,57,97,105,51,2,76,92,521,16.9
4270,"Boban Marjanović\marjabo01","2018-19",30,"TOT","NBA",3,58,12,681,160,260,156,250,4,10,98,131,87,178,265,54,16,27,59,90,422,8.09
4271,"Donyell Marshall\marshdo01","1998-99",25,"GSW","NBA",3,48,20,1250,208,494,182,422,26,72,88,121,115,227,342,66,47,37,80,123,530,10.63
4272,"Antonio McDyess\mcdyean01","2010-11",36,"SAS","NBA",3,73,16,1387,169,344,169,343,0,1,52,77,122,273,395,84,36,39,72,163,390,6.67
4273,"Jim McIlvaine\mcilvji01","1996-97",24,"SEA","NBA",3,82,79,1477,130,276,129,269,1,7,53,107,132,198,330,23,39,164,62,247,314,5.53
4274,"Stanislav Medvedenko\medvest01","2003-04",24,"LAL","NBA",3,68,38,1442,237,537,237,534,0,3,89,116,148,195,343,57,38,18,59,191,563,7.34
4275,"Jodie Meeks\meeksjo01","2012-13",25,"LAL","NBA",3,78,10,1663,205,530,83,188,122,342,86,96,37,134,171,69,58,5,52,103,618,6.45
4276,"Salah Mejri\mejrisa01","2016-17",30,"DAL","NBA",3,73,11,905,88,137,87,134,1,3,36,61,97,211,308,14,32,61,40,152,213,4.79
4277,"Darius Miles\milesda01","2000-01",19,"LAC","NBA",3,81,21,2133,318,630,317,611,1,19,124,238,127,350,477,99,51,125,147,191,761,9.88
4278,"Brad Miller\millebr01","2010-11",34,"HOU","NBA",3,60,5,1015,132,296,92,189,40,107,78,94,44,178,222,145,28,21,54,98,382,7.57
4279,"Darius Miller\milleda01","2017-18",27,"NOP","NBA",3,82,3,1944,216,487,69,129,147,358,58,67,18,146,164,111,28,17,58,160,637,6.85
4280,"Chris Mills\millsch01","1998-99",29,"GSW","NBA",3,47,24,1395,186,453,154,338,32,115,79,96,49,188,237,103,39,14,58,125,483,9.56
4281,"Greg Minor\minorgr01","1995-96",24,"BOS","NBA",3,78,47,1761,320,640,313,613,7,27,99,130,93,164,257,146,36,11,78,161,746,8.49
4282,"Sam Mitchell\mitchsa01","1998-99",35,"MIN","NBA",3,50,20,1344,213,522,204,484,9,38,126,165,55,127,182,98,35,16,34,111,561,9.06
4283,"Anthony Morrow\morroan01","2010-11",25,"NJN","NBA",3,58,47,1856,279,620,169,360,110,260,96,107,37,135,172,68,19,7,54,135,764,9.96
4284,"Anthony Morrow\morroan01","2008-09",23,"GSW","NBA",3,67,17,1515,255,534,169,350,86,184,80,92,78,121,199,80,36,12,52,130,676,8.65
4285,"Pete Myers\myerspe01","1993-94",30,"CHI","NBA",3,82,81,2030,253,556,245,527,8,29,136,194,54,127,181,245,78,20,136,195,650,8.23
4286,"Steve Nash\nashst01","1999-00",25,"DAL","NBA",3,56,27,1532,173,363,113,214,60,149,75,85,34,87,121,272,37,3,102,122,481,10.18
4287,"Rasho Nesterović\nestera01","1999-00",23,"MIN","NBA",3,82,55,1723,206,433,206,431,0,2,59,103,135,244,379,93,21,85,71,262,471,6.46
4288,"Nerlens Noel\noelne01","2015-16",21,"PHI","NBA",3,67,62,1965,306,587,305,585,1,2,134,227,154,388,542,122,118,100,158,192,747,13.6
4289,"Tony Parker\parketo01","2016-17",34,"SAS","NBA",3,63,63,1587,265,569,242,500,23,69,85,117,9,104,113,285,34,2,89,92,638,9.73
4290,"Ruben Patterson\patteru01","2003-04",28,"POR","NBA",3,73,1,1651,200,395,198,383,2,12,105,190,129,139,268,139,84,21,105,152,507,7.94
4291,"Bobby Phills\phillbo01","1998-99",29,"CHH","NBA",3,43,43,1574,215,497,147,325,68,172,115,168,39,135,174,149,60,25,92,124,613,13.52
4292,"Mickaël Piétrus\pietrmi01","2008-09",26,"ORL","NBA",3,54,25,1329,176,426,96,203,80,223,78,110,44,132,176,65,31,24,56,126,510,8.02
4293,"Zach Randolph\randoza01","2008-09",27,"TOT","NBA",3,50,45,1757,415,873,383,776,32,97,179,244,157,347,504,103,43,16,114,133,1041,17.96
4294,"Zach Randolph\randoza01","2007-08",26,"NYK","NBA",3,69,68,2244,486,1058,464,978,22,80,223,289,184,526,710,140,59,16,186,194,1217,15.89
4295,"J.J. Redick\redicjj01","2013-14",29,"LAC","NBA",3,35,34,987,181,398,108,213,73,185,97,106,9,65,74,78,28,3,42,65,532,12.47
4296,"J.R. Reid\reidjr01","1993-94",25,"SAS","NBA",3,70,11,1344,260,530,260,527,0,3,107,153,91,129,220,73,43,25,84,165,627,7.73
4297,"Jason Richardson\richaja01","2006-07",26,"GSW","NBA",3,51,49,1675,306,734,196,433,110,301,92,140,71,188,259,172,54,32,82,129,814,13.8
4298,"Quentin Richardson\richaqu01","2000-01",20,"LAC","NBA",3,76,28,1358,232,525,182,374,50,151,99,158,105,152,257,62,42,7,64,98,613,6.68
4299,"Eddie Robinson\robined01","1999-00",23,"CHH","NBA",3,67,8,1112,212,386,212,382,0,4,47,64,54,130,184,32,48,25,39,67,471,6.57
4300,"Sean Rooks\rooksse01","1994-95",25,"MIN","NBA",3,80,70,2405,289,615,289,610,0,5,290,381,165,321,486,97,29,71,142,208,868,10.72
4301,"Derrick Rose\rosede01","2018-19",30,"MIN","NBA",3,51,13,1392,363,753,309,607,54,146,137,160,33,107,140,220,31,12,82,57,917,15.2
4302,"Derrick Rose\rosede01","2016-17",28,"NYK","NBA",3,64,64,2082,460,977,447,917,13,60,221,253,66,180,246,283,44,17,147,84,1154,15.53
4303,"Ricky Rubio\rubiori01","2012-13",22,"MIN","NBA",3,57,47,1691,185,514,158,422,27,92,211,264,44,185,229,418,137,5,172,143,608,14.49
4304,"Thabo Sefolosha\sefolth01","2013-14",29,"OKC","NBA",3,61,61,1584,141,340,93,188,48,152,53,69,50,170,220,94,79,17,55,90,383,7.21
4305,"James Singleton\singlja01","2008-09",27,"DAL","NBA",3,62,6,884,117,221,104,181,13,40,67,78,89,161,250,17,26,28,36,110,314,5.79
4306,"Craig Smith\smithcr01","2009-10",26,"LAC","NBA",3,75,2,1232,226,397,225,392,1,5,132,208,97,190,287,84,33,25,88,194,585,7.88
4307,"Joe Smith\smithjo02","2002-03",27,"MIN","NBA",3,54,21,1117,151,328,151,326,0,2,102,131,111,159,270,38,14,55,43,171,404,7.6
4308,"Latrell Sprewell\sprewla01","1998-99",28,"NYK","NBA",3,37,4,1233,215,518,194,441,21,77,155,191,41,115,156,91,46,2,79,65,606,13.2
4309,"John Starks\starkjo01","1998-99",33,"GSW","NBA",3,50,50,1686,269,728,191,459,78,269,74,100,33,130,163,235,69,5,83,135,690,11.6
4310,"Michael Stewart\stewami01","1997-98",22,"SAC","NBA",3,81,37,1761,155,323,155,323,0,0,65,142,197,339,536,61,29,195,85,251,375,7.44
4311,"Bryant Stith\stithbr01","1996-97",26,"DEN","NBA",3,52,52,1788,251,603,181,421,70,182,202,234,74,143,217,133,60,20,101,119,774,13.33
4312,"Gary Trent\trentga01","2001-02",27,"MIN","NBA",3,64,10,1140,193,381,193,379,0,2,92,144,104,166,270,60,21,27,58,160,478,7.15
4313,"Anderson Varejão\varejan01","2004-05",22,"CLE","NBA",3,54,0,863,99,193,99,191,0,2,68,127,109,148,257,27,41,38,26,122,266,6.23
4314,"Jacque Vaughn\vaughja01","2000-01",25,"UTA","NBA",3,82,0,1620,170,393,140,315,30,78,128,164,18,132,150,323,48,3,129,145,498,7.47
4315,"Spud Webb\webbsp01","1995-96",32,"TOT","NBA",3,77,21,1462,186,430,139,301,47,129,125,145,26,74,100,294,52,7,110,109,544,7.95
4316,"Bonzi Wells\wellsbo01","2007-08",31,"TOT","NBA",3,73,7,1562,252,569,240,519,12,50,146,227,84,247,331,97,75,32,103,157,662,8.63
4317,"Derrick Williams\willide02","2012-13",21,"MIN","NBA",3,78,56,1916,338,786,273,590,65,196,192,272,96,334,430,46,44,37,101,127,933,9.74
4318,"Walt Williams\williwa02","2000-01",30,"HOU","NBA",3,72,31,1583,202,513,104,265,98,248,97,126,31,214,245,97,30,28,73,153,599,7.29
4319,"James Worthy\worthja01","1992-93",31,"LAL","NBA",3,82,69,2359,510,1142,480,1031,30,111,171,211,73,174,247,278,92,27,137,87,1221,12.36
4320,"Shareef Abdur-Rahim\abdursh01","1996-97",20,"VAN","NBA",2.9,80,71,2802,550,1214,543,1187,7,27,387,519,216,339,555,175,79,79,225,199,1494,16.13
4321,"Steven Adams\adamsst01","2013-14",20,"OKC","NBA",2.9,81,20,1197,93,185,93,185,0,0,79,136,142,190,332,43,40,57,71,203,265,4.85
4322,"Lou Amundson\amundlo01","2009-10",27,"PHO","NBA",2.9,79,0,1168,152,276,152,275,0,1,67,123,128,218,346,31,24,73,57,169,371,5.71
4323,"Derek Anderson\anderde01","2006-07",32,"CHA","NBA",2.9,50,32,1190,126,294,72,142,54,152,93,106,29,84,113,133,52,7,56,115,399,8.67
4324,"Carmelo Anthony\anthoca01","2014-15",30,"NYK","NBA",2.9,40,40,1428,358,806,297,627,61,179,189,237,72,192,264,122,40,17,89,87,966,19.22
4325,"Greg Anthony\anthogr01","1994-95",27,"NYK","NBA",2.9,61,2,943,128,293,72,138,56,155,60,76,7,57,64,160,50,7,57,99,372,6.63
4326,"Marco Belinelli\belinma01","2011-12",25,"NOH","NBA",2.9,66,55,1966,286,686,179,402,107,284,101,129,19,153,172,101,48,5,69,115,780,9
4327,"Marco Belinelli\belinma01","2014-15",28,"SAS","NBA",2.9,62,9,1388,199,470,113,240,86,230,84,99,26,131,157,94,31,3,61,85,568,7.65
4328,"Jordan Bell\belljo01","2017-18",23,"GSW","NBA",2.9,57,13,809,116,185,116,181,0,4,30,44,60,147,207,102,35,56,51,92,262,7.05
4329,"Andris Biedriņš\biedran01","2005-06",19,"GSW","NBA",2.9,68,2,1000,118,185,118,185,0,0,22,72,124,159,283,24,23,47,34,190,258,5.02
4330,"Bismack Biyombo\biyombi01","2017-18",25,"ORL","NBA",2.9,82,25,1495,183,352,183,351,0,1,102,157,144,324,468,66,21,95,84,158,468,7.24
4331,"Bismack Biyombo\biyombi01","2016-17",24,"ORL","NBA",2.9,81,27,1793,179,339,179,339,0,0,125,234,157,410,567,74,25,91,95,202,483,7.91
4332,"Rolando Blackman\blackro01","1992-93",33,"NYK","NBA",2.9,60,33,1434,239,539,208,466,31,73,71,90,23,79,102,157,22,10,65,129,580,7.84
4333,"Bogdan Bogdanović\bogdabo01","2017-18",25,"SAC","NBA",2.9,78,53,2175,344,772,215,443,129,329,100,119,31,192,223,258,72,16,125,172,917,11.02
4334,"Bojan Bogdanović\bogdabo02","2016-17",27,"TOT","NBA",2.9,81,54,2083,376,845,232,453,144,392,217,243,37,240,277,111,34,7,131,146,1113,10.97
4335,"Trevor Booker\booketr01","2017-18",30,"TOT","NBA",2.9,68,7,1158,177,343,169,310,8,33,66,93,117,201,318,82,28,21,59,119,428,6.99
4336,"Earl Boykins\boykiea01","2005-06",29,"DEN","NBA",2.9,60,0,1542,271,661,209,482,62,179,152,174,21,60,81,230,48,4,83,73,756,10.62
4337,"Shawn Bradley\bradlsh01","1997-98",25,"DAL","NBA",2.9,64,46,1822,300,711,299,708,1,3,130,180,164,354,518,60,51,214,96,214,731,12.24
4338,"Terrell Brandon\brandte01","1993-94",23,"CLE","NBA",2.9,73,10,1548,230,548,223,516,7,32,139,162,38,121,159,277,84,16,111,108,606,9.01
4339,"Mikal Bridges\bridgmi01","2018-19",22,"PHO","NBA",2.9,82,56,2417,242,563,137,250,105,313,95,118,56,208,264,173,129,38,70,201,684,9.27
4340,"Miles Bridges\bridgmi02","2018-19",20,"CHO","NBA",2.9,80,25,1696,237,511,172,311,65,200,58,77,67,256,323,95,55,49,50,111,597,7.64
4341,"Jud Buechler\buechju01","1998-99",30,"DET","NBA",2.9,50,0,1056,100,240,39,92,61,148,13,18,29,104,133,57,37,13,21,83,274,5.66
4342,"Vince Carter\cartevi01","2011-12",35,"DAL","NBA",2.9,61,40,1542,223,542,149,337,74,205,95,115,32,173,205,139,56,25,84,134,615,9.34
4343,"Willie Cauley-Stein\caulewi01","2016-17",23,"SAC","NBA",2.9,75,21,1421,255,481,255,479,0,2,101,151,85,254,339,80,53,44,69,147,611,8.42
4344,"Duane Causwell\causwdu01","1992-93",24,"SAC","NBA",2.9,55,45,1211,175,321,175,320,0,1,103,165,112,191,303,35,32,87,58,192,453,9.31
4345,"Mario Chalmers\chalmma01","2010-11",24,"MIA","NBA",2.9,70,28,1579,155,388,72,157,83,231,54,62,12,134,146,177,76,7,91,158,447,7.11
4346,"Tyson Chandler\chandty01","2009-10",27,"CHA","NBA",2.9,51,27,1163,109,190,109,190,0,0,115,157,114,206,320,16,17,55,91,138,333,8.26
4347,"Chris Childs\childch01","1998-99",31,"NYK","NBA",2.9,48,0,1297,114,267,78,173,36,94,64,78,18,115,133,193,44,1,85,156,328,8.63
4348,"Zach Collins\colliza01","2018-19",21,"POR","NBA",2.9,77,0,1356,189,400,149,279,40,121,94,126,109,215,324,71,25,66,77,174,512,7.08
4349,"Darren Collison\collida01","2009-10",22,"NOH","NBA",2.9,76,37,2109,376,789,330,674,46,115,148,174,41,151,192,432,78,4,202,92,946,13.08
4350,"Dante Cunningham\cunnida01","2013-14",26,"MIN","NBA",2.9,81,7,1635,236,509,236,504,0,5,38,67,112,218,330,83,62,58,42,146,510,6.53
4351,"Michael Curry\currymi01","1997-98",29,"MIL","NBA",2.9,82,27,1978,196,418,192,409,4,9,147,176,26,72,98,137,56,14,77,218,543,6.32
4352,"Samuel Dalembert\dalemsa01","2010-11",29,"SAC","NBA",2.9,80,46,1938,268,567,268,565,0,2,108,148,212,445,657,67,36,116,132,225,644,9.57
4353,"Andrew DeClercq\declean01","1999-00",26,"CLE","NBA",2.9,82,31,1831,225,443,225,443,0,0,94,160,156,283,439,58,63,66,108,275,544,7.6
4354,"Carlos Delfino\delfica01","2006-07",24,"DET","NBA",2.9,82,1,1372,156,376,110,238,46,138,70,89,67,199,266,88,46,8,61,97,428,5.36
4355,"Gorgui Dieng\dienggo01","2017-18",28,"MIN","NBA",2.9,79,0,1333,186,388,167,327,19,61,79,102,106,254,360,71,45,39,59,147,470,6.7
4356,"Keyon Dooling\doolike01","2010-11",30,"MIL","NBA",2.9,80,22,1757,206,519,125,285,81,234,78,94,12,105,117,243,54,4,91,119,571,6.97
4357,"Jared Dudley\dudleja01","2007-08",22,"CHA","NBA",2.9,73,14,1384,163,348,154,307,9,41,87,118,121,165,286,81,55,10,50,128,422,6.36
4358,"Blue Edwards\edwarbl01","1993-94",28,"MIL","NBA",2.9,82,64,2322,382,800,344,694,38,106,151,189,104,225,329,171,83,27,146,235,953,10.78
4359,"Howard Eisley\eisleho01","1997-98",25,"UTA","NBA",2.9,82,18,1726,229,519,181,401,48,118,127,149,25,141,166,346,54,13,160,182,633,8.83
4360,"Francisco Elson\elsonfr01","2005-06",29,"DEN","NBA",2.9,72,54,1579,151,284,150,279,1,5,49,74,99,240,339,47,54,45,65,211,352,6.36
4361,"Kenneth Faried\farieke01","2018-19",29,"TOT","NBA",2.9,37,13,728,156,265,148,240,8,25,64,99,97,153,250,20,17,23,33,82,384,10.65
4362,"Tony Farmer\farmeto01","1999-00",30,"GSW","NBA",2.9,74,9,1199,127,312,119,268,8,44,203,265,118,177,295,74,66,16,82,167,465,7.02
4363,"Derrick Favors\favorde01","2010-11",19,"TOT","NBA",2.9,78,27,1535,215,416,215,416,0,0,103,173,171,241,412,39,29,68,77,246,533,7.29
4364,"Vern Fleming\flemive01","1992-93",30,"IND","NBA",2.9,75,8,1503,280,554,273,518,7,36,143,197,63,106,169,224,63,9,121,126,710,9.42
4365,"Steve Francis\francst01","2006-07",29,"NYK","NBA",2.9,44,30,1237,140,343,98,232,42,111,175,211,33,124,157,170,41,12,100,126,497,12.04
4366,"Dean Garrett\garrede01","1998-99",32,"MIN","NBA",2.9,49,37,1054,116,231,116,231,0,0,38,51,99,158,257,28,30,45,29,113,270,6.8
4367,"Kendall Gill\gillke01","1992-93",24,"CHH","NBA",2.9,69,67,2430,463,1032,446,970,17,62,224,290,120,220,340,268,98,36,174,191,1167,15.22
4368,"Aaron Gordon\gordoaa01","2017-18",22,"ORL","NBA",2.9,58,57,1909,375,865,260,523,115,342,157,225,87,370,457,136,59,45,107,111,1022,15.65
4369,"Eric Gordon\gordoer01","2014-15",26,"NOP","NBA",2.9,61,60,2018,285,694,144,379,141,315,107,133,28,131,159,229,50,14,122,145,818,11.8
4370,"Jerami Grant\grantje01","2016-17",22,"TOT","NBA",2.9,80,4,1531,152,328,109,212,43,116,90,147,38,167,205,46,33,79,44,149,437,5.6
4371,"Danny Green\greenda02","2017-18",30,"SAS","NBA",2.9,70,60,1791,217,561,101,241,116,320,50,65,41,208,249,110,63,80,74,122,600,8.34
4372,"JaMychal Green\greenja01","2018-19",28,"TOT","NBA",2.9,65,6,1371,230,476,159,300,71,176,80,101,104,305,409,50,45,34,87,193,611,9.67
4373,"Adrian Griffin\griffad01","2002-03",28,"DAL","NBA",2.9,74,48,1373,146,337,140,313,6,24,27,32,88,176,264,105,77,6,47,157,325,5.48
4374,"Adrian Griffin\griffad01","2005-06",31,"DAL","NBA",2.9,52,45,1245,98,204,98,202,0,2,41,53,75,152,227,89,51,9,39,113,237,6.52
4375,"Anfernee Hardaway\hardaan01","2001-02",30,"PHO","NBA",2.9,80,55,2462,389,931,366,848,23,83,158,195,98,252,350,324,122,32,189,184,959,11.99
4376,"Maurice Harkless\harklma01","2015-16",22,"POR","NBA",2.9,78,14,1457,195,411,156,271,39,140,69,111,101,179,280,67,49,35,62,124,498,6.46
4377,"Ron Harper\harpero01","1993-94",30,"LAC","NBA",2.9,75,75,2856,569,1335,498,1099,71,236,299,418,129,331,460,344,144,54,242,167,1508,18.13
4378,"Spencer Hawes\hawessp01","2011-12",23,"PHI","NBA",2.9,37,29,920,156,319,153,307,3,12,40,55,78,192,270,98,16,48,55,100,355,11.2
4379,"Jarvis Hayes\hayesja01","2007-08",26,"DET","NBA",2.9,82,1,1287,217,504,144,310,73,194,45,60,35,143,178,62,47,6,47,137,552,5.44
4380,"Brendan Haywood\haywobr01","2010-11",31,"DAL","NBA",2.9,72,8,1331,128,223,128,222,0,1,64,177,129,247,376,19,16,74,51,146,320,5.57
4381,"Robert Horry\horryro01","2006-07",36,"SAS","NBA",2.9,68,8,1124,90,251,40,102,50,149,38,64,73,156,229,77,45,41,44,105,268,4.96
4382,"Robert Horry\horryro01","1996-97",26,"TOT","NBA",2.9,54,29,1395,157,360,108,206,49,154,60,90,68,169,237,110,66,55,72,153,423,9.22
4383,"Allan Houston\houstal01","1998-99",27,"NYK","NBA",2.9,50,50,1815,294,703,237,563,57,140,168,195,20,132,152,137,35,9,130,115,813,12.51
4384,"Zydrunas Ilgauskas\ilgauzy01","2010-11",35,"MIA","NBA",2.9,72,51,1145,162,319,162,318,0,1,36,46,108,179,287,26,23,58,52,185,360,5.47
4385,"Allen Iverson\iversal01","2008-09",33,"TOT","NBA",2.9,57,53,2093,348,834,320,735,28,99,271,347,30,143,173,283,88,6,146,86,995,15.43
4386,"Justin Jackson\jacksju01","2018-19",23,"TOT","NBA",2.9,81,14,1614,217,485,130,240,87,245,62,79,44,168,212,96,32,14,29,99,583,6.39
4387,"Keith Jennings\jennike01","1993-94",25,"GSW","NBA",2.9,76,2,1097,138,342,82,191,56,151,100,120,16,73,89,218,65,0,74,62,432,6.49
4388,"Derrick Jones\jonesde02","2018-19",21,"MIA","NBA",2.9,60,14,1153,160,324,132,233,28,91,74,122,96,144,240,37,46,42,43,123,422,7.29
4389,"Jumaine Jones\jonesju01","2002-03",23,"CLE","NBA",2.9,80,12,2204,308,710,197,396,111,314,57,83,106,299,405,112,67,22,107,176,784,9.03
4390,"Cory Joseph\josepco01","2013-14",22,"SAS","NBA",2.9,68,19,936,126,265,114,227,12,38,79,96,32,75,107,114,35,14,43,84,343,5.42
4391,"Chris Kaman\kamanch01","2006-07",24,"LAC","NBA",2.9,75,66,2176,294,652,294,651,0,1,166,224,160,428,588,79,41,116,147,251,754,10.73
4392,"Carl Landry\landrca01","2011-12",28,"NOH","NBA",2.9,41,8,999,182,362,182,359,0,3,147,184,78,136,214,38,13,12,64,89,511,10.96
4393,"Andrew Lang\langan01","1993-94",27,"ATL","NBA",2.9,82,0,1608,215,458,214,454,1,4,73,106,126,187,313,51,38,87,81,192,504,6.29
4394,"Fat Lever\leverfa01","1993-94",33,"DAL","NBA",2.9,81,54,1947,227,557,201,483,26,74,75,98,83,200,283,213,159,15,88,155,555,8.38
4395,"Walter McCarty\mccarwa01","2003-04",29,"BOS","NBA",2.9,77,23,1900,203,523,66,157,137,366,62,82,28,211,239,124,72,22,91,179,605,7.56
4396,"Walter McCarty\mccarwa01","1997-98",23,"BOS","NBA",2.9,82,64,2340,295,730,241,555,54,175,144,194,141,223,364,177,110,44,141,274,788,9.58
4397,"T.J. McConnell\mccontj01","2018-19",26,"PHI","NBA",2.9,76,3,1470,220,419,206,377,14,42,29,37,28,146,174,258,79,17,91,105,483,8.1
4398,"Doug McDermott\mcderdo01","2018-19",27,"IND","NBA",2.9,77,1,1340,207,422,123,216,84,206,66,79,17,92,109,67,18,8,42,104,564,5.98
4399,"Rodney McGruder\mcgruro01","2016-17",25,"MIA","NBA",2.9,78,65,1966,190,460,117,240,73,220,44,71,94,162,256,124,46,18,56,140,497,6.26
4400,"Chris Mihm\mihmch01","2003-04",24,"TOT","NBA",2.9,76,17,1330,186,381,186,381,0,0,110,166,156,257,413,21,37,63,90,208,482,6.95
4401,"C.J. Miles\milescj01","2017-18",30,"TOR","NBA",2.9,70,3,1337,227,599,63,145,164,454,81,97,18,134,152,55,37,21,39,134,699,7.36
4402,"C.J. Miles\milescj01","2008-09",21,"UTA","NBA",2.9,72,72,1623,258,562,195,383,63,179,78,89,45,122,167,107,46,15,64,187,657,7.79
4403,"Andre Miller\millean02","2011-12",35,"DEN","NBA",2.9,66,7,1809,242,552,224,469,18,83,137,169,53,168,221,441,63,9,177,133,639,12.17
4404,"Jamario Moon\moonja01","2009-10",29,"CLE","NBA",2.9,61,2,1052,114,247,82,147,32,100,36,45,26,165,191,49,34,30,23,69,296,5.42
4405,"Tyrone Nesby\nesbyty01","2001-02",26,"WAS","NBA",2.9,70,9,1498,183,421,170,374,13,47,64,93,105,213,318,91,61,22,49,164,443,6.82
4406,"Kelly Olynyk\olynyke01","2013-14",22,"BOS","NBA",2.9,70,9,1400,234,502,194,388,40,114,99,122,140,225,365,109,35,27,106,227,607,8.8
4407,"Zaza Pachulia\pachuza01","2004-05",20,"MIL","NBA",2.9,74,4,1397,160,354,160,353,0,1,138,185,131,247,378,60,44,34,70,166,458,6.98
4408,"Morris Peterson\petermo01","2006-07",29,"TOR","NBA",2.9,71,12,1515,222,517,116,222,106,295,84,123,32,205,237,47,45,12,53,126,634,7.41
4409,"Quincy Pondexter\pondequ01","2014-15",26,"TOT","NBA",2.9,75,30,1793,188,447,97,203,91,244,71,96,53,142,195,94,19,24,51,150,538,6.27
4410,"Eldridge Recasner\recasel01","1997-98",30,"ATL","NBA",2.9,59,14,1454,206,452,144,304,62,148,74,79,32,110,142,117,41,1,91,94,548,8.35
4411,"Bryant Reeves\reevebr01","2000-01",27,"VAN","NBA",2.9,75,48,1832,254,552,253,548,1,4,113,142,132,320,452,80,43,54,90,243,622,8.58
4412,"Don Reid\reiddo01","1995-96",22,"DET","NBA",2.9,69,46,997,106,187,106,187,0,0,51,77,78,125,203,11,47,40,41,199,263,4.75
4413,"Jason Richardson\richaja01","2001-02",21,"GSW","NBA",2.9,80,75,2629,464,1090,382,844,82,246,141,210,124,216,340,236,106,31,160,195,1151,12.19
4414,"Glenn Robinson\robingl01","2002-03",30,"ATL","NBA",2.9,69,68,2591,539,1248,449,985,90,263,268,306,86,371,457,205,91,26,248,183,1436,17.37
4415,"Rodney Rogers\rogerro01","1996-97",25,"LAC","NBA",2.9,81,62,2480,408,884,343,704,65,180,191,288,137,274,411,222,88,61,221,272,1072,12.69
4416,"Jalen Rose\roseja01","1995-96",23,"DEN","NBA",2.9,80,37,2134,290,604,258,496,32,108,191,277,46,214,260,495,53,39,234,229,803,12.41
4417,"Dennis Schröder\schrode01","2018-19",25,"OKC","NBA",2.9,79,14,2314,457,1104,333,740,124,364,186,227,38,246,284,323,65,12,172,189,1224,13.05
4418,"Ramon Sessions\sessira01","2012-13",26,"CHA","NBA",2.9,61,0,1652,276,676,243,569,33,107,291,347,27,142,169,230,48,7,104,91,876,12.66
4419,"Dickey Simpkins\simpkdi01","1998-99",26,"CHI","NBA",2.9,50,35,1448,150,324,150,323,0,1,156,242,110,229,339,65,36,13,72,128,456,9.62
4420,"Marcus Smart\smartma01","2014-15",20,"BOS","NBA",2.9,67,38,1808,175,477,84,205,91,272,82,127,61,161,222,208,99,18,90,176,523,8.76
4421,"Marcus Smart\smartma01","2015-16",21,"BOS","NBA",2.9,61,10,1667,184,529,123,288,61,241,129,166,76,179,255,185,91,18,80,183,558,9.53
4422,"Kenny Smith\smithke01","1995-96",30,"HOU","NBA",2.9,68,56,1617,201,464,110,226,91,238,87,106,21,75,96,245,47,3,100,116,580,8.63
4423,"Vladimir Stepania\stepavl01","2002-03",26,"MIA","NBA",2.9,79,6,1594,185,427,185,427,0,0,71,134,211,343,554,24,45,40,69,169,441,6.36
4424,"Larry Stewart\stewala01","1992-93",24,"WSB","NBA",2.9,81,8,1823,306,564,306,562,0,2,184,253,154,229,383,146,47,29,153,191,796,10.11
4425,"Stromile Swift\swiftst01","2004-05",25,"MEM","NBA",2.9,60,14,1279,219,488,219,484,0,4,166,219,92,181,273,43,41,92,90,182,604,9.56
4426,"Wally Szczerbiak\szczewa02","2007-08",30,"TOT","NBA",2.9,75,2,1736,311,722,221,504,90,218,149,175,34,183,217,104,23,12,76,103,861,8.81
4427,"Kurt Thomas\thomaku01","2006-07",34,"PHO","NBA",2.9,67,13,1208,126,259,126,258,0,1,56,71,86,293,379,24,24,29,35,156,308,5.73
4428,"Tim Thomas\thomati01","2002-03",25,"MIL","NBA",2.9,80,70,2358,412,930,315,665,97,265,145,186,97,292,389,102,70,49,133,257,1066,11.18
4429,"Jason Thompson\thompja02","2010-11",24,"SAC","NBA",2.9,75,39,1748,271,534,271,531,0,3,121,200,144,310,454,88,28,44,99,212,663,8.91
4430,"P.J. Tucker\tuckepj01","2012-13",27,"PHO","NBA",2.9,79,45,1910,210,444,188,374,22,70,64,86,132,218,350,109,62,19,67,145,506,7.11
4431,"Ben Wallace\wallabe01","1997-98",23,"WAS","NBA",2.9,67,16,1124,85,164,85,164,0,0,35,98,112,212,324,18,61,72,28,116,205,5.26
4432,"Charlie Ward\wardch01","2003-04",33,"TOT","NBA",2.9,71,10,1252,160,390,76,184,84,206,20,27,12,132,144,215,64,11,96,107,424,6.93
4433,"Earl Watson\watsoea01","2007-08",28,"SEA","NBA",2.9,78,73,2269,339,747,290,615,49,132,111,145,43,182,225,531,69,11,175,158,838,12.51
4434,"Eric Williams\willier01","1996-97",24,"BOS","NBA",2.9,72,67,2435,374,820,372,812,2,8,328,436,126,203,329,129,72,13,139,213,1078,12.69
4435,"Marvin Williams\willima02","2013-14",27,"UTA","NBA",2.9,66,50,1674,231,526,147,292,84,234,57,73,82,252,334,78,54,31,53,151,603,8.86
4436,"Monty Williams\willimo01","2001-02",30,"ORL","NBA",2.9,68,19,1284,198,362,198,358,0,4,88,134,80,155,235,96,49,17,86,134,484,7.55
4437,"Shammond Williams\willish01","2000-01",25,"SEA","NBA",2.9,69,6,1238,161,368,100,235,61,133,84,96,34,98,132,190,31,4,82,83,467,7.08
4438,"Sam Young\youngsa01","2010-11",25,"MEM","NBA",2.9,78,46,1577,233,494,216,444,17,50,89,116,40,147,187,71,68,23,61,120,572,6.63
4439,"Tyler Zeller\zellety01","2017-18",28,"TOT","NBA",2.9,66,34,1109,187,334,177,306,10,28,57,79,110,195,305,47,15,35,47,126,441,7.08
4440,"Shareef Abdur-Rahim\abdursh01","2006-07",30,"SAC","NBA",2.8,80,45,2015,310,654,307,634,3,20,170,234,122,276,398,109,53,40,116,243,793,9.38
4441,"Danny Ainge\aingeda01","1993-94",34,"PHO","NBA",2.8,68,1,1555,224,537,144,293,80,244,78,94,28,103,131,180,57,8,81,140,606,8.15
4442,"Lavoy Allen\allenla01","2014-15",25,"IND","NBA",2.8,63,0,1070,141,299,141,299,0,0,33,47,123,200,323,73,15,42,40,102,315,6.05
4443,"Nick Anderson\anderni01","1999-00",32,"SAC","NBA",2.8,72,72,2094,306,782,174,385,132,397,37,76,83,256,339,123,94,16,95,118,781,9.27
4444,"Greg Anthony\anthogr01","1998-99",31,"POR","NBA",2.8,50,0,806,104,251,55,126,49,125,62,89,14,49,63,100,66,3,55,75,319,6.75
4445,"Carlos Arroyo\arroyca01","2007-08",28,"ORL","NBA",2.8,62,20,1269,157,348,128,264,29,84,87,102,10,103,113,219,26,2,77,85,430,7.57
4446,"Chucky Atkins\atkinch01","2000-01",26,"DET","NBA",2.8,81,75,2363,380,952,259,613,121,339,90,130,28,145,173,330,67,5,149,184,971,10.02
4447,"D.J. Augustin\augusdj01","2012-13",25,"IND","NBA",2.8,76,5,1226,103,294,36,104,67,190,83,99,20,71,91,170,34,3,68,64,356,4.95
4448,"D.J. Augustin\augusdj01","2009-10",22,"CHA","NBA",2.8,80,2,1472,168,435,98,257,70,178,102,131,11,86,97,193,45,5,74,127,508,6.02
4449,"Vin Baker\bakervi01","2003-04",32,"TOT","NBA",2.8,54,33,1313,208,432,207,429,1,3,114,157,112,168,280,66,29,32,77,160,531,9.34
4450,"Renaldo Balkman\balkmre01","2006-07",22,"NYK","NBA",2.8,68,1,1064,139,275,134,248,5,27,51,90,97,197,294,44,57,44,49,146,334,6.14
4451,"Leandro Barbosa\barbole01","2014-15",32,"GSW","NBA",2.8,66,1,982,183,386,140,274,43,112,58,74,23,68,91,99,41,8,44,87,467,6.3
4452,"J.J. Barea\bareajo01","2015-16",31,"DAL","NBA",2.8,74,16,1667,317,711,217,451,100,260,74,96,26,126,152,302,26,2,113,110,808,9.84
4453,"Harrison Barnes\barneha02","2012-13",20,"GSW","NBA",2.8,81,81,2058,276,628,224,483,52,145,144,190,53,280,333,98,52,14,101,140,748,8.2
4454,"Jon Barry\barryjo01","2003-04",34,"DEN","NBA",2.8,57,9,1101,120,297,69,159,51,138,60,71,25,98,123,147,57,8,53,66,351,7.04
4455,"Tony Battie\battito01","2008-09",32,"ORL","NBA",2.8,77,3,1202,158,323,156,314,2,9,54,82,92,186,278,31,26,25,46,112,372,4.86
4456,"Khem Birch\birchkh01","2018-19",26,"ORL","NBA",2.8,50,1,643,91,151,91,150,0,1,58,83,79,111,190,38,18,29,20,72,240,6.03
4457,"Nemanja Bjelica\bjeline01","2017-18",29,"MIN","NBA",2.8,67,21,1371,171,371,95,188,76,183,36,45,53,221,274,86,50,16,52,141,454,7.31
4458,"Steve Blake\blakest01","2005-06",25,"POR","NBA",2.8,68,57,1781,206,470,130,286,76,184,72,91,26,120,146,306,42,5,83,107,560,9.17
4459,"Mark Blount\blounma01","2006-07",31,"MIN","NBA",2.8,82,81,2544,427,839,418,808,9,31,147,195,136,369,505,67,43,58,159,239,1010,11.06
4460,"Mark Blount\blounma01","2004-05",29,"BOS","NBA",2.8,82,57,2130,327,618,327,617,0,1,117,164,143,254,397,129,33,64,158,229,771,9.48
4461,"Kentavious Caldwell-Pope\caldwke01","2014-15",21,"DET","NBA",2.8,82,82,2587,390,972,237,528,153,444,110,158,46,209,255,109,93,18,94,161,1043,9.55
4462,"Sam Cassell\cassesa01","2006-07",37,"LAC","NBA",2.8,58,30,1407,261,625,229,516,32,109,160,182,27,140,167,270,28,8,101,126,714,11.41
4463,"Cedric Ceballos\cebalce01","1997-98",28,"TOT","NBA",2.8,47,25,990,204,415,183,345,21,70,107,145,75,146,221,60,33,16,72,88,536,10.35
4464,"Mario Chalmers\chalmma01","2014-15",28,"MIA","NBA",2.8,80,37,2368,267,663,194,415,73,248,206,266,24,182,206,307,122,10,173,251,813,10.72
4465,"Calbert Cheaney\cheanca01","2002-03",31,"UTA","NBA",2.8,81,74,2351,325,651,315,626,10,25,40,69,73,211,284,163,65,13,108,225,700,8.2
4466,"Speedy Claxton\claxtsp01","2001-02",23,"PHI","NBA",2.8,67,18,1528,181,452,177,419,4,33,114,136,46,114,160,198,95,6,95,145,480,7.9
4467,"Bimbo Coles\colesbi01","1994-95",26,"MIA","NBA",2.8,68,65,2207,261,607,245,531,16,76,141,174,46,145,191,416,99,13,156,185,679,12.07
4468,"Jamal Crawford\crawfja01","2002-03",22,"CHI","NBA",2.8,80,31,1992,334,808,248,566,86,242,104,129,21,164,185,334,77,25,134,126,858,10.23
4469,"Jordan Crawford\crawfjo02","2013-14",25,"TOT","NBA",2.8,81,35,1859,327,788,237,503,90,285,146,169,28,155,183,281,47,5,134,120,890,9.63
4470,"Sasha Danilović\danilsa01","1996-97",26,"TOT","NBA",2.8,56,42,1789,248,570,163,334,85,236,121,151,29,107,136,102,54,9,116,160,702,10.29
4471,"Baron Davis\davisba01","2010-11",31,"TOT","NBA",2.8,58,44,1649,289,693,208,454,81,239,101,131,35,121,156,391,78,28,146,143,760,14
4472,"Ricky Davis\davisri01","2001-02",22,"CLE","NBA",2.8,82,8,1954,376,781,365,746,11,35,196,248,63,180,243,178,69,23,148,145,959,10.35
4473,"Gorgui Dieng\dienggo01","2018-19",29,"MIN","NBA",2.8,76,2,1031,189,377,170,321,19,56,88,106,81,230,311,72,48,41,57,134,485,7.12
4474,"Spencer Dinwiddie\dinwisp01","2016-17",23,"BRK","NBA",2.8,59,18,1334,134,302,96,201,38,101,126,159,27,137,164,185,44,23,66,119,432,8.75
4475,"Goran Dragić\dragigo01","2009-10",23,"PHO","NBA",2.8,80,2,1442,222,491,148,303,74,188,117,159,38,133,171,241,48,8,126,131,635,8.17
4476,"Harold Ellis\ellisha01","1993-94",23,"LAC","NBA",2.8,49,16,923,159,292,159,288,0,4,106,149,94,59,153,31,73,2,43,97,424,8.64
4477,"Jeremy Evans\evansje01","2013-14",26,"UTA","NBA",2.8,66,4,1209,175,332,175,330,0,2,51,75,120,190,310,44,42,46,40,139,401,6.94
4478,"Jordan Farmar\farmajo01","2009-10",23,"LAL","NBA",2.8,82,0,1474,224,515,138,286,86,229,57,85,14,117,131,127,52,11,72,109,591,6.22
4479,"Terrance Ferguson\fergute01","2018-19",20,"OKC","NBA",2.8,74,74,1931,185,431,79,141,106,290,37,51,33,108,141,72,40,16,47,231,513,5.91
4480,"Duane Ferrell\ferredu01","1992-93",27,"ATL","NBA",2.8,82,15,1736,327,696,318,660,9,36,176,226,97,94,191,132,59,17,103,160,839,8.56
4481,"Evan Fournier\fournev01","2016-17",24,"ORL","NBA",2.8,68,66,2234,408,930,280,570,128,360,223,277,44,165,209,202,66,4,141,180,1167,13.99
4482,"Rick Fox\foxri01","1994-95",25,"BOS","NBA",2.8,53,7,1039,169,351,138,276,31,75,95,123,61,94,155,139,52,19,78,154,464,9.42
4483,"Adonal Foyle\foylead01","2005-06",30,"GSW","NBA",2.8,77,72,1824,152,300,152,300,0,0,41,67,143,281,424,33,44,125,80,215,345,6.62
4484,"Pat Garrity\garripa01","1999-00",23,"ORL","NBA",2.8,82,1,1479,258,585,179,388,79,197,80,111,44,166,210,58,31,19,85,197,675,6.4
4485,"Armen Gilliam\gilliar01","1992-93",28,"PHI","NBA",2.8,80,26,1742,359,774,359,773,0,1,274,325,136,336,472,116,37,54,157,123,992,11.48
4486,"Maurice Harkless\harklma01","2013-14",20,"ORL","NBA",2.8,80,41,1950,224,483,165,329,59,154,85,143,69,195,264,80,97,50,86,140,592,7.67
4487,"Matt Harpring\harprma01","2003-04",27,"UTA","NBA",2.8,31,31,1134,193,410,185,377,8,33,108,157,91,156,247,63,22,2,65,102,502,14.16
4488,"Matt Harpring\harprma01","2007-08",31,"UTA","NBA",2.8,76,0,1374,237,474,235,464,2,10,146,205,96,144,240,82,45,14,95,162,622,7.49
4489,"Lucious Harris\harrilu01","1999-00",29,"NJN","NBA",2.8,77,11,1510,198,463,160,348,38,115,79,99,53,134,187,100,65,6,42,98,513,6.16
4490,"Buddy Hield\hieldbu01","2017-18",25,"SAC","NBA",2.8,80,12,2024,416,933,240,525,176,408,71,81,55,252,307,155,85,22,124,148,1079,11.5
4491,"George Hill\hillge01","2018-19",32,"TOT","NBA",2.8,60,13,1302,170,376,122,223,48,153,70,85,39,109,148,135,52,8,51,102,458,7.8
4492,"Richaun Holmes\holmeri01","2017-18",24,"PHI","NBA",2.8,48,2,746,135,241,131,210,4,31,37,56,57,154,211,61,20,29,25,97,311,7.42
4493,"Al Horford\horfoal01","2013-14",27,"ATL","NBA",2.8,29,29,958,238,420,234,409,4,11,58,85,66,178,244,76,27,44,64,56,538,18.52
4494,"Juwan Howard\howarju01","1998-99",25,"WAS","NBA",2.8,36,36,1430,286,604,286,601,0,3,110,146,90,203,293,107,42,14,95,130,682,16.75
4495,"Juwan Howard\howarju01","1994-95",21,"WSB","NBA",2.8,65,52,2348,455,931,455,924,0,7,194,292,184,361,545,165,52,15,166,236,1104,15.25
4496,"Steven Hunter\huntest01","2006-07",25,"PHI","NBA",2.8,70,41,1605,188,326,188,326,0,0,74,151,114,221,335,26,13,76,65,137,450,6.92
4497,"Brandon Ingram\ingrabr01","2017-18",20,"LAL","NBA",2.8,59,59,1975,358,761,317,656,41,105,192,282,57,257,314,230,45,43,149,163,949,15
4498,"Allen Iverson\iversal01","2003-04",28,"PHI","NBA",2.8,48,47,2040,435,1125,378,926,57,199,339,455,34,144,178,324,115,5,209,87,1266,21.3
4499,"Jim Jackson\jacksji01","2001-02",31,"MIA","NBA",2.8,55,19,1825,238,538,200,457,38,81,75,87,54,236,290,140,42,14,106,145,589,10.34
4500,"Jim Jackson\jacksji01","1999-00",29,"ATL","NBA",2.8,79,76,2767,507,1235,390,932,117,303,186,212,101,293,394,230,57,10,185,167,1317,13.01
4501,"Mike James\jamesmi01","2006-07",31,"MIN","NBA",2.8,82,65,2069,297,703,217,488,80,215,154,184,25,138,163,297,55,7,129,171,828,9.46
4502,"Marko Jarić\jaricma01","2004-05",26,"LAC","NBA",2.8,50,41,1656,189,457,133,306,56,151,59,82,20,141,161,303,84,17,98,107,493,12.24
4503,"Al Jefferson\jeffeal01","2015-16",31,"CHO","NBA",2.8,47,18,1096,245,505,245,505,0,0,72,111,57,244,301,70,30,41,34,117,562,11.04
4504,"Anthony Johnson\johnsan02","2008-09",34,"ORL","NBA",2.8,80,12,1481,154,381,102,248,52,133,61,81,29,118,147,200,46,5,82,111,421,5.7
4505,"Joe Johnson\johnsjo02","2002-03",21,"PHO","NBA",2.8,82,34,2255,316,796,241,591,75,205,96,124,57,207,264,210,62,19,108,143,803,8.4
4506,"Maxi Kleber\klebima01","2017-18",26,"DAL","NBA",2.8,72,36,1206,151,309,111,181,40,128,44,59,71,163,234,51,26,47,30,114,386,5.73
4507,"Linas Kleiza\kleizli01","2006-07",22,"DEN","NBA",2.8,79,14,1488,200,474,117,253,83,221,115,135,77,189,266,45,28,14,79,200,598,6.51
4508,"Brandon Knight\knighbr03","2013-14",22,"MIL","NBA",2.8,72,69,2400,461,1092,351,754,110,338,259,323,46,209,255,352,69,17,188,146,1291,15.48
4509,"Brevin Knight\knighbr01","1999-00",24,"CLE","NBA",2.8,65,46,1754,230,558,228,548,2,10,140,184,38,155,193,458,107,21,157,185,602,12.39
4510,"Toni Kukoč\kukocto01","1998-99",30,"CHI","NBA",2.8,44,44,1654,315,750,276,613,39,137,159,215,65,245,310,235,49,11,121,82,828,17.09
4511,"Carl Landry\landrca01","2014-15",31,"SAC","NBA",2.8,70,15,1192,190,369,190,369,0,0,123,150,99,169,268,26,15,17,54,132,503,6.6
4512,"Zach LaVine\lavinza01","2018-19",23,"CHI","NBA",2.8,63,62,2171,530,1135,410,814,120,321,312,375,40,254,294,283,60,26,215,140,1492,20.29
4513,"Meyers Leonard\leoname01","2014-15",22,"POR","NBA",2.8,55,7,847,125,245,78,133,47,112,30,32,46,204,250,32,10,14,39,113,327,6.31
4514,"Kevon Looney\looneke01","2017-18",21,"GSW","NBA",2.8,66,4,910,112,193,111,188,1,5,42,77,83,132,215,42,34,56,31,106,267,5.32
4515,"Sam Mack\macksa01","1998-99",28,"TOT","NBA",2.8,44,15,1083,167,384,80,165,87,219,51,58,14,81,95,55,35,4,33,94,472,8.67
4516,"Tony Massenburg\masseto01","1996-97",29,"NJN","NBA",2.8,79,49,1954,219,452,219,451,0,1,130,206,222,295,517,23,38,50,91,217,568,7.65
4517,"O.J. Mayo\mayooj01","2014-15",27,"MIL","NBA",2.8,71,15,1697,296,701,197,424,99,277,115,139,30,157,187,197,57,18,128,165,806,9.95
4518,"Luc Mbah a Moute\mbahalu01","2017-18",31,"HOU","NBA",2.8,61,15,1564,166,345,103,172,63,173,65,95,22,164,186,55,72,25,68,100,460,7.79
4519,"Doug McDermott\mcderdo01","2015-16",24,"CHI","NBA",2.8,81,4,1861,291,644,181,385,110,259,72,84,37,158,195,59,14,6,53,127,764,6.94
4520,"Kevin McHale\mchalke01","1992-93",35,"BOS","NBA",2.8,71,0,1656,298,649,296,631,2,18,164,195,95,263,358,73,16,59,92,126,762,9.38
4521,"Sam Mitchell\mitchsa01","1992-93",29,"IND","NBA",2.8,81,1,1402,215,483,211,460,4,23,150,185,93,155,248,76,23,10,51,207,584,6.18
4522,"Mikki Moore\mooremi01","2000-01",25,"DET","NBA",2.8,81,2,1154,132,268,132,267,0,1,95,130,121,195,316,33,24,61,74,202,359,5.26
4523,"Larry Nance\nancela01","1993-94",34,"CLE","NBA",2.8,33,19,909,153,314,153,314,0,0,64,85,77,150,227,49,27,55,38,96,370,11.93
4524,"Jameer Nelson\nelsoja01","2013-14",31,"ORL","NBA",2.8,68,68,2179,294,747,158,356,136,391,96,112,29,202,231,476,52,5,166,146,820,13.08
4525,"Jameer Nelson\nelsoja01","2016-17",34,"DEN","NBA",2.8,75,39,2045,268,604,162,331,106,273,45,63,28,164,192,385,54,8,128,197,687,10.27
4526,"Johnny Newman\newmajo01","1996-97",33,"MIL","NBA",2.8,82,4,2060,246,547,212,449,34,98,189,247,66,120,186,116,73,17,115,257,715,7.9
4527,"Johnny Newman\newmajo01","1994-95",31,"MIL","NBA",2.8,82,11,1896,226,488,181,360,45,128,137,171,72,101,173,91,69,13,86,234,634,7.08
4528,"Andrés Nocioni\nocioan01","2008-09",29,"TOT","NBA",2.8,76,18,1991,299,701,175,390,124,311,145,183,54,307,361,102,39,33,113,261,867,9.98
4529,"Shaquille O'Neal\onealsh01","2006-07",34,"MIA","NBA",2.8,40,39,1135,283,479,283,479,0,0,124,294,97,200,297,79,8,55,95,139,690,15.51
4530,"Shaquille O'Neal\onealsh01","2007-08",35,"TOT","NBA",2.8,61,61,1748,331,558,331,558,0,0,170,338,166,388,554,93,32,88,181,228,832,14.54
4531,"Billy Owens\owensbi01","1996-97",27,"SAC","NBA",2.8,66,56,1995,299,640,274,568,25,72,101,145,134,258,392,187,62,25,133,187,724,11.29
4532,"Scott Padgett\padgesc01","2004-05",28,"HOU","NBA",2.8,66,0,942,98,233,48,107,50,126,29,40,47,138,185,55,33,10,30,119,275,4.53
4533,"Elfrid Payton\paytoel01","2017-18",23,"TOT","NBA",2.8,63,63,1808,329,667,299,575,30,92,109,168,64,210,274,393,83,22,168,147,797,14.62
4534,"Mickaël Piétrus\pietrmi01","2007-08",25,"GSW","NBA",2.8,66,16,1316,170,387,104,204,66,183,66,98,67,175,242,49,66,43,48,200,472,7.33
4535,"Norman Powell\powelno01","2016-17",23,"TOR","NBA",2.8,76,18,1368,227,506,171,333,56,173,126,159,26,143,169,82,52,14,70,127,636,7.19
4536,"Don Reid\reiddo01","1997-98",24,"DET","NBA",2.8,68,44,994,94,176,94,176,0,0,50,71,77,98,175,26,25,55,28,183,238,4.35
4537,"Jason Richardson\richaja01","2011-12",31,"ORL","NBA",2.8,54,54,1591,243,596,141,319,102,277,41,69,36,158,194,107,53,22,60,91,629,9.61
4538,"Alvin Robertson\roberal01","1995-96",33,"TOR","NBA",2.8,77,69,2478,285,607,244,456,41,151,107,158,110,232,342,323,166,36,183,268,718,12.22
4539,"Clifford Robinson\robincl02","2005-06",39,"NJN","NBA",2.8,80,13,1863,219,513,159,338,60,175,52,79,55,212,267,89,44,40,62,206,550,6.36
4540,"Nate Robinson\robinna01","2011-12",27,"GSW","NBA",2.8,51,9,1192,205,484,139,303,66,181,94,113,15,85,100,231,59,2,75,118,570,11.13
4541,"Dennis Scott\scottde01","1992-93",24,"ORL","NBA",2.8,54,43,1759,329,763,221,495,108,268,92,117,38,148,186,136,57,18,104,131,858,12.68
4542,"Joe Smith\smithjo02","2006-07",31,"TOT","NBA",2.8,65,11,1503,214,477,214,472,0,5,125,148,120,280,400,49,37,27,76,148,553,8.4
4543,"Eric Snow\snower01","2006-07",33,"CLE","NBA",2.8,82,45,1929,135,324,135,320,0,4,72,113,35,153,188,330,55,16,111,185,342,6.4
4544,"Marreese Speights\speigma01","2012-13",25,"TOT","NBA",2.8,79,3,1300,260,584,257,574,3,10,135,175,146,240,386,47,24,53,80,175,658,7.41
4545,"Latrell Sprewell\sprewla01","2001-02",31,"NYK","NBA",2.8,81,81,3326,573,1419,428,1016,145,403,284,346,59,239,298,313,94,14,223,161,1575,15.16
4546,"Mark Strickland\stricma01","1997-98",27,"MIA","NBA",2.8,51,8,847,145,269,145,268,0,1,59,82,80,133,213,26,18,34,47,87,349,6.95
4547,"Roy Tarpley\tarplro01","1994-95",30,"DAL","NBA",2.8,55,1,1354,292,610,287,592,5,18,102,122,142,307,449,58,45,55,109,155,691,12.3
4548,"Jamaal Tinsley\tinslja01","2006-07",28,"IND","NBA",2.8,72,72,2243,346,889,285,696,61,193,172,239,60,180,240,494,117,25,200,190,925,13.76
4549,"Jamaal Tinsley\tinslja01","2004-05",26,"IND","NBA",2.8,40,40,1301,218,522,160,366,58,156,122,164,26,134,160,257,81,12,134,112,616,16.36
4550,"Anthony Tolliver\tollian01","2015-16",30,"DET","NBA",2.8,72,5,1341,128,332,30,60,98,272,29,47,39,190,229,52,26,16,28,86,383,5
4551,"Jake Tsakalidis\tsakaja01","2005-06",26,"MEM","NBA",2.8,51,19,732,100,165,100,165,0,0,57,87,78,134,212,13,14,32,39,107,257,5.88
4552,"Jake Tsakalidis\tsakaja01","2001-02",22,"PHO","NBA",2.8,67,47,1582,190,400,190,399,0,1,111,159,130,244,374,23,23,69,78,193,491,7.53
4553,"Trent Tucker\tucketr01","1992-93",33,"CHI","NBA",2.8,69,0,909,143,295,91,164,52,131,18,22,16,55,71,82,24,6,18,65,356,4.62
4554,"Hedo Türkoğlu\turkohe01","2000-01",21,"SAC","NBA",2.8,74,7,1245,138,335,110,249,28,86,87,112,49,161,210,69,52,24,55,139,391,5.44
4555,"Ime Udoka\udokaim01","2007-08",30,"SAS","NBA",2.8,73,0,1316,159,375,98,210,61,165,44,58,36,192,228,63,56,17,58,127,423,5.78
4556,"Keith Van Horn\vanhoke01","2000-01",25,"NJN","NBA",2.8,49,47,1733,308,708,243,538,65,170,150,186,78,269,347,82,40,20,103,150,831,14.17
4557,"Greivis Vásquez\vasqugr01","2014-15",28,"TOR","NBA",2.8,82,29,1991,296,725,163,374,133,351,50,66,22,194,216,302,46,10,119,177,775,8.91
4558,"Bill Wennington\wennibi01","1995-96",32,"CHI","NBA",2.8,71,20,1065,169,343,168,342,1,1,37,43,58,116,174,46,21,16,37,171,376,4.72
4559,"David Wesley\wesleda01","2003-04",33,"NOH","NBA",2.8,61,60,2001,311,800,219,515,92,285,137,182,28,106,134,175,71,14,100,147,851,10.73
4560,"David West\westda01","2003-04",23,"NOH","NBA",2.8,71,1,930,108,228,108,226,0,2,57,80,117,180,297,60,27,28,48,117,273,5
4561,"Chris Wilcox\wilcoch01","2010-11",28,"DET","NBA",2.8,57,29,995,187,322,187,321,0,1,50,89,95,176,271,43,29,17,43,145,424,7.67
4562,"Damien Wilkins\wilkida02","2006-07",27,"SEA","NBA",2.8,82,31,2037,262,602,212,480,50,122,150,170,87,142,229,156,92,16,116,157,724,8.58
4563,"Deron Williams\willide01","2005-06",21,"UTA","NBA",2.8,80,47,2307,339,805,248,586,91,219,95,135,35,159,194,359,60,17,145,233,864,10.26
4564,"Hot Rod Williams\williho01","1995-96",33,"PHO","NBA",2.8,62,58,1652,180,397,180,396,0,1,95,130,129,243,372,62,46,90,62,170,455,8.65
4565,"Marvin Williams\willima02","2005-06",19,"ATL","NBA",2.8,79,7,1952,235,531,222,478,13,53,189,253,122,261,383,63,48,24,83,227,672,7.98
4566,"Mo Williams\willima01","2011-12",29,"LAC","NBA",2.8,52,1,1472,260,611,167,372,93,239,72,80,23,76,99,160,51,7,86,103,685,10.88
4567,"Justise Winslow\winslju01","2018-19",22,"MIA","NBA",2.8,66,52,1959,324,749,228,493,96,256,86,137,63,292,355,282,72,19,142,177,830,12.72
4568,"Haywoode Workman\workmha01","1993-94",28,"IND","NBA",2.8,65,52,1714,195,460,177,404,18,56,93,116,32,172,204,404,85,4,151,152,501,10.77
4569,"Nick Young\youngni01","2010-11",25,"WAS","NBA",2.8,64,40,2034,412,935,307,664,105,271,186,228,26,148,174,75,45,17,90,144,1115,12.3
4570,"Mahmoud Abdul-Rauf\abdulma02","1996-97",27,"SAC","NBA",2.7,75,51,2131,411,924,317,678,94,246,115,136,16,106,122,189,56,6,119,174,1031,10.42
4571,"Jeff Adrien\adrieje01","2013-14",27,"TOT","NBA",2.7,53,12,961,143,275,143,275,0,0,76,119,102,204,306,38,24,36,39,108,362,7.69
4572,"Arron Afflalo\afflaar01","2015-16",30,"NYK","NBA",2.7,71,57,2371,354,799,263,561,91,238,110,131,23,243,266,144,25,10,82,142,909,10.17
4573,"Tony Allen\allento01","2013-14",32,"MEM","NBA",2.7,55,28,1278,204,413,193,366,11,47,76,121,79,129,208,94,90,19,90,121,495,9.49
4574,"Tony Allen\allento01","2004-05",23,"BOS","NBA",2.7,77,34,1262,184,387,172,356,12,31,112,152,85,136,221,64,76,24,77,156,492,6.55
4575,"Tony Allen\allento01","2007-08",26,"BOS","NBA",2.7,75,11,1373,169,389,151,332,18,57,138,181,34,134,168,114,62,21,109,168,494,6.61
4576,"Chris Andersen\anderch01","2012-13",34,"MIA","NBA",2.7,42,0,624,71,123,69,120,2,3,63,93,57,115,172,17,16,44,24,89,207,6.3
4577,"Alan Anderson\anderal01","2014-15",32,"BRK","NBA",2.7,74,19,1744,195,440,122,230,73,210,82,101,31,173,204,83,56,5,60,148,545,6.85
4578,"Kyle Anderson\anderky01","2018-19",25,"MEM","NBA",2.7,43,40,1281,150,276,141,242,9,34,37,64,48,203,251,128,54,37,58,112,346,10.97
4579,"Kyle Anderson\anderky01","2016-17",23,"SAS","NBA",2.7,72,14,1020,93,209,78,169,15,40,45,57,33,175,208,91,51,26,39,63,246,4.84
4580,"Shandon Anderson\andersh01","2002-03",29,"NYK","NBA",2.7,82,9,1731,248,537,196,397,52,140,139,190,64,190,254,87,73,20,114,177,687,7.8
4581,"Greg Anthony\anthogr01","1997-98",30,"SEA","NBA",2.7,80,0,1021,150,349,84,190,66,159,53,80,18,93,111,205,64,3,91,97,419,5.97
4582,"Gilbert Arenas\arenagi01","2001-02",20,"GSW","NBA",2.7,47,30,1155,174,384,135,271,39,113,124,160,41,91,132,174,69,11,97,115,511,11.67
4583,"Carlos Arroyo\arroyca01","2005-06",26,"TOT","NBA",2.7,77,0,1194,168,378,161,358,7,20,106,137,33,97,130,232,38,4,83,119,449,6.42
4584,"Ömer Aşık\asikom01","2010-11",24,"CHI","NBA",2.7,82,0,989,78,141,78,141,0,0,73,145,112,194,306,32,20,56,64,153,229,4.11
4585,"Vincent Askew\askewvi01","1992-93",26,"TOT","NBA",2.7,73,4,1129,152,309,150,303,2,6,105,149,62,99,161,122,40,19,69,135,411,6.04
4586,"Chucky Atkins\atkinch01","2003-04",29,"TOT","NBA",2.7,64,24,1544,192,484,111,243,81,241,73,97,9,84,93,223,45,2,92,102,538,7.91
4587,"J.J. Barea\bareajo01","2014-15",30,"DAL","NBA",2.7,77,10,1362,225,536,171,369,54,167,76,94,23,111,134,263,33,1,70,104,580,7.26
4588,"Brent Barry\barrybr01","1997-98",26,"TOT","NBA",2.7,58,36,1600,213,506,123,277,90,229,115,134,29,142,171,153,64,27,104,118,631,10.57
4589,"Tony Battie\battito01","2006-07",30,"ORL","NBA",2.7,66,66,1575,176,360,176,359,0,1,52,77,92,252,344,35,29,30,61,185,404,6.43
4590,"Jerryd Bayless\bayleje01","2009-10",21,"POR","NBA",2.7,74,11,1304,200,483,171,391,29,92,201,242,18,102,120,172,26,5,94,152,630,7.48
4591,"Bradley Beal\bealbr01","2015-16",22,"WAS","NBA",2.7,55,35,1708,359,799,254,528,105,271,135,176,41,147,188,162,54,11,112,117,958,14.11
4592,"Bogdan Bogdanović\bogdabo01","2018-19",26,"SAC","NBA",2.7,70,17,1947,361,863,227,491,134,372,134,162,40,203,243,267,72,15,117,142,990,12.65
4593,"Frank Brickowski\brickfr01","1993-94",34,"TOT","NBA",2.7,71,46,2094,368,754,364,734,4,20,195,254,85,319,404,222,80,27,181,242,935,13.33
4594,"Malcolm Brogdon\brogdma01","2017-18",25,"MIL","NBA",2.7,48,20,1436,244,503,182,342,62,161,75,85,23,133,156,152,41,13,66,128,625,12.2
4595,"Rasual Butler\butlera01","2009-10",30,"LAC","NBA",2.7,82,64,2702,356,870,211,438,145,432,122,145,39,201,240,116,36,68,79,121,979,9.32
4596,"Jason Caffey\caffeja01","1997-98",24,"TOT","NBA",2.7,80,14,1423,226,466,226,464,0,2,131,200,160,184,344,67,25,20,105,181,583,6.79
4597,"Omri Casspi\casspom01","2014-15",26,"SAC","NBA",2.7,67,19,1416,209,427,174,340,35,87,140,191,54,206,260,102,31,9,88,107,593,8.51
4598,"Kelvin Cato\catoke01","1997-98",23,"POR","NBA",2.7,74,8,1007,98,229,98,226,0,3,86,125,91,161,252,23,29,94,44,164,282,4.82
4599,"Mario Chalmers\chalmma01","2009-10",23,"MIA","NBA",2.7,73,22,1807,182,454,107,218,75,236,82,110,25,110,135,246,91,12,123,175,521,8.09
4600,"Tyson Chandler\chandty01","2017-18",35,"PHO","NBA",2.7,46,46,1151,121,187,121,187,0,0,58,93,134,284,418,53,16,27,59,106,300,9.62
4601,"Wilson Chandler\chandwi01","2009-10",22,"NYK","NBA",2.7,65,64,2320,412,860,372,710,40,150,129,160,93,255,348,138,46,49,108,184,993,13.22
4602,"Bimbo Coles\colesbi01","1998-99",30,"GSW","NBA",2.7,48,32,1272,183,414,177,389,6,25,83,101,21,96,117,222,45,11,82,113,455,10.13
4603,"Chris Crawford\crawfch01","2003-04",28,"ATL","NBA",2.7,56,25,1207,211,471,167,358,44,113,103,119,58,117,175,45,37,20,55,131,569,8.39
4604,"Deyonta Davis\davisde01","2017-18",21,"MEM","NBA",2.7,62,6,943,161,265,161,265,0,0,38,57,75,175,250,40,15,39,32,125,360,6.48
4605,"Sherman Douglas\douglsh01","1993-94",27,"BOS","NBA",2.7,78,78,2789,425,919,412,863,13,56,177,276,70,123,193,683,89,11,233,171,1040,15.12
4606,"Jared Dudley\dudleja01","2008-09",23,"TOT","NBA",2.7,68,7,1155,136,285,107,211,29,74,71,105,82,123,205,56,57,8,43,105,372,5.84
4607,"Reggie Evans\evansre01","2007-08",27,"PHI","NBA",2.7,81,61,1879,152,346,151,345,1,1,120,257,224,387,611,65,86,8,108,213,425,7.04
4608,"Tyreke Evans\evansty01","2011-12",22,"SAC","NBA",2.7,63,61,2162,408,900,388,801,20,99,201,258,64,225,289,283,84,29,171,136,1037,15.32
4609,"Festus Ezeli\ezelife01","2015-16",26,"GSW","NBA",2.7,46,13,770,125,228,125,228,0,0,70,132,91,166,257,32,18,50,38,94,320,7.91
4610,"Derrick Favors\favorde01","2016-17",25,"UTA","NBA",2.7,50,39,1186,203,417,200,407,3,10,67,109,92,213,305,56,45,40,60,103,476,9.65
4611,"Raymond Felton\feltora01","2015-16",31,"DAL","NBA",2.7,80,31,2192,277,682,217,469,60,213,149,176,36,222,258,284,68,15,121,141,763,9.58
4612,"Danny Ferry\ferryda01","1999-00",33,"CLE","NBA",2.7,63,3,1326,189,380,156,305,33,75,52,57,55,183,238,67,22,24,55,181,463,7.17
4613,"Jeff Foster\fosteje01","2000-01",24,"IND","NBA",2.7,71,9,1152,100,213,98,206,2,7,47,91,144,245,389,33,39,28,52,152,249,5.06
4614,"Matt Geiger\geigema01","1994-95",25,"MIA","NBA",2.7,74,43,1712,260,485,256,475,4,10,93,143,146,267,413,55,41,51,113,245,617,8.67
4615,"Devean George\georgde01","2002-03",25,"LAL","NBA",2.7,71,7,1613,180,461,131,329,49,132,83,105,91,195,286,92,56,38,65,180,492,6.96
4616,"Drew Gooden\goodedr01","2008-09",27,"TOT","NBA",2.7,51,28,1264,237,506,237,502,0,4,131,156,113,249,362,48,30,18,76,144,605,10.91
4617,"Harvey Grant\grantha01","1996-97",31,"WSB","NBA",2.7,78,25,1604,129,314,101,225,28,89,30,39,63,193,256,68,46,48,30,167,316,4.79
4618,"Derek Harper\harpede01","1996-97",35,"DAL","NBA",2.7,75,29,2210,299,674,239,498,60,176,95,128,30,107,137,321,92,12,132,144,753,10.23
4619,"Derek Harper\harpede01","1992-93",31,"DAL","NBA",2.7,62,60,2108,393,939,292,682,101,257,239,316,42,81,123,334,80,16,136,145,1126,15.63
4620,"Devin Harris\harride01","2009-10",26,"NJN","NBA",2.7,64,61,2221,356,884,296,667,60,217,308,386,24,179,203,423,79,18,181,178,1080,16.27
4621,"Devin Harris\harride01","2004-05",21,"DAL","NBA",2.7,76,19,1173,157,366,113,235,44,131,78,103,28,74,102,169,77,19,82,139,436,6.34
4622,"Trenton Hassell\hassetr01","2004-05",25,"MIN","NBA",2.7,82,51,2068,225,475,224,464,1,11,90,114,80,139,219,128,30,30,64,200,541,6.31
4623,"Brendan Haywood\haywobr01","2011-12",32,"DAL","NBA",2.7,54,54,1146,118,228,118,228,0,0,45,96,139,185,324,19,24,54,46,121,281,6.54
4624,"John Henson\hensojo01","2016-17",26,"MIL","NBA",2.7,58,39,1123,159,309,159,308,0,1,74,107,92,203,295,57,29,78,52,151,392,8.06
4625,"Nenê Hilário\hilarne01","2015-16",33,"WAS","NBA",2.7,57,11,1094,209,384,209,381,0,3,107,185,52,207,259,97,54,26,76,156,525,9.69
4626,"Nenê Hilário\hilarne01","2011-12",29,"TOT","NBA",2.7,39,33,1110,211,393,211,389,0,4,113,168,63,228,291,80,42,38,96,95,535,14.44
4627,"Solomon Hill\hillso01","2016-17",25,"NOP","NBA",2.7,80,71,2374,183,478,89,208,94,270,103,128,51,256,307,141,72,32,82,182,563,7.59
4628,"Fred Hoiberg\hoibefr01","2001-02",29,"CHI","NBA",2.7,79,8,1408,121,291,97,199,24,92,79,94,18,192,210,136,61,5,32,87,345,5.41
4629,"Rodney Hood\hoodro01","2017-18",25,"TOT","NBA",2.7,60,23,1616,322,751,195,418,127,333,111,129,22,143,165,95,45,12,70,105,882,11.06
4630,"Kris Humphries\humphkr01","2012-13",27,"BRK","NBA",2.7,65,21,1191,139,310,139,308,0,2,97,123,126,239,365,32,16,33,57,127,375,6.32
4631,"Casey Jacobsen\jacobca01","2004-05",23,"TOT","NBA",2.7,84,1,1798,165,408,99,231,66,177,151,192,35,132,167,113,33,8,71,104,547,5.9
4632,"Al Jefferson\jeffeal01","2004-05",20,"BOS","NBA",2.7,71,1,1051,195,369,195,366,0,3,85,135,119,193,312,24,22,55,66,195,475,6.72
4633,"Richard Jefferson\jefferi01","2015-16",35,"CLE","NBA",2.7,74,5,1326,143,312,77,139,66,173,58,87,15,113,128,59,33,14,43,129,410,5.03
4634,"Richard Jefferson\jefferi01","2013-14",33,"UTA","NBA",2.7,82,78,2213,294,654,171,353,123,301,120,162,18,201,219,130,56,14,94,168,831,8.76
4635,"Amir Johnson\johnsam01","2008-09",21,"DET","NBA",2.7,62,24,911,97,163,97,163,0,0,23,35,102,130,232,20,20,60,33,171,217,4.93
4636,"Joe Johnson\johnsjo02","2015-16",34,"TOT","NBA",2.7,81,81,2703,377,859,257,546,120,313,118,142,49,243,292,318,61,4,159,146,992,11.54
4637,"Kosta Koufos\koufoko01","2011-12",22,"DEN","NBA",2.7,48,24,792,115,192,115,192,0,0,33,55,95,163,258,15,24,41,33,96,263,6.92
4638,"Christian Laettner\laettch01","2004-05",35,"MIA","NBA",2.7,49,0,739,107,184,106,177,1,7,45,59,36,95,131,41,32,15,29,78,260,5.96
4639,"Jeremy Lamb\lambje01","2015-16",23,"CHO","NBA",2.7,66,0,1227,230,510,174,329,56,181,64,88,44,208,252,77,42,30,50,105,580,7.93
4640,"Jeremy Lamb\lambje01","2016-17",24,"CHO","NBA",2.7,62,5,1143,226,491,185,345,41,146,110,129,30,234,264,75,27,23,40,98,603,8.76
4641,"Courtney Lee\leeco01","2010-11",25,"HOU","NBA",2.7,81,1,1723,253,576,182,402,71,174,95,120,51,158,209,100,58,18,68,102,672,7.21
4642,"David Lee\leeda02","2005-06",22,"NYK","NBA",2.7,67,14,1129,137,230,137,230,0,0,71,123,109,194,303,43,30,20,51,124,345,6.17
4643,"Jon Leuer\leuerjo01","2015-16",26,"PHO","NBA",2.7,67,27,1255,224,466,182,356,42,110,77,101,76,297,373,72,38,30,75,125,567,8.65
4644,"Jeremy Lin\linje01","2011-12",23,"NYK","NBA",2.7,35,25,940,171,383,147,308,24,75,146,183,18,89,107,216,55,9,126,78,512,15.79
4645,"Jeremy Lin\linje01","2014-15",26,"LAL","NBA",2.7,74,30,1907,277,654,212,478,65,176,213,268,26,170,196,339,82,32,166,189,832,11.93
4646,"Brad Lohaus\lohaubr01","1992-93",28,"MIL","NBA",2.7,80,24,1766,283,614,198,384,85,230,73,101,59,217,276,127,47,74,93,178,724,8.68
4647,"Robin Lopez\lopezro01","2018-19",30,"CHI","NBA",2.7,74,36,1606,304,535,297,504,7,31,89,123,140,146,286,89,11,78,96,124,704,9.19
4648,"Tyronn Lue\luety01","2005-06",28,"ATL","NBA",2.7,51,10,1234,192,418,134,291,58,127,118,138,13,69,82,157,26,3,75,113,560,9.94
4649,"Mark Madsen\madsema01","2003-04",28,"MIN","NBA",2.7,72,12,1246,101,204,101,198,0,6,57,118,134,138,272,28,33,18,47,175,259,4.25
4650,"Lauri Markkanen\markkla01","2018-19",21,"CHI","NBA",2.7,52,51,1682,342,795,222,463,120,332,170,195,74,396,470,75,37,33,85,122,974,16.25
4651,"Kenyon Martin\martike01","2010-11",33,"DEN","NBA",2.7,48,48,1233,185,362,183,353,2,9,42,72,67,230,297,109,43,35,59,136,414,10.11
4652,"Wesley Matthews\matthwe02","2018-19",32,"TOT","NBA",2.7,69,68,2091,279,698,129,295,150,403,132,163,32,138,170,160,54,17,91,160,840,10.09
4653,"JaVale McGee\mcgeeja01","2017-18",30,"GSW","NBA",2.7,65,17,615,136,219,136,213,0,6,38,52,59,110,169,33,21,57,27,91,310,5.49
4654,"Tracy McGrady\mcgratr01","2008-09",29,"HOU","NBA",2.7,35,35,1181,188,485,144,368,44,117,125,156,20,134,154,175,42,15,69,38,545,14.43
4655,"Salah Mejri\mejrisa01","2017-18",31,"DAL","NBA",2.7,61,1,729,88,137,88,134,0,3,38,66,85,161,246,35,22,67,39,121,214,5.47
4656,"Khris Middleton\middlkh01","2013-14",22,"MIL","NBA",2.7,82,64,2460,376,854,256,564,120,290,118,137,60,250,310,169,83,20,123,243,990,10.66
4657,"Brad Miller\millebr01","2006-07",30,"SAC","NBA",2.7,63,56,1783,224,494,219,461,5,33,115,149,79,322,401,224,38,39,108,155,568,10.8
4658,"Harold Miner\minerha01","1993-94",22,"MIA","NBA",2.7,63,31,1358,254,532,250,526,4,6,149,180,75,81,156,95,31,13,95,132,661,8.68
4659,"Nazr Mohammed\mohamna01","2010-11",33,"TOT","NBA",2.7,75,37,1280,234,448,234,447,0,1,67,112,140,228,368,23,30,56,70,184,535,7.06
4660,"E'Twaun Moore\mooreet01","2016-17",27,"NOP","NBA",2.7,73,22,1820,283,619,206,411,77,208,57,74,33,119,152,164,50,32,62,131,700,8.51
4661,"Shabazz Muhammad\muhamsh01","2015-16",23,"MIN","NBA",2.7,82,0,1682,317,681,273,529,44,152,185,242,100,167,267,52,24,7,70,94,863,8.08
4662,"Shabazz Muhammad\muhamsh01","2016-17",24,"MIN","NBA",2.7,78,1,1516,288,598,239,453,49,145,147,190,84,136,220,35,22,6,56,86,772,7.57
4663,"Eduardo Nájera\najered01","2005-06",29,"DEN","NBA",2.7,64,3,1449,127,301,123,289,4,12,89,114,128,197,325,52,53,34,54,165,347,6.57
4664,"Johnny Newman\newmajo01","1997-98",34,"DEN","NBA",2.7,74,15,2176,344,799,308,694,36,105,365,445,50,91,141,138,77,24,147,208,1089,11.92
4665,"Jermaine O'Neal\onealje01","2013-14",35,"GSW","NBA",2.7,44,13,883,125,248,125,248,0,0,99,132,85,157,242,25,14,40,52,102,349,8.38
4666,"Shaquille O'Neal\onealsh01","2010-11",38,"BOS","NBA",2.7,37,36,752,134,201,134,201,0,0,73,131,48,130,178,26,16,42,56,120,341,9.88
4667,"Lamar Odom\odomla01","2012-13",33,"LAC","NBA",2.7,82,2,1616,146,366,128,276,18,90,20,42,117,363,480,142,69,58,86,214,330,6.4
4668,"Zaza Pachulia\pachuza01","2012-13",28,"ATL","NBA",2.7,52,15,1134,114,241,114,238,0,3,78,103,132,204,336,79,35,12,70,128,306,7.81
4669,"Zaza Pachulia\pachuza01","2009-10",25,"ATL","NBA",2.7,78,1,1089,120,246,120,242,0,4,93,143,117,176,293,42,37,31,58,186,333,5.05
4670,"Robert Pack\packro01","1995-96",26,"WSB","NBA",2.7,31,31,1084,190,444,164,346,26,98,154,182,29,103,132,242,62,1,114,68,560,19.32
4671,"Anthony Peeler\peelean01","1992-93",23,"LAL","NBA",2.7,77,11,1656,297,634,251,516,46,118,162,206,64,115,179,166,60,14,123,193,802,9.31
4672,"Ricky Pierce\piercri01","1996-97",37,"TOT","NBA",2.7,60,27,1250,239,497,197,402,42,95,139,155,36,85,121,80,28,9,68,97,659,8.98
4673,"Otto Porter\porteot01","2014-15",21,"WAS","NBA",2.7,74,13,1432,176,391,141,287,35,104,58,79,70,151,221,65,44,30,52,97,445,5.84
4674,"Terry Porter\portete01","1996-97",33,"MIN","NBA",2.7,82,20,1568,187,449,120,249,67,200,127,166,31,145,176,295,54,11,128,104,568,7.95
4675,"James Posey\poseyja01","2001-02",25,"DEN","NBA",2.7,73,63,2238,277,736,210,499,67,237,161,203,109,320,429,180,114,39,127,224,782,10.95
4676,"Vladimir Radmanović\radmavl01","2002-03",22,"SEA","NBA",2.7,72,16,1910,274,668,170,375,104,293,72,102,76,247,323,97,64,22,100,136,724,8.76
4677,"Don Reid\reiddo01","1998-99",25,"DET","NBA",2.7,47,30,935,97,174,97,174,0,0,48,79,66,104,170,33,27,43,36,156,242,6.27
4678,"Mike Scott\scottmi01","2014-15",26,"ATL","NBA",2.7,68,0,1123,201,453,135,261,66,192,61,77,45,154,199,75,25,3,39,83,529,6.55
4679,"Rony Seikaly\seikaro01","1997-98",32,"TOT","NBA",2.7,56,49,1636,250,579,250,577,0,2,246,332,146,247,393,77,28,43,146,164,746,12.06
4680,"Brian Skinner\skinnbr01","2003-04",27,"MIL","NBA",2.7,56,54,1577,255,513,255,513,0,0,79,138,119,292,411,49,30,61,78,165,589,10.35
4681,"J.R. Smith\smithjr01","2009-10",24,"DEN","NBA",2.7,75,0,2082,428,1033,270,566,158,467,142,201,28,206,234,183,99,20,139,174,1156,12.2
4682,"Joe Smith\smithjo02","2008-09",33,"TOT","NBA",2.7,57,3,1102,156,333,153,326,3,7,59,82,89,174,263,41,17,40,25,122,374,6.54
4683,"Rik Smits\smitsri01","1992-93",26,"IND","NBA",2.7,81,81,2072,494,1017,494,1017,0,0,167,228,126,306,432,121,27,75,147,285,1155,11.77
4684,"Marreese Speights\speigma01","2011-12",24,"MEM","NBA",2.7,60,54,1345,221,488,221,485,0,3,84,109,133,241,374,48,21,29,74,147,526,8.12
4685,"Greg Stiemsma\stiemgr01","2011-12",26,"BOS","NBA",2.7,55,3,766,66,121,66,121,0,0,29,41,48,129,177,28,37,85,33,144,161,5.18
4686,"Peja Stojaković\stojape01","2009-10",32,"NOH","NBA",2.7,62,55,1947,278,688,146,336,132,352,96,107,39,188,227,92,48,5,56,83,784,9.93
4687,"Amar'e Stoudemire\stoudam01","2012-13",30,"NYK","NBA",2.7,29,0,682,154,267,154,267,0,0,105,130,60,85,145,13,10,21,50,89,413,12.74
4688,"Erick Strickland\stricer01","2002-03",29,"IND","NBA",2.7,71,10,1275,163,380,101,220,62,160,70,87,23,122,145,209,38,7,98,111,458,7.01
4689,"Rodney Stuckey\stuckro01","2009-10",23,"DET","NBA",2.7,73,67,2499,449,1109,431,1030,18,79,299,359,67,214,281,348,101,12,163,205,1215,14.52
4690,"Jared Sullinger\sullija01","2012-13",20,"BOS","NBA",2.7,45,5,892,111,225,110,220,1,5,47,63,92,172,264,35,22,22,29,154,270,7.07
4691,"Mirza Teletović\teletmi01","2013-14",28,"BRK","NBA",2.7,72,7,1396,221,529,85,180,136,349,44,62,60,206,266,57,29,23,54,143,622,7.28
4692,"Garrett Temple\templga01","2015-16",29,"WAS","NBA",2.7,80,43,1951,201,505,112,247,89,258,91,125,36,176,212,140,69,18,64,195,582,7
4693,"Etan Thomas\thomaet01","2006-07",28,"WAS","NBA",2.7,65,32,1246,159,277,159,277,0,0,77,138,136,241,377,29,22,89,71,162,395,7.63
4694,"Jason Thompson\thompja02","2013-14",27,"SAC","NBA",2.7,82,61,2007,251,496,251,496,0,0,84,145,153,374,527,53,32,56,95,251,586,7.73
4695,"Jason Thompson\thompja02","2008-09",22,"SAC","NBA",2.7,82,56,2303,356,717,356,709,0,8,198,286,234,372,606,93,46,59,146,314,910,11.1
4696,"Tom Tolbert\tolbeto01","1992-93",27,"ORL","NBA",2.7,72,61,1838,226,454,217,426,9,28,122,168,133,279,412,91,33,21,124,192,583,8.52
4697,"Anthony Tolliver\tollian01","2014-15",29,"TOT","NBA",2.7,76,11,1432,161,393,55,103,106,290,54,69,51,185,236,59,24,16,51,137,482,5.74
4698,"Ekpe Udoh\udohek01","2012-13",25,"MIL","NBA",2.7,76,9,1312,117,269,117,268,0,1,89,119,113,138,251,43,39,85,43,139,323,5.24
4699,"Jake Voskuhl\voskuja01","2001-02",24,"PHO","NBA",2.7,59,34,900,107,193,107,193,0,0,82,109,103,147,250,18,11,23,48,139,296,5.64
4700,"John Wall\walljo01","2017-18",27,"WAS","NBA",2.7,41,41,1410,280,667,218,500,62,167,175,241,22,128,150,393,57,45,158,80,797,20.47
4701,"Earl Watson\watsoea01","2005-06",26,"TOT","NBA",2.7,70,10,1578,219,509,109,237,110,272,75,111,24,134,158,289,68,10,136,159,623,9.72
4702,"Chris Whitney\whitnch01","1997-98",26,"WAS","NBA",2.7,82,6,1073,126,355,74,186,52,169,118,129,16,99,115,196,34,6,65,106,422,5.38
4703,"Kenny Williams\willike03","1992-93",23,"IND","NBA",2.7,57,0,844,150,282,150,279,0,3,48,68,102,126,228,38,21,45,28,87,348,6.54
4704,"Corliss Williamson\willico02","1996-97",23,"SAC","NBA",2.7,79,31,1992,371,745,371,742,0,3,173,251,139,187,326,124,60,49,157,263,915,10.41
4705,"Metta World Peace\artesro01","2001-02",22,"TOT","NBA",2.7,55,50,1642,269,636,216,466,53,170,136,204,73,198,271,127,141,39,118,217,727,13.23
4706,"Arron Afflalo\afflaar01","2014-15",29,"TOT","NBA",2.6,78,72,2502,375,884,257,551,118,333,167,198,27,220,247,129,41,7,116,167,1035,10.11
4707,"Gilbert Arenas\arenagi01","2003-04",22,"WAS","NBA",2.6,55,52,2066,358,914,233,581,125,333,237,317,55,199,254,275,103,12,226,176,1078,17.36
4708,"Ömer Aşık\asikom01","2011-12",25,"CHI","NBA",2.6,66,2,971,79,156,79,156,0,0,47,103,127,223,350,32,30,68,68,121,205,5.23
4709,"Stacey Augmon\augmost01","1998-99",30,"POR","NBA",2.6,48,21,874,78,174,78,172,0,2,52,76,47,78,125,58,57,18,30,81,208,5.58
4710,"D.J. Augustin\augusdj01","2015-16",28,"TOT","NBA",2.6,62,0,1178,148,350,80,182,68,168,103,128,8,87,95,198,38,4,84,85,467,7.88
4711,"Thurl Bailey\baileth01","1993-94",32,"MIN","NBA",2.6,79,3,1297,232,455,232,453,0,2,119,149,66,149,215,54,20,58,58,93,583,6.71
4712,"Renaldo Balkman\balkmre01","2008-09",24,"DEN","NBA",2.6,53,10,780,110,197,108,190,2,7,42,65,86,117,203,34,47,23,35,98,264,6.21
4713,"Matt Barnes\barnema02","2015-16",35,"MEM","NBA",2.6,76,45,2190,264,693,145,323,119,370,111,138,84,336,420,163,78,57,121,234,758,10.1
4714,"Andris Biedriņš\biedran01","2010-11",24,"GSW","NBA",2.6,59,55,1397,142,266,142,266,0,0,10,31,145,281,426,60,52,52,57,198,294,7.75
4715,"Corie Blount\blounco01","1997-98",29,"LAL","NBA",2.6,70,3,1029,107,187,107,183,0,4,39,78,114,184,298,37,29,25,51,157,253,4.87
4716,"Keith Bogans\boganke01","2009-10",29,"SAS","NBA",2.6,79,50,1559,120,298,50,102,70,196,37,50,25,151,176,95,45,12,53,156,347,4.7
4717,"Andrew Bogut\bogutan01","2008-09",24,"MIL","NBA",2.6,36,33,1124,183,317,183,317,0,0,56,98,117,252,369,72,23,37,86,130,422,13.98
4718,"Trevor Booker\booketr01","2010-11",23,"WAS","NBA",2.6,65,14,1063,139,253,139,252,0,1,68,101,98,153,251,35,29,42,38,115,346,6.07
4719,"Carlos Boozer\boozeca01","2008-09",27,"UTA","NBA",2.6,37,37,1197,251,512,251,512,0,0,97,139,111,274,385,79,39,7,79,132,599,15.61
4720,"Jalen Brunson\brunsja01","2018-19",22,"DAL","NBA",2.6,73,38,1591,264,565,201,384,63,181,87,120,25,144,169,230,37,4,88,127,678,8.81
4721,"Matt Bullard\bullama01","2000-01",33,"HOU","NBA",2.6,61,5,1000,129,305,43,92,86,213,10,14,22,108,130,42,10,9,12,76,354,4.72
4722,"Willie Burton\burtowi01","1994-95",26,"PHI","NBA",2.6,53,31,1564,243,606,137,331,106,275,220,267,49,115,164,96,32,19,122,167,812,12.16
4723,"Rasual Butler\butlera01","2006-07",27,"NOK","NBA",2.6,81,38,2223,314,788,180,425,134,363,56,87,42,214,256,63,40,54,67,148,818,7.46
4724,"Rasual Butler\butlera01","2014-15",35,"WAS","NBA",2.6,75,1,1505,218,517,127,282,91,235,53,67,27,170,197,63,29,22,48,98,580,6.23
4725,"Elden Campbell\campbel01","1992-93",24,"LAL","NBA",2.6,79,13,1551,238,520,238,517,0,3,130,204,127,205,332,48,59,100,69,165,606,7.63
4726,"Matt Carroll\carroma01","2005-06",25,"CHA","NBA",2.6,78,6,1275,192,476,120,291,72,185,138,168,34,123,157,35,47,11,48,120,594,5.99
4727,"Austin Croshere\croshau01","2001-02",26,"IND","NBA",2.6,76,1,1286,185,448,136,303,49,145,97,114,74,220,294,77,26,29,67,106,516,6.41
4728,"Jae Crowder\crowdja01","2017-18",27,"TOT","NBA",2.6,80,47,2090,271,671,161,330,110,341,121,148,59,216,275,99,64,21,74,187,773,8.24
4729,"Terry Cummings\cummite01","1998-99",37,"GSW","NBA",2.6,50,0,1011,186,424,185,423,1,1,81,114,95,160,255,58,46,10,58,168,454,8.28
4730,"Terry Cummings\cummite01","1997-98",36,"TOT","NBA",2.6,74,3,1185,200,428,200,427,0,1,67,98,97,186,283,47,38,10,51,181,467,5.76
4731,"Dell Curry\curryde01","1998-99",34,"MIL","NBA",2.6,42,0,864,163,336,94,191,69,145,28,34,18,67,85,48,36,3,45,42,423,8.48
4732,"Ed Davis\davised01","2013-14",24,"MEM","NBA",2.6,63,4,956,155,290,155,290,0,0,47,89,92,168,260,27,17,43,40,114,357,5.86
4733,"Todd Day\dayto01","1992-93",23,"MIL","NBA",2.6,71,37,1931,358,828,304,644,54,184,213,297,144,147,291,117,75,48,118,222,983,11.55
4734,"Andrew DeClercq\declean01","2002-03",29,"ORL","NBA",2.6,77,21,1327,149,279,149,279,0,0,67,104,142,197,339,52,39,36,84,258,365,5.85
4735,"Cheick Diallo\diallch01","2018-19",22,"NOP","NBA",2.6,64,1,896,168,271,167,267,1,4,50,67,75,257,332,33,29,33,49,113,387,7.28
4736,"Ike Diogu\dioguik01","2005-06",22,"GSW","NBA",2.6,69,14,1031,175,334,175,334,0,0,136,168,95,134,229,29,15,30,78,164,486,6.63
4737,"Sherman Douglas\douglsh01","1992-93",26,"BOS","NBA",2.6,79,36,1932,264,530,258,501,6,29,84,150,65,97,162,508,49,10,161,166,618,10.16
4738,"Wayne Ellington\ellinwa01","2018-19",31,"TOT","NBA",2.6,53,38,1297,184,457,46,85,138,372,39,49,14,93,107,72,54,6,40,92,545,8.42
4739,"Monta Ellis\ellismo01","2011-12",26,"TOT","NBA",2.6,58,58,2120,450,1040,388,839,62,201,219,275,20,180,200,346,85,18,177,136,1181,17.77
4740,"Pervis Ellison\ellispe01","1995-96",28,"BOS","NBA",2.6,69,29,1431,145,295,145,295,0,0,75,117,151,300,451,62,39,99,84,207,365,7.71
4741,"James Ennis\ennisja01","2018-19",28,"TOT","NBA",2.6,58,27,1230,138,294,83,138,55,156,58,81,60,122,182,41,41,23,34,150,389,6.69
4742,"Maurice Evans\evansma01","2006-07",28,"LAL","NBA",2.6,76,10,1732,234,542,186,409,48,133,122,155,93,128,221,74,38,14,57,126,638,6.93
4743,"Raymond Felton\feltora01","2005-06",21,"CHA","NBA",2.6,80,54,2406,345,883,248,612,97,271,161,222,77,188,265,446,102,8,182,181,948,12.12
4744,"Matt Geiger\geigema01","1999-00",30,"PHI","NBA",2.6,65,20,1406,260,589,260,585,0,4,109,140,154,233,387,39,29,22,91,194,629,8.23
4745,"Devean George\georgde01","2005-06",28,"LAL","NBA",2.6,71,5,1542,170,425,120,265,50,160,58,86,82,192,274,68,66,34,54,159,448,6.4
4746,"Daniel Gibson\gibsoda01","2009-10",23,"CLE","NBA",2.6,56,10,1068,125,268,54,119,71,149,34,49,13,60,73,70,25,7,36,79,355,5.71
4747,"Kendall Gill\gillke01","1998-99",30,"NJN","NBA",2.6,50,47,1606,236,593,234,576,2,17,114,167,61,183,244,123,134,26,71,162,588,11.64
4748,"Dion Glover\glovedi01","2002-03",24,"ATL","NBA",2.6,76,42,1890,277,648,221,490,56,158,127,162,62,220,282,141,71,15,108,146,737,8.86
4749,"Eric Gordon\gordoer01","2018-19",30,"HOU","NBA",2.6,68,53,2158,384,938,168,338,216,600,119,152,17,131,148,129,41,27,90,143,1103,11.71
4750,"JaMychal Green\greenja01","2017-18",27,"MEM","NBA",2.6,55,54,1542,223,488,180,361,43,127,80,111,147,317,464,79,32,25,76,153,569,10.81
4751,"JaMychal Green\greenja01","2015-16",25,"MEM","NBA",2.6,78,15,1446,230,495,215,450,15,45,103,137,139,234,373,67,46,33,83,189,578,7.37
4752,"Tom Hammonds\hammoto01","1994-95",27,"DEN","NBA",2.6,70,5,956,139,260,139,259,0,1,132,177,55,167,222,36,11,14,56,132,410,5.72
4753,"Tim Hardaway\hardati02","2017-18",25,"NYK","NBA",2.6,57,54,1885,360,856,230,446,130,410,146,179,32,192,224,155,62,10,92,123,996,13.94
4754,"Matt Harpring\harprma01","2000-01",24,"CLE","NBA",2.6,56,55,1615,238,524,225,472,13,52,134,165,90,152,242,102,42,17,90,161,623,10.02
4755,"Matt Harpring\harprma01","1998-99",22,"ORL","NBA",2.6,50,22,1114,148,320,138,295,10,25,102,143,88,126,214,45,30,6,73,112,408,7.56
4756,"Al Harrington\harrial01","2001-02",21,"IND","NBA",2.6,44,1,1313,230,484,229,481,1,3,115,144,96,180,276,54,41,21,78,166,576,11.85
4757,"Gary Harris\harriga01","2018-19",24,"DEN","NBA",2.6,57,48,1639,270,637,188,395,82,242,115,144,41,119,160,127,55,19,68,113,737,10.68
4758,"Trenton Hassell\hassetr01","2006-07",27,"MIN","NBA",2.6,76,68,2223,217,443,211,418,6,25,72,92,83,160,243,203,22,26,80,144,512,7.37
4759,"Hersey Hawkins\hawkihe01","1999-00",33,"CHI","NBA",2.6,61,49,1622,159,375,104,234,55,141,107,119,31,144,175,134,74,15,100,146,480,8.6
4760,"Alan Henderson\hendeal01","2002-03",30,"ATL","NBA",2.6,82,3,1494,153,327,153,325,0,2,88,138,156,242,398,41,33,32,61,168,394,5.48
4761,"Willy Hernangómez\hernawi01","2018-19",24,"CHO","NBA",2.6,58,3,812,153,295,138,256,15,39,100,144,117,194,311,60,16,20,58,98,421,7.84
4762,"Nenê Hilário\hilarne01","2017-18",35,"HOU","NBA",2.6,52,4,758,136,239,136,237,0,2,68,107,54,122,176,45,28,14,38,123,340,6.75
4763,"Kirk Hinrich\hinriki01","2008-09",28,"CHI","NBA",2.6,51,4,1339,183,419,114,250,69,169,68,86,16,107,123,197,66,19,87,126,503,10.63
4764,"Rondae Hollis-Jefferson\holliro01","2016-17",22,"BRK","NBA",2.6,78,50,1761,235,542,220,475,15,67,190,253,96,356,452,154,82,44,116,177,675,9.82
4765,"Rodney Hood\hoodro01","2018-19",26,"TOT","NBA",2.6,72,49,1893,292,671,208,435,84,236,137,155,25,132,157,126,59,12,55,146,805,9.21
4766,"Rodney Hood\hoodro01","2016-17",24,"UTA","NBA",2.6,59,55,1593,272,666,158,359,114,307,90,115,16,186,202,96,38,11,65,132,748,9.73
4767,"Robert Horry\horryro01","2000-01",30,"LAL","NBA",2.6,79,1,1587,147,380,93,224,54,156,59,83,93,203,296,128,54,54,79,210,407,6.2
4768,"Juwan Howard\howarju01","2009-10",36,"POR","NBA",2.6,73,27,1632,191,375,191,374,0,1,55,70,108,227,335,61,27,10,72,191,437,6.24
4769,"Steven Hunter\huntest01","2004-05",23,"PHO","NBA",2.6,76,3,1046,135,220,135,219,0,1,78,163,98,129,227,13,4,102,44,131,348,5.12
4770,"Jarrett Jack\jackja01","2014-15",31,"BRK","NBA",2.6,80,27,2241,359,817,320,671,39,146,200,227,19,226,245,373,75,13,191,143,957,12.01
4771,"Marc Jackson\jacksma02","2000-01",26,"GSW","NBA",2.6,48,35,1410,237,508,232,485,5,23,154,192,119,242,361,59,34,27,93,138,633,12.41
4772,"Casey Jacobsen\jacobca01","2003-04",22,"PHO","NBA",2.6,78,13,1828,150,360,75,180,75,180,91,111,42,159,201,98,48,9,68,144,466,6.02
4773,"Antawn Jamison\jamisan01","2010-11",34,"CLE","NBA",2.6,56,38,1842,374,876,283,613,91,263,171,234,86,289,375,93,50,30,77,137,1010,14.42
4774,"Jared Jeffries\jeffrja01","2004-05",23,"WAS","NBA",2.6,77,71,2007,203,434,187,383,16,51,101,173,152,222,374,151,66,35,114,206,523,8.02
4775,"Avery Johnson\johnsav01","2000-01",35,"SAS","NBA",2.6,55,20,1290,134,300,133,294,1,6,41,60,21,64,85,237,33,4,60,90,310,6.94
4776,"James Johnson\johnsja01","2011-12",24,"TOR","NBA",2.6,62,40,1561,233,518,214,458,19,60,81,115,74,218,292,122,71,84,101,177,566,9.92
4777,"Wesley Johnson\johnswe01","2015-16",28,"LAC","NBA",2.6,80,9,1666,208,515,105,206,103,309,30,46,37,211,248,49,89,56,54,173,549,6.59
4778,"Fred Jones\jonesfr01","2005-06",26,"IND","NBA",2.6,68,2,1837,233,559,170,372,63,187,122,160,18,152,170,154,55,20,107,142,651,8.57
4779,"Luke Kennard\kennalu01","2017-18",21,"DET","NBA",2.6,73,9,1463,206,465,125,270,81,195,65,76,21,155,176,124,44,13,69,86,558,7.13
4780,"Kyle Korver\korveky01","2009-10",28,"UTA","NBA",2.6,52,0,952,138,280,79,170,59,110,39,49,10,101,111,89,26,12,42,76,374,7.12
4781,"Kosta Koufos\koufoko01","2016-17",27,"SAC","NBA",2.6,71,62,1419,216,392,216,391,0,1,38,62,118,285,403,47,36,48,61,172,470,7.55
4782,"Larry Krystkowiak\krystla01","1992-93",28,"UTA","NBA",2.6,71,0,1362,198,425,198,424,0,1,117,147,74,205,279,68,42,13,62,181,513,6.94
4783,"Christian Laettner\laettch01","2001-02",32,"WAS","NBA",2.6,57,48,1441,168,362,166,352,2,10,66,76,74,227,301,151,60,25,85,129,404,9.08
4784,"Zach LaVine\lavinza01","2015-16",20,"MIN","NBA",2.6,82,33,2294,433,959,310,643,123,316,161,203,27,201,228,251,69,17,155,193,1150,11.99
4785,"Shaun Livingston\livinsh01","2016-17",31,"GSW","NBA",2.6,76,3,1345,173,316,172,313,1,3,42,60,28,123,151,139,38,20,62,120,389,5.78
4786,"Shaun Livingston\livinsh01","2012-13",27,"TOT","NBA",2.6,66,16,1455,166,346,166,342,0,4,85,98,31,127,158,215,48,31,76,127,417,7.87
4787,"Grant Long\longgr01","1996-97",30,"DET","NBA",2.6,65,24,1166,123,275,106,228,17,47,63,84,88,134,222,39,43,6,48,106,326,5.19
4788,"George Lynch\lynchge01","1998-99",28,"PHI","NBA",2.6,43,43,1315,147,349,138,326,9,23,53,84,110,169,279,76,85,22,79,142,356,9.84
4789,"Corey Maggette\maggeco01","1999-00",20,"ORL","NBA",2.6,77,5,1370,224,469,222,458,2,11,196,261,123,180,303,61,24,26,138,169,646,7.63
4790,"Jamaal Magloire\magloja01","2000-01",22,"CHH","NBA",2.6,74,0,1095,122,271,122,269,0,2,95,145,103,192,295,27,18,78,61,139,339,5.24
4791,"Dan Majerle\majerda01","2000-01",35,"MIA","NBA",2.6,53,19,1306,87,259,30,78,57,181,36,44,20,146,166,88,53,15,35,98,267,5.83
4792,"Danny Manning\mannida01","2000-01",34,"UTA","NBA",2.6,82,0,1305,247,500,240,472,7,28,102,140,66,148,214,92,47,29,96,219,603,6.75
4793,"Danny Manning\mannida01","1998-99",32,"PHO","NBA",2.6,50,5,1184,187,386,186,377,1,9,78,112,62,157,219,113,36,38,69,129,453,9.47
4794,"Šarūnas Marčiulionis\marcisa01","1995-96",31,"SAC","NBA",2.6,53,0,1039,176,389,112,232,64,157,155,200,20,57,77,118,52,4,96,112,571,9.8
4795,"Wesley Matthews\matthwe02","2017-18",31,"DAL","NBA",2.6,63,62,2131,283,697,130,295,153,402,83,101,28,170,198,172,76,16,83,140,802,11.22
4796,"Jason Maxiell\maxieja01","2009-10",26,"DET","NBA",2.6,76,29,1550,212,415,212,414,0,1,89,155,161,240,401,39,36,38,68,175,513,6.99
4797,"George McCloud\mccloge01","2000-01",33,"DEN","NBA",2.6,76,8,2007,250,655,173,421,77,234,152,181,55,169,224,279,53,27,117,165,729,9.42
4798,"Doug McDermott\mcderdo01","2016-17",25,"TOT","NBA",2.6,66,5,1508,222,497,145,289,77,208,71,84,20,159,179,58,13,5,38,79,592,6.92
4799,"Nate McMillan\mcmilna01","1996-97",32,"SEA","NBA",2.6,37,2,798,61,149,33,65,28,84,19,29,15,103,118,140,58,6,32,78,169,7.91
4800,"C.J. Miles\milescj01","2012-13",25,"CLE","NBA",2.6,65,13,1364,255,614,129,286,126,328,93,107,24,150,174,63,49,17,69,138,729,8.77
4801,"Mike Miller\millemi01","2012-13",32,"MIA","NBA",2.6,59,17,900,100,231,27,56,73,175,8,11,18,139,157,99,21,4,35,63,281,5.32
4802,"Mikki Moore\mooremi01","2004-05",29,"LAC","NBA",2.6,74,4,1178,144,287,143,282,1,5,107,136,97,149,246,47,19,32,63,173,396,5.59
4803,"Jermaine O'Neal\onealje01","2008-09",30,"TOT","NBA",2.6,68,61,2027,365,770,365,769,0,1,175,222,126,307,433,122,29,136,144,211,905,12.88
4804,"Patrick Patterson\pattepa01","2017-18",28,"OKC","NBA",2.6,82,3,1270,106,266,40,95,66,171,40,46,32,161,193,57,48,23,33,87,318,4.3
4805,"Tim Perry\perryti01","1993-94",28,"PHI","NBA",2.6,80,68,2336,272,625,199,425,73,200,102,176,117,287,404,94,60,82,80,154,719,8.82
4806,"Wesley Person\persowe01","1998-99",27,"CLE","NBA",2.6,45,42,1342,198,437,123,237,75,200,32,53,19,123,142,80,37,16,41,52,503,9.53
4807,"Miles Plumlee\plumlmi01","2014-15",26,"TOT","NBA",2.6,73,28,1194,136,254,136,254,0,0,22,46,112,208,320,34,41,66,51,111,294,5.48
4808,"Olden Polynice\polynol01","1992-93",28,"DET","NBA",2.6,67,18,1299,210,429,210,428,0,1,66,142,181,237,418,29,31,21,54,126,486,7.05
4809,"Chris Quinn\quinnch01","2007-08",24,"MIA","NBA",2.6,60,25,1340,158,373,94,214,64,159,85,98,11,107,118,178,46,4,55,90,465,8.04
4810,"Eldridge Recasner\recasel01","1995-96",28,"HOU","NBA",2.6,63,27,1275,149,359,68,168,81,191,57,66,31,113,144,170,23,5,61,111,436,7.04
4811,"Malik Rose\rosema01","1998-99",24,"SAS","NBA",2.6,47,0,608,93,201,93,200,0,1,98,146,90,92,182,29,40,22,56,120,284,6.59
4812,"Malik Rose\rosema01","2004-05",30,"TOT","NBA",2.6,76,5,1475,198,441,197,431,1,10,137,186,129,212,341,59,46,16,102,208,534,6.84
4813,"Brandon Rush\rushbr01","2010-11",25,"IND","NBA",2.6,67,21,1754,217,515,124,292,93,223,80,106,33,184,217,62,41,35,69,107,607,7.74
4814,"Bryon Russell\russebr01","2004-05",34,"DEN","NBA",2.6,70,2,1026,95,252,39,103,56,149,61,77,50,122,172,72,44,11,35,130,307,4.76
4815,"Dennis Schröder\schrode01","2017-18",24,"ATL","NBA",2.6,67,67,2078,500,1146,424,884,76,262,225,265,44,164,208,417,72,6,183,147,1301,16.93
4816,"Mike Scott\scottmi01","2013-14",25,"ATL","NBA",2.6,80,6,1482,301,628,239,428,62,200,103,132,62,222,284,75,30,7,79,121,767,7.96
4817,"Thabo Sefolosha\sefolth01","2017-18",33,"UTA","NBA",2.6,38,6,806,118,240,86,156,32,84,44,54,29,132,161,33,52,12,30,59,312,8.82
4818,"Joe Smith\smithjo02","1997-98",22,"TOT","NBA",2.6,79,55,2344,464,1070,464,1062,0,8,227,293,199,272,471,94,62,51,158,263,1155,11.61
4819,"Darius Songaila\songada01","2003-04",25,"SAC","NBA",2.6,73,7,976,133,273,133,273,0,0,71,88,91,134,225,48,42,12,43,126,337,5.02
4820,"Tyrus Thomas\thomaty01","2009-10",23,"TOT","NBA",2.6,54,3,1220,194,420,194,417,0,3,120,175,81,254,335,56,63,85,92,129,508,10.47
4821,"Hollis Thompson\thompho01","2014-15",23,"PHI","NBA",2.6,71,23,1776,224,543,109,256,115,287,63,89,53,145,198,85,57,26,66,141,626,7.59
4822,"Tristan Thompson\thomptr01","2018-19",27,"CLE","NBA",2.6,43,40,1198,201,380,201,380,0,0,68,106,173,265,438,86,28,16,59,89,470,12.65
4823,"Hedo Türkoğlu\turkohe01","2002-03",23,"SAC","NBA",2.6,67,11,1175,165,391,136,313,29,78,88,110,35,153,188,87,25,12,50,125,447,5.97
4824,"Evan Turner\turneev01","2017-18",29,"POR","NBA",2.6,79,40,2034,258,577,216,445,42,132,91,107,30,214,244,173,47,29,99,163,649,7.95
4825,"Von Wafer\wafervo01","2008-09",23,"HOU","NBA",2.6,63,11,1225,229,512,165,348,64,164,88,117,19,94,113,71,40,8,59,71,610,7.49
4826,"Antoine Walker\walkean02","2002-03",26,"BOS","NBA",2.6,78,78,3235,603,1554,415,972,188,582,176,286,99,464,563,373,116,31,260,221,1570,16.71
4827,"Antoine Walker\walkean02","1998-99",22,"BOS","NBA",2.6,42,41,1549,303,735,238,559,65,176,113,202,106,253,359,130,63,28,119,142,784,16.01
4828,"C.J. Watson\watsocj01","2011-12",27,"CHI","NBA",2.6,49,25,1159,161,437,93,264,68,173,84,104,21,84,105,200,45,8,97,103,474,9.33
4829,"Earl Watson\watsoea01","2009-10",30,"IND","NBA",2.6,79,52,2322,223,524,170,340,53,184,120,169,54,186,240,399,104,16,175,181,619,10.28
4830,"Clarence Weatherspoon\weathcl01","2003-04",33,"TOT","NBA",2.6,52,1,868,104,211,104,210,0,1,53,72,74,130,204,30,30,15,35,75,261,5.58
4831,"David Wesley\wesleda01","1994-95",24,"BOS","NBA",2.6,51,36,1380,128,313,77,194,51,119,71,94,31,86,117,266,82,9,87,144,378,10.24
4832,"David Wesley\wesleda01","2001-02",31,"CHH","NBA",2.6,67,63,2487,364,910,279,654,85,256,138,188,44,99,143,236,74,15,119,147,951,11.14
4833,"David West\westda01","2016-17",36,"GSW","NBA",2.6,68,0,854,135,252,132,244,3,8,43,56,47,156,203,151,42,48,78,105,316,6.63
4834,"Doug West\westdo01","1993-94",26,"MIN","NBA",2.6,72,61,2182,434,891,433,883,1,8,187,231,61,170,231,172,65,24,137,236,1056,12.26
4835,"Chris Wilcox\wilcoch01","2003-04",21,"LAC","NBA",2.6,65,17,1340,227,436,227,435,0,1,105,150,125,180,305,51,29,20,80,183,559,8.11
4836,"Derrick Williams\willide02","2013-14",22,"TOT","NBA",2.6,78,15,1820,206,482,180,383,26,99,186,259,71,252,323,56,48,20,76,114,624,7.31
4837,"Jerome Williams\willije01","2004-05",31,"NYK","NBA",2.6,79,4,1211,122,243,122,238,0,5,115,172,115,168,283,41,55,10,65,155,359,5.3
4838,"Lou Williams\willilo02","2013-14",27,"ATL","NBA",2.6,60,7,1445,197,493,118,262,79,231,152,179,10,114,124,210,45,4,92,65,625,9.87
4839,"Scott Williams\willisc01","1996-97",28,"PHI","NBA",2.6,62,52,1317,162,318,162,316,0,2,38,55,155,242,397,41,44,41,50,206,362,7.38
4840,"Justise Winslow\winslju01","2017-18",21,"MIA","NBA",2.6,68,25,1680,207,488,158,359,49,129,66,104,64,306,370,148,54,33,77,140,529,8.58
4841,"Metta World Peace\artesro01","2011-12",32,"LAL","NBA",2.6,64,45,1720,183,465,127,276,56,189,71,115,71,147,218,140,69,27,69,137,493,7.75
4842,"Cody Zeller\zelleco01","2013-14",21,"CHA","NBA",2.6,82,3,1416,172,404,172,403,0,1,146,200,118,235,353,92,40,41,87,170,490,6.45
4843,"Tyler Zeller\zellety01","2013-14",24,"CLE","NBA",2.6,70,9,1049,156,290,156,289,0,1,87,121,103,179,282,36,18,38,60,137,399,6.11
4844,"Quincy Acy\acyqu01","2015-16",25,"SAC","NBA",2.5,59,29,876,119,214,100,165,19,49,50,68,65,123,188,27,29,24,27,103,307,5.72
4845,"Lavoy Allen\allenla01","2012-13",23,"PHI","NBA",2.5,79,37,1669,206,454,206,453,0,1,43,60,159,236,395,73,24,55,55,180,455,6.13
4846,"Ryan Anderson\anderry01","2008-09",20,"NJN","NBA",2.5,66,30,1312,160,407,91,218,69,189,98,116,104,207,311,52,44,20,63,157,487,7.24
4847,"Trevor Ariza\arizatr01","2018-19",33,"TOT","NBA",2.5,69,69,2349,294,736,149,302,145,434,130,164,50,321,371,252,91,21,106,130,863,12.79
4848,"Darrell Armstrong\armstda01","1997-98",29,"ORL","NBA",2.5,48,17,1236,156,380,131,312,25,68,105,123,65,94,159,236,58,5,112,96,442,10.86
4849,"Carlos Arroyo\arroyca01","2006-07",27,"ORL","NBA",2.5,72,5,1304,203,478,189,427,14,51,132,166,31,103,134,202,39,2,90,131,552,7.23
4850,"Stacey Augmon\augmost01","2000-01",32,"POR","NBA",2.5,66,23,1182,127,266,127,262,0,4,57,87,60,99,159,98,48,21,48,105,311,5.43
4851,"Andrea Bargnani\bargnan01","2010-11",25,"TOR","NBA",2.5,66,66,2353,525,1173,448,950,77,223,287,350,74,269,343,119,34,46,152,160,1414,16.13
4852,"Marco Belinelli\belinma01","2018-19",32,"SAS","NBA",2.5,79,1,1815,285,690,138,295,147,395,112,124,16,182,198,132,35,8,72,121,829,8.45
4853,"Travis Best\besttr01","2004-05",32,"NJN","NBA",2.5,76,6,1461,190,452,164,367,26,85,108,122,19,88,107,143,66,9,67,148,514,6.36
4854,"Eric Bledsoe\bledser01","2015-16",26,"PHO","NBA",2.5,31,31,1059,223,492,175,363,48,129,138,172,18,107,125,190,63,19,110,75,632,20.08
4855,"Corie Blount\blounco01","1996-97",28,"LAL","NBA",2.5,58,18,1009,92,179,91,176,1,3,56,83,113,163,276,35,22,26,50,121,241,5.46
4856,"Keith Bogans\boganke01","2008-09",28,"TOT","NBA",2.5,65,15,1272,119,324,45,106,74,218,52,57,31,171,202,64,43,4,41,105,364,5.45
4857,"Matt Bonner\bonnema01","2012-13",32,"SAS","NBA",2.5,68,4,909,112,230,59,110,53,120,11,15,25,104,129,36,17,19,16,86,288,4.08
4858,"Anthony Bowie\bowiean01","1992-93",29,"ORL","NBA",2.5,77,45,1761,268,569,253,521,15,48,67,84,36,158,194,175,54,14,84,131,618,7.58
4859,"Avery Bradley\bradlav01","2014-15",24,"BOS","NBA",2.5,77,77,2428,434,1012,310,660,124,352,79,100,46,195,241,135,82,15,109,177,1071,10.54
4860,"Dee Brown\brownde01","1998-99",30,"TOR","NBA",2.5,49,0,1377,187,495,52,146,135,349,40,55,15,88,103,143,56,8,80,75,549,9.68
4861,"Kwame Brown\brownkw01","2002-03",20,"WAS","NBA",2.5,80,20,1773,224,502,224,499,0,3,145,217,128,298,426,58,50,80,110,159,593,7.74
4862,"Mark Bryant\bryanma01","1997-98",32,"PHO","NBA",2.5,70,22,1110,109,225,109,224,0,1,73,95,92,152,244,46,36,15,58,180,291,4.92
4863,"Matt Bullard\bullama01","1997-98",30,"HOU","NBA",2.5,67,24,1190,175,389,79,158,96,231,20,27,25,121,146,60,31,24,39,104,466,6.11
4864,"Michael Cage\cagemi01","1997-98",36,"NJN","NBA",2.5,79,17,1201,43,84,43,83,0,1,20,36,115,193,308,32,45,44,23,105,106,3.54
4865,"Tony Campbell\campbto01","1992-93",30,"NYK","NBA",2.5,58,13,1062,194,396,192,391,2,5,59,87,59,96,155,62,34,5,51,150,449,6.57
4866,"Omri Casspi\casspom01","2009-10",21,"SAC","NBA",2.5,77,31,1931,300,672,225,469,75,203,117,174,75,274,349,95,54,17,98,125,792,8.97
4867,"Omri Casspi\casspom01","2010-11",22,"SAC","NBA",2.5,71,27,1702,225,546,133,299,92,247,68,101,74,233,307,74,54,13,68,115,610,7.64
4868,"Tom Chambers\chambto01","1994-95",35,"UTA","NBA",2.5,81,4,1240,195,427,191,403,4,24,109,135,66,147,213,73,25,30,52,173,503,5.6
4869,"Rex Chapman\chapmre01","1994-95",27,"WSB","NBA",2.5,45,29,1468,254,639,168,365,86,274,137,159,23,90,113,128,67,15,62,85,731,13.08
4870,"Pat Connaughton\connapa01","2017-18",25,"POR","NBA",2.5,82,5,1488,165,390,91,180,74,210,37,44,36,125,161,91,23,22,43,120,441,4.85
4871,"Tyrone Corbin\corbity01","1995-96",33,"TOT","NBA",2.5,71,2,1284,155,351,152,333,3,18,100,120,81,163,244,84,63,20,67,147,413,6.4
4872,"Robert Covington\covinro01","2018-19",28,"TOT","NBA",2.5,35,35,1203,156,362,71,137,85,225,68,89,28,165,193,46,74,47,47,126,465,13.77
4873,"Marquis Daniels\daniema01","2004-05",24,"DAL","NBA",2.5,60,17,1412,220,504,213,469,7,35,98,133,87,129,216,128,83,14,86,124,545,8.92
4874,"Glen Davis\davisgl01","2007-08",22,"BOS","NBA",2.5,69,1,940,107,221,107,221,0,0,99,150,95,113,208,28,31,20,65,160,313,4.76
4875,"Hubert Davis\davishu01","1999-00",29,"DAL","NBA",2.5,79,15,1817,217,464,135,297,82,167,67,77,17,117,134,141,24,3,70,109,583,6.57
4876,"Todd Day\dayto01","1999-00",30,"PHO","NBA",2.5,58,1,941,130,330,66,165,64,165,72,108,31,98,129,65,44,22,50,127,396,6.19
4877,"Andrew DeClercq\declean01","2000-01",27,"ORL","NBA",2.5,67,51,903,107,193,107,193,0,0,47,82,91,145,236,32,41,33,51,198,261,5.01
4878,"Tony Delk\delkto01","2001-02",28,"TOT","NBA",2.5,63,17,1447,226,588,159,374,67,214,78,97,58,145,203,132,53,10,59,98,597,7.97
4879,"DeMar DeRozan\derozde01","2011-12",22,"TOR","NBA",2.5,63,63,2206,381,903,357,811,24,92,268,331,40,171,211,128,48,17,123,162,1054,12.43
4880,"Travis Diener\dienetr01","2007-08",25,"IND","NBA",2.5,66,21,1356,159,430,85,197,74,233,64,71,26,89,115,251,35,4,55,107,456,7.2
4881,"Toney Douglas\douglto01","2015-16",29,"NOP","NBA",2.5,61,18,1262,183,445,102,242,81,203,84,99,25,118,143,157,70,5,64,131,531,8.64
4882,"Kevin Duckworth\duckwke01","1992-93",28,"POR","NBA",2.5,74,55,1762,301,688,301,686,0,2,127,174,118,269,387,70,45,39,87,222,729,8.45
4883,"Kevin Edwards\edwarke01","1992-93",27,"MIA","NBA",2.5,40,30,1134,216,462,211,445,5,17,119,141,48,73,121,120,68,12,75,69,556,12.97
4884,"Evan Eschmeyer\eschmev01","2000-01",25,"NJN","NBA",2.5,74,51,1331,92,200,92,200,0,0,67,102,135,231,366,40,41,58,53,220,251,5.27
4885,"T.J. Ford\fordtj01","2005-06",22,"MIL","NBA",2.5,72,70,2557,328,789,293,685,35,104,187,248,63,248,311,473,104,7,219,196,878,13.85
4886,"Dan Gadzuric\gadzuda01","2005-06",27,"MIL","NBA",2.5,74,0,885,171,309,171,308,0,1,41,89,91,141,232,24,25,43,35,171,383,5.14
4887,"Pat Garrity\garripa01","2000-01",24,"ORL","NBA",2.5,76,1,1579,223,576,126,352,97,224,85,98,51,159,210,51,40,15,68,241,628,6.3
4888,"Ryan Gomes\gomesry01","2010-11",28,"LAC","NBA",2.5,76,62,2095,207,505,135,294,72,211,61,85,61,193,254,118,62,12,55,159,547,6.86
4889,"Ryan Gomes\gomesry01","2008-09",26,"MIN","NBA",2.5,82,76,2614,420,974,314,689,106,285,146,181,106,286,392,135,63,22,128,183,1092,10.9
4890,"Eric Gordon\gordoer01","2013-14",25,"NOP","NBA",2.5,64,64,2057,356,817,255,559,101,258,175,223,30,135,165,208,74,12,134,114,988,13.02
4891,"Jerian Grant\grantje02","2016-17",24,"CHI","NBA",2.5,63,28,1028,128,301,79,167,49,134,65,73,17,94,111,121,47,8,44,93,370,6.17
4892,"Willie Green\greenwi01","2012-13",31,"LAC","NBA",2.5,72,60,1188,178,386,107,220,71,166,23,32,17,80,97,55,29,12,31,96,450,5.03
4893,"Othella Harrington\harriot01","2000-01",27,"TOT","NBA",2.5,74,45,1815,247,507,247,504,0,3,171,224,139,249,388,56,34,45,145,237,665,8.75
4894,"Devin Harris\harride01","2017-18",34,"TOT","NBA",2.5,71,1,1340,187,454,108,227,79,227,142,170,12,115,127,152,47,12,76,158,595,7.79
4895,"Devin Harris\harride01","2015-16",32,"DAL","NBA",2.5,64,0,1280,167,374,115,216,52,158,101,140,18,120,138,118,60,13,66,124,487,7.55
4896,"Lucious Harris\harrilu01","2003-04",33,"NJN","NBA",2.5,69,15,1504,187,463,149,362,38,101,66,78,39,101,140,135,41,2,53,74,478,6.04
4897,"Udonis Haslem\hasleud01","2007-08",27,"MIA","NBA",2.5,49,48,1805,237,507,237,507,0,0,115,142,107,336,443,68,39,18,67,145,589,12.13
4898,"Rod Higgins\higgiro01","1992-93",33,"SAC","NBA",2.5,69,4,1425,199,483,156,350,43,133,130,151,66,127,193,119,51,29,63,141,571,7.77
4899,"Grant Hill\hillgr01","2002-03",30,"ORL","NBA",2.5,29,29,843,151,307,150,303,1,4,118,144,40,166,206,122,28,13,84,46,421,15.9
4900,"Justin Holiday\holidju01","2016-17",27,"NYK","NBA",2.5,82,4,1639,233,538,136,265,97,273,66,80,27,198,225,102,65,31,66,109,629,7.17
4901,"Troy Hudson\hudsotr01","2001-02",25,"ORL","NBA",2.5,81,4,1854,354,815,288,628,66,187,176,201,30,115,145,255,57,6,163,119,950,9.99
4902,"Steven Hunter\huntest01","2005-06",24,"PHI","NBA",2.5,69,35,1312,175,291,175,291,0,0,71,138,110,161,271,17,12,76,64,120,421,6.46
4903,"Zydrunas Ilgauskas\ilgauzy01","2009-10",34,"CLE","NBA",2.5,64,6,1339,194,438,183,415,11,23,75,101,114,231,345,48,14,50,63,183,474,7.11
4904,"Zydrunas Ilgauskas\ilgauzy01","2001-02",26,"CLE","NBA",2.5,62,23,1329,241,567,241,562,0,5,208,276,136,198,334,70,17,84,94,187,690,10.01
4905,"Bobby Jackson\jacksbo01","2006-07",33,"NOK","NBA",2.5,56,2,1330,204,518,150,353,54,165,130,168,42,136,178,141,50,6,78,98,592,9.28
4906,"Jim Jackson\jacksji01","1998-99",28,"POR","NBA",2.5,49,9,1175,152,370,127,280,25,90,85,101,36,123,159,128,43,6,82,80,414,8.36
4907,"Jim Jackson\jacksji01","1997-98",27,"TOT","NBA",2.5,79,78,3046,476,1107,415,916,61,191,229,282,130,270,400,381,79,8,263,186,1242,14.53
4908,"Jim Jackson\jacksji01","2002-03",32,"SAC","NBA",2.5,63,0,1309,204,462,172,391,32,71,47,55,84,178,262,118,31,4,80,132,487,7.35
4909,"Reggie Jackson\jacksre01","2012-13",22,"OKC","NBA",2.5,70,0,993,149,325,125,221,24,104,52,62,21,145,166,122,29,13,53,84,374,5.6
4910,"James Jones\jonesja02","2004-05",24,"IND","NBA",2.5,75,24,1330,126,318,60,152,66,166,53,62,39,135,174,57,31,28,43,123,371,4.74
4911,"Luke Kennard\kennalu01","2018-19",22,"DET","NBA",2.5,63,10,1437,228,520,122,251,106,269,51,61,12,171,183,114,26,10,57,92,613,8.29
4912,"Jerome Kersey\kerseje01","1994-95",32,"POR","NBA",2.5,63,0,1143,203,489,196,462,7,27,95,124,93,163,256,82,52,35,64,173,508,7.49
4913,"Michael Kidd-Gilchrist\kiddgmi01","2018-19",25,"CHO","NBA",2.5,64,3,1179,158,332,142,285,16,47,95,123,88,158,246,61,32,39,43,156,427,6.98
4914,"Brevin Knight\knighbr01","1998-99",23,"CLE","NBA",2.5,39,38,1186,134,315,134,310,0,5,105,141,16,115,131,302,70,7,105,115,373,13.6
4915,"Tyronn Lue\luety01","2006-07",29,"ATL","NBA",2.5,56,17,1488,218,524,162,363,56,161,144,163,19,85,104,201,24,0,85,101,636,9.91
4916,"George Lynch\lynchge01","2003-04",33,"NOH","NBA",2.5,78,51,1701,149,375,106,236,43,139,34,51,96,216,312,117,48,18,64,159,375,5.55
4917,"George Lynch\lynchge01","1997-98",27,"VAN","NBA",2.5,82,0,1493,248,516,239,486,9,30,111,158,147,215,362,122,65,41,104,161,616,8.04
4918,"Todd MacCulloch\maccuto01","2000-01",25,"PHI","NBA",2.5,63,3,597,109,185,109,185,0,0,42,66,69,99,168,10,7,19,27,96,260,4.11
4919,"Ben McLemore\mclembe01","2014-15",21,"SAC","NBA",2.5,82,82,2670,363,831,223,440,140,391,130,160,31,210,241,140,77,19,138,219,996,10.15
4920,"C.J. Miles\milescj01","2010-11",23,"UTA","NBA",2.5,78,19,1969,366,899,257,560,109,339,159,196,54,201,255,135,74,38,93,221,1000,10.25
4921,"C.J. Miles\milescj01","2013-14",26,"CLE","NBA",2.5,51,34,984,178,409,95,198,83,211,64,75,18,85,103,52,46,15,44,103,503,8.19
4922,"Paul Millsap\millspa01","2017-18",32,"DEN","NBA",2.5,38,37,1143,202,435,163,322,39,113,112,161,65,180,245,105,39,44,73,99,555,14.55
4923,"Nazr Mohammed\mohamna01","2000-01",23,"TOT","NBA",2.5,58,22,912,176,369,176,368,0,1,89,126,115,192,307,19,29,35,64,113,441,7.38
4924,"Eric Murdock\murdoer01","1995-96",27,"TOT","NBA",2.5,73,14,1673,244,587,199,442,45,145,114,143,26,143,169,327,135,9,132,140,647,10.41
4925,"Mike Muscala\muscami01","2018-19",27,"TOT","NBA",2.5,64,10,1306,145,361,56,105,89,256,70,85,57,187,244,76,22,38,48,130,449,7
4926,"Gary Neal\nealga01","2011-12",27,"SAS","NBA",2.5,56,7,1206,212,486,129,288,83,198,50,64,12,106,118,117,27,2,60,75,557,8.1
4927,"Jameer Nelson\nelsoja01","2004-05",22,"ORL","NBA",2.5,79,21,1612,286,628,242,487,44,141,73,107,52,141,193,237,78,3,117,199,689,8.52
4928,"Andrés Nocioni\nocioan01","2004-05",25,"CHI","NBA",2.5,81,38,1892,241,601,216,504,25,97,170,222,69,317,386,122,37,34,135,208,677,7.81
4929,"Dirk Nowitzki\nowitdi01","2016-17",38,"DAL","NBA",2.5,54,54,1424,296,678,217,469,79,209,98,112,23,330,353,82,30,38,51,113,769,12.27
4930,"Kyle O'Quinn\oquinky01","2013-14",23,"ORL","NBA",2.5,69,19,1188,186,371,186,368,0,3,57,83,100,264,364,78,39,88,78,165,429,7.74
4931,"Bo Outlaw\outlabo01","1994-95",23,"LAC","NBA",2.5,81,31,1655,170,325,170,320,0,5,82,186,121,192,313,84,90,151,78,227,422,7.41
4932,"Scott Padgett\padgesc01","2002-03",26,"UTA","NBA",2.5,82,2,1321,170,423,125,290,45,133,81,107,83,189,272,86,41,24,70,148,466,5.54
4933,"Anthony Peeler\peelean01","1997-98",28,"TOT","NBA",2.5,38,32,1193,190,420,137,295,53,125,36,47,37,86,123,137,61,6,51,97,469,12.02
4934,"Will Perdue\perduwi01","1992-93",27,"CHI","NBA",2.5,72,16,998,137,246,137,245,0,1,67,111,103,184,287,74,22,47,74,139,341,5.94
4935,"Kendrick Perkins\perkike01","2012-13",28,"OKC","NBA",2.5,78,78,1954,143,313,143,312,0,1,44,72,110,356,466,111,43,83,109,227,330,6.69
4936,"Vitaly Potapenko\potapvi01","1999-00",24,"BOS","NBA",2.5,79,72,1797,307,615,307,614,0,1,109,160,182,317,499,77,41,29,145,239,723,8.98
4937,"Tayshaun Prince\princta01","2014-15",34,"TOT","NBA",2.5,58,16,1397,177,402,146,335,31,67,49,65,52,158,210,93,29,16,35,55,434,7.01
4938,"Eldridge Recasner\recasel01","1996-97",29,"ATL","NBA",2.5,71,4,1207,148,350,90,210,58,140,51,58,35,80,115,94,38,4,65,97,405,5.2
4939,"Khalid Reeves\reevekh01","1997-98",25,"DAL","NBA",2.5,82,54,1950,248,593,192,441,56,152,165,213,54,131,185,230,80,10,130,195,717,8.58
4940,"J.R. Reid\reidjr01","1995-96",27,"TOT","NBA",2.5,65,21,1313,160,324,160,323,0,1,107,142,73,182,255,42,43,17,79,187,427,6.72
4941,"J.R. Reid\reidjr01","1998-99",30,"TOT","NBA",2.5,41,26,1029,132,277,132,276,0,1,105,137,45,167,212,48,37,10,51,135,369,9.21
4942,"Josh Richardson\richajo01","2015-16",22,"MIA","NBA",2.5,52,2,1107,123,272,70,157,53,115,42,63,21,86,107,73,36,25,35,107,341,6.52
4943,"Isaiah Rider\rideris01","1998-99",27,"POR","NBA",2.5,47,41,1385,249,605,207,494,42,111,111,147,59,137,196,104,25,9,95,100,651,10.54
4944,"Austin Rivers\riverau01","2016-17",24,"LAC","NBA",2.5,74,29,2054,323,731,212,432,111,299,132,191,20,141,161,204,48,10,115,187,889,10.07
4945,"Glenn Robinson\robingl02","2016-17",23,"IND","NBA",2.5,69,27,1427,158,338,109,213,49,125,54,76,57,189,246,47,41,20,37,63,419,6.13
4946,"Jalen Rose\roseja01","2005-06",33,"TOT","NBA",2.5,72,45,1983,290,685,231,513,59,172,248,318,28,183,211,181,30,13,115,156,887,10.36
4947,"Brandon Rush\rushbr01","2009-10",24,"IND","NBA",2.5,82,64,2491,297,702,173,400,124,302,56,89,41,305,346,112,56,65,93,159,774,8.62
4948,"John Salley\sallejo01","1992-93",28,"MIA","NBA",2.5,51,34,1422,154,307,154,307,0,0,115,144,113,200,313,83,32,70,101,192,423,10.24
4949,"Dennis Schröder\schrode01","2014-15",21,"ATL","NBA",2.5,77,10,1516,284,665,232,517,52,148,148,179,29,135,164,317,49,4,150,127,768,9.65
4950,"Luis Scola\scolalu01","2013-14",33,"IND","NBA",2.5,82,2,1399,263,560,262,553,1,7,99,136,86,305,391,81,26,16,108,164,626,7.01
4951,"Mike Scott\scottmi01","2017-18",29,"WAS","NBA",2.5,76,1,1406,276,524,210,361,66,163,50,76,50,197,247,80,23,10,79,148,668,7.71
4952,"Thabo Sefolosha\sefolth01","2014-15",30,"ATL","NBA",2.5,52,7,976,104,249,79,171,25,78,45,58,53,170,223,75,53,21,38,67,278,6.72
4953,"Brian Shaw\shawbr01","2000-01",34,"LAL","NBA",2.5,80,28,1833,164,411,122,276,42,135,51,64,48,256,304,258,49,27,97,159,421,7.05
4954,"J.R. Smith\smithjr01","2011-12",26,"NYK","NBA",2.5,35,1,967,165,405,98,212,67,193,39,55,29,107,136,84,54,6,46,87,436,10.96
4955,"Steve Smith\smithst01","2002-03",33,"SAS","NBA",2.5,53,18,1032,113,291,74,173,39,118,95,114,21,78,99,70,28,9,43,79,360,5.98
4956,"Darius Songaila\songada01","2005-06",27,"CHI","NBA",2.5,62,7,1329,236,491,234,486,2,5,94,115,76,170,246,88,35,16,85,157,568,8.33
4957,"Rodney Stuckey\stuckro01","2012-13",26,"DET","NBA",2.5,76,24,2171,304,748,249,566,55,182,213,272,43,169,212,270,51,17,134,127,876,10.36
4958,"Stromile Swift\swiftst01","2005-06",26,"HOU","NBA",2.5,66,5,1344,225,458,225,456,0,2,136,209,103,188,291,25,38,50,91,198,586,8.08
4959,"Etan Thomas\thomaet01","2005-06",27,"WAS","NBA",2.5,71,9,1121,131,246,131,246,0,0,75,125,99,180,279,14,20,68,51,148,337,5.44
4960,"Kurt Thomas\thomaku01","1998-99",26,"NYK","NBA",2.5,50,44,1182,170,368,170,367,0,1,66,108,82,204,286,55,45,17,73,159,406,8.19
4961,"Tristan Thompson\thomptr01","2017-18",26,"CLE","NBA",2.5,53,22,1072,132,235,132,235,0,0,43,79,126,226,352,33,16,17,36,102,307,7.03
4962,"Otis Thorpe\thorpot01","1997-98",35,"TOT","NBA",2.5,74,66,2197,294,624,294,619,0,5,164,240,151,386,537,222,48,30,152,238,752,11.37
4963,"Anthony Tolliver\tollian01","2009-10",24,"TOT","NBA",2.5,46,29,1427,193,449,143,297,50,152,103,134,84,236,320,87,32,33,46,128,539,11.6
4964,"Robert Traylor\traylro01","2003-04",26,"NOH","NBA",2.5,71,0,942,145,287,143,282,2,5,70,128,106,156,262,43,39,37,62,161,362,5.57
4965,"Robert Traylor\traylro01","1998-99",21,"MIL","NBA",2.5,49,43,786,108,201,108,200,0,1,43,80,80,102,182,38,44,44,42,140,259,6.55
4966,"Evan Turner\turneev01","2014-15",26,"BOS","NBA",2.5,82,57,2260,320,746,287,627,33,119,106,141,40,377,417,449,83,19,198,180,779,11.56
4967,"Denzel Valentine\valende01","2017-18",24,"CHI","NBA",2.5,77,37,2095,301,721,158,351,143,370,38,51,48,345,393,244,65,11,99,185,783,10.31
4968,"Jake Voskuhl\voskuja01","2002-03",25,"PHO","NBA",2.5,65,1,947,92,163,92,163,0,0,64,96,97,128,225,36,18,29,48,172,248,4.79
4969,"Eric Williams\willier01","1999-00",27,"BOS","NBA",2.5,68,17,1378,165,386,140,314,25,72,134,169,55,101,156,93,44,16,66,165,489,6.67
4970,"Mo Williams\willima01","2005-06",23,"MIL","NBA",2.5,58,12,1531,267,629,194,438,73,191,96,113,30,113,143,230,52,7,105,146,703,11
4971,"Sean Williams\willise01","2007-08",21,"NJN","NBA",2.5,73,29,1278,164,305,164,305,0,0,81,133,115,207,322,28,28,106,70,193,409,6.72
4972,"Shawne Williams\willish03","2010-11",24,"NYK","NBA",2.5,64,11,1323,164,385,79,173,85,212,41,49,60,179,239,47,39,51,46,164,454,7.03
4973,"Walt Williams\williwa02","2002-03",32,"DAL","NBA",2.5,66,1,1161,134,341,70,170,64,171,31,50,53,154,207,59,42,26,35,141,363,5.37
4974,"Corliss Williamson\willico02","1998-99",25,"SAC","NBA",2.5,50,50,1374,269,555,268,550,1,5,120,188,85,121,206,66,30,8,75,118,659,10.3
4975,"Justise Winslow\winslju01","2015-16",19,"MIA","NBA",2.5,78,8,2232,195,462,163,346,32,116,80,117,81,322,403,117,68,26,95,184,502,7.32
4976,"Lorenzen Wright\wrighlo02","2002-03",27,"MEM","NBA",2.5,70,49,1982,325,716,325,711,0,5,147,223,170,358,528,80,51,54,110,209,797,10.73
4977,"Nick Young\youngni01","2013-14",28,"LAL","NBA",2.5,64,9,1810,387,889,252,539,135,350,235,285,29,137,166,95,46,12,95,156,1144,13.18
4978,"Tony Allen\allento01","2015-16",34,"MEM","NBA",2.4,64,57,1620,215,469,200,427,15,42,90,138,104,192,296,70,110,18,78,175,535,8.8
4979,"John Amaechi\amaecjo01","1999-00",29,"ORL","NBA",2.4,80,53,1684,306,700,305,694,1,6,223,291,62,204,266,95,35,37,139,161,836,8.44
4980,"Chris Andersen\anderch01","2003-04",25,"DEN","NBA",2.4,71,0,1029,90,203,90,202,0,1,63,107,89,209,298,35,34,114,48,119,243,5.31
4981,"Kenny Anderson\anderke01","1998-99",28,"BOS","NBA",2.4,34,33,1010,161,357,155,333,6,24,84,101,24,79,103,193,33,2,71,78,412,12.66
4982,"Ömer Aşık\asikom01","2013-14",27,"HOU","NBA",2.4,48,19,968,101,190,101,190,0,0,78,126,101,277,378,25,14,37,59,92,280,7.85
4983,"Chucky Atkins\atkinch01","1999-00",25,"ORL","NBA",2.4,82,0,1626,314,741,257,578,57,163,97,133,20,106,126,306,52,3,142,137,782,8.45
4984,"Jeff Ayres\pendeje02","2013-14",26,"SAS","NBA",2.4,73,10,952,101,174,101,174,0,0,38,55,89,169,258,60,13,25,63,146,240,4.49
4985,"Dana Barros\barroda01","1999-00",32,"BOS","NBA",2.4,72,0,1139,196,435,137,291,59,144,66,76,13,86,99,133,31,4,66,80,517,6.3
4986,"Jon Barry\barryjo01","2000-01",31,"SAC","NBA",2.4,62,2,1010,103,255,57,123,46,132,64,73,16,78,94,130,28,6,53,66,316,5.42
4987,"Jon Barry\barryjo01","1998-99",29,"SAC","NBA",2.4,43,0,736,59,138,35,59,24,79,71,84,25,71,96,112,53,5,47,61,213,7.17
4988,"Jon Barry\barryjo01","1996-97",27,"ATL","NBA",2.4,58,8,965,100,246,52,122,48,124,37,46,26,73,99,115,55,3,59,56,285,5.63
4989,"Shane Battier\battish01","2013-14",35,"MIA","NBA",2.4,73,56,1468,105,275,32,65,73,210,15,23,34,104,138,63,50,39,21,124,298,4.4
4990,"Jerryd Bayless\bayleje01","2015-16",27,"MIL","NBA",2.4,52,18,1505,185,437,84,206,101,231,70,90,21,120,141,163,47,11,73,111,541,10.12
4991,"Jerryd Bayless\bayleje01","2013-14",25,"TOT","NBA",2.4,72,19,1686,248,617,172,405,76,212,94,118,22,123,145,194,60,9,82,161,666,8.11
4992,"Jerryd Bayless\bayleje01","2014-15",26,"MIL","NBA",2.4,77,4,1717,220,516,183,396,37,120,121,137,22,189,211,233,59,12,133,163,598,8.22
4993,"Aron Baynes\baynear01","2018-19",32,"BOS","NBA",2.4,51,18,821,105,223,84,162,21,61,53,62,88,152,240,57,12,34,40,125,284,6.63
4994,"Michael Beasley\beaslmi01","2017-18",29,"NYK","NBA",2.4,74,30,1653,409,807,375,721,34,86,124,159,97,317,414,123,36,43,143,145,976,11.87
4995,"Tarik Black\blackta01","2016-17",25,"LAL","NBA",2.4,67,16,1091,150,294,149,292,1,2,82,109,144,199,343,39,29,44,58,173,383,6.73
4996,"Rolando Blackman\blackro01","1993-94",34,"NYK","NBA",2.4,55,1,969,161,369,131,285,30,84,48,53,23,70,93,76,25,6,44,100,400,5.89
4997,"Steve Blake\blakest01","2012-13",32,"LAL","NBA",2.4,45,13,1175,114,270,42,99,72,171,27,35,21,111,132,173,34,6,62,83,327,8.72
4998,"Andray Blatche\blatcan01","2010-11",24,"WAS","NBA",2.4,64,63,2172,426,957,422,939,4,18,220,283,183,343,526,144,98,51,172,182,1076,15.57
4999,"Bojan Bogdanović\bogdabo02","2014-15",25,"BRK","NBA",2.4,78,28,1854,261,576,170,320,91,256,87,106,50,163,213,68,34,9,78,104,700,7.27
5000,"Anthony Bonner\bonnean01","1992-93",24,"SAC","NBA",2.4,70,35,1764,229,497,229,490,0,7,143,241,188,267,455,96,86,17,105,183,601,9.32
5001,"Devin Booker\bookede01","2017-18",21,"PHO","NBA",2.4,54,54,1865,455,1054,308,670,147,384,289,329,26,218,244,253,47,14,194,168,1346,20.48
5002,"Avery Bradley\bradlav01","2011-12",21,"BOS","NBA",2.4,64,28,1368,200,402,178,348,22,54,62,78,34,81,115,87,43,12,75,109,484,6.79
5003,"Dee Brown\brownde01","1995-96",27,"BOS","NBA",2.4,65,23,1591,246,616,178,396,68,220,135,158,36,100,136,146,80,12,74,119,695,9.2
5004,"Devin Brown\brownde02","2007-08",29,"CLE","NBA",2.4,78,20,1762,217,531,172,385,45,146,107,142,65,198,263,175,52,7,99,144,586,7.33
5005,"Randy Brown\brownra02","1996-97",28,"CHI","NBA",2.4,72,3,1057,140,333,136,311,4,22,57,84,34,77,111,133,81,17,58,116,341,5.33
5006,"Mark Bryant\bryanma01","1999-00",34,"CLE","NBA",2.4,75,50,1712,174,346,174,346,0,0,76,94,126,226,352,61,31,31,87,250,424,6.41
5007,"Trey Burke\burketr01","2014-15",22,"UTA","NBA",2.4,76,43,2288,370,1005,246,615,124,390,109,145,31,173,204,328,65,15,124,119,973,10.39
5008,"Trey Burke\burketr01","2017-18",25,"NYK","NBA",2.4,36,9,785,193,384,155,279,38,105,37,57,13,58,71,170,24,4,43,43,461,12.1
5009,"Caron Butler\butleca01","2014-15",34,"DET","NBA",2.4,78,21,1623,161,396,78,177,83,219,55,61,21,175,196,79,43,4,49,120,460,5.44
5010,"Antoine Carr\carran01","1996-97",35,"UTA","NBA",2.4,82,0,1460,252,522,252,519,0,3,99,127,60,135,195,74,24,63,75,214,603,6.4
5011,"Omri Casspi\casspom01","2013-14",25,"HOU","NBA",2.4,71,2,1283,173,410,112,234,61,176,83,122,55,205,260,88,44,14,72,100,490,6.7
5012,"Cedric Ceballos\cebalce01","1996-97",27,"TOT","NBA",2.4,50,40,1426,282,617,256,515,26,102,139,186,102,228,330,64,33,23,85,113,729,12.34
5013,"Jordan Clarkson\clarkjo01","2014-15",22,"LAL","NBA",2.4,59,38,1476,267,596,229,475,38,121,131,158,56,135,191,206,51,12,96,109,703,11.22
5014,"DeMarcus Cousins\couside01","2018-19",28,"GSW","NBA",2.4,30,30,771,178,371,152,276,26,95,106,144,43,204,247,107,40,44,72,109,488,17.63
5015,"John Crotty\crottjo01","1996-97",27,"MIA","NBA",2.4,48,0,659,79,154,59,105,20,49,54,64,15,32,47,102,18,0,42,79,232,5.42
5016,"Dante Cunningham\cunnida01","2017-18",30,"TOT","NBA",2.4,73,25,1562,164,364,106,196,58,168,31,52,78,220,298,48,39,30,33,111,417,5.92
5017,"Seth Curry\curryse01","2018-19",28,"POR","NBA",2.4,74,2,1399,212,465,99,214,113,251,44,52,27,93,120,66,36,12,61,97,581,6.43
5018,"Dewayne Dedmon\dedmode01","2015-16",26,"ORL","NBA",2.4,58,20,705,99,177,99,177,0,0,57,76,67,161,228,13,22,46,32,109,255,5.48
5019,"Bison Dele\delebi01","1998-99",29,"DET","NBA",2.4,49,48,1177,216,431,216,430,0,1,81,118,92,180,272,71,38,40,111,181,513,10.36
5020,"Carlos Delfino\delfica01","2011-12",29,"MIL","NBA",2.4,54,53,1537,182,453,96,214,86,239,38,48,20,188,208,123,79,10,66,99,488,9.17
5021,"Toney Douglas\douglto01","2012-13",26,"TOT","NBA",2.4,71,0,1289,188,466,106,250,82,216,76,84,34,104,138,151,71,3,81,145,534,7.24
5022,"Chris Douglas-Roberts\douglch01","2013-14",27,"CHA","NBA",2.4,49,8,1016,111,252,60,120,51,132,66,82,16,103,119,51,29,16,36,61,339,6.61
5023,"Predrag Drobnjak\drobnpr01","2002-03",27,"SEA","NBA",2.4,82,69,1984,325,789,295,704,30,85,91,115,111,209,320,86,48,38,65,180,771,7.34
5024,"Jared Dudley\dudleja01","2013-14",28,"LAC","NBA",2.4,74,43,1729,196,447,115,222,81,225,38,58,36,124,160,104,41,10,56,146,511,6.13
5025,"Ledell Eackles\eacklle01","1995-96",29,"WSB","NBA",2.4,55,26,1238,161,377,107,249,54,128,98,118,44,104,148,86,28,3,57,84,474,7.56
5026,"Dale Ellis\ellisda01","1998-99",38,"SEA","NBA",2.4,48,5,1232,174,395,80,178,94,217,53,70,25,90,115,38,25,3,45,77,495,7.94
5027,"Derek Fisher\fishede01","2003-04",29,"LAL","NBA",2.4,82,3,1769,203,576,151,397,52,179,122,153,30,122,152,187,103,4,79,115,580,6.62
5028,"Tim Frazier\fraziti01","2016-17",26,"NOP","NBA",2.4,65,35,1525,163,404,123,276,40,128,98,129,34,139,173,335,56,6,101,133,464,9.2
5029,"Francisco García\garcifr01","2006-07",25,"SAC","NBA",2.4,79,5,1410,163,380,110,231,53,149,95,114,53,152,205,87,45,43,70,190,474,6.12
5030,"Francisco García\garcifr01","2008-09",27,"SAC","NBA",2.4,65,36,1975,295,665,207,444,88,221,146,178,56,162,218,150,80,67,112,196,824,12.04
5031,"Chris Gatling\gatlich01","2000-01",33,"CLE","NBA",2.4,74,6,1670,329,733,301,641,28,92,156,228,99,292,391,61,52,27,119,185,842,9.48
5032,"Chris Gatling\gatlich01","1997-98",30,"NJN","NBA",2.4,57,16,1359,248,545,247,541,1,4,159,265,118,216,334,53,52,29,99,152,656,10.08
5033,"Alonzo Gee\geeal01","2011-12",24,"CLE","NBA",2.4,63,31,1827,227,551,183,414,44,137,167,212,101,221,322,113,83,17,114,149,665,10.4
5034,"Paul George\georgpa01","2010-11",20,"IND","NBA",2.4,61,19,1265,179,395,138,257,41,138,77,101,37,187,224,65,62,26,70,127,476,7.82
5035,"Daniel Gibson\gibsoda01","2010-11",24,"CLE","NBA",2.4,67,15,1865,264,660,146,367,118,293,134,163,24,153,177,201,48,21,80,154,780,10.24
5036,"Gordan Giriček\giricgo01","2003-04",26,"TOT","NBA",2.4,73,43,2041,316,724,256,572,60,152,135,158,51,175,226,122,56,15,103,144,827,9.31
5037,"Ryan Gomes\gomesry01","2009-10",27,"MIN","NBA",2.4,76,64,2210,327,732,253,533,74,199,104,126,76,272,348,124,62,16,95,155,832,9.75
5038,"Willie Green\greenwi01","2011-12",30,"ATL","NBA",2.4,53,2,922,153,325,103,212,50,113,48,56,15,65,80,40,23,6,33,74,404,6.07
5039,"Eddie Griffin\griffed01","2001-02",19,"HOU","NBA",2.4,73,24,1896,244,666,154,393,90,273,64,86,117,299,416,53,17,134,47,117,642,7.93
5040,"Richard Hamilton\hamilri01","2000-01",22,"WAS","NBA",2.4,78,42,2519,547,1249,507,1103,40,146,277,319,75,163,238,224,75,10,201,203,1411,13.75
5041,"Tom Hammonds\hammoto01","1997-98",30,"MIN","NBA",2.4,57,2,1140,127,246,127,245,0,1,92,132,100,171,271,36,15,17,48,127,346,6.48
5042,"Maurice Harkless\harklma01","2012-13",19,"ORL","NBA",2.4,76,59,1974,260,564,228,447,32,117,73,128,122,213,335,50,88,62,69,144,625,8.06
5043,"Ron Harper\harpero01","1994-95",31,"CHI","NBA",2.4,77,53,1536,209,491,178,381,31,110,81,131,51,129,180,157,97,27,100,132,530,7.11
5044,"Tobias Harris\harrito02","2012-13",20,"TOT","NBA",2.4,55,34,1299,233,512,199,404,34,108,103,137,73,214,287,69,32,44,66,120,603,10
5045,"Spencer Hawes\hawessp01","2010-11",22,"PHI","NBA",2.4,81,81,1718,264,568,255,531,9,37,47,88,129,336,465,121,29,71,97,201,584,7.72
5046,"Chuck Hayes\hayesch01","2005-06",22,"HOU","NBA",2.4,40,0,535,59,105,59,104,0,1,29,45,67,112,179,14,26,14,12,76,147,5.2
5047,"Gerald Henderson\hendege02","2010-11",23,"CHA","NBA",2.4,68,30,1661,259,570,252,534,7,36,128,163,49,158,207,101,50,32,64,118,653,8.38
5048,"Walter Herrmann\herrmwa01","2006-07",27,"CHA","NBA",2.4,48,12,936,174,330,121,215,53,115,41,53,28,111,139,26,17,7,32,76,442,7.74
5049,"Larry Hughes\hughela01","2001-02",23,"GSW","NBA",2.4,73,56,2049,343,810,325,717,18,93,191,259,83,162,245,316,113,23,171,150,895,12.14
5050,"Larry Hughes\hughela01","1998-99",20,"PHI","NBA",2.4,50,1,988,170,414,162,362,8,52,107,151,83,106,189,77,44,14,68,97,455,7.98
5051,"Jarrett Jack\jackja01","2010-11",27,"TOT","NBA",2.4,83,15,1722,260,637,227,529,33,108,182,214,20,153,173,242,54,6,110,102,735,8.16
5052,"Marko Jarić\jaricma01","2007-08",29,"MIN","NBA",2.4,75,56,2189,227,528,181,401,46,127,121,163,38,184,222,311,97,32,128,180,621,10.02
5053,"Richard Jefferson\jefferi01","2004-05",24,"NJN","NBA",2.4,33,33,1355,238,564,208,475,30,89,227,269,49,191,240,133,33,17,132,109,733,19.72
5054,"Jonas Jerebko\jerebjo01","2015-16",28,"BOS","NBA",2.4,78,0,1176,118,286,75,178,43,108,61,78,77,211,288,62,20,24,52,137,340,4.82
5055,"Eddie Johnson\johnsed03","1993-94",34,"CHH","NBA",2.4,73,27,1460,339,738,280,588,59,150,99,127,80,144,224,125,36,8,84,143,836,9.08
5056,"Damon Jones\jonesda01","2006-07",30,"CLE","NBA",2.4,60,0,1173,137,355,48,124,89,231,30,44,9,57,66,94,16,2,36,53,393,5.06
5057,"Chris Kaman\kamanch01","2009-10",27,"LAC","NBA",2.4,76,76,2608,589,1202,589,1196,0,6,230,307,184,520,704,120,37,94,223,213,1408,16.31
5058,"Jerome Kersey\kerseje01","1995-96",33,"GSW","NBA",2.4,76,58,1620,205,500,202,483,3,17,97,147,154,209,363,114,91,45,75,205,510,7.49
5059,"Voshon Lenard\lenarvo01","2002-03",29,"TOR","NBA",2.4,63,24,1929,325,809,233,557,92,252,156,194,48,164,212,144,59,21,103,156,898,11.2
5060,"Meyers Leonard\leoname01","2012-13",20,"POR","NBA",2.4,69,9,1206,151,277,148,270,3,7,72,89,80,175,255,33,11,38,49,168,377,5.79
5061,"Shaun Livingston\livinsh01","2006-07",21,"LAC","NBA",2.4,54,31,1611,208,449,203,433,5,16,82,116,56,128,184,274,59,29,108,135,503,11.17
5062,"Grant Long\longgr01","2000-01",34,"VAN","NBA",2.4,66,27,1507,140,319,136,304,4,15,112,157,76,198,274,83,72,15,62,160,396,6.98
5063,"O.J. Mayo\mayooj01","2010-11",23,"MEM","NBA",2.4,71,17,1869,304,747,208,483,96,264,99,131,35,135,170,145,73,26,99,127,803,9.15
5064,"Luc Mbah a Moute\mbahalu01","2011-12",25,"MIL","NBA",2.4,43,22,1009,133,261,132,257,1,4,66,103,77,150,227,29,40,22,39,93,333,8.26
5065,"George McCloud\mccloge01","1997-98",30,"PHO","NBA",2.4,63,13,1213,173,427,102,219,71,208,39,51,45,173,218,84,54,13,63,132,456,6.83
5066,"Anthony Morrow\morroan01","2013-14",28,"NOP","NBA",2.4,76,9,1426,238,520,150,325,88,195,72,87,29,111,140,59,38,12,51,102,636,6.64
5067,"Mike Muscala\muscami01","2017-18",26,"ATL","NBA",2.4,53,7,1060,143,312,81,145,62,167,57,62,56,174,230,51,31,27,42,80,405,7.91
5068,"David Nwaba\nwabada01","2017-18",25,"CHI","NBA",2.4,70,21,1646,202,423,184,371,18,52,133,203,89,237,326,104,59,29,77,158,555,8.49
5069,"Royce O'Neale\onealro01","2017-18",24,"UTA","NBA",2.4,69,4,1150,120,284,78,166,42,118,61,76,25,211,236,95,36,16,55,105,343,5.71
5070,"Kevin Ollie\ollieke01","2003-04",31,"CLE","NBA",2.4,82,7,1401,95,257,91,248,4,9,147,176,23,147,170,234,51,8,81,119,341,5.8
5071,"Kevin Ollie\ollieke01","2001-02",29,"TOT","NBA",2.4,81,17,1723,137,353,136,351,1,2,187,227,25,159,184,291,62,2,106,97,462,7.34
5072,"Patrick Patterson\pattepa01","2010-11",21,"HOU","NBA",2.4,52,6,868,149,267,149,265,0,2,30,42,86,114,200,41,17,37,31,77,328,6.68
5073,"Anthony Peeler\peelean01","1994-95",25,"LAL","NBA",2.4,73,24,1559,285,659,201,443,84,216,102,128,62,106,168,122,52,13,82,143,756,8.38
5074,"Bobby Portis\portibo01","2016-17",21,"CHI","NBA",2.4,64,13,1000,183,375,151,279,32,96,39,59,75,221,296,35,16,11,37,94,437,6.35
5075,"James Posey\poseyja01","2009-10",33,"NOH","NBA",2.4,77,2,1731,126,345,45,103,81,242,66,80,32,297,329,117,42,19,51,204,399,6.12
5076,"Norman Powell\powelno01","2018-19",25,"TOR","NBA",2.4,60,3,1126,193,400,125,230,68,170,62,75,16,123,139,91,39,13,65,96,516,7.92
5077,"Željko Rebrača\rebraze01","2004-05",32,"LAC","NBA",2.4,58,2,928,133,234,133,234,0,0,73,85,49,135,184,26,13,40,49,130,339,6.14
5078,"Bryant Reeves\reevebr01","1996-97",23,"VAN","NBA",2.4,75,75,2777,498,1025,497,1014,1,11,216,307,174,436,610,160,29,67,175,270,1213,14.54
5079,"Quentin Richardson\richaqu01","2003-04",23,"LAC","NBA",2.4,65,64,2338,425,1068,305,727,120,341,151,204,146,268,414,139,67,19,141,130,1121,13.31
5080,"Austin Rivers\riverau01","2017-18",25,"LAC","NBA",2.4,61,59,2057,341,805,205,445,136,360,102,159,27,118,145,242,74,16,109,152,920,12.83
5081,"Rajon Rondo\rondora01","2006-07",20,"BOS","NBA",2.4,78,25,1831,188,450,182,421,6,29,119,184,74,218,292,297,128,8,137,181,501,8.89
5082,"Terrence Ross\rosste01","2014-15",23,"TOR","NBA",2.4,82,61,2092,309,753,164,363,145,390,44,56,32,194,226,86,53,25,69,136,807,7.56
5083,"Dennis Scott\scottde01","1997-98",29,"TOT","NBA",2.4,81,45,2290,329,828,204,486,125,342,105,130,47,200,247,153,53,39,104,152,888,8.84
5084,"Iman Shumpert\shumpim01","2011-12",21,"NYK","NBA",2.4,59,35,1705,214,534,166,377,48,157,87,109,42,144,186,164,101,8,111,173,563,9.52
5085,"Charles Smith\smithch01","1993-94",28,"NYK","NBA",2.4,43,21,1105,176,397,168,381,8,16,87,121,66,99,165,50,26,45,64,144,447,8.94
5086,"Josh Smith\smithjo03","2004-05",19,"ATL","NBA",2.4,74,59,2050,274,602,270,579,4,23,163,237,147,310,457,127,59,144,135,157,715,10.88
5087,"Tony Snell\snellto01","2014-15",23,"CHI","NBA",2.4,72,22,1412,159,371,86,174,73,197,44,55,31,145,176,62,32,11,48,86,435,5.39
5088,"Tony Snell\snellto01","2017-18",26,"MIL","NBA",2.4,75,59,2053,185,425,77,157,108,268,38,48,9,132,141,98,47,28,36,115,516,6.4
5089,"Darius Songaila\songada01","2008-09",30,"WAS","NBA",2.4,77,29,1521,243,457,243,456,0,1,80,90,75,152,227,94,64,20,74,200,566,7.45
5090,"Felton Spencer\spencfe01","1995-96",28,"UTA","NBA",2.4,71,70,1267,146,281,146,281,0,0,104,151,100,206,306,11,20,54,77,240,396,6.01
5091,"Jerry Stackhouse\stackje01","2005-06",31,"DAL","NBA",2.4,55,11,1525,242,603,206,473,36,130,195,221,32,121,153,160,37,10,121,96,715,10.85
5092,"DeShawn Stevenson\stevede01","2005-06",24,"ORL","NBA",2.4,82,82,2648,359,781,357,766,2,15,180,242,59,182,241,160,58,17,123,178,900,9.15
5093,"Amar'e Stoudemire\stoudam01","2015-16",33,"MIA","NBA",2.4,52,36,762,125,221,125,221,0,0,50,67,65,157,222,27,18,41,47,92,300,6.59
5094,"Derek Strong\stronde01","1994-95",26,"BOS","NBA",2.4,70,24,1344,149,329,147,322,2,7,141,172,136,239,375,44,24,13,79,143,441,6.74
5095,"Tyrus Thomas\thomaty01","2007-08",21,"CHI","NBA",2.4,74,27,1330,186,440,185,434,1,6,129,174,102,240,342,90,48,72,77,170,502,7.41
5096,"Jason Thompson\thompja02","2014-15",28,"SAC","NBA",2.4,81,63,1991,201,428,201,427,0,1,89,143,139,391,530,85,33,57,84,239,491,7.34
5097,"Robert Traylor\traylro01","2002-03",25,"NOH","NBA",2.4,69,0,851,105,237,104,234,1,3,57,88,108,154,262,50,45,37,53,153,268,4.96
5098,"Evan Turner\turneev01","2011-12",23,"PHI","NBA",2.4,65,20,1713,263,590,252,541,11,49,73,108,27,349,376,180,40,20,105,117,610,9.52
5099,"Beno Udrih\udrihbe01","2007-08",25,"SAC","NBA",2.4,65,51,2080,328,708,275,571,53,137,125,147,34,183,217,282,56,10,148,138,834,12.43
5100,"Anderson Varejão\varejan01","2007-08",25,"CLE","NBA",2.4,48,13,1320,136,295,136,293,0,2,49,82,134,265,399,53,37,26,59,134,321,8.49
5101,"Dwyane Wade\wadedw01","2018-19",37,"MIA","NBA",2.4,72,2,1885,416,960,330,699,86,261,165,233,69,216,285,301,59,38,166,118,1083,13.34
5102,"Gerald Wallace\wallage01","2004-05",22,"CHA","NBA",2.4,70,68,2147,286,637,269,575,17,62,191,289,118,268,386,137,117,91,159,182,780,12
5103,"Mark West\westma01","1993-94",33,"PHO","NBA",2.4,82,50,1236,162,286,162,286,0,0,58,116,112,183,295,33,31,109,74,214,382,5.75
5104,"Deron Williams\willide01","2016-17",32,"TOT","NBA",2.4,64,44,1657,263,600,178,366,85,234,90,109,14,133,147,360,31,8,138,138,701,11.34
5105,"Kenny Williams\willike03","1993-94",24,"IND","NBA",2.4,68,1,982,191,391,191,387,0,4,45,64,93,112,205,52,24,49,45,99,427,5.86
5106,"Lou Williams\willilo02","2012-13",26,"ATL","NBA",2.4,39,9,1119,187,443,115,247,72,196,105,121,8,72,80,139,44,10,74,55,551,12.55
5107,"Kevin Willis\willike02","1998-99",36,"TOR","NBA",2.4,42,38,1216,187,447,187,445,0,2,130,155,109,241,350,67,28,28,86,134,504,11.68
5108,"Victor Alexander\alexavi01","1993-94",24,"GSW","NBA",2.3,69,39,1318,266,502,264,489,2,13,68,129,114,194,308,66,28,32,86,168,602,8.01
5109,"Ryan Anderson\anderry01","2013-14",25,"NOP","NBA",2.3,22,14,795,155,354,88,190,67,164,59,62,66,76,142,17,10,7,20,47,436,15.12
5110,"Darrell Arthur\arthuda01","2015-16",27,"DEN","NBA",2.3,70,16,1516,221,489,176,372,45,117,40,53,86,207,293,96,53,48,66,185,527,7.7
5111,"Stacey Augmon\augmost01","2001-02",33,"CHH","NBA",2.3,77,3,1319,140,328,140,325,0,3,77,101,59,166,225,103,56,12,54,115,357,5.2
5112,"Marcus Banks\banksma01","2005-06",24,"TOT","NBA",2.3,58,29,1497,219,468,197,405,22,63,118,147,23,112,135,220,54,11,119,162,578,10.28
5113,"Matt Barnes\barnema02","2007-08",27,"GSW","NBA",2.3,73,18,1414,187,442,134,261,53,181,59,79,94,230,324,139,48,36,85,159,486,7.45
5114,"Dana Barros\barroda01","2000-01",33,"DET","NBA",2.3,60,0,1079,183,412,139,307,44,105,68,80,6,88,94,110,30,2,60,63,478,6.73
5115,"Brent Barry\barrybr01","2007-08",36,"SAS","NBA",2.3,31,1,554,77,160,29,48,48,112,19,20,12,43,55,54,17,3,18,43,221,7.04
5116,"Tony Battie\battito01","2000-01",24,"BOS","NBA",2.3,40,25,845,108,201,108,198,0,3,44,69,73,160,233,16,27,60,37,126,260,8.15
5117,"Tony Battie\battito01","2003-04",27,"TOT","NBA",2.3,73,7,1478,170,384,168,375,2,9,66,89,118,241,359,58,26,67,63,159,408,6.23
5118,"Benoit Benjamin\benjabe01","1995-96",31,"TOT","NBA",2.3,83,71,1896,294,590,294,587,0,3,140,194,141,398,539,64,45,85,144,224,728,9.35
5119,"David Benoit\benoida01","1992-93",24,"UTA","NBA",2.3,82,27,1712,258,592,224,494,34,98,114,152,116,276,392,43,45,43,90,201,664,7.31
5120,"Dāvis Bertāns\bertada01","2016-17",24,"SAS","NBA",2.3,67,6,808,103,234,34,61,69,173,28,34,22,76,98,46,20,28,32,75,303,4.31
5121,"Chauncey Billups\billuch01","1998-99",22,"DEN","NBA",2.3,45,41,1488,191,495,106,260,85,235,157,172,24,72,96,173,58,14,98,115,624,12.78
5122,"Keith Bogans\boganke01","2005-06",25,"TOT","NBA",2.3,72,31,1912,215,544,150,344,65,200,127,186,55,200,255,128,71,9,90,167,622,7.95
5123,"Trevor Booker\booketr01","2012-13",25,"WAS","NBA",2.3,48,14,887,108,220,108,215,0,5,40,72,98,141,239,40,32,16,31,95,256,6.23
5124,"Earl Boykins\boykiea01","2010-11",34,"MIL","NBA",2.3,57,0,862,156,352,129,281,27,71,69,82,15,40,55,141,38,3,52,43,408,6.66
5125,"Shawn Bradley\bradlsh01","2003-04",31,"DAL","NBA",2.3,66,5,773,89,188,89,187,0,1,41,49,72,101,173,20,33,74,17,130,219,4.36
5126,"Shawn Bradley\bradlsh01","2001-02",29,"DAL","NBA",2.3,53,16,757,78,163,78,162,0,1,59,64,53,123,176,20,28,64,25,128,215,5.42
5127,"Corey Brewer\breweco01","2017-18",31,"TOT","NBA",2.3,72,18,1208,142,316,111,206,31,110,65,90,43,111,154,65,79,14,49,139,380,5.58
5128,"Corey Brewer\breweco01","2011-12",25,"DEN","NBA",2.3,59,17,1287,201,463,168,336,33,127,90,130,43,107,150,88,72,17,56,113,525,7.98
5129,"Derrick Brown\brownde04","2011-12",24,"CHA","NBA",2.3,65,17,1443,212,409,206,385,6,24,94,141,95,141,236,67,48,12,55,96,524,7.71
5130,"P.J. Brown\brownpj01","2006-07",37,"CHI","NBA",2.3,72,49,1456,170,418,170,416,0,2,96,122,129,218,347,48,24,52,85,187,436,6.03
5131,"Mark Bryant\bryanma01","1993-94",28,"POR","NBA",2.3,79,10,1441,185,384,185,383,0,1,72,104,117,198,315,37,32,29,66,187,442,5.55
5132,"Mark Bryant\bryanma01","1996-97",31,"PHO","NBA",2.3,41,18,1018,152,275,152,275,0,0,76,108,67,145,212,47,22,5,46,136,380,9.24
5133,"Greg Buckner\buckngr01","2001-02",25,"DAL","NBA",2.3,44,16,885,104,198,99,182,5,16,40,58,67,106,173,48,31,19,27,124,253,6.73
5134,"Jud Buechler\buechju01","1995-96",27,"CHI","NBA",2.3,74,0,740,112,242,72,152,40,90,14,22,45,66,111,56,34,7,39,70,278,3.69
5135,"Caron Butler\butleca01","2011-12",31,"LAC","NBA",2.3,63,63,1871,287,705,195,448,92,257,87,107,44,186,230,78,52,9,77,123,753,9.07
5136,"Calbert Cheaney\cheanca01","2003-04",32,"GSW","NBA",2.3,79,7,2067,278,578,278,568,0,10,47,77,77,183,260,136,60,12,85,184,603,7.15
5137,"Earl Clark\clarkea01","2012-13",25,"LAL","NBA",2.3,59,36,1363,170,386,135,282,35,104,53,76,82,243,325,65,36,44,62,102,428,7.78
5138,"Ian Clark\clarkia01","2016-17",25,"GSW","NBA",2.3,77,0,1137,211,433,150,270,61,163,44,58,22,99,121,90,39,8,55,77,527,5.96
5139,"Bimbo Coles\colesbi01","1999-00",31,"ATL","NBA",2.3,80,54,1924,276,607,268,568,8,39,85,104,30,142,172,290,58,11,103,178,645,8.26
5140,"Nick Collison\collini01","2005-06",25,"SEA","NBA",2.3,66,27,1448,207,394,207,391,0,3,79,113,143,225,368,74,21,35,77,213,493,8.04
5141,"Jamal Crawford\crawfja01","2011-12",31,"POR","NBA",2.3,60,6,1613,283,737,203,477,80,260,191,206,16,102,118,191,55,14,111,74,837,11.23
5142,"Jae Crowder\crowdja01","2013-14",23,"DAL","NBA",2.3,78,8,1254,130,296,80,145,50,151,46,61,46,148,194,60,59,21,41,100,356,4.98
5143,"Michael Curry\currymi01","2001-02",33,"DET","NBA",2.3,82,75,1912,125,276,118,250,7,26,72,91,15,153,168,127,47,10,60,207,329,4.74
5144,"Antonio Daniels\daniean01","2002-03",27,"POR","NBA",2.3,67,2,872,84,186,66,127,18,59,65,76,11,61,72,85,33,9,32,43,251,4.14
5145,"Mark Davis\davisma02","1996-97",23,"PHI","NBA",2.3,75,17,1705,251,535,227,442,24,93,113,168,138,185,323,135,85,31,118,230,639,8.98
5146,"Bison Dele\delebi01","1994-95",25,"DEN","NBA",2.3,63,10,1261,196,333,196,333,0,0,106,162,98,200,298,53,38,43,114,210,498,8.66
5147,"DeMar DeRozan\derozde01","2009-10",20,"TOR","NBA",2.3,77,65,1664,255,512,251,496,4,16,148,194,66,157,223,53,43,18,62,176,662,7.39
5148,"Chris Duhon\duhonch01","2007-08",25,"CHI","NBA",2.3,66,18,1490,133,344,79,189,54,155,65,80,19,97,116,263,48,2,71,92,385,7.14
5149,"Mike Dunleavy\dunlemi02","2009-10",29,"IND","NBA",2.3,67,15,1486,229,558,154,322,75,236,133,158,25,211,236,103,38,15,72,105,666,8.54
5150,"Kevin Durant\duranke01","2007-08",19,"SEA","NBA",2.3,80,80,2768,587,1366,528,1161,59,205,391,448,70,278,348,192,78,75,232,122,1624,16.05
5151,"Reggie Evans\evansre01","2006-07",26,"DEN","NBA",2.3,66,11,1127,117,215,117,215,0,0,91,183,156,304,460,45,42,16,95,144,325,6.87
5152,"Raymond Felton\feltora01","2006-07",22,"CHA","NBA",2.3,78,75,2832,393,1024,290,712,103,312,204,256,51,216,267,545,118,10,230,180,1093,14.43
5153,"Danny Ferry\ferryda01","2001-02",35,"SAS","NBA",2.3,50,2,799,76,177,33,78,43,99,34,36,15,75,90,48,16,9,22,70,229,4.53
5154,"Danny Fortson\fortsda01","2003-04",27,"DAL","NBA",2.3,56,20,625,71,139,71,139,0,0,75,92,114,136,250,9,12,11,37,148,217,4.77
5155,"Randy Foye\foyera01","2006-07",23,"MIN","NBA",2.3,82,12,1879,300,691,232,506,68,185,164,192,49,169,218,232,53,21,152,184,832,9.44
5156,"Willie Green\greenwi01","2008-09",27,"PHI","NBA",2.3,81,60,1828,286,658,235,497,51,161,62,85,29,97,126,158,53,13,64,154,685,6.82
5157,"Anfernee Hardaway\hardaan01","2002-03",31,"PHO","NBA",2.3,58,51,1777,256,573,230,500,26,73,77,97,66,192,258,235,66,26,145,150,615,11.38
5158,"Derek Harper\harpede01","1997-98",36,"ORL","NBA",2.3,66,45,1761,226,542,167,378,59,164,55,79,23,80,103,233,72,10,101,140,566,8.34
5159,"Trenton Hassell\hassetr01","2005-06",26,"MIN","NBA",2.3,77,67,2514,286,616,279,593,7,23,131,176,82,134,216,203,43,29,124,201,710,8.66
5160,"Hersey Hawkins\hawkihe01","2000-01",34,"CHH","NBA",2.3,59,0,681,56,137,39,91,17,46,54,63,17,63,80,72,33,9,19,45,183,3.86
5161,"John Henson\hensojo01","2015-16",25,"MIL","NBA",2.3,57,1,960,164,291,164,290,0,1,69,117,87,134,221,54,18,109,64,131,397,8.07
5162,"Mario Hezonja\hezonma01","2017-18",22,"ORL","NBA",2.3,75,30,1657,273,617,183,350,90,267,86,105,41,240,281,106,81,31,86,134,722,9.08
5163,"Fred Hoiberg\hoibefr01","1997-98",25,"IND","NBA",2.3,65,1,874,85,222,53,137,32,85,59,69,14,109,123,45,40,3,22,101,261,3.98
5164,"Danuel House\houseda01","2018-19",25,"HOU","NBA",2.3,39,13,979,118,252,44,74,74,178,56,71,25,115,140,40,21,11,35,80,366,8.81
5165,"Joe Ingles\inglejo01","2015-16",28,"UTA","NBA",2.3,81,2,1241,124,291,43,81,81,210,13,18,19,132,151,96,55,4,65,98,342,4.58
5166,"Jarrett Jack\jackja01","2013-14",30,"CLE","NBA",2.3,80,31,2252,286,698,223,513,63,185,125,149,22,201,223,324,56,22,133,133,760,9.54
5167,"Antawn Jamison\jamisan01","1998-99",22,"GSW","NBA",2.3,47,24,1058,178,394,175,384,3,10,90,153,131,170,301,34,38,16,68,102,449,8.78
5168,"Marko Jarić\jaricma01","2005-06",27,"MIN","NBA",2.3,75,49,2102,226,566,186,433,40,133,95,138,60,173,233,293,108,21,127,189,587,9.13
5169,"Al Jefferson\jeffeal01","2016-17",32,"IND","NBA",2.3,66,1,931,235,471,235,470,0,1,65,85,75,203,278,57,19,16,33,125,535,7.16
5170,"Al Jefferson\jeffeal01","2005-06",21,"BOS","NBA",2.3,59,7,1062,189,379,189,375,0,4,86,134,97,202,299,30,30,46,62,166,464,7.76
5171,"Richard Jefferson\jefferi01","2014-15",34,"DAL","NBA",2.3,74,18,1244,144,324,78,169,66,155,78,114,25,158,183,61,32,11,52,115,432,5.46
5172,"Ervin Johnson\johnser02","2003-04",36,"MIN","NBA",2.3,66,47,965,55,103,55,102,0,1,17,28,61,171,232,24,27,43,30,156,127,3.62
5173,"Ervin Johnson\johnser02","2001-02",34,"MIL","NBA",2.3,81,9,1660,89,193,89,192,0,1,30,66,142,324,466,27,37,82,52,219,208,4.86
5174,"Ivan Johnson\johnsiv01","2012-13",28,"ATL","NBA",2.3,69,5,1035,185,356,184,343,1,13,81,131,76,190,266,46,56,14,71,131,452,6.68
5175,"Tyler Johnson\johnsty01","2018-19",26,"TOT","NBA",2.3,57,22,1529,217,526,127,266,90,260,95,127,34,139,173,166,54,27,77,97,619,10.23
5176,"Jumaine Jones\jonesju01","2000-01",21,"PHI","NBA",2.3,65,0,866,122,275,102,215,20,60,40,53,63,126,189,32,30,15,39,68,304,4.52
5177,"Terrence Jones\joneste01","2016-17",25,"TOT","NBA",2.3,54,12,1270,231,492,212,417,19,75,103,170,65,241,306,59,40,54,48,67,584,10.12
5178,"Michael Jordan\jordami01","1994-95",31,"CHI","NBA",2.3,17,17,668,166,404,150,372,16,32,109,136,25,92,117,90,30,13,35,47,457,22.28
5179,"Frank Kaminsky\kaminfr01","2016-17",23,"CHO","NBA",2.3,75,16,1954,320,802,204,448,116,354,118,156,57,279,336,162,46,34,76,139,874,9.91
5180,"Enes Kanter\kanteen01","2012-13",20,"UTA","NBA",2.3,70,2,1078,206,379,205,378,1,1,93,117,135,169,304,31,28,32,101,116,506,7.25
5181,"Adam Keefe\keefead01","1996-97",26,"UTA","NBA",2.3,62,0,915,82,160,82,159,0,1,71,103,75,141,216,32,30,13,45,97,235,4.69
5182,"Gerard King\kingge02","1999-00",27,"WAS","NBA",2.3,62,28,1060,139,277,139,277,0,0,49,66,84,166,250,49,34,15,41,132,327,5.82
5183,"Kyle Korver\korveky01","2018-19",37,"TOT","NBA",2.3,70,0,1334,201,483,63,135,138,348,60,73,9,153,162,81,25,12,59,106,600,7.03
5184,"Christian Laettner\laettch01","2003-04",34,"WAS","NBA",2.3,48,18,984,119,256,113,235,6,21,40,50,50,182,232,89,37,28,42,102,284,7.5
5185,"Andrew Lang\langan01","1995-96",29,"TOT","NBA",2.3,71,69,2365,353,790,352,785,1,5,125,156,153,302,455,65,42,126,124,241,832,10.78
5186,"Joffrey Lauvergne\lauvejo01","2015-16",24,"DEN","NBA",2.3,59,15,1041,195,380,182,327,13,53,62,69,77,213,290,56,13,15,54,115,465,7.68
5187,"Jim Les\lesji01","1992-93",29,"SAC","NBA",2.3,73,0,881,110,259,44,105,66,154,42,50,20,69,89,169,40,7,48,81,328,5.29
5188,"Caris LeVert\leverca01","2017-18",23,"BRK","NBA",2.3,71,10,1864,320,735,235,490,85,245,133,187,53,207,260,299,82,22,153,159,858,12.12
5189,"Brook Lopez\lopezbr01","2013-14",25,"BRK","NBA",2.3,17,17,533,129,229,129,228,0,1,94,115,39,63,102,16,9,30,28,52,352,18.64
5190,"Trey Lyles\lylestr01","2015-16",20,"UTA","NBA",2.3,80,33,1382,191,436,142,308,49,128,57,82,59,240,299,59,26,18,65,114,488,5.61
5191,"Shelvin Mack\macksh01","2013-14",23,"ATL","NBA",2.3,73,11,1490,209,501,147,317,62,184,64,74,21,139,160,271,50,2,89,100,544,7.92
5192,"Ian Mahinmi\mahinia01","2012-13",26,"IND","NBA",2.3,80,2,1322,149,329,149,327,0,2,104,171,115,196,311,27,39,66,92,201,402,5.41
5193,"Rick Mahorn\mahorri01","1992-93",34,"NJN","NBA",2.3,74,9,1077,101,214,100,211,1,3,88,110,93,186,279,33,19,31,58,156,291,4.71
5194,"Šarūnas Marčiulionis\marcisa01","1994-95",30,"SEA","NBA",2.3,66,4,1194,216,457,181,370,35,87,145,198,17,51,68,110,72,3,98,126,612,8.12
5195,"George McCloud\mccloge01","1994-95",27,"DAL","NBA",2.3,42,3,802,144,328,110,239,34,89,80,96,82,65,147,53,23,9,40,71,402,8.3
5196,"Xavier McDaniel\mcdanxa01","1993-94",30,"BOS","NBA",2.3,82,5,1971,387,839,377,798,10,41,144,213,142,258,400,126,48,39,116,193,928,9.65
5197,"Doug McDermott\mcderdo01","2017-18",26,"TOT","NBA",2.3,81,4,1768,237,508,145,292,92,216,64,81,40,160,200,79,19,16,56,122,630,6.52
5198,"Sam Mitchell\mitchsa01","1999-00",36,"MIN","NBA",2.3,66,24,1227,168,376,158,353,10,23,81,92,28,110,138,111,27,14,44,116,427,6
5199,"Cuttino Mobley\moblecu01","1998-99",23,"HOU","NBA",2.3,49,37,1456,172,405,119,257,53,148,90,110,22,89,111,121,44,23,79,98,487,9.26
5200,"Nazr Mohammed\mohamna01","2006-07",29,"DET","NBA",2.3,51,33,773,118,222,118,222,0,0,50,82,89,140,229,9,27,40,43,133,286,6.23
5201,"Eric Moreland\moreler01","2017-18",26,"DET","NBA",2.3,67,3,805,66,122,66,122,0,0,11,29,81,197,278,78,31,51,42,116,143,4.62
5202,"Lamond Murray\murrala01","2000-01",27,"CLE","NBA",2.3,78,46,2225,391,925,330,760,61,165,155,211,104,236,340,124,83,27,141,173,998,10.37
5203,"Dikembe Mutombo\mutomdi01","2007-08",41,"HOU","NBA",2.3,39,25,619,43,80,43,80,0,0,32,45,68,131,199,5,11,48,17,55,118,5.17
5204,"Ira Newble\newblir01","2001-02",27,"ATL","NBA",2.3,42,35,1273,131,263,130,256,1,7,75,88,80,142,222,45,38,20,49,117,338,8.89
5205,"Victor Oladipo\oladivi01","2018-19",26,"IND","NBA",2.3,36,36,1147,249,588,175,372,74,216,103,141,21,181,202,186,60,11,82,72,675,17.4
5206,"Bo Outlaw\outlabo01","1995-96",24,"LAC","NBA",2.3,80,3,985,107,186,107,183,0,3,72,162,87,113,200,50,44,91,45,127,286,4.82
5207,"Bo Outlaw\outlabo01","1993-94",22,"LAC","NBA",2.3,37,14,871,98,167,98,165,0,2,61,103,81,131,212,36,36,37,31,94,257,9.04
5208,"Travis Outlaw\outlatr01","2006-07",22,"POR","NBA",2.3,67,1,1532,246,567,236,530,10,37,143,181,65,152,217,52,61,74,66,150,645,8.47
5209,"Zaza Pachulia\pachuza01","2018-19",34,"DET","NBA",2.3,68,3,878,85,193,85,189,0,4,97,124,99,166,265,91,31,17,57,151,267,5.41
5210,"Smush Parker\parkesm01","2006-07",25,"LAL","NBA",2.3,82,80,2457,342,785,232,484,110,301,113,175,45,161,206,228,119,10,153,211,907,10.21
5211,"Elfrid Payton\paytoel01","2014-15",20,"ORL","NBA",2.3,82,63,2489,301,708,290,666,11,42,118,214,107,242,349,533,142,20,203,193,731,12.03
5212,"Kendrick Perkins\perkike01","2005-06",21,"BOS","NBA",2.3,68,40,1332,137,266,137,264,0,2,80,130,140,264,404,69,21,105,107,199,354,7.46
5213,"Eric Piatkowski\piatker01","2004-05",34,"CHI","NBA",2.3,68,11,841,111,258,54,124,57,134,45,56,15,64,79,51,29,1,37,67,324,4.12
5214,"Eric Piatkowski\piatker01","1998-99",28,"LAC","NBA",2.3,49,38,1242,180,417,115,252,65,165,88,102,39,101,140,53,44,6,53,86,513,8.75
5215,"Eric Piatkowski\piatker01","1996-97",26,"LAC","NBA",2.3,65,0,747,134,298,83,178,51,120,69,84,49,56,105,52,33,10,46,85,388,5.31
5216,"Eric Piatkowski\piatker01","1999-00",29,"LAC","NBA",2.3,75,23,1712,238,573,145,330,93,243,85,100,74,148,222,81,44,13,57,140,654,7.21
5217,"James Posey\poseyja01","2004-05",28,"MEM","NBA",2.3,50,18,1382,127,356,72,178,55,178,96,111,45,174,219,88,48,23,69,134,405,8.28
5218,"Pablo Prigioni\prigipa01","2014-15",37,"TOT","NBA",2.3,67,3,1197,91,228,34,62,57,166,35,41,30,89,119,171,79,1,62,88,274,5.9
5219,"Joel Przybilla\przybjo01","2005-06",26,"POR","NBA",2.3,56,52,1395,131,239,131,239,0,0,82,154,146,245,391,43,20,130,76,149,344,8.89
5220,"Theo Ratliff\ratlith01","2004-05",31,"POR","NBA",2.3,63,45,1731,115,257,115,257,0,0,74,107,111,220,331,34,23,158,56,183,304,7.09
5221,"J.J. Redick\redicjj01","2008-09",24,"ORL","NBA",2.3,64,5,1111,117,299,50,120,67,179,81,93,8,101,109,73,21,1,54,72,382,5.17
5222,"Bryant Reeves\reevebr01","1995-96",22,"VAN","NBA",2.3,77,63,2460,401,877,401,874,0,3,219,299,178,392,570,109,43,55,157,226,1021,11.96
5223,"Don Reid\reiddo01","2000-01",27,"ORL","NBA",2.3,65,7,764,82,145,82,145,0,0,46,75,84,158,242,21,23,54,48,190,210,4.65
5224,"Luke Ridnour\ridnolu01","2006-07",25,"SEA","NBA",2.3,71,58,2091,301,695,252,556,49,139,128,159,28,136,164,368,83,19,156,181,779,11.55
5225,"James Robinson\robinja02","1995-96",25,"POR","NBA",2.3,76,5,1627,229,574,127,290,102,284,89,135,44,113,157,150,34,16,111,146,649,7.02
5226,"Rodney Rogers\rogerro01","1995-96",24,"LAC","NBA",2.3,67,51,1950,306,641,257,488,49,153,113,180,113,173,286,167,75,35,144,216,774,11.22
5227,"Rodney Rogers\rogerro01","2002-03",31,"NJN","NBA",2.3,68,0,1303,183,455,139,323,44,132,68,90,61,202,263,107,50,31,91,192,478,7
5228,"Rajon Rondo\rondora01","2016-17",30,"CHI","NBA",2.3,69,42,1843,229,561,179,428,50,133,30,50,73,282,355,461,99,11,169,144,538,11.6
5229,"Sean Rooks\rooksse01","2000-01",31,"LAC","NBA",2.3,82,0,1553,169,395,168,393,1,2,107,143,91,212,303,77,34,64,73,197,446,5.81
5230,"Donald Royal\royaldo01","1995-96",29,"ORL","NBA",2.3,64,7,963,106,216,106,214,0,2,125,164,57,96,153,42,29,15,52,97,337,5.35
5231,"Bryon Russell\russebr01","2001-02",31,"UTA","NBA",2.3,66,40,1998,222,584,145,358,77,226,115,140,79,216,295,136,64,19,110,205,636,9.04
5232,"Byron Scott\scottby01","1995-96",34,"VAN","NBA",2.3,80,0,1894,271,676,197,455,74,221,203,243,40,152,192,123,63,22,100,126,819,8.49
5233,"Rony Seikaly\seikaro01","1995-96",30,"GSW","NBA",2.3,64,60,1813,285,568,283,565,2,3,204,282,166,333,499,71,40,69,180,219,776,12.48
5234,"Kevin Séraphin\serapke01","2011-12",22,"WAS","NBA",2.3,57,21,1176,203,382,203,381,0,1,47,70,103,177,280,33,19,76,66,133,453,8.16
5235,"Kyle Singler\singlky01","2012-13",24,"DET","NBA",2.3,82,74,2293,275,642,205,442,70,200,100,124,109,221,330,77,57,37,98,217,720,7.8
5236,"James Singleton\singlja01","2005-06",24,"LAC","NBA",2.3,59,10,753,77,151,67,131,10,20,39,50,63,134,197,29,19,21,28,95,203,4.35
5237,"Doug Smith\smithdo03","1993-94",24,"DAL","NBA",2.3,79,42,1684,295,678,293,669,2,9,106,127,114,235,349,119,82,38,93,287,698,8.41
5238,"Jason Smith\smithja02","2016-17",30,"WAS","NBA",2.3,74,3,1068,174,329,137,251,37,78,35,51,64,194,258,37,21,54,58,168,420,5.96
5239,"Joe Smith\smithjo02","2005-06",30,"MIL","NBA",2.3,44,5,887,145,305,145,303,0,2,89,115,83,147,230,31,24,13,40,120,379,8.18
5240,"Josh Smith\smithjo03","2014-15",29,"TOT","NBA",2.3,83,35,2300,414,987,342,759,72,228,127,255,152,378,530,277,87,116,206,228,1027,12.34
5241,"Michael Smith\smithmi02","1998-99",26,"VAN","NBA",2.3,48,10,1098,77,144,77,143,0,1,76,128,135,215,350,48,46,18,60,107,230,7.74
5242,"Tiago Splitter\splitti01","2010-11",26,"SAS","NBA",2.3,60,6,738,101,191,101,190,0,1,76,140,72,129,201,26,29,17,32,91,278,4.98
5243,"Jerry Stackhouse\stackje01","2007-08",33,"DAL","NBA",2.3,58,13,1412,213,526,153,342,60,184,132,148,33,100,133,145,28,10,86,82,618,8.94
5244,"Anthony Tolliver\tollian01","2016-17",31,"SAC","NBA",2.3,65,9,1477,155,351,65,121,90,230,61,82,51,186,237,77,34,20,56,109,461,7.16
5245,"Gary Trent\trentga01","2003-04",29,"MIN","NBA",2.3,68,2,1025,155,328,155,322,0,6,69,91,83,133,216,49,12,17,54,129,379,5.11
5246,"Evan Turner\turneev01","2010-11",22,"PHI","NBA",2.3,78,14,1797,225,529,211,485,14,44,101,125,42,264,306,159,49,14,80,138,565,7.28
5247,"Keith Van Horn\vanhoke01","2005-06",30,"DAL","NBA",2.3,53,0,1090,164,387,114,251,50,136,94,113,54,138,192,37,31,11,71,121,472,7.56
5248,"Anderson Varejão\varejan01","2005-06",23,"CLE","NBA",2.3,48,4,760,79,150,79,149,0,1,61,119,77,158,235,19,31,19,27,118,219,5.71
5249,"Greivis Vásquez\vasqugr01","2011-12",25,"NOH","NBA",2.3,66,26,1706,225,523,182,388,43,135,96,117,23,150,173,359,60,8,148,126,589,10.46
5250,"Rasheed Wallace\wallara01","1995-96",21,"WSB","NBA",2.3,65,51,1788,275,565,248,483,27,82,78,120,93,210,303,85,42,54,103,206,655,9.43
5251,"Earl Watson\watsoea01","2004-05",25,"MEM","NBA",2.3,80,14,1808,236,554,184,391,52,163,91,138,35,129,164,359,83,19,167,184,615,8.95
5252,"Earl Watson\watsoea01","2002-03",23,"MEM","NBA",2.3,79,2,1366,170,391,139,300,31,91,62,86,46,118,164,225,89,14,88,138,433,6.83
5253,"Bill Wennington\wennibi01","1994-95",31,"CHI","NBA",2.3,73,1,956,156,317,156,313,0,4,51,63,64,126,190,40,22,17,39,198,363,4.61
5254,"Chris Whitney\whitnch01","2000-01",29,"WAS","NBA",2.3,59,31,1532,182,470,89,222,93,248,101,113,12,94,106,248,55,3,103,150,558,9.66
5255,"Marvin Williams\willima02","2006-07",20,"ATL","NBA",2.3,64,63,2179,306,706,295,661,11,45,216,265,84,253,337,121,52,30,127,191,839,11.56
5256,"Marvin Williams\willima02","2012-13",26,"UTA","NBA",2.3,73,51,1727,199,470,145,304,54,166,77,99,55,208,263,77,37,38,60,98,529,6.76
5257,"Monty Williams\willimo01","1997-98",26,"SAS","NBA",2.3,72,16,1314,165,368,164,366,1,2,122,182,67,112,179,89,34,24,82,133,453,5.86
5258,"Kevin Willis\willike02","1999-00",37,"TOR","NBA",2.3,79,1,1679,236,569,235,566,1,3,131,164,201,281,482,49,36,48,98,256,604,7.39
5259,"David Wingate\wingada01","1992-93",29,"CHH","NBA",2.3,72,55,1471,180,336,179,330,1,6,79,107,49,125,174,183,66,9,89,135,440,7.44
5260,"Jeff Withey\witheje01","2015-16",25,"UTA","NBA",2.3,51,10,658,87,162,87,160,0,2,43,59,56,117,173,20,21,53,28,75,217,5.36
5261,"David Wood\woodda01","1993-94",29,"DET","NBA",2.3,78,3,1182,119,259,97,210,22,49,62,82,104,135,239,51,39,19,35,201,322,4.67
5262,"Orlando Woolridge\woolror01","1992-93",33,"TOT","NBA",2.3,58,47,1555,289,599,289,590,0,9,120,177,87,98,185,115,27,27,79,122,698,9.86
5263,"Metta World Peace\artesro01","1999-00",20,"CHI","NBA",2.3,72,63,2238,309,759,249,568,60,191,188,279,62,246,308,202,119,39,166,159,866,11.57
5264,"Nick Young\youngni01","2012-13",27,"PHI","NBA",2.3,59,17,1411,224,542,149,332,75,210,105,128,24,106,130,84,36,14,50,84,628,8.23
5265,"Tariq Abdul-Wahad\abdulta01","1999-00",25,"TOT","NBA",2.2,61,56,1578,274,646,271,623,3,23,146,193,101,190,291,98,59,28,106,147,697,9.82
5266,"Álex Abrines\abrinal01","2017-18",24,"OKC","NBA",2.2,75,8,1134,115,291,31,70,84,221,39,46,26,88,114,28,38,8,25,124,353,4.02
5267,"Cole Aldrich\aldrico01","2014-15",26,"NYK","NBA",2.2,61,16,976,144,301,144,301,0,0,50,64,101,237,338,75,37,65,59,122,338,7.37
5268,"Cory Alexander\alexaco01","1997-98",24,"TOT","NBA",2.2,60,22,1298,171,400,105,224,66,176,80,102,17,129,146,209,70,11,112,98,488,9.17
5269,"Courtney Alexander\alexaco02","2001-02",24,"WAS","NBA",2.2,56,28,1325,223,474,218,456,5,18,98,121,43,105,148,86,35,7,60,113,549,8.15
5270,"Greg Anderson\andergr01","1996-97",32,"SAS","NBA",2.2,82,48,1659,130,262,130,261,0,1,62,93,157,291,448,34,63,67,73,225,322,5.99
5271,"Trevor Ariza\arizatr01","2011-12",26,"NOH","NBA",2.2,41,41,1350,168,403,139,316,29,87,79,102,41,174,215,135,69,25,76,73,444,11.88
5272,"B.J. Armstrong\armstbj01","1997-98",30,"TOT","NBA",2.2,66,0,831,105,213,96,178,9,35,42,50,16,60,76,150,29,0,42,74,261,4.77
5273,"Vin Baker\bakervi01","2001-02",30,"SEA","NBA",2.2,55,41,1710,315,649,314,641,1,8,143,226,168,182,350,72,22,36,127,197,774,11.82
5274,"J.J. Barea\bareajo01","2008-09",24,"DAL","NBA",2.2,79,15,1600,246,557,191,403,55,154,70,93,36,141,177,269,37,5,105,121,617,7.8
5275,"J.J. Barea\bareajo01","2009-10",25,"DAL","NBA",2.2,78,18,1546,232,527,176,370,56,157,76,90,17,129,146,258,35,6,102,119,596,7.6
5276,"Andrea Bargnani\bargnan01","2011-12",26,"TOR","NBA",2.2,31,31,1032,209,484,175,369,34,115,151,173,24,148,172,61,18,15,69,52,603,15.45
5277,"Brandon Bass\bassbr01","2016-17",31,"LAC","NBA",2.2,52,0,577,107,186,106,183,1,3,77,88,43,86,129,21,14,11,29,45,292,5.54
5278,"Kent Bazemore\bazemke01","2017-18",28,"ATL","NBA",2.2,65,65,1789,284,676,176,402,108,274,160,201,25,223,248,228,100,45,157,147,836,13.08
5279,"Rodrigue Beaubois\beaubro01","2011-12",23,"DAL","NBA",2.2,53,12,1151,188,445,150,313,38,132,58,69,19,132,151,152,56,28,70,98,472,8.94
5280,"Charlie Bell\bellch01","2008-09",29,"MIL","NBA",2.2,70,23,1783,217,524,130,284,87,240,66,80,32,102,134,151,50,7,76,138,587,7.37
5281,"Raja Bell\bellra01","2004-05",28,"UTA","NBA",2.2,63,32,1790,303,667,249,533,54,134,112,150,48,153,201,91,44,8,79,205,772,9.6
5282,"Benoit Benjamin\benjabe01","1994-95",30,"NJN","NBA",2.2,61,57,1598,271,531,271,531,0,0,133,175,94,346,440,38,23,64,125,151,675,10.91
5283,"Patrick Beverley\beverpa01","2012-13",24,"HOU","NBA",2.2,41,0,713,79,189,43,93,36,96,34,41,45,64,109,117,37,21,44,83,228,7.36
5284,"DeJuan Blair\blairde01","2012-13",23,"SAS","NBA",2.2,61,16,851,142,271,142,270,0,1,44,70,66,164,230,45,37,10,49,112,328,5.77
5285,"Matt Bonner\bonnema01","2006-07",26,"SAS","NBA",2.2,56,0,653,106,237,70,143,36,94,27,38,64,92,156,22,17,11,25,67,275,4.46
5286,"Calvin Booth\boothca01","2003-04",27,"SEA","NBA",2.2,71,35,1206,135,290,135,288,0,2,75,94,86,194,280,28,17,101,45,150,345,5.74
5287,"Carlos Boozer\boozeca01","2014-15",33,"LAL","NBA",2.2,71,26,1692,371,743,371,743,0,0,94,150,111,371,482,95,41,12,92,184,836,10.57
5288,"Bruce Bowen\bowenbr01","2008-09",37,"SAS","NBA",2.2,80,10,1506,79,187,37,89,42,98,14,26,16,129,145,40,36,13,25,123,214,3.01
5289,"Bruce Bowen\bowenbr01","1997-98",26,"BOS","NBA",2.2,61,9,1305,122,298,102,239,20,59,76,122,79,95,174,81,87,29,52,174,340,6.48
5290,"Aaron Brooks\brookaa01","2013-14",29,"TOT","NBA",2.2,72,12,1557,233,581,137,333,96,248,83,95,43,97,140,233,52,13,117,146,645,8.43
5291,"Chucky Brown\brownch01","1992-93",24,"NJN","NBA",2.2,77,20,1186,160,331,160,326,0,5,71,98,88,144,232,51,20,24,56,112,391,4.91
5292,"Greg Buckner\buckngr01","2006-07",30,"DAL","NBA",2.2,76,11,1372,123,299,91,196,32,103,27,34,35,123,158,70,47,7,40,152,305,4.03
5293,"Sam Cassell\cassesa01","1993-94",24,"HOU","NBA",2.2,66,6,1122,162,388,136,300,26,88,90,107,25,109,134,192,59,7,94,136,440,7.25
5294,"Omri Casspi\casspom01","2017-18",29,"GSW","NBA",2.2,53,7,740,120,207,110,185,10,22,50,69,30,170,200,51,18,19,37,71,300,6.46
5295,"Chris Childs\childch01","2000-01",33,"TOT","NBA",2.2,77,5,1859,135,335,103,229,32,106,60,71,24,178,202,355,59,15,156,242,362,7.48
5296,"Nick Collison\collini01","2014-15",34,"OKC","NBA",2.2,66,2,1101,106,253,90,193,16,60,45,65,90,160,250,90,35,25,45,156,273,5.24
5297,"Daequan Cook\cookda02","2008-09",21,"MIA","NBA",2.2,75,4,1833,242,645,89,250,153,395,49,56,19,170,189,71,39,10,42,125,686,6.66
5298,"Tyrone Corbin\corbity01","1998-99",36,"ATL","NBA",2.2,47,6,1066,131,335,93,216,38,119,52,80,37,108,145,43,31,7,43,74,352,6.01
5299,"John Crotty\crottjo01","2001-02",32,"UTA","NBA",2.2,41,0,802,98,208,67,139,31,69,57,66,16,59,75,141,19,1,51,77,284,7.86
5300,"Dell Curry\curryde01","1999-00",35,"TOR","NBA",2.2,67,9,1095,194,454,99,212,95,242,24,32,11,89,100,89,32,9,40,66,507,6.03
5301,"Stephen Curry\curryst01","2011-12",23,"GSW","NBA",2.2,26,23,732,145,296,90,175,55,121,38,47,15,73,88,138,39,8,65,62,383,15.64
5302,"Samuel Dalembert\dalemsa01","2012-13",31,"MIL","NBA",2.2,47,23,765,137,253,136,252,1,1,38,55,105,171,276,21,17,53,51,90,313,7.73
5303,"Antonio Davis\davisan01","2002-03",34,"TOR","NBA",2.2,53,52,1894,261,641,261,641,0,0,216,280,130,307,437,131,23,62,118,150,738,13.23
5304,"Hubert Davis\davishu01","2000-01",30,"TOT","NBA",2.2,66,18,1692,196,433,118,262,78,171,54,62,28,111,139,110,35,1,81,121,524,7.04
5305,"Michael Dickerson\dickemi01","1998-99",23,"HOU","NBA",2.2,50,50,1558,215,462,144,298,71,164,46,72,26,57,83,95,27,11,66,90,547,8.67
5306,"Gorgui Dieng\dienggo01","2013-14",24,"MIN","NBA",2.2,60,15,818,113,227,112,226,1,1,59,93,103,197,300,39,30,50,54,108,286,6.18
5307,"Michael Doleac\doleami01","1998-99",21,"ORL","NBA",2.2,49,0,780,125,267,125,267,0,0,54,80,66,82,148,20,19,17,26,117,304,5.32
5308,"Toney Douglas\douglto01","2009-10",23,"NYK","NBA",2.2,56,12,1087,179,391,111,216,68,175,55,68,40,68,108,112,42,3,55,116,481,7.85
5309,"Chris Dudley\dudlech02","1992-93",27,"NJN","NBA",2.2,71,16,1398,94,266,94,266,0,0,57,110,215,298,513,16,17,103,54,195,245,5.36
5310,"LaPhonso Ellis\ellisla01","2001-02",31,"MIA","NBA",2.2,66,14,1684,189,452,151,328,38,124,53,84,107,180,287,56,30,37,73,196,469,6.45
5311,"Jamie Feick\feickja01","1998-99",24,"TOT","NBA",2.2,28,16,852,67,134,67,134,0,0,43,60,112,176,288,24,25,18,34,73,177,9.74
5312,"Raymond Felton\feltora01","2013-14",29,"NYK","NBA",2.2,65,65,2017,240,608,178,413,62,195,88,122,54,143,197,365,78,27,129,157,630,11.05
5313,"Raymond Felton\feltora01","2017-18",33,"OKC","NBA",2.2,82,2,1365,224,552,143,322,81,230,36,44,25,131,156,203,49,16,76,91,565,6.46
5314,"Randy Foye\foyera01","2009-10",26,"WAS","NBA",2.2,70,38,1667,256,619,193,437,63,182,129,145,16,114,130,228,33,10,94,123,704,8.83
5315,"Dean Garrett\garrede01","1997-98",31,"DEN","NBA",2.2,82,82,2632,242,565,242,565,0,0,114,176,227,417,644,90,57,133,84,197,598,9.09
5316,"Manu Ginóbili\ginobma01","2017-18",40,"SAS","NBA",2.2,65,0,1299,201,463,137,271,64,192,110,131,19,123,142,163,43,16,105,126,576,8.45
5317,"Joey Graham\grahajo01","2008-09",26,"TOR","NBA",2.2,78,10,1541,231,480,228,464,3,16,132,160,95,197,292,48,35,12,74,191,597,6.87
5318,"Willie Green\greenwi01","2009-10",28,"PHI","NBA",2.2,73,18,1553,248,543,201,407,47,136,95,114,20,109,129,152,32,11,67,135,638,7.5
5319,"Tom Hammonds\hammoto01","1993-94",26,"DEN","NBA",2.2,74,2,877,115,230,115,230,0,0,71,104,62,137,199,34,20,12,41,91,301,4.12
5320,"Othella Harrington\harriot01","1998-99",25,"HOU","NBA",2.2,41,10,903,156,304,156,304,0,0,88,122,72,174,246,15,6,25,61,103,400,8.99
5321,"Devin Harris\harride01","2016-17",33,"DAL","NBA",2.2,65,0,1087,136,341,78,164,58,177,107,129,11,116,127,136,43,7,57,101,437,6.74
5322,"Roy Hibbert\hibbero01","2015-16",29,"LAL","NBA",2.2,81,81,1878,182,411,182,409,0,2,117,145,132,266,398,95,32,110,76,252,481,7.28
5323,"Jordan Hill\hilljo01","2014-15",27,"LAL","NBA",2.2,70,57,1874,357,777,354,766,3,11,124,168,174,382,556,103,34,52,106,164,841,11.25
5324,"Tyrone Hill\hillty01","1998-99",30,"TOT","NBA",2.2,38,23,1104,122,268,122,268,0,0,81,150,115,172,287,35,34,16,59,145,325,9.03
5325,"Rodney Hood\hoodro01","2014-15",22,"UTA","NBA",2.2,50,21,1064,155,374,93,204,62,170,61,80,9,108,117,83,30,12,45,119,433,7.38
5326,"Eddie House\houseed01","2010-11",32,"MIA","NBA",2.2,56,1,978,128,321,60,146,68,175,38,40,9,83,92,62,32,3,29,68,362,5.39
5327,"Joe Ingles\inglejo01","2014-15",27,"UTA","NBA",2.2,79,32,1673,147,354,75,152,72,202,30,40,22,153,175,182,72,10,98,124,396,6.07
5328,"Bobby Jackson\jacksbo01","1999-00",26,"MIN","NBA",2.2,73,10,1034,140,346,127,300,13,46,76,98,50,103,153,172,48,7,58,114,369,5.6
5329,"Stephen Jackson\jacksst02","2008-09",30,"GSW","NBA",2.2,59,59,2339,413,997,310,692,103,305,294,356,70,233,303,381,88,31,229,153,1223,19.71
5330,"Jared Jeffries\jeffrja01","2009-10",28,"TOT","NBA",2.2,70,37,1794,138,314,117,243,21,71,75,120,130,158,288,101,62,71,76,203,372,6.96
5331,"Eddie Johnson\johnsed03","1997-98",38,"HOU","NBA",2.2,75,1,1490,227,544,161,346,66,198,113,136,50,103,153,88,32,3,62,89,633,6.54
5332,"Ivan Johnson\johnsiv01","2011-12",27,"ATL","NBA",2.2,56,0,934,141,275,139,269,2,6,72,100,65,161,226,32,43,18,69,116,356,6.73
5333,"Fred Jones\jonesfr01","2007-08",28,"NYK","NBA",2.2,70,26,1757,182,432,108,240,74,192,94,126,30,140,170,166,48,18,78,140,532,7.63
5334,"James Jones\jonesja02","2006-07",26,"PHO","NBA",2.2,76,7,1376,162,440,72,202,90,238,71,81,33,143,176,45,28,42,28,115,485,5.22
5335,"Enes Kanter\kanteen01","2013-14",21,"UTA","NBA",2.2,80,37,2138,419,853,419,852,0,1,149,204,222,376,598,75,28,42,144,230,987,11.06
5336,"Ryan Kelly\kellyry01","2013-14",22,"LAL","NBA",2.2,59,25,1312,157,371,109,229,48,142,110,135,42,177,219,95,32,45,47,147,472,8.18
5337,"Steve Kerr\kerrst01","2002-03",37,"SAS","NBA",2.2,75,0,952,110,256,61,132,49,124,30,34,12,48,60,70,27,3,35,49,299,3.52
5338,"Meyers Leonard\leoname01","2015-16",23,"POR","NBA",2.2,61,10,1333,195,435,109,207,86,228,35,46,51,263,314,92,8,18,77,183,511,8.04
5339,"Marcus Liberty\liberma01","1992-93",24,"DEN","NBA",2.2,78,32,1585,252,620,230,561,22,59,102,156,131,204,335,105,64,21,79,143,628,7.17
5340,"Luc Longley\longllu01","1993-94",25,"TOT","NBA",2.2,76,46,1502,219,465,219,464,0,1,90,125,129,304,433,109,45,79,119,216,528,8.24
5341,"John Lucas III\lucasjo02","2011-12",29,"CHI","NBA",2.2,49,2,726,143,358,88,218,55,140,28,32,22,54,76,108,19,1,42,42,369,6.12
5342,"Todd MacCulloch\maccuto01","2002-03",27,"PHI","NBA",2.2,42,35,812,123,238,123,238,0,0,53,79,66,130,196,20,19,32,35,107,299,7.26
5343,"Ian Mahinmi\mahinia01","2017-18",31,"WAS","NBA",2.2,77,0,1145,138,248,138,246,0,2,90,128,135,177,312,53,38,42,100,230,366,6
5344,"Matt Maloney\malonma01","1997-98",26,"HOU","NBA",2.2,78,78,2217,239,586,113,240,126,346,65,78,16,126,142,219,62,5,107,99,669,8.01
5345,"Tony Massenburg\masseto01","1994-95",27,"LAC","NBA",2.2,80,50,2127,282,601,282,598,0,3,177,235,160,295,455,67,48,58,118,253,741,9.09
5346,"Sean May\mayse01","2006-07",22,"CHA","NBA",2.2,35,8,838,164,328,162,325,2,3,86,112,73,160,233,66,19,24,56,100,416,11.91
5347,"Josh McRoberts\mcrobjo01","2012-13",25,"TOT","NBA",2.2,67,22,1487,156,343,132,259,24,84,65,85,93,232,325,141,32,27,66,131,401,7.39
5348,"Andre Miller\millean02","2014-15",38,"TOT","NBA",2.2,81,0,1253,145,290,138,256,7,34,58,77,37,116,153,284,32,6,104,103,355,6.16
5349,"Andre Miller\millean02","2013-14",37,"TOT","NBA",2.2,58,2,982,106,231,95,210,11,21,60,77,28,102,130,197,34,9,61,75,283,6.67
5350,"Sam Mitchell\mitchsa01","1993-94",30,"IND","NBA",2.2,75,18,1084,140,306,140,301,0,5,82,110,71,119,190,65,33,9,50,152,362,4.71
5351,"Mikki Moore\mooremi01","1999-00",24,"DET","NBA",2.2,29,0,488,87,140,87,140,0,0,54,68,44,68,112,17,9,31,23,104,228,8.5
5352,"Tracy Murray\murratr01","1993-94",22,"POR","NBA",2.2,66,1,820,167,355,117,246,50,109,50,72,43,68,111,31,21,20,37,76,434,5.22
5353,"Boštjan Nachbar\nachbbo01","2007-08",27,"NJN","NBA",2.2,75,1,1660,245,609,151,347,94,262,154,196,56,204,260,88,44,21,85,182,738,8.23
5354,"Lee Nailon\nailole01","2004-05",29,"NOH","NBA",2.2,68,51,2017,415,869,415,867,0,2,133,165,128,170,298,109,36,16,110,190,963,11.04
5355,"Larry Nance\nancela02","2015-16",23,"LAL","NBA",2.2,63,22,1266,158,300,157,290,1,10,32,47,101,211,312,44,54,23,41,124,349,6.7
5356,"Rasho Nesterović\nestera01","2008-09",32,"IND","NBA",2.2,70,19,1214,224,437,224,436,0,1,25,32,93,147,240,109,30,38,63,171,473,6.9
5357,"Joakim Noah\noahjo01","2018-19",33,"MEM","NBA",2.2,42,1,693,110,213,110,212,0,1,78,109,58,180,238,89,20,31,50,96,298,9.04
5358,"Joakim Noah\noahjo01","2016-17",31,"NYK","NBA",2.2,46,46,1015,99,202,99,201,0,1,34,78,162,241,403,103,30,37,58,127,232,8.73
5359,"Steve Novak\novakst01","2008-09",25,"LAC","NBA",2.2,71,3,1161,176,396,57,110,119,286,21,23,19,106,125,40,20,5,23,71,492,5.44
5360,"Charles Oakley\oaklech01","1999-00",36,"TOR","NBA",2.2,80,80,2431,234,560,220,519,14,41,66,85,117,423,540,253,102,45,154,294,548,9.61
5361,"Greg Oden\odengr01","2009-10",22,"POR","NBA",2.2,21,21,502,92,152,92,152,0,0,49,64,64,114,178,19,8,48,39,84,233,13.5
5362,"Lamar Odom\odomla01","2002-03",23,"LAC","NBA",2.2,49,47,1679,268,611,226,482,42,129,136,175,59,267,326,178,42,41,140,181,714,14.36
5363,"Jahlil Okafor\okafoja01","2018-19",23,"NOP","NBA",2.2,59,24,935,212,362,211,357,1,5,59,89,82,196,278,40,15,40,52,96,484,8.23
5364,"Greg Ostertag\ostergr01","1997-98",24,"UTA","NBA",2.2,63,23,1288,115,239,115,239,0,0,67,140,134,240,374,25,28,132,74,166,297,6.89
5365,"Kelly Oubre\oubreke01","2018-19",23,"TOT","NBA",2.2,69,19,1935,375,842,267,504,108,338,189,244,71,254,325,84,84,59,103,181,1047,13.04
5366,"Billy Owens\owensbi01","1992-93",23,"GSW","NBA",2.2,37,37,1201,247,493,246,482,1,11,117,183,108,156,264,144,35,28,106,105,612,16.22
5367,"Robert Pack\packro01","1994-95",25,"DEN","NBA",2.2,42,32,1144,170,395,140,323,30,72,137,175,19,94,113,290,61,6,134,101,507,14.21
5368,"Cherokee Parks\parksch02","1996-97",24,"MIN","NBA",2.2,76,0,961,103,202,103,201,0,1,46,76,83,112,195,34,41,48,32,150,252,4.16
5369,"Elfrid Payton\paytoel01","2015-16",21,"ORL","NBA",2.2,73,69,2145,318,730,288,638,30,92,112,190,77,184,261,468,89,20,177,159,778,12.3
5370,"Anthony Peeler\peelean01","2003-04",34,"SAC","NBA",2.2,75,0,1391,156,348,88,207,68,141,51,61,31,122,153,120,56,10,77,103,431,6.05
5371,"Miles Plumlee\plumlmi01","2015-16",27,"MIL","NBA",2.2,61,14,870,140,233,140,233,0,0,34,59,94,138,232,16,21,50,40,73,314,5.85
5372,"Vitaly Potapenko\potapvi01","1998-99",23,"TOT","NBA",2.2,50,44,1394,204,412,204,411,0,1,91,155,114,218,332,75,35,36,100,169,499,10.24
5373,"A.J. Price\priceaj01","2012-13",26,"WAS","NBA",2.2,57,22,1278,161,413,91,213,70,200,49,62,20,94,114,205,33,3,64,73,441,7.64
5374,"Brent Price\pricebr01","1998-99",30,"HOU","NBA",2.2,40,6,806,100,207,54,95,46,112,46,61,18,60,78,113,33,1,65,90,292,8.13
5375,"Glen Rice\ricegl01","1998-99",31,"LAL","NBA",2.2,27,25,985,171,396,118,261,53,135,77,90,9,90,99,71,17,6,45,67,472,13.65
5376,"Josh Richardson\richajo01","2016-17",23,"MIA","NBA",2.2,53,34,1614,202,513,127,286,75,227,60,77,35,133,168,140,60,39,65,132,539,9.55
5377,"Doc Rivers\riverdo01","1995-96",34,"SAS","NBA",2.2,78,0,1235,108,290,61,153,47,137,48,64,30,108,138,123,73,21,57,175,311,4.79
5378,"Andre Roberson\roberan03","2017-18",26,"OKC","NBA",2.2,39,39,1037,87,162,79,126,8,36,12,38,75,110,185,46,45,35,30,89,194,7.2
5379,"Brian Roberts\roberbr01","2012-13",27,"NOH","NBA",2.2,78,5,1324,213,511,154,358,59,153,70,77,17,80,97,219,37,3,71,108,555,6.55
5380,"Brian Roberts\roberbr01","2013-14",28,"NOP","NBA",2.2,72,42,1667,244,581,180,403,64,178,125,133,17,119,136,234,43,7,95,132,677,8.76
5381,"Eddie Robinson\robined01","2002-03",26,"CHI","NBA",2.2,64,18,1355,155,315,152,301,3,14,51,63,76,124,200,66,62,13,52,120,364,6.22
5382,"Nate Robinson\robinna01","2009-10",25,"TOT","NBA",2.2,56,2,1115,215,493,128,270,87,223,50,67,28,82,110,163,49,5,73,116,567,9.14
5383,"Carlos Rogers\rogerca01","1999-00",28,"HOU","NBA",2.2,53,15,1101,170,324,169,310,1,14,81,137,98,177,275,42,14,34,63,77,422,7.89
5384,"Sean Rooks\rooksse01","1993-94",24,"DAL","NBA",2.2,47,28,1255,193,393,193,392,0,1,150,210,84,175,259,49,21,44,80,109,536,10.72
5385,"Bryon Russell\russebr01","2003-04",33,"LAL","NBA",2.2,72,1,945,98,244,55,132,43,112,50,65,32,114,146,71,32,12,37,110,289,4.17
5386,"Dennis Schröder\schrode01","2015-16",22,"ATL","NBA",2.2,80,6,1621,329,781,252,542,77,239,144,182,25,179,204,349,70,9,183,138,879,10.64
5387,"Thabo Sefolosha\sefolth01","2008-09",24,"TOT","NBA",2.2,66,36,1453,152,357,128,270,24,87,61,73,54,188,242,111,75,45,64,104,389,7.21
5388,"Alexey Shved\shvedal01","2014-15",26,"TOT","NBA",2.2,42,9,767,133,335,86,196,47,139,121,150,23,76,99,106,30,6,48,48,434,9.26
5389,"Jason Smith\smithja02","2011-12",25,"NOH","NBA",2.2,40,29,947,181,348,180,339,1,9,33,47,72,124,196,34,21,41,40,102,396,9.28
5390,"Kirk Snyder\snydeki01","2005-06",22,"NOK","NBA",2.2,68,45,1310,205,453,159,324,46,129,86,117,55,106,161,102,29,23,70,106,542,6.99
5391,"Lance Stephenson\stephla01","2015-16",25,"TOT","NBA",2.2,69,13,1372,228,474,198,396,30,78,87,111,40,183,223,133,43,9,94,135,573,8.03
5392,"Mark Strickland\stricma01","1999-00",29,"MIA","NBA",2.2,58,5,663,122,224,122,224,0,0,40,56,44,96,140,22,15,18,24,68,284,4.63
5393,"Rod Strickland\stricro02","2000-01",34,"TOT","NBA",2.2,54,28,1371,182,429,178,412,4,17,130,173,36,104,140,303,53,5,107,76,498,10.7
5394,"Rodney Stuckey\stuckro01","2013-14",27,"DET","NBA",2.2,73,5,1950,372,853,348,765,24,88,244,292,39,130,169,152,54,10,125,131,1012,10.68
5395,"Jeff Teague\teaguje01","2018-19",30,"MIN","NBA",2.2,42,41,1264,176,416,141,311,35,105,123,153,16,90,106,343,43,18,97,90,510,14.65
5396,"Garrett Temple\templga01","2018-19",32,"TOT","NBA",2.2,75,55,2040,208,493,118,229,90,264,80,107,28,188,216,106,76,30,70,204,586,7.61
5397,"Garrett Temple\templga01","2016-17",30,"SAC","NBA",2.2,65,21,1728,183,432,101,212,82,220,58,74,32,152,184,168,84,28,78,141,506,8.7
5398,"Hasheem Thabeet\thabeha01","2012-13",25,"OKC","NBA",2.2,66,4,770,64,106,64,106,0,0,32,53,69,126,195,11,30,60,41,148,160,3.95
5399,"Kenny Thomas\thomake01","2000-01",23,"HOU","NBA",2.2,74,21,1820,206,465,181,373,25,92,91,126,122,295,417,77,40,43,116,178,528,7.59
5400,"Kenny Thomas\thomake01","1999-00",22,"HOU","NBA",2.2,72,29,1797,212,531,180,409,32,122,138,209,147,290,437,113,54,22,112,167,594,8.36
5401,"Tim Thomas\thomati01","1998-99",21,"TOT","NBA",2.2,50,26,812,132,279,111,211,21,68,73,112,49,77,126,46,26,12,46,107,358,6.34
5402,"Tim Thomas\thomati01","2001-02",24,"MIL","NBA",2.2,74,22,1987,316,753,221,462,95,291,142,179,64,236,300,105,65,32,127,200,869,9.92
5403,"Tim Thomas\thomati01","2004-05",27,"NYK","NBA",2.2,71,68,1940,315,718,230,510,85,208,136,173,45,192,237,110,41,17,113,222,851,9.64
5404,"Tyrus Thomas\thomaty01","2006-07",20,"CHI","NBA",2.2,72,4,966,134,282,134,280,0,2,106,175,89,180,269,40,46,76,94,162,374,6.08
5405,"Al Thornton\thornal01","2009-10",26,"TOT","NBA",2.2,75,46,2079,320,676,309,645,11,31,153,211,116,178,294,90,45,35,102,206,804,9.14
5406,"Beno Udrih\udrihbe01","2012-13",30,"TOT","NBA",2.2,66,9,1457,210,476,176,374,34,102,84,103,34,107,141,302,41,3,108,90,538,8.97
5407,"Nick Van Exel\vanexni01","1998-99",27,"DEN","NBA",2.2,50,50,1802,306,769,234,535,72,234,142,175,14,99,113,368,40,3,121,90,826,14.84
5408,"Anderson Varejão\varejan01","2010-11",28,"CLE","NBA",2.2,31,31,994,114,216,114,214,0,2,54,81,98,203,301,45,27,38,40,87,282,11.97
5409,"John Wall\walljo01","2010-11",20,"WAS","NBA",2.2,69,64,2606,398,972,364,857,34,115,301,393,35,282,317,574,121,35,261,175,1131,18.07
5410,"T.J. Warren\warretj01","2015-16",22,"PHO","NBA",2.2,47,4,1070,221,441,193,371,28,70,45,64,57,90,147,44,37,16,32,94,515,9.04
5411,"Delonte West\westde01","2011-12",28,"DAL","NBA",2.2,44,33,1060,166,360,139,284,27,76,62,70,13,88,101,139,58,11,76,67,421,9.9
5412,"Ennis Whatley\whatlen01","1993-94",31,"ATL","NBA",2.2,82,1,1004,120,236,120,230,0,6,52,66,22,77,99,181,59,2,78,93,292,4.83
5413,"Eric Williams\willier01","2001-02",29,"BOS","NBA",2.2,74,30,1747,144,385,120,299,24,86,160,219,58,163,221,109,77,8,95,179,472,6.54
5414,"Eric Williams\willier01","2000-01",28,"BOS","NBA",2.2,81,11,1745,162,448,116,309,46,139,165,231,64,143,207,112,64,13,76,179,535,6.1
5415,"Jayson Williams\willija01","1998-99",30,"NJN","NBA",2.2,30,30,1020,97,218,97,216,0,2,48,85,147,213,360,33,24,60,46,126,242,11.55
5416,"Mo Williams\willima01","2013-14",31,"POR","NBA",2.2,74,0,1834,280,672,197,447,83,225,78,89,42,111,153,321,55,10,149,197,721,9.54
5417,"Mo Williams\willima01","2004-05",22,"MIL","NBA",2.2,80,80,2254,323,737,291,638,32,99,136,160,50,194,244,484,74,11,196,221,814,11.7
5418,"Shelden Williams\willish02","2006-07",23,"ATL","NBA",2.2,81,31,1514,166,365,164,361,2,4,110,144,131,304,435,44,52,39,96,199,444,6.49
5419,"Walt Williams\williwa02","1997-98",27,"TOT","NBA",2.2,59,17,1470,210,544,130,325,80,219,108,125,50,150,200,122,59,35,92,161,608,9.38
5420,"Kevin Willis\willike02","1995-96",33,"TOT","NBA",2.2,75,60,2135,325,712,324,703,1,9,143,202,208,430,638,53,32,41,161,253,794,10.07
5421,"David Wood\woodda01","1994-95",30,"GSW","NBA",2.2,78,13,1336,153,326,122,235,31,91,91,117,83,158,241,65,28,13,53,217,428,5.51
5422,"Dorell Wright\wrighdo01","2007-08",22,"MIA","NBA",2.2,44,34,1104,143,293,139,282,4,11,57,69,48,172,220,60,29,41,29,79,347,8.68
5423,"Lorenzen Wright\wrighlo02","1998-99",23,"LAC","NBA",2.2,48,15,1135,119,260,119,259,0,1,81,117,142,219,361,33,26,36,48,162,319,8.1
5424,"Lorenzen Wright\wrighlo02","1999-00",24,"ATL","NBA",2.2,75,0,1205,180,361,179,358,1,3,87,135,117,188,305,21,29,40,66,203,448,5.89
5425,"Álex Abrines\abrinal01","2016-17",23,"OKC","NBA",2.1,68,6,1055,134,341,40,94,94,247,44,49,18,68,86,40,37,8,33,114,406,4.76
5426,"Alexis Ajinça\ajincal01","2013-14",25,"NOP","NBA",2.1,56,30,951,136,249,136,248,0,1,56,67,94,183,277,40,23,46,63,187,328,7.1
5427,"Derek Anderson\anderde01","1998-99",24,"CLE","NBA",2.1,38,13,978,125,314,104,245,21,69,138,165,20,89,109,145,48,4,82,73,409,11.17
5428,"Shandon Anderson\andersh01","2004-05",31,"TOT","NBA",2.1,66,5,1171,98,217,93,188,5,29,54,66,41,150,191,70,40,14,50,138,255,4.74
5429,"Trevor Ariza\arizatr01","2004-05",19,"NYK","NBA",2.1,80,12,1382,172,389,169,376,3,13,121,174,89,153,242,85,70,18,73,150,468,6.03
5430,"Leandro Barbosa\barbole01","2015-16",33,"GSW","NBA",2.1,68,0,1079,171,370,132,260,39,110,52,62,28,89,117,82,44,10,53,107,433,5.79
5431,"Brent Barry\barrybr01","1996-97",25,"LAC","NBA",2.1,59,0,1094,155,379,99,206,56,173,76,93,30,80,110,154,51,15,76,88,442,7.55
5432,"Jon Barry\barryjo01","1993-94",24,"MIL","NBA",2.1,72,7,1242,158,382,126,267,32,115,97,122,36,110,146,168,102,17,83,110,445,7.23
5433,"Kent Bazemore\bazemke01","2016-17",27,"ATL","NBA",2.1,73,64,1963,295,721,203,455,92,266,119,168,45,186,231,177,91,52,125,165,801,10.12
5434,"Travis Best\besttr01","1998-99",26,"IND","NBA",2.1,49,0,1043,127,305,105,246,22,59,70,83,19,61,80,169,42,4,62,111,346,7.62
5435,"Mike Bibby\bibbymi01","2007-08",29,"TOT","NBA",2.1,48,44,1573,248,603,155,355,93,248,78,100,16,144,160,290,54,4,119,97,667,13.73
5436,"Steve Blake\blakest01","2006-07",26,"TOT","NBA",2.1,82,42,2225,209,509,142,301,67,208,43,64,21,148,169,408,61,8,129,121,528,8.13
5437,"Steve Blake\blakest01","2014-15",34,"POR","NBA",2.1,81,0,1529,122,327,45,108,77,219,29,41,16,121,137,288,41,5,104,118,350,5.75
5438,"Matt Bonner\bonnema01","2014-15",34,"SAS","NBA",2.1,72,19,935,94,230,48,104,46,126,30,37,29,86,115,47,10,12,11,65,264,3.27
5439,"Calvin Booth\boothca01","2000-01",24,"TOT","NBA",2.1,55,29,933,120,252,120,252,0,0,53,78,77,169,246,42,29,111,53,146,293,7.07
5440,"Ryan Bowen\bowenry01","2002-03",27,"DEN","NBA",2.1,62,31,996,97,197,95,190,2,7,27,41,78,79,157,54,65,29,43,82,223,4.91
5441,"Chucky Brown\brownch01","1994-95",26,"HOU","NBA",2.1,41,14,814,105,174,104,171,1,3,38,62,64,125,189,30,11,14,29,105,249,6.76
5442,"Sterling Brown\brownst02","2018-19",23,"MIL","NBA",2.1,58,7,1034,145,312,92,165,53,147,29,42,29,155,184,84,25,8,46,88,372,6.37
5443,"Trey Burke\burketr01","2015-16",23,"UTA","NBA",2.1,64,0,1366,262,634,174,378,88,256,67,82,18,94,112,148,35,6,80,86,679,8.15
5444,"Caron Butler\butleca01","2003-04",23,"MIA","NBA",2.1,68,56,2030,240,631,230,589,10,42,133,176,92,234,326,126,75,13,91,162,623,8.28
5445,"Marcus Camby\cambyma01","2001-02",27,"NYK","NBA",2.1,29,29,1007,130,290,130,289,0,1,62,99,89,233,322,33,34,50,42,107,322,13
5446,"Elden Campbell\campbel01","2003-04",35,"DET","NBA",2.1,65,27,892,138,314,138,314,0,0,85,124,52,157,209,45,21,50,63,137,361,5.41
5447,"Tony Campbell\campbto01","1994-95",32,"CLE","NBA",2.1,78,0,1128,161,392,146,350,15,42,132,159,60,93,153,69,32,8,65,122,469,5.07
5448,"Antoine Carr\carran01","1995-96",34,"UTA","NBA",2.1,80,0,1532,233,510,233,507,0,3,114,144,71,129,200,74,28,65,78,254,580,6.37
5449,"Tyson Chandler\chandty01","2018-19",36,"TOT","NBA",2.1,55,6,875,61,99,61,98,0,1,51,87,92,215,307,37,21,23,42,110,173,5.45
5450,"Pete Chilcutt\chilcpe01","1994-95",26,"HOU","NBA",2.1,68,17,1347,146,328,111,242,35,86,31,42,106,211,317,66,25,43,61,117,358,6.04
5451,"Chris Childs\childch01","1999-00",32,"NYK","NBA",2.1,71,2,1675,146,357,109,253,37,104,47,59,17,130,147,285,36,4,105,240,376,6.72
5452,"Jordan Clarkson\clarkjo01","2015-16",23,"LAL","NBA",2.1,79,79,2552,475,1098,364,778,111,320,164,204,93,220,313,192,88,7,135,168,1225,12.44
5453,"Chris Copeland\copelch01","2012-13",28,"NYK","NBA",2.1,56,13,862,182,380,123,240,59,140,63,83,34,85,119,27,16,12,50,104,486,6.71
5454,"Tyrone Corbin\corbity01","1994-95",32,"ATL","NBA",2.1,81,4,1389,205,464,191,408,14,56,78,114,98,164,262,67,55,16,74,161,502,5.71
5455,"John Crotty\crottjo01","1994-95",25,"UTA","NBA",2.1,80,0,1019,93,231,82,195,11,36,98,121,27,70,97,205,39,6,70,105,295,4.84
5456,"Terry Cummings\cummite01","1996-97",35,"SEA","NBA",2.1,45,3,828,155,319,152,314,3,5,57,82,70,113,183,39,33,7,45,113,370,7.49
5457,"Dante Cunningham\cunnida01","2015-16",28,"NOP","NBA",2.1,80,46,1971,186,412,131,238,55,174,57,82,57,179,236,77,42,33,41,173,484,5.92
5458,"Baron Davis\davisba01","1999-00",20,"CHH","NBA",2.1,82,0,1523,182,433,157,322,25,111,97,153,48,117,165,309,97,19,140,201,486,7.63
5459,"Todd Day\dayto01","1993-94",24,"MIL","NBA",2.1,76,39,2127,351,845,318,697,33,148,231,331,115,195,310,138,103,52,129,221,966,10.99
5460,"Austin Daye\dayeau01","2010-11",22,"DET","NBA",2.1,72,16,1446,193,471,124,299,69,172,82,108,64,210,274,78,39,39,59,165,537,7.01
5461,"Tony Delk\delkto01","2004-05",31,"ATL","NBA",2.1,56,1,1340,246,591,174,389,72,202,103,136,28,102,130,104,47,3,54,123,667,9.15
5462,"Matthew Dellavedova\dellama01","2013-14",23,"CLE","NBA",2.1,72,4,1271,122,296,65,141,57,155,38,48,29,94,123,187,33,5,60,121,339,5.46
5463,"Keyon Dooling\doolike01","2006-07",26,"ORL","NBA",2.1,66,2,1435,188,458,157,362,31,96,114,141,22,64,86,112,52,15,72,125,521,6.67
5464,"Blue Edwards\edwarbl01","1997-98",32,"VAN","NBA",2.1,81,20,1968,326,742,286,622,40,120,180,215,61,156,217,201,86,27,134,183,872,9.89
5465,"Craig Ehlo\ehlocr01","1994-95",33,"ATL","NBA",2.1,49,0,1166,191,422,140,288,51,134,44,71,55,92,147,113,46,6,73,86,477,8.88
5466,"Maurice Evans\evansma01","2004-05",26,"SAC","NBA",2.1,65,11,1233,165,373,138,291,27,82,59,78,88,113,201,45,37,8,34,104,416,5.66
5467,"Reggie Evans\evansre01","2005-06",25,"TOT","NBA",2.1,67,25,1393,131,268,131,267,0,1,115,217,171,331,502,38,40,10,85,166,377,7.1
5468,"Bryn Forbes\forbebr01","2017-18",24,"SAS","NBA",2.1,80,12,1517,209,497,120,269,89,228,48,72,12,98,110,80,28,2,37,108,555,5.13
5469,"Evan Fournier\fournev01","2014-15",22,"ORL","NBA",2.1,58,32,1661,253,575,168,350,85,225,107,147,28,125,153,120,40,2,82,116,698,9.78
5470,"Rick Fox\foxri01","1992-93",23,"BOS","NBA",2.1,71,14,1082,184,380,180,357,4,23,81,101,55,104,159,113,61,21,77,133,453,6.63
5471,"Channing Frye\fryech01","2014-15",31,"ORL","NBA",2.1,75,51,1870,191,487,55,141,136,346,31,35,27,266,293,94,47,39,78,191,549,7.2
5472,"Lawrence Funderburke\fundela01","1997-98",27,"SAC","NBA",2.1,52,1,1094,191,390,190,383,1,7,110,162,80,154,234,63,19,15,62,56,493,8.52
5473,"Kevin Gamble\gamblke01","1993-94",28,"BOS","NBA",2.1,75,28,1880,368,804,343,701,25,103,103,126,41,118,159,149,57,22,77,134,864,9.06
5474,"Devean George\georgde01","2006-07",29,"DAL","NBA",2.1,60,17,1283,146,370,93,220,53,150,36,48,57,156,213,33,46,23,51,143,381,5.77
5475,"Ben Gordon\gordobe01","2009-10",26,"DET","NBA",2.1,62,17,1730,291,699,216,465,75,234,198,230,26,93,119,166,49,6,118,147,855,11.07
5476,"Eric Gordon\gordoer01","2015-16",27,"NOP","NBA",2.1,45,44,1481,231,552,118,258,113,294,111,125,10,89,99,121,43,14,73,98,686,12.52
5477,"Jerami Grant\grantje01","2015-16",21,"PHI","NBA",2.1,77,52,2066,251,599,216,453,35,146,212,322,99,262,361,135,54,127,110,215,749,9.97
5478,"Gerald Green\greenge01","2017-18",32,"HOU","NBA",2.1,41,2,929,168,413,58,115,110,298,51,60,15,118,133,25,24,15,31,87,497,9.19
5479,"Willie Green\greenwi01","2007-08",26,"PHI","NBA",2.1,74,74,1970,379,870,328,691,51,179,112,148,32,150,182,151,54,22,109,119,921,9.42
5480,"Justin Hamilton\hamilju01","2016-17",26,"BRK","NBA",2.1,64,7,1177,174,379,119,199,55,180,39,52,71,191,262,55,29,43,43,91,442,6.93
5481,"Al Harrington\harrial01","2010-11",30,"DEN","NBA",2.1,73,3,1665,281,675,164,347,117,328,86,117,76,256,332,101,39,10,106,202,765,8.79
5482,"Lucious Harris\harrilu01","1995-96",25,"DAL","NBA",2.1,61,1,1016,183,397,136,272,47,125,68,87,41,81,122,79,35,3,46,56,481,6.72
5483,"Josh Hart\hartjo01","2018-19",23,"LAL","NBA",2.1,67,22,1715,189,464,97,190,92,274,55,80,35,213,248,93,64,40,58,147,525,7.79
5484,"Spencer Hawes\hawessp01","2009-10",21,"SAC","NBA",2.1,72,59,1904,312,666,286,579,26,87,73,106,145,291,436,158,32,83,131,200,723,10.33
5485,"Jarvis Hayes\hayesja01","2008-09",27,"NJN","NBA",2.1,74,1,1832,257,577,163,333,94,244,36,52,27,240,267,54,52,7,49,162,644,7.27
5486,"Carl Herrera\herreca01","1994-95",28,"HOU","NBA",2.1,61,26,1331,171,327,171,325,0,2,73,117,98,180,278,44,40,38,71,136,415,7.3
5487,"Roy Hibbert\hibbero01","2008-09",22,"IND","NBA",2.1,70,42,1009,198,420,198,420,0,0,98,147,115,128,243,49,20,76,55,215,494,6.63
5488,"George Hill\hillge01","2008-09",22,"SAS","NBA",2.1,77,7,1270,150,372,126,299,24,73,114,146,30,128,158,136,45,21,74,150,438,5.75
5489,"Solomon Hill\hillso01","2015-16",24,"IND","NBA",2.1,59,3,866,93,208,69,134,24,74,36,42,39,127,166,57,37,11,33,68,246,4.85
5490,"Fred Hoiberg\hoibefr01","1996-97",24,"IND","NBA",2.1,47,0,572,67,156,38,86,29,70,61,77,13,68,81,41,27,6,22,51,224,4.84
5491,"Justin Holiday\holidju01","2018-19",29,"TOT","NBA",2.1,82,77,2607,300,777,138,312,162,465,95,106,46,277,323,146,121,36,104,164,857,9.83
5492,"Larry Hughes\hughela01","2008-09",30,"TOT","NBA",2.1,55,20,1479,224,557,149,364,75,193,117,145,16,143,159,119,72,14,71,96,640,10.13
5493,"Jaren Jackson\jacksja01","1998-99",31,"SAS","NBA",2.1,47,13,861,108,284,55,137,53,147,32,39,21,78,99,49,41,9,37,63,301,5.61
5494,"Richard Jefferson\jefferi01","2016-17",36,"CLE","NBA",2.1,79,13,1614,153,343,91,157,62,186,80,108,28,175,203,78,26,10,52,153,448,5.4
5495,"Jonas Jerebko\jerebjo01","2016-17",29,"BOS","NBA",2.1,78,6,1232,114,262,69,132,45,130,26,37,59,213,272,71,25,17,39,122,299,4.52
5496,"Chris Kaman\kamanch01","2004-05",22,"LAC","NBA",2.1,63,50,1632,246,495,246,494,0,1,80,121,135,288,423,73,26,68,115,182,572,9.55
5497,"Jerome Kersey\kerseje01","1999-00",37,"SAS","NBA",2.1,72,18,1310,146,354,146,345,0,9,29,41,58,167,225,69,67,47,51,161,321,5.07
5498,"Michael Kidd-Gilchrist\kiddgmi01","2012-13",19,"CHA","NBA",2.1,78,77,2025,281,613,279,604,2,9,140,187,131,324,455,117,54,70,101,164,704,9.43
5499,"Brevin Knight\knighbr01","2007-08",32,"LAC","NBA",2.1,74,39,1674,138,342,138,336,0,6,62,71,15,127,142,328,100,11,71,160,338,7.36
5500,"Carl Landry\landrca01","2015-16",32,"PHI","NBA",2.1,36,12,569,139,250,133,237,6,13,67,91,49,97,146,32,12,9,22,69,351,8.92
5501,"Jeremy Lin\linje01","2018-19",30,"TOT","NBA",2.1,74,4,1436,238,541,183,354,55,187,176,210,22,157,179,231,47,13,124,144,707,9.45
5502,"Jeremy Lin\linje01","2016-17",28,"BRK","NBA",2.1,36,33,883,175,400,117,244,58,156,115,141,11,124,135,184,42,14,86,79,523,14.92
5503,"Robin Lopez\lopezro01","2011-12",23,"PHO","NBA",2.1,64,0,895,124,269,124,269,0,0,100,140,90,119,209,20,18,60,43,128,348,5.48
5504,"Tyronn Lue\luety01","2003-04",26,"ORL","NBA",2.1,76,69,2332,309,714,229,505,80,209,101,131,26,161,187,317,61,5,124,185,799,10.16
5505,"Ian Mahinmi\mahinia01","2014-15",28,"IND","NBA",2.1,61,6,1146,117,212,117,212,0,0,31,102,105,251,356,33,30,46,59,172,265,5.95
5506,"Dan Majerle\majerda01","2001-02",36,"PHO","NBA",2.1,65,1,1180,99,289,20,54,79,235,23,39,28,148,176,90,48,15,35,104,300,4.97
5507,"Kenyon Martin\martike01","2000-01",23,"NJN","NBA",2.1,68,68,2272,346,777,345,766,1,11,121,192,137,365,502,131,78,113,138,281,814,12.2
5508,"Lee Mayberry\maybele01","1995-96",25,"MIL","NBA",2.1,82,20,1705,153,364,78,175,75,189,41,68,21,69,90,302,64,10,89,144,422,6.54
5509,"JaVale McGee\mcgeeja01","2009-10",22,"WAS","NBA",2.1,60,19,968,156,307,156,306,0,1,74,116,88,155,243,14,16,101,51,122,386,6.84
5510,"Tracy McGrady\mcgratr01","2010-11",31,"DET","NBA",2.1,72,39,1686,227,514,197,426,30,88,90,129,49,202,251,252,66,34,102,101,574,9.11
5511,"Derrick McKey\mckeyde01","1997-98",31,"IND","NBA",2.1,57,4,1316,150,327,146,310,4,17,55,77,74,137,211,88,57,30,79,156,359,7.11
5512,"Alfonzo McKinnie\mckinal01","2018-19",26,"GSW","NBA",2.1,72,5,1003,134,275,92,157,42,118,27,48,81,166,247,31,18,15,30,134,337,4.7
5513,"Brad Miller\millebr01","1998-99",22,"CHH","NBA",2.1,38,0,469,78,138,77,136,1,2,81,102,35,82,117,22,9,18,32,65,238,6.53
5514,"Greg Minor\minorgr01","1994-95",23,"BOS","NBA",2.1,63,8,945,155,301,153,289,2,12,65,78,49,88,137,66,32,16,44,89,377,5.83
5515,"Cuttino Mobley\moblecu01","2007-08",32,"LAC","NBA",2.1,77,38,2702,377,870,310,678,67,192,163,199,50,225,275,202,78,34,123,152,984,11.23
5516,"Mikki Moore\mooremi01","2008-09",33,"TOT","NBA",2.1,70,20,1202,114,206,114,206,0,0,48,61,76,182,258,53,17,19,48,208,276,4.9
5517,"Lamond Murray\murrala01","1996-97",23,"LAC","NBA",2.1,74,1,1295,181,435,150,344,31,91,156,211,85,148,233,57,53,29,86,113,549,6.77
5518,"Jameer Nelson\nelsoja01","2012-13",30,"ORL","NBA",2.1,56,56,1977,306,780,185,425,121,355,89,102,23,186,209,413,71,6,154,161,822,15.02
5519,"Jermaine O'Neal\onealje01","1999-00",21,"POR","NBA",2.1,70,8,859,108,222,108,221,0,1,57,98,97,132,229,18,11,55,47,127,273,4.26
5520,"Charles Oakley\oaklech01","1998-99",35,"TOR","NBA",2.1,50,50,1633,140,327,139,322,1,5,67,83,96,278,374,168,46,21,96,182,348,9.93
5521,"Hakeem Olajuwon\olajuha01","2001-02",39,"TOR","NBA",2.1,61,37,1378,194,418,194,416,0,2,47,84,98,268,366,66,74,90,98,147,435,8.77
5522,"Greg Ostertag\ostergr01","2001-02",28,"UTA","NBA",2.1,74,14,1107,91,201,91,201,0,0,63,130,125,188,313,50,15,109,51,152,245,4.94
5523,"Ruben Patterson\patteru01","2005-06",30,"TOT","NBA",2.1,71,22,1792,327,635,326,622,1,13,203,338,118,126,244,127,76,21,150,150,858,10.81
5524,"Chuck Person\persoch01","1997-98",33,"SAS","NBA",2.1,61,11,1455,143,398,48,122,95,276,28,37,17,187,204,86,29,10,67,121,409,5.93
5525,"Mickaël Piétrus\pietrmi01","2004-05",22,"GSW","NBA",2.1,67,3,1340,214,501,147,306,67,195,141,202,65,124,189,82,46,18,92,139,636,8.03
5526,"Scot Pollard\pollasc01","2005-06",30,"IND","NBA",2.1,45,32,771,70,154,70,154,0,0,29,38,73,145,218,24,37,20,26,115,169,5.35
5527,"Tayshaun Prince\princta01","2011-12",31,"DET","NBA",2.1,63,63,2087,336,798,299,694,37,104,89,115,72,209,281,153,27,32,74,77,798,10.04
5528,"Chris Quinn\quinnch01","2008-09",25,"MIA","NBA",2.1,66,0,962,118,289,62,152,56,137,47,58,8,67,75,132,24,2,33,79,339,4.96
5529,"Ivan Rabb\rabbiv01","2018-19",21,"MEM","NBA",2.1,49,13,721,116,212,113,197,3,15,49,69,70,136,206,54,17,14,35,90,284,6.55
5530,"Vladimir Radmanović\radmavl01","2010-11",30,"GSW","NBA",2.1,74,6,1169,137,318,67,145,70,173,30,34,64,148,212,79,44,44,57,157,374,5.67
5531,"Vladimir Radmanović\radmavl01","2001-02",21,"SEA","NBA",2.1,61,16,1230,146,354,80,197,66,157,49,72,45,185,230,81,56,24,72,119,407,7.05
5532,"Zach Randolph\randoza01","2011-12",30,"MEM","NBA",2.1,28,8,735,132,285,130,277,2,8,58,88,78,147,225,48,21,4,40,57,324,11.17
5533,"Pooh Richardson\richapo01","1994-95",28,"LAC","NBA",2.1,80,77,2864,353,897,266,653,87,244,81,125,38,223,261,632,129,12,171,218,874,13.17
5534,"Quentin Richardson\richaqu01","2008-09",28,"NYK","NBA",2.1,72,51,1894,262,667,142,338,120,329,89,117,71,248,319,117,47,7,74,132,733,8.63
5535,"Andre Roberson\roberan03","2014-15",23,"OKC","NBA",2.1,67,65,1286,92,201,71,116,21,85,23,48,60,195,255,70,53,29,46,141,228,5.05
5536,"Jalen Rose\roseja01","1996-97",24,"IND","NBA",2.1,66,6,1188,172,377,151,305,21,72,117,156,27,94,121,155,57,18,107,136,482,7.54
5537,"Brandon Roy\roybr01","2010-11",26,"POR","NBA",2.1,47,23,1310,209,523,171,409,38,114,117,138,28,93,121,129,37,12,55,76,573,9.92
5538,"Bryon Russell\russebr01","1993-94",23,"UTA","NBA",2.1,67,48,1121,135,279,133,257,2,22,62,101,61,120,181,54,68,19,55,138,334,5.5
5539,"John Salmons\salmojo01","2003-04",24,"PHI","NBA",2.1,77,24,1603,161,416,111,269,50,147,71,92,38,158,196,134,62,16,77,122,443,5.89
5540,"Malik Sealy\sealyma01","1994-95",24,"LAC","NBA",2.1,60,41,1604,291,669,269,596,22,73,174,223,77,137,214,107,72,25,83,173,778,10.94
5541,"Brian Shaw\shawbr01","1999-00",33,"LAL","NBA",2.1,74,2,1249,123,322,105,264,18,58,41,54,45,171,216,201,35,14,75,105,305,5.34
5542,"Henry Sims\simshe01","2014-15",24,"PHI","NBA",2.1,73,32,1399,238,502,234,480,4,22,106,137,121,238,359,79,39,30,99,135,586,7.89
5543,"Henry Sims\simshe01","2013-14",23,"TOT","NBA",2.1,46,25,875,130,274,130,273,0,1,90,121,104,133,237,52,28,20,41,116,350,8.07
5544,"Michael Smith\smithmi02","1997-98",25,"TOT","NBA",2.1,48,33,1053,93,194,93,193,0,1,65,103,120,186,306,88,41,15,51,95,251,7.76
5545,"Eric Snow\snower01","2005-06",32,"CLE","NBA",2.1,82,82,2351,163,399,162,389,1,10,64,93,38,160,198,346,76,19,116,218,391,7.02
5546,"Marreese Speights\speigma01","2013-14",26,"GSW","NBA",2.1,79,3,982,195,442,187,411,8,31,110,134,101,189,290,32,10,34,66,148,508,5.56
5547,"Marreese Speights\speigma01","2009-10",22,"PHI","NBA",2.1,62,1,1016,212,444,212,439,0,5,108,145,85,167,252,36,29,34,51,152,532,7.58
5548,"Jerry Stackhouse\stackje01","1996-97",22,"PHI","NBA",2.1,81,81,3166,533,1308,431,966,102,342,511,667,156,182,338,253,93,63,316,219,1679,16.83
5549,"John Starks\starkjo01","2000-01",35,"UTA","NBA",2.1,75,64,2122,273,686,209,504,64,182,89,111,29,125,154,178,73,10,94,217,699,7.81
5550,"Derek Strong\stronde01","1993-94",25,"MIL","NBA",2.1,67,11,1131,141,341,138,328,3,13,159,206,109,172,281,48,38,14,61,69,444,6.52
5551,"Mike Sweetney\sweetmi01","2005-06",23,"CHI","NBA",2.1,66,44,1222,200,444,200,444,0,0,133,204,118,232,350,59,19,56,95,209,533,7.78
5552,"Jason Terry\terryja01","2016-17",39,"MIL","NBA",2.1,74,0,1365,105,243,32,72,73,171,24,29,15,91,106,98,46,20,36,95,307,4.7
5553,"Kurt Thomas\thomaku01","2009-10",37,"MIL","NBA",2.1,70,9,1049,99,208,99,208,0,0,12,15,84,207,291,47,26,46,48,159,210,4.43
5554,"Hedo Türkoğlu\turkohe01","2011-12",32,"ORL","NBA",2.1,53,53,1653,209,504,118,246,91,258,67,95,24,175,199,233,45,17,142,139,576,11.23
5555,"Evan Turner\turneev01","2012-13",24,"PHI","NBA",2.1,82,82,2892,441,1053,383,894,58,159,154,208,56,461,517,354,71,17,187,197,1094,12.8
5556,"Ekpe Udoh\udohek01","2011-12",24,"TOT","NBA",2.1,61,11,1290,127,295,127,293,0,2,86,114,100,154,254,57,40,102,53,174,340,6.98
5557,"Anderson Varejão\varejan01","2011-12",29,"CLE","NBA",2.1,25,25,785,114,222,114,218,0,4,43,64,109,178,287,43,35,17,45,62,271,13.78
5558,"Sasha Vujačić\vujacsa01","2010-11",26,"TOT","NBA",2.1,67,17,1648,239,595,142,333,97,262,81,96,30,156,186,132,54,5,66,136,656,8.26
5559,"Dion Waiters\waitedi01","2015-16",24,"OKC","NBA",2.1,78,15,2152,282,706,196,466,86,240,112,157,36,166,202,154,81,15,120,143,762,8.24
5560,"Samaki Walker\walkesa01","2002-03",26,"LAL","NBA",2.1,67,39,1243,115,274,115,273,0,1,66,101,115,253,368,64,20,55,56,143,296,5.77
5561,"T.J. Warren\warretj01","2018-19",25,"PHO","NBA",2.1,43,36,1360,297,611,220,431,77,180,101,124,31,143,174,64,51,29,52,119,772,14.87
5562,"C.J. Watson\watsocj01","2010-11",26,"CHI","NBA",2.1,82,1,1091,146,394,102,282,44,112,69,93,16,78,94,186,55,11,73,82,405,4.98
5563,"Jahidi White\whiteja01","2000-01",24,"WAS","NBA",2.1,68,56,1609,203,408,203,407,0,1,177,312,178,343,521,20,32,111,136,211,583,9.66
5564,"Andrew Wiggins\wiggian01","2014-15",19,"MIN","NBA",2.1,82,82,2969,497,1137,458,1011,39,126,354,466,134,240,374,170,86,50,177,190,1387,13.84
5565,"Andrew Wiggins\wiggian01","2017-18",22,"MIN","NBA",2.1,82,82,2979,569,1300,457,962,112,338,202,314,82,276,358,160,91,51,138,163,1452,13.5
5566,"Gerald Wilkins\wilkige01","1996-97",33,"ORL","NBA",2.1,80,26,2202,323,759,257,556,66,203,136,190,59,114,173,173,54,12,123,144,848,8.46
5567,"Alan Williams\willial03","2016-17",24,"PHO","NBA",2.1,47,0,708,138,267,138,266,0,1,70,112,94,198,292,23,27,32,37,125,346,8.08
5568,"Alvin Williams\willial02","2003-04",29,"TOR","NBA",2.1,56,54,1730,201,496,175,407,26,89,66,85,18,132,150,224,55,10,78,114,494,8.9
5569,"Buck Williams\willibu01","1997-98",37,"NYK","NBA",2.1,41,6,738,75,149,75,149,0,0,52,71,78,105,183,21,17,15,38,93,202,5.74
5570,"Derrick Williams\willide02","2014-15",23,"SAC","NBA",2.1,74,6,1462,217,485,168,329,49,156,134,196,41,161,202,50,34,4,56,67,617,6.65
5571,"Eric Williams\willier01","2004-05",32,"TOT","NBA",2.1,55,39,1322,142,330,114,257,28,73,112,161,44,128,172,92,38,4,60,147,424,7.35
5572,"Jason Williams\willija02","2007-08",32,"MIA","NBA",2.1,67,53,1886,211,550,114,275,97,275,69,80,12,118,130,307,83,5,91,93,588,9.5
5573,"Jason Williams\willija02","1998-99",23,"SAC","NBA",2.1,50,50,1805,231,617,131,294,100,323,79,105,14,139,153,299,95,1,143,91,641,13.15
5574,"Jayson Williams\willija01","1994-95",26,"NJN","NBA",2.1,75,6,982,149,323,149,318,0,5,65,122,179,246,425,35,26,33,59,160,363,5.56
5575,"Mo Williams\willima01","2014-15",32,"TOT","NBA",2.1,68,33,1980,341,860,222,512,119,348,163,187,22,152,174,424,46,14,172,162,964,13.4
5576,"Shelden Williams\willish02","2011-12",28,"NJN","NBA",2.1,58,35,1276,96,201,96,201,0,0,76,104,141,209,350,35,47,39,66,149,268,6.78
5577,"Thaddeus Young\youngth01","2009-10",21,"PHI","NBA",2.1,67,45,2145,382,813,334,675,48,138,114,165,130,220,350,97,81,15,126,133,926,11.77
5578,"Alaa Abdelnaby\abdelal01","1992-93",24,"TOT","NBA",2,75,52,1311,245,473,245,472,0,1,88,116,126,211,337,27,25,26,97,189,578,7.07
5579,"Arron Afflalo\afflaar01","2012-13",27,"ORL","NBA",2,64,64,2307,397,905,325,665,72,240,191,223,29,210,239,206,40,11,138,137,1057,13.39
5580,"Shandon Anderson\andersh01","1998-99",25,"UTA","NBA",2,50,2,1072,162,363,148,322,14,41,89,125,49,83,132,56,39,10,66,89,427,7.23
5581,"OG Anunoby\anunoog01","2018-19",21,"TOR","NBA",2,67,6,1352,183,404,116,202,67,202,36,62,58,139,197,47,46,22,55,140,469,6.3
5582,"Lonzo Ball\balllo01","2017-18",20,"LAL","NBA",2,52,50,1780,203,564,113,269,90,295,32,71,69,291,360,376,88,43,136,117,528,13.93
5583,"Matt Barnes\barnema02","2016-17",36,"TOT","NBA",2,74,18,1777,185,473,98,210,87,263,70,89,70,314,384,195,48,26,107,185,527,8.36
5584,"Brandon Bass\bassbr01","2009-10",24,"ORL","NBA",2,50,3,648,119,233,119,233,0,0,52,63,54,73,127,19,12,27,31,69,290,5.3
5585,"Tony Battie\battito01","2004-05",28,"ORL","NBA",2,81,32,1894,163,354,163,348,0,6,68,94,109,343,452,42,30,81,81,244,394,6.15
5586,"Jerryd Bayless\bayleje01","2011-12",23,"TOR","NBA",2,31,11,705,117,276,73,172,44,104,75,88,8,58,66,118,24,4,53,70,353,10.88
5587,"Rodrigue Beaubois\beaubro01","2009-10",21,"DAL","NBA",2,56,16,700,155,299,110,189,45,110,42,52,12,66,78,74,29,12,54,84,397,6.54
5588,"Charlie Bell\bellch01","2009-10",30,"MIL","NBA",2,71,39,1611,169,443,96,243,73,200,48,67,31,101,132,104,39,12,54,136,459,5.38
5589,"Jonathan Bender\bendejo01","2001-02",21,"IND","NBA",2,78,17,1647,198,460,153,335,45,125,140,181,64,180,244,62,19,49,96,147,581,6.62
5590,"Bismack Biyombo\biyombi01","2018-19",26,"CHO","NBA",2,54,32,783,89,156,89,156,0,0,58,91,81,166,247,33,11,41,34,103,236,5.76
5591,"Matt Bonner\bonnema01","2007-08",27,"SAS","NBA",2,68,3,853,121,291,75,154,46,137,38,44,53,139,192,32,14,17,39,111,326,4.31
5592,"Devin Booker\bookede01","2016-17",20,"PHO","NBA",2,78,78,2730,606,1431,459,1026,147,405,367,441,46,203,249,268,72,21,241,242,1726,16.81
5593,"Anthony Bowie\bowiean01","1994-95",31,"ORL","NBA",2,77,4,1261,177,369,165,329,12,40,61,73,54,85,139,159,47,21,86,138,427,6.02
5594,"Kedrick Brown\brownke01","2003-04",22,"TOT","NBA",2,55,26,969,117,254,79,155,38,99,17,27,41,105,146,64,30,7,29,80,289,5.31
5595,"Greg Buckner\buckngr01","2000-01",24,"DAL","NBA",2,37,9,820,84,192,82,185,2,7,59,81,60,97,157,49,33,9,27,118,229,6.91
5596,"Michael Cage\cagemi01","1996-97",35,"PHI","NBA",2,82,24,1247,66,141,66,141,0,0,19,41,112,208,320,43,48,42,17,118,151,3.72
5597,"Elden Campbell\campbel01","2002-03",34,"TOT","NBA",2,56,1,869,117,295,117,294,0,1,109,136,47,134,181,51,33,39,50,129,343,6.09
5598,"Pete Chilcutt\chilcpe01","1997-98",29,"VAN","NBA",2,82,0,1420,156,359,102,229,54,130,39,59,77,229,306,104,53,37,62,158,405,5.88
5599,"Derrick Coleman\colemde01","1998-99",31,"CHH","NBA",2,37,29,1178,168,406,161,373,7,33,143,190,76,252,328,78,24,42,90,96,486,13.23
5600,"Jason Collins\collija04","2005-06",27,"NJN","NBA",2,71,70,1895,104,262,101,250,3,12,44,86,93,249,342,70,46,40,61,251,255,5.02
5601,"Brian Cook\cookbr01","2004-05",24,"LAL","NBA",2,72,0,1087,176,422,98,223,78,199,28,37,63,153,216,35,23,26,29,139,458,5.3
5602,"Robert Covington\covinro01","2015-16",25,"PHI","NBA",2,67,49,1903,274,712,104,230,170,482,140,177,65,354,419,97,105,40,143,232,858,12.28
5603,"Austin Croshere\croshau01","2002-03",27,"IND","NBA",2,49,0,633,86,209,59,140,27,69,53,65,40,115,155,56,6,13,28,48,252,5.13
5604,"Terry Cummings\cummite01","1994-95",33,"SAS","NBA",2,76,20,1273,224,464,224,464,0,0,72,123,138,240,378,59,36,19,95,188,520,6.66
5605,"Dante Cunningham\cunnida01","2010-11",23,"TOT","NBA",2,78,18,1637,218,472,217,459,1,13,45,62,96,181,277,43,54,43,51,177,482,5.86
5606,"Dell Curry\curryde01","2000-01",36,"TOR","NBA",2,71,1,956,162,382,100,237,62,145,43,51,16,69,85,75,27,8,39,66,429,4.82
5607,"Michael Curry\currymi01","1999-00",31,"DET","NBA",2,82,3,1611,182,379,181,374,1,5,141,168,21,83,104,87,33,5,73,209,506,5.39
5608,"Michael Curry\currymi01","2002-03",34,"DET","NBA",2,78,77,1555,92,229,76,175,16,54,36,45,16,111,127,104,44,4,43,163,236,3.58
5609,"Marquis Daniels\daniema01","2010-11",30,"BOS","NBA",2,49,0,938,114,232,110,211,4,21,39,57,24,89,113,64,39,22,38,63,271,5.95
5610,"Antonio Davis\davisan01","1994-95",26,"IND","NBA",2,44,1,1030,109,245,109,245,0,0,117,174,105,175,280,25,19,29,64,134,335,8.03
5611,"Glen Davis\davisgl01","2013-14",28,"TOT","NBA",2,68,44,1662,271,593,267,582,4,11,95,137,108,243,351,77,58,29,76,159,641,8.68
5612,"Juan Dixon\dixonju01","2004-05",26,"WAS","NBA",2,63,4,1054,186,447,138,300,48,147,87,97,32,87,119,111,43,4,68,98,507,6.91
5613,"Melvin Ely\elyme01","2005-06",27,"CHA","NBA",2,57,22,1348,216,425,216,423,0,2,128,192,94,183,277,76,29,44,100,160,560,9.6
5614,"Patrick Ewing\ewingpa01","2000-01",38,"SEA","NBA",2,79,79,2107,294,684,294,682,0,2,172,251,124,461,585,92,53,91,151,229,760,9.9
5615,"Tim Frazier\fraziti01","2018-19",28,"TOT","NBA",2,59,19,1120,116,261,79,160,37,101,41,54,41,127,168,248,30,5,76,112,310,7.51
5616,"Daniel Gibson\gibsoda01","2006-07",20,"CLE","NBA",2,60,16,988,98,231,46,107,52,124,28,39,28,64,92,69,23,8,44,94,276,4.38
5617,"Horace Grant\grantho01","2003-04",38,"LAL","NBA",2,55,10,1106,92,224,92,223,0,1,39,54,79,154,233,71,24,21,29,70,223,5.07
5618,"Anfernee Hardaway\hardaan01","2003-04",32,"TOT","NBA",2,76,14,2095,279,679,249,600,30,79,111,138,69,218,287,176,70,20,107,146,699,8.51
5619,"Derek Harper\harpede01","1998-99",37,"LAL","NBA",2,45,29,1120,120,291,77,174,43,117,26,32,13,54,67,187,44,4,52,66,309,7.9
5620,"Donnell Harvey\harvedo01","2002-03",22,"DEN","NBA",2,77,27,1613,246,551,245,544,1,7,118,176,125,284,409,100,48,27,123,203,611,7.81
5621,"Alan Henderson\hendeal01","1995-96",23,"ATL","NBA",2,79,4,1416,192,434,192,431,0,3,119,200,164,192,356,51,44,43,87,217,503,6.28
5622,"Gerald Henderson\hendege02","2016-17",29,"PHI","NBA",2,72,41,1667,234,553,173,380,61,173,133,165,34,151,185,112,40,15,62,129,662,7.76
5623,"Gerald Henderson\hendege02","2015-16",28,"POR","NBA",2,72,0,1431,232,529,184,393,48,136,112,146,30,181,211,75,39,19,68,87,624,7.25
5624,"Carl Herrera\herreca01","1993-94",27,"HOU","NBA",2,75,0,1292,142,310,142,310,0,0,69,97,101,184,285,37,32,26,69,159,353,4.96
5625,"Jay Humphries\humphja01","1993-94",31,"UTA","NBA",2,75,19,1619,233,535,195,439,38,96,57,76,35,92,127,219,65,11,95,168,561,7.32
5626,"Lindsey Hunter\hunteli01","2001-02",31,"LAL","NBA",2,82,47,1616,187,490,108,282,79,208,20,40,18,103,121,129,66,19,55,120,473,5.06
5627,"Brandon Ingram\ingrabr01","2018-19",21,"LAL","NBA",2,52,52,1760,362,729,331,635,31,94,195,289,41,226,267,154,28,31,129,149,950,15.6
5628,"Marc Jackson\jacksma02","2002-03",28,"MIN","NBA",2,77,0,1041,153,349,152,348,1,1,114,149,86,139,225,37,24,30,59,137,421,5
5629,"Reggie Jackson\jacksre01","2017-18",27,"DET","NBA",2,45,45,1201,246,577,194,408,52,169,112,134,29,96,125,238,27,4,99,87,656,13.07
5630,"Henry James\jameshe01","1996-97",31,"ATL","NBA",2,53,15,945,125,306,49,125,76,181,30,36,27,54,81,21,11,1,29,98,356,4.68
5631,"Jonas Jerebko\jerebjo01","2012-13",25,"DET","NBA",2,49,2,892,142,316,117,233,25,83,68,88,68,117,185,43,38,8,42,90,377,7.19
5632,"Anthony Johnson\johnsan02","2007-08",33,"TOT","NBA",2,69,52,1531,155,355,113,262,42,93,35,43,22,115,137,262,52,9,84,115,387,7.16
5633,"Tyler Johnson\johnsty01","2015-16",23,"MIA","NBA",2,36,5,863,118,243,91,172,27,71,51,64,28,81,109,79,24,14,47,66,314,8.85
5634,"Dahntay Jones\jonesda02","2011-12",31,"IND","NBA",2,65,3,1052,115,281,82,204,33,77,83,99,23,94,117,63,23,11,46,119,346,4.78
5635,"Dahntay Jones\jonesda02","2008-09",28,"DEN","NBA",2,79,71,1426,154,336,143,319,11,17,110,151,58,110,168,78,49,19,68,199,429,5.36
5636,"Shawn Kemp\kempsh01","2002-03",33,"ORL","NBA",2,79,55,1633,211,505,211,504,0,1,115,155,147,304,451,55,66,33,102,239,537,7.09
5637,"Jon Koncak\koncajo01","1995-96",32,"ORL","NBA",2,67,35,1288,84,175,81,166,3,9,32,57,63,209,272,51,27,44,41,226,203,4.57
5638,"Toni Kukoč\kukocto01","2001-02",33,"ATL","NBA",2,59,9,1494,211,504,158,333,53,171,109,153,43,175,218,210,48,17,113,91,584,10.04
5639,"Trajan Langdon\langdtr01","2000-01",24,"CLE","NBA",2,65,5,1116,135,313,84,189,51,124,68,76,12,77,89,81,38,9,52,114,389,5.5
5640,"Jon Leuer\leuerjo01","2013-14",24,"MEM","NBA",2,49,0,642,121,246,98,197,23,49,37,47,37,121,158,20,18,13,27,63,302,5.68
5641,"Shaun Livingston\livinsh01","2018-19",33,"GSW","NBA",2,64,0,967,109,210,109,208,0,2,40,51,42,75,117,114,31,27,38,74,258,5.1
5642,"Tyronn Lue\luety01","2001-02",24,"WAS","NBA",2,71,0,1458,222,520,159,379,63,141,48,63,14,108,122,246,49,0,96,120,555,7.66
5643,"Jamaal Magloire\magloja01","2005-06",27,"MIL","NBA",2,82,82,2465,287,615,287,615,0,0,178,333,220,558,778,56,29,80,166,276,752,9.87
5644,"Thon Maker\makerth01","2018-19",21,"TOT","NBA",2,64,5,972,109,268,60,115,49,153,56,84,41,161,202,45,21,51,33,105,323,5.26
5645,"JaVale McGee\mcgeeja01","2008-09",21,"WAS","NBA",2,75,14,1143,191,387,191,387,0,0,107,162,120,174,294,23,33,75,61,155,489,6.56
5646,"Tracy McGrady\mcgratr01","1997-98",18,"TOR","NBA",2,64,17,1179,179,398,165,357,14,41,79,111,105,164,269,98,49,61,66,86,451,7.8
5647,"Aaron McKie\mckieaa01","1994-95",22,"POR","NBA",2,45,20,827,116,261,105,233,11,28,50,73,35,94,129,89,36,16,39,97,293,6.86
5648,"Aaron McKie\mckieaa01","2004-05",32,"PHI","NBA",2,68,3,1118,61,142,41,80,20,62,10,16,20,152,172,103,48,17,31,116,152,4.05
5649,"Jodie Meeks\meeksjo01","2017-18",30,"WAS","NBA",2,77,0,1119,157,393,85,183,72,210,101,117,15,111,126,70,29,4,37,55,487,5.19
5650,"Harold Miner\minerha01","1992-93",21,"MIA","NBA",2,73,0,1383,292,615,289,606,3,9,163,214,74,73,147,73,34,8,92,130,750,7.75
5651,"Shabazz Muhammad\muhamsh01","2014-15",22,"MIN","NBA",2,38,13,866,194,397,174,346,20,51,104,145,63,91,154,44,18,7,35,49,512,10.81
5652,"Shabazz Napier\napiesh01","2018-19",27,"BRK","NBA",2,56,2,983,169,435,93,207,76,228,115,138,18,82,100,143,41,16,66,67,529,8.49
5653,"Jusuf Nurkić\nurkiju01","2016-17",22,"TOT","NBA",2,65,48,1391,271,534,271,533,0,1,120,210,154,313,467,123,50,74,143,161,662,11.31
5654,"Jermaine O'Neal\onealje01","2012-13",34,"PHO","NBA",2,55,4,1029,179,371,179,371,0,0,96,115,82,211,293,42,19,78,73,126,454,8.7
5655,"Kelly Oubre\oubreke01","2016-17",21,"WAS","NBA",2,79,5,1605,186,442,132,254,54,188,75,99,61,200,261,47,58,17,50,195,501,5.87
5656,"Jannero Pargo\pargoja01","2006-07",27,"NOK","NBA",2,82,7,1710,283,692,202,483,81,209,104,122,20,160,180,203,53,4,122,121,751,7.84
5657,"Kendrick Perkins\perkike01","2011-12",27,"OKC","NBA",2,65,65,1744,128,262,128,262,0,0,73,112,120,306,426,78,25,73,118,189,329,7.42
5658,"Sam Perkins\perkisa01","2000-01",39,"IND","NBA",2,64,41,999,86,226,48,116,38,110,32,38,32,136,168,41,33,18,19,61,242,4.02
5659,"Tim Perry\perryti01","1992-93",27,"PHI","NBA",2,81,51,2104,287,613,277,564,10,49,147,207,154,255,409,126,40,91,123,159,731,9.24
5660,"Eric Piatkowski\piatker01","1994-95",24,"LAC","NBA",2,81,11,1208,201,456,127,258,74,198,90,115,63,70,133,77,37,15,63,150,566,5.82
5661,"Olden Polynice\polynol01","2000-01",36,"UTA","NBA",2,81,79,1619,206,415,206,414,0,1,17,65,157,221,378,31,27,77,78,241,429,5.62
5662,"Olden Polynice\polynol01","1998-99",34,"SEA","NBA",2,48,47,1481,169,358,168,357,1,1,29,94,184,241,425,43,20,30,49,150,368,8.34
5663,"Theo Ratliff\ratlith01","2005-06",32,"POR","NBA",2,55,19,1301,108,189,108,189,0,0,54,83,89,190,279,28,18,88,47,143,270,6.91
5664,"Doc Rivers\riverdo01","1994-95",33,"TOT","NBA",2,63,0,989,108,302,63,175,45,127,60,82,15,94,109,162,65,21,60,150,321,6.04
5665,"Lawrence Roberts\roberla01","2006-07",24,"MEM","NBA",2,54,18,969,94,208,94,206,0,2,95,131,101,160,261,30,36,13,36,133,283,6.13
5666,"Clifford Robinson\robincl02","2003-04",37,"GSW","NBA",2,82,82,2846,366,945,254,631,112,314,123,173,54,268,322,271,68,73,173,237,967,10.6
5667,"Carlos Rogers\rogerca01","2000-01",29,"HOU","NBA",2,39,0,544,75,110,75,109,0,1,29,52,48,91,139,9,10,18,17,33,179,5.32
5668,"Rodney Rogers\rogerro01","1993-94",22,"DEN","NBA",2,79,14,1406,239,545,204,453,35,92,127,189,90,136,226,101,63,48,131,195,640,7.43
5669,"Ricky Rubio\rubiori01","2011-12",21,"MIN","NBA",2,41,31,1404,139,389,107,295,32,94,126,157,21,150,171,336,91,8,131,97,436,14.81
5670,"Brandon Rush\rushbr01","2015-16",30,"GSW","NBA",2,72,25,1055,111,260,46,103,65,157,18,28,21,160,181,57,20,23,33,57,305,4.33
5671,"Mike Sanders\sandemi01","1992-93",32,"CLE","NBA",2,53,51,1189,197,396,196,392,1,4,59,78,52,118,170,75,39,30,57,150,454,8.08
5672,"Danny Schayes\schayda01","1997-98",38,"ORL","NBA",2,74,33,1272,155,371,155,371,0,0,96,119,97,145,242,44,34,33,61,182,406,5.19
5673,"Iman Shumpert\shumpim01","2016-17",26,"CLE","NBA",2,76,31,1937,201,489,107,228,94,261,71,90,39,179,218,109,62,27,78,150,567,7.13
5674,"Iman Shumpert\shumpim01","2013-14",23,"NYK","NBA",2,74,58,1962,183,484,107,256,76,228,53,71,81,227,308,129,92,13,79,209,495,7.25
5675,"Bobby Simmons\simmobo01","2003-04",23,"LAC","NBA",2,56,8,1376,147,373,145,361,2,12,141,169,115,147,262,96,51,17,73,169,437,8.19
5676,"Jonathon Simmons\simmojo02","2016-17",27,"SAS","NBA",2,78,8,1392,177,421,147,319,30,102,99,132,20,140,160,126,47,25,76,146,483,5.93
5677,"Jonathon Simmons\simmojo02","2015-16",26,"SAS","NBA",2,55,2,813,122,242,104,195,18,47,69,92,16,80,96,58,24,5,53,103,331,5.59
5678,"Kyle Singler\singlky01","2014-15",26,"TOT","NBA",2,80,58,1743,172,446,76,205,96,241,40,52,33,161,194,85,47,21,55,153,480,5.38
5679,"Donald Sloan\sloando01","2015-16",28,"BRK","NBA",2,61,33,1318,154,350,116,251,38,99,78,104,17,156,173,268,32,4,80,73,424,8.55
5680,"Donald Sloan\sloando01","2014-15",27,"IND","NBA",2,53,21,1107,145,355,104,224,41,131,60,77,12,131,143,190,23,0,65,47,391,7.68
5681,"Charles Smith\smithch04","2001-02",26,"SAS","NBA",2,60,22,1141,182,428,147,297,35,131,42,65,34,99,133,80,52,44,59,114,441,6.62
5682,"Felton Spencer\spencfe01","1994-95",27,"UTA","NBA",2,34,34,905,105,215,105,215,0,0,107,135,90,170,260,17,12,32,68,131,317,10.22
5683,"Latrell Sprewell\sprewla01","1994-95",24,"GSW","NBA",2,69,69,2771,490,1171,400,845,90,326,350,448,58,198,256,279,112,46,230,108,1420,17.38
5684,"Rodney Stuckey\stuckro01","2015-16",29,"IND","NBA",2,58,1,1275,183,443,163,360,20,83,131,158,19,137,156,142,43,8,76,77,517,8.27
5685,"Rodney Stuckey\stuckro01","2007-08",21,"DET","NBA",2,57,2,1081,153,382,150,366,3,16,127,156,32,97,129,160,49,6,78,113,436,7.63
5686,"Hasheem Thabeet\thabeha01","2009-10",22,"MEM","NBA",2,68,13,883,77,131,77,131,0,0,54,93,85,158,243,11,15,89,43,162,208,4.61
5687,"Hollis Thompson\thompho01","2013-14",22,"PHI","NBA",2,77,41,1742,171,372,104,205,67,167,52,73,73,174,247,73,53,12,60,144,461,6.13
5688,"Marcus Thornton\thornma01","2013-14",26,"TOT","NBA",2,72,27,1741,252,639,143,323,109,316,90,112,57,141,198,77,58,11,67,110,703,7.59
5689,"Wayman Tisdale\tisdawa01","1995-96",31,"PHO","NBA",2,63,6,1152,279,564,279,564,0,0,114,149,55,159,214,58,15,36,63,188,672,8.59
5690,"Evan Turner\turneev01","2018-19",30,"POR","NBA",2,73,2,1605,204,443,193,391,11,52,75,106,37,291,328,283,33,18,114,110,494,8.6
5691,"Jacque Vaughn\vaughja01","2002-03",27,"ORL","NBA",2,80,48,1686,184,411,176,377,8,34,97,125,26,92,118,232,64,2,97,169,473,6.53
5692,"Sasha Vujačić\vujacsa01","2005-06",21,"LAL","NBA",2,82,4,1449,108,312,49,140,59,172,46,52,33,126,159,139,48,3,50,150,321,4.32
5693,"Samaki Walker\walkesa01","1999-00",23,"SAS","NBA",2,71,7,980,137,305,137,305,0,0,86,126,77,195,272,38,10,35,64,108,360,5
5694,"Taurean Waller-Prince\princta02","2017-18",23,"ATL","NBA",2,82,82,2464,415,975,239,518,176,457,152,180,50,339,389,214,85,42,191,168,1158,12.81
5695,"Luke Walton\waltolu01","2005-06",25,"LAL","NBA",2,69,6,1333,135,328,117,273,18,55,57,76,88,159,247,156,41,15,78,119,345,6.11
5696,"Luke Walton\waltolu01","2008-09",28,"LAL","NBA",2,65,34,1166,134,307,117,250,17,57,41,57,55,125,180,177,32,10,69,105,326,6.05
5697,"Earl Watson\watsoea01","2006-07",27,"SEA","NBA",2,77,25,2152,263,687,171,407,92,280,108,147,34,151,185,437,99,23,167,152,726,10.78
5698,"Bill Wennington\wennibi01","1996-97",33,"CHI","NBA",2,61,19,783,118,237,118,235,0,2,44,53,46,83,129,41,10,11,31,132,280,4.19
5699,"Shelden Williams\willish02","2009-10",26,"BOS","NBA",2,54,0,597,63,121,63,120,0,1,75,98,47,99,146,21,13,21,30,85,201,4.32
5700,"Tyler Zeller\zellety01","2012-13",23,"CLE","NBA",2,77,55,2033,245,559,245,555,0,4,120,157,159,279,438,96,35,70,95,251,610,8.16
5701,"Ante Žižić\zizican01","2018-19",22,"CLE","NBA",2,59,25,1082,183,331,183,331,0,0,93,132,108,212,320,53,13,22,61,113,459,8.11
5702,"Arron Afflalo\afflaar01","2007-08",22,"DET","NBA",1.9,75,9,970,99,241,89,193,10,48,68,87,36,101,137,52,31,8,34,83,276,3.56
5703,"Tony Allen\allento01","2006-07",25,"BOS","NBA",1.9,33,18,805,133,259,125,226,8,33,105,134,35,89,124,56,49,12,75,87,379,11.68
5704,"Tony Allen\allento01","2009-10",28,"BOS","NBA",1.9,54,8,889,129,253,129,248,0,5,72,119,52,93,145,72,59,19,66,109,330,6.79
5705,"Al-Farouq Aminu\aminual01","2016-17",26,"POR","NBA",1.9,61,25,1773,183,466,113,254,70,212,96,136,77,374,451,99,60,44,94,102,532,9.89
5706,"Chris Andersen\anderch01","2011-12",33,"DEN","NBA",1.9,32,1,486,59,108,59,108,0,0,50,82,48,100,148,6,19,46,17,52,168,6.81
5707,"James Anderson\anderja01","2013-14",24,"PHI","NBA",1.9,80,62,2309,309,717,194,366,115,351,77,106,59,241,300,149,74,28,106,154,810,9.22
5708,"Justin Anderson\anderju01","2016-17",23,"TOT","NBA",1.9,75,10,1228,186,439,128,245,58,194,102,129,69,176,245,66,41,23,66,109,532,6.53
5709,"Chris Anstey\anstech01","1999-00",25,"CHI","NBA",1.9,73,11,1007,161,364,160,358,1,6,116,147,90,190,280,65,29,25,80,180,439,6.03
5710,"Keith Askins\askinke01","1994-95",27,"MIA","NBA",1.9,50,5,854,81,207,60,129,21,78,46,57,86,112,198,39,35,17,25,109,229,5.31
5711,"Marcus Banks\banksma01","2004-05",23,"BOS","NBA",1.9,81,2,1145,115,286,94,227,21,59,121,163,29,97,126,155,63,13,79,146,372,5.33
5712,"Leandro Barbosa\barbole01","2003-04",21,"PHO","NBA",1.9,70,46,1500,210,470,127,260,83,210,47,61,23,100,123,165,93,7,120,184,550,8.03
5713,"J.J. Barea\bareajo01","2012-13",28,"MIN","NBA",1.9,74,2,1713,316,758,219,478,97,280,105,134,34,173,207,294,32,0,145,131,834,9.98
5714,"Andrea Bargnani\bargnan01","2006-07",21,"TOR","NBA",1.9,65,2,1629,267,625,167,357,100,268,117,142,52,203,255,50,32,53,107,180,751,9.48
5715,"Charles Barkley\barklch01","1999-00",36,"HOU","NBA",1.9,20,18,620,106,222,100,196,6,26,71,110,71,138,209,63,14,4,44,48,289,15.25
5716,"Nemanja Bjelica\bjeline01","2015-16",27,"MIN","NBA",1.9,60,0,1075,110,235,62,110,48,125,40,55,49,161,210,83,26,21,47,154,308,6.07
5717,"Corie Blount\blounco01","2003-04",35,"TOT","NBA",1.9,62,3,1050,115,253,115,250,0,3,15,27,98,177,275,55,49,24,43,135,245,5.22
5718,"Mark Blount\blounma01","2000-01",25,"BOS","NBA",1.9,64,50,1098,101,200,101,200,0,0,46,66,97,134,231,32,39,76,62,183,248,5.43
5719,"Devin Booker\bookede01","2015-16",19,"PHO","NBA",1.9,76,51,2108,367,867,268,578,99,289,215,256,27,160,187,200,44,20,160,225,1048,11.11
5720,"Bruce Bowen\bowenbr01","2001-02",30,"SAS","NBA",1.9,59,59,1699,155,398,99,250,56,148,46,96,42,120,162,88,62,25,66,116,412,6.46
5721,"Shawn Bradley\bradlsh01","2004-05",32,"DAL","NBA",1.9,77,14,885,84,186,84,186,0,0,43,63,70,144,214,15,25,63,33,153,211,3.53
5722,"Jon Brockman\brockjo01","2010-11",23,"MIL","NBA",1.9,63,6,677,48,94,48,94,0,0,40,59,74,110,184,18,14,3,24,119,136,2.92
5723,"Scott Brooks\brooksc01","1994-95",29,"TOT","NBA",1.9,59,0,808,126,275,101,206,25,69,64,79,14,52,66,116,34,4,47,56,341,5.72
5724,"Kwame Brown\brownkw01","2008-09",26,"DET","NBA",1.9,58,30,999,90,169,90,169,0,0,63,122,91,199,290,32,24,24,50,138,243,5.45
5725,"Kwame Brown\brownkw01","2006-07",24,"LAL","NBA",1.9,41,28,1132,143,242,143,241,0,1,59,134,81,163,244,75,39,49,76,124,345,10.4
5726,"Randy Brown\brownra02","1992-93",24,"SAC","NBA",1.9,75,34,1726,225,486,223,480,2,6,115,157,75,137,212,196,108,34,120,206,567,8.72
5727,"Rick Brunson\brunsri01","2004-05",32,"LAC","NBA",1.9,80,39,1945,166,442,118,312,48,130,57,74,23,164,187,410,82,7,125,106,437,7.95
5728,"Jud Buechler\buechju01","1997-98",29,"CHI","NBA",1.9,74,0,608,85,176,60,111,25,65,3,6,24,53,77,49,22,15,21,47,198,2.77
5729,"Trey Burke\burketr01","2018-19",26,"TOT","NBA",1.9,58,8,1125,236,548,180,389,56,159,103,124,28,71,99,159,33,7,49,58,631,9
5730,"Alec Burks\burksal01","2017-18",26,"UTA","NBA",1.9,64,1,1059,170,414,123,272,47,142,107,124,19,173,192,67,37,8,60,75,494,6.75
5731,"Will Bynum\bynumwi01","2009-10",27,"DET","NBA",1.9,63,20,1667,237,534,225,479,12,55,142,178,24,118,142,283,55,7,115,143,628,10.31
5732,"Vince Carter\cartevi01","2018-19",42,"ATL","NBA",1.9,76,9,1330,196,468,73,152,123,316,47,66,31,163,194,87,44,27,48,141,562,6.67
5733,"Wendell Carter\cartewe01","2018-19",19,"CHI","NBA",1.9,44,44,1110,180,371,174,339,6,32,89,112,87,220,307,78,26,58,65,152,455,11.41
5734,"Tyson Chandler\chandty01","2003-04",21,"CHI","NBA",1.9,35,8,782,67,158,67,157,0,1,79,118,82,188,270,23,17,43,38,87,213,8.14
5735,"Rex Chapman\chapmre01","1992-93",25,"WSB","NBA",1.9,60,23,1300,287,602,244,486,43,116,132,163,19,69,88,116,38,10,79,119,749,9.86
5736,"Jamal Crawford\crawfja01","2016-17",36,"LAC","NBA",1.9,82,1,2157,359,870,243,548,116,322,174,203,17,112,129,214,61,14,134,115,1008,9.8
5737,"Jordan Crawford\crawfjo02","2012-13",24,"TOT","NBA",1.9,70,14,1709,301,725,218,479,83,246,129,159,44,165,209,225,39,7,141,106,814,10
5738,"John Crotty\crottjo01","1999-00",30,"DET","NBA",1.9,69,0,937,106,251,73,171,33,80,80,93,17,58,75,128,27,5,54,104,325,4.88
5739,"Dante Cunningham\cunnida01","2018-19",31,"SAS","NBA",1.9,64,21,928,75,158,45,93,30,65,14,18,48,140,188,50,27,13,22,71,194,4.03
5740,"Dante Cunningham\cunnida01","2009-10",22,"POR","NBA",1.9,63,2,707,106,214,106,212,0,2,31,48,54,106,160,14,24,22,15,97,243,3.84
5741,"Erick Dampier\dampier01","2010-11",35,"MIA","NBA",1.9,51,22,815,52,89,52,88,0,1,24,44,53,124,177,22,14,47,32,82,128,4.15
5742,"Ricky Davis\davisri01","2007-08",28,"MIA","NBA",1.9,82,47,2963,420,971,285,638,135,333,155,197,55,298,353,276,87,14,191,187,1130,12.59
5743,"Todd Day\dayto01","1995-96",26,"TOT","NBA",1.9,79,12,1807,299,817,199,515,100,302,224,287,70,154,224,107,81,51,109,225,922,9.19
5744,"Matthew Dellavedova\dellama01","2014-15",24,"CLE","NBA",1.9,67,13,1380,111,307,43,140,68,167,29,38,37,89,126,204,24,2,61,152,319,5.43
5745,"Cheick Diallo\diallch01","2017-18",21,"NOP","NBA",1.9,52,0,581,102,176,102,176,0,0,50,66,47,164,211,19,11,21,28,82,254,5.55
5746,"Travis Diener\dienetr01","2008-09",26,"IND","NBA",1.9,55,0,719,74,179,28,61,46,118,12,15,6,80,86,122,26,5,21,42,206,4.7
5747,"Michael Doleac\doleami01","2004-05",27,"MIA","NBA",1.9,80,8,1175,148,331,148,329,0,2,25,41,74,185,259,47,23,22,36,160,321,3.96
5748,"Joey Dorsey\dorsejo01","2014-15",31,"HOU","NBA",1.9,69,17,854,80,145,80,144,0,1,24,83,103,176,279,25,40,25,41,157,184,4.02
5749,"Chris Duhon\duhonch01","2009-10",27,"NYK","NBA",1.9,67,59,2072,168,451,78,193,90,258,68,95,28,150,178,378,59,3,110,83,494,9.43
5750,"Mark Eaton\eatonma01","1992-93",36,"UTA","NBA",1.9,64,57,1104,71,130,71,130,0,0,35,50,73,191,264,17,18,79,43,143,177,4.67
5751,"Blue Edwards\edwarbl01","1995-96",30,"VAN","NBA",1.9,82,82,2773,401,956,317,711,84,245,157,208,98,248,346,212,118,46,170,243,1043,11.6
5752,"LaPhonso Ellis\ellisla01","1999-00",29,"ATL","NBA",1.9,58,8,1309,209,464,206,443,3,21,66,95,98,192,290,59,32,25,52,133,487,7.6
5753,"Joel Embiid\embiijo01","2016-17",22,"PHI","NBA",1.9,31,31,786,200,429,164,331,36,98,191,244,61,182,243,66,27,76,117,112,627,19.65
5754,"James Ennis\ennisja01","2014-15",24,"MIA","NBA",1.9,62,3,1051,101,247,70,152,31,95,79,94,51,125,176,48,25,17,39,89,312,5.07
5755,"Reggie Evans\evansre01","2008-09",28,"PHI","NBA",1.9,79,7,1137,79,178,79,177,0,1,104,175,135,226,361,26,41,8,69,161,262,4.43
5756,"Jordan Farmar\farmajo01","2010-11",24,"NJN","NBA",1.9,73,18,1796,255,651,146,347,109,304,82,100,24,149,173,368,62,6,139,128,701,10.04
5757,"Raymond Felton\feltora01","2016-17",32,"LAC","NBA",1.9,80,11,1700,221,514,175,370,46,144,50,64,33,185,218,191,66,22,83,125,538,7.04
5758,"Duane Ferrell\ferredu01","1996-97",31,"IND","NBA",1.9,62,18,1115,159,337,141,293,18,44,58,94,57,84,141,66,38,6,55,120,394,5.68
5759,"Yogi Ferrell\ferreyo01","2018-19",25,"SAC","NBA",1.9,71,3,1067,153,352,99,203,54,149,60,67,13,96,109,137,36,4,40,64,420,5.78
5760,"Vern Fleming\flemive01","1994-95",32,"IND","NBA",1.9,55,1,686,93,188,93,181,0,7,65,90,20,68,88,109,27,1,43,80,251,5.2
5761,"Danny Fortson\fortsda01","1997-98",21,"DEN","NBA",1.9,80,23,1811,276,611,275,608,1,3,263,339,182,266,448,76,44,30,157,314,816,9.57
5762,"Adonal Foyle\foylead01","1999-00",24,"GSW","NBA",1.9,76,59,1654,193,380,193,380,0,0,34,90,174,250,424,42,26,136,71,218,420,6.96
5763,"Lawrence Funderburke\fundela01","2000-01",30,"SAC","NBA",1.9,59,2,698,120,242,120,242,0,0,48,77,74,122,196,17,9,13,32,44,288,4.46
5764,"Kevin Garnett\garneke01","2014-15",38,"TOT","NBA",1.9,47,47,952,143,306,142,299,1,7,36,45,48,263,311,77,46,17,46,109,323,8.48
5765,"Dean Garrett\garrede01","2000-01",34,"MIN","NBA",1.9,70,21,831,75,156,75,156,0,0,27,39,65,152,217,24,26,49,25,93,177,3.67
5766,"Alonzo Gee\geeal01","2012-13",25,"CLE","NBA",1.9,82,82,2541,305,744,236,525,69,219,163,205,75,245,320,133,107,29,132,199,842,9.45
5767,"Alonzo Gee\geeal01","2015-16",28,"NOP","NBA",1.9,73,38,1632,132,255,115,195,17,60,44,66,60,185,245,72,63,13,55,169,325,5.63
5768,"Matt Geiger\geigema01","1996-97",27,"CHH","NBA",1.9,49,13,1044,171,350,165,330,6,20,89,127,100,158,258,38,20,27,67,153,437,8.45
5769,"Kendall Gill\gillke01","2002-03",34,"MIN","NBA",1.9,82,34,2068,286,677,267,618,19,59,123,161,51,197,248,156,78,15,108,176,714,7.76
5770,"Gordan Giriček\giricgo01","2006-07",29,"UTA","NBA",1.9,61,6,1188,176,381,124,259,52,122,71,87,24,105,129,63,28,5,64,122,475,6.55
5771,"Drew Gooden\goodedr01","2003-04",22,"ORL","NBA",1.9,79,17,2134,369,829,360,787,9,42,167,262,160,356,516,89,62,72,126,196,914,10.44
5772,"Paul Graham\grahapa01","1992-93",25,"ATL","NBA",1.9,80,11,1508,256,560,214,419,42,141,96,131,61,129,190,164,86,6,120,185,650,7.84
5773,"Jeff Grayer\grayeje01","1993-94",28,"GSW","NBA",1.9,67,4,1096,191,363,189,351,2,12,71,118,76,115,191,62,33,13,63,103,455,6.27
5774,"Gerald Green\greenge01","2018-19",33,"HOU","NBA",1.9,73,0,1473,231,578,75,137,156,441,57,68,30,152,182,40,33,27,55,126,675,7
5775,"Gerald Green\greenge01","2014-15",29,"PHO","NBA",1.9,74,4,1446,324,778,187,391,137,387,99,120,33,153,186,91,42,12,104,145,884,8.77
5776,"Tim Hardaway\hardati02","2015-16",23,"ATL","NBA",1.9,51,1,864,114,265,66,123,48,142,50,56,7,79,86,51,21,7,23,48,326,5.48
5777,"Jason Hart\hartja01","2003-04",25,"SAS","NBA",1.9,53,5,660,71,159,69,150,2,9,33,43,10,69,79,81,28,5,29,59,177,3.96
5778,"Spencer Hawes\hawessp01","2015-16",27,"CHO","NBA",1.9,57,6,1035,124,306,86,204,38,102,54,65,51,193,244,109,22,27,58,111,340,6.77
5779,"Alan Henderson\hendeal01","2000-01",28,"ATL","NBA",1.9,73,42,1810,298,671,298,670,0,1,173,271,180,226,406,50,51,29,126,164,769,8.88
5780,"John Henson\hensojo01","2012-13",22,"MIL","NBA",1.9,63,9,827,162,336,162,333,0,3,56,105,116,181,297,31,19,42,47,83,380,6.01
5781,"Tyrone Hill\hillty01","1995-96",27,"CLE","NBA",1.9,44,2,929,130,254,130,254,0,0,81,135,94,150,244,33,31,20,64,144,341,8.17
5782,"Eddie House\houseed01","2006-07",28,"NJN","NBA",1.9,56,1,946,180,421,105,246,75,175,33,36,14,78,92,67,27,3,27,69,468,6.37
5783,"Juwan Howard\howarju01","1999-00",26,"WAS","NBA",1.9,82,82,2909,509,1108,509,1101,0,7,202,275,132,338,470,247,67,21,225,299,1220,12.94
5784,"Kris Humphries\humphkr01","2009-10",24,"TOT","NBA",1.9,69,0,1221,180,408,180,407,0,1,127,190,120,258,378,32,36,48,66,145,487,7.12
5785,"Wesley Iwundu\iwundwe01","2018-19",24,"ORL","NBA",1.9,68,13,1233,113,274,84,195,29,79,84,103,37,147,184,73,28,22,44,123,339,5.19
5786,"Reggie Jackson\jacksre01","2016-17",26,"DET","NBA",1.9,52,50,1424,284,677,218,493,66,184,118,136,21,93,114,270,35,5,114,129,752,12.65
5787,"Stephen Jackson\jacksst02","2010-11",32,"CHA","NBA",1.9,67,67,2405,435,1059,314,700,121,359,249,305,53,251,304,241,80,28,209,161,1240,15.53
5788,"Marko Jarić\jaricma01","2002-03",24,"LAC","NBA",1.9,66,12,1379,179,446,126,280,53,166,79,105,35,125,160,193,97,11,103,125,490,8.22
5789,"Ervin Johnson\johnser02","2002-03",35,"MIL","NBA",1.9,69,17,1170,61,135,61,135,0,0,30,44,117,177,294,24,34,63,34,178,152,4.19
5790,"Linton Johnson\johnsli01","2006-07",26,"NOK","NBA",1.9,54,0,720,93,190,83,160,10,30,30,37,52,111,163,18,33,18,27,101,226,4.64
5791,"Wesley Johnson\johnswe01","2013-14",26,"LAL","NBA",1.9,79,62,2240,277,651,177,380,100,271,61,77,70,278,348,124,86,77,90,207,715,9.24
5792,"Damon Jones\jonesda01","2001-02",25,"DET","NBA",1.9,67,0,1083,114,284,45,98,69,186,43,59,13,90,103,140,23,1,61,83,340,5.12
5793,"Solomon Jones\jonesso01","2008-09",24,"ATL","NBA",1.9,63,0,675,67,111,66,109,1,2,53,74,52,90,142,15,7,34,27,125,188,3.6
5794,"Jason Kapono\kaponja01","2007-08",26,"TOR","NBA",1.9,81,7,1530,243,498,186,380,57,118,37,43,31,89,120,65,34,2,58,131,580,5.62
5795,"Shawn Kemp\kempsh01","2001-02",32,"POR","NBA",1.9,75,5,1232,175,407,175,403,0,4,104,131,90,198,288,52,43,33,81,184,454,5.95
5796,"Stacey King\kingst01","1992-93",26,"CHI","NBA",1.9,76,3,1059,160,340,158,334,2,6,86,122,105,102,207,71,26,20,70,128,408,5.16
5797,"Nenad Krstić\krstine01","2006-07",23,"NJN","NBA",1.9,26,26,848,170,323,170,322,0,1,86,121,51,125,176,46,10,24,52,88,426,14.74
5798,"Andrew Lang\langan01","1996-97",30,"MIL","NBA",1.9,52,52,1194,115,248,115,248,0,0,44,61,94,184,278,25,26,47,39,140,274,6.29
5799,"Shaun Livingston\livinsh01","2010-11",25,"CHA","NBA",1.9,73,0,1261,185,397,184,393,1,4,108,125,29,120,149,164,47,29,88,109,479,6.99
5800,"Felipe López\lopezfe01","2000-01",26,"TOT","NBA",1.9,70,48,1565,211,478,192,426,19,52,109,156,55,179,234,107,62,30,83,156,550,7.61
5801,"Robin Lopez\lopezro01","2017-18",29,"CHI","NBA",1.9,64,64,1690,342,645,338,631,4,14,68,90,134,156,290,124,14,53,107,109,756,10.72
5802,"Sam Mack\macksa01","1995-96",25,"HOU","NBA",1.9,31,20,868,121,287,67,152,54,135,39,46,18,80,98,79,22,9,28,75,335,9.76
5803,"Shelvin Mack\macksh01","2017-18",27,"ORL","NBA",1.9,69,3,1365,178,414,130,275,48,139,69,97,23,143,166,272,54,8,89,91,473,8.11
5804,"Mark Madsen\madsema01","2001-02",26,"LAL","NBA",1.9,59,5,650,66,146,66,144,0,2,35,54,89,73,162,44,16,13,22,104,167,3.46
5805,"Darrick Martin\martida01","1997-98",26,"LAC","NBA",1.9,82,63,2299,275,730,168,437,107,293,184,217,19,145,164,331,82,10,154,198,841,9.92
5806,"Kevin Martin\martike02","2014-15",31,"MIN","NBA",1.9,39,36,1302,267,625,192,434,75,191,170,193,19,123,142,89,33,1,76,76,779,15.18
5807,"Roger Mason\masonro01","2009-10",29,"SAS","NBA",1.9,79,5,1515,193,496,105,232,88,264,27,34,11,151,162,137,30,14,59,99,501,5.43
5808,"Vernon Maxwell\maxweve01","1994-95",29,"HOU","NBA",1.9,64,54,2038,306,777,163,336,143,441,99,144,18,146,164,274,75,13,137,157,854,11.81
5809,"Eric Maynor\maynoer01","2009-10",22,"TOT","NBA",1.9,81,2,1269,154,368,132,297,22,71,52,72,21,108,129,266,40,10,85,115,382,5.71
5810,"T.J. McConnell\mccontj01","2015-16",23,"PHI","NBA",1.9,81,17,1606,218,464,187,375,31,89,26,41,43,207,250,367,95,10,140,114,493,8.74
5811,"Rodney McGruder\mcgruro01","2018-19",27,"MIA","NBA",1.9,66,45,1550,186,461,107,236,79,225,52,72,60,178,238,112,36,12,64,115,503,7.04
5812,"Jim McIlvaine\mcilvji01","1997-98",25,"SEA","NBA",1.9,78,72,1211,101,223,101,220,0,3,45,81,96,163,259,19,24,137,54,240,247,4.53
5813,"C.J. Miles\milescj01","2009-10",22,"UTA","NBA",1.9,63,28,1497,241,562,167,345,74,217,66,95,42,126,168,105,58,17,81,190,622,8.32
5814,"C.J. Miles\milescj01","2007-08",20,"UTA","NBA",1.9,60,13,689,113,236,83,159,30,77,41,52,16,62,78,53,32,8,27,98,297,4.64
5815,"Darko Miličić\milicda01","2008-09",23,"MEM","NBA",1.9,61,15,1034,137,266,137,266,0,0,59,105,83,181,264,34,22,51,48,134,333,6.07
5816,"Chris Mills\millsch01","2001-02",32,"GSW","NBA",1.9,66,0,1237,178,427,130,300,48,127,85,107,51,139,190,72,31,13,56,120,489,6.35
5817,"Anthony Morrow\morroan01","2015-16",30,"OKC","NBA",1.9,68,6,926,136,333,57,129,79,204,29,39,10,52,62,24,22,5,17,64,380,3.89
5818,"Mike Muscala\muscami01","2014-15",23,"ATL","NBA",1.9,40,8,502,83,151,74,129,9,22,22,25,52,67,119,25,16,19,21,52,197,5.44
5819,"Gary Neal\nealga01","2012-13",28,"SAS","NBA",1.9,68,17,1484,246,597,157,346,89,251,64,74,13,130,143,129,30,2,69,93,645,7.36
5820,"Ira Newble\newblir01","2004-05",30,"CLE","NBA",1.9,74,69,1832,182,424,163,371,19,53,55,69,78,142,220,91,50,18,61,144,438,5.71
5821,"Ken Norman\normake01","1993-94",29,"MIL","NBA",1.9,82,75,2539,412,919,349,730,63,189,92,183,169,331,500,222,58,46,150,209,979,11.09
5822,"Scott Padgett\padgesc01","2003-04",27,"HOU","NBA",1.9,58,5,547,74,167,46,102,28,65,24,32,46,93,139,23,12,13,22,73,200,3.49
5823,"Cherokee Parks\parksch02","2000-01",28,"TOT","NBA",1.9,65,31,1054,134,274,134,268,0,6,31,44,71,158,229,46,25,36,41,122,299,5.07
5824,"John Paxson\paxsojo01","1992-93",32,"CHI","NBA",1.9,59,8,1030,105,233,86,192,19,41,17,20,9,39,48,136,38,2,31,99,246,4.7
5825,"Scot Pollard\pollasc01","2004-05",29,"IND","NBA",1.9,49,17,865,79,167,79,167,0,0,33,49,85,120,205,18,30,24,31,123,191,4.91
5826,"Joel Przybilla\przybjo01","2001-02",22,"MIL","NBA",1.9,71,62,1128,76,142,76,141,0,1,38,90,78,205,283,21,20,118,43,199,190,4.66
5827,"Vladimir Radmanović\radmavl01","2008-09",28,"TOT","NBA",1.9,78,31,1445,196,466,91,204,105,262,43,58,45,177,222,81,46,15,98,111,540,6.26
5828,"Isaiah Rider\rideris01","1994-95",23,"MIN","NBA",1.9,75,67,2645,558,1249,419,853,139,396,277,339,90,159,249,245,69,23,232,194,1532,16.16
5829,"Austin Rivers\riverau01","2015-16",23,"LAC","NBA",1.9,67,7,1464,226,516,164,331,62,185,79,116,22,108,130,99,48,9,61,137,593,7.21
5830,"James Robinson\robinja02","1996-97",26,"MIN","NBA",1.9,69,5,1309,196,482,94,215,102,267,78,114,24,88,112,126,30,8,69,125,572,6.77
5831,"Rumeal Robinson\robinru01","1992-93",26,"NJN","NBA",1.9,80,28,1585,270,638,250,582,20,56,112,195,49,110,159,323,96,12,140,169,672,8.68
5832,"Michael Ruffin\ruffimi01","2004-05",28,"WAS","NBA",1.9,79,7,1262,41,99,41,98,0,1,29,67,157,175,332,64,43,41,44,193,111,3.7
5833,"Iman Shumpert\shumpim01","2012-13",22,"NYK","NBA",1.9,45,45,996,109,275,58,148,51,127,36,47,31,105,136,75,43,7,37,99,305,6.81
5834,"Jonathon Simmons\simmojo02","2017-18",28,"ORL","NBA",1.9,69,50,2029,354,761,285,557,69,204,185,241,61,178,239,171,58,16,146,175,962,12.07
5835,"Brian Skinner\skinnbr01","2004-05",28,"TOT","NBA",1.9,49,23,941,104,205,104,204,0,1,25,70,107,173,280,43,31,49,40,102,233,6.54
5836,"Brian Skinner\skinnbr01","2001-02",25,"CLE","NBA",1.9,65,8,1107,88,162,88,162,0,0,48,79,93,188,281,17,24,61,42,130,224,4.99
5837,"Marcus Smart\smartma01","2017-18",23,"BOS","NBA",1.9,54,11,1614,189,515,114,266,75,249,97,133,43,146,189,259,71,23,129,133,550,11.01
5838,"Charles Smith\smithch01","1995-96",30,"TOT","NBA",1.9,73,34,1716,244,578,242,563,2,15,119,163,133,229,362,65,50,80,106,224,609,7.95
5839,"Steve Smith\smithst01","2003-04",34,"NOH","NBA",1.9,71,4,929,119,293,76,186,43,107,77,83,27,54,81,56,15,6,42,91,358,4.07
5840,"Eric Snow\snower01","1996-97",23,"SEA","NBA",1.9,67,0,775,74,164,70,149,4,15,47,66,17,53,70,159,37,3,48,94,199,4.25
5841,"Eric Snow\snower01","2004-05",31,"CLE","NBA",1.9,81,15,1844,125,327,112,282,13,45,59,80,37,118,155,317,67,16,89,189,322,6.13
5842,"Latrell Sprewell\sprewla01","2004-05",34,"MIN","NBA",1.9,80,79,2450,398,961,329,750,69,211,156,188,65,189,254,179,53,21,127,124,1021,9.87
5843,"Jerry Stackhouse\stackje01","1998-99",24,"DET","NBA",1.9,42,9,1188,181,488,146,362,35,126,210,247,26,81,107,118,34,19,121,79,607,11.8
5844,"Derek Strong\stronde01","1995-96",27,"LAL","NBA",1.9,63,0,746,72,169,71,160,1,9,69,85,60,118,178,32,18,12,20,80,214,3.78
5845,"Stromile Swift\swiftst01","2000-01",21,"VAN","NBA",1.9,80,6,1312,153,339,153,335,0,4,85,141,109,175,284,28,62,82,64,160,391,5.56
5846,"Jason Terry\terryja01","1999-00",22,"ATL","NBA",1.9,81,27,1888,249,600,203,443,46,157,113,140,24,142,166,346,90,10,156,133,657,9.03
5847,"Robert Traylor\traylro01","2000-01",23,"CLE","NBA",1.9,70,7,1212,161,324,161,322,0,2,80,141,124,176,300,63,49,76,98,204,402,6.88
5848,"Anderson Varejão\varejan01","2014-15",32,"CLE","NBA",1.9,26,26,636,111,200,111,198,0,2,33,45,57,113,170,35,19,16,35,58,255,10.67
5849,"Henry Walker\walkebi01","2009-10",22,"TOT","NBA",1.9,35,13,768,120,232,70,116,50,116,39,49,15,73,88,40,23,3,28,83,329,8.54
5850,"Kenny Walker\walkeke01","1993-94",29,"WSB","NBA",1.9,73,4,1397,132,274,132,271,0,3,87,125,118,171,289,33,26,59,44,156,351,5.52
5851,"Samaki Walker\walkesa01","2000-01",24,"SAS","NBA",1.9,61,1,963,121,252,120,249,1,3,78,124,67,176,243,29,10,41,68,103,321,5.42
5852,"Ben Wallace\wallabe01","2010-11",36,"DET","NBA",1.9,54,49,1238,67,149,66,147,1,2,19,57,129,221,350,72,54,54,44,81,154,6.36
5853,"Charlie Ward\wardch01","2001-02",31,"NYK","NBA",1.9,63,0,1058,113,303,60,139,53,164,47,58,15,112,127,203,68,14,75,100,326,6.75
5854,"Chris Webber\webbech01","1995-96",22,"WSB","NBA",1.9,15,15,558,150,276,135,242,15,34,41,69,37,77,114,75,27,9,49,51,356,22.87
5855,"Russell Westbrook\westbru01","2008-09",20,"OKC","NBA",1.9,82,65,2668,436,1095,401,966,35,129,349,428,178,221,399,435,110,16,274,191,1256,14.85
5856,"Damien Wilkins\wilkida02","2009-10",30,"MIN","NBA",1.9,80,31,1585,165,381,147,320,18,61,103,129,72,177,249,135,66,25,76,144,451,6.47
5857,"Damien Wilkins\wilkida02","2012-13",33,"PHI","NBA",1.9,61,21,1095,145,316,128,265,17,51,81,109,32,73,105,91,37,18,49,98,388,6.05
5858,"John Williams\willijo02","1992-93",26,"LAC","NBA",1.9,74,8,1638,205,477,193,424,12,53,70,129,88,228,316,142,83,23,79,188,492,7.32
5859,"Shawne Williams\willish03","2014-15",28,"TOT","NBA",1.9,63,22,1087,121,300,57,122,64,178,35,40,36,130,166,44,25,21,30,135,341,4.99
5860,"Shelden Williams\willish02","2010-11",27,"TOT","NBA",1.9,59,38,911,103,220,103,220,0,0,58,75,93,180,273,32,23,26,43,126,264,5.38
5861,"Haywoode Workman\workmha01","1994-95",29,"IND","NBA",1.9,69,14,1028,101,269,66,171,35,98,55,74,21,90,111,194,59,5,73,115,292,5.5
5862,"Metta World Peace\artesro01","2000-01",21,"CHI","NBA",1.9,76,74,2363,327,815,284,667,43,148,210,280,59,235,294,228,152,45,159,254,907,11.84
5863,"Brandan Wright\wrighbr03","2008-09",21,"GSW","NBA",1.9,39,23,688,130,246,130,242,0,4,63,85,62,95,157,21,22,37,23,74,323,8.19
5864,"Dorell Wright\wrighdo01","2006-07",21,"MIA","NBA",1.9,66,19,1292,162,364,157,330,5,34,64,86,40,232,272,95,41,46,65,112,393,6.71
5865,"Dorell Wright\wrighdo01","2013-14",28,"POR","NBA",1.9,68,13,984,111,297,42,95,69,202,52,69,29,162,191,64,23,16,39,62,343,4.83
5866,"Nick Young\youngni01","2011-12",26,"TOT","NBA",1.9,62,35,1729,316,784,213,502,103,282,144,169,31,102,133,56,44,17,83,141,879,9.6
5867,"Cody Zeller\zelleco01","2017-18",25,"CHO","NBA",1.9,33,0,627,85,156,83,153,2,3,61,85,67,110,177,31,14,21,33,81,233,8.16
5868,"Arron Afflalo\afflaar01","2008-09",23,"DET","NBA",1.8,74,8,1234,131,300,88,193,43,107,58,71,30,104,134,44,28,13,43,144,363,4.35
5869,"Mark Aguirre\aguirma01","1992-93",33,"DET","NBA",1.8,51,15,1056,187,422,157,339,30,83,99,129,43,109,152,105,16,7,68,101,503,8.35
5870,"Ashraf Amaya\amayaas01","1995-96",24,"VAN","NBA",1.8,54,34,1104,121,252,121,251,0,1,97,149,114,189,303,33,22,10,57,151,339,6.73
5871,"Lou Amundson\amundlo01","2008-09",26,"PHO","NBA",1.8,76,0,1044,134,250,134,249,0,1,53,120,128,142,270,28,32,65,56,154,321,4.97
5872,"Gilbert Arenas\arenagi01","2009-10",28,"WAS","NBA",1.8,32,32,1169,253,616,190,435,63,181,153,207,17,116,133,230,41,9,117,95,722,19.75
5873,"Trevor Ariza\arizatr01","2007-08",22,"TOT","NBA",1.8,35,3,546,69,136,64,118,5,18,49,75,30,78,108,44,31,11,23,45,192,6.48
5874,"Darrell Armstrong\armstda01","1996-97",28,"ORL","NBA",1.8,67,0,1010,132,345,77,164,55,181,92,106,35,41,76,175,61,9,99,114,411,6.52
5875,"Stacey Augmon\augmost01","1997-98",29,"POR","NBA",1.8,71,23,1445,154,372,153,365,1,7,94,156,104,131,235,88,57,32,81,144,403,5.84
5876,"Luke Babbitt\babbilu01","2016-17",27,"MIA","NBA",1.8,68,55,1065,113,281,26,71,87,210,11,15,12,129,141,36,20,11,25,118,324,4.12
5877,"Vin Baker\bakervi01","2000-01",29,"SEA","NBA",1.8,76,27,2129,347,822,346,806,1,16,232,321,179,251,430,90,38,73,158,264,927,10.25
5878,"Leandro Barbosa\barbole01","2004-05",22,"PHO","NBA",1.8,63,6,1087,168,354,117,215,51,139,55,69,32,98,130,126,30,7,87,127,442,6.84
5879,"Jon Barry\barryjo01","1995-96",26,"GSW","NBA",1.8,68,0,712,91,185,47,92,44,93,31,37,17,46,63,85,33,11,42,51,257,4.22
5880,"Michael Beasley\beaslmi01","2016-17",28,"MIL","NBA",1.8,56,6,935,216,406,198,363,18,43,78,105,40,153,193,53,27,27,66,92,528,8.56
5881,"Travis Best\besttr01","2002-03",30,"MIA","NBA",1.8,72,52,1807,231,583,195,474,36,109,105,123,26,121,147,255,44,7,106,174,603,7.87
5882,"Khem Birch\birchkh01","2017-18",25,"ORL","NBA",1.8,42,0,578,68,126,68,126,0,0,42,61,70,110,180,34,15,21,21,56,178,5.59
5883,"Steve Blake\blakest01","2010-11",30,"LAL","NBA",1.8,79,0,1581,110,306,37,113,73,193,26,30,19,137,156,170,40,3,73,99,319,4.69
5884,"Steve Blake\blakest01","2013-14",33,"TOT","NBA",1.8,55,28,1498,133,353,54,143,79,210,33,43,13,146,159,307,54,8,102,85,378,9.42
5885,"Corie Blount\blounco01","2000-01",32,"TOT","NBA",1.8,68,6,1305,130,294,128,286,2,8,51,83,181,219,400,59,42,22,73,165,313,5.96
5886,"Anthony Bonner\bonnean01","1994-95",26,"NYK","NBA",1.8,58,23,1126,88,193,87,188,1,5,44,67,113,149,262,80,48,23,79,159,221,5.81
5887,"Matt Bonner\bonnema01","2013-14",33,"SAS","NBA",1.8,61,0,690,73,164,31,66,42,98,9,12,16,114,130,31,15,11,16,49,197,3.39
5888,"Josh Boone\boonejo01","2008-09",24,"NJN","NBA",1.8,62,7,995,113,214,113,214,0,0,32,85,104,154,258,31,22,48,31,106,258,5.04
5889,"Josh Boone\boonejo01","2009-10",25,"NJN","NBA",1.8,63,28,1045,117,223,117,223,0,0,19,58,124,191,315,29,30,48,37,111,253,5.37
5890,"Avery Bradley\bradlav01","2013-14",23,"BOS","NBA",1.8,60,58,1855,361,825,282,625,79,200,90,112,48,178,226,85,63,11,96,145,891,11.16
5891,"Randy Brown\brownra02","1997-98",29,"CHI","NBA",1.8,71,6,1147,116,302,116,297,0,5,56,78,34,60,94,151,71,12,63,118,288,4.75
5892,"Kobe Bryant\bryanko01","1996-97",18,"LAL","NBA",1.8,71,6,1103,176,422,125,286,51,136,136,166,47,85,132,91,49,23,112,102,539,6.81
5893,"Greg Buckner\buckngr01","1999-00",23,"DAL","NBA",1.8,48,1,923,111,233,101,207,10,26,43,63,56,118,174,55,38,20,36,148,275,6.42
5894,"Jud Buechler\buechju01","1992-93",24,"GSW","NBA",1.8,70,9,1287,176,403,156,344,20,59,65,87,81,114,195,94,47,19,55,98,437,6.01
5895,"Matt Bullard\bullama01","1999-00",32,"HOU","NBA",1.8,56,27,1024,139,340,60,163,79,177,25,30,13,125,138,63,19,13,36,85,382,5.8
5896,"Caron Butler\butleca01","2013-14",33,"TOT","NBA",1.8,56,13,1419,213,540,115,291,98,249,63,75,21,208,229,82,47,17,60,120,587,8.88
5897,"José Calderón\caldejo01","2017-18",36,"CLE","NBA",1.8,57,32,914,93,185,48,88,45,97,24,30,14,70,84,117,27,2,41,81,255,5.34
5898,"Kentavious Caldwell-Pope\caldwke01","2013-14",20,"DET","NBA",1.8,80,41,1583,182,460,123,275,59,185,47,61,38,118,156,55,75,12,28,145,470,4.99
5899,"Anthony Carter\cartean01","2008-09",33,"DEN","NBA",1.8,78,5,1787,167,386,146,298,21,88,57,78,40,165,205,364,96,13,155,142,412,8.23
5900,"Vince Carter\cartevi01","2015-16",39,"MEM","NBA",1.8,60,3,1005,133,343,74,174,59,169,70,84,31,115,146,56,38,16,35,101,395,5.82
5901,"Sam Cassell\cassesa01","2007-08",38,"TOT","NBA",1.8,55,34,1274,233,532,210,456,23,76,127,144,17,119,136,214,37,6,97,98,616,10.46
5902,"Duane Causwell\causwdu01","1994-95",26,"SAC","NBA",1.8,58,24,820,76,147,76,146,0,1,57,98,57,117,174,15,14,80,33,146,209,4.66
5903,"Tyson Chandler\chandty01","2001-02",19,"CHI","NBA",1.8,71,31,1389,151,304,151,304,0,0,134,222,114,229,343,54,28,93,99,179,436,7.27
5904,"Marquese Chriss\chrisma01","2016-17",19,"PHO","NBA",1.8,82,75,1743,284,632,212,408,72,224,113,181,96,252,348,60,67,70,108,263,753,8.47
5905,"Jordan Clarkson\clarkjo01","2018-19",26,"CLE","NBA",1.8,81,0,2214,529,1180,385,735,144,445,162,192,82,188,270,196,57,13,135,112,1364,12.95
5906,"Marty Conlon\conloma01","1996-97",29,"BOS","NBA",1.8,74,15,1614,214,454,212,444,2,10,144,171,128,195,323,104,46,18,109,154,574,7.99
5907,"Brian Cook\cookbr01","2006-07",26,"LAL","NBA",1.8,65,24,1018,185,408,139,293,46,115,34,47,61,154,215,65,25,27,51,134,450,6.29
5908,"Quinn Cook\cookqu01","2018-19",25,"GSW","NBA",1.8,74,10,1059,204,439,123,239,81,200,20,26,22,135,157,116,20,3,50,92,509,6.04
5909,"Terry Cummings\cummite01","1993-94",32,"SAS","NBA",1.8,59,29,1133,183,428,183,426,0,2,63,107,132,165,297,50,31,13,59,137,429,6.42
5910,"Eddy Curry\curryed01","2001-02",19,"CHI","NBA",1.8,72,31,1150,189,377,189,377,0,0,105,160,111,161,272,25,16,53,69,173,483,6.28
5911,"Antonio Daniels\daniean01","1998-99",23,"SAS","NBA",1.8,47,0,614,83,183,78,166,5,17,49,65,13,41,54,106,30,6,44,39,220,5.29
5912,"Lloyd Daniels\daniell01","1992-93",25,"SAS","NBA",1.8,77,10,1573,285,644,226,467,59,177,72,99,86,130,216,148,38,30,102,144,701,7.82
5913,"Emanual Davis\davisem01","2000-01",32,"SEA","NBA",1.8,62,39,1290,133,318,83,191,50,127,45,55,28,126,154,137,64,12,77,101,361,6.73
5914,"Michael Dickerson\dickemi01","2000-01",25,"VAN","NBA",1.8,70,69,2618,425,1020,339,790,86,230,206,270,70,159,229,233,62,27,162,207,1142,12.97
5915,"Jared Dudley\dudleja01","2018-19",33,"BRK","NBA",1.8,59,25,1220,101,239,48,88,53,151,32,46,34,121,155,83,36,16,43,131,287,5.45
5916,"Jared Dudley\dudleja01","2016-17",31,"PHO","NBA",1.8,64,7,1362,157,346,80,143,77,203,43,65,31,194,225,121,42,16,73,154,434,7.4
5917,"Pervis Ellison\ellispe01","1994-95",27,"BOS","NBA",1.8,55,11,1083,152,300,152,298,0,2,71,99,124,185,309,34,22,54,76,179,375,7.67
5918,"Francisco Elson\elsonfr01","2003-04",27,"DEN","NBA",1.8,62,14,875,94,199,94,198,0,1,30,45,65,138,203,32,35,39,35,145,218,4.45
5919,"Francisco Elson\elsonfr01","2008-09",32,"MIL","NBA",1.8,59,23,977,83,169,82,165,1,4,33,39,100,129,229,32,36,36,48,144,200,4.88
5920,"Jordan Farmar\farmajo01","2011-12",25,"NJN","NBA",1.8,39,5,831,147,315,92,190,55,125,57,63,7,54,61,129,24,2,68,49,406,9.79
5921,"Yogi Ferrell\ferreyo01","2016-17",23,"TOT","NBA",1.8,46,29,1197,160,394,92,218,68,176,74,89,20,91,111,172,42,9,70,90,462,9.94
5922,"Derek Fisher\fishede01","2000-01",26,"LAL","NBA",1.8,20,20,709,77,187,52,124,25,63,50,62,5,54,59,87,39,2,29,50,229,12.45
5923,"Rick Fox\foxri01","1998-99",29,"LAL","NBA",1.8,44,1,944,148,330,116,235,32,95,66,89,26,63,89,89,28,10,56,114,394,7.86
5924,"Dan Gadzuric\gadzuda01","2008-09",30,"MIL","NBA",1.8,67,26,941,117,244,117,242,0,2,37,68,95,160,255,39,32,43,41,162,271,4.87
5925,"Kevin Gamble\gamblke01","1995-96",30,"TOT","NBA",1.8,65,13,1325,152,379,108,265,44,114,38,48,21,92,113,100,35,8,43,147,386,5.13
5926,"Francisco García\garcifr01","2013-14",32,"HOU","NBA",1.8,55,4,1083,118,294,49,101,69,193,10,19,21,101,122,63,27,33,30,120,315,5.38
5927,"Winston Garland\garlawi01","1992-93",28,"HOU","NBA",1.8,66,4,1004,152,343,146,330,6,13,81,89,32,76,108,138,39,4,67,116,391,5.91
5928,"Rudy Gay\gayru01","2016-17",30,"SAC","NBA",1.8,30,30,1013,201,442,159,329,42,113,118,138,35,155,190,83,44,26,74,79,562,17.38
5929,"Gordan Giriček\giricgo01","2004-05",27,"UTA","NBA",1.8,81,44,1660,283,632,245,527,38,105,111,137,25,157,182,137,46,11,90,155,715,7.38
5930,"Drew Gooden\goodedr01","2010-11",29,"MIL","NBA",1.8,35,18,860,156,362,153,342,3,20,81,102,73,165,238,47,21,18,46,98,396,10.24
5931,"Treveon Graham\grahatr01","2017-18",24,"CHO","NBA",1.8,63,2,1050,96,221,56,124,40,97,41,59,42,79,121,59,33,2,27,109,273,4.34
5932,"Willie Green\greenwi01","2010-11",29,"NOH","NBA",1.8,77,13,1674,270,609,216,454,54,155,78,100,22,139,161,74,36,13,67,143,672,6.57
5933,"Tom Gugliotta\guglito01","2000-01",31,"PHO","NBA",1.8,57,2,1159,149,380,146,368,3,12,61,77,76,179,255,55,47,21,51,110,362,6.16
5934,"Richard Hamilton\hamilri01","2010-11",32,"DET","NBA",1.8,55,39,1498,288,671,233,527,55,144,146,172,24,102,126,171,39,4,88,95,777,11.35
5935,"Zendon Hamilton\hamilze01","2003-04",28,"PHI","NBA",1.8,46,0,473,51,95,51,95,0,0,67,96,49,97,146,13,8,8,27,74,169,4.18
5936,"Tom Hammonds\hammoto01","1995-96",28,"DEN","NBA",1.8,71,4,1045,127,268,127,268,0,0,88,115,85,138,223,23,23,13,48,137,342,4.67
5937,"Tim Hardaway\hardati01","2001-02",35,"TOT","NBA",1.8,68,16,1601,226,620,103,266,123,354,77,97,14,110,124,278,57,10,111,109,652,8.95
5938,"Tim Hardaway\hardati02","2018-19",26,"TOT","NBA",1.8,65,63,2057,390,993,228,516,162,477,232,276,33,189,222,159,54,8,105,141,1174,13.49
5939,"Ron Harper\harpero01","2000-01",37,"LAL","NBA",1.8,47,46,1139,127,271,108,199,19,72,34,48,46,120,166,113,39,25,62,70,307,7.76
5940,"Donnell Harvey\harvedo01","2001-02",21,"TOT","NBA",1.8,47,4,841,108,217,108,217,0,0,54,90,80,147,227,37,21,24,33,115,270,6.41
5941,"Juan Hernangómez\hernaju01","2016-17",21,"DEN","NBA",1.8,62,9,842,101,224,55,111,46,113,57,76,43,144,187,29,30,12,31,62,305,5.07
5942,"Willy Hernangómez\hernawi01","2017-18",23,"TOT","NBA",1.8,48,1,495,91,164,86,152,5,12,59,90,61,122,183,33,18,16,35,64,246,5.85
5943,"Roy Hibbert\hibbero01","2016-17",30,"TOT","NBA",1.8,48,13,682,80,147,80,147,0,0,61,75,54,98,152,21,8,46,32,100,221,5.42
5944,"J.J. Hickson\hicksjj01","2014-15",26,"DEN","NBA",1.8,73,8,1411,218,459,218,457,0,2,116,201,150,302,452,57,36,35,96,136,552,7.74
5945,"Jordan Hill\hilljo01","2010-11",23,"HOU","NBA",1.8,72,11,1125,173,352,173,350,0,2,60,85,128,178,306,29,14,52,62,157,406,5.72
5946,"Kirk Hinrich\hinriki01","2011-12",31,"ATL","NBA",1.8,48,31,1237,122,295,75,159,47,136,25,32,11,90,101,132,38,11,58,100,316,6.96
5947,"Fred Hoiberg\hoibefr01","1999-00",27,"CHI","NBA",1.8,31,11,845,89,230,57,136,32,94,69,76,7,103,110,85,40,2,43,66,279,9.54
5948,"Ryan Hollins\holliry01","2010-11",26,"CLE","NBA",1.8,70,16,1182,131,219,131,219,0,0,111,163,70,116,186,26,22,42,67,199,373,5.65
5949,"Eddie House\houseed01","2004-05",26,"TOT","NBA",1.8,68,7,891,165,366,121,269,44,97,23,27,16,67,83,96,44,6,35,65,397,5.2
5950,"Byron Houston\houstby01","1992-93",23,"GSW","NBA",1.8,79,8,1274,145,325,143,318,2,7,129,194,119,196,315,69,44,43,87,253,421,6
5951,"Larry Hughes\hughela01","2007-08",29,"TOT","NBA",1.8,68,57,2020,305,801,238,607,67,194,150,188,39,191,230,181,99,17,116,139,827,10.33
5952,"Larry Hughes\hughela01","2005-06",27,"CLE","NBA",1.8,36,31,1281,192,469,164,393,28,76,146,193,26,135,161,131,53,21,99,117,558,14.21
5953,"Jay Humphries\humphja01","1992-93",30,"UTA","NBA",1.8,78,20,2034,287,659,272,584,15,75,101,130,40,103,143,317,101,11,132,236,690,9.23
5954,"Kris Humphries\humphkr01","2007-08",22,"TOR","NBA",1.8,70,0,925,161,333,161,331,0,2,75,124,90,169,259,28,25,28,47,107,397,5.38
5955,"Mike James\jamesmi01","2002-03",27,"MIA","NBA",1.8,78,8,1722,218,585,151,357,67,228,104,142,26,123,149,246,64,5,108,176,607,7.29
5956,"Anthony Johnson\johnsan02","2002-03",28,"NJN","NBA",1.8,66,2,842,103,231,90,196,13,35,51,74,13,65,78,86,37,5,41,93,270,4.12
5957,"Eddie Johnson\johnsed03","1996-97",37,"TOT","NBA",1.8,52,2,913,160,362,111,231,49,131,55,68,27,111,138,52,15,2,47,81,424,6.49
5958,"Stanley Johnson\johnsst04","2017-18",21,"DET","NBA",1.8,69,50,1894,210,560,143,326,67,234,112,145,33,219,252,112,95,14,77,169,599,8.14
5959,"Dahntay Jones\jonesda02","2009-10",29,"IND","NBA",1.8,76,26,1892,287,623,283,591,4,32,198,257,48,181,229,150,40,39,129,237,776,9.14
5960,"Damon Jones\jonesda01","2000-01",24,"VAN","NBA",1.8,71,10,1415,170,416,86,185,84,231,37,52,16,108,124,224,36,1,76,58,461,6.69
5961,"Frank Kaminsky\kaminfr01","2018-19",25,"CHO","NBA",1.8,47,0,755,138,298,88,159,50,139,79,107,39,124,163,63,12,12,41,68,405,7.87
5962,"Steve Kerr\kerrst01","2001-02",36,"POR","NBA",1.8,65,0,775,102,217,76,151,26,66,39,40,6,54,60,63,13,1,24,49,269,3.68
5963,"Kerry Kittles\kittlke01","1998-99",24,"NJN","NBA",1.8,46,40,1570,227,613,177,455,50,158,88,114,52,139,191,116,79,26,66,82,592,10.83
5964,"Brevin Knight\knighbr01","2006-07",31,"CHA","NBA",1.8,45,25,1273,152,363,151,345,1,18,103,128,14,101,115,296,67,3,95,113,408,11.71
5965,"Jon Koncak\koncajo01","1994-95",31,"ATL","NBA",1.8,62,20,943,77,187,65,151,12,36,13,24,23,161,184,52,36,46,20,137,179,4.08
5966,"Caris LeVert\leverca01","2016-17",22,"BRK","NBA",1.8,57,26,1237,171,380,112,196,59,184,67,93,23,165,188,110,49,8,59,91,468,8.19
5967,"Shaun Livingston\livinsh01","2017-18",32,"GSW","NBA",1.8,71,7,1129,172,343,172,338,0,5,50,61,32,99,131,140,35,21,58,117,394,5.89
5968,"Luc Longley\longllu01","1998-99",30,"PHO","NBA",1.8,39,39,933,140,290,140,290,0,0,59,76,59,162,221,45,23,21,53,119,339,8.79
5969,"Luc Longley\longllu01","1994-95",26,"CHI","NBA",1.8,55,0,1001,135,302,135,300,0,2,88,107,82,181,263,73,24,45,86,177,358,7.36
5970,"Ian Mahinmi\mahinia01","2010-11",24,"DAL","NBA",1.8,56,0,488,55,98,55,96,0,2,63,82,43,77,120,8,14,15,25,105,173,3.52
5971,"Jamal Mashburn\mashbja01","1998-99",26,"MIA","NBA",1.8,24,23,855,134,297,121,267,13,30,75,104,24,122,146,75,20,3,60,58,356,13.46
5972,"Tony Massenburg\masseto01","1998-99",31,"VAN","NBA",1.8,43,35,1143,189,388,189,386,0,2,103,155,83,174,257,23,26,39,64,108,481,10.15
5973,"Jason Maxiell\maxieja01","2006-07",23,"DET","NBA",1.8,67,8,943,131,262,131,262,0,0,72,137,88,98,186,14,30,60,53,110,334,4.97
5974,"Jason Maxiell\maxieja01","2012-13",29,"DET","NBA",1.8,72,71,1789,204,457,204,457,0,0,90,145,135,274,409,54,32,95,81,172,498,7.47
5975,"Lee Mayberry\maybele01","1992-93",22,"MIL","NBA",1.8,82,4,1503,171,375,128,265,43,110,39,68,26,92,118,273,59,7,85,148,424,6.35
5976,"Walter McCarty\mccarwa01","2001-02",27,"BOS","NBA",1.8,56,0,718,80,180,41,81,39,99,13,19,32,96,128,41,18,7,22,83,212,3.9
5977,"CJ McCollum\mccolcj01","2014-15",23,"POR","NBA",1.8,62,3,973,159,365,104,226,55,139,51,73,14,77,91,64,43,8,48,81,424,5.7
5978,"Antonio McDyess\mcdyean01","1996-97",22,"DEN","NBA",1.8,74,73,2565,536,1157,530,1122,6,35,274,387,155,382,537,106,62,126,199,276,1352,15.55
5979,"Jim McIlvaine\mcilvji01","1995-96",23,"WSB","NBA",1.8,80,6,1195,62,145,62,145,0,0,58,105,66,164,230,11,21,166,36,171,182,4.04
5980,"Derrick McKey\mckeyde01","1996-97",30,"IND","NBA",1.8,50,49,1449,148,379,133,321,15,58,89,123,80,161,241,135,47,30,83,141,400,8.78
5981,"Stanislav Medvedenko\medvest01","2001-02",22,"LAL","NBA",1.8,71,6,729,145,304,145,300,0,4,41,62,85,73,158,43,29,11,42,119,331,4.19
5982,"Ron Mercer\mercero01","1999-00",23,"TOT","NBA",1.8,68,68,2377,460,1080,445,1032,15,48,213,270,64,186,250,158,75,23,151,151,1148,12.57
5983,"Ron Mercer\mercero01","2000-01",24,"CHI","NBA",1.8,61,61,2535,500,1121,486,1075,14,46,188,228,72,164,236,201,78,27,129,148,1202,15.3
5984,"Mike Miller\millemi01","2011-12",31,"MIA","NBA",1.8,39,2,752,91,209,38,92,53,117,2,5,22,106,128,42,14,6,30,58,237,5.76
5985,"Oliver Miller\milleol01","1996-97",26,"TOT","NBA",1.8,61,8,1152,123,238,123,236,0,2,48,79,105,201,306,87,47,63,90,181,294,7.19
5986,"E'Twaun Moore\mooreet01","2015-16",26,"CHI","NBA",1.8,59,22,1263,187,389,140,285,47,104,22,35,19,114,133,99,37,18,53,103,443,6.99
5987,"Marcus Morris\morrima03","2012-13",23,"TOT","NBA",1.8,77,23,1524,222,526,136,293,86,233,66,117,80,197,277,62,45,20,77,160,596,6.62
5988,"Ronald Murray\murraro01","2009-10",30,"TOT","NBA",1.8,75,2,1673,268,683,199,462,69,221,141,194,28,155,183,135,46,16,91,126,746,7.72
5989,"Raul Neto\netora01","2015-16",23,"UTA","NBA",1.8,81,53,1499,180,418,116,256,64,162,52,70,17,103,120,174,62,2,109,122,476,5.94
5990,"Moochie Norris\norrimo01","2001-02",28,"HOU","NBA",1.8,82,26,2249,251,631,215,497,36,134,127,169,73,173,246,403,81,4,156,130,665,9.4
5991,"Bo Outlaw\outlabo01","1998-99",27,"ORL","NBA",1.8,31,22,851,84,154,84,151,0,3,35,81,54,113,167,56,40,43,58,79,203,9.24
5992,"Scott Padgett\padgesc01","2005-06",29,"NJN","NBA",1.8,62,1,718,71,201,29,80,42,121,27,34,56,109,165,41,28,12,21,90,211,3.66
5993,"Milt Palacio\palacmi01","2000-01",22,"BOS","NBA",1.8,58,6,1141,126,267,114,231,12,36,78,92,25,77,102,151,48,0,80,83,342,6.8
5994,"J.R. Reid\reidjr01","1997-98",29,"CHH","NBA",1.8,79,1,1109,146,318,143,310,3,8,89,122,72,138,210,51,35,19,65,172,384,4.74
5995,"Brian Roberts\roberbr01","2014-15",29,"CHO","NBA",1.8,72,10,1330,176,452,114,259,62,193,66,74,13,96,109,162,33,6,57,75,480,5.9
5996,"Stanley Roberts\roberst01","1997-98",27,"MIN","NBA",1.8,74,44,1328,191,386,191,386,0,0,75,156,109,254,363,27,24,72,70,226,457,6.34
5997,"Nate Robinson\robinna01","2013-14",29,"DEN","NBA",1.8,44,1,866,164,383,106,229,58,154,71,85,21,60,81,112,36,4,58,92,457,9.06
5998,"Sean Rooks\rooksse01","1995-96",26,"TOT","NBA",1.8,65,7,1117,144,285,143,278,1,7,135,202,81,174,255,47,23,42,80,141,424,6.81
5999,"Sean Rooks\rooksse01","1996-97",27,"LAL","NBA",1.8,69,3,735,87,185,87,184,0,1,91,130,56,107,163,42,17,38,51,123,265,4.24
6000,"Jalen Rose\roseja01","1998-99",26,"IND","NBA",1.8,49,1,1238,200,496,183,431,17,65,125,158,34,120,154,93,50,15,72,128,542,9.16
6001,"Thabo Sefolosha\sefolth01","2011-12",27,"OKC","NBA",1.8,42,42,914,67,155,36,84,31,71,38,43,21,107,128,47,37,17,40,78,203,6.01
6002,"Brian Shaw\shawbr01","1992-93",26,"MIA","NBA",1.8,68,45,1603,197,501,154,371,43,130,61,78,70,187,257,235,48,19,96,163,498,8.06
6003,"Reggie Slater\slatere01","2000-01",30,"MIN","NBA",1.8,55,16,686,90,175,90,175,0,0,74,110,78,108,186,26,18,9,43,126,254,4.91
6004,"Jason Smith\smithja02","2015-16",29,"ORL","NBA",1.8,76,2,1181,244,503,240,487,4,16,54,67,53,166,219,62,33,65,57,163,546,6.52
6005,"Steve Smith\smithst01","2004-05",35,"TOT","NBA",1.8,50,1,750,102,248,61,143,41,105,69,80,15,50,65,71,14,7,27,82,314,5.43
6006,"Marreese Speights\speigma01","2015-16",28,"GSW","NBA",1.8,72,0,832,197,456,173,394,24,62,94,114,77,162,239,61,19,34,66,117,512,6.18
6007,"Lance Stephenson\stephla01","2017-18",27,"IND","NBA",1.8,82,7,1850,303,709,236,477,67,232,84,127,62,362,424,235,46,17,131,177,757,9.23
6008,"DeShawn Stevenson\stevede01","2010-11",29,"DAL","NBA",1.8,72,54,1158,128,330,34,81,94,249,33,43,20,86,106,77,21,5,44,71,383,4.44
6009,"Bob Sura\surabo01","2002-03",29,"GSW","NBA",1.8,55,0,1130,135,328,107,243,28,85,103,148,58,109,167,177,45,2,82,108,401,8.08
6010,"Maurice Taylor\tayloma01","1997-98",21,"LAC","NBA",1.8,71,3,1513,321,675,321,674,0,1,173,244,118,178,296,53,34,40,107,222,815,9.3
6011,"Tyrus Thomas\thomaty01","2010-11",24,"CHA","NBA",1.8,41,2,861,156,331,156,328,0,3,107,136,65,159,224,29,30,66,65,113,419,10.35
6012,"Robert Traylor\traylro01","2004-05",27,"CLE","NBA",1.8,74,6,1327,177,399,177,391,0,8,55,102,136,196,332,61,54,50,73,215,409,6.03
6013,"Jacque Vaughn\vaughja01","2004-05",29,"NJN","NBA",1.8,71,34,1410,146,325,141,310,5,15,76,91,17,90,107,135,41,1,62,138,373,5.31
6014,"Noah Vonleh\vonleno01","2016-17",21,"POR","NBA",1.8,74,41,1265,130,270,123,250,7,20,60,94,131,256,387,31,30,27,64,154,327,5.43
6015,"Nikola Vučević\vucevni01","2011-12",21,"PHI","NBA",1.8,51,15,812,131,291,128,283,3,8,18,34,88,158,246,31,20,34,33,111,283,5.67
6016,"Sasha Vujačić\vujacsa01","2006-07",22,"LAL","NBA",1.8,73,4,935,105,268,45,107,60,161,43,49,28,79,107,64,41,1,30,103,313,4.03
6017,"Earl Watson\watsoea01","2003-04",24,"MEM","NBA",1.8,81,14,1669,172,464,146,358,26,106,90,138,49,129,178,402,91,19,146,175,460,7.92
6018,"Martell Webster\webstma02","2010-11",24,"MIN","NBA",1.8,46,1,1094,152,340,97,208,55,132,94,122,36,111,147,53,28,9,58,101,453,8.58
6019,"Doug West\westdo01","1994-95",27,"MIN","NBA",1.8,71,65,2328,351,762,340,701,11,61,206,246,60,167,227,185,65,24,126,250,919,11.44
6020,"Mark West\westma01","1994-95",34,"DET","NBA",1.8,67,58,1543,217,390,217,390,0,0,66,138,160,248,408,18,27,102,85,247,500,8.35
6021,"D.J. White\whitedj01","2010-11",24,"TOT","NBA",1.8,47,0,685,111,219,111,217,0,2,46,64,43,115,158,19,12,20,14,77,268,5.41
6022,"Rodney White\whitero02","2003-04",23,"DEN","NBA",1.8,72,0,985,215,468,182,381,33,87,78,104,44,121,165,60,32,20,78,105,541,6.15
6023,"Derrick Williams\willide02","2011-12",20,"MIN","NBA",1.8,66,15,1418,205,498,168,360,37,138,136,195,77,234,311,38,30,31,77,95,583,7.51
6024,"Jayson Williams\willija01","1993-94",25,"NJN","NBA",1.8,70,0,877,125,293,125,293,0,0,72,119,109,154,263,26,17,36,35,140,322,4.48
6025,"Mo Williams\willima01","2012-13",30,"UTA","NBA",1.8,46,46,1418,229,533,170,379,59,154,75,85,24,86,110,285,46,9,125,105,592,13.09
6026,"Jeff Withey\witheje01","2013-14",23,"NOP","NBA",1.8,58,4,684,69,129,69,128,0,1,52,73,49,101,150,26,15,50,20,73,190,4.26
6027,"Jeff Withey\witheje01","2016-17",26,"UTA","NBA",1.8,51,1,432,55,103,55,102,0,1,36,48,52,69,121,7,16,32,14,52,146,3.58
6028,"Quincy Acy\acyqu01","2014-15",24,"NYK","NBA",1.7,68,22,1287,152,331,134,271,18,60,76,97,79,222,301,68,27,22,60,147,398,6.31
6029,"Lavoy Allen\allenla01","2016-17",27,"IND","NBA",1.7,61,5,871,77,168,77,167,0,1,23,33,105,114,219,57,18,24,29,78,177,4.07
6030,"Tony Allen\allento01","2005-06",24,"BOS","NBA",1.7,51,9,978,129,274,118,240,11,34,100,134,32,79,111,67,51,18,67,126,369,7.26
6031,"Derrick Alston\alstode01","1995-96",23,"PHI","NBA",1.7,73,41,1614,198,387,197,384,1,3,55,112,127,175,302,61,56,52,59,191,452,6.76
6032,"Alan Anderson\anderal01","2013-14",31,"BRK","NBA",1.7,78,26,1773,194,485,110,237,84,248,92,118,40,135,175,81,48,11,62,147,564,6.08
6033,"Shandon Anderson\andersh01","2003-04",30,"NYK","NBA",1.7,80,37,1974,238,564,202,436,36,128,123,161,53,169,222,122,68,17,118,182,635,7.18
6034,"Joel Anthony\anthojo01","2008-09",26,"MIA","NBA",1.7,65,28,1048,57,118,57,118,0,0,30,46,89,108,197,27,20,93,41,139,144,4.01
6035,"Carlos Arroyo\arroyca01","2010-11",31,"TOT","NBA",1.7,64,43,1185,120,273,89,204,31,69,39,47,20,83,103,125,21,1,60,71,310,4.91
6036,"Darrell Arthur\arthuda01","2008-09",20,"MEM","NBA",1.7,76,64,1464,191,436,191,434,0,2,40,60,108,238,346,43,52,52,47,206,422,5.82
6037,"Darrell Arthur\arthuda01","2012-13",24,"MEM","NBA",1.7,59,3,970,162,359,157,341,5,18,33,46,68,101,169,33,24,33,43,126,362,5.22
6038,"Ömer Aşık\asikom01","2015-16",29,"NOP","NBA",1.7,68,64,1178,104,195,104,195,0,0,61,112,120,294,414,26,21,23,60,124,269,5.51
6039,"Mo Bamba\bambamo01","2018-19",20,"ORL","NBA",1.7,47,1,766,117,243,96,173,21,70,37,63,64,169,233,39,13,64,43,102,292,7.16
6040,"Leandro Barbosa\barbole01","2011-12",29,"TOT","NBA",1.7,64,0,1382,271,637,206,467,65,170,101,124,33,95,128,96,56,7,94,135,708,8.45
6041,"Michael Beasley\beaslmi01","2010-11",22,"MIN","NBA",1.7,73,73,2361,561,1246,501,1082,60,164,219,291,118,291,409,158,54,52,195,222,1401,14.92
6042,"Raja Bell\bellra01","2010-11",34,"UTA","NBA",1.7,68,63,2097,191,467,123,274,68,193,91,102,31,145,176,118,56,14,63,169,541,7.43
6043,"Raja Bell\bellra01","2002-03",26,"DAL","NBA",1.7,75,32,1173,93,211,72,160,21,51,23,34,47,98,145,57,52,8,43,134,230,3.61
6044,"Jonathan Bender\bendejo01","2002-03",22,"IND","NBA",1.7,46,2,819,112,254,93,201,19,53,60,84,42,91,133,42,8,56,42,86,303,6.31
6045,"Chauncey Billups\billuch01","2011-12",35,"LAC","NBA",1.7,20,20,607,83,228,35,103,48,125,85,95,4,46,50,80,9,3,38,40,299,12.79
6046,"Corie Blount\blounco01","1994-95",26,"CHI","NBA",1.7,68,9,889,100,210,100,208,0,2,38,67,107,133,240,60,26,33,59,146,238,4.51
6047,"Mark Blount\blounma01","2005-06",30,"TOT","NBA",1.7,81,55,2240,373,734,373,734,0,0,168,222,96,269,365,99,40,76,194,254,914,10.32
6048,"Mark Blount\blounma01","2002-03",27,"TOT","NBA",1.7,81,31,1403,150,347,150,347,0,0,101,139,111,197,308,56,42,68,103,187,401,5.62
6049,"Keith Bogans\boganke01","2006-07",26,"ORL","NBA",1.7,59,18,990,99,245,46,108,53,137,47,63,16,77,93,59,28,2,46,98,298,4.54
6050,"Muggsy Bogues\boguemu01","1997-98",33,"TOT","NBA",1.7,61,31,1570,141,323,137,307,4,16,61,68,30,102,132,331,67,3,105,58,347,8.66
6051,"Muggsy Bogues\boguemu01","1998-99",34,"GSW","NBA",1.7,36,5,714,76,154,76,148,0,6,31,36,16,57,73,134,43,1,47,44,183,7.51
6052,"Andrew Bogut\bogutan01","2012-13",28,"GSW","NBA",1.7,32,32,786,83,184,82,183,1,1,19,38,68,177,245,67,20,55,35,85,186,8.94
6053,"Josh Boone\boonejo01","2006-07",22,"NJN","NBA",1.7,61,0,669,99,171,99,171,0,0,56,103,64,112,176,10,11,21,33,94,254,4.23
6054,"Ryan Bowen\bowenry01","2000-01",25,"DEN","NBA",1.7,57,0,696,80,144,76,133,4,11,27,44,62,51,113,30,37,12,24,95,191,3.98
6055,"Ronnie Brewer\brewero02","2006-07",21,"UTA","NBA",1.7,56,14,675,102,193,102,184,0,9,56,83,37,38,75,24,37,6,24,44,260,4.34
6056,"Jon Brockman\brockjo01","2009-10",22,"SAC","NBA",1.7,52,4,654,55,103,55,103,0,0,37,62,105,108,213,22,15,5,23,115,147,3.96
6057,"Devin Brown\brownde02","2003-04",25,"SAS","NBA",1.7,58,0,627,85,196,81,182,4,14,60,74,38,92,130,33,15,4,38,61,234,3.76
6058,"Matt Bullard\bullama01","1996-97",29,"HOU","NBA",1.7,71,12,1025,114,284,47,101,67,183,25,34,13,104,117,67,21,18,38,68,320,4.09
6059,"Alec Burks\burksal01","2014-15",23,"UTA","NBA",1.7,27,27,899,121,300,95,232,26,68,106,129,19,95,114,82,17,5,52,64,374,12.1
6060,"Rasual Butler\butlera01","2005-06",26,"NOK","NBA",1.7,79,20,1875,257,633,165,391,92,242,79,114,51,181,232,40,33,45,65,142,685,6.53
6061,"Rasual Butler\butlera01","2004-05",25,"MIA","NBA",1.7,65,15,1203,163,409,106,256,57,153,37,48,15,136,151,62,18,29,37,104,420,5.18
6062,"Will Bynum\bynumwi01","2012-13",30,"DET","NBA",1.7,65,0,1219,253,540,229,464,24,76,106,131,28,69,97,231,45,5,125,128,636,9.2
6063,"Brian Cardinal\cardibr01","2010-11",33,"DAL","NBA",1.7,56,4,618,43,100,1,13,42,87,17,18,10,49,59,40,24,7,17,82,145,3.08
6064,"Chris Carr\carrch01","1996-97",22,"MIN","NBA",1.7,55,10,830,125,271,94,183,31,88,56,73,31,82,113,48,24,10,37,93,337,5.46
6065,"Anthony Carter\cartean01","2000-01",25,"MIA","NBA",1.7,72,6,1630,195,480,189,440,6,40,65,103,46,134,180,268,73,10,119,154,461,7.32
6066,"Kelvin Cato\catoke01","2000-01",26,"HOU","NBA",1.7,35,13,624,64,111,64,111,0,0,37,57,47,94,141,11,13,31,25,89,165,5.82
6067,"Dell Curry\curryde01","1997-98",33,"CHH","NBA",1.7,52,1,971,194,434,133,289,61,145,41,52,26,75,101,69,31,4,54,85,490,7.34
6068,"Eddy Curry\curryed01","2007-08",25,"NYK","NBA",1.7,59,58,1530,297,544,297,544,0,0,187,300,111,164,275,32,14,29,126,157,781,10.86
6069,"Michael Curry\currymi01","2000-01",32,"DET","NBA",1.7,68,58,1485,145,319,141,310,4,9,62,73,21,100,121,132,27,3,61,173,356,5.24
6070,"Michael Curry\currymi01","1998-99",30,"MIL","NBA",1.7,50,4,1146,90,206,89,191,1,15,63,79,19,89,108,78,42,7,37,135,244,5.48
6071,"Kornél Dávid\davidko01","1998-99",27,"CHI","NBA",1.7,50,6,902,109,243,109,242,0,1,90,111,70,103,173,40,23,17,48,88,308,6.1
6072,"Ed Davis\davised01","2016-17",27,"POR","NBA",1.7,46,12,789,75,142,75,142,0,0,50,81,96,148,244,26,15,22,37,137,200,5.75
6073,"Glen Davis\davisgl01","2011-12",26,"ORL","NBA",1.7,61,13,1427,225,534,223,520,2,14,114,167,107,224,331,47,43,19,75,106,566,7.91
6074,"Hubert Davis\davishu01","2001-02",31,"WAS","NBA",1.7,51,17,1231,146,326,89,200,57,126,16,21,7,70,77,107,28,3,44,58,365,6.45
6075,"Johnny Dawkins\dawkijo01","1992-93",29,"PHI","NBA",1.7,74,10,1598,258,590,232,506,26,84,113,142,33,103,136,339,80,4,121,91,655,9.57
6076,"Andrew DeClercq\declean01","2003-04",30,"ORL","NBA",1.7,71,53,1211,93,195,93,195,0,0,44,54,131,186,317,44,47,32,54,217,230,4.98
6077,"Dewayne Dedmon\dedmode01","2014-15",25,"ORL","NBA",1.7,59,15,845,91,162,91,161,0,1,34,64,118,177,295,9,16,50,51,141,216,5.12
6078,"Juan Dixon\dixonju01","2006-07",28,"TOT","NBA",1.7,81,6,1926,299,703,220,477,79,226,101,116,27,131,158,123,76,9,101,177,778,7.79
6079,"Michael Doleac\doleami01","2003-04",26,"TOT","NBA",1.7,72,0,1029,140,322,140,322,0,0,45,52,88,177,265,44,23,36,48,142,325,4.69
6080,"Bryce Drew\drewbr01","2001-02",27,"CHH","NBA",1.7,61,0,774,78,182,47,109,31,73,23,29,14,58,72,101,32,2,33,49,210,4
6081,"Joe Dumars\dumarjo01","1994-95",31,"DET","NBA",1.7,67,67,2544,417,970,314,632,103,338,277,344,47,111,158,368,72,7,219,153,1214,16.01
6082,"Howard Eisley\eisleho01","2003-04",31,"TOT","NBA",1.7,67,23,1457,166,451,114,288,52,163,76,89,20,109,129,273,56,5,98,137,460,7.58
6083,"Maurice Evans\evansma01","2010-11",32,"TOT","NBA",1.7,73,24,1549,177,424,122,257,55,167,52,58,52,104,156,45,34,14,33,129,461,5.07
6084,"Reggie Evans\evansre01","2003-04",23,"SEA","NBA",1.7,75,27,1280,67,165,67,162,0,3,83,148,156,252,408,33,54,10,65,176,217,4.66
6085,"Festus Ezeli\ezelife01","2014-15",25,"GSW","NBA",1.7,46,7,504,76,139,76,139,0,0,49,78,60,95,155,9,7,42,32,77,201,4.94
6086,"Cristiano Felício\feliccr01","2017-18",25,"CHI","NBA",1.7,55,16,977,127,215,127,213,0,2,54,81,83,150,233,55,16,11,54,104,308,6.42
6087,"Raymond Felton\feltora01","2011-12",27,"POR","NBA",1.7,60,56,1906,261,642,199,439,62,203,100,124,27,122,149,390,78,10,170,122,684,12.45
6088,"Danny Ferry\ferryda01","1993-94",27,"CLE","NBA",1.7,70,1,965,149,334,135,283,14,51,38,43,47,94,141,74,28,22,41,113,350,4.65
6089,"Danny Ferry\ferryda01","1998-99",32,"CLE","NBA",1.7,50,10,1058,141,296,103,199,38,97,29,33,16,86,102,53,23,10,39,113,349,6.09
6090,"Derek Fisher\fishede01","1998-99",24,"LAL","NBA",1.7,50,21,1131,99,263,61,166,38,97,60,79,21,70,91,197,61,1,77,95,296,7.6
6091,"Randy Foye\foyera01","2010-11",27,"LAC","NBA",1.7,63,24,1551,206,531,135,314,71,217,133,149,13,90,103,170,47,21,95,122,616,8.61
6092,"Anthony Goldwire\goldwan01","1996-97",25,"TOT","NBA",1.7,60,30,1188,131,330,67,177,64,153,61,78,12,72,84,219,33,2,76,104,387,7.05
6093,"Drew Gooden\goodedr01","2002-03",21,"TOT","NBA",1.7,70,47,1873,355,777,341,729,14,48,151,212,163,292,455,83,53,35,150,172,875,10.95
6094,"Drew Gooden\goodedr01","2014-15",33,"WAS","NBA",1.7,51,7,864,110,276,87,217,23,59,34,44,72,151,223,49,21,9,28,91,277,5.38
6095,"Ben Gordon\gordobe01","2011-12",28,"DET","NBA",1.7,52,21,1398,234,530,171,383,63,147,117,136,14,107,121,127,34,11,115,114,648,10.42
6096,"Ben Gordon\gordobe01","2010-11",27,"DET","NBA",1.7,82,27,2131,339,770,232,504,107,266,136,160,41,154,195,171,48,16,141,178,921,9.33
6097,"Jerian Grant\grantje02","2018-19",26,"ORL","NBA",1.7,60,1,939,92,220,52,110,40,110,26,40,19,79,98,156,44,6,51,78,250,5.4
6098,"Gerald Green\greenge01","2015-16",30,"MIA","NBA",1.7,69,14,1557,230,587,146,327,84,260,72,92,25,138,163,56,38,19,46,123,616,6.45
6099,"Darvin Ham\hamda01","1999-00",26,"MIL","NBA",1.7,35,21,792,71,128,71,127,0,1,35,78,85,87,172,42,29,29,29,102,177,7.03
6100,"Tom Hammonds\hammoto01","1996-97",29,"DEN","NBA",1.7,81,8,1758,191,398,191,396,0,2,124,172,135,266,401,64,16,24,88,205,506,6.45
6101,"Othella Harrington\harriot01","1997-98",24,"HOU","NBA",1.7,58,3,903,129,266,129,265,0,1,92,122,73,134,207,24,10,27,47,112,350,5.72
6102,"Andrew Harrison\harrian01","2017-18",23,"MEM","NBA",1.7,56,46,1326,181,429,134,287,47,142,124,159,23,108,131,177,38,26,81,138,533,9.35
6103,"Spencer Hawes\hawessp01","2016-17",28,"TOT","NBA",1.7,54,1,797,134,277,109,196,25,81,44,52,38,153,191,81,15,30,49,77,337,6.71
6104,"Jarvis Hayes\hayesja01","2004-05",23,"WAS","NBA",1.7,54,22,1560,206,530,164,407,42,123,99,118,41,186,227,90,49,9,62,107,553,8.63
6105,"J.J. Hickson\hicksjj01","2011-12",23,"TOT","NBA",1.7,54,19,1244,183,392,183,390,0,2,86,134,133,202,335,45,30,35,70,85,452,8.36
6106,"Grant Hill\hillgr01","2005-06",33,"ORL","NBA",1.7,21,17,613,119,243,117,235,2,8,78,102,15,65,80,48,24,6,35,50,318,13.32
6107,"Justin Holiday\holidju01","2017-18",28,"CHI","NBA",1.7,72,72,2265,290,782,129,333,161,449,135,164,31,260,291,153,80,31,93,134,876,10.53
6108,"Ryan Hollins\holliry01","2012-13",28,"LAC","NBA",1.7,60,0,663,70,114,70,114,0,0,66,88,50,89,139,11,6,34,44,133,206,3.97
6109,"Robert Horry\horryro01","1998-99",28,"LAL","NBA",1.7,38,5,744,67,146,47,101,20,45,34,46,56,96,152,56,36,39,49,103,188,7.13
6110,"Larry Hughes\hughela01","1999-00",21,"TOT","NBA",1.7,82,37,2324,459,1147,430,1022,29,125,279,377,113,236,349,205,115,28,195,191,1226,12.01
6111,"Jared Jeffries\jeffrja01","2011-12",30,"NYK","NBA",1.7,39,4,729,59,144,56,128,3,16,49,72,69,83,152,26,29,25,29,89,170,5.36
6112,"John Jenkins\jenkijo01","2012-13",21,"ATL","NBA",1.7,61,2,902,131,294,78,156,53,138,59,70,17,77,94,56,12,10,40,37,374,5.11
6113,"Brandon Jennings\jennibr01","2016-17",27,"TOT","NBA",1.7,81,13,1802,192,535,113,283,79,252,114,152,29,167,196,395,70,4,128,116,577,8.54
6114,"DerMarr Johnson\johnsde03","2001-02",21,"ATL","NBA",1.7,72,46,1727,214,540,125,293,89,247,85,105,59,188,247,81,62,56,102,163,602,7.75
6115,"Wesley Johnson\johnswe01","2014-15",27,"LAL","NBA",1.7,76,59,2245,286,691,195,432,91,259,90,112,67,252,319,124,59,45,87,162,753,8.94
6116,"Wesley Johnson\johnswe01","2017-18",30,"LAC","NBA",1.7,74,40,1486,150,368,90,191,60,177,43,58,29,187,216,61,76,62,55,146,403,6.05
6117,"James Jones\jonesja02","2011-12",31,"MIA","NBA",1.7,51,10,666,57,150,11,36,46,114,25,30,6,43,49,19,17,9,10,45,185,3.08
6118,"Enes Kanter\kanteen01","2011-12",19,"UTA","NBA",1.7,66,0,874,117,236,117,235,0,1,70,105,107,171,278,8,18,23,54,87,304,4.89
6119,"Adam Keefe\keefead01","1998-99",28,"UTA","NBA",1.7,44,0,642,56,124,56,120,0,4,62,89,51,91,142,28,16,12,33,63,174,4.54
6120,"Brandon Knight\knighbr03","2015-16",24,"PHO","NBA",1.7,52,50,1870,371,895,251,544,120,351,156,183,36,166,202,263,61,20,177,124,1018,16.71
6121,"Brevin Knight\knighbr01","2003-04",28,"TOT","NBA",1.7,56,13,1037,105,246,103,238,2,8,49,65,14,98,112,204,84,1,72,107,261,7.08
6122,"Nenad Krstić\krstine01","2008-09",25,"OKC","NBA",1.7,46,29,1141,191,407,191,407,0,0,63,79,85,168,253,29,21,49,45,114,445,8.85
6123,"Andrew Lang\langan01","1992-93",26,"PHI","NBA",1.7,73,59,1861,149,351,148,346,1,5,87,114,136,300,436,79,46,141,89,261,386,7.72
6124,"Shane Larkin\larkish01","2014-15",22,"NYK","NBA",1.7,76,22,1865,187,432,152,316,35,116,61,78,29,147,176,226,93,9,83,150,470,7.41
6125,"Voshon Lenard\lenarvo01","2001-02",28,"DEN","NBA",1.7,71,19,1665,315,769,226,529,89,240,94,120,38,145,183,130,59,25,91,105,813,8.89
6126,"Caris LeVert\leverca01","2018-19",24,"BRK","NBA",1.7,40,25,1063,207,483,159,329,48,154,85,123,35,116,151,156,42,14,69,77,547,12.45
6127,"Rashard Lewis\lewisra02","2013-14",34,"MIA","NBA",1.7,60,6,971,98,236,52,102,46,134,26,33,24,86,110,57,53,8,35,90,268,4.69
6128,"George Lynch\lynchge01","1995-96",25,"LAL","NBA",1.7,76,6,1012,117,272,113,259,4,13,53,80,82,127,209,51,47,10,40,106,291,4.08
6129,"Todd MacCulloch\maccuto01","1999-00",24,"PHI","NBA",1.7,56,6,528,89,161,89,161,0,0,28,54,48,98,146,13,11,37,26,94,206,3.98
6130,"Shawn Marion\mariosh01","2014-15",36,"CLE","NBA",1.7,57,24,1101,119,267,107,221,12,46,26,34,64,138,202,51,27,27,33,58,276,5.19
6131,"Boban Marjanović\marjabo01","2016-17",28,"DET","NBA",1.7,35,0,293,72,132,72,132,0,0,47,58,46,84,130,9,6,12,10,25,191,5.59
6132,"Desmond Mason\masonde01","2000-01",23,"SEA","NBA",1.7,78,14,1522,189,439,171,372,18,67,67,91,72,177,249,63,39,20,53,146,463,5.36
6133,"Tony Massenburg\masseto01","1995-96",28,"TOT","NBA",1.7,54,28,1463,214,432,214,429,0,3,111,157,127,225,352,30,28,20,73,140,539,9.4
6134,"Marlon Maxey\maxeyma01","1993-94",24,"MIN","NBA",1.7,55,2,626,89,167,89,165,0,2,70,98,75,124,199,10,16,33,40,113,248,5.11
6135,"Jason Maxiell\maxieja01","2011-12",28,"DET","NBA",1.7,65,42,1466,183,383,183,381,0,2,58,106,126,207,333,41,32,50,71,151,424,6.75
6136,"Rashad McCants\mccanra01","2007-08",23,"MIN","NBA",1.7,75,24,2020,428,944,286,595,142,349,116,155,50,156,206,162,66,18,172,234,1114,11.78
6137,"Patrick McCaw\mccawpa01","2016-17",21,"GSW","NBA",1.7,71,20,1074,106,245,65,122,41,123,29,37,21,79,100,77,32,15,36,62,282,4.03
6138,"Dominic McGuire\mcguido01","2008-09",23,"WAS","NBA",1.7,79,57,2072,140,324,138,320,2,4,74,102,113,315,428,198,62,74,92,153,356,7.56
6139,"Greg Minor\minorgr01","1997-98",26,"BOS","NBA",1.7,69,16,1126,140,321,134,290,6,31,59,86,55,95,150,88,53,11,43,100,345,5.04
6140,"E'Twaun Moore\mooreet01","2013-14",24,"ORL","NBA",1.7,79,3,1506,195,456,138,295,57,161,52,68,29,107,136,112,60,13,55,106,499,5.74
6141,"E'Twaun Moore\mooreet01","2018-19",29,"NOP","NBA",1.7,53,36,1463,256,532,180,356,76,176,45,59,35,92,127,102,40,8,59,112,633,9.91
6142,"Markieff Morris\morrima02","2012-13",23,"PHO","NBA",1.7,82,32,1837,266,653,221,519,45,134,93,127,131,265,396,108,77,64,104,209,670,8.07
6143,"Anthony Morrow\morroan01","2011-12",26,"NJN","NBA",1.7,62,18,1636,272,658,166,372,106,286,97,104,31,96,127,61,46,9,70,86,747,8.68
6144,"Arnett Moultrie\moultar01","2012-13",22,"PHI","NBA",1.7,47,0,542,78,134,78,134,0,0,18,28,76,69,145,10,17,10,19,43,174,4.18
6145,"Chris Mullin\mullich01","1994-95",31,"GSW","NBA",1.7,25,23,890,170,348,128,255,42,93,94,107,25,90,115,125,38,19,93,53,476,19.2
6146,"Chris Mullin\mullich01","1999-00",36,"IND","NBA",1.7,47,2,582,80,187,35,77,45,110,37,41,14,62,76,37,28,9,28,60,242,4.94
6147,"Troy Murphy\murphtr01","2011-12",31,"LAL","NBA",1.7,59,0,956,77,171,49,104,28,67,6,9,40,151,191,51,15,16,26,98,188,4
6148,"Ronald Murray\murraro01","2003-04",24,"SEA","NBA",1.7,82,18,2021,389,915,322,686,67,229,168,235,45,159,204,205,81,28,149,158,1013,10.09
6149,"Boštjan Nachbar\nachbbo01","2004-05",24,"TOT","NBA",1.7,71,6,1341,161,411,86,215,75,196,97,117,24,158,182,74,29,16,73,183,494,6.02
6150,"Andrew Nicholson\nichoan01","2012-13",23,"ORL","NBA",1.7,75,28,1249,256,486,256,486,0,0,75,94,69,189,258,44,24,32,79,133,587,6.96
6151,"Moochie Norris\norrimo01","1999-00",26,"HOU","NBA",1.7,30,0,502,69,159,57,130,12,29,57,73,16,52,68,94,23,1,30,32,207,7.79
6152,"Moochie Norris\norrimo01","2002-03",29,"HOU","NBA",1.7,82,3,1375,134,330,123,285,11,45,78,114,37,122,159,196,55,4,86,72,357,5.17
6153,"Fabricio Oberto\obertfa01","2008-09",33,"SAS","NBA",1.7,54,11,677,61,104,61,103,0,1,20,35,65,77,142,59,7,11,38,95,142,3.71
6154,"Emeka Okafor\okafoem01","2011-12",29,"NOH","NBA",1.7,27,27,781,114,214,114,214,0,0,38,74,70,143,213,24,16,26,37,73,266,10.5
6155,"Doug Overton\overtdo01","1994-95",25,"WSB","NBA",1.7,82,20,1704,207,498,154,373,53,125,109,125,26,117,143,246,53,2,104,126,576,7.17
6156,"Zaza Pachulia\pachuza01","2013-14",29,"MIL","NBA",1.7,53,43,1325,149,349,149,348,0,1,110,130,141,192,333,136,45,14,92,124,408,9.41
6157,"Robert Pack\packro01","1993-94",24,"DEN","NBA",1.7,66,4,1382,223,503,217,474,6,29,179,236,25,98,123,356,81,9,204,147,631,11.08
6158,"Milt Palacio\palacmi01","2004-05",26,"TOR","NBA",1.7,80,4,1533,175,392,173,380,2,12,115,155,26,108,134,279,48,13,104,126,467,6.91
6159,"Robert Parish\parisro01","1995-96",42,"CHH","NBA",1.7,74,34,1086,120,241,120,241,0,0,50,71,89,214,303,29,21,54,50,80,290,4.88
6160,"Sasha Pavlović\pavloal01","2008-09",25,"CLE","NBA",1.7,66,12,1053,116,275,68,158,48,117,25,54,31,96,127,72,22,16,48,122,305,4.27
6161,"Sam Perkins\perkisa01","1998-99",37,"IND","NBA",1.7,48,0,789,80,200,45,110,35,90,43,60,36,102,138,25,15,14,22,74,238,4.6
6162,"Johan Petro\petrojo01","2006-07",21,"SEA","NBA",1.7,81,13,1510,226,438,226,438,0,0,50,77,92,243,335,45,39,47,82,237,502,6.33
6163,"Quincy Pondexter\pondequ01","2011-12",23,"MEM","NBA",1.7,64,8,1002,108,239,86,166,22,73,33,53,55,71,126,27,27,5,30,90,271,3.73
6164,"Terry Porter\portete01","1994-95",31,"POR","NBA",1.7,35,9,770,105,267,61,153,44,114,58,82,18,63,81,133,30,2,58,60,312,8.98
6165,"Leon Powe\powele01","2006-07",23,"BOS","NBA",1.7,63,2,720,79,177,79,175,0,2,106,144,97,118,215,10,14,22,47,104,264,4.43
6166,"Mark Price\pricema01","1997-98",33,"ORL","NBA",1.7,63,33,1430,229,531,177,376,52,155,87,103,24,105,129,297,53,5,162,92,597,9.94
6167,"Kurt Rambis\rambiku01","1992-93",34,"TOT","NBA",1.7,72,1,822,67,129,67,127,0,2,43,65,77,150,227,53,43,18,42,122,177,4
6168,"Kurt Rambis\rambiku01","1993-94",35,"LAL","NBA",1.7,50,1,635,59,114,59,113,0,1,46,71,84,105,189,32,22,23,26,89,164,4.68
6169,"J.J. Redick\redicjj01","2006-07",22,"ORL","NBA",1.7,42,0,622,80,195,42,97,38,98,54,60,10,42,52,36,12,0,21,52,252,4.84
6170,"Isaiah Rider\rideris01","1993-94",22,"MIN","NBA",1.7,79,60,2415,522,1115,468,965,54,150,215,265,118,197,315,202,54,28,218,194,1313,13.45
6171,"Bernard Robinson\robinbe01","2005-06",25,"CHA","NBA",1.7,66,18,1303,157,365,155,344,2,21,106,134,62,157,219,77,81,10,74,141,422,6.78
6172,"Clifford Robinson\robincl02","2004-05",38,"TOT","NBA",1.7,71,29,1689,202,523,135,330,67,193,62,97,54,155,209,104,62,53,66,181,533,6.89
6173,"Sergio Rodríguez\rodrise01","2008-09",22,"POR","NBA",1.7,80,13,1225,129,329,92,215,37,114,61,77,43,87,130,286,54,2,119,133,356,5.98
6174,"Quinton Ross\rossqu01","2004-05",23,"LAC","NBA",1.7,78,19,1659,161,373,160,369,1,4,74,110,59,151,210,109,51,22,54,165,397,5.29
6175,"Michael Ruffin\ruffimi01","2005-06",29,"WAS","NBA",1.7,76,4,1010,34,77,34,75,0,2,37,74,122,149,271,27,33,31,38,179,105,3.05
6176,"John Salmons\salmojo01","2013-14",34,"TOT","NBA",1.7,78,8,1726,150,413,87,250,63,163,40,52,20,143,163,147,47,19,54,124,403,5.1
6177,"John Salmons\salmojo01","2005-06",26,"PHI","NBA",1.7,82,24,2059,219,521,193,434,26,87,155,200,48,172,220,223,73,13,125,178,619,7.93
6178,"Brian Scalabrine\scalabr01","2003-04",25,"NJN","NBA",1.7,69,2,928,86,218,76,177,10,41,58,70,42,131,173,65,21,14,42,113,240,3.8
6179,"Kevin Séraphin\serapke01","2014-15",25,"WAS","NBA",1.7,79,0,1235,231,450,231,448,0,2,58,82,87,201,288,59,10,59,98,197,520,6.27
6180,"Iman Shumpert\shumpim01","2015-16",25,"CLE","NBA",1.7,54,5,1316,114,305,71,159,43,146,40,51,32,171,203,92,54,19,57,119,311,6.51
6181,"Ish Smith\smithis01","2018-19",30,"DET","NBA",1.7,56,0,1251,205,489,161,354,44,135,47,62,23,122,145,203,28,11,61,109,501,8.4
6182,"Jason Smith\smithja02","2012-13",26,"NOH","NBA",1.7,51,0,876,167,341,167,337,0,4,86,102,64,122,186,34,15,45,55,123,420,7.58
6183,"Tony Smith\smithto02","1993-94",25,"LAL","NBA",1.7,73,31,1617,272,617,256,567,16,50,85,119,106,89,195,148,59,14,76,128,645,7.65
6184,"Darius Songaila\songada01","2007-08",29,"WAS","NBA",1.7,80,13,1554,214,467,214,465,0,2,67,73,81,190,271,135,53,16,86,181,495,6.48
6185,"Marreese Speights\speigma01","2010-11",23,"PHI","NBA",1.7,64,1,734,144,291,143,287,1,4,55,73,64,146,210,30,8,19,40,120,344,4.95
6186,"Tiago Splitter\splitti01","2015-16",31,"ATL","NBA",1.7,36,2,579,81,155,81,153,0,2,39,48,45,75,120,30,20,12,24,71,201,6.08
6187,"Vladimir Stepania\stepavl01","2001-02",25,"MIA","NBA",1.7,67,4,884,117,249,116,247,1,2,50,104,100,170,270,16,24,44,52,103,285,4.63
6188,"Greg Stiemsma\stiemgr01","2012-13",27,"MIN","NBA",1.7,76,19,1209,127,278,127,278,0,0,53,69,61,200,261,30,44,90,59,184,307,5.12
6189,"Peja Stojaković\stojape01","1998-99",21,"SAC","NBA",1.7,48,1,1025,141,373,84,195,57,178,63,74,43,100,143,72,41,7,53,43,402,7.22
6190,"Damon Stoudamire\stoudda01","2005-06",32,"MEM","NBA",1.7,27,27,862,114,287,78,183,36,104,53,62,23,72,95,128,19,1,55,49,317,11.31
6191,"Rod Strickland\stricro02","2002-03",36,"MIN","NBA",1.7,47,8,956,120,278,119,267,1,11,79,107,20,75,95,215,46,6,76,55,320,8.53
6192,"Jeff Teague\teaguje01","2010-11",22,"ATL","NBA",1.7,70,7,963,133,304,115,256,18,48,77,97,11,91,102,138,45,25,64,82,361,5.62
6193,"Lance Thomas\thomala01","2015-16",27,"NYK","NBA",1.7,59,5,1313,169,382,125,273,44,109,102,119,34,97,131,53,22,7,57,109,484,6.67
6194,"Tim Thomas\thomati01","2007-08",30,"LAC","NBA",1.7,63,51,1940,291,705,208,434,83,271,115,153,62,261,323,171,40,29,98,192,780,11.06
6195,"Tim Thomas\thomati01","2008-09",31,"TOT","NBA",1.7,64,6,1247,189,438,111,249,78,189,89,121,42,159,201,68,31,11,70,144,545,7.31
6196,"Klay Thompson\thompkl01","2011-12",21,"GSW","NBA",1.7,66,29,1608,318,718,207,450,111,268,79,91,24,137,161,133,49,20,103,155,826,10.1
6197,"Marcus Thornton\thornma01","2015-16",28,"TOT","NBA",1.7,61,8,1109,216,542,125,272,91,270,67,79,38,112,150,85,47,4,51,90,590,7.57
6198,"Jamaal Tinsley\tinslja01","2001-02",23,"IND","NBA",1.7,80,78,2442,289,760,247,585,42,175,131,186,78,220,298,647,138,40,270,248,751,13.13
6199,"Wayman Tisdale\tisdawa01","1994-95",30,"PHO","NBA",1.7,65,13,1276,278,574,278,574,0,0,94,122,83,164,247,45,29,27,64,190,650,8.1
6200,"Gary Trent\trentga01","1995-96",21,"POR","NBA",1.7,69,10,1219,220,429,220,420,0,9,78,141,84,154,238,50,25,11,92,116,518,6.43
6201,"Jacque Vaughn\vaughja01","2006-07",31,"SAS","NBA",1.7,64,4,760,71,167,70,165,1,2,49,65,8,60,68,131,24,2,40,74,192,3.77
6202,"Jan Veselý\veselja01","2011-12",21,"WAS","NBA",1.7,57,20,1078,117,218,117,217,0,1,33,62,101,148,249,47,39,32,60,156,267,6.03
6203,"Charlie Villanueva\villach01","2006-07",22,"MIL","NBA",1.7,39,17,984,180,383,151,297,29,86,73,89,62,166,228,36,24,12,54,108,462,10.47
6204,"Charlie Villanueva\villach01","2007-08",23,"MIL","NBA",1.7,76,31,1829,354,814,299,629,55,185,123,157,145,321,466,78,30,35,107,174,886,9.73
6205,"Jake Voskuhl\voskuja01","2006-07",29,"CHA","NBA",1.7,73,9,1043,121,255,121,255,0,0,77,113,84,172,256,44,30,24,56,199,319,4.86
6206,"Antoine Walker\walkean02","1996-97",20,"BOS","NBA",1.7,82,68,2970,576,1354,524,1195,52,159,231,366,288,453,741,262,105,53,230,271,1435,15.68
6207,"Jiří Welsch\welscji01","2004-05",25,"TOT","NBA",1.7,71,32,1317,149,371,115,261,34,110,129,169,26,141,167,103,44,5,73,121,461,6.07
6208,"Doug West\westdo01","1996-97",29,"MIN","NBA",1.7,68,66,1920,226,484,211,439,15,45,64,94,37,111,148,113,61,24,66,218,531,7.16
6209,"Damien Wilkins\wilkida02","2005-06",26,"SEA","NBA",1.7,82,12,1525,193,435,179,379,14,56,136,162,79,113,192,107,72,12,85,144,536,6.47
6210,"Aaron Williams\williaa01","1997-98",26,"SEA","NBA",1.7,65,9,757,115,220,115,219,0,1,66,85,48,99,147,14,19,38,50,119,296,4.53
6211,"Jayson Williams\willija01","1996-97",28,"NJN","NBA",1.7,41,40,1432,221,540,221,536,0,4,108,183,242,311,553,51,24,36,82,158,550,13.09
6212,"Lorenzo Williams\willilo01","1995-96",26,"DAL","NBA",1.7,65,61,1806,87,214,87,213,0,1,24,70,234,287,521,85,48,122,78,226,198,7.17
6213,"Reggie Williams\willire02","2009-10",23,"GSW","NBA",1.7,24,10,782,140,283,107,191,33,92,52,62,18,92,110,66,23,6,29,49,365,14.01
6214,"Scott Williams\willisc01","1997-98",29,"PHI","NBA",1.7,58,7,801,93,213,93,208,0,5,51,63,87,124,211,29,17,21,30,132,237,4.43
6215,"Scott Williams\willisc01","1993-94",25,"CHI","NBA",1.7,38,11,638,114,236,113,231,1,5,60,98,69,112,181,39,16,21,44,112,289,7.49
6216,"Walt Williams\williwa02","2001-02",31,"HOU","NBA",1.7,48,25,1117,166,396,88,213,78,183,40,51,37,125,162,69,18,10,53,106,450,7.77
6217,"Kevin Willis\willike02","2001-02",39,"HOU","NBA",1.7,52,5,865,125,284,125,283,0,1,65,87,105,194,299,14,25,23,41,98,315,6.31
6218,"D.J. Wilson\wilsodj01","2018-19",22,"MIL","NBA",1.7,48,3,882,104,251,58,124,46,127,26,47,45,177,222,52,18,20,32,85,280,6.14
6219,"David Wingate\wingada01","1996-97",33,"SEA","NBA",1.7,65,2,929,89,214,64,143,25,71,33,40,23,51,74,80,44,5,37,108,236,3.88
6220,"Julian Wright\wrighju01","2007-08",20,"NOH","NBA",1.7,57,1,640,90,169,80,145,10,24,33,52,33,84,117,40,29,12,34,43,223,4.3
6221,"Sharone Wright\wrighsh01","1994-95",22,"PHI","NBA",1.7,79,49,2044,361,776,361,768,0,8,182,282,191,281,472,48,37,104,151,246,904,10.09
6222,"Nick Young\youngni01","2017-18",32,"GSW","NBA",1.7,80,8,1393,201,488,78,162,123,326,56,65,20,105,125,36,38,7,39,100,581,5.43
6223,"Tyler Zeller\zellety01","2015-16",26,"BOS","NBA",1.7,60,3,710,138,290,138,290,0,0,88,108,62,116,178,29,10,22,46,97,364,5.42
6224,"Michael Adams\adamsmi01","1994-95",32,"CHH","NBA",1.6,29,0,443,67,148,38,67,29,81,25,30,6,23,29,95,23,1,26,41,188,7.28
6225,"Lavoy Allen\allenla01","2011-12",22,"PHI","NBA",1.6,41,15,624,79,167,79,167,0,0,11,14,47,124,171,34,13,18,20,73,169,4.89
6226,"Tony Allen\allento01","2008-09",27,"BOS","NBA",1.6,46,2,887,137,284,131,257,6,27,79,109,22,82,104,66,54,23,77,98,359,7.85
6227,"Alan Anderson\anderal01","2012-13",30,"TOR","NBA",1.6,65,2,1495,236,616,141,331,95,285,126,147,34,114,148,103,48,7,80,131,693,8.18
6228,"Derek Anderson\anderde01","2005-06",31,"TOT","NBA",1.6,43,11,1047,108,303,68,169,40,134,93,111,21,122,143,101,23,6,54,98,349,7.63
6229,"Kenny Anderson\anderke01","2002-03",32,"TOT","NBA",1.6,61,2,1135,163,382,162,375,1,7,45,57,31,101,132,198,58,5,75,106,372,6.85
6230,"Greg Anthony\anthogr01","2000-01",33,"POR","NBA",1.6,58,0,856,97,253,32,94,65,159,23,35,21,40,61,82,40,3,43,63,282,4.53
6231,"Stacey Augmon\augmost01","2003-04",35,"NOH","NBA",1.6,69,24,1416,143,347,142,340,1,7,110,139,52,122,174,85,55,15,76,114,397,5.71
6232,"Luke Babbitt\babbilu01","2014-15",25,"NOP","NBA",1.6,63,19,830,92,192,33,77,59,115,13,19,12,99,111,24,17,11,26,63,256,3.84
6233,"Vin Baker\bakervi01","2002-03",31,"BOS","NBA",1.6,52,9,942,99,207,99,203,0,4,72,107,90,108,198,29,22,30,61,146,270,5.64
6234,"Lonzo Ball\balllo01","2018-19",21,"LAL","NBA",1.6,47,45,1423,185,456,110,228,75,228,20,48,54,197,251,255,69,19,103,114,465,12.12
6235,"Brent Barry\barrybr01","1998-99",27,"CHI","NBA",1.6,37,30,1181,141,356,89,184,52,172,78,101,39,105,144,116,42,11,72,98,412,10.77
6236,"Jerryd Bayless\bayleje01","2010-11",22,"TOT","NBA",1.6,71,14,1496,218,517,169,371,49,146,166,206,26,139,165,266,38,5,127,149,651,9.21
6237,"Kent Bazemore\bazemke01","2014-15",25,"ATL","NBA",1.6,75,10,1324,141,331,93,199,48,132,60,100,21,201,222,78,52,33,73,127,390,5.56
6238,"Michael Beasley\beaslmi01","2013-14",25,"MIA","NBA",1.6,55,2,831,177,355,156,301,21,54,61,79,31,141,172,42,23,21,57,93,436,7.04
6239,"Jordan Bell\belljo01","2018-19",24,"GSW","NBA",1.6,68,3,788,99,192,99,190,0,2,25,41,55,129,184,76,20,51,42,80,223,4.48
6240,"David Benoit\benoida01","1993-94",25,"UTA","NBA",1.6,55,18,1070,139,361,127,302,12,59,68,88,89,171,260,23,23,37,37,115,358,5.85
6241,"David Benoit\benoida01","1997-98",29,"TOT","NBA",1.6,77,0,1123,152,408,97,238,55,170,61,74,60,143,203,25,35,20,52,157,420,4.39
6242,"Andris Biedriņš\biedran01","2009-10",23,"GSW","NBA",1.6,33,29,763,81,137,81,137,0,0,4,25,63,196,259,57,20,44,32,117,166,8.74
6243,"Anthony Bowie\bowiean01","1995-96",32,"ORL","NBA",1.6,74,4,1078,128,272,116,241,12,31,40,46,40,83,123,105,34,10,55,112,308,4.46
6244,"Frank Brickowski\brickfr01","1995-96",36,"SEA","NBA",1.6,63,8,986,123,252,91,173,32,79,61,86,26,125,151,58,26,8,78,185,339,5.31
6245,"Scott Brooks\brooksc01","1995-96",30,"DAL","NBA",1.6,69,0,716,134,293,109,231,25,62,59,69,11,30,41,100,42,3,43,53,352,4.74
6246,"Chucky Brown\brownch01","1998-99",30,"CHH","NBA",1.6,48,21,1192,176,373,161,333,15,40,40,59,36,138,174,57,16,19,38,106,407,7.24
6247,"Chucky Brown\brownch01","1996-97",28,"TOT","NBA",1.6,70,1,757,78,154,77,148,1,6,47,70,41,107,148,28,9,22,19,100,204,3.16
6248,"Randy Brown\brownra02","1994-95",26,"SAC","NBA",1.6,67,2,1086,124,287,110,240,14,47,55,82,24,84,108,133,99,19,78,153,317,6.02
6249,"Shannon Brown\brownsh01","2011-12",26,"PHO","NBA",1.6,59,19,1400,251,598,183,410,68,188,80,99,38,119,157,69,44,15,64,66,650,8.3
6250,"Mark Bryant\bryanma01","1994-95",29,"POR","NBA",1.6,49,0,658,101,192,100,190,1,2,41,63,55,106,161,28,19,16,39,109,244,5.21
6251,"Willie Burton\burtowi01","1993-94",25,"MIA","NBA",1.6,53,1,697,124,283,121,268,3,15,120,158,50,86,136,39,18,20,54,96,371,6.06
6252,"Rasual Butler\butlera01","2003-04",24,"MIA","NBA",1.6,45,0,675,119,250,69,142,50,108,16,21,4,57,61,23,10,13,28,72,304,5.2
6253,"Jason Caffey\caffeja01","1999-00",26,"GSW","NBA",1.6,71,56,2159,323,675,323,673,0,2,206,345,189,293,482,119,62,20,170,269,852,11.34
6254,"Rodney Carney\carnero01","2007-08",23,"PHI","NBA",1.6,70,6,1039,158,392,120,272,38,120,55,81,50,99,149,32,39,23,34,96,409,4.64
6255,"Kelvin Cato\catoke01","1998-99",24,"POR","NBA",1.6,43,0,545,58,129,57,128,1,1,34,67,49,101,150,19,23,56,27,100,151,4.8
6256,"Daequan Cook\cookda02","2010-11",23,"OKC","NBA",1.6,43,0,598,79,181,14,27,65,154,16,20,8,64,72,20,14,1,17,51,239,4.65
6257,"Daequan Cook\cookda02","2011-12",24,"OKC","NBA",1.6,57,22,989,109,296,30,68,79,228,14,22,12,110,122,15,22,11,16,69,311,4.09
6258,"Quinn Cook\cookqu01","2017-18",24,"GSW","NBA",1.6,33,18,740,122,252,76,148,46,104,22,25,10,72,82,89,12,1,32,59,312,8.82
6259,"Dante Cunningham\cunnida01","2014-15",27,"NOP","NBA",1.6,66,27,1652,155,339,154,329,1,10,29,47,70,186,256,50,46,37,35,101,340,5.56
6260,"Michael Curry\currymi01","1995-96",27,"TOT","NBA",1.6,46,1,783,73,161,53,108,20,53,45,62,27,58,85,27,24,2,24,92,211,4.33
6261,"Glen Davis\davisgl01","2009-10",24,"BOS","NBA",1.6,54,1,933,122,279,122,275,0,4,96,138,101,104,205,35,21,14,53,132,340,5.81
6262,"Hubert Davis\davishu01","1998-99",28,"DAL","NBA",1.6,50,21,1378,174,397,109,253,65,144,44,50,3,83,86,89,21,3,57,76,457,7.32
6263,"Austin Daye\dayeau01","2012-13",24,"TOT","NBA",1.6,55,0,676,90,208,49,110,41,98,26,34,16,107,123,42,14,22,29,82,247,4.4
6264,"Andrew DeClercq\declean01","1996-97",23,"GSW","NBA",1.6,71,1,1065,142,273,142,273,0,0,91,151,122,176,298,32,33,27,76,229,375,5.78
6265,"Vinny Del Negro\delnevi01","2000-01",34,"TOT","NBA",1.6,65,1,922,106,234,105,221,1,13,41,44,12,70,82,126,26,3,34,78,254,4.32
6266,"Vinny Del Negro\delnevi01","1998-99",32,"MIL","NBA",1.6,48,7,1093,114,270,101,240,13,30,40,50,14,88,102,174,33,3,55,62,281,6.9
6267,"Tony Delk\delkto01","1996-97",23,"CHH","NBA",1.6,61,1,867,119,256,67,144,52,112,42,51,31,68,99,99,36,6,68,71,332,5.67
6268,"Chris Douglas-Roberts\douglch01","2010-11",24,"MIL","NBA",1.6,44,12,884,117,273,102,227,15,46,74,89,7,81,88,50,29,13,35,73,323,6.39
6269,"Goran Dragić\dragigo01","2018-19",32,"MIA","NBA",1.6,36,22,991,179,433,122,269,57,164,79,101,20,91,111,174,30,5,71,81,494,12.59
6270,"Predrag Drobnjak\drobnpr01","2001-02",26,"SEA","NBA",1.6,64,12,1174,191,414,191,412,0,2,55,73,75,144,219,51,20,31,51,109,437,5.96
6271,"Tony Dumas\dumasto01","1995-96",23,"DAL","NBA",1.6,67,12,1284,274,655,200,448,74,207,154,257,58,57,115,99,42,13,77,128,776,8.24
6272,"LeRon Ellis\ellisle02","1993-94",24,"CHH","NBA",1.6,50,1,680,88,182,88,182,0,0,45,68,70,118,188,24,17,25,21,83,221,4.92
6273,"Francisco Elson\elsonfr01","2004-05",28,"DEN","NBA",1.6,67,11,939,101,216,100,213,1,3,45,79,61,140,201,34,34,41,40,129,248,4.34
6274,"Jeremy Evans\evansje01","2010-11",23,"UTA","NBA",1.6,49,3,463,76,115,76,114,0,1,26,37,36,61,97,24,17,17,19,50,178,4.24
6275,"Tyreke Evans\evansty01","2010-11",21,"SAC","NBA",1.6,57,53,2107,382,933,339,785,43,148,205,266,46,229,275,319,85,30,184,143,1012,16.26
6276,"Vern Fleming\flemive01","1995-96",33,"NJN","NBA",1.6,77,3,1747,227,524,224,496,3,28,133,177,49,121,170,255,41,5,122,115,590,7.63
6277,"Jeff Foster\fosteje01","2002-03",26,"IND","NBA",1.6,77,2,802,64,178,64,176,0,2,34,63,118,161,279,51,28,21,34,103,162,3.14
6278,"Joel Freeland\freeljo01","2014-15",27,"POR","NBA",1.6,48,8,617,74,151,74,151,0,0,21,25,62,129,191,16,9,23,23,93,169,4.25
6279,"Lawrence Funderburke\fundela01","2001-02",31,"SAC","NBA",1.6,56,1,722,115,245,115,242,0,3,34,56,76,122,198,32,11,18,33,65,264,4.55
6280,"Kevin Gamble\gamblke01","1996-97",31,"SAC","NBA",1.6,62,2,953,123,286,69,174,54,112,7,10,13,94,107,77,21,17,27,76,307,4.59
6281,"Francisco García\garcifr01","2005-06",24,"SAC","NBA",1.6,67,11,1301,130,325,91,188,39,137,78,101,39,146,185,94,41,47,75,135,377,6.06
6282,"Gordan Giriček\giricgo01","2002-03",25,"TOT","NBA",1.6,76,62,2148,350,803,265,554,85,249,150,183,36,202,238,137,52,8,145,159,935,9.85
6283,"Stephen Graham\grahast01","2009-10",27,"CHA","NBA",1.6,70,8,804,119,240,103,190,16,50,42,65,24,111,135,23,20,10,36,94,296,3.76
6284,"Brian Grant\grantbr01","2004-05",32,"LAL","NBA",1.6,69,8,1136,103,209,103,209,0,0,57,79,101,156,257,34,23,23,43,175,263,4.56
6285,"Gary Grant\grantga01","1992-93",27,"LAC","NBA",1.6,74,8,1624,210,476,199,434,11,42,55,74,27,112,139,353,106,9,129,168,486,8.71
6286,"Gerald Green\greenge01","2006-07",21,"BOS","NBA",1.6,81,26,1780,310,739,215,481,95,258,128,159,68,140,208,83,41,24,120,198,843,7.86
6287,"Tom Gugliotta\guglito01","1992-93",23,"WSB","NBA",1.6,81,81,2795,484,1135,446,1000,38,135,181,281,219,562,781,306,134,35,230,195,1187,15.2
6288,"Jordan Hamilton\hamiljo02","2013-14",23,"TOT","NBA",1.6,60,12,1019,147,376,77,178,70,198,40,51,32,162,194,52,44,20,46,67,404,6.12
6289,"Al Harrington\harrial01","2004-05",24,"ATL","NBA",1.6,66,66,2550,453,986,437,912,16,74,236,351,145,316,461,208,85,16,204,249,1158,15.59
6290,"Devin Harris\harride01","2013-14",30,"DAL","NBA",1.6,40,0,818,96,254,65,153,31,101,92,115,8,77,85,178,28,2,59,72,315,8.86
6291,"Andrew Harrison\harrian01","2016-17",22,"MEM","NBA",1.6,72,18,1474,117,360,74,204,43,156,148,194,23,113,136,198,53,21,85,194,425,6.42
6292,"Chuck Hayes\hayesch01","2008-09",25,"HOU","NBA",1.6,71,1,858,42,113,42,109,0,4,7,19,74,176,250,42,34,19,25,134,91,2.83
6293,"Alan Henderson\hendeal01","2006-07",34,"PHI","NBA",1.6,38,5,418,43,67,43,67,0,0,33,47,48,59,107,10,9,12,12,62,119,3.97
6294,"Grant Hill\hillgr01","2011-12",39,"PHO","NBA",1.6,49,46,1378,201,451,187,398,14,53,83,109,29,142,171,107,41,29,65,88,499,9.34
6295,"Eddie House\houseed01","2005-06",27,"PHO","NBA",1.6,81,0,1421,320,759,197,443,123,316,33,41,15,117,132,148,42,12,76,96,796,7.36
6296,"Kris Humphries\humphkr01","2015-16",30,"TOT","NBA",1.6,53,17,835,121,295,87,187,34,108,67,84,57,161,218,36,16,23,38,94,343,6.09
6297,"Kris Humphries\humphkr01","2016-17",31,"ATL","NBA",1.6,56,4,689,87,214,68,160,19,54,64,82,60,146,206,29,15,21,28,69,257,4.77
6298,"Ersan İlyasova\ilyaser01","2013-14",26,"MIL","NBA",1.6,55,47,1478,237,579,200,448,37,131,107,130,107,235,342,72,46,8,61,135,618,9.77
6299,"Jaren Jackson\jacksja01","1996-97",29,"WSB","NBA",1.6,75,0,1133,134,329,81,171,53,158,53,69,31,101,132,65,45,16,60,131,374,4.61
6300,"Al Jefferson\jeffeal01","2017-18",33,"IND","NBA",1.6,36,1,484,111,208,111,205,0,3,30,36,30,113,143,30,16,23,21,66,252,7.19
6301,"Eddie Johnson\johnsed03","1995-96",36,"IND","NBA",1.6,62,1,1002,180,436,135,308,45,128,70,79,45,108,153,69,20,4,56,104,475,5.98
6302,"Charles Jones\jonesch01","1992-93",35,"WSB","NBA",1.6,67,21,1206,33,63,33,62,0,1,22,38,87,190,277,42,38,77,38,144,88,4.22
6303,"Fred Jones\jonesfr01","2008-09",29,"LAC","NBA",1.6,52,21,1495,129,317,75,170,54,147,66,81,23,103,126,188,53,11,66,112,378,8.55
6304,"Solomon Jones\jonesso01","2006-07",22,"ATL","NBA",1.6,58,8,666,65,128,65,127,0,1,59,75,49,87,136,11,11,42,25,124,189,3.82
6305,"Chris Kaman\kamanch01","2012-13",30,"DAL","NBA",1.6,66,52,1363,313,617,313,616,0,1,67,85,97,275,372,51,29,52,103,141,693,9.53
6306,"Steve Kerr\kerrst01","1998-99",33,"SAS","NBA",1.6,44,0,734,68,174,43,94,25,80,31,35,6,38,44,49,23,3,22,28,192,3.93
6307,"Joe Kleine\kleinjo01","1993-94",32,"PHO","NBA",1.6,74,4,848,125,256,120,245,5,11,30,39,50,143,193,45,14,19,35,118,285,3.89
6308,"Brevin Knight\knighbr01","2000-01",25,"TOT","NBA",1.6,53,43,1457,139,371,138,361,1,10,54,66,23,145,168,311,101,4,91,155,333,9.68
6309,"Rodions Kurucs\kurucro01","2018-19",20,"BRK","NBA",1.6,63,46,1294,202,449,144,265,58,184,72,92,56,190,246,52,41,25,77,146,534,7.71
6310,"Jeremy Lamb\lambje01","2014-15",22,"OKC","NBA",1.6,47,8,633,104,250,66,139,38,111,49,55,8,99,107,44,21,6,27,52,295,5.49
6311,"T.J. Leaf\leaftj01","2018-19",21,"IND","NBA",1.6,58,1,522,99,183,91,152,8,31,19,31,43,82,125,24,9,19,12,35,225,3.81
6312,"Grant Long\longgr01","1997-98",31,"DET","NBA",1.6,40,17,739,50,117,50,113,0,4,41,57,57,93,150,25,29,12,22,91,141,4.69
6313,"Vernon Maxwell\maxweve01","1998-99",33,"SAC","NBA",1.6,46,1,1007,164,421,84,190,80,231,84,114,13,72,85,76,30,3,67,111,492,8.05
6314,"Lee Mayberry\maybele01","1996-97",26,"VAN","NBA",1.6,80,38,1952,149,370,66,149,83,221,29,46,29,105,134,329,60,8,90,159,410,6.92
6315,"Lee Mayberry\maybele01","1994-95",24,"MIL","NBA",1.6,82,50,1744,172,408,100,231,72,177,58,83,21,61,82,276,51,4,106,123,474,6.43
6316,"Luc Mbah a Moute\mbahalu01","2015-16",29,"LAC","NBA",1.6,75,61,1274,94,207,81,167,13,40,30,57,60,111,171,30,44,19,34,100,231,3.46
6317,"Rashad McCants\mccanra01","2005-06",21,"MIN","NBA",1.6,79,12,1362,241,535,174,355,67,180,78,106,29,114,143,63,44,22,86,176,627,6.31
6318,"Tracy McGrady\mcgratr01","2011-12",32,"ATL","NBA",1.6,52,0,837,101,231,86,198,15,33,56,83,23,131,154,110,16,15,53,35,273,5.88
6319,"Derrick McKey\mckeyde01","2001-02",35,"PHI","NBA",1.6,41,1,784,52,122,47,110,5,12,10,14,48,79,127,45,41,4,22,90,119,4.36
6320,"Derrick McKey\mckeyde01","1999-00",33,"IND","NBA",1.6,32,0,634,43,108,33,85,10,23,43,56,29,106,135,35,29,13,19,81,139,6
6321,"Aaron McKie\mckieaa01","1998-99",26,"PHI","NBA",1.6,50,4,959,95,237,89,206,6,31,44,62,27,113,140,100,63,3,57,90,240,5.92
6322,"Khris Middleton\middlkh01","2016-17",25,"MIL","NBA",1.6,29,23,889,150,333,105,229,45,104,81,92,11,112,123,99,41,7,65,79,426,14.24
6323,"Darius Miller\milleda01","2018-19",28,"NOP","NBA",1.6,69,15,1757,189,484,56,120,133,364,56,71,14,114,128,146,40,23,59,165,567,7.35
6324,"Mike Miller\millemi01","2010-11",30,"MIA","NBA",1.6,41,2,838,81,202,38,84,43,118,23,34,38,146,184,51,20,2,41,88,228,5.98
6325,"Oliver Miller\milleol01","1992-93",22,"PHO","NBA",1.6,56,1,1069,121,255,121,252,0,3,71,100,70,205,275,118,38,100,108,145,313,8.43
6326,"Chris Morris\morrich01","1998-99",33,"PHO","NBA",1.6,44,2,535,64,149,48,93,16,56,40,46,54,67,121,23,16,11,21,54,184,4.34
6327,"Markieff Morris\morrima02","2018-19",29,"TOT","NBA",1.6,58,16,1270,204,484,136,281,68,203,71,92,61,204,265,79,36,22,54,175,547,8.52
6328,"Mike Muscala\muscami01","2015-16",24,"ATL","NBA",1.6,60,0,565,76,152,64,113,12,39,31,39,38,79,117,34,13,27,27,72,195,3.64
6329,"Eduardo Nájera\najered01","2004-05",28,"TOT","NBA",1.6,68,4,1185,145,322,139,301,6,21,58,91,102,141,243,65,41,24,61,148,354,5.5
6330,"Andrew Nicholson\nichoan01","2015-16",26,"ORL","NBA",1.6,56,0,823,146,310,105,196,41,114,51,65,34,167,201,25,10,22,41,69,384,6.13
6331,"Lucas Nogueira\noguelu01","2017-18",25,"TOR","NBA",1.6,49,3,418,49,80,44,61,5,19,19,28,18,69,87,22,23,43,16,49,122,3.78
6332,"Jusuf Nurkić\nurkiju01","2014-15",20,"DEN","NBA",1.6,62,27,1103,171,383,171,381,0,2,84,132,125,257,382,50,52,68,86,207,426,7.98
6333,"Kyle O'Quinn\oquinky01","2014-15",24,"ORL","NBA",1.6,51,17,824,119,242,107,199,12,43,44,57,46,153,199,59,31,39,55,110,294,6.79
6334,"Kyle O'Quinn\oquinky01","2015-16",25,"NYK","NBA",1.6,65,1,764,129,271,124,249,5,22,46,60,76,174,250,72,20,49,61,107,309,5.69
6335,"Hakeem Olajuwon\olajuha01","1999-00",37,"HOU","NBA",1.6,44,28,1049,193,421,193,419,0,2,69,112,65,209,274,61,41,70,73,88,455,10.51
6336,"Michael Olowokandi\olowomi01","2001-02",26,"LAC","NBA",1.6,80,79,2568,384,886,384,886,0,0,117,188,164,547,711,90,55,145,175,217,885,11.17
6337,"Patrick Patterson\pattepa01","2011-12",22,"HOU","NBA",1.6,64,1,1483,225,511,225,508,0,3,40,57,112,174,286,53,27,36,49,113,490,6.55
6338,"Mike Penberthy\penbemi01","2000-01",26,"LAL","NBA",1.6,53,0,851,92,222,37,83,55,139,28,31,10,53,63,71,22,2,34,57,267,4.63
6339,"Wesley Person\persowe01","2004-05",33,"TOT","NBA",1.6,41,3,667,107,226,66,137,41,89,9,13,3,80,83,39,19,4,17,30,264,5.59
6340,"Ed Pinckney\pincked01","1994-95",31,"MIL","NBA",1.6,62,17,835,48,97,48,97,0,0,44,62,65,146,211,21,34,17,26,64,140,3.7
6341,"Jakob Pöltl\poeltja01","2016-17",21,"TOR","NBA",1.6,54,4,626,67,115,67,115,0,0,31,57,78,87,165,12,17,20,29,113,165,3.82
6342,"Bobby Portis\portibo01","2018-19",23,"TOT","NBA",1.6,50,28,1299,279,628,204,437,75,191,77,97,109,294,403,72,35,20,74,145,710,12.69
6343,"Norman Powell\powelno01","2015-16",22,"TOR","NBA",1.6,49,24,725,97,229,61,140,36,89,43,53,16,95,111,47,29,10,32,59,273,5.32
6344,"Brent Price\pricebr01","1997-98",29,"HOU","NBA",1.6,72,2,1332,128,310,55,123,73,187,77,98,37,70,107,192,52,4,111,163,406,6.44
6345,"Vladimir Radmanović\radmavl01","2011-12",31,"ATL","NBA",1.6,49,3,755,74,197,24,62,50,135,22,29,34,109,143,54,21,15,35,62,220,4.8
6346,"Julius Randle\randlju01","2015-16",21,"LAL","NBA",1.6,81,60,2286,358,835,348,799,10,36,193,270,172,657,829,144,53,29,149,242,919,11.76
6347,"Anthony Randolph\randoan01","2008-09",19,"GSW","NBA",1.6,63,22,1129,199,431,199,427,0,4,101,141,128,235,363,49,42,74,80,141,499,8.48
6348,"Mitch Richmond\richmmi01","2000-01",35,"WAS","NBA",1.6,37,30,1216,205,504,160,371,45,133,143,160,15,94,109,111,43,7,84,86,598,13.23
6349,"Isaiah Rider\rideris01","1999-00",28,"ATL","NBA",1.6,60,47,2084,449,1072,393,892,56,180,204,260,63,195,258,219,41,6,168,132,1158,14.44
6350,"Glenn Robinson\robingl01","2003-04",31,"PHI","NBA",1.6,42,42,1336,275,614,241,514,34,100,114,137,46,143,189,57,42,9,106,96,698,12.69
6351,"Thomas Robinson\robinth01","2013-14",22,"POR","NBA",1.6,70,0,873,141,293,141,292,0,1,57,101,105,202,307,34,23,20,57,131,339,5.09
6352,"Rajon Rondo\rondora01","2014-15",28,"TOT","NBA",1.6,68,68,2018,275,645,248,559,27,86,31,78,73,300,373,538,91,7,210,153,608,12.79
6353,"Quinton Ross\rossqu01","2005-06",24,"LAC","NBA",1.6,67,45,1515,130,308,130,301,0,7,57,75,38,132,170,79,51,16,47,155,317,4.95
6354,"Clifford Rozier\roziecl01","1996-97",24,"TOT","NBA",1.6,42,29,737,79,174,79,172,0,2,31,61,102,132,234,31,24,44,29,97,189,6.12
6355,"John Salmons\salmojo01","2012-13",33,"SAC","NBA",1.6,76,72,2278,244,612,145,345,99,267,85,110,33,174,207,226,51,25,85,143,672,8.43
6356,"Larry Sanders\sandela01","2014-15",26,"MIL","NBA",1.6,27,26,586,86,172,86,172,0,0,24,48,67,99,166,23,26,39,28,104,196,8.75
6357,"Mike Scott\scottmi01","2018-19",30,"TOT","NBA",1.6,79,3,1395,168,420,67,168,101,252,22,33,43,233,276,66,26,13,44,156,459,5.31
6358,"Pascal Siakam\siakapa01","2016-17",22,"TOR","NBA",1.6,55,38,859,103,205,102,198,1,7,22,32,64,121,185,17,26,45,33,109,229,4.84
6359,"Jason Smith\smithja02","2010-11",24,"NOH","NBA",1.6,77,6,1102,136,307,136,305,0,2,59,70,89,152,241,36,26,32,53,150,331,4.36
6360,"Tony Snell\snellto01","2013-14",22,"CHI","NBA",1.6,77,12,1231,129,336,72,158,57,178,31,41,19,105,124,68,29,15,44,84,346,3.83
6361,"Larry Stewart\stewala01","1996-97",28,"SEA","NBA",1.6,70,21,982,112,252,103,215,9,37,67,93,75,96,171,52,31,23,63,108,300,4.43
6362,"Bryant Stith\stithbr01","1992-93",22,"DEN","NBA",1.6,39,12,865,124,278,124,274,0,4,99,119,39,85,124,49,24,5,44,82,347,7.83
6363,"Bryant Stith\stithbr01","1999-00",29,"DEN","NBA",1.6,45,6,691,86,189,69,133,17,56,64,77,23,61,84,61,18,12,33,56,253,5.61
6364,"Peja Stojaković\stojape01","2010-11",33,"TOT","NBA",1.6,33,13,617,100,227,43,91,57,136,23,25,14,61,75,29,13,2,17,24,280,6.82
6365,"Damon Stoudamire\stoudda01","2002-03",29,"POR","NBA",1.6,59,27,1315,156,415,112,301,44,114,53,67,40,115,155,204,39,6,82,67,409,7.17
6366,"Derek Strong\stronde01","1998-99",30,"ORL","NBA",1.6,44,0,695,76,180,76,178,0,2,71,99,66,95,161,17,15,7,37,64,223,4.83
6367,"Bob Sura\surabo01","1995-96",22,"CLE","NBA",1.6,79,3,1150,148,360,121,282,27,78,99,141,34,101,135,233,56,21,115,126,422,6.33
6368,"Wally Szczerbiak\szczewa02","2003-04",26,"MIN","NBA",1.6,28,0,622,106,236,86,190,20,46,53,64,24,64,88,33,12,1,28,42,285,8.17
6369,"Wally Szczerbiak\szczewa02","2006-07",29,"BOS","NBA",1.6,32,19,900,161,388,117,282,44,106,113,126,16,82,98,55,18,3,54,65,479,11.39
6370,"Etan Thomas\thomaet01","2001-02",23,"WAS","NBA",1.6,47,0,618,81,151,81,151,0,0,41,74,55,126,181,6,17,35,26,76,203,4.99
6371,"Etan Thomas\thomaet01","2004-05",26,"WAS","NBA",1.6,47,10,976,128,255,128,255,0,0,76,144,85,159,244,20,17,51,50,133,332,7.27
6372,"Jason Thompson\thompja02","2015-16",29,"TOT","NBA",1.6,47,7,471,52,108,47,93,5,15,38,54,32,102,134,29,12,20,15,80,147,3.95
6373,"Al Thornton\thornal01","2010-11",27,"TOT","NBA",1.6,71,23,1383,205,431,201,405,4,26,110,142,56,157,213,62,35,12,64,143,524,6.53
6374,"Ekpe Udoh\udohek01","2018-19",31,"UTA","NBA",1.6,51,1,320,50,72,50,72,0,0,19,30,27,63,90,28,10,31,13,36,119,3.36
6375,"Nick Van Exel\vanexni01","2004-05",33,"POR","NBA",1.6,53,34,1619,214,561,114,304,100,257,58,74,20,141,161,227,44,0,92,70,586,10.18
6376,"Jacque Vaughn\vaughja01","2007-08",32,"SAS","NBA",1.6,74,9,1139,121,283,118,273,3,10,61,80,13,61,74,159,23,1,54,97,306,4.23
6377,"Jan Veselý\veselja01","2013-14",23,"TOT","NBA",1.6,54,1,776,89,173,89,173,0,0,19,56,81,110,191,21,53,35,36,121,197,4.91
6378,"Charlie Villanueva\villach01","2012-13",28,"DET","NBA",1.6,69,0,1092,175,464,85,205,90,259,27,49,49,192,241,54,31,39,39,96,467,5.74
6379,"Noah Vonleh\vonleno01","2017-18",22,"TOT","NBA",1.6,54,16,875,104,234,84,168,20,66,36,58,70,241,311,34,19,17,31,68,264,5.78
6380,"Dion Waiters\waitedi01","2016-17",25,"MIA","NBA",1.6,46,43,1384,281,663,196,448,85,215,82,127,18,135,153,200,42,20,103,95,729,13.4
6381,"Dion Waiters\waitedi01","2013-14",22,"CLE","NBA",1.6,70,24,2072,430,993,338,743,92,250,161,235,32,163,195,209,63,17,154,153,1113,12.28
6382,"John Wallace\wallajo01","1996-97",22,"NYK","NBA",1.6,68,6,787,122,236,120,232,2,4,79,110,51,104,155,37,21,25,76,102,325,4.74
6383,"Rex Walters\waltere01","1996-97",26,"PHI","NBA",1.6,59,16,1041,148,325,91,177,57,148,49,62,21,86,107,113,28,3,61,75,402,6.45
6384,"Rex Walters\waltere01","1994-95",24,"NJN","NBA",1.6,80,30,1435,206,469,135,273,71,196,40,52,18,75,93,121,37,16,71,135,523,5.53
6385,"Luke Walton\waltolu01","2003-04",23,"LAL","NBA",1.6,72,2,730,65,153,52,114,13,39,31,44,39,88,127,113,28,8,44,70,174,3.49
6386,"Mark West\westma01","1996-97",36,"CLE","NBA",1.6,70,43,959,100,180,100,180,0,0,27,56,69,117,186,19,11,55,52,142,227,3.81
6387,"Aaron Williams\williaa01","2005-06",34,"TOT","NBA",1.6,48,5,791,91,176,91,176,0,0,40,58,64,117,181,17,17,21,30,138,222,5.08
6388,"Eric Williams\willier01","1995-96",23,"BOS","NBA",1.6,64,6,1470,241,546,238,536,3,10,200,298,92,125,217,70,56,11,88,147,685,8.74
6389,"Herb Williams\willihe01","1993-94",35,"NYK","NBA",1.6,70,3,774,103,233,103,232,0,1,27,42,56,126,182,28,18,43,39,108,233,3.51
6390,"Walt Williams\williwa02","1992-93",22,"SAC","NBA",1.6,59,26,1673,358,823,297,632,61,191,224,302,115,150,265,178,66,29,179,209,1001,14.47
6391,"Kevin Willis\willike02","2002-03",40,"SAS","NBA",1.6,71,6,840,123,257,123,255,0,2,51,83,83,143,226,24,20,20,60,120,297,4.15
6392,"Haywoode Workman\workmha01","1998-99",33,"MIL","NBA",1.6,29,29,815,73,170,56,123,17,47,37,47,14,88,102,172,32,1,63,53,200,10.35
6393,"Brandan Wright\wrighbr03","2016-17",29,"MEM","NBA",1.6,28,5,447,83,135,83,134,0,1,23,35,31,47,78,15,11,20,10,42,189,6.77
6394,"Dorell Wright\wrighdo01","2014-15",29,"POR","NBA",1.6,48,2,592,72,190,31,82,41,108,34,42,14,97,111,41,20,11,18,55,219,4.42
6395,"Quincy Acy\acyqu01","2013-14",23,"TOT","NBA",1.5,63,0,847,66,141,62,126,4,15,35,53,72,144,216,28,23,26,30,122,171,3.79
6396,"Rafael Addison\addisra01","1994-95",30,"DET","NBA",1.5,79,16,1776,279,586,255,503,24,83,74,99,67,175,242,109,53,25,76,236,656,7.48
6397,"Lavoy Allen\allenla01","2013-14",24,"TOT","NBA",1.5,65,2,1072,134,300,132,287,2,13,33,50,119,192,311,71,24,33,44,126,303,5.55
6398,"Greg Anderson\andergr01","1994-95",30,"ATL","NBA",1.5,51,0,622,57,104,57,104,0,0,34,71,62,126,188,17,23,32,32,103,148,4.23
6399,"Kenny Anderson\anderke01","2003-04",33,"IND","NBA",1.5,44,31,905,113,256,112,252,1,4,35,48,19,62,81,125,26,5,50,73,262,6.19
6400,"Pero Antić\anticpe01","2014-15",32,"ATL","NBA",1.5,63,3,1037,108,296,56,123,52,173,88,123,58,131,189,49,18,14,49,132,356,5.01
6401,"Hilton Armstrong\armsthi01","2008-09",24,"NOH","NBA",1.5,70,29,1092,138,246,138,244,0,2,62,98,81,114,195,29,26,45,80,181,338,5.18
6402,"Vincent Askew\askewvi01","1996-97",30,"TOT","NBA",1.5,43,0,838,81,186,74,162,7,24,70,88,25,73,98,90,17,6,46,123,239,5.99
6403,"Chucky Atkins\atkinch01","2002-03",28,"DET","NBA",1.5,65,7,1398,168,465,82,223,86,242,40,49,21,75,96,175,27,4,77,108,462,6.01
6404,"Stacey Augmon\augmost01","1996-97",28,"TOT","NBA",1.5,60,10,942,105,220,105,220,0,0,69,97,47,91,138,56,42,17,64,87,279,5.07
6405,"Stacey Augmon\augmost01","1999-00",31,"POR","NBA",1.5,59,0,692,83,175,83,173,0,2,37,55,42,74,116,53,27,11,38,69,203,3.81
6406,"Anthony Avent\aventan01","1994-95",25,"ORL","NBA",1.5,71,3,1066,105,244,105,244,0,0,48,75,97,196,293,41,28,50,53,170,258,4.61
6407,"Leandro Barbosa\barbole01","2010-11",28,"TOR","NBA",1.5,58,0,1395,294,653,222,440,72,213,109,137,14,85,99,119,50,6,84,112,769,10.27
6408,"Andrea Bargnani\bargnan01","2013-14",28,"NYK","NBA",1.5,42,39,1257,222,502,192,394,30,108,84,102,69,153,222,45,14,52,58,100,558,10.93
6409,"Brent Barry\barrybr01","2008-09",37,"HOU","NBA",1.5,56,1,857,70,172,21,41,49,131,19,20,17,77,94,78,24,3,48,45,208,4.17
6410,"Lonny Baxter\baxtelo01","2003-04",25,"TOT","NBA",1.5,62,5,766,103,209,102,206,1,3,44,76,64,123,187,20,17,29,38,123,251,4.18
6411,"Mario Bennett\bennema01","1997-98",24,"LAL","NBA",1.5,45,4,354,80,135,79,133,1,2,16,44,60,66,126,18,19,11,21,61,177,4.29
6412,"Nemanja Bjelica\bjeline01","2016-17",28,"MIN","NBA",1.5,65,1,1190,151,356,95,179,56,177,45,61,57,187,244,79,40,20,59,154,403,6.38
6413,"Tarik Black\blackta01","2017-18",26,"HOU","NBA",1.5,51,2,536,75,127,74,116,1,11,29,63,63,100,163,13,21,30,35,107,180,4.39
6414,"Ryan Bowen\bowenry01","2007-08",32,"NOH","NBA",1.5,53,4,660,49,100,49,99,0,1,16,29,55,45,100,25,32,11,15,77,114,2.94
6415,"Michael Bradley\bradlmi01","2002-03",23,"TOR","NBA",1.5,67,11,1314,151,314,150,308,1,6,35,67,162,247,409,67,16,32,76,125,338,6.19
6416,"Bruce Brown\brownbr01","2018-19",22,"DET","NBA",1.5,74,56,1449,125,314,101,221,24,93,45,60,48,137,185,91,40,36,46,178,319,4.68
6417,"Jaylen Brown\brownja02","2016-17",20,"BOS","NBA",1.5,78,20,1341,192,423,146,288,46,135,85,124,45,175,220,64,35,18,68,142,515,5.9
6418,"Mike Brown\brownmi01","1992-93",29,"UTA","NBA",1.5,82,21,1551,176,409,176,408,0,1,113,164,147,244,391,64,32,23,95,190,465,5.83
6419,"Mike Brown\brownmi01","1993-94",30,"MIN","NBA",1.5,82,40,1921,111,260,111,258,0,2,77,118,119,328,447,72,51,29,75,218,299,5.43
6420,"Randy Brown\brownra02","1995-96",27,"CHI","NBA",1.5,68,0,671,78,192,77,181,1,11,28,46,17,49,66,73,57,12,31,88,185,3.2
6421,"Mark Bryant\bryanma01","1998-99",33,"CHI","NBA",1.5,45,29,1204,168,348,168,347,0,1,71,110,92,140,232,48,34,16,68,149,407,8.59
6422,"Jud Buechler\buechju01","1994-95",26,"CHI","NBA",1.5,57,0,605,90,183,75,135,15,48,22,39,36,62,98,50,24,12,30,64,217,3.94
6423,"Jud Buechler\buechju01","2000-01",32,"DET","NBA",1.5,57,3,737,76,164,44,87,32,77,9,12,20,74,94,39,21,10,25,83,193,3.51
6424,"Alec Burks\burksal01","2015-16",24,"UTA","NBA",1.5,31,3,797,137,334,105,255,32,79,106,141,16,93,109,63,18,4,51,71,412,10.56
6425,"Alec Burks\burksal01","2011-12",20,"UTA","NBA",1.5,59,0,939,153,357,138,312,15,45,104,143,57,75,132,55,27,5,51,84,425,5.81
6426,"Alec Burks\burksal01","2018-19",27,"TOT","NBA",1.5,64,24,1375,192,474,131,306,61,168,116,141,30,205,235,128,39,21,65,91,561,8.33
6427,"Will Bynum\bynumwi01","2010-11",28,"DET","NBA",1.5,61,5,1125,182,406,166,356,16,50,102,122,15,59,74,195,52,4,83,113,482,7.93
6428,"Bruno Caboclo\cabocbr01","2018-19",23,"MEM","NBA",1.5,34,19,800,96,225,48,95,48,130,42,50,42,116,158,50,14,33,38,81,282,8.68
6429,"Nick Calathes\calatni01","2013-14",24,"MEM","NBA",1.5,71,7,1173,142,311,123,250,19,61,44,72,23,114,137,207,66,8,101,117,347,6.28
6430,"Marcus Camby\cambyma01","2002-03",28,"DEN","NBA",1.5,29,9,616,93,227,91,222,2,5,33,50,75,133,208,47,20,40,27,69,221,8.85
6431,"Tony Campbell\campbto01","1993-94",31,"TOT","NBA",1.5,63,14,1214,227,512,220,484,7,28,94,120,76,110,186,82,50,15,84,134,555,7.45
6432,"Rodney Carney\carnero01","2008-09",24,"MIN","NBA",1.5,67,6,1199,176,423,97,197,79,226,50,66,36,90,126,26,45,29,43,94,481,5.71
6433,"Rodney Carney\carnero01","2009-10",25,"PHI","NBA",1.5,68,0,857,113,282,72,147,41,135,52,63,26,111,137,37,25,20,21,79,319,4.15
6434,"Antoine Carr\carran01","1997-98",36,"UTA","NBA",1.5,66,8,1086,151,325,151,325,0,0,76,98,42,89,131,48,11,53,48,195,378,5.09
6435,"Wilson Chandler\chandwi01","2018-19",31,"TOT","NBA",1.5,51,33,1177,114,273,55,115,59,158,18,25,48,167,215,82,25,21,46,123,305,6.66
6436,"Pete Chilcutt\chilcpe01","1993-94",25,"TOT","NBA",1.5,76,24,1365,203,448,200,433,3,15,41,65,129,242,371,86,53,39,74,164,450,6.54
6437,"Jae Crowder\crowdja01","2012-13",22,"DAL","NBA",1.5,78,16,1353,141,367,78,175,63,192,47,73,35,152,187,94,63,17,49,128,392,5.08
6438,"Erick Dampier\dampier01","1998-99",23,"GSW","NBA",1.5,50,50,1414,161,414,161,414,0,0,120,204,164,218,382,54,26,58,92,165,442,8.8
6439,"Antonio Daniels\daniean01","2008-09",33,"TOT","NBA",1.5,74,9,1021,99,236,77,176,22,60,80,100,5,72,77,177,26,1,62,55,300,4.7
6440,"Sasha Danilović\danilsa01","1995-96",25,"MIA","NBA",1.5,19,18,542,83,184,49,106,34,78,55,72,12,34,46,47,15,3,37,49,255,11.63
6441,"Vinny Del Negro\delnevi01","1999-00",33,"MIL","NBA",1.5,67,0,1211,153,325,145,301,8,24,35,39,9,98,107,160,36,0,48,81,349,5.55
6442,"Dan Dickau\dickada01","2007-08",29,"LAC","NBA",1.5,67,8,1040,124,296,88,188,36,108,68,82,13,84,97,172,32,3,55,108,352,5.7
6443,"Ike Diogu\dioguik01","2006-07",23,"TOT","NBA",1.5,59,2,760,127,266,127,266,0,0,112,140,75,128,203,25,8,26,67,122,366,5.84
6444,"Michael Doleac\doleami01","2000-01",23,"ORL","NBA",1.5,77,21,1398,220,527,220,524,0,3,50,59,70,203,273,65,37,41,59,239,490,5.53
6445,"Keyon Dooling\doolike01","2004-05",24,"MIA","NBA",1.5,74,0,1184,139,345,120,270,19,75,85,109,11,79,90,132,39,11,65,120,382,4.89
6446,"Damyean Dotson\dotsoda01","2018-19",24,"NYK","NBA",1.5,73,40,2004,290,698,164,356,126,342,73,98,34,228,262,135,58,10,71,135,779,9.05
6447,"Chris Dudley\dudlech02","1997-98",32,"NYK","NBA",1.5,51,22,858,58,143,58,143,0,0,41,92,108,167,275,21,13,51,44,139,157,4.57
6448,"Chris Dudley\dudlech02","1998-99",33,"NYK","NBA",1.5,46,16,685,48,109,48,109,0,0,19,40,79,114,193,7,13,38,24,116,115,3.72
6449,"Mike Dunleavy\dunlemi02","2002-03",22,"GSW","NBA",1.5,82,3,1305,168,417,116,267,52,150,78,100,66,148,214,106,53,19,86,120,466,5.59
6450,"Mike Dunleavy\dunlemi02","2016-17",36,"TOT","NBA",1.5,53,2,841,93,220,40,86,53,134,36,45,18,97,115,50,15,7,28,67,275,4.82
6451,"Tyus Edney\edneyty01","1996-97",23,"SAC","NBA",1.5,70,20,1376,150,391,142,349,8,42,177,215,34,79,113,226,60,2,112,98,485,7.44
6452,"Sean Elliott\elliose01","1996-97",28,"SAS","NBA",1.5,39,39,1393,196,464,154,338,42,126,148,196,48,142,190,124,24,24,89,105,582,13.33
6453,"Brian Evans\evansbr01","1997-98",24,"TOT","NBA",1.5,72,1,893,123,312,94,225,29,87,46,57,49,88,137,55,29,13,38,101,321,3.87
6454,"Reggie Evans\evansre01","2013-14",33,"TOT","NBA",1.5,54,20,899,71,150,71,150,0,0,72,130,115,219,334,21,37,3,58,119,214,5.59
6455,"Festus Ezeli\ezelife01","2012-13",23,"GSW","NBA",1.5,78,41,1120,74,169,74,169,0,0,43,81,141,172,313,22,23,74,63,157,191,3.88
6456,"Richie Frahm\frahmri01","2003-04",26,"SEA","NBA",1.5,54,0,469,63,139,29,47,34,92,23,26,12,44,56,24,16,4,7,50,183,3.11
6457,"Channing Frye\fryech01","2017-18",34,"TOT","NBA",1.5,53,1,695,104,212,65,97,39,115,17,19,12,123,135,38,18,13,21,69,264,4.98
6458,"Mickaël Gelabale\gelabmi01","2012-13",29,"MIN","NBA",1.5,36,13,644,72,139,56,87,16,52,21,24,32,67,99,26,16,4,16,47,181,5.22
6459,"Armen Gilliam\gilliar01","1998-99",34,"MIL","NBA",1.5,34,5,668,101,223,101,222,0,1,79,101,33,93,126,19,22,12,36,48,281,7.37
6460,"Anthony Goldwire\goldwan01","2004-05",33,"TOT","NBA",1.5,33,2,537,57,136,25,56,32,80,26,31,10,49,59,78,15,0,15,32,172,5.78
6461,"Jeff Grayer\grayeje01","1992-93",27,"GSW","NBA",1.5,48,12,1025,165,353,163,339,2,14,91,136,71,86,157,70,31,8,54,120,423,7.76
6462,"Donté Greene\greendo01","2009-10",21,"SAC","NBA",1.5,76,50,1630,244,553,175,370,69,183,90,140,53,181,234,71,41,53,93,150,647,7.35
6463,"Eddie Griffin\griffed01","2005-06",23,"MIN","NBA",1.5,70,27,1359,130,370,114,288,16,82,44,74,107,282,389,40,13,148,43,125,320,5.73
6464,"Justin Hamilton\hamilju01","2014-15",24,"TOT","NBA",1.5,41,14,712,85,178,75,147,10,31,39,47,57,77,134,36,27,30,26,70,219,6.15
6465,"Devin Harris\harride01","2018-19",35,"DAL","NBA",1.5,68,2,1071,132,347,70,147,62,200,102,134,12,100,112,122,35,16,56,133,428,5.9
6466,"David Harrison\harrida01","2005-06",23,"IND","NBA",1.5,67,17,1034,148,294,148,294,0,0,89,174,84,170,254,14,23,59,79,193,385,5.67
6467,"Jason Hart\hartja01","2006-07",28,"TOT","NBA",1.5,36,22,846,100,224,93,195,7,29,42,47,14,84,98,103,44,1,38,83,249,7.95
6468,"Trenton Hassell\hassetr01","2001-02",22,"CHI","NBA",1.5,78,47,2237,267,628,207,463,60,165,87,114,65,190,255,172,55,44,101,184,681,8.28
6469,"Chuck Hayes\hayesch01","2012-13",29,"SAC","NBA",1.5,74,1,1209,84,190,84,189,0,1,30,48,113,186,299,112,31,18,44,114,198,4.5
6470,"Jarvis Hayes\hayesja01","2006-07",25,"WAS","NBA",1.5,81,17,1626,224,546,158,363,66,183,71,84,42,168,210,80,48,13,56,160,585,5.98
6471,"J.J. Hickson\hicksjj01","2008-09",20,"CLE","NBA",1.5,62,0,705,100,194,100,194,0,0,45,67,52,113,165,9,14,30,45,81,245,4
6472,"J.J. Hickson\hicksjj01","2010-11",22,"CLE","NBA",1.5,80,66,2256,429,936,429,931,0,5,247,367,217,478,695,91,48,54,173,215,1105,12.51
6473,"Jrue Holiday\holidjr01","2013-14",23,"NOP","NBA",1.5,34,34,1143,203,454,173,377,30,77,51,63,28,114,142,268,56,12,105,92,487,16.31
6474,"Richaun Holmes\holmeri01","2015-16",22,"PHI","NBA",1.5,51,1,702,114,222,106,178,8,44,51,74,62,73,135,33,19,40,32,92,287,5.73
6475,"Kevin Huerter\huertke01","2018-19",20,"ATL","NBA",1.5,75,59,2048,275,657,139,304,136,353,41,56,60,185,245,214,65,25,109,155,727,9.35
6476,"Kris Humphries\humphkr01","2006-07",21,"TOR","NBA",1.5,60,2,670,87,185,87,185,0,0,53,79,78,109,187,18,14,21,32,98,227,3.97
6477,"Mike Iuzzolino\iuzzomi01","1992-93",25,"DAL","NBA",1.5,70,23,1769,221,478,167,334,54,144,114,149,31,109,140,328,49,6,129,101,610,9.84
6478,"Marko Jarić\jaricma01","2003-04",25,"LAC","NBA",1.5,58,50,1760,185,477,134,327,51,150,74,101,44,131,175,281,93,20,115,132,495,10.31
6479,"Marko Jarić\jaricma01","2006-07",28,"MIN","NBA",1.5,70,13,1555,136,325,104,240,32,85,67,88,54,130,184,145,75,16,88,172,371,6.44
6480,"Brandon Jennings\jennibr01","2015-16",26,"TOT","NBA",1.5,48,7,868,112,304,61,149,51,155,57,78,16,80,96,170,29,7,57,57,332,7.23
6481,"Frank Johnson\johnsfr01","1992-93",34,"PHO","NBA",1.5,77,0,1122,136,312,135,300,1,12,59,76,41,72,113,186,60,8,80,112,332,5.22
6482,"James Johnson\johnsja01","2018-19",31,"MIA","NBA",1.5,55,33,1164,164,379,114,230,50,149,50,70,22,154,176,135,35,27,74,114,428,7.98
6483,"Orlando Johnson\johnsor01","2012-13",23,"IND","NBA",1.5,51,0,619,72,180,36,86,36,94,23,32,20,90,110,47,11,9,29,51,203,3.85
6484,"Charles Jones\jonesch01","1993-94",36,"DET","NBA",1.5,42,0,877,36,78,36,77,0,1,19,34,89,146,235,29,14,43,12,136,91,4.84
6485,"Damian Jones\jonesda03","2018-19",23,"GSW","NBA",1.5,24,22,410,53,74,53,74,0,0,24,37,31,44,75,28,12,25,16,63,130,7.22
6486,"Damon Jones\jonesda01","2002-03",26,"SAC","NBA",1.5,49,1,709,80,210,36,89,44,121,20,27,11,59,70,80,18,4,23,42,224,4.31
6487,"James Jones\jonesja02","2014-15",34,"CLE","NBA",1.5,57,2,669,74,201,11,26,63,175,39,46,9,53,62,24,13,8,13,67,250,3.44
6488,"Perry Jones\jonespe01","2013-14",22,"OKC","NBA",1.5,62,7,764,83,181,61,120,22,61,28,42,28,86,114,26,14,19,21,62,216,3.35
6489,"Terrence Jones\joneste01","2015-16",24,"HOU","NBA",1.5,50,11,1044,166,367,141,288,25,79,77,116,62,149,211,41,23,39,49,86,434,7.83
6490,"Tyus Jones\jonesty01","2016-17",20,"MIN","NBA",1.5,60,0,774,75,181,49,108,26,73,33,43,10,57,67,156,48,5,38,50,209,4.93
6491,"DeAndre Jordan\jordade01","2009-10",21,"LAC","NBA",1.5,70,12,1137,144,238,144,236,0,2,48,128,122,230,352,21,16,62,75,152,336,5.86
6492,"Steve Kerr\kerrst01","2000-01",35,"SAS","NBA",1.5,55,1,650,67,159,34,82,33,77,14,15,6,29,35,57,16,1,21,30,181,3.03
6493,"Joe Kleine\kleinjo01","1992-93",31,"BOS","NBA",1.5,78,3,1129,108,267,108,261,0,6,41,58,113,233,346,39,17,17,37,123,257,3.86
6494,"Linas Kleiza\kleizli01","2011-12",27,"TOR","NBA",1.5,49,3,1057,165,410,103,231,62,179,81,100,42,157,199,46,23,4,64,119,473,7.8
6495,"Toni Kukoč\kukocto01","2004-05",36,"MIL","NBA",1.5,53,6,1099,105,256,63,140,42,116,44,61,31,129,160,160,39,13,64,70,296,7.1
6496,"Joffrey Lauvergne\lauvejo01","2016-17",25,"TOT","NBA",1.5,70,1,980,148,336,115,238,33,98,46,73,72,179,251,70,25,6,56,83,375,5.24
6497,"Randy Livingston\livinra01","1999-00",24,"PHO","NBA",1.5,79,15,1081,155,373,136,318,19,55,52,62,25,105,130,170,49,13,92,129,381,5.15
6498,"Brad Lohaus\lohaubr01","1994-95",30,"MIA","NBA",1.5,61,1,730,97,231,34,76,63,155,10,15,28,74,102,43,20,25,29,85,267,4.11
6499,"Robin Lopez\lopezro01","2010-11",22,"PHO","NBA",1.5,67,56,991,179,357,179,357,0,0,74,100,82,134,216,8,18,45,48,143,432,5.74
6500,"George Lynch\lynchge01","1996-97",26,"VAN","NBA",1.5,41,27,1059,137,291,129,260,8,31,60,97,98,163,261,76,63,17,64,97,342,10.02
6501,"Don MacLean\macledo01","1995-96",26,"DEN","NBA",1.5,56,5,1107,233,547,219,498,14,49,145,198,62,143,205,89,21,5,68,105,625,8.62
6502,"Thon Maker\makerth01","2017-18",20,"MIL","NBA",1.5,74,12,1238,130,316,99,212,31,104,65,93,75,150,225,46,38,53,44,162,356,5.04
6503,"Matt Maloney\malonma01","2000-01",29,"ATL","NBA",1.5,55,27,1403,146,348,95,206,51,142,26,34,14,103,117,154,56,5,70,94,369,7.18
6504,"Boban Marjanović\marjabo01","2017-18",29,"TOT","NBA",1.5,39,1,337,79,148,79,148,0,0,77,97,48,96,144,22,10,11,36,51,235,6.3
6505,"Desmond Mason\masonde01","2007-08",30,"MIL","NBA",1.5,59,56,1702,230,477,230,477,0,0,114,173,75,181,256,121,40,30,83,106,574,9.43
6506,"Tony Massenburg\masseto01","2001-02",34,"MEM","NBA",1.5,73,31,1247,159,349,158,348,1,1,84,117,100,224,324,26,30,31,65,174,403,5.6
6507,"Eric Maynor\maynoer01","2010-11",23,"OKC","NBA",1.5,82,0,1200,134,333,97,237,37,96,43,59,25,96,121,238,35,6,77,96,348,5.08
6508,"Jelani McCoy\mccoyje01","1999-00",22,"SEA","NBA",1.5,58,2,746,102,177,102,177,0,0,45,91,54,125,179,24,15,46,45,127,249,4.88
6509,"Dominic McGuire\mcguido01","2011-12",26,"GSW","NBA",1.5,64,6,1127,94,210,94,206,0,4,39,53,73,173,246,110,44,36,56,104,227,5.57
6510,"Jim McIlvaine\mcilvji01","1999-00",27,"NJN","NBA",1.5,66,53,1048,64,154,64,154,0,0,29,56,106,124,230,36,26,117,38,205,157,4.38
6511,"Josh McRoberts\mcrobjo01","2009-10",22,"IND","NBA",1.5,42,3,524,76,146,68,123,8,23,19,38,40,87,127,44,17,16,19,74,179,4.99
6512,"C.J. Miles\milescj01","2011-12",24,"UTA","NBA",1.5,56,14,1145,177,465,131,315,46,150,108,136,27,89,116,69,46,18,53,122,508,7.06
6513,"Patty Mills\millspa02","2012-13",24,"SAS","NBA",1.5,58,2,656,113,241,61,111,52,130,16,19,9,41,50,62,26,4,39,55,294,4.51
6514,"Jérôme Moïso\moisoje01","2002-03",24,"NOH","NBA",1.5,51,1,644,89,171,89,171,0,0,27,41,59,119,178,22,19,44,46,87,205,4.94
6515,"Markieff Morris\morrima02","2011-12",22,"PHO","NBA",1.5,63,7,1227,174,436,131,312,43,124,76,106,69,210,279,65,41,42,70,179,467,7.09
6516,"Rasho Nesterović\nestera01","2000-01",24,"MIN","NBA",1.5,73,39,1233,147,319,147,318,0,1,34,65,99,187,286,45,25,63,55,189,328,5.02
6517,"Cedi Osman\osmande01","2018-19",23,"CLE","NBA",1.5,76,75,2444,360,844,230,470,130,374,141,181,45,312,357,195,60,11,114,195,991,11.52
6518,"Anthony Parker\parkean01","2010-11",35,"CLE","NBA",1.5,72,65,2091,220,552,134,325,86,227,74,95,33,185,218,218,67,10,80,109,600,8.43
6519,"Elfrid Payton\paytoel01","2018-19",24,"NOP","NBA",1.5,42,42,1250,179,412,146,307,33,105,55,74,49,171,220,320,44,17,112,81,446,14.04
6520,"Will Perdue\perduwi01","1998-99",33,"SAS","NBA",1.5,37,1,445,38,60,38,60,0,0,14,26,33,105,138,18,9,10,22,63,90,3.84
6521,"Bobby Phills\phillbo01","1999-00",30,"CHH","NBA",1.5,28,9,825,152,335,122,244,30,91,47,65,17,54,71,79,41,8,48,72,381,11.8
6522,"Ricky Pierce\piercri01","1994-95",35,"GSW","NBA",1.5,27,6,673,111,254,88,184,23,70,93,106,12,52,64,40,22,2,24,38,338,10.24
6523,"Mickaël Piétrus\pietrmi01","2003-04",21,"GSW","NBA",1.5,53,22,748,96,231,61,126,35,105,52,75,48,71,119,27,32,12,40,100,279,4.78
6524,"Olden Polynice\polynol01","1997-98",33,"SAC","NBA",1.5,70,25,1458,249,542,249,541,0,1,52,115,173,266,439,107,37,45,98,158,550,8.06
6525,"Bobby Portis\portibo01","2015-16",20,"CHI","NBA",1.5,62,4,1102,186,436,170,384,16,52,48,66,123,214,337,52,25,22,54,100,436,6.61
6526,"Vitaly Potapenko\potapvi01","1997-98",22,"CLE","NBA",1.5,80,0,1412,234,488,234,487,0,1,102,144,110,203,313,57,27,28,132,198,570,6.46
6527,"Pablo Prigioni\prigipa01","2015-16",38,"LAC","NBA",1.5,59,3,823,55,147,27,52,28,95,7,8,38,76,114,130,53,1,49,82,145,4.31
6528,"Tayshaun Prince\princta01","2013-14",33,"MEM","NBA",1.5,76,76,1948,200,492,180,423,20,69,34,60,32,202,234,119,39,19,41,63,454,5.37
6529,"Anthony Randolph\randoan01","2009-10",20,"GSW","NBA",1.5,33,8,749,137,309,136,304,1,5,109,136,73,142,215,42,28,51,49,92,384,11.84
6530,"Zach Randolph\randoza01","2017-18",36,"SAC","NBA",1.5,59,57,1508,361,763,310,616,51,147,84,107,97,300,397,127,42,10,116,119,857,12.79
6531,"Willie Reed\reedwi02","2017-18",27,"TOT","NBA",1.5,42,5,428,81,121,80,119,1,2,32,55,35,86,121,10,9,22,19,56,195,5.08
6532,"Austin Rivers\riverau01","2014-15",22,"TOT","NBA",1.5,76,5,1563,203,496,164,365,39,131,85,126,27,125,152,155,48,14,65,146,530,6.25
6533,"Doc Rivers\riverdo01","1993-94",32,"NYK","NBA",1.5,19,19,499,55,127,36,75,19,52,14,22,4,35,39,100,25,5,29,44,143,9.84
6534,"Nate Robinson\robinna01","2005-06",21,"NYK","NBA",1.5,72,26,1544,230,565,172,419,58,146,152,202,56,111,167,147,59,1,114,201,670,8
6535,"Thomas Robinson\robinth01","2014-15",23,"TOT","NBA",1.5,54,4,798,126,260,126,258,0,2,56,106,95,208,303,33,32,20,59,104,308,6.42
6536,"Sean Rooks\rooksse01","1992-93",23,"DAL","NBA",1.5,72,68,2087,368,747,368,745,0,2,234,389,196,340,536,95,38,81,160,204,970,12.61
6537,"Jalen Rose\roseja01","2003-04",31,"TOT","NBA",1.5,66,64,2497,383,952,314,750,69,202,187,231,34,232,266,329,51,22,208,184,1022,13.55
6538,"Kareem Rush\rushka01","2003-04",23,"LAL","NBA",1.5,72,15,1244,190,432,142,294,48,138,31,52,20,77,97,59,33,20,48,109,459,4.88
6539,"Bryon Russell\russebr01","2002-03",32,"WAS","NBA",1.5,70,23,1388,108,306,62,166,46,140,53,69,43,165,208,72,70,7,55,130,315,4.94
6540,"Dennis Scott\scottde01","1999-00",31,"VAN","NBA",1.5,66,0,1263,125,333,54,144,71,189,48,57,16,90,106,69,28,9,30,104,369,4.66
6541,"Thabo Sefolosha\sefolth01","2018-19",34,"UTA","NBA",1.5,50,2,609,71,149,37,71,34,78,14,22,8,115,123,27,43,5,25,41,190,4.51
6542,"Thabo Sefolosha\sefolth01","2007-08",23,"CHI","NBA",1.5,69,22,1436,180,421,151,333,29,88,75,104,50,205,255,129,61,30,93,128,464,7.3
6543,"Iman Shumpert\shumpim01","2014-15",24,"TOT","NBA",1.5,62,25,1545,193,471,126,275,67,196,43,64,55,169,224,135,81,16,91,138,496,8.25
6544,"Chris Singleton\singlch01","2011-12",22,"WAS","NBA",1.5,66,51,1431,116,312,72,185,44,127,30,44,43,190,233,49,70,30,38,176,306,5.26
6545,"Reggie Slater\slatere01","1997-98",27,"TOR","NBA",1.5,78,28,1662,211,459,211,459,0,0,203,322,134,171,305,74,45,30,102,201,625,7.44
6546,"Craig Smith\smithcr01","2010-11",27,"LAC","NBA",1.5,48,0,586,104,188,104,183,0,5,50,68,43,74,117,31,16,7,33,84,258,5.21
6547,"Jason Smith\smithja02","2007-08",21,"PHI","NBA",1.5,76,1,1107,141,310,137,296,4,14,54,82,77,153,230,20,22,50,48,142,340,4.36
6548,"Tony Smith\smithto02","1992-93",24,"LAL","NBA",1.5,55,9,752,133,275,131,264,2,11,62,82,46,41,87,63,50,7,40,72,330,5.75
6549,"DeShawn Stevenson\stevede01","2012-13",31,"ATL","NBA",1.5,56,31,1158,98,262,22,53,76,209,12,23,18,104,122,52,29,6,23,69,284,4.53
6550,"DeShawn Stevenson\stevede01","2003-04",22,"TOT","NBA",1.5,80,78,2444,376,871,357,800,19,71,138,204,79,219,298,158,52,17,120,140,909,8.96
6551,"Greg Stiemsma\stiemgr01","2013-14",28,"NOP","NBA",1.5,55,20,1007,70,122,70,121,0,1,19,32,72,154,226,36,35,57,44,169,159,5.22
6552,"Derek Strong\stronde01","1992-93",24,"MIL","NBA",1.5,23,0,339,42,92,38,84,4,8,68,85,40,75,115,14,11,1,13,20,156,7.35
6553,"Garrett Temple\templga01","2014-15",28,"WAS","NBA",1.5,52,18,735,68,170,35,82,33,88,35,48,24,66,90,56,42,9,34,76,204,4.43
6554,"Jason Terry\terryja01","2015-16",38,"HOU","NBA",1.5,72,7,1258,151,376,58,115,93,261,27,33,14,65,79,103,47,9,49,91,422,5.19
6555,"John Thomas\thomajo02","1998-99",23,"TOR","NBA",1.5,39,11,593,71,123,71,122,0,1,27,48,65,69,134,15,17,9,21,82,169,4.88
6556,"Ronny Turiaf\turiaro01","2013-14",31,"MIN","NBA",1.5,31,10,606,64,107,64,107,0,0,21,50,55,119,174,24,8,50,24,65,149,7.02
6557,"Jacque Vaughn\vaughja01","2005-06",30,"NJN","NBA",1.5,80,6,1234,107,245,106,239,1,6,59,81,16,75,91,123,42,1,52,140,274,3.77
6558,"John Wallace\wallajo01","1997-98",23,"TOR","NBA",1.5,82,36,2361,468,979,467,977,1,2,210,293,117,256,373,110,62,101,172,239,1147,11.89
6559,"Taurean Waller-Prince\princta02","2018-19",24,"ATL","NBA",1.5,55,47,1552,262,594,139,279,123,315,95,116,22,177,199,118,53,19,100,141,742,11.84
6560,"Earl Watson\watsoea01","2001-02",22,"SEA","NBA",1.5,64,0,964,96,212,80,168,16,44,23,36,31,52,83,125,60,5,51,93,231,4.69
6561,"Martell Webster\webstma02","2011-12",25,"MIN","NBA",1.5,47,26,1140,115,272,78,163,37,109,57,72,42,126,168,40,31,17,46,86,324,6.63
6562,"Damien Wilkins\wilkida02","2010-11",31,"ATL","NBA",1.5,52,0,676,69,137,67,127,2,10,40,56,23,67,90,41,27,9,21,72,180,3.91
6563,"Jason Williams\willija02","1999-00",24,"SAC","NBA",1.5,81,81,2760,363,973,218,468,145,505,128,170,22,208,230,589,117,8,296,140,999,13.25
6564,"Corliss Williamson\willico02","2006-07",33,"SAC","NBA",1.5,68,1,1337,236,463,236,461,0,2,148,207,63,158,221,39,29,15,97,183,620,7.68
6565,"Joe Wolf\wolfjo01","1995-96",31,"TOT","NBA",1.5,64,8,1065,135,263,135,257,0,6,21,29,49,138,187,63,15,5,42,163,291,4.61
6566,"Orlando Woolridge\woolror01","1993-94",34,"PHI","NBA",1.5,74,1,1955,364,773,363,759,1,14,208,302,103,195,298,139,41,56,142,186,937,10.82
6567,"Wang Zhizhi\zhizhwa01","2001-02",24,"DAL","NBA",1.5,55,0,600,109,248,61,132,48,116,42,57,19,92,111,22,11,18,25,84,308,4.64
6568,"Tariq Abdul-Wahad\abdulta01","1998-99",24,"SAC","NBA",1.4,49,49,1205,177,407,171,386,6,21,94,136,72,114,186,50,50,16,70,121,454,8.03
6569,"Arron Afflalo\afflaar01","2016-17",31,"SAC","NBA",1.4,61,45,1580,185,420,123,269,62,151,83,93,9,116,125,78,21,6,42,104,515,6.9
6570,"Furkan Aldemir\aldemfu01","2014-15",23,"PHI","NBA",1.4,41,9,540,40,78,40,73,0,5,13,27,78,98,176,28,17,16,17,96,93,4.07
6571,"Al-Farouq Aminu\aminual01","2011-12",21,"NOH","NBA",1.4,66,21,1477,150,365,137,318,13,47,86,114,95,213,308,66,59,34,91,136,399,6.73
6572,"Willie Anderson\anderwi01","1995-96",29,"TOT","NBA",1.4,76,44,2060,288,660,254,540,34,120,132,163,48,198,246,197,75,59,143,230,742,9.68
6573,"Pero Antić\anticpe01","2013-14",31,"ATL","NBA",1.4,50,26,925,123,294,67,123,56,171,50,66,57,152,209,58,19,12,55,126,352,6.81
6574,"Keith Askins\askinke01","1992-93",25,"MIA","NBA",1.4,69,1,935,88,213,66,148,22,65,29,40,74,124,198,31,31,29,37,141,227,3.78
6575,"Andrea Bargnani\bargnan01","2007-08",22,"TOR","NBA",1.4,78,53,1861,280,725,190,464,90,261,142,169,50,238,288,89,23,37,88,211,792,7.85
6576,"John Battle\battljo01","1993-94",31,"CLE","NBA",1.4,51,1,814,130,273,125,254,5,19,73,97,7,32,39,83,22,1,41,66,338,5.6
6577,"Bismack Biyombo\biyombi01","2012-13",20,"CHA","NBA",1.4,80,65,2186,156,346,156,346,0,0,74,142,194,388,582,35,28,143,82,195,386,7.05
6578,"Andray Blatche\blatcan01","2008-09",22,"WAS","NBA",1.4,71,36,1703,297,630,292,609,5,21,114,162,126,252,378,118,53,74,117,211,713,10
6579,"Keith Bogans\boganke01","2012-13",32,"BRK","NBA",1.4,74,23,1408,108,284,24,39,84,245,11,17,16,104,120,76,28,4,49,108,311,3.85
6580,"Jonah Bolden\boldejo01","2018-19",23,"PHI","NBA",1.4,44,10,639,80,162,46,66,34,96,13,27,47,118,165,40,17,39,36,99,207,5.87
6581,"Ryan Bowen\bowenry01","1999-00",24,"DEN","NBA",1.4,52,0,589,46,117,45,108,1,9,38,53,75,39,114,20,39,13,14,95,131,3.25
6582,"Aaron Brooks\brookaa01","2007-08",23,"HOU","NBA",1.4,51,0,608,93,225,57,116,36,109,42,49,13,43,56,87,13,5,44,69,264,4.72
6583,"Chucky Brown\brownch01","1997-98",29,"ATL","NBA",1.4,77,8,1202,161,372,159,364,2,8,63,87,57,126,183,55,23,13,51,100,387,4.22
6584,"Devin Brown\brownde02","2005-06",27,"UTA","NBA",1.4,81,14,1711,207,527,168,409,39,118,158,212,73,134,207,104,44,14,99,153,611,6.33
6585,"Chase Budinger\budinch01","2015-16",27,"TOT","NBA",1.4,66,2,929,104,239,80,153,24,86,39,56,43,107,150,64,32,10,44,62,271,4.28
6586,"Scott Burrell\burresc01","1998-99",28,"NJN","NBA",1.4,32,10,706,75,208,47,136,28,72,34,42,32,87,119,45,40,11,23,82,212,6.88
6587,"Isaiah Canaan\canaais01","2014-15",23,"TOT","NBA",1.4,47,21,938,146,378,55,132,91,246,49,60,18,69,87,98,29,3,62,83,432,7.57
6588,"Isaiah Canaan\canaais01","2015-16",24,"PHI","NBA",1.4,77,39,1966,260,722,84,237,176,485,150,180,20,154,174,137,56,12,91,133,846,8.6
6589,"Anthony Carter\cartean01","1999-00",24,"MIA","NBA",1.4,79,30,1859,201,509,198,486,3,23,93,124,48,151,199,378,93,5,173,167,498,8.23
6590,"Rex Chapman\chapmre01","1999-00",32,"PHO","NBA",1.4,53,19,957,124,320,83,197,41,123,59,78,10,70,80,62,22,1,38,70,348,4.98
6591,"Pete Chilcutt\chilcpe01","1995-96",27,"HOU","NBA",1.4,74,0,651,73,179,36,81,37,98,17,26,51,105,156,26,19,14,22,65,200,2.83
6592,"Josh Childress\childjo01","2010-11",27,"PHO","NBA",1.4,54,3,894,121,214,120,198,1,16,29,59,69,86,155,42,33,23,44,68,272,5.54
6593,"Doug Christie\chrisdo01","1995-96",25,"TOT","NBA",1.4,55,17,1036,150,337,104,231,46,106,69,93,34,120,154,117,70,19,95,141,415,8.3
6594,"Doug Christie\chrisdo01","1993-94",23,"LAL","NBA",1.4,65,34,1515,244,562,205,443,39,119,145,208,93,142,235,136,89,28,140,186,672,9.98
6595,"Norris Cole\coleno01","2014-15",26,"TOT","NBA",1.4,75,25,1831,230,558,175,382,55,176,58,81,13,146,159,255,57,15,99,124,573,7.66
6596,"Steve Colter\coltest01","1994-95",32,"CLE","NBA",1.4,57,7,752,67,169,59,134,8,35,54,71,13,46,59,101,30,6,36,53,196,3.97
6597,"Marty Conlon\conloma01","1993-94",26,"TOT","NBA",1.4,30,9,579,95,165,95,163,0,2,43,53,53,86,139,34,9,8,33,69,233,8.18
6598,"Seth Curry\curryse01","2015-16",25,"SAC","NBA",1.4,44,9,692,102,224,52,113,50,111,45,54,9,51,60,67,22,3,36,41,299,6.24
6599,"Troy Daniels\danietr01","2017-18",26,"PHO","NBA",1.4,79,15,1622,232,575,49,117,183,458,56,64,12,115,127,48,26,5,56,137,703,6.38
6600,"Glen Davis\davisgl01","2014-15",29,"LAC","NBA",1.4,74,0,904,117,255,117,251,0,4,60,95,43,126,169,39,41,21,39,132,294,4.04
6601,"Terry Davis\daviste01","1998-99",31,"WAS","NBA",1.4,37,34,578,49,92,49,92,0,0,28,38,50,89,139,10,11,3,16,79,126,4.13
6602,"DeSagana Diop\diopde01","2008-09",27,"TOT","NBA",1.4,75,1,1036,74,171,74,171,0,0,22,66,114,159,273,32,29,56,39,128,170,3.49
6603,"Juan Dixon\dixonju01","2003-04",25,"WAS","NBA",1.4,71,16,1478,247,637,188,439,59,198,111,139,30,118,148,137,82,4,104,111,664,7.68
6604,"Keyon Dooling\doolike01","2000-01",20,"LAC","NBA",1.4,76,1,1237,148,362,120,282,28,80,125,179,8,81,89,177,41,11,94,107,449,5.81
6605,"Tyus Edney\edneyty01","1997-98",24,"BOS","NBA",1.4,52,7,623,93,216,90,206,3,10,88,111,20,35,55,139,51,1,66,69,277,6.25
6606,"Sean Elliott\elliose01","1997-98",29,"SAS","NBA",1.4,36,36,1012,122,303,88,213,34,90,56,78,16,108,124,62,24,14,57,92,334,8.02
6607,"Sean Elliott\elliose01","1993-94",25,"DET","NBA",1.4,73,73,2409,360,791,334,704,26,87,139,173,68,195,263,197,54,27,129,174,885,10.65
6608,"LaPhonso Ellis\ellisla01","1997-98",27,"DEN","NBA",1.4,76,71,2575,410,1007,353,806,57,201,206,256,146,398,544,213,65,49,173,226,1083,13
6609,"Semih Erden\erdense01","2010-11",24,"TOT","NBA",1.4,41,8,595,62,111,62,111,0,0,39,60,37,81,118,20,15,24,34,104,163,4.75
6610,"Tyreke Evans\evansty01","2015-16",26,"NOP","NBA",1.4,25,25,765,136,314,103,229,33,85,74,93,20,109,129,164,32,8,73,66,379,16.4
6611,"Patrick Ewing\ewingpa01","2001-02",39,"ORL","NBA",1.4,65,4,901,148,333,148,332,0,1,94,134,60,203,263,35,22,45,65,129,390,5.9
6612,"Cristiano Felício\feliccr01","2018-19",26,"CHI","NBA",1.4,60,0,746,95,179,95,175,0,4,50,73,79,139,218,37,11,7,33,69,240,4.54
6613,"Dorian Finney-Smith\finnedo01","2016-17",23,"DAL","NBA",1.4,81,35,1642,124,333,68,142,56,191,46,61,55,167,222,67,52,25,45,125,350,4.51
6614,"Marcus Fizer\fizerma01","2002-03",24,"CHI","NBA",1.4,38,0,809,178,383,177,377,1,6,88,134,80,136,216,48,14,17,57,89,445,9.88
6615,"Vern Fleming\flemive01","1993-94",31,"IND","NBA",1.4,55,5,1053,147,318,147,314,0,4,64,87,27,96,123,173,40,6,87,98,358,7.26
6616,"T.J. Ford\fordtj01","2009-10",26,"IND","NBA",1.4,47,32,1189,186,418,178,368,8,50,104,135,41,108,149,180,44,11,90,102,484,10.44
6617,"Evan Fournier\fournev01","2013-14",21,"DEN","NBA",1.4,76,4,1503,228,544,139,307,89,237,93,123,34,168,202,112,34,7,100,179,638,7.03
6618,"Tim Frazier\fraziti01","2017-18",27,"WAS","NBA",1.4,59,11,838,68,172,51,116,17,56,23,30,18,97,115,194,47,7,57,97,176,5.32
6619,"Joel Freeland\freeljo01","2013-14",26,"POR","NBA",1.4,52,0,727,77,162,77,160,0,2,20,29,88,120,208,36,10,22,32,95,174,4.26
6620,"Langston Galloway\gallola01","2017-18",26,"DET","NBA",1.4,58,2,863,126,340,51,122,75,218,33,41,13,79,92,58,35,5,18,39,360,4.92
6621,"Chris Gatling\gatlich01","2001-02",34,"MIA","NBA",1.4,54,1,809,131,293,130,285,1,8,82,117,71,135,206,25,17,11,58,109,345,5.61
6622,"Drew Gooden\goodedr01","2013-14",32,"WAS","NBA",1.4,22,0,395,76,143,69,126,7,17,24,27,37,77,114,15,10,7,17,53,183,8.32
6623,"Marcin Gortat\gortama01","2018-19",34,"LAC","NBA",1.4,47,43,751,99,186,99,186,0,0,35,48,67,194,261,65,6,24,50,92,233,6.59
6624,"Gary Grant\grantga01","1995-96",30,"NYK","NBA",1.4,47,1,596,88,181,80,157,8,24,48,58,12,40,52,69,39,3,45,91,232,5.25
6625,"Aaron Gray\grayaa01","2011-12",27,"TOR","NBA",1.4,49,40,813,83,161,83,161,0,0,25,47,83,198,281,27,22,17,51,127,191,5.47
6626,"A.C. Green\greenac01","1998-99",35,"DAL","NBA",1.4,50,35,924,108,256,108,248,0,8,30,52,82,146,228,25,28,8,19,69,246,4.87
6627,"Richard Hamilton\hamilri01","2009-10",31,"DET","NBA",1.4,46,46,1552,293,717,252,579,41,138,204,241,30,92,122,202,30,3,115,115,831,14.21
6628,"Josh Harrellson\harrejo01","2011-12",22,"NYK","NBA",1.4,37,4,540,63,149,43,90,20,59,16,26,47,97,144,11,23,20,20,48,162,4.9
6629,"Othella Harrington\harriot01","1996-97",23,"HOU","NBA",1.4,57,1,860,112,204,112,201,0,3,49,81,75,123,198,18,12,22,57,112,273,4.94
6630,"David Harrison\harrida01","2004-05",22,"IND","NBA",1.4,43,14,760,106,184,106,184,0,0,52,91,48,87,135,13,16,55,53,134,264,6.5
6631,"Shaquille Harrison\harrish01","2018-19",25,"CHI","NBA",1.4,73,11,1430,184,426,160,337,24,89,82,123,33,189,222,139,89,30,60,124,474,7.25
6632,"Udonis Haslem\hasleud01","2014-15",34,"MIA","NBA",1.4,62,25,995,107,239,105,229,2,10,45,64,71,187,258,46,21,13,41,113,261,4.75
6633,"Chuck Hayes\hayesch01","2013-14",30,"TOT","NBA",1.4,61,1,754,56,130,56,129,0,1,20,25,69,141,210,35,34,12,33,95,132,3.48
6634,"Rod Higgins\higgiro01","1993-94",34,"CLE","NBA",1.4,36,11,547,71,163,49,113,22,50,31,42,25,57,82,36,25,14,21,53,195,5.49
6635,"Nenê Hilário\hilarne01","2018-19",36,"HOU","NBA",1.4,42,2,546,60,116,60,113,0,3,31,47,34,89,123,26,18,15,11,87,151,4.36
6636,"Jordan Hill\hilljo01","2011-12",24,"TOT","NBA",1.4,39,8,551,82,165,82,162,0,3,30,47,61,125,186,16,14,27,31,71,194,5.72
6637,"Jordan Hill\hilljo01","2009-10",22,"TOT","NBA",1.4,47,0,624,99,201,99,199,0,2,46,68,76,99,175,20,14,21,30,92,244,5.25
6638,"Jordan Hill\hilljo01","2012-13",25,"LAL","NBA",1.4,29,1,458,77,155,77,153,0,2,40,61,82,84,166,13,8,19,26,55,194,7.06
6639,"Tyrone Hill\hillty01","2002-03",34,"TOT","NBA",1.4,56,43,1351,129,306,129,306,0,0,54,80,126,265,391,41,46,26,68,172,312,6.93
6640,"Lindsey Hunter\hunteli01","2004-05",34,"DET","NBA",1.4,76,3,1144,108,302,85,218,23,84,46,58,38,85,123,130,68,13,68,125,285,4.33
6641,"Bobby Jackson\jacksbo01","2004-05",31,"SAC","NBA",1.4,25,0,536,109,255,76,159,33,96,50,58,23,62,85,59,14,2,28,58,301,10.14
6642,"Antawn Jamison\jamisan01","1999-00",23,"GSW","NBA",1.4,43,41,1556,356,756,354,749,2,7,127,208,172,187,359,90,30,15,113,115,841,15.56
6643,"Jonas Jerebko\jerebjo01","2013-14",26,"DET","NBA",1.4,64,0,741,98,208,67,134,31,74,43,59,51,124,175,39,21,6,43,85,270,4.37
6644,"Chris Johnson\johnsch04","2013-14",23,"BOS","NBA",1.4,40,0,789,85,214,42,87,43,127,37,43,31,66,97,31,27,4,22,63,250,5.55
6645,"Adam Keefe\keefead01","1993-94",23,"ATL","NBA",1.4,63,1,763,96,213,96,213,0,0,81,111,77,124,201,34,20,9,60,80,273,4.46
6646,"Warren Kidd\kiddwa01","1993-94",23,"PHI","NBA",1.4,68,14,884,100,169,100,169,0,0,47,86,76,157,233,19,19,23,44,129,247,4.33
6647,"Sean Kilpatrick\kilpase01","2016-17",27,"BRK","NBA",1.4,70,24,1754,305,735,200,427,105,308,204,242,22,258,280,157,45,6,135,118,919,11.18
6648,"Joe Kleine\kleinjo01","1994-95",33,"PHO","NBA",1.4,75,42,968,119,265,119,263,0,2,42,49,82,177,259,39,14,18,35,174,280,3.96
6649,"Brevin Knight\knighbr01","2001-02",26,"MEM","NBA",1.4,53,11,1151,141,334,139,326,2,8,87,115,11,98,109,302,79,7,111,135,371,9.84
6650,"Luke Kornet\kornelu01","2018-19",23,"NYK","NBA",1.4,46,18,784,107,283,37,90,70,193,38,46,28,107,135,54,27,42,25,41,322,6.78
6651,"Skal Labissière\labissk01","2017-18",21,"SAC","NBA",1.4,60,28,1240,205,458,187,407,18,51,95,118,99,189,288,72,25,49,73,132,523,8.34
6652,"Shane Larkin\larkish01","2015-16",23,"BRK","NBA",1.4,78,17,1751,222,502,183,394,39,108,83,107,28,152,180,342,95,12,146,121,566,9.08
6653,"Shane Larkin\larkish01","2017-18",25,"BOS","NBA",1.4,54,2,775,84,219,53,133,31,86,32,37,15,77,92,98,29,2,33,58,231,4.54
6654,"Meyers Leonard\leoname01","2016-17",24,"POR","NBA",1.4,74,12,1222,146,378,72,165,74,213,35,40,27,210,237,71,13,28,35,172,401,5
6655,"Jon Leuer\leuerjo01","2011-12",22,"MIL","NBA",1.4,46,12,555,97,191,94,182,3,9,21,28,45,75,120,25,14,17,18,67,218,4.6
6656,"Art Long\longar01","2001-02",29,"SEA","NBA",1.4,63,27,989,120,244,120,244,0,0,45,85,107,144,251,41,22,28,63,180,285,5.03
6657,"Grant Long\longgr01","1999-00",33,"VAN","NBA",1.4,42,1,920,74,167,74,163,0,4,55,71,86,148,234,43,45,10,49,108,203,6.79
6658,"Kevon Looney\looneke01","2016-17",20,"GSW","NBA",1.4,53,4,447,56,107,54,98,2,9,21,34,44,80,124,29,15,17,17,64,135,3.28
6659,"Raül López\lopezra01","2003-04",23,"UTA","NBA",1.4,82,11,1617,223,517,198,432,25,85,101,117,24,131,155,305,62,2,174,200,572,7.7
6660,"Shelvin Mack\macksh01","2016-17",26,"UTA","NBA",1.4,55,9,1205,170,381,133,261,37,120,53,77,20,105,125,154,42,3,90,100,430,7.7
6661,"Ian Mahinmi\mahinia01","2016-17",30,"WAS","NBA",1.4,31,0,555,65,111,65,111,0,0,43,75,47,103,150,19,33,24,34,90,173,7.47
6662,"Roger Mason\masonro01","2012-13",32,"NOH","NBA",1.4,69,13,1219,132,305,66,146,66,159,39,43,11,121,132,74,26,11,51,104,369,5
6663,"Jason Maxiell\maxieja01","2014-15",31,"CHO","NBA",1.4,61,0,878,81,192,81,192,0,0,41,71,86,117,203,19,18,44,29,96,203,3.81
6664,"Ray McCallum\mccalra01","2014-15",23,"SAC","NBA",1.4,68,30,1436,206,470,172,359,34,111,57,84,52,128,180,188,45,11,85,92,503,7.38
6665,"George McCloud\mccloge01","1992-93",25,"IND","NBA",1.4,78,21,1500,216,525,158,344,58,181,75,102,60,145,205,192,53,11,107,165,565,7.05
6666,"Jelani McCoy\mccoyje01","1998-99",21,"SEA","NBA",1.4,26,0,331,56,76,56,76,0,0,21,42,27,52,79,4,11,20,10,42,133,5.89
6667,"Xavier McDaniel\mcdanxa01","1994-95",31,"BOS","NBA",1.4,68,15,1430,246,546,240,525,6,21,89,125,94,206,300,108,30,20,89,146,587,7.77
6668,"Derrick McKey\mckeyde01","2000-01",34,"IND","NBA",1.4,66,20,987,60,136,56,116,4,20,21,27,49,127,176,74,48,13,47,136,145,3.8
6669,"Aaron McKie\mckieaa01","1997-98",25,"TOT","NBA",1.4,81,32,1813,139,381,127,318,12,63,42,55,58,173,231,175,101,13,76,164,332,5.44
6670,"Josh McRoberts\mcrobjo01","2011-12",24,"LAL","NBA",1.4,50,6,718,56,118,53,111,3,7,23,36,61,110,171,51,15,18,31,74,138,4.09
6671,"Oliver Miller\milleol01","2003-04",33,"MIN","NBA",1.4,48,1,506,53,100,53,99,0,1,15,23,46,84,130,36,19,26,33,91,121,3.82
6672,"Patty Mills\millspa02","2014-15",26,"SAS","NBA",1.4,51,0,801,128,336,66,154,62,182,33,40,21,54,75,87,28,2,35,58,351,5.58
6673,"Eric Montross\montrer01","1996-97",25,"TOT","NBA",1.4,78,77,1828,159,349,159,349,0,0,21,62,181,337,518,61,20,73,77,268,339,5.93
6674,"Donatas Motiejūnas\motiedo01","2013-14",23,"HOU","NBA",1.4,62,3,952,131,296,110,212,21,84,58,96,60,165,225,34,20,21,49,132,341,5.15
6675,"Troy Murphy\murphtr01","2001-02",21,"GSW","NBA",1.4,82,4,1448,178,423,175,414,3,9,121,156,99,223,322,70,36,21,84,217,480,5.73
6676,"Martin Müürsepp\muursma01","1997-98",23,"DAL","NBA",1.4,41,7,603,83,191,67,153,16,38,51,67,46,68,114,30,29,14,29,96,233,5.65
6677,"Juan Carlos Navarro\navarju01","2007-08",27,"MEM","NBA",1.4,82,30,2117,308,766,152,334,156,432,124,146,34,176,210,177,48,1,134,94,896,8.91
6678,"Gary Neal\nealga01","2015-16",31,"WAS","NBA",1.4,40,2,807,151,325,110,225,41,100,47,55,11,72,83,47,20,1,29,55,390,7.66
6679,"Jameer Nelson\nelsoja01","2014-15",32,"TOT","NBA",1.4,63,29,1407,205,504,116,246,89,258,24,36,33,113,146,253,47,6,109,136,523,8.48
6680,"Steve Novak\novakst01","2013-14",30,"TOR","NBA",1.4,54,1,540,60,146,8,24,52,122,6,6,8,50,58,13,12,4,5,44,178,2.72
6681,"David Nwaba\nwabada01","2018-19",26,"CLE","NBA",1.4,51,14,984,126,262,102,187,24,75,58,85,41,122,163,54,36,17,29,106,334,6.69
6682,"Kyle O'Quinn\oquinky01","2012-13",22,"ORL","NBA",1.4,57,5,638,101,197,101,196,0,1,30,45,65,144,209,52,11,26,37,107,232,4.87
6683,"Kevin Ollie\ollieke01","2000-01",28,"TOT","NBA",1.4,70,4,925,76,192,75,189,1,3,63,89,16,79,95,146,30,1,49,84,216,3.89
6684,"Greg Ostertag\ostergr01","1995-96",22,"UTA","NBA",1.4,57,10,661,86,182,86,182,0,0,36,54,57,118,175,5,5,63,25,91,208,4.04
6685,"Travis Outlaw\outlatr01","2013-14",29,"SAC","NBA",1.4,63,4,1065,130,326,89,209,41,117,42,52,36,132,168,48,20,19,26,94,343,4.71
6686,"Travis Outlaw\outlatr01","2004-05",20,"POR","NBA",1.4,59,2,793,133,267,129,257,4,10,49,75,40,81,121,35,30,40,39,77,319,5.18
6687,"Robert Parish\parisro01","1994-95",41,"CHH","NBA",1.4,81,4,1352,159,372,159,372,0,0,71,101,93,257,350,44,27,36,66,132,389,4.98
6688,"Anthony Parker\parkean01","2011-12",36,"CLE","NBA",1.4,51,51,1280,141,326,91,188,50,138,35,56,10,128,138,120,38,7,50,65,367,7.23
6689,"Jabari Parker\parkeja01","2018-19",23,"TOT","NBA",1.4,64,17,1724,369,749,308,554,61,195,131,184,79,342,421,152,46,30,151,145,930,13.65
6690,"Tony Parker\parketo01","2017-18",35,"SAS","NBA",1.4,55,21,1071,178,388,168,351,10,37,55,78,7,88,95,195,28,1,68,52,421,7.54
6691,"Cherokee Parks\parksch02","1999-00",27,"VAN","NBA",1.4,56,14,808,72,145,72,144,0,1,24,37,55,128,183,35,29,45,28,115,168,4.43
6692,"Cameron Payne\payneca01","2015-16",21,"OKC","NBA",1.4,57,1,698,114,278,78,167,36,111,19,24,9,76,85,108,36,6,44,80,283,4.94
6693,"Kendrick Perkins\perkike01","2006-07",22,"BOS","NBA",1.4,72,53,1576,132,269,132,266,0,3,60,100,113,259,372,94,23,96,113,214,324,6.63
6694,"Scot Pollard\pollasc01","2003-04",28,"IND","NBA",1.4,61,3,678,47,114,47,114,0,0,12,21,67,97,164,10,23,26,22,110,106,2.54
6695,"Ronnie Price\pricero01","2015-16",32,"PHO","NBA",1.4,62,18,1211,116,302,48,106,68,196,31,41,25,74,99,147,74,13,70,161,331,6.25
6696,"Joel Przybilla\przybjo01","2009-10",30,"POR","NBA",1.4,30,9,681,45,86,45,86,0,0,33,51,72,166,238,8,8,43,39,95,123,7.08
6697,"Theo Ratliff\ratlith01","2009-10",36,"TOT","NBA",1.4,49,29,807,70,152,70,152,0,0,38,50,59,98,157,25,12,61,41,87,178,4.69
6698,"Theo Ratliff\ratlith01","2008-09",35,"PHI","NBA",1.4,46,0,579,34,64,34,64,0,0,21,35,46,82,128,9,17,47,14,77,89,3.47
6699,"Jason Richardson\richaja01","2012-13",32,"PHI","NBA",1.4,33,33,936,135,336,78,169,57,167,20,33,19,108,127,51,40,15,26,57,347,9.02
6700,"Pooh Richardson\richapo01","1993-94",27,"IND","NBA",1.4,37,25,1022,160,354,157,342,3,12,47,77,28,82,110,237,32,3,88,78,370,11.3
6701,"Roy Rogers\rogerro02","1996-97",23,"VAN","NBA",1.4,82,50,1848,244,483,243,482,1,1,54,94,139,247,386,46,21,163,86,214,543,7.42
6702,"Terry Rozier\roziete01","2016-17",22,"BOS","NBA",1.4,74,0,1263,151,411,94,232,57,179,51,66,40,187,227,131,46,11,47,69,410,5.58
6703,"Bryon Russell\russebr01","1994-95",24,"UTA","NBA",1.4,63,15,860,104,238,91,194,13,44,62,93,44,97,141,34,48,11,42,101,283,4.47
6704,"Robert Sacre\sacrero01","2013-14",24,"LAL","NBA",1.4,65,13,1089,143,300,143,300,0,0,64,94,82,172,254,51,24,47,44,134,350,5.84
6705,"John Salmons\salmojo01","2004-05",25,"PHI","NBA",1.4,58,8,993,85,210,54,119,31,91,35,48,12,109,121,114,40,13,51,92,236,5.09
6706,"Brian Scalabrine\scalabr01","2004-05",26,"NJN","NBA",1.4,54,14,1167,132,332,110,264,22,68,53,69,83,161,244,88,34,18,66,111,339,6.64
6707,"Danny Schayes\schayda01","1992-93",33,"MIL","NBA",1.4,70,7,1124,105,263,105,260,0,3,112,137,72,177,249,78,36,36,65,148,322,5.5
6708,"Danny Schayes\schayda01","1994-95",35,"PHO","NBA",1.4,69,27,823,126,248,125,247,1,1,50,69,57,151,208,89,20,37,64,170,303,5.27
6709,"Iman Shumpert\shumpim01","2018-19",28,"TOT","NBA",1.4,62,41,1481,167,446,72,173,95,273,36,45,27,156,183,112,59,24,50,127,465,7.15
6710,"J.R. Smith\smithjr01","2017-18",32,"CLE","NBA",1.4,80,61,2244,240,595,97,214,143,381,39,56,29,206,235,141,68,11,81,161,662,7.54
6711,"Kirk Snyder\snydeki01","2006-07",23,"HOU","NBA",1.4,39,1,563,66,146,55,102,11,44,49,75,17,66,83,39,11,12,26,51,192,4.76
6712,"Nik Stauskas\stausni01","2016-17",23,"PHI","NBA",1.4,80,27,2188,251,634,119,275,132,359,122,150,21,205,226,188,45,32,128,144,756,8.64
6713,"Mike Sweetney\sweetmi01","2003-04",21,"NYK","NBA",1.4,42,1,494,69,140,69,139,0,1,42,58,68,89,157,14,18,12,32,57,180,4.81
6714,"Stromile Swift\swiftst01","2007-08",28,"TOT","NBA",1.4,56,4,844,135,265,135,263,0,2,73,109,64,135,199,26,15,54,51,113,343,6.21
6715,"Miloš Teodosić\teodomi01","2017-18",30,"LAC","NBA",1.4,45,36,1134,151,360,63,128,88,232,39,46,16,110,126,209,23,5,97,103,429,10.17
6716,"Ronny Turiaf\turiaro01","2009-10",27,"GSW","NBA",1.4,42,20,872,85,146,85,145,0,1,37,78,54,137,191,90,23,54,49,98,207,7.68
6717,"Evan Turner\turneev01","2013-14",25,"TOT","NBA",1.4,81,56,2457,434,1021,384,865,50,156,213,262,62,346,408,262,67,7,189,195,1131,12.21
6718,"Jeff Turner\turneje01","1993-94",31,"ORL","NBA",1.4,68,51,1536,199,426,181,371,18,55,35,45,79,192,271,60,23,11,75,239,451,6.02
6719,"Beno Udrih\udrihbe01","2011-12",29,"MIL","NBA",1.4,59,0,1080,146,332,129,273,17,59,39,55,26,76,102,227,37,1,77,69,348,6.86
6720,"Nick Van Exel\vanexni01","2005-06",34,"SAS","NBA",1.4,65,2,986,136,343,81,189,55,154,28,41,6,85,91,123,16,3,57,60,355,4.69
6721,"Charlie Villanueva\villach01","2014-15",30,"DAL","NBA",1.4,64,1,678,150,362,67,141,83,221,20,35,30,119,149,19,15,22,28,64,403,4.8
6722,"Sasha Vujačić\vujacsa01","2009-10",25,"LAL","NBA",1.4,67,1,575,66,164,41,83,25,81,28,33,25,54,79,41,20,4,17,67,185,2.65
6723,"Samaki Walker\walkesa01","1997-98",21,"DAL","NBA",1.4,41,19,1027,156,321,156,320,0,1,53,97,96,206,302,24,30,40,61,127,365,9.29
6724,"Ben Wallace\wallabe01","2011-12",37,"DET","NBA",1.4,62,11,980,34,86,33,82,1,4,16,47,81,188,269,43,47,51,34,60,85,3.97
6725,"Shawne Williams\willish03","2007-08",21,"IND","NBA",1.4,65,3,967,159,372,116,235,43,137,76,106,54,122,176,59,26,26,58,132,437,5.91
6726,"Haywoode Workman\workmha01","1995-96",30,"IND","NBA",1.4,77,4,1164,101,259,78,188,23,71,54,73,27,97,124,213,65,4,93,152,279,5.16
6727,"Antoine Wright\wrighan01","2008-09",24,"DAL","NBA",1.4,65,53,1552,179,431,134,282,45,149,71,95,31,105,136,77,46,27,54,172,474,6.27
6728,"Lorenzen Wright\wrighlo02","2001-02",26,"MEM","NBA",1.4,43,33,1251,223,486,223,484,0,2,70,123,130,275,405,44,30,23,72,126,516,11.23
6729,"Danny Young\youngda01","1992-93",30,"DET","NBA",1.4,65,2,836,69,167,47,99,22,68,28,32,13,34,47,119,31,5,30,36,188,3.6
6730,"Nick Young\youngni01","2009-10",24,"WAS","NBA",1.4,74,23,1421,233,558,164,388,69,170,104,130,20,82,102,48,28,8,56,147,639,5.94
6731,"Cole Aldrich\aldrico01","2016-17",28,"MIN","NBA",1.3,62,0,531,45,86,45,86,0,0,15,22,51,107,158,25,25,23,17,85,105,2.93
6732,"Chris Andersen\anderch01","2015-16",37,"TOT","NBA",1.3,27,15,402,38,72,34,58,4,14,25,36,36,62,98,12,15,13,9,29,105,5.08
6733,"Chris Andersen\anderch01","2005-06",27,"NOK","NBA",1.3,32,2,570,56,98,56,98,0,0,49,103,61,94,155,6,8,41,26,84,161,6.13
6734,"David Andersen\anderda03","2009-10",29,"HOU","NBA",1.3,63,0,891,147,340,120,262,27,78,46,67,54,154,208,44,15,12,37,119,367,5.03
6735,"Derek Anderson\anderde01","2004-05",30,"POR","NBA",1.3,47,32,1239,152,391,94,240,58,151,70,87,25,103,128,143,36,4,70,89,432,8.56
6736,"B.J. Armstrong\armstbj01","1996-97",29,"GSW","NBA",1.3,49,17,1020,148,327,123,237,25,90,68,79,7,67,74,126,25,2,53,56,389,7.33
6737,"Carlos Arroyo\arroyca01","2004-05",25,"TOT","NBA",1.3,70,16,1448,167,429,159,399,8,30,119,149,26,78,104,280,44,4,107,143,461,7.14
6738,"Jeff Ayres\pendeje02","2009-10",22,"POR","NBA",1.3,39,4,405,43,65,43,65,0,0,18,20,25,73,98,1,7,16,12,76,104,3.41
6739,"Renaldo Balkman\balkmre01","2007-08",23,"NYK","NBA",1.3,65,0,952,91,186,90,174,1,12,41,95,83,133,216,40,44,30,37,132,224,4.43
6740,"J.J. Barea\bareajo01","2016-17",32,"DAL","NBA",1.3,35,6,771,142,343,89,195,53,148,44,51,9,75,84,193,14,1,63,30,381,10.81
6741,"Will Barton\bartowi01","2014-15",24,"TOT","NBA",1.3,58,0,983,150,353,127,268,23,85,74,94,26,136,162,81,48,19,61,70,397,6.63
6742,"Charlie Bell\bellch01","2007-08",28,"MIL","NBA",1.3,68,5,1628,185,486,111,269,74,217,70,87,31,136,167,210,52,2,76,121,514,7.47
6743,"Mike Bibby\bibbymi01","1998-99",20,"VAN","NBA",1.3,50,50,1758,260,605,245,531,15,74,127,169,30,106,136,325,78,5,146,122,662,13.78
6744,"Andris Biedriņš\biedran01","2011-12",25,"GSW","NBA",1.3,47,35,739,39,64,39,64,0,0,1,9,45,131,176,16,23,45,14,125,79,3.89
6745,"Chauncey Billups\billuch01","2012-13",36,"LAC","NBA",1.3,22,22,418,53,132,20,42,33,90,45,48,2,30,32,49,12,1,26,25,184,7.79
6746,"Keith Bogans\boganke01","2003-04",23,"ORL","NBA",1.3,73,36,1787,183,454,116,267,67,187,65,103,106,211,317,98,46,10,75,128,498,6.67
6747,"Anthony Bowie\bowiean01","1993-94",30,"ORL","NBA",1.3,70,0,948,139,289,138,271,1,18,41,49,29,91,120,102,32,12,58,81,320,4.71
6748,"MarShon Brooks\brookma01","2012-13",24,"BRK","NBA",1.3,73,2,912,155,335,140,280,15,55,69,94,32,72,104,76,34,16,69,93,394,4.82
6749,"Chucky Brown\brownch01","1999-00",31,"TOT","NBA",1.3,63,29,1096,148,328,146,318,2,10,36,52,35,132,167,66,20,18,45,114,334,4.81
6750,"Derrick Brown\brownde04","2009-10",22,"CHA","NBA",1.3,57,0,535,68,147,66,140,2,7,48,72,31,47,78,19,21,10,19,53,186,3.04
6751,"Chase Budinger\budinch01","2014-15",26,"MIN","NBA",1.3,67,4,1286,169,390,117,247,52,143,67,81,33,165,198,64,44,10,49,72,457,6.28
6752,"Rasual Butler\butlera01","2015-16",36,"SAS","NBA",1.3,46,0,432,49,104,34,55,15,49,11,16,3,53,56,24,13,23,8,11,124,2.98
6753,"Will Bynum\bynumwi01","2008-09",26,"DET","NBA",1.3,57,1,803,156,342,153,323,3,19,95,119,19,56,75,157,34,2,76,85,410,6.99
6754,"Žarko Čabarkapa\cabarza01","2004-05",23,"TOT","NBA",1.3,40,0,475,86,177,73,141,13,36,53,65,35,67,102,25,10,5,30,59,238,5.39
6755,"Rodney Carney\carnero01","2006-07",22,"PHI","NBA",1.3,67,35,1169,182,392,157,320,25,72,53,87,39,89,128,26,38,23,43,118,442,5.23
6756,"Michael Carter-Williams\cartemi01","2013-14",22,"PHI","NBA",1.3,70,70,2414,427,1054,372,846,55,208,258,367,101,336,437,441,130,43,247,213,1167,17.14
6757,"Bill Cartwright\cartwbi01","1993-94",36,"CHI","NBA",1.3,42,41,780,98,191,98,191,0,0,39,57,43,109,152,57,8,8,50,83,235,5.9
6758,"Omri Casspi\casspom01","2018-19",30,"MEM","NBA",1.3,36,0,520,86,161,71,118,15,43,39,58,17,98,115,26,20,9,23,35,226,6.41
6759,"Duane Causwell\causwdu01","1995-96",27,"SAC","NBA",1.3,73,26,1044,90,216,90,215,0,1,70,96,86,162,248,20,27,78,53,173,250,4.37
6760,"Cedric Ceballos\cebalce01","2000-01",31,"TOT","NBA",1.3,40,0,559,101,229,79,156,22,73,37,43,34,72,106,20,16,7,32,61,261,5.4
6761,"Maurice Cheeks\cheekma01","1992-93",36,"NJN","NBA",1.3,35,0,510,51,93,51,91,0,2,24,27,5,37,42,107,33,2,33,35,126,5.89
6762,"Jarron Collins\collija03","2006-07",28,"UTA","NBA",1.3,82,9,913,75,170,75,170,0,0,54,83,71,100,171,60,13,8,37,147,204,2.83
6763,"Allen Crabbe\crabbal01","2014-15",22,"POR","NBA",1.3,51,9,683,63,153,33,68,30,85,12,16,7,66,73,39,19,15,15,74,168,3.34
6764,"Chris Crawford\crawfch01","1998-99",23,"ATL","NBA",1.3,42,30,784,110,255,99,222,11,33,57,70,37,53,90,24,10,13,48,106,288,5.24
6765,"Jamal Crawford\crawfja01","2017-18",37,"MIN","NBA",1.3,80,0,1653,308,742,204,428,104,314,102,113,21,78,99,185,40,9,95,85,822,7.96
6766,"Austin Croshere\croshau01","2006-07",31,"DAL","NBA",1.3,61,2,727,78,222,52,131,26,91,45,52,33,153,186,44,14,6,33,68,227,3.66
6767,"John Crotty\crottjo01","1995-96",26,"CLE","NBA",1.3,58,4,617,51,114,43,87,8,27,62,72,20,34,54,102,22,6,51,60,172,3.93
6768,"Vonteego Cummings\cummivo01","1999-00",23,"GSW","NBA",1.3,75,11,1793,265,655,216,504,49,151,127,169,57,127,184,247,91,13,132,174,706,9.11
6769,"Marquis Daniels\daniema01","2008-09",28,"IND","NBA",1.3,54,43,1700,311,689,293,599,18,90,93,129,80,168,248,114,62,26,94,120,733,11.48
6770,"Marquis Daniels\daniema01","2009-10",29,"BOS","NBA",1.3,51,4,937,124,249,118,221,6,28,34,56,27,68,95,66,27,6,42,91,288,5.29
6771,"Troy Daniels\danietr01","2016-17",25,"MEM","NBA",1.3,67,3,1183,185,495,47,140,138,355,43,54,22,78,100,46,20,4,45,90,551,5.51
6772,"Dale Davis\davisda01","2006-07",37,"DET","NBA",1.3,46,6,464,33,74,33,74,0,0,17,26,59,78,137,12,10,34,15,59,83,3
6773,"Austin Daye\dayeau01","2009-10",21,"DET","NBA",1.3,69,4,915,137,295,108,200,29,95,46,56,34,140,174,34,25,26,48,114,349,4.78
6774,"Nando De Colo\decolna01","2012-13",25,"SAS","NBA",1.3,72,6,920,105,241,74,159,31,82,35,44,23,115,138,138,41,6,81,87,276,4.76
6775,"Tony Delk\delkto01","1999-00",26,"SAC","NBA",1.3,46,1,682,120,279,111,239,9,40,47,59,36,52,88,55,35,5,32,58,296,5.57
6776,"Bryce Drew\drewbr01","1999-00",25,"HOU","NBA",1.3,72,5,1293,158,413,99,250,59,163,45,53,23,80,103,162,41,1,66,79,420,5.38
6777,"Chris Duhon\duhonch01","2011-12",29,"ORL","NBA",1.3,63,9,1226,85,203,35,84,50,119,17,21,14,88,102,151,35,9,81,71,237,5
6778,"Howard Eisley\eisleho01","1998-99",26,"UTA","NBA",1.3,50,0,1038,140,314,119,264,21,50,67,80,12,82,94,185,30,2,109,122,368,7.95
6779,"Monta Ellis\ellismo01","2009-10",24,"GSW","NBA",1.3,64,64,2647,631,1406,554,1178,77,228,292,388,47,210,257,340,143,25,244,189,1631,21.28
6780,"Jeremy Evans\evansje01","2014-15",27,"UTA","NBA",1.3,38,0,266,32,58,30,53,2,5,24,29,26,45,71,13,11,12,5,29,90,3.08
6781,"Reggie Evans\evansre01","2010-11",30,"TOR","NBA",1.3,30,18,798,42,103,42,102,0,1,48,88,119,226,345,38,29,6,39,89,132,8.62
6782,"Reggie Evans\evansre01","2011-12",31,"LAC","NBA",1.3,56,0,771,34,72,34,72,0,0,36,71,100,171,271,17,31,6,44,118,104,3.73
6783,"Kenneth Faried\farieke01","2017-18",28,"DEN","NBA",1.3,32,7,461,76,148,76,147,0,1,36,51,68,85,153,18,12,13,23,51,188,6.37
6784,"Greg Foster\fostegr01","1997-98",29,"UTA","NBA",1.3,78,49,1446,186,418,184,409,2,9,67,87,85,188,273,51,15,28,68,187,441,5.06
6785,"Adonal Foyle\foylead01","2007-08",32,"ORL","NBA",1.3,82,0,774,70,153,70,153,0,0,16,34,71,137,208,18,16,45,32,94,156,2.6
6786,"Langston Galloway\gallola01","2014-15",23,"NYK","NBA",1.3,45,41,1457,204,511,142,335,62,176,63,78,37,153,190,150,52,12,61,129,533,10.94
6787,"Langston Galloway\gallola01","2016-17",25,"TOT","NBA",1.3,74,2,1495,207,545,87,237,120,308,51,64,27,129,156,93,46,6,46,96,585,6.2
6788,"Francisco García\garcifr01","2012-13",31,"TOT","NBA",1.3,58,20,1029,118,300,51,121,67,179,18,21,8,83,91,63,46,38,32,88,321,5.35
6789,"Mickaël Gelabale\gelabmi01","2006-07",23,"SEA","NBA",1.3,70,14,1239,122,264,111,217,11,47,66,82,59,114,173,56,24,22,49,108,321,4.66
6790,"Devean George\georgde01","2009-10",32,"GSW","NBA",1.3,45,4,761,89,206,41,83,48,123,16,23,21,93,114,32,41,10,15,89,242,5.48
6791,"Joey Graham\grahajo01","2005-06",23,"TOR","NBA",1.3,80,24,1581,198,414,169,327,29,87,108,133,57,187,244,60,37,13,92,228,533,6.23
6792,"Danny Granger\grangda01","2013-14",30,"TOT","NBA",1.3,41,2,847,116,307,73,179,43,128,63,67,31,102,133,41,12,17,46,62,338,6.68
6793,"Gary Grant\grantga01","1993-94",28,"LAC","NBA",1.3,78,8,1533,253,563,236,501,17,62,65,76,42,100,142,291,119,12,136,139,588,8.7
6794,"Aaron Gray\grayaa01","2008-09",24,"CHI","NBA",1.3,56,18,715,81,167,81,166,0,1,34,59,84,136,220,46,14,18,40,135,196,4.43
6795,"Gerald Green\greenge01","2012-13",27,"IND","NBA",1.3,60,7,1080,155,424,96,236,59,188,52,65,31,110,141,50,19,23,53,64,421,5.13
6796,"Adrian Griffin\griffad01","2006-07",32,"CHI","NBA",1.3,54,1,585,61,129,61,123,0,6,15,19,40,69,109,59,32,4,38,78,137,3.5
6797,"Adrian Griffin\griffad01","2004-05",30,"CHI","NBA",1.3,69,1,667,58,161,56,152,2,9,33,44,52,94,146,53,43,4,30,78,151,2.88
6798,"Richard Hamilton\hamilri01","2011-12",33,"CHI","NBA",1.3,28,28,697,140,310,123,264,17,46,29,37,20,46,66,84,12,1,49,56,326,9.28
6799,"Lucious Harris\harrilu01","2004-05",34,"CLE","NBA",1.3,73,4,1128,118,299,97,234,21,65,56,69,39,82,121,49,27,6,29,68,313,3.56
6800,"Scott Hastings\hastisc01","1992-93",32,"DEN","NBA",1.3,76,0,670,57,112,55,104,2,8,40,55,44,93,137,34,12,8,29,115,156,2.51
6801,"Alan Henderson\hendeal01","2005-06",33,"CLE","NBA",1.3,51,3,531,47,91,47,91,0,0,33,49,60,77,137,10,9,12,22,58,127,3.04
6802,"Alan Henderson\hendeal01","1996-97",24,"ATL","NBA",1.3,30,0,501,77,162,77,162,0,0,45,75,47,69,116,23,21,6,29,73,199,6.4
6803,"Buddy Hield\hieldbu01","2016-17",24,"TOT","NBA",1.3,82,55,1888,327,767,179,388,148,379,64,76,35,234,269,121,38,9,101,115,866,8.44
6804,"Fred Hoiberg\hoibefr01","2002-03",30,"CHI","NBA",1.3,63,0,784,49,126,44,105,5,21,41,50,11,126,137,70,40,5,25,59,144,3.48
6805,"Justin Holiday\holidju01","2014-15",25,"GSW","NBA",1.3,59,4,657,91,235,56,126,35,109,37,45,12,61,73,48,40,12,29,54,254,3.96
6806,"Ryan Hollins\holliry01","2013-14",29,"LAC","NBA",1.3,61,0,482,53,72,53,72,0,0,35,56,31,59,90,8,9,31,29,87,141,2.88
6807,"Al Horford\horfoal01","2011-12",25,"ATL","NBA",1.3,11,11,348,57,103,57,102,0,1,22,30,26,51,77,24,10,14,16,21,136,13.72
6808,"Stephen Howard\howarst01","1996-97",26,"TOT","NBA",1.3,49,0,418,62,108,62,108,0,0,52,81,29,56,85,11,19,12,25,62,176,3.73
6809,"Troy Hudson\hudsotr01","2004-05",28,"MIN","NBA",1.3,79,32,1729,266,664,177,406,89,258,70,90,19,86,105,283,27,6,113,121,691,7.54
6810,"Chris Hunter\huntech01","2009-10",25,"GSW","NBA",1.3,60,9,783,109,217,109,213,0,4,52,69,56,111,167,37,13,35,30,132,270,4.75
6811,"Lindsey Hunter\hunteli01","2006-07",36,"DET","NBA",1.3,52,0,745,94,244,56,125,38,119,30,33,9,38,47,93,34,7,35,56,256,4.7
6812,"Marc Jackson\jacksma02","2003-04",29,"PHI","NBA",1.3,22,13,598,71,171,71,170,0,1,64,81,45,81,126,18,12,6,24,45,206,8.5
6813,"Yi Jianlian\jianlyi01","2009-10",22,"NJN","NBA",1.3,52,51,1655,227,563,212,522,15,41,154,193,115,257,372,47,37,52,77,170,623,10.75
6814,"Alexander Johnson\johnsal01","2006-07",23,"MEM","NBA",1.3,59,19,753,91,169,91,169,0,0,78,118,50,131,181,17,25,35,47,137,260,5.02
6815,"DerMarr Johnson\johnsde03","2005-06",25,"DEN","NBA",1.3,58,21,924,132,306,76,146,56,160,34,42,19,77,96,55,25,26,46,86,354,5.34
6816,"Ervin Johnson\johnser02","1994-95",27,"SEA","NBA",1.3,64,30,907,85,192,85,191,0,1,29,46,101,188,289,16,17,67,54,163,199,4.41
6817,"James Johnson\johnsja01","2015-16",28,"TOR","NBA",1.3,57,32,926,114,240,94,174,20,66,39,68,28,98,126,67,29,33,54,84,287,5.31
6818,"Wesley Johnson\johnswe01","2010-11",23,"MIN","NBA",1.3,79,63,2069,271,682,168,393,103,289,64,92,51,189,240,148,58,54,95,163,709,7.9
6819,"DeAndre Jordan\jordade01","2008-09",20,"LAC","NBA",1.3,53,13,771,93,147,93,147,0,0,42,109,72,165,237,11,11,59,41,96,228,5.48
6820,"Jason Kapono\kaponja01","2004-05",23,"CHA","NBA",1.3,81,14,1491,269,671,189,477,80,194,70,85,32,132,164,61,40,6,46,132,688,5.83
6821,"Viktor Khryapa\khryavi01","2005-06",23,"POR","NBA",1.3,69,53,1492,158,342,148,312,10,30,77,111,114,193,307,88,50,29,84,209,403,6.78
6822,"Andrei Kirilenko\kirilan01","2013-14",32,"BRK","NBA",1.3,45,4,857,82,160,81,155,1,5,61,119,55,91,146,72,40,19,54,65,226,6.35
6823,"Brandon Knight\knighbr03","2011-12",20,"DET","NBA",1.3,66,60,2129,319,769,214,493,105,276,104,137,33,178,211,251,49,10,171,154,847,11.2
6824,"Kosta Koufos\koufoko01","2008-09",19,"UTA","NBA",1.3,48,7,565,94,185,94,185,0,0,36,51,50,88,138,20,12,31,26,70,224,4.77
6825,"Skal Labissière\labissk01","2016-17",20,"SAC","NBA",1.3,33,12,612,117,218,114,210,3,8,52,74,51,111,162,27,16,13,37,64,289,8.58
6826,"Joffrey Lauvergne\lauvejo01","2017-18",26,"SAS","NBA",1.3,55,1,534,98,190,98,185,0,5,30,47,63,108,171,41,9,3,33,45,226,4.25
6827,"Alex Len\lenal01","2015-16",22,"PHO","NBA",1.3,78,46,1821,264,624,263,617,1,7,174,239,178,416,594,97,38,62,145,230,703,9.39
6828,"Jon Leuer\leuerjo01","2014-15",25,"MEM","NBA",1.3,63,6,824,121,273,114,244,7,29,37,59,50,157,207,46,17,9,35,86,286,4.33
6829,"Shaun Livingston\livinsh01","2005-06",20,"LAC","NBA",1.3,61,14,1525,149,349,148,341,1,8,53,77,41,142,183,273,46,32,111,160,352,8.04
6830,"Shaun Livingston\livinsh01","2011-12",26,"MIL","NBA",1.3,58,27,1092,127,271,125,268,2,3,62,79,39,84,123,122,27,20,66,79,318,6
6831,"Brad Lohaus\lohaubr01","1995-96",31,"TOT","NBA",1.3,55,8,598,71,175,20,53,51,122,4,5,7,57,64,44,10,17,20,70,197,3.29
6832,"Luc Longley\longllu01","1999-00",31,"PHO","NBA",1.3,72,68,1417,186,399,186,399,0,0,80,97,100,223,323,77,22,42,136,221,452,6.59
6833,"Kevin Love\loveke01","2018-19",30,"CLE","NBA",1.3,22,21,598,109,283,56,136,53,147,103,114,33,206,239,48,6,5,42,54,374,16.08
6834,"Sam Mack\macksa01","1996-97",26,"HOU","NBA",1.3,52,10,904,105,262,58,120,47,142,35,42,20,86,106,58,29,6,42,67,292,5.08
6835,"Shelvin Mack\macksh01","2014-15",24,"ATL","NBA",1.3,55,0,833,117,292,77,165,40,127,25,31,8,71,79,155,30,2,49,32,299,5.65
6836,"Shelvin Mack\macksh01","2015-16",25,"TOT","NBA",1.3,52,27,1058,182,415,143,290,39,125,45,61,13,115,128,187,34,3,95,72,448,8.5
6837,"Jamaal Magloire\magloja01","2008-09",30,"MIA","NBA",1.3,55,12,709,65,131,65,131,0,0,29,60,82,140,222,22,11,25,32,121,159,3.88
6838,"Thon Maker\makerth01","2016-17",19,"MIL","NBA",1.3,57,34,562,83,181,55,107,28,74,32,49,40,74,114,23,10,26,17,84,226,3.78
6839,"Jeff Malone\malonje01","1994-95",33,"PHI","NBA",1.3,19,19,660,144,284,133,256,11,28,51,59,11,44,55,29,15,0,29,35,350,13.84
6840,"Donyell Marshall\marshdo01","1996-97",23,"GSW","NBA",1.3,61,20,1022,174,421,139,310,35,111,61,98,92,184,276,54,25,46,55,96,444,6.71
6841,"Donyell Marshall\marshdo01","1995-96",22,"GSW","NBA",1.3,62,6,934,125,314,97,220,28,94,64,83,65,148,213,49,22,31,48,83,342,5.29
6842,"Cartier Martin\martica01","2013-14",29,"TOT","NBA",1.3,59,6,870,111,264,52,113,59,151,48,65,13,97,110,33,27,7,34,71,329,4.76
6843,"Darrick Martin\martida01","1999-00",28,"SAC","NBA",1.3,71,1,893,133,350,95,226,38,124,98,119,7,37,44,122,28,2,62,89,402,4.71
6844,"Jarell Martin\martija01","2017-18",23,"MEM","NBA",1.3,73,36,1661,221,496,187,398,34,98,89,116,97,221,318,73,39,49,86,211,565,7.49
6845,"Tony Massenburg\masseto01","1997-98",30,"VAN","NBA",1.3,61,13,894,148,309,148,309,0,0,100,137,80,152,232,21,25,24,60,123,396,6.12
6846,"Bob McCann\mccanbo01","1992-93",28,"MIN","NBA",1.3,79,7,1536,200,410,200,408,0,2,95,152,92,190,282,68,51,58,79,202,495,6.55
6847,"Mitch McGary\mcgarmi01","2014-15",22,"OKC","NBA",1.3,32,2,485,88,165,88,163,0,2,25,40,53,112,165,14,16,16,31,72,201,6.8
6848,"Salah Mejri\mejrisa01","2015-16",29,"DAL","NBA",1.3,34,6,397,49,78,49,77,0,1,27,46,41,82,123,10,8,36,23,54,125,5.05
6849,"Ron Mercer\mercero01","2002-03",26,"IND","NBA",1.3,72,3,1671,244,597,241,581,3,16,65,81,32,122,154,112,49,14,54,123,556,5.95
6850,"Ron Mercer\mercero01","1998-99",22,"BOS","NBA",1.3,41,40,1551,305,707,300,677,5,30,83,105,37,118,155,104,67,12,89,81,698,12.84
6851,"Chris Mihm\mihmch01","2000-01",21,"CLE","NBA",1.3,59,43,1166,173,391,173,390,0,1,100,126,106,174,280,16,20,53,80,156,446,6.97
6852,"Darius Miles\milesda01","2004-05",23,"POR","NBA",1.3,63,22,1699,336,697,328,674,8,23,129,215,71,228,299,129,75,78,157,189,809,12.07
6853,"Eric Mobley\mobleer01","1994-95",24,"MIL","NBA",1.3,46,26,587,78,132,76,130,2,2,22,45,55,98,153,21,8,27,24,63,180,4.62
6854,"Nazr Mohammed\mohamna01","2011-12",34,"OKC","NBA",1.3,63,1,692,79,169,79,168,0,1,13,23,59,111,170,14,20,37,26,101,171,3.24
6855,"Eric Montross\montrer01","1998-99",27,"DET","NBA",1.3,46,2,577,42,80,42,79,0,1,11,32,45,94,139,14,12,27,16,107,95,3.12
6856,"Eric Montross\montrer01","1995-96",24,"BOS","NBA",1.3,61,59,1432,196,346,196,346,0,0,50,133,119,233,352,43,19,29,83,181,442,7.46
6857,"Gheorghe Mureșan\muresgh01","1993-94",22,"WSB","NBA",1.3,54,2,650,128,235,128,235,0,0,48,71,66,126,192,18,28,48,54,120,304,6.16
6858,"Troy Murphy\murphtr01","2003-04",23,"GSW","NBA",1.3,28,0,610,107,243,102,226,5,17,60,80,48,125,173,20,12,17,34,58,279,8.96
6859,"Jamal Murray\murraja01","2016-17",19,"DEN","NBA",1.3,82,10,1764,295,730,180,386,115,344,106,120,41,173,214,170,51,24,113,124,811,8.35
6860,"Lamond Murray\murrala01","2004-05",31,"TOR","NBA",1.3,62,1,918,132,310,86,205,46,105,61,80,44,120,164,47,32,16,54,85,371,5.5
6861,"Ronald Murray\murraro01","2006-07",27,"DET","NBA",1.3,69,18,1477,177,438,153,355,24,83,87,120,26,87,113,187,49,13,90,96,465,6.52
6862,"Pete Myers\myerspe01","1994-95",31,"CHI","NBA",1.3,71,14,1270,119,287,109,248,10,39,70,114,57,82,139,148,58,15,88,125,318,5.28
6863,"Tyrone Nesby\nesbyty01","1999-00",24,"LAC","NBA",1.3,73,39,2317,364,915,270,634,94,281,151,191,82,193,275,121,75,31,102,205,973,10.32
6864,"Georges Niang\niangge01","2018-19",25,"UTA","NBA",1.3,59,0,516,86,181,43,76,43,105,20,24,11,76,87,35,10,6,23,57,235,3.64
6865,"Andrés Nocioni\nocioan01","2009-10",30,"SAC","NBA",1.3,75,28,1477,234,587,138,338,96,249,71,99,32,190,222,75,32,26,67,160,635,6.64
6866,"Andrés Nocioni\nocioan01","2010-11",31,"PHI","NBA",1.3,54,17,931,118,277,76,159,42,118,49,61,19,150,169,45,14,15,47,100,327,5.54
6867,"Nerlens Noel\noelne01","2017-18",23,"DAL","NBA",1.3,30,6,472,55,105,55,104,0,1,21,28,48,120,168,20,31,22,26,59,131,6.81
6868,"Victor Oladipo\oladivi01","2013-14",21,"ORL","NBA",1.3,80,44,2487,392,936,318,710,74,226,248,318,43,286,329,327,129,37,256,210,1106,13.69
6869,"Greg Ostertag\ostergr01","2005-06",32,"UTA","NBA",1.3,60,22,807,61,124,61,124,0,0,24,48,82,143,225,58,6,66,46,129,146,4.28
6870,"Jannero Pargo\pargoja01","2011-12",32,"ATL","NBA",1.3,50,0,671,105,253,52,115,53,138,19,20,9,64,73,96,20,2,49,64,282,5.29
6871,"Jabari Parker\parkeja01","2014-15",19,"MIL","NBA",1.3,25,25,738,129,263,125,247,4,16,46,66,50,88,138,42,31,5,47,42,308,11.46
6872,"Gary Payton\paytoga01","2006-07",38,"MIA","NBA",1.3,68,28,1503,144,366,112,243,32,123,38,57,18,114,132,201,43,3,66,117,358,5.74
6873,"Elliot Perry\perryel01","1997-98",28,"MIL","NBA",1.3,81,33,1752,241,561,224,511,17,50,92,109,21,87,108,230,90,2,128,129,591,7.2
6874,"Wesley Person\persowe01","2003-04",32,"TOT","NBA",1.3,58,0,1037,126,314,71,176,55,138,31,39,16,101,117,66,19,9,38,38,338,4.89
6875,"Mickaël Piétrus\pietrmi01","2010-11",28,"TOT","NBA",1.3,57,4,1107,143,365,58,129,85,236,39,57,15,111,126,33,29,21,39,101,410,5.64
6876,"Mark Pope\popema01","2000-01",28,"MIL","NBA",1.3,63,45,942,62,142,57,118,5,24,22,35,56,91,147,38,16,26,17,140,151,3.03
6877,"Zach Randolph\randoza01","2005-06",24,"POR","NBA",1.3,74,71,2545,536,1229,520,1174,16,55,245,343,193,399,592,144,57,14,165,185,1333,14.22
6878,"Željko Rebrača\rebraze01","2002-03",30,"DET","NBA",1.3,30,12,488,80,145,80,145,0,0,38,48,27,65,92,9,6,17,29,79,198,6.18
6879,"Quentin Richardson\richaqu01","2011-12",31,"ORL","NBA",1.3,48,3,866,74,197,32,76,42,121,25,30,15,108,123,38,28,6,29,74,215,4.43
6880,"Quentin Richardson\richaqu01","2010-11",30,"ORL","NBA",1.3,57,19,955,87,255,45,109,42,146,33,44,39,139,178,38,25,5,33,74,249,3.99
6881,"Rajon Rondo\rondora01","2018-19",32,"LAL","NBA",1.3,46,29,1369,175,432,124,290,51,142,23,36,34,209,243,367,57,7,127,100,424,13.1
6882,"Clifford Rozier\roziecl01","1994-95",22,"GSW","NBA",1.3,66,34,1494,189,390,187,383,2,7,68,152,200,286,486,45,35,39,89,196,448,7.65
6883,"Damjan Rudež\rudezda01","2014-15",28,"IND","NBA",1.3,68,2,1047,119,263,50,93,69,170,16,23,8,39,47,53,16,5,47,79,323,3.81
6884,"D'Angelo Russell\russeda01","2016-17",20,"LAL","NBA",1.3,63,60,1811,351,867,216,483,135,384,147,188,31,190,221,303,87,16,176,130,984,14.28
6885,"Brian Shaw\shawbr01","1994-95",28,"ORL","NBA",1.3,78,9,1836,192,494,144,310,48,184,70,95,52,189,241,406,73,18,184,184,502,8.84
6886,"Ish Smith\smithis01","2015-16",27,"TOT","NBA",1.3,77,53,2239,397,967,341,797,56,170,122,176,43,262,305,502,88,24,175,133,972,13.12
6887,"Tony Smith\smithto02","1994-95",26,"LAL","NBA",1.3,61,4,1024,132,309,100,218,32,91,44,63,43,64,107,102,46,7,50,111,340,5.48
6888,"Tony Smith\smithto02","1995-96",27,"TOT","NBA",1.3,59,3,938,116,274,78,158,38,116,28,46,30,65,95,154,37,10,66,106,298,5.68
6889,"Eric Snow\snower01","1997-98",24,"TOT","NBA",1.3,64,0,918,79,184,77,167,2,17,49,71,19,62,81,177,60,5,63,114,209,5.04
6890,"Darius Songaila\songada01","2009-10",31,"NOH","NBA",1.3,75,1,1410,241,488,240,482,1,6,60,74,59,173,232,70,62,14,81,206,543,6.74
6891,"Felton Spencer\spencfe01","1996-97",29,"TOT","NBA",1.3,73,65,1558,139,284,139,284,0,0,94,161,157,259,416,22,34,50,88,275,372,6.2
6892,"Erick Strickland\stricer01","1998-99",25,"DAL","NBA",1.3,33,2,567,89,221,71,162,18,59,53,65,12,71,83,64,40,2,36,44,249,7.41
6893,"Rod Strickland\stricro02","2003-04",37,"TOT","NBA",1.3,61,10,1197,150,353,140,317,10,36,72,98,34,121,155,244,35,11,85,76,382,7.54
6894,"Etan Thomas\thomaet01","2002-03",24,"WAS","NBA",1.3,38,0,513,61,124,61,124,0,0,60,94,70,95,165,3,8,23,33,66,182,5.22
6895,"Al Thornton\thornal01","2008-09",25,"LAC","NBA",1.3,71,67,2654,469,1051,449,972,20,79,236,313,122,246,368,103,59,62,130,227,1194,13.19
6896,"Jake Tsakalidis\tsakaja01","2000-01",21,"PHO","NBA",1.3,57,39,947,101,215,101,215,0,0,54,91,83,159,242,19,10,55,66,137,256,5.08
6897,"Ime Udoka\udokaim01","2008-09",31,"SAS","NBA",1.3,67,3,1035,110,287,69,162,41,125,28,46,28,159,187,54,36,12,38,86,289,4.21
6898,"Beno Udrih\udrihbe01","2016-17",34,"DET","NBA",1.3,39,0,560,92,197,81,165,11,32,32,34,6,51,57,131,13,0,36,29,227,6.48
6899,"Beno Udrih\udrihbe01","2005-06",23,"SAS","NBA",1.3,54,3,586,106,233,82,163,24,70,39,50,18,34,52,92,14,2,53,55,275,4.64
6900,"Gerald Wallace\wallage01","2013-14",31,"BOS","NBA",1.3,58,16,1416,116,230,97,166,19,64,47,101,36,176,212,143,73,14,97,79,298,7.41
6901,"Martell Webster\webstma02","2006-07",20,"POR","NBA",1.3,82,27,1759,195,492,104,242,91,250,93,132,43,197,240,52,35,19,76,126,574,5.76
6902,"Sonny Weems\weemsso01","2009-10",23,"TOR","NBA",1.3,69,19,1368,236,458,234,443,2,15,44,64,42,150,192,101,39,25,65,126,518,7.07
6903,"Delonte West\westde01","2007-08",24,"TOT","NBA",1.3,61,31,1533,196,475,148,340,48,135,67,91,31,162,193,229,59,29,117,103,507,9.18
6904,"Chris Whitney\whitnch01","1995-96",24,"WSB","NBA",1.3,21,0,335,45,99,26,55,19,44,41,44,2,31,33,51,18,1,23,46,150,7.86
6905,"Chris Wilcox\wilcoch01","2004-05",22,"LAC","NBA",1.3,54,25,1005,169,329,169,329,0,0,88,144,63,165,228,38,26,24,77,129,426,7.44
6906,"Chris Wilcox\wilcoch01","2011-12",29,"BOS","NBA",1.3,28,4,481,64,107,64,107,0,0,24,39,38,84,122,12,11,9,30,64,152,6.11
6907,"Alvin Williams\willial02","1997-98",23,"TOT","NBA",1.3,54,13,1071,125,282,116,254,9,28,65,90,24,57,81,103,38,3,58,79,324,5.76
6908,"Jordan Williams\willijo03","2011-12",21,"NJN","NBA",1.3,43,5,635,77,152,77,152,0,0,43,66,66,90,156,11,21,15,23,61,197,4.97
6909,"Monty Williams\willimo01","2000-01",29,"ORL","NBA",1.3,82,0,1211,162,364,161,351,1,13,85,133,86,157,243,79,29,16,85,136,410,4.8
6910,"David Wood\woodda01","1995-96",31,"TOT","NBA",1.3,62,0,772,75,174,55,112,20,62,38,50,51,103,154,34,19,10,24,150,208,3.59
6911,"Qyntel Woods\woodsqy01","2005-06",24,"NYK","NBA",1.3,49,16,1013,129,254,107,194,22,60,49,76,44,146,190,47,32,13,61,96,329,6.98
6912,"Metta World Peace\artesro01","2004-05",25,"IND","NBA",1.3,7,7,291,59,119,52,102,7,17,47,51,8,37,45,22,12,6,17,27,172,22.9
6913,"Brandan Wright\wrighbr03","2017-18",30,"TOT","NBA",1.3,28,1,381,59,102,59,102,0,0,21,33,33,62,95,13,13,26,8,32,139,5.88
6914,"Sharone Wright\wrighsh01","1995-96",23,"TOT","NBA",1.3,57,38,1434,248,512,247,509,1,3,167,259,148,208,356,38,30,49,109,163,664,10.55
6915,"Cole Aldrich\aldrico01","2013-14",25,"NYK","NBA",1.2,46,2,330,33,61,33,61,0,0,26,30,37,92,129,14,8,30,18,40,92,3.29
6916,"Rafer Alston\alstora01","2002-03",26,"TOR","NBA",1.2,47,4,980,139,335,88,205,51,130,37,54,21,86,107,192,38,15,86,120,366,8.64
6917,"Justin Anderson\anderju01","2017-18",24,"PHI","NBA",1.2,38,0,519,87,202,53,99,34,103,28,38,25,68,93,25,15,7,16,54,236,5.26
6918,"Shandon Anderson\andersh01","1996-97",23,"UTA","NBA",1.2,65,0,1066,147,318,123,271,24,47,68,99,52,127,179,49,27,8,73,113,386,5.36
6919,"Giannis Antetokounmpo\antetgi01","2013-14",19,"MIL","NBA",1.2,77,23,1897,173,418,132,300,41,118,138,202,78,261,339,150,60,61,122,173,525,8.04
6920,"Joel Anthony\anthojo01","2014-15",32,"DET","NBA",1.2,49,0,406,36,62,36,62,0,0,15,22,32,61,93,5,12,49,12,55,87,2.9
6921,"Joel Anthony\anthojo01","2012-13",30,"MIA","NBA",1.2,62,3,566,35,68,35,68,0,0,17,28,45,70,115,13,13,42,22,49,87,2.36
6922,"Hilton Armstrong\armsthi01","2006-07",22,"NOK","NBA",1.2,56,5,634,68,125,68,125,0,0,40,67,58,91,149,10,12,26,35,79,176,3.6
6923,"Stacey Augmon\augmost01","2002-03",34,"NOH","NBA",1.2,70,3,862,79,192,79,185,0,7,54,72,26,93,119,69,27,9,40,80,212,3.3
6924,"D.J. Augustin\augusdj01","2016-17",29,"ORL","NBA",1.2,78,20,1538,195,517,100,243,95,274,131,161,15,102,117,209,31,1,90,101,616,6.99
6925,"Isaac Austin\austiis01","1998-99",29,"ORL","NBA",1.2,49,49,1259,185,453,183,446,2,7,105,157,83,154,237,89,47,35,114,125,477,9.01
6926,"Gustavo Ayón\ayongu01","2012-13",27,"TOT","NBA",1.2,55,3,734,92,167,92,167,0,0,20,50,60,139,199,71,22,17,47,107,204,5
6927,"Jeff Ayres\pendeje02","2014-15",27,"SAS","NBA",1.2,51,0,383,55,95,55,95,0,0,27,36,37,80,117,14,8,8,26,60,137,3.12
6928,"Kelenna Azubuike\azubuke01","2006-07",23,"GSW","NBA",1.2,41,9,669,98,220,64,141,34,79,61,78,26,68,94,28,22,10,39,49,291,6.23
6929,"Dwayne Bacon\bacondw01","2018-19",23,"CHO","NBA",1.2,43,13,759,122,257,84,170,38,87,34,46,8,81,89,47,12,5,18,72,316,6.14
6930,"Thurl Bailey\baileth01","1992-93",31,"MIN","NBA",1.2,70,3,1276,203,446,203,446,0,0,119,142,53,162,215,61,20,47,60,88,525,6.66
6931,"J.J. Barea\bareajo01","2011-12",27,"MIN","NBA",1.2,41,11,1032,167,418,114,275,53,143,76,98,14,100,114,232,21,0,103,61,463,11.16
6932,"Will Barton\bartowi01","2018-19",28,"DEN","NBA",1.2,43,38,1189,185,460,118,264,67,196,57,74,32,167,199,124,18,22,65,82,494,10.21
6933,"Marco Belinelli\belinma01","2009-10",23,"TOR","NBA",1.2,66,1,1121,154,379,94,221,60,158,101,121,14,81,95,89,42,5,60,80,469,6.11
6934,"Andris Biedriņš\biedran01","2004-05",18,"GSW","NBA",1.2,30,1,384,45,78,45,77,0,1,19,40,47,71,118,12,12,24,12,87,109,4.95
6935,"Corie Blount\blounco01","1993-94",25,"CHI","NBA",1.2,67,8,690,76,174,76,174,0,0,46,75,76,118,194,56,19,33,52,93,198,3.79
6936,"Bruce Bowen\bowenbr01","1999-00",28,"TOT","NBA",1.2,69,2,878,72,194,45,136,27,58,25,43,27,69,96,34,23,15,19,118,196,2.57
6937,"Corey Brewer\breweco01","2015-16",29,"HOU","NBA",1.2,82,12,1669,212,552,151,328,61,224,105,140,42,157,199,109,84,19,78,168,590,6.43
6938,"Corey Brewer\breweco01","2016-17",30,"TOT","NBA",1.2,82,11,1281,147,348,120,230,27,118,50,68,32,134,166,97,61,20,55,133,371,4.74
6939,"Dillon Brooks\brookdi01","2017-18",22,"MEM","NBA",1.2,82,74,2350,340,772,246,508,94,264,124,166,49,208,257,135,73,17,124,233,898,9.26
6940,"Shannon Brown\brownsh01","2012-13",27,"PHO","NBA",1.2,59,22,1402,240,571,201,430,39,141,98,125,44,105,149,108,59,15,74,92,617,8.6
6941,"Jud Buechler\buechju01","1996-97",28,"CHI","NBA",1.2,76,0,703,58,158,40,104,18,54,5,14,45,81,126,60,23,21,27,50,139,2.34
6942,"Reggie Bullock\bullore01","2015-16",24,"DET","NBA",1.2,37,0,429,43,98,21,45,22,53,14,15,14,54,68,27,10,2,8,29,122,3.45
6943,"Caron Butler\butleca01","2010-11",30,"DAL","NBA",1.2,29,29,867,170,378,142,313,28,65,68,88,22,96,118,46,28,8,49,59,436,11.88
6944,"Jackie Butler\butleja01","2005-06",20,"NYK","NBA",1.2,55,0,740,117,215,117,215,0,0,58,77,67,116,183,25,17,31,62,127,292,5.64
6945,"Rasual Butler\butlera01","2007-08",28,"NOH","NBA",1.2,51,8,875,91,260,47,127,44,133,26,31,16,84,100,36,15,21,10,66,252,3.91
6946,"Antoine Carr\carran01","1993-94",32,"SAS","NBA",1.2,34,0,465,78,160,78,159,0,1,42,58,12,39,51,15,9,22,15,75,198,4.89
6947,"DeMarre Carroll\carrode01","2015-16",29,"TOR","NBA",1.2,26,22,786,105,270,59,152,46,118,30,50,31,91,122,27,44,6,28,63,286,9.5
6948,"Vince Carter\cartevi01","2017-18",41,"SAC","NBA",1.2,58,5,1026,114,283,57,118,57,165,28,37,18,130,148,69,42,26,36,96,313,5.6
6949,"Michael Carter-Williams\cartemi01","2015-16",24,"MIL","NBA",1.2,54,37,1649,251,555,236,500,15,55,106,162,48,228,276,281,80,41,153,162,623,13.49
6950,"Bill Cartwright\cartwbi01","1992-93",35,"CHI","NBA",1.2,63,63,1253,141,343,141,343,0,0,72,98,83,150,233,83,20,10,62,154,354,5.37
6951,"Omri Casspi\casspom01","2011-12",23,"CLE","NBA",1.2,65,35,1341,166,412,113,244,53,168,74,108,63,165,228,66,37,21,64,115,459,6.35
6952,"Duane Causwell\causwdu01","1993-94",25,"SAC","NBA",1.2,41,8,674,71,137,71,137,0,0,40,68,68,118,186,11,19,49,33,109,182,5.82
6953,"Tyler Cavanaugh\cavanty01","2017-18",23,"ATL","NBA",1.2,39,1,518,67,152,35,63,32,89,17,21,45,82,127,27,9,4,14,61,183,4.7
6954,"Calbert Cheaney\cheanca01","2001-02",30,"DEN","NBA",1.2,68,47,1631,224,466,224,462,0,4,46,67,57,183,240,110,34,21,70,156,494,6.92
6955,"Calbert Cheaney\cheanca01","1993-94",22,"WSB","NBA",1.2,65,21,1604,327,696,326,673,1,23,124,161,88,102,190,126,63,10,108,148,779,9.88
6956,"Chris Childs\childch01","1994-95",27,"NJN","NBA",1.2,53,11,1021,106,279,65,154,41,125,55,73,14,55,69,219,42,3,76,116,308,7.04
6957,"Jordan Clarkson\clarkjo01","2016-17",24,"LAL","NBA",1.2,82,19,2397,477,1071,360,715,117,356,134,168,49,197,246,213,88,8,164,150,1205,11.87
6958,"Speedy Claxton\claxtsp01","2002-03",24,"SAS","NBA",1.2,30,0,471,67,145,67,134,0,11,39,57,22,34,56,75,22,7,35,43,173,6.43
6959,"Norris Cole\coleno01","2013-14",25,"MIA","NBA",1.2,82,6,2014,207,500,147,326,60,174,53,68,17,143,160,248,77,5,127,156,527,6.97
6960,"Derrick Coleman\colemde01","2000-01",33,"CHH","NBA",1.2,34,3,683,97,255,77,204,20,51,63,92,46,138,184,39,10,21,42,53,277,7.39
6961,"Jason Collier\collija02","2003-04",26,"ATL","NBA",1.2,20,16,545,79,165,78,161,1,4,67,85,36,75,111,17,11,11,31,71,226,10.5
6962,"Dell Curry\curryde01","2001-02",37,"TOR","NBA",1.2,56,4,886,141,347,96,216,45,131,33,37,23,58,81,61,22,6,41,50,360,4.88
6963,"Hubert Davis\davishu01","1992-93",22,"NYK","NBA",1.2,50,2,815,110,251,104,232,6,19,43,54,13,43,56,83,22,4,45,71,269,4.76
6964,"Terry Dehere\deherte01","1996-97",25,"LAC","NBA",1.2,73,3,1053,148,383,96,223,52,160,122,148,15,80,95,158,27,3,96,142,470,5.87
6965,"Sam Dekker\dekkesa01","2017-18",23,"LAC","NBA",1.2,73,1,883,128,259,118,199,10,60,37,56,44,130,174,38,24,9,33,71,303,4
6966,"Matthew Dellavedova\dellama01","2016-17",26,"MIL","NBA",1.2,76,54,1986,208,534,129,319,79,215,82,96,24,123,147,357,53,0,133,153,577,8.45
6967,"Juan Dixon\dixonju01","2005-06",27,"POR","NBA",1.2,76,42,1920,357,821,292,651,65,170,156,194,30,147,177,149,58,6,113,157,935,9.54
6968,"Michael Doleac\doleami01","2006-07",29,"MIA","NBA",1.2,56,0,698,82,175,82,174,0,1,36,41,44,111,155,22,18,15,30,96,200,3.83
6969,"Blue Edwards\edwarbl01","1994-95",29,"TOT","NBA",1.2,67,7,1112,181,393,159,318,22,75,75,90,50,80,130,77,43,16,81,143,459,6.13
6970,"Howard Eisley\eisleho01","1996-97",24,"UTA","NBA",1.2,82,0,1083,139,308,119,236,20,72,70,89,20,64,84,198,44,10,110,141,368,5.17
6971,"Wayne Ellington\ellinwa01","2014-15",27,"LAL","NBA",1.2,65,36,1675,254,617,164,374,90,243,52,64,31,179,210,105,33,2,50,77,650,7.8
6972,"Reggie Evans\evansre01","2014-15",34,"SAC","NBA",1.2,47,7,764,58,137,58,135,0,2,60,97,97,202,299,32,22,5,45,91,176,5.45
6973,"Dante Exum\exumda01","2016-17",21,"UTA","NBA",1.2,66,26,1228,155,363,111,214,44,149,58,73,30,102,132,111,21,12,80,146,412,5.66
6974,"Cristiano Felício\feliccr01","2015-16",23,"CHI","NBA",1.2,31,4,321,40,72,40,68,0,4,25,35,30,72,102,26,6,13,13,31,105,4.54
6975,"Terrance Ferguson\fergute01","2017-18",19,"OKC","NBA",1.2,61,12,763,70,169,30,49,40,120,9,10,19,28,47,19,24,10,11,83,189,2.65
6976,"Rudy Fernández\fernaru01","2011-12",26,"DEN","NBA",1.2,31,1,710,99,225,59,103,40,122,30,43,9,56,65,75,31,3,40,37,268,8.27
6977,"Duane Ferrell\ferredu01","1994-95",29,"IND","NBA",1.2,56,1,607,83,173,82,167,1,6,64,85,50,38,88,31,26,6,43,79,231,3.96
6978,"Derek Fisher\fishede01","2011-12",37,"TOT","NBA",1.2,63,43,1508,129,348,94,239,35,109,57,67,12,109,121,170,51,4,73,117,350,5.96
6979,"Tremaine Fowlkes\fowlktr01","2002-03",26,"LAC","NBA",1.2,37,10,573,56,128,54,119,2,9,50,59,41,62,103,23,25,2,20,63,164,4.78
6980,"Adonal Foyle\foylead01","2001-02",26,"GSW","NBA",1.2,79,36,1485,171,385,171,385,0,0,37,93,150,234,384,41,36,168,76,179,379,6.22
6981,"Dan Gadzuric\gadzuda01","2002-03",24,"MIL","NBA",1.2,49,30,760,70,145,70,144,0,1,29,56,66,131,197,9,22,52,27,125,169,4.66
6982,"Danilo Gallinari\gallida01","2017-18",29,"LAC","NBA",1.2,21,21,671,102,256,66,145,36,111,81,87,9,92,101,41,12,10,26,30,321,12.78
6983,"Winston Garland\garlawi01","1994-95",30,"MIN","NBA",1.2,73,58,1931,170,410,151,335,19,75,89,112,48,120,168,318,71,13,105,184,448,8.08
6984,"Kevin Garnett\garneke01","2013-14",37,"BRK","NBA",1.2,54,54,1109,157,356,157,353,0,3,38,47,60,298,358,82,43,40,69,123,352,8.03
6985,"Pat Garrity\garripa01","2005-06",29,"ORL","NBA",1.2,57,0,938,101,242,51,113,50,129,30,37,31,77,108,38,12,9,38,108,282,4.18
6986,"Alonzo Gee\geeal01","2014-15",27,"TOT","NBA",1.2,54,2,662,87,186,74,151,13,35,54,77,37,57,94,25,35,7,33,58,241,4.29
6987,"Matt Geiger\geigema01","1992-93",23,"MIA","NBA",1.2,48,2,554,76,145,76,141,0,4,62,92,46,74,120,14,15,18,36,123,214,4.51
6988,"Armen Gilliam\gilliar01","1999-00",35,"UTA","NBA",1.2,50,0,782,133,305,133,304,0,1,67,86,72,137,209,42,12,16,55,83,333,6.03
6989,"Gerald Green\greenge01","2011-12",26,"NJN","NBA",1.2,31,2,781,154,320,111,210,43,110,49,65,15,93,108,34,28,17,55,80,400,10.91
6990,"Darvin Ham\hamda01","2001-02",28,"MIL","NBA",1.2,70,2,1208,120,211,119,204,1,7,62,123,91,111,202,73,25,37,83,175,303,5.17
6991,"Ron Harper\harpero01","1998-99",35,"CHI","NBA",1.2,35,35,1107,147,390,120,305,27,85,71,101,49,131,180,115,60,35,65,80,392,11.51
6992,"Matt Harpring\harprma01","2008-09",32,"UTA","NBA",1.2,63,2,693,111,241,111,239,0,2,55,72,47,76,123,28,29,9,29,102,277,3.97
6993,"Al Harrington\harrial01","2000-01",20,"IND","NBA",1.2,78,38,1892,241,543,240,536,1,7,103,157,119,262,381,130,63,18,148,223,586,7.69
6994,"Spencer Hawes\hawessp01","2014-15",26,"LAC","NBA",1.2,73,15,1274,163,415,108,239,55,176,44,68,30,228,258,88,24,53,61,173,425,5.7
6995,"Gordon Hayward\haywago01","2010-11",20,"UTA","NBA",1.2,72,17,1218,142,293,107,219,35,74,69,97,41,98,139,81,30,19,70,106,388,5.33
6996,"Grant Hill\hillgr01","2001-02",29,"ORL","NBA",1.2,14,14,512,83,195,83,193,0,2,69,80,29,96,125,64,8,4,37,40,235,16.64
6997,"Jrue Holiday\holidjr01","2009-10",19,"PHI","NBA",1.2,73,51,1767,230,520,168,361,62,159,65,86,56,135,191,280,79,18,156,153,587,9.19
6998,"Ryan Hollins\holliry01","2009-10",25,"MIN","NBA",1.2,73,27,1223,169,303,169,302,0,1,109,158,79,128,207,51,19,38,95,199,447,6.12
6999,"Rondae Hollis-Jefferson\holliro01","2015-16",21,"BRK","NBA",1.2,29,17,615,63,138,59,124,4,14,37,52,39,115,154,43,39,16,26,61,167,7.98
7000,"Rondae Hollis-Jefferson\holliro01","2018-19",24,"BRK","NBA",1.2,59,21,1234,200,487,191,438,9,49,118,183,83,227,310,96,44,27,68,107,527,8.38
7001,"Jarrett Jack\jackja01","2005-06",22,"POR","NBA",1.2,79,4,1599,189,428,169,352,20,76,128,160,18,142,160,219,41,2,102,138,526,6.95
7002,"Jarrett Jack\jackja01","2017-18",34,"NYK","NBA",1.2,62,56,1548,189,443,164,357,25,86,63,75,22,169,191,348,35,4,115,98,466,9.43
7003,"Bobby Jackson\jacksbo01","1998-99",25,"MIN","NBA",1.2,50,12,941,141,348,131,321,10,27,61,79,43,92,135,167,39,3,75,75,353,7.41
7004,"Bobby Jackson\jacksbo01","2008-09",35,"SAC","NBA",1.2,71,10,1484,193,485,133,288,60,197,86,101,42,158,200,143,62,4,66,100,532,7.16
7005,"Marc Jackson\jacksma02","2005-06",31,"TOT","NBA",1.2,64,10,1027,174,369,173,367,1,2,66,82,86,131,217,44,13,8,65,126,415,5.56
7006,"Casey Jacobsen\jacobca01","2002-03",21,"PHO","NBA",1.2,72,0,1147,122,327,70,162,52,165,72,105,29,54,83,73,35,6,55,90,368,4.14
7007,"Bernard James\jamesbe01","2012-13",27,"DAL","NBA",1.2,46,11,457,53,103,53,101,0,2,25,41,52,79,131,6,12,38,18,64,131,3.67
7008,"Jerome James\jamesje01","2004-05",29,"SEA","NBA",1.2,80,80,1330,174,342,174,340,0,2,47,65,81,160,241,19,23,111,88,279,395,5.36
7009,"Jared Jeffries\jeffrja01","2008-09",27,"NYK","NBA",1.2,56,36,1310,120,273,119,261,1,12,55,90,128,103,231,80,47,33,65,153,296,6.38
7010,"Jared Jeffries\jeffrja01","2006-07",25,"NYK","NBA",1.2,55,43,1307,95,206,93,186,2,20,31,68,111,127,238,67,44,30,61,150,223,5.62
7011,"Anthony Johnson\johnsan02","2006-07",32,"TOT","NBA",1.2,67,17,1301,142,343,117,270,25,73,46,61,22,79,101,201,33,3,76,119,355,5.7
7012,"Buck Johnson\johnsbu01","1992-93",29,"WSB","NBA",1.2,73,19,1287,193,403,193,400,0,3,92,126,78,117,195,89,36,18,70,187,478,6.14
7013,"Frank Johnson\johnsfr01","1993-94",35,"PHO","NBA",1.2,70,5,875,134,299,132,287,2,12,54,69,29,53,82,148,41,1,65,120,324,4.86
7014,"Dahntay Jones\jonesda02","2010-11",30,"IND","NBA",1.2,45,2,589,100,214,86,175,14,39,69,90,4,61,65,33,20,7,31,70,283,5.31
7015,"Dwayne Jones\jonesdw02","2007-08",24,"CLE","NBA",1.2,56,0,472,25,47,25,46,0,1,28,58,69,71,140,10,10,25,17,88,78,2.39
7016,"Fred Jones\jonesfr01","2006-07",27,"TOT","NBA",1.2,63,12,1319,139,361,100,233,39,128,95,114,23,92,115,108,48,16,67,121,412,6.16
7017,"James Jones\jonesja02","2015-16",35,"CLE","NBA",1.2,48,0,463,58,142,17,38,41,104,21,26,8,42,50,14,11,10,13,50,178,3.08
7018,"Popeye Jones\jonespo01","2000-01",30,"WAS","NBA",1.2,45,1,638,60,153,59,147,1,6,41,55,83,137,220,31,19,8,21,95,162,4.61
7019,"Jerome Jordan\jordaje01","2014-15",28,"BRK","NBA",1.2,44,0,383,50,94,50,94,0,0,38,44,52,53,105,13,8,15,22,58,138,3.62
7020,"Reggie Jordan\jordare01","1997-98",30,"MIN","NBA",1.2,57,1,487,54,113,54,112,0,1,41,72,57,40,97,50,35,9,30,63,149,3.41
7021,"Jason Kapono\kaponja01","2005-06",24,"MIA","NBA",1.2,51,2,665,79,177,58,124,21,53,28,33,12,59,71,37,7,3,20,89,207,3.45
7022,"Jerome Kersey\kerseje01","1997-98",35,"SEA","NBA",1.2,37,2,717,97,233,96,223,1,10,39,65,56,79,135,44,52,14,36,104,234,6.65
7023,"Randolph Keys\keysra01","1995-96",29,"MIL","NBA",1.2,69,1,816,87,208,65,137,22,71,36,43,41,84,125,65,32,14,33,139,232,3.71
7024,"Bernard King\kingbe01","1992-93",36,"NJN","NBA",1.2,32,2,430,91,177,89,170,2,7,39,57,35,41,76,18,11,3,21,53,223,5.76
7025,"Linas Kleiza\kleizli01","2005-06",21,"DEN","NBA",1.2,61,2,519,77,173,75,160,2,13,57,81,38,78,116,15,10,13,16,87,213,3.1
7026,"Mindaugas Kuzminskas\kuzmimi01","2016-17",27,"NYK","NBA",1.2,68,5,1016,158,369,104,201,54,168,55,68,47,79,126,69,29,11,51,79,425,5.3
7027,"Raef LaFrentz\lafrera01","1998-99",22,"DEN","NBA",1.2,12,12,387,59,129,47,98,12,31,36,48,33,58,91,8,9,17,9,38,166,13.12
7028,"Rashard Lewis\lewisra02","2012-13",33,"MIA","NBA",1.2,55,9,792,103,249,52,118,51,131,28,45,19,102,121,30,21,14,33,67,285,4.46
7029,"Todd Lichti\lichtto01","1992-93",26,"DEN","NBA",1.2,48,12,752,124,276,122,270,2,6,81,102,35,67,102,52,28,11,49,60,331,6.08
7030,"Shaun Livingston\livinsh01","2009-10",24,"TOT","NBA",1.2,36,18,796,104,201,104,195,0,6,42,48,16,62,78,130,17,11,58,61,250,8.21
7031,"Tyronn Lue\luety01","2007-08",30,"TOT","NBA",1.2,50,3,736,113,253,74,167,39,86,25,32,9,45,54,74,11,1,27,66,290,4.81
7032,"Trey Lyles\lylestr01","2018-19",23,"DEN","NBA",1.2,64,2,1120,207,495,156,295,51,200,81,116,44,202,246,87,30,23,68,93,546,7.4
7033,"Rick Mahorn\mahorri01","1994-95",36,"NJN","NBA",1.2,58,7,630,79,151,78,148,1,3,39,49,45,117,162,26,11,12,34,93,198,3.83
7034,"Sean Marks\marksse01","2008-09",33,"NOH","NBA",1.2,60,5,838,80,165,78,155,2,10,30,44,62,125,187,14,7,33,35,121,192,3.63
7035,"Kenyon Martin\martike01","2012-13",35,"NYK","NBA",1.2,18,11,431,56,93,56,93,0,0,17,40,34,61,95,8,16,17,16,64,129,8.26
7036,"Kenyon Martin\martike01","2013-14",36,"NYK","NBA",1.2,32,15,633,63,123,63,122,0,1,11,19,36,98,134,50,25,27,26,85,137,6.42
7037,"Kevin Martin\martike02","2015-16",32,"TOT","NBA",1.2,55,13,1095,156,419,107,283,49,136,153,172,14,96,110,58,26,3,54,83,514,7.06
7038,"Antonio McDyess\mcdyean01","2003-04",29,"TOT","NBA",1.2,42,20,927,126,268,126,268,0,0,38,69,70,187,257,36,37,24,57,117,290,7.67
7039,"Darko Miličić\milicda01","2005-06",20,"TOT","NBA",1.2,55,1,767,119,234,119,232,0,2,28,50,44,107,151,41,14,77,51,92,266,5.42
7040,"Anthony Miller\millean01","1999-00",28,"HOU","NBA",1.2,35,14,476,52,97,52,97,0,0,26,51,49,115,164,16,11,10,19,68,130,4.79
7041,"Anthony Miller\millean01","1994-95",23,"LAL","NBA",1.2,46,1,527,70,132,68,127,2,5,47,76,67,85,152,35,20,7,38,77,189,4.85
7042,"Chris Mills\millsch01","1999-00",30,"GSW","NBA",1.2,20,11,649,123,292,115,262,8,30,68,84,46,77,123,47,18,4,25,60,322,13.17
7043,"Nazr Mohammed\mohamna01","2012-13",35,"CHI","NBA",1.2,63,12,693,66,180,66,178,0,2,34,47,73,122,195,26,21,32,24,97,166,3.19
7044,"Chris Morris\morrich01","1996-97",31,"UTA","NBA",1.2,73,1,977,122,299,91,186,31,113,39,54,37,125,162,43,29,24,45,121,314,3.95
7045,"Anthony Morrow\morroan01","2016-17",31,"TOT","NBA",1.2,49,7,714,98,252,57,119,41,133,34,37,12,19,31,25,24,2,6,44,271,3.83
7046,"Alonzo Mourning\mournal01","2004-05",34,"TOT","NBA",1.2,37,17,702,100,212,100,212,0,0,82,141,53,145,198,18,8,74,57,82,282,8.15
7047,"Lamond Murray\murrala01","1995-96",22,"LAC","NBA",1.2,77,32,1816,257,575,220,459,37,116,99,132,89,157,246,84,61,25,108,151,650,7.44
7048,"Johnny Newman\newmajo01","1998-99",35,"CLE","NBA",1.2,50,2,949,106,251,83,190,23,61,68,84,15,60,75,41,28,12,41,126,303,5.17
7049,"Jermaine O'Neal\onealje01","1997-98",19,"POR","NBA",1.2,60,9,808,112,231,112,229,0,2,45,89,80,121,201,17,15,58,55,101,269,4.71
7050,"Semi Ojeleye\ojelese01","2017-18",23,"BOS","NBA",1.2,73,0,1150,65,188,25,63,40,125,25,41,37,124,161,20,21,4,25,91,195,2.54
7051,"Jahlil Okafor\okafoja01","2015-16",20,"PHI","NBA",1.2,53,48,1591,397,781,396,775,1,6,133,194,122,251,373,65,22,61,124,140,928,14.62
7052,"Jahlil Okafor\okafoja01","2016-17",21,"PHI","NBA",1.2,50,33,1134,242,471,242,471,0,0,106,158,81,159,240,58,20,49,91,122,590,10.54
7053,"Josh Okogie\okogijo01","2018-19",20,"MIN","NBA",1.2,74,52,1757,196,508,136,293,60,215,118,162,41,177,218,91,88,33,63,166,570,7.26
7054,"Kevin Ollie\ollieke01","2008-09",36,"MIN","NBA",1.2,50,21,850,61,150,61,149,0,1,80,96,13,62,75,117,19,4,34,79,202,4.97
7055,"Michael Olowokandi\olowomi01","2003-04",28,"MIN","NBA",1.2,43,25,925,121,285,121,285,0,0,36,61,78,167,245,24,16,68,54,137,278,6.87
7056,"Michael Olowokandi\olowomi01","2004-05",29,"MIN","NBA",1.2,62,34,1215,161,353,161,353,0,0,46,69,106,218,324,29,15,56,68,193,368,6.13
7057,"Bo Outlaw\outlabo01","2006-07",35,"ORL","NBA",1.2,41,0,460,34,51,34,51,0,0,13,22,47,59,106,16,17,6,21,57,81,3.17
7058,"Billy Owens\owensbi01","1999-00",30,"TOT","NBA",1.2,62,11,1305,150,358,139,324,11,34,63,106,99,202,301,97,33,21,85,166,374,6.49
7059,"Jabari Parker\parkeja01","2017-18",22,"MIL","NBA",1.2,31,3,743,160,332,129,251,31,81,40,54,42,109,151,59,25,10,45,50,391,11.31
7060,"Cherokee Parks\parksch02","2002-03",30,"LAC","NBA",1.2,30,18,648,82,163,81,161,1,2,23,38,46,86,132,21,16,20,18,52,188,6.61
7061,"Nikola Peković\pekovni01","2014-15",29,"MIN","NBA",1.2,31,29,815,139,328,139,328,0,0,108,129,89,145,234,27,19,12,42,59,386,11.08
7062,"Chuck Person\persoch01","1993-94",29,"MIN","NBA",1.2,77,37,2029,356,843,256,571,100,272,82,108,55,198,253,185,45,12,121,164,894,9.35
7063,"Wesley Person\persowe01","2000-01",29,"CLE","NBA",1.2,44,22,958,128,292,94,208,34,84,24,30,11,119,130,64,27,11,40,62,314,6.59
7064,"Eric Piatkowski\piatker01","1995-96",25,"LAC","NBA",1.2,65,1,784,98,242,60,128,38,114,67,82,40,63,103,48,24,10,45,83,301,4.16
7065,"Mickaël Piétrus\pietrmi01","2011-12",29,"BOS","NBA",1.2,42,6,921,104,270,43,88,61,182,20,31,18,112,130,25,21,10,33,81,289,5.59
7066,"A.J. Price\priceaj01","2009-10",23,"IND","NBA",1.2,56,2,865,145,354,85,180,60,174,60,75,12,76,88,106,35,3,59,53,410,6.44
7067,"Ivan Rabb\rabbiv01","2017-18",20,"MEM","NBA",1.2,36,5,516,86,152,86,152,0,0,29,36,53,105,158,32,12,13,35,55,201,6.47
7068,"Willie Reed\reedwi02","2015-16",25,"BRK","NBA",1.2,39,2,426,76,133,76,133,0,0,30,55,49,73,122,10,6,30,16,47,182,4.93
7069,"Khalid Reeves\reevekh01","1996-97",24,"TOT","NBA",1.2,63,30,1432,184,470,101,243,83,227,65,87,34,85,119,226,34,9,108,159,516,7.9
7070,"Luke Ridnour\ridnolu01","2003-04",22,"SEA","NBA",1.2,69,6,1114,145,350,118,270,27,80,65,79,35,73,108,163,52,7,80,105,382,5.85
7071,"Austin Rivers\riverau01","2018-19",26,"TOT","NBA",1.2,76,15,2028,232,572,128,245,104,327,50,95,25,137,162,167,47,23,68,207,618,7.07
7072,"James Robinson\robinja02","1994-95",24,"POR","NBA",1.2,71,25,1539,255,624,179,401,76,223,65,110,42,90,132,180,48,13,127,142,651,7.52
7073,"Sergio Rodríguez\rodrise01","2009-10",23,"TOT","NBA",1.2,66,8,1048,167,351,135,260,32,91,68,93,24,65,89,212,50,5,114,84,434,7.31
7074,"Rodney Rogers\rogerro01","1998-99",27,"LAC","NBA",1.2,47,7,968,131,297,113,234,18,63,68,101,65,114,179,77,47,22,66,140,348,7.81
7075,"Derrick Rose\rosede01","2014-15",26,"CHI","NBA",1.2,51,51,1530,338,835,262,564,76,271,152,187,35,126,161,251,36,16,161,63,904,14.27
7076,"Michael Ruffin\ruffimi01","2007-08",31,"MIL","NBA",1.2,46,2,632,33,62,33,62,0,0,25,63,90,96,186,24,31,19,19,93,91,3.94
7077,"Trevor Ruffin\ruffitr01","1995-96",25,"PHI","NBA",1.2,61,23,1551,263,648,159,364,104,284,148,182,21,111,132,269,43,2,149,132,778,11.5
7078,"Daniel Santiago\santida01","2003-04",27,"MIL","NBA",1.2,54,28,708,78,163,78,163,0,0,61,90,35,97,132,24,19,21,32,98,217,4.18
7079,"Dennis Scott\scottde01","1998-99",30,"TOT","NBA",1.2,36,9,738,87,213,50,116,37,97,23,31,8,50,58,40,15,3,19,49,234,5.13
7080,"Malik Sealy\sealyma01","1995-96",25,"LAC","NBA",1.2,62,48,1601,272,655,251,555,21,100,147,184,76,164,240,116,84,28,113,150,712,10.13
7081,"Brian Shaw\shawbr01","2001-02",35,"LAL","NBA",1.2,58,0,631,61,173,32,85,29,88,18,26,19,93,112,89,25,3,32,43,169,3.51
7082,"Dickey Simpkins\simpkdi01","1995-96",23,"CHI","NBA",1.2,60,12,685,77,160,76,159,1,1,61,97,66,90,156,38,9,8,56,78,216,3.73
7083,"Brian Skinner\skinnbr01","2007-08",31,"PHO","NBA",1.2,66,0,844,92,198,90,195,2,3,33,63,63,175,238,15,21,77,39,112,219,4.33
7084,"Chris Smith\smithch03","1994-95",24,"MIN","NBA",1.2,64,17,1073,116,264,69,156,47,108,41,63,14,59,73,146,32,22,50,119,320,5.49
7085,"J.R. Smith\smithjr01","2005-06",20,"NOK","NBA",1.2,55,25,989,144,366,92,226,52,140,83,101,19,91,110,58,37,4,54,90,423,6.21
7086,"Jason Smith\smithja02","2014-15",28,"NYK","NBA",1.2,82,31,1785,257,592,242,550,15,42,127,153,98,226,324,140,32,44,104,205,656,7.61
7087,"Larry Smith\smithla01","1992-93",35,"SAS","NBA",1.2,66,13,833,38,87,38,87,0,0,9,22,103,165,268,28,23,16,39,133,85,2.96
7088,"Omari Spellman\spellom01","2018-19",21,"ATL","NBA",1.2,46,11,805,98,244,54,116,44,128,32,45,72,122,194,47,26,25,31,67,272,6.29
7089,"Jerry Stackhouse\stackje01","1995-96",21,"PHI","NBA",1.2,72,71,2701,452,1091,359,799,93,292,387,518,90,175,265,278,76,79,252,179,1384,16.4
7090,"Salim Stoudamire\stoudsa01","2005-06",23,"ATL","NBA",1.2,61,1,1236,204,492,122,276,82,216,99,110,12,104,116,75,27,3,82,118,589,7.37
7091,"Jeffery Taylor\tayloje03","2012-13",23,"CHA","NBA",1.2,77,29,1507,172,399,119,245,53,154,75,103,51,99,150,63,47,15,48,136,472,5.35
7092,"Garrett Temple\templga01","2012-13",26,"WAS","NBA",1.2,51,36,1156,105,258,79,178,26,80,26,37,29,94,123,115,50,17,61,94,262,6.09
7093,"Garrett Temple\templga01","2017-18",31,"SAC","NBA",1.2,65,35,1615,199,476,110,249,89,227,60,78,22,130,152,124,57,27,79,135,547,7.84
7094,"Kenny Thomas\thomake01","2006-07",29,"SAC","NBA",1.2,62,53,1412,146,303,146,302,0,1,39,76,134,243,377,76,43,16,90,141,331,6.79
7095,"Lance Thomas\thomala01","2011-12",23,"NOH","NBA",1.2,42,10,630,57,126,57,125,0,1,52,62,49,77,126,12,10,7,24,78,166,4.05
7096,"Lance Thomas\thomala01","2012-13",24,"NOH","NBA",1.2,59,9,646,53,106,53,106,0,0,43,59,44,71,115,17,11,7,14,78,149,2.77
7097,"Hollis Thompson\thompho01","2015-16",24,"PHI","NBA",1.2,77,17,2154,270,680,121,288,149,392,69,96,54,218,272,99,36,24,76,187,758,7.92
7098,"Marcus Thornton\thornma01","2014-15",27,"TOT","NBA",1.2,48,0,721,140,345,86,202,54,143,46,56,23,63,86,36,27,7,27,38,380,5.88
7099,"Anthony Tolliver\tollian01","2018-19",33,"MIN","NBA",1.2,65,0,1079,99,259,18,44,81,215,47,60,15,162,177,46,17,21,36,91,326,4.83
7100,"Anthony Tolliver\tollian01","2012-13",27,"ATL","NBA",1.2,62,11,963,82,216,37,83,45,133,44,51,31,124,155,32,15,12,36,66,253,3.86
7101,"Robert Traylor\traylro01","2001-02",24,"CHH","NBA",1.2,61,1,678,87,204,86,203,1,1,53,84,67,120,187,37,24,37,45,127,228,4.23
7102,"Jake Tsakalidis\tsakaja01","2003-04",24,"MEM","NBA",1.2,40,28,533,67,133,67,133,0,0,36,61,37,91,128,18,9,22,23,79,170,4.55
7103,"Hedo Türkoğlu\turkohe01","2014-15",35,"LAC","NBA",1.2,62,2,705,83,188,23,49,60,139,6,11,5,94,99,37,19,7,29,66,232,3.56
7104,"Evan Turner\turneev01","2016-17",28,"POR","NBA",1.2,65,12,1658,235,552,204,434,31,118,85,103,36,211,247,205,53,24,100,121,586,9.21
7105,"Beno Udrih\udrihbe01","2008-09",26,"SAC","NBA",1.2,73,72,2270,321,696,286,583,35,113,123,150,46,174,220,342,81,12,158,192,800,11.61
7106,"Nick Van Exel\vanexni01","2003-04",32,"GSW","NBA",1.2,39,29,1255,187,479,141,329,46,150,70,99,16,88,104,206,20,2,78,57,490,10.9
7107,"Noah Vonleh\vonleno01","2015-16",20,"POR","NBA",1.2,78,56,1174,117,278,106,232,11,46,38,51,91,214,305,30,27,26,50,152,283,4.08
7108,"Dion Waiters\waitedi01","2018-19",27,"MIA","NBA",1.2,44,28,1138,198,478,89,189,109,289,22,44,7,109,116,121,29,9,64,72,527,9.75
7109,"John Wall\walljo01","2018-19",28,"WAS","NBA",1.2,32,32,1104,245,552,194,383,51,169,122,175,15,101,116,279,49,29,121,71,663,20.76
7110,"Rex Walters\waltere01","1993-94",23,"NJN","NBA",1.2,48,0,386,60,115,46,87,14,28,28,34,6,32,38,71,15,3,30,41,162,3.86
7111,"Kyle Weaver\weaveky01","2008-09",22,"OKC","NBA",1.2,56,19,1166,113,246,81,153,32,93,41,58,31,99,130,101,47,25,69,81,299,6.29
7112,"Jahidi White\whiteja01","2003-04",27,"TOT","NBA",1.2,62,17,865,99,190,99,190,0,0,63,126,97,164,261,7,25,51,66,176,261,5.04
7113,"Alvin Williams\willial02","1998-99",24,"TOR","NBA",1.2,50,45,1051,95,237,81,195,14,42,44,52,19,63,82,130,51,12,56,94,248,6
7114,"Kenrich Williams\willike04","2018-19",24,"NOP","NBA",1.2,46,29,1079,107,279,55,123,52,156,13,19,55,164,219,83,45,19,36,95,279,7.13
7115,"Monty Williams\willimo01","1996-97",25,"SAS","NBA",1.2,65,26,1345,234,460,234,459,0,1,120,186,98,108,206,91,55,52,116,161,588,8.78
7116,"Robert Williams\williro04","2018-19",21,"BOS","NBA",1.2,32,2,283,36,51,36,51,0,0,9,15,27,54,81,7,9,40,10,36,81,4.11
7117,"Shammond Williams\willish01","2001-02",26,"SEA","NBA",1.2,50,2,603,81,193,53,118,28,75,31,39,16,47,63,83,21,2,35,35,221,4.42
7118,"Shelden Williams\willish02","2007-08",24,"TOT","NBA",1.2,64,0,776,92,212,92,210,0,2,71,105,68,137,205,19,22,21,35,110,255,4.09
7119,"Nate Wolters\woltena01","2013-14",22,"MIL","NBA",1.2,58,31,1309,170,389,152,327,18,62,59,90,33,116,149,187,35,15,57,67,417,7.52
7120,"Antoine Wright\wrighan01","2006-07",22,"NJN","NBA",1.2,63,23,1137,110,251,91,192,19,59,44,73,38,137,175,55,30,10,43,120,283,4.53
7121,"Nick Young\youngni01","2008-09",23,"WAS","NBA",1.2,82,5,1837,336,756,280,592,56,164,164,193,31,119,150,95,39,20,92,140,892,8.11
7122,"Nick Young\youngni01","2014-15",29,"LAL","NBA",1.2,42,0,1000,174,476,91,251,83,225,132,148,17,79,96,41,23,11,44,83,563,9.3
7123,"Sam Young\youngsa01","2009-10",24,"MEM","NBA",1.2,80,1,1321,224,497,213,441,11,56,136,175,77,124,201,52,34,20,94,106,595,6.07
7124,"Quincy Acy\acyqu01","2012-13",22,"TOR","NBA",1.1,29,0,342,42,75,41,73,1,2,31,38,30,47,77,11,13,15,17,53,116,4.81
7125,"Cory Alexander\alexaco01","1996-97",23,"SAS","NBA",1.1,80,6,1454,194,490,100,238,94,252,95,129,29,94,123,254,82,16,146,148,577,7.73
7126,"Courtney Alexander\alexaco02","2002-03",25,"NOH","NBA",1.1,66,7,1360,193,505,174,448,19,57,118,146,39,79,118,79,31,6,68,125,523,5.65
7127,"Victor Alexander\alexavi01","1994-95",25,"GSW","NBA",1.1,50,29,1237,230,447,224,422,6,25,36,60,87,204,291,60,28,29,76,145,502,9.56
7128,"Malik Allen\allenma01","2004-05",26,"TOT","NBA",1.1,36,1,519,84,177,84,177,0,0,26,28,40,59,99,18,9,22,18,53,194,4.99
7129,"Chris Andersen\anderch01","2002-03",24,"DEN","NBA",1.1,59,3,907,114,285,114,284,0,1,77,140,109,165,274,32,30,60,60,90,305,5.59
7130,"Justin Anderson\anderju01","2015-16",22,"DAL","NBA",1.1,55,9,647,71,175,49,92,22,83,44,55,18,114,132,29,19,25,24,45,208,3.98
7131,"Kenny Anderson\anderke01","2000-01",30,"BOS","NBA",1.1,33,28,849,88,227,77,194,11,33,59,71,16,57,73,134,44,2,52,62,246,8.66
7132,"Greg Anthony\anthogr01","2001-02",34,"TOT","NBA",1.1,60,38,1514,183,475,135,312,48,163,60,91,22,110,132,282,77,5,94,114,474,8.88
7133,"Darrell Arthur\arthuda01","2016-17",28,"DEN","NBA",1.1,41,7,639,95,215,42,98,53,117,19,22,25,87,112,42,19,21,36,76,262,6.25
7134,"Luke Babbitt\babbilu01","2015-16",26,"NOP","NBA",1.1,47,13,845,122,289,78,180,44,109,39,50,25,123,148,53,11,7,23,90,327,5.99
7135,"Leandro Barbosa\barbole01","2009-10",27,"PHO","NBA",1.1,44,5,786,155,365,111,229,44,136,64,73,11,58,69,64,23,12,46,71,418,7.38
7136,"Jon Barry\barryjo01","1994-95",25,"MIL","NBA",1.1,52,0,602,57,134,41,86,16,48,61,80,15,34,49,85,30,4,41,54,191,4.31
7137,"Maceo Baston\bastoma01","2006-07",31,"IND","NBA",1.1,47,2,405,49,76,46,69,3,7,37,47,21,53,74,16,12,18,32,65,138,3.53
7138,"Jerryd Bayless\bayleje01","2017-18",29,"PHI","NBA",1.1,39,11,925,109,262,55,116,54,146,35,44,15,65,80,54,23,6,46,91,307,6.68
7139,"Raja Bell\bellra01","2001-02",25,"PHI","NBA",1.1,74,12,890,103,240,91,196,12,44,36,48,31,80,111,71,21,4,48,109,254,3.25
7140,"Raja Bell\bellra01","2011-12",35,"UTA","NBA",1.1,34,33,796,81,174,47,87,34,87,21,25,6,43,49,38,13,2,21,78,217,5.49
7141,"Andris Biedriņš\biedran01","2012-13",26,"GSW","NBA",1.1,53,9,495,10,21,10,21,0,0,4,13,34,119,153,14,15,42,14,101,24,2.36
7142,"Steve Blake\blakest01","2015-16",35,"DET","NBA",1.1,58,2,986,93,240,41,89,52,151,16,20,9,80,89,200,24,5,81,70,254,5.6
7143,"Corie Blount\blounco01","2002-03",34,"CHI","NBA",1.1,50,3,836,65,134,65,134,0,0,20,35,68,137,205,50,33,19,43,121,150,4.79
7144,"Ryan Bowen\bowenry01","2004-05",29,"HOU","NBA",1.1,66,6,604,47,111,44,105,3,6,14,21,21,55,76,18,23,5,7,61,111,1.8
7145,"Sam Bowie\bowiesa01","1994-95",33,"LAL","NBA",1.1,67,10,1225,118,267,116,256,2,11,68,89,72,216,288,118,21,80,91,182,306,6.46
7146,"Corey Brewer\breweco01","2010-11",24,"TOT","NBA",1.1,69,24,1510,193,488,163,376,30,112,136,192,57,118,175,89,100,16,87,159,552,7.37
7147,"Ronnie Brewer\brewero02","2012-13",27,"TOT","NBA",1.1,60,34,853,70,198,47,122,23,76,16,39,42,98,140,50,43,6,18,33,179,3.29
7148,"Aaron Brooks\brookaa01","2010-11",26,"TOT","NBA",1.1,59,12,1284,220,587,150,351,70,236,124,140,20,58,78,233,34,3,99,115,634,9.07
7149,"Scott Burrell\burresc01","1995-96",25,"CHH","NBA",1.1,20,20,693,92,206,55,108,37,98,42,56,26,72,98,47,27,13,43,76,263,12.91
7150,"Jimmy Butler\butleji01","2011-12",22,"CHI","NBA",1.1,42,0,359,32,79,30,68,2,11,43,56,23,33,56,14,11,5,14,20,109,2.57
7151,"Mitchell Butler\butlemi02","1993-94",23,"WSB","NBA",1.1,75,19,1321,207,418,207,413,0,5,104,180,106,119,225,77,54,20,87,131,518,6.53
7152,"Rasual Butler\butlera01","2013-14",34,"IND","NBA",1.1,50,2,378,51,110,25,48,26,62,8,14,6,35,41,17,7,9,11,30,136,2.37
7153,"Nick Calathes\calatni01","2014-15",25,"MEM","NBA",1.1,58,0,838,104,247,93,204,11,43,24,45,19,87,106,146,63,5,61,100,243,5.42
7154,"Chris Carr\carrch01","1997-98",23,"MIN","NBA",1.1,51,40,1165,190,452,150,325,40,127,84,99,43,112,155,85,17,11,69,129,504,7.92
7155,"Pete Chilcutt\chilcpe01","1996-97",28,"VAN","NBA",1.1,54,1,662,72,165,47,96,25,69,13,22,67,89,156,47,26,17,28,52,182,4.16
7156,"Chris Childs\childch01","2001-02",34,"TOR","NBA",1.1,69,4,1576,97,296,64,176,33,120,58,71,18,136,154,351,56,5,123,177,285,6.93
7157,"Ian Clark\clarkia01","2017-18",26,"NOP","NBA",1.1,74,2,1455,222,495,160,300,62,195,45,59,10,117,127,110,33,10,57,120,551,6.16
7158,"Keith Closs\closske01","1999-00",23,"LAC","NBA",1.1,57,6,820,96,197,96,194,0,3,46,78,65,114,179,25,13,73,34,80,238,4.89
7159,"Jarron Collins\collija03","2004-05",26,"UTA","NBA",1.1,50,38,961,65,157,65,156,0,1,83,119,57,107,164,61,11,6,34,146,213,4.76
7160,"Mike Conley\conlemi01","2007-08",20,"MEM","NBA",1.1,53,46,1381,189,442,159,351,30,91,90,123,21,118,139,222,44,2,89,85,498,9.57
7161,"Brian Cook\cookbr01","2003-04",23,"LAL","NBA",1.1,35,2,442,67,141,67,136,0,5,21,28,31,70,101,20,16,16,17,64,155,4.63
7162,"DeMarcus Cousins\couside01","2010-11",20,"SAC","NBA",1.1,81,62,2309,432,1004,429,986,3,18,276,402,217,482,699,204,85,68,268,332,1143,13.8
7163,"Jordan Crawford\crawfjo02","2011-12",23,"WAS","NBA",1.1,64,32,1753,349,872,270,599,79,273,161,203,44,124,168,190,59,5,141,111,938,11.14
7164,"Austin Croshere\croshau01","2007-08",32,"GSW","NBA",1.1,44,0,457,61,137,39,76,22,61,29,32,33,71,104,30,8,6,22,60,173,3.98
7165,"Lloyd Daniels\daniell01","1993-94",26,"SAS","NBA",1.1,65,5,980,140,372,96,247,44,125,46,64,45,66,111,94,29,16,60,69,370,4.75
7166,"Troy Daniels\danietr01","2015-16",24,"CHO","NBA",1.1,43,0,476,89,187,30,65,59,122,5,9,7,50,57,21,11,3,24,40,242,4.55
7167,"Ricky Davis\davisri01","1999-00",20,"CHH","NBA",1.1,48,4,570,94,187,94,183,0,4,39,51,29,54,83,62,30,8,46,39,227,5.02
7168,"Johnny Dawkins\dawkijo01","1993-94",30,"PHI","NBA",1.1,72,12,1343,177,423,140,318,37,105,84,100,28,95,123,263,63,5,111,74,475,7.54
7169,"Johnny Dawkins\dawkijo01","1994-95",31,"DET","NBA",1.1,50,9,1170,125,270,100,197,25,73,50,55,28,85,113,205,52,1,86,74,325,8.51
7170,"Boris Diaw\diawbo01","2016-17",34,"UTA","NBA",1.1,73,33,1283,146,327,126,246,20,81,26,35,46,112,158,170,18,9,87,83,338,5.07
7171,"Keyon Dooling\doolike01","2005-06",25,"ORL","NBA",1.1,50,7,1137,178,405,165,362,13,43,101,121,11,67,78,109,49,4,82,116,470,8.18
7172,"LaPhonso Ellis\ellisla01","2002-03",32,"MIA","NBA",1.1,55,3,784,100,262,73,155,27,107,50,66,44,113,157,15,15,15,31,88,277,4.11
7173,"Monta Ellis\ellismo01","2016-17",31,"IND","NBA",1.1,74,33,1998,247,557,204,422,43,135,93,128,19,185,204,236,78,27,135,149,630,9.04
7174,"Pervis Ellison\ellispe01","1997-98",30,"BOS","NBA",1.1,33,8,447,40,70,40,70,0,0,20,34,52,57,109,31,20,31,28,90,100,5.1
7175,"Landry Fields\fieldla01","2012-13",24,"TOR","NBA",1.1,51,22,1037,102,223,100,209,2,14,34,53,59,149,208,60,32,8,42,63,240,5.49
7176,"Derek Fisher\fishede01","1996-97",22,"LAL","NBA",1.1,80,3,921,104,262,82,189,22,73,79,120,25,72,97,119,41,5,71,87,309,3.97
7177,"Marcus Fizer\fizerma01","2001-02",23,"CHI","NBA",1.1,76,20,1963,371,848,364,807,7,41,189,283,128,299,427,120,49,24,131,186,938,10.21
7178,"Danny Fortson\fortsda01","2000-01",24,"GSW","NBA",1.1,6,6,203,29,50,29,50,0,0,42,54,29,69,98,5,2,0,10,22,100,19.42
7179,"Randy Foye\foyera01","2007-08",24,"MIN","NBA",1.1,39,31,1259,198,462,137,314,61,148,53,65,13,115,128,164,36,3,79,102,510,11.93
7180,"Adonal Foyle\foylead01","1998-99",23,"GSW","NBA",1.1,44,0,614,52,121,52,121,0,0,25,51,79,115,194,18,15,43,31,90,129,4.32
7181,"Adonal Foyle\foylead01","2003-04",28,"GSW","NBA",1.1,44,8,572,59,130,59,130,0,0,19,35,54,113,167,17,6,46,21,68,137,4.09
7182,"Tellis Frank\frankte01","1993-94",28,"MIN","NBA",1.1,67,11,959,67,160,67,158,0,2,54,76,83,137,220,57,35,35,49,163,188,4.2
7183,"Jimmer Fredette\fredeji01","2012-13",23,"SAC","NBA",1.1,69,0,967,172,409,107,253,65,156,85,99,19,52,71,92,31,3,68,64,494,5.75
7184,"Kevin Garnett\garneke01","2015-16",39,"MIN","NBA",1.1,38,38,556,54,115,54,114,0,1,14,21,15,135,150,62,28,10,16,70,122,5.23
7185,"Pat Garrity\garripa01","2004-05",28,"ORL","NBA",1.1,71,0,955,123,306,74,159,49,147,29,33,21,103,124,30,19,9,30,107,324,3.57
7186,"Pat Garrity\garripa01","1998-99",22,"PHO","NBA",1.1,39,9,538,85,170,78,152,7,18,40,56,26,49,75,18,8,3,20,62,217,4.57
7187,"Pau Gasol\gasolpa01","2018-19",38,"TOT","NBA",1.1,30,6,360,42,94,36,81,6,13,28,40,22,115,137,52,5,15,16,29,118,5.7
7188,"Eddie Gill\gilled01","2004-05",26,"IND","NBA",1.1,73,3,1021,81,242,45,125,36,117,71,81,16,96,112,83,59,5,60,105,269,4.02
7189,"Dion Glover\glovedi01","2003-04",25,"TOT","NBA",1.1,69,30,1643,230,589,190,470,40,119,120,156,58,208,266,130,50,19,102,123,620,7.91
7190,"Eric Gordon\gordoer01","2012-13",24,"NOH","NBA",1.1,42,40,1264,235,584,179,411,56,173,187,222,10,67,77,137,45,8,117,75,713,13.37
7191,"Joey Graham\grahajo01","2009-10",27,"DEN","NBA",1.1,63,18,759,105,202,103,189,2,13,54,73,39,84,123,22,23,7,43,104,266,3.99
7192,"Gary Grant\grantga01","1997-98",32,"POR","NBA",1.1,22,2,359,43,93,36,74,7,19,12,14,8,40,48,84,17,2,24,30,105,6.94
7193,"Aaron Gray\grayaa01","2010-11",26,"NOH","NBA",1.1,41,6,531,56,99,56,99,0,0,17,34,59,112,171,16,11,12,32,96,129,4.25
7194,"Zendon Hamilton\hamilze01","2001-02",26,"DEN","NBA",1.1,54,15,848,103,245,103,245,0,0,118,181,110,143,253,14,21,18,60,104,324,5.8
7195,"Anfernee Hardaway\hardaan01","1997-98",26,"ORL","NBA",1.1,19,15,625,103,273,88,223,15,50,90,118,8,68,76,68,28,15,46,45,311,14.02
7196,"Othella Harrington\harriot01","2005-06",32,"CHI","NBA",1.1,72,23,824,135,273,135,273,0,0,77,123,54,100,154,39,7,13,61,131,347,4.12
7197,"Lucious Harris\harrilu01","1997-98",27,"NJN","NBA",1.1,50,0,671,69,177,57,138,12,39,41,55,21,31,52,42,42,5,21,77,191,3.7
7198,"Udonis Haslem\hasleud01","2013-14",33,"MIA","NBA",1.1,46,18,653,74,146,74,146,0,0,25,44,42,133,175,13,11,15,24,79,173,4.2
7199,"Steve Henson\hensost01","1992-93",24,"ATL","NBA",1.1,53,2,719,71,182,34,102,37,80,34,40,12,43,55,155,30,1,52,85,213,5.15
7200,"Ryan Hollins\holliry01","2007-08",23,"CHA","NBA",1.1,60,1,532,46,94,46,94,0,0,55,82,53,54,107,14,10,30,25,96,147,2.87
7201,"Robert Horry\horryro01","2007-08",37,"SAS","NBA",1.1,45,5,583,38,119,20,49,18,70,18,28,35,74,109,47,21,19,22,55,112,3.35
7202,"Eddie House\houseed01","2009-10",31,"TOT","NBA",1.1,68,0,1217,173,455,94,228,79,227,48,52,13,96,109,85,40,7,47,81,473,5.44
7203,"Robbie Hummel\hummero01","2013-14",24,"MIN","NBA",1.1,53,5,655,67,177,35,88,32,89,15,16,35,97,132,23,16,2,10,57,181,3.2
7204,"Mark Jackson\jacksma01","2002-03",37,"UTA","NBA",1.1,82,0,1467,147,369,120,274,27,95,61,80,34,142,176,375,48,3,152,90,382,6.8
7205,"Šarūnas Jasikevičius\jasiksa01","2006-07",30,"TOT","NBA",1.1,63,3,973,128,322,84,192,44,130,86,95,15,54,69,172,26,1,90,75,386,6.08
7206,"Amir Johnson\johnsam01","2018-19",31,"PHI","NBA",1.1,51,6,529,79,157,67,117,12,40,31,41,47,100,147,60,16,13,45,99,201,4.8
7207,"Anthony Johnson\johnsan02","1998-99",24,"ATL","NBA",1.1,49,2,885,91,225,86,206,5,19,57,82,16,59,75,107,35,7,65,67,244,5.26
7208,"Chris Johnson\johnsch04","2015-16",25,"UTA","NBA",1.1,70,2,857,72,194,45,95,27,99,34,42,27,105,132,45,32,20,40,100,205,3.22
7209,"Derrick Jones\jonesde02","2016-17",19,"PHO","NBA",1.1,32,8,545,68,121,65,110,3,11,29,41,39,40,79,12,14,13,13,63,168,5.28
7210,"Eddie Jones\jonesed02","2007-08",36,"DAL","NBA",1.1,47,33,922,66,180,32,64,34,116,10,14,18,114,132,69,26,8,29,72,176,4.41
7211,"Chris King\kingch01","1995-96",26,"VAN","NBA",1.1,80,66,1930,250,585,206,472,44,113,90,136,102,183,285,104,68,33,103,163,634,7.3
7212,"Brandon Knight\knighbr03","2012-13",21,"DET","NBA",1.1,75,75,2365,357,878,237,551,120,327,165,225,54,193,247,303,58,8,205,157,999,11.7
7213,"Travis Knight\knightr01","1998-99",24,"LAL","NBA",1.1,37,23,525,67,130,67,129,0,1,22,29,34,94,128,31,21,27,35,108,156,5.45
7214,"Furkan Korkmaz\korkmfu01","2018-19",21,"PHI","NBA",1.1,48,7,679,98,245,51,101,47,144,36,44,16,91,107,52,29,2,25,62,279,5.27
7215,"Toni Kukoč\kukocto01","2005-06",37,"MIL","NBA",1.1,65,0,1018,116,298,71,151,45,147,40,56,26,124,150,139,33,17,66,87,317,5.39
7216,"Meyers Leonard\leoname01","2017-18",25,"POR","NBA",1.1,33,2,254,46,78,35,52,11,26,9,11,12,58,70,17,7,0,10,36,112,3.69
7217,"Robin Lopez\lopezro01","2008-09",20,"PHO","NBA",1.1,60,7,614,71,137,71,136,0,1,47,68,52,66,118,8,11,41,28,97,189,3.43
7218,"Kevin Love\loveke01","2012-13",24,"MIN","NBA",1.1,18,18,618,105,298,85,206,20,92,100,142,64,188,252,42,13,9,39,34,330,16.45
7219,"John Lucas III\lucasjo02","2012-13",30,"TOR","NBA",1.1,63,0,827,129,334,72,183,57,151,18,25,8,57,65,105,23,1,26,50,333,4.3
7220,"Sam Mack\macksa01","1997-98",27,"VAN","NBA",1.1,57,54,1414,222,559,112,290,110,269,62,77,30,103,133,101,41,11,69,117,616,8.42
7221,"Don MacLean\macledo01","1994-95",25,"WSB","NBA",1.1,39,20,1052,158,361,148,321,10,40,104,136,46,119,165,51,15,3,44,97,430,8.88
7222,"Mark Madsen\madsema01","2002-03",27,"LAL","NBA",1.1,54,22,781,69,163,69,163,0,0,36,61,86,73,159,38,15,19,27,116,174,3.63
7223,"Mark Madsen\madsema01","2000-01",25,"LAL","NBA",1.1,70,3,641,55,113,54,112,1,1,26,37,74,78,152,24,8,8,27,111,137,2.38
7224,"Jamaal Magloire\magloja01","2006-07",28,"POR","NBA",1.1,81,23,1703,199,395,199,395,0,0,131,242,151,341,492,30,21,66,129,226,529,7.07
7225,"Stephon Marbury\marbust01","2007-08",30,"NYK","NBA",1.1,24,19,805,111,265,83,191,28,74,83,116,17,42,59,113,21,2,48,57,333,12.66
7226,"Tony Massenburg\masseto01","2004-05",37,"SAS","NBA",1.1,61,6,699,74,182,74,182,0,0,48,63,54,109,163,14,18,20,40,122,196,3.27
7227,"Luc Mbah a Moute\mbahalu01","2014-15",28,"PHI","NBA",1.1,67,61,1916,251,636,189,434,62,202,96,163,82,246,328,106,81,21,99,104,660,8.8
7228,"James Michael McAdoo\mcadoja01","2016-17",24,"GSW","NBA",1.1,52,2,457,62,117,60,109,2,8,21,42,34,57,91,18,18,29,19,47,147,3.25
7229,"Walter McCarty\mccarwa01","2004-05",30,"TOT","NBA",1.1,72,0,906,95,235,40,80,55,155,15,29,29,109,138,37,25,15,36,144,260,3.4
7230,"Jelani McCoy\mccoyje01","2000-01",23,"SEA","NBA",1.1,70,44,1143,138,264,138,264,0,0,41,93,92,159,251,57,18,49,75,141,317,5.13
7231,"JaVale McGee\mcgeeja01","2015-16",28,"DAL","NBA",1.1,34,2,370,77,134,77,133,0,1,18,36,53,80,133,3,5,26,21,49,172,5.3
7232,"Jeff McInnis\mcinnje01","2002-03",28,"POR","NBA",1.1,75,1,1311,188,423,182,388,6,35,50,67,22,75,97,170,21,2,75,117,432,5.13
7233,"Jodie Meeks\meeksjo01","2016-17",29,"ORL","NBA",1.1,36,10,738,103,256,47,119,56,137,65,74,5,72,77,45,34,4,36,41,327,7.9
7234,"Salah Mejri\mejrisa01","2018-19",32,"DAL","NBA",1.1,36,4,399,55,112,44,78,11,34,20,32,36,95,131,35,10,26,21,55,141,5.14
7235,"Loren Meyer\meyerlo01","1995-96",23,"DAL","NBA",1.1,72,21,1266,145,330,142,319,3,11,70,102,114,205,319,57,20,32,67,224,363,5.38
7236,"Greg Monroe\monrogr01","2018-19",28,"TOT","NBA",1.1,43,2,480,92,189,91,184,1,5,45,72,67,105,172,24,14,8,32,66,230,5.32
7237,"Jamario Moon\moonja01","2010-11",30,"TOT","NBA",1.1,59,20,1042,101,248,63,125,38,123,15,17,23,142,165,52,28,33,22,65,255,4.65
7238,"Timofey Mozgov\mozgoti01","2011-12",25,"DEN","NBA",1.1,44,35,687,100,190,100,190,0,0,39,57,53,126,179,22,15,42,53,86,239,6.14
7239,"Timofey Mozgov\mozgoti01","2016-17",30,"LAL","NBA",1.1,54,52,1104,169,328,169,327,0,1,63,78,104,160,264,43,16,31,72,133,401,7.53
7240,"Eduardo Nájera\najered01","2000-01",24,"DAL","NBA",1.1,40,4,431,58,111,57,108,1,3,14,33,41,54,95,27,13,8,17,48,131,3.61
7241,"Eduardo Nájera\najered01","2003-04",27,"DAL","NBA",1.1,58,7,720,72,162,70,158,2,4,30,46,67,89,156,25,35,19,29,90,176,3.68
7242,"Raul Neto\netora01","2018-19",26,"UTA","NBA",1.1,37,1,474,74,161,54,101,20,60,28,33,6,56,62,93,14,4,35,49,196,5.88
7243,"Ivano Newbill\newbiiv01","1996-97",26,"ATL","NBA",1.1,72,2,850,40,91,40,91,0,0,20,52,76,128,204,24,28,15,42,115,100,2.45
7244,"Joakim Noah\noahjo01","2015-16",30,"CHI","NBA",1.1,29,2,635,51,133,51,132,0,1,22,45,87,168,255,110,18,29,52,77,124,8.94
7245,"Ken Norman\normake01","1995-96",31,"ATL","NBA",1.1,34,28,770,127,273,94,189,33,84,17,48,40,92,132,63,15,16,46,68,304,8.07
7246,"Steve Novak\novakst01","2007-08",24,"HOU","NBA",1.1,35,0,264,49,102,15,31,34,71,3,4,4,31,35,6,2,3,4,17,135,3
7247,"Jermaine O'Neal\onealje01","2011-12",33,"BOS","NBA",1.1,25,24,570,52,120,52,120,0,0,21,31,37,98,135,10,8,43,21,80,125,6.28
7248,"Fabricio Oberto\obertfa01","2005-06",30,"SAS","NBA",1.1,59,0,490,44,93,44,91,0,2,15,27,57,66,123,27,9,11,28,91,103,2.3
7249,"Kevin Ollie\ollieke01","2005-06",33,"PHI","NBA",1.1,70,23,1069,75,174,74,171,1,3,41,49,13,85,98,101,33,3,29,103,192,3.46
7250,"Zaza Pachulia\pachuza01","2007-08",23,"ATL","NBA",1.1,62,5,944,107,245,107,242,0,3,108,153,89,159,248,36,24,13,69,140,322,5.37
7251,"Robert Pack\packro01","1996-97",27,"TOT","NBA",1.1,54,42,1782,272,693,241,581,31,112,196,243,28,118,146,452,94,6,217,139,771,15.72
7252,"Robert Pack\packro01","2000-01",31,"DEN","NBA",1.1,74,11,1260,181,426,169,395,12,31,105,137,30,107,137,293,65,1,135,114,479,7.65
7253,"Jannero Pargo\pargoja01","2007-08",28,"NOH","NBA",1.1,80,5,1497,254,652,189,466,65,186,71,81,26,104,130,192,50,5,93,123,644,6.56
7254,"Chandler Parsons\parsoch01","2017-18",29,"MEM","NBA",1.1,36,8,691,108,234,57,113,51,121,17,27,14,76,90,69,18,11,35,53,284,7.48
7255,"Patrick Patterson\pattepa01","2018-19",29,"OKC","NBA",1.1,63,5,861,82,219,36,82,46,137,19,30,42,105,147,31,16,13,22,46,229,3.33
7256,"Anthony Peeler\peelean01","1998-99",29,"MIN","NBA",1.1,28,28,810,103,272,69,158,34,114,30,41,30,54,84,78,35,6,38,60,270,8.71
7257,"Scot Pollard\pollasc01","1998-99",23,"SAC","NBA",1.1,16,5,259,33,61,33,61,0,0,16,23,38,44,82,4,8,18,5,41,82,6.62
7258,"Vitaly Potapenko\potapvi01","2003-04",28,"SEA","NBA",1.1,65,39,1419,200,409,200,409,0,0,59,92,101,188,289,53,22,28,77,161,459,6.67
7259,"Josh Powell\poweljo01","2007-08",25,"LAC","NBA",1.1,64,25,1228,145,315,145,312,0,3,63,87,115,216,331,47,14,23,65,130,353,5.88
7260,"Ronnie Price\pricero01","2007-08",24,"UTA","NBA",1.1,61,3,588,88,204,62,129,26,75,26,38,8,38,46,78,32,3,30,83,228,3.65
7261,"Miroslav Raduljica\radulmi01","2013-14",26,"MIL","NBA",1.1,48,2,465,68,126,68,126,0,0,45,55,54,54,108,23,7,13,28,84,181,3.99
7262,"Anthony Randolph\randoan01","2011-12",22,"MIN","NBA",1.1,34,5,517,94,200,94,199,0,1,64,84,42,81,123,19,13,35,40,56,252,7.11
7263,"Shavlik Randolph\randosh01","2005-06",22,"PHI","NBA",1.1,57,1,487,44,97,44,97,0,0,43,71,55,78,133,19,19,12,21,83,131,2.87
7264,"Khalid Reeves\reevekh01","1995-96",23,"TOT","NBA",1.1,51,12,833,95,227,67,136,28,91,61,82,18,61,79,118,37,3,63,115,279,5.94
7265,"Don Reid\reiddo01","1999-00",26,"TOT","NBA",1.1,38,3,498,60,112,60,112,0,0,24,34,31,71,102,11,24,31,23,118,144,4.73
7266,"Larry Robinson\robinla01","2000-01",33,"TOT","NBA",1.1,34,1,632,67,184,23,68,44,116,21,24,23,64,87,36,28,2,25,46,199,5.45
7267,"Nate Robinson\robinna01","2010-11",26,"TOT","NBA",1.1,59,11,1013,150,376,85,176,65,200,36,44,15,75,90,111,29,4,68,115,401,5.76
7268,"Rajon Rondo\rondora01","2013-14",27,"BOS","NBA",1.1,30,30,998,141,350,115,260,26,90,42,67,22,142,164,294,40,2,99,65,350,15.47
7269,"Sean Rooks\rooksse01","1999-00",30,"DAL","NBA",1.1,71,13,1001,122,283,122,283,0,0,65,89,82,166,248,68,29,52,70,169,309,5.1
7270,"Sean Rooks\rooksse01","1997-98",28,"LAL","NBA",1.1,41,1,425,46,101,46,101,0,0,47,79,46,72,118,24,2,23,19,68,139,3.8
7271,"Malik Rose\rosema01","1996-97",22,"CHH","NBA",1.1,54,1,525,61,128,61,126,0,2,38,62,70,94,164,32,28,17,41,114,160,3.95
7272,"Clifford Rozier\roziecl01","1995-96",23,"GSW","NBA",1.1,59,1,723,79,135,79,133,0,2,26,55,71,100,171,22,19,30,40,135,184,3.95
7273,"Brian Scalabrine\scalabr01","2008-09",30,"BOS","NBA",1.1,39,8,504,48,114,24,53,24,61,16,18,7,43,50,18,7,10,12,73,136,3.11
7274,"Malik Sealy\sealyma01","1998-99",28,"MIN","NBA",1.1,31,7,731,95,231,89,208,6,23,55,61,23,69,92,36,30,5,33,68,251,7.11
7275,"Ramon Sessions\sessira01","2009-10",23,"MIN","NBA",1.1,82,1,1732,253,555,252,540,1,15,167,233,58,156,214,258,55,5,137,137,674,8.35
7276,"Ramon Sessions\sessira01","2014-15",28,"TOT","NBA",1.1,64,10,1188,125,334,106,274,19,60,133,173,23,121,144,182,29,0,86,73,402,6.5
7277,"Brian Shaw\shawbr01","1996-97",30,"ORL","NBA",1.1,77,31,1867,189,516,126,322,63,194,111,140,47,147,194,319,67,26,170,197,552,8.32
7278,"Lionel Simmons\simmoli01","1995-96",27,"SAC","NBA",1.1,54,5,810,86,217,67,166,19,51,55,75,41,104,145,83,31,20,51,85,246,5.21
7279,"Kyle Singler\singlky01","2015-16",27,"OKC","NBA",1.1,68,2,977,86,221,56,124,30,97,29,44,50,91,141,24,30,9,32,120,231,3.15
7280,"James Singleton\singlja01","2009-10",28,"TOT","NBA",1.1,57,3,977,97,254,90,217,7,37,53,62,108,168,276,31,28,43,49,113,254,5.29
7281,"Brian Skinner\skinnbr01","2006-07",30,"MIL","NBA",1.1,67,44,1523,124,253,124,253,0,0,46,79,106,279,385,58,18,64,75,195,294,6.13
7282,"Brian Skinner\skinnbr01","2005-06",29,"TOT","NBA",1.1,65,5,944,82,160,82,160,0,0,27,56,76,152,228,30,25,43,45,119,191,4.12
7283,"Chris Smith\smithch03","1992-93",22,"MIN","NBA",1.1,80,6,1266,125,289,123,275,2,14,95,120,32,64,96,196,48,16,68,96,347,5.24
7284,"Josh Smith\smithjo03","2013-14",28,"DET","NBA",1.1,77,76,2730,517,1233,447,968,70,265,160,301,102,418,520,252,105,110,199,197,1264,14.52
7285,"Kirk Snyder\snydeki01","2007-08",24,"TOT","NBA",1.1,36,18,761,96,189,91,166,5,23,64,88,30,96,126,64,20,15,52,55,261,7.87
7286,"Darius Songaila\songada01","2006-07",28,"WAS","NBA",1.1,37,1,700,118,225,118,223,0,2,46,54,44,90,134,38,17,10,43,105,282,7.37
7287,"Felton Spencer\spencfe01","1992-93",25,"MIN","NBA",1.1,71,48,1296,105,226,105,226,0,0,83,127,134,190,324,17,23,66,70,243,293,5.21
7288,"Nik Stauskas\stausni01","2018-19",25,"TOT","NBA",1.1,68,0,1015,136,338,66,150,70,188,57,64,18,109,127,81,21,7,51,50,399,5.11
7289,"Lance Stephenson\stephla01","2018-19",28,"LAL","NBA",1.1,68,3,1123,184,432,111,235,73,197,50,73,32,183,215,140,41,7,86,111,491,7.1
7290,"Damon Stoudamire\stoudda01","2006-07",33,"MEM","NBA",1.1,62,51,1501,171,437,112,262,59,175,66,83,31,108,139,299,47,2,101,95,467,8.65
7291,"Robert Swift\swiftro01","2005-06",20,"SEA","NBA",1.1,47,20,987,124,241,124,241,0,0,53,91,94,170,264,8,15,56,49,142,301,7.07
7292,"Žan Tabak\tabakza01","1995-96",25,"TOR","NBA",1.1,67,18,1332,225,414,225,413,0,1,64,114,117,203,320,62,24,31,101,204,514,7.63
7293,"Sebastian Telfair\telfase01","2011-12",26,"PHO","NBA",1.1,60,1,895,141,342,108,237,33,105,53,67,20,71,91,138,41,12,68,120,368,6.03
7294,"Kurt Thomas\thomaku01","2012-13",40,"NYK","NBA",1.1,39,17,392,45,83,44,82,1,1,6,13,24,65,89,21,10,16,8,52,97,3.22
7295,"Kurt Thomas\thomaku01","2011-12",39,"POR","NBA",1.1,53,3,803,73,157,73,157,0,0,14,20,39,149,188,46,24,31,31,123,160,4.34
7296,"Brooks Thompson\thompbr01","1996-97",26,"TOT","NBA",1.1,67,6,1055,162,406,65,162,97,244,24,38,18,78,96,180,55,2,87,126,445,6.58
7297,"Tristan Thompson\thomptr01","2011-12",20,"CLE","NBA",1.1,60,25,1424,194,442,194,440,0,2,106,192,187,202,389,27,27,62,81,134,494,7.88
7298,"Al Thornton\thornal01","2007-08",24,"LAC","NBA",1.1,79,31,2158,374,871,331,741,43,130,214,288,98,260,358,98,46,43,128,195,1005,10.17
7299,"Otis Thorpe\thorpot01","1999-00",37,"MIA","NBA",1.1,51,1,777,125,243,125,240,0,3,29,48,56,110,166,33,26,9,59,136,279,5.35
7300,"Ronny Turiaf\turiaro01","2012-13",30,"LAC","NBA",1.1,65,0,701,49,97,49,97,0,0,23,63,45,107,152,35,19,35,29,80,121,2.85
7301,"Jeff Turner\turneje01","1994-95",32,"ORL","NBA",1.1,49,5,576,73,178,46,103,27,75,26,29,23,74,97,38,12,3,22,102,199,3.71
7302,"Kiki Vandeweghe\vandeki01","1992-93",34,"LAC","NBA",1.1,41,3,494,92,203,80,166,12,37,58,66,12,36,48,25,13,7,20,45,254,4.88
7303,"Sasha Vujačić\vujacsa01","2015-16",31,"NYK","NBA",1.1,61,25,908,106,277,54,134,52,143,32,39,26,123,149,84,34,5,44,83,296,4.88
7304,"Dwyane Wade\wadedw01","2017-18",36,"TOT","NBA",1.1,67,3,1536,299,682,267,571,32,111,135,189,50,202,252,228,61,47,140,124,765,11.04
7305,"Von Wafer\wafervo01","2010-11",25,"BOS","NBA",1.1,58,2,553,67,159,49,92,18,67,32,38,7,42,49,35,18,5,20,39,184,2.81
7306,"Dion Waiters\waitedi01","2014-15",23,"TOT","NBA",1.1,80,23,2208,375,946,302,700,73,246,117,172,41,151,192,163,90,21,113,155,940,8.77
7307,"Henry Walker\walkebi01","2010-11",23,"NYK","NBA",1.1,61,1,784,104,236,45,83,59,153,31,44,16,106,122,34,21,6,37,81,298,4.38
7308,"Taurean Waller-Prince\princta02","2016-17",22,"ATL","NBA",1.1,59,10,981,114,285,81,183,33,102,74,94,25,132,157,55,43,27,61,96,335,5.7
7309,"T.J. Warren\warretj01","2014-15",21,"PHO","NBA",1.1,40,1,614,113,214,108,193,5,21,14,19,41,44,85,25,18,9,27,51,245,5.36
7310,"Clarence Weatherspoon\weathcl01","2004-05",34,"HOU","NBA",1.1,40,18,525,47,114,47,114,0,0,29,35,35,87,122,17,9,6,15,74,123,3.34
7311,"Chris Webber\webbech01","2003-04",30,"SAC","NBA",1.1,23,23,831,174,421,173,416,1,5,81,114,48,152,200,105,31,20,60,76,430,16.97
7312,"Chris Wilcox\wilcoch01","2008-09",26,"TOT","NBA",1.1,62,6,1049,184,370,184,366,0,4,79,140,96,181,277,47,26,16,75,137,447,6.74
7313,"Morlon Wiley\wileymo01","1994-95",28,"TOT","NBA",1.1,43,2,424,50,117,20,38,30,79,7,10,6,37,43,75,22,2,23,44,137,3.88
7314,"Aaron Williams\williaa01","1998-99",27,"SEA","NBA",1.1,40,2,458,52,123,52,122,0,1,54,74,54,74,128,22,14,24,30,75,158,4.55
7315,"Aaron Williams\williaa01","1996-97",25,"TOT","NBA",1.1,33,1,563,85,148,85,147,0,1,33,49,62,81,143,15,16,29,32,72,203,7
7316,"Derrick Williams\willide02","2016-17",25,"TOT","NBA",1.1,50,11,804,108,244,78,147,30,97,58,89,19,111,130,28,14,7,28,60,304,5.09
7317,"Herb Williams\willihe01","1992-93",34,"NYK","NBA",1.1,55,0,571,72,175,72,175,0,0,14,21,44,102,146,19,21,28,22,78,158,3.16
7318,"Jawad Williams\willija04","2009-10",26,"CLE","NBA",1.1,54,6,742,81,206,51,113,30,93,32,45,16,67,83,34,12,5,18,73,224,3.32
7319,"Lorenzo Williams\willilo01","1993-94",24,"TOT","NBA",1.1,38,11,716,49,110,49,109,0,1,12,28,95,122,217,25,18,46,22,92,110,5.28
7320,"Lou Williams\willilo02","2006-07",20,"PHI","NBA",1.1,61,0,688,93,211,81,174,12,37,64,92,17,53,70,110,22,1,46,42,262,4.39
7321,"Mo Williams\willima01","2015-16",33,"CLE","NBA",1.1,41,14,748,132,302,96,200,36,102,38,42,6,66,72,98,14,5,57,60,338,7.14
7322,"Scott Williams\willisc01","2003-04",35,"TOT","NBA",1.1,43,21,527,90,186,88,183,2,3,16,27,38,94,132,17,20,16,16,95,198,4.54
7323,"Scott Williams\willisc01","2002-03",34,"PHO","NBA",1.1,69,33,872,120,292,120,290,0,2,33,42,72,121,193,22,27,21,32,159,273,3.58
7324,"Loren Woods\woodslo01","2003-04",25,"MIA","NBA",1.1,38,2,506,44,96,44,96,0,0,33,55,65,69,134,10,11,19,26,52,121,3.88
7325,"Brandan Wright\wrighbr03","2007-08",20,"GSW","NBA",1.1,38,6,376,62,112,62,112,0,0,27,40,38,61,99,9,6,22,13,36,151,4.2
7326,"Delon Wright\wrighde01","2016-17",24,"TOR","NBA",1.1,27,0,446,49,116,39,86,10,30,42,55,16,32,48,57,27,11,25,31,150,6.56
7327,"Ivica Zubac\zubaciv01","2016-17",19,"LAL","NBA",1.1,38,11,609,126,238,126,235,0,3,32,49,41,118,159,30,14,33,30,66,284,7.44
7328,"Quincy Acy\acyqu01","2017-18",27,"BRK","NBA",1,70,8,1359,130,365,28,73,102,292,49,60,40,217,257,57,33,29,60,149,411,5.7
7329,"Hassan Adams\adamsha01","2006-07",22,"NJN","NBA",1,61,8,495,75,135,75,134,0,1,24,36,35,42,77,13,17,4,22,47,174,2.7
7330,"Jeff Adrien\adrieje01","2012-13",26,"CHA","NBA",1,52,5,713,72,168,72,166,0,2,65,100,68,128,196,36,18,27,32,80,209,4.74
7331,"Alexis Ajinça\ajincal01","2015-16",27,"NOP","NBA",1,59,17,861,150,315,150,314,0,1,52,62,75,194,269,31,19,36,54,134,352,6.12
7332,"Alexis Ajinça\ajincal01","2016-17",28,"NOP","NBA",1,39,15,584,89,178,89,174,0,4,29,40,46,131,177,12,20,22,31,77,207,5.85
7333,"Kadeem Allen\allenka01","2018-19",26,"NYK","NBA",1,19,1,416,65,141,48,105,17,36,42,54,8,43,51,76,16,4,26,46,189,10.73
7334,"Malik Allen\allenma01","2007-08",29,"TOT","NBA",1,73,16,1096,157,327,156,325,1,2,23,25,66,130,196,44,19,31,45,149,338,4.4
7335,"Malik Allen\allenma01","2005-06",27,"CHI","NBA",1,54,20,701,121,247,120,246,1,1,23,38,44,96,140,20,14,16,34,92,266,4.27
7336,"Malik Allen\allenma01","2006-07",28,"CHI","NBA",1,60,1,638,107,258,107,257,0,1,28,34,42,77,119,16,17,16,21,85,242,3.15
7337,"Derrick Alston\alstode01","1994-95",22,"PHI","NBA",1,64,1,1032,120,258,120,254,0,4,59,120,98,121,219,33,39,35,53,107,299,4.94
7338,"Lou Amundson\amundlo01","2011-12",29,"IND","NBA",1,60,0,753,89,207,89,207,0,0,35,82,94,128,222,14,27,44,45,125,213,4.02
7339,"Ömer Aşık\asikom01","2016-17",30,"NOP","NBA",1,31,19,482,31,65,31,65,0,0,23,39,48,115,163,15,5,10,14,51,85,4.3
7340,"Jeff Ayres\pendeje02","2012-13",25,"IND","NBA",1,37,0,369,61,126,59,122,2,4,21,23,29,75,104,15,6,12,23,44,145,3.97
7341,"J.J. Barea\bareajo01","2018-19",34,"DAL","NBA",1,38,0,752,161,385,123,257,38,128,55,78,13,82,95,211,22,1,72,50,415,10.77
7342,"Matt Barnes\barnema02","2005-06",25,"TOT","NBA",1,56,5,631,70,140,67,125,3,15,32,47,48,73,121,28,20,7,30,100,175,3.43
7343,"Dana Barros\barroda01","1996-97",29,"BOS","NBA",1,24,8,708,110,253,67,148,43,105,37,43,5,43,48,81,26,6,39,34,300,11.27
7344,"Michael Beasley\beaslmi01","2015-16",27,"HOU","NBA",1,20,0,363,107,205,104,196,3,9,38,49,29,69,98,16,11,9,24,39,255,10.88
7345,"Steve Blake\blakest01","2011-12",31,"LAL","NBA",1,53,5,1237,101,268,48,110,53,158,21,27,9,76,85,175,39,2,72,75,276,6.1
7346,"Walter Bond\bondwa01","1993-94",24,"UTA","NBA",1,56,4,559,63,156,44,102,19,54,31,40,20,41,61,31,16,12,17,90,176,2.84
7347,"Calvin Booth\boothca01","2004-05",28,"TOT","NBA",1,51,1,451,49,108,49,107,0,1,26,32,29,78,107,8,15,28,16,78,124,2.91
7348,"Cal Bowdler\bowdlca01","2000-01",23,"ATL","NBA",1,44,0,375,53,114,52,109,1,5,33,40,30,47,77,4,10,21,11,45,140,3.11
7349,"Earl Boykins\boykiea01","2001-02",25,"LAC","NBA",1,68,2,761,110,275,97,233,13,42,47,61,27,27,54,145,20,2,44,44,280,3.98
7350,"Earl Boykins\boykiea01","2009-10",33,"WAS","NBA",1,67,1,1117,172,403,153,343,19,60,77,89,17,58,75,171,24,3,69,48,440,5.94
7351,"Corey Brewer\breweco01","2018-19",32,"TOT","NBA",1,31,3,492,53,123,39,79,14,44,31,43,26,50,76,39,32,7,19,63,151,5.67
7352,"Corey Brewer\breweco01","2009-10",23,"MIN","NBA",1,82,82,2482,409,949,327,712,82,237,166,256,70,209,279,193,117,29,164,224,1066,11.14
7353,"Scott Brooks\brooksc01","1997-98",32,"CLE","NBA",1,43,0,312,28,66,23,55,5,11,18,20,6,24,30,49,18,3,12,25,79,2.55
7354,"Derrick Brown\brownde04","2010-11",23,"TOT","NBA",1,49,1,576,74,131,69,121,5,10,32,60,41,58,99,33,20,10,35,59,185,4.11
7355,"Randy Brown\brownra02","1998-99",30,"CHI","NBA",1,39,32,1139,132,319,132,309,0,10,78,103,27,105,132,149,68,8,80,93,342,10.06
7356,"Matt Bullard\bullama01","1993-94",26,"HOU","NBA",1,65,0,725,78,226,28,72,50,154,20,26,23,61,84,64,14,6,28,67,226,2.97
7357,"Reggie Bullock\bullore01","2016-17",25,"DET","NBA",1,31,5,467,54,128,26,55,28,73,5,7,13,51,64,29,18,3,10,22,141,4.46
7358,"Alec Burks\burksal01","2012-13",21,"UTA","NBA",1,64,0,1137,163,388,130,296,33,92,92,129,37,108,145,92,35,13,74,114,451,6.19
7359,"Will Bynum\bynumwi01","2013-14",31,"DET","NBA",1,56,3,1054,184,430,164,368,20,62,97,121,24,75,99,216,39,7,103,121,485,8.62
7360,"Vince Carter\cartevi01","2014-15",38,"MEM","NBA",1,66,1,1091,135,406,66,174,69,232,45,57,27,106,133,79,43,14,43,102,384,4.7
7361,"Alex Caruso\carusal01","2018-19",24,"LAL","NBA",1,25,4,531,77,173,53,123,24,50,51,64,20,47,67,77,24,9,42,54,229,9.78
7362,"Pete Chilcutt\chilcpe01","1992-93",24,"SAC","NBA",1,59,9,834,165,340,165,340,0,0,32,46,80,114,194,64,22,21,54,102,362,5.82
7363,"Gary Clark\clarkga01","2018-19",24,"HOU","NBA",1,51,2,641,50,151,9,13,41,138,7,7,24,92,116,18,20,26,7,47,148,3.13
7364,"Jarron Collins\collija03","2007-08",29,"UTA","NBA",1,70,9,702,36,82,36,81,0,1,46,74,40,76,116,37,10,6,22,106,118,2.15
7365,"Marty Conlon\conloma01","1992-93",25,"SAC","NBA",1,46,0,467,81,171,81,167,0,4,57,81,48,75,123,37,13,5,28,43,219,4.65
7366,"Chris Copeland\copelch01","2013-14",29,"IND","NBA",1,41,0,265,55,117,22,38,33,79,10,14,7,25,32,18,3,7,14,38,153,3.04
7367,"John Crotty\crottjo01","1993-94",24,"UTA","NBA",1,45,0,313,45,99,34,75,11,24,31,36,11,20,31,77,15,1,27,36,132,3.57
7368,"Nando De Colo\decolna01","2013-14",26,"TOT","NBA",1,47,3,494,64,153,46,100,18,53,31,35,14,59,73,65,22,6,35,48,177,4.14
7369,"Andrew DeClercq\declean01","2001-02",28,"ORL","NBA",1,61,14,633,67,149,67,149,0,0,28,50,74,89,163,22,23,24,34,130,162,3.21
7370,"Terry Dehere\deherte01","1997-98",26,"SAC","NBA",1,77,18,1410,180,451,130,319,50,132,79,99,21,85,106,196,52,4,96,150,489,6.13
7371,"Sam Dekker\dekkesa01","2018-19",24,"TOT","NBA",1,47,5,788,120,256,101,194,19,62,28,46,53,95,148,46,38,7,24,47,287,6.02
7372,"Malcolm Delaney\delanma01","2017-18",28,"ATL","NBA",1,54,3,1014,109,285,63,161,46,124,74,92,9,91,100,163,35,6,66,82,338,6.82
7373,"Carlos Delfino\delfica01","2005-06",23,"DET","NBA",1,68,1,726,91,226,71,166,20,60,45,67,28,85,113,44,21,15,36,86,247,3.29
7374,"Ike Diogu\dioguik01","2010-11",27,"LAC","NBA",1,36,0,470,83,148,83,148,0,0,41,62,41,74,115,2,3,3,22,72,207,5.02
7375,"DeSagana Diop\diopde01","2003-04",22,"CLE","NBA",1,56,3,730,57,147,57,147,0,0,12,20,72,127,199,34,26,51,29,116,126,3.71
7376,"James Donaldson\donalja01","1994-95",37,"UTA","NBA",1,43,40,613,44,74,44,74,0,0,22,31,19,88,107,14,6,28,22,66,110,3.5
7377,"Goran Dragić\dragigo01","2010-11",24,"TOT","NBA",1,70,5,1234,192,441,136,286,56,155,83,133,36,106,142,204,50,10,117,125,523,7.54
7378,"Predrag Drobnjak\drobnpr01","2004-05",29,"ATL","NBA",1,71,1,1435,238,543,213,472,25,71,96,120,73,165,238,49,42,24,78,138,597,6.91
7379,"Chris Dudley\dudlech02","2000-01",35,"PHO","NBA",1,53,33,613,29,73,29,73,0,0,14,36,64,119,183,18,14,29,26,111,72,2.71
7380,"Chris Duhon\duhonch01","2012-13",30,"LAL","NBA",1,46,9,820,47,123,14,32,33,91,6,13,11,57,68,133,20,1,40,56,133,4.43
7381,"Ronald Dupree\duprero01","2004-05",24,"DET","NBA",1,47,0,472,61,127,60,125,1,2,29,47,34,61,95,24,7,10,22,60,152,3.17
7382,"Ledell Eackles\eacklle01","1997-98",31,"WAS","NBA",1,42,0,547,75,175,59,129,16,46,52,59,25,50,75,16,17,0,29,43,218,4.31
7383,"Ledell Eackles\eacklle01","1994-95",28,"MIA","NBA",1,54,6,898,143,326,125,285,18,41,91,126,33,62,95,72,19,2,53,88,395,5.9
7384,"Howard Eisley\eisleho01","1995-96",23,"UTA","NBA",1,65,0,961,104,242,90,180,14,62,65,77,22,56,78,146,29,3,77,130,287,4.91
7385,"LaPhonso Ellis\ellisla01","1995-96",25,"DEN","NBA",1,45,28,1269,189,432,185,410,4,22,89,148,93,229,322,74,36,33,83,163,471,10.23
7386,"Dante Exum\exumda01","2018-19",23,"UTA","NBA",1,42,1,664,101,241,83,179,18,62,68,86,16,52,68,110,14,5,52,69,288,6.53
7387,"Duane Ferrell\ferredu01","1995-96",30,"IND","NBA",1,54,6,591,80,166,80,158,0,8,42,57,32,61,93,30,23,3,34,83,202,3.61
7388,"Danny Ferry\ferryda01","1997-98",31,"CLE","NBA",1,69,3,1034,113,286,80,187,33,99,32,40,23,91,114,59,26,17,53,118,291,3.73
7389,"Michael Finley\finlemi01","2009-10",36,"TOT","NBA",1,46,7,709,81,184,49,102,32,82,8,15,6,65,71,43,10,6,21,33,202,3.82
7390,"Sleepy Floyd\floydsl01","1992-93",32,"HOU","NBA",1,52,10,867,124,305,108,249,16,56,81,102,14,72,86,132,32,6,68,59,345,6.46
7391,"Greg Foster\fostegr01","1996-97",28,"UTA","NBA",1,79,12,920,111,245,109,242,2,3,54,65,56,131,187,31,10,20,54,145,278,3.38
7392,"Greg Foster\fostegr01","1994-95",26,"TOT","NBA",1,78,3,1144,150,318,143,295,7,23,78,111,85,174,259,39,15,28,71,183,385,4.8
7393,"Evan Fournier\fournev01","2012-13",20,"DEN","NBA",1,38,4,428,75,152,53,98,22,54,30,39,6,29,35,44,19,1,32,65,202,4.91
7394,"Randy Foye\foyera01","2014-15",31,"DEN","NBA",1,50,21,1087,148,402,54,139,94,263,45,55,9,76,85,119,34,11,60,97,435,7.36
7395,"Adonal Foyle\foylead01","2006-07",31,"GSW","NBA",1,48,6,475,48,85,48,85,0,0,11,25,51,75,126,19,11,50,23,61,107,3.56
7396,"Richie Frahm\frahmri01","2004-05",27,"POR","NBA",1,43,0,499,56,140,25,60,31,80,21,25,17,44,61,30,15,4,14,35,164,3.49
7397,"Tim Frazier\fraziti01","2015-16",25,"TOT","NBA",1,51,2,741,96,229,80,181,16,48,53,74,26,84,110,162,33,2,65,73,261,6.32
7398,"Sundiata Gaines\gainesu01","2011-12",25,"NJN","NBA",1,57,12,793,102,271,74,189,28,82,59,96,27,81,108,126,55,2,52,58,291,5.53
7399,"Danilo Gallinari\gallida01","2008-09",20,"NYK","NBA",1,28,2,412,56,125,24,53,32,72,26,27,13,42,55,15,14,4,15,48,170,5.49
7400,"Francisco García\garcifr01","2009-10",28,"SAC","NBA",1,25,4,575,82,176,59,117,23,59,15,17,11,55,66,45,10,19,21,49,202,7.68
7401,"Dean Garrett\garrede01","1999-00",33,"MIN","NBA",1,56,23,604,48,108,48,108,0,0,18,26,41,99,140,19,8,40,21,94,114,2.85
7402,"Alonzo Gee\geeal01","2010-11",23,"TOT","NBA",1,56,34,1118,121,264,104,213,17,51,72,92,62,120,182,38,40,18,55,94,331,6.05
7403,"Harry Giles\gilesha01","2018-19",20,"SAC","NBA",1,58,0,820,175,348,175,342,0,6,58,91,66,156,222,85,31,22,73,150,408,7.17
7404,"Aaron Gordon\gordoaa01","2014-15",19,"ORL","NBA",1,47,8,797,93,208,80,160,13,48,44,61,46,123,169,33,21,22,38,83,243,5.42
7405,"Brian Grant\grantbr01","1996-97",24,"SAC","NBA",1,24,15,607,91,207,91,207,0,0,70,90,49,93,142,28,19,25,44,75,252,10.35
7406,"Tom Hammonds\hammoto01","1998-99",31,"MIN","NBA",1,49,0,716,82,179,82,179,0,0,48,75,54,82,136,20,8,7,32,88,212,3.88
7407,"Tyler Hansbrough\hansbty01","2015-16",30,"CHO","NBA",1,44,0,343,32,71,30,68,2,3,38,65,40,49,89,8,12,7,12,55,104,2.6
7408,"Al Harrington\harrial01","1999-00",19,"IND","NBA",1,50,0,854,121,264,113,230,8,34,78,111,47,112,159,38,25,9,65,130,328,6
7409,"Gerald Henderson\hendege02","2011-12",24,"CHA","NBA",1,55,55,1831,332,723,321,676,11,47,155,204,64,161,225,126,49,20,100,128,830,12.33
7410,"Steve Henson\hensost01","1994-95",26,"POR","NBA",1,37,0,380,37,86,14,34,23,52,22,25,3,23,26,85,9,0,30,52,119,4.09
7411,"Walter Herrmann\herrmwa01","2008-09",29,"DET","NBA",1,59,0,630,82,207,41,87,41,120,19,25,28,79,107,22,7,4,17,43,224,3.01
7412,"Kirk Hinrich\hinriki01","2014-15",34,"CHI","NBA",1,66,22,1610,142,381,84,213,58,168,35,50,20,101,121,148,46,14,73,144,377,5.59
7413,"Ryan Hollins\holliry01","2008-09",24,"TOT","NBA",1,45,3,444,50,94,50,94,0,0,43,72,46,51,97,7,7,32,24,78,143,3.53
7414,"Ryan Hollins\holliry01","2015-16",31,"TOT","NBA",1,37,12,460,49,79,49,79,0,0,26,42,47,51,98,10,6,21,24,62,124,4.02
7415,"Ryan Hollins\holliry01","2014-15",30,"SAC","NBA",1,46,9,441,53,82,53,82,0,0,31,54,36,67,103,14,6,19,25,65,137,3.52
7416,"Josh Howard\howarjo01","2009-10",29,"TOT","NBA",1,35,12,918,157,388,134,302,23,86,109,139,30,95,125,48,26,11,46,91,446,9.79
7417,"Steven Hunter\huntest01","2001-02",20,"ORL","NBA",1,53,21,516,67,147,67,147,0,0,55,94,40,57,97,5,5,43,16,81,189,3.3
7418,"Ersan İlyasova\ilyaser01","2006-07",19,"MIL","NBA",1,66,14,973,139,363,85,215,54,148,70,89,58,131,189,49,27,17,51,147,402,5.22
7419,"Royal Ivey\iveyro01","2012-13",31,"PHI","NBA",1,53,5,698,62,144,25,56,37,88,9,16,16,41,57,32,23,3,20,73,170,3.05
7420,"Justin Jackson\jacksju01","2017-18",22,"SAC","NBA",1,68,41,1506,185,419,128,234,57,185,26,36,27,160,187,74,28,13,40,81,453,5.79
7421,"Richard Jefferson\jefferi01","2012-13",32,"GSW","NBA",1,56,1,568,62,136,48,91,14,45,38,53,5,79,84,31,14,7,23,45,176,3.1
7422,"Anthony Johnson\johnsan02","2009-10",35,"ORL","NBA",1,31,0,406,49,111,36,72,13,39,19,20,8,40,48,63,11,1,26,32,130,4.73
7423,"Chris Johnson\johnsch03","2012-13",27,"MIN","NBA",1,30,0,284,48,75,48,75,0,0,21,34,20,40,60,8,7,28,13,49,117,4.49
7424,"Joe Johnson\johnsjo02","2017-18",36,"TOT","NBA",1,55,4,1205,146,360,106,215,40,145,40,45,14,158,172,83,18,7,49,67,372,5.93
7425,"James Jones\jonesja02","2009-10",29,"MIA","NBA",1,36,6,503,43,119,6,29,37,90,23,28,4,41,45,17,11,4,11,45,146,3.38
7426,"Sean Kilpatrick\kilpase01","2015-16",26,"TOT","NBA",1,31,0,616,123,270,84,156,39,114,60,67,12,44,56,29,12,2,31,37,345,8.34
7427,"Kyle Korver\korveky01","2003-04",22,"PHI","NBA",1,74,0,882,115,327,34,120,81,207,19,24,30,81,111,40,25,8,41,102,330,3.35
7428,"Larry Krystkowiak\krystla01","1993-94",29,"ORL","NBA",1,34,11,682,71,148,71,147,0,1,31,39,38,85,123,35,14,4,29,74,173,5.44
7429,"Tim Legler\legleti01","1994-95",28,"GSW","NBA",1,24,0,371,60,115,34,65,26,50,30,34,12,28,40,27,12,1,20,33,176,6.9
7430,"Alton Lister\listeal01","1994-95",36,"MIL","NBA",1,60,32,776,66,134,66,133,0,1,35,70,67,169,236,12,16,57,38,146,167,4.07
7431,"Ian Mahinmi\mahinia01","2018-19",32,"WAS","NBA",1,34,6,498,47,104,44,88,3,16,42,61,48,80,128,25,25,16,21,84,139,5.36
7432,"Moses Malone\malonmo01","1993-94",38,"PHI","NBA",1,55,0,618,102,232,102,231,0,1,90,117,106,120,226,34,11,17,59,52,294,5.43
7433,"Danny Manning\mannida01","1999-00",33,"MIL","NBA",1,72,0,1217,149,339,148,335,1,4,34,52,50,158,208,73,62,29,55,183,333,5.07
7434,"Tony Massenburg\masseto01","2002-03",35,"UTA","NBA",1,58,1,792,104,232,104,232,0,0,65,84,59,97,156,17,17,19,50,144,273,4.3
7435,"Luc Mbah a Moute\mbahalu01","2013-14",27,"TOT","NBA",1,64,7,1003,87,193,83,176,4,17,46,67,56,90,146,36,30,14,40,68,224,3.73
7436,"Jelani McCoy\mccoyje01","2002-03",25,"TOR","NBA",1,67,25,1367,194,395,194,395,0,0,69,126,95,260,355,43,28,60,96,162,457,7.13
7437,"Andre Miller\millean02","2015-16",39,"TOT","NBA",1,39,4,461,59,106,57,98,2,8,24,32,12,39,51,87,16,0,37,46,144,4.81
7438,"Mikki Moore\mooremi01","2003-04",28,"TOT","NBA",1,32,0,395,50,99,50,99,0,0,30,35,29,55,84,19,7,13,22,65,130,4.43
7439,"Chris Morris\morrich01","1997-98",32,"UTA","NBA",1,54,1,538,85,207,66,145,19,62,44,61,35,79,114,24,25,17,33,61,233,3.97
7440,"Steve Nash\nashst01","1998-99",24,"DAL","NBA",1,40,40,1269,114,314,65,183,49,131,38,46,32,82,114,219,37,2,83,98,315,9.37
7441,"Gary Neal\nealga01","2013-14",29,"TOT","NBA",1,52,3,1114,193,471,125,291,68,180,94,105,10,80,90,83,18,0,64,65,548,7.75
7442,"Kyle O'Quinn\oquinky01","2018-19",28,"IND","NBA",1,45,3,371,69,136,68,124,1,12,17,21,29,90,119,56,9,25,31,68,156,4.45
7443,"Emeka Okafor\okafoem01","2017-18",35,"NOP","NBA",1,26,19,353,48,95,48,95,0,0,18,22,47,73,120,8,8,25,13,30,114,5.55
7444,"Emeka Okafor\okafoem01","2005-06",23,"CHA","NBA",1,26,25,874,131,316,131,316,0,0,82,125,94,167,261,31,22,50,53,88,344,13.12
7445,"Kendrick Perkins\perkike01","2010-11",26,"TOT","NBA",1,29,24,742,67,130,67,130,0,0,40,72,62,170,232,26,9,26,56,91,174,8.11
7446,"Johan Petro\petrojo01","2005-06",20,"SEA","NBA",1,68,41,1282,153,300,153,300,0,0,47,75,109,187,296,15,25,51,60,213,353,5.63
7447,"Scot Pollard\pollasc01","2002-03",27,"SAC","NBA",1,23,0,325,40,87,40,87,0,0,23,38,46,60,106,6,13,15,15,50,103,5.31
7448,"James Posey\poseyja01","2010-11",34,"IND","NBA",1,49,0,839,81,241,14,29,67,212,11,15,10,137,147,34,24,6,24,103,240,4.34
7449,"Vitaly Potapenko\potapvi01","2004-05",29,"SEA","NBA",1,33,1,335,45,87,45,86,0,1,27,31,30,48,78,9,7,3,12,53,117,3.61
7450,"Don Reid\reiddo01","1996-97",23,"DET","NBA",1,47,14,462,54,112,54,111,0,1,24,32,36,65,101,14,16,15,23,105,132,3.16
7451,"Pooh Richardson\richapo01","1996-97",30,"LAC","NBA",1,59,18,1065,131,344,89,216,42,128,26,43,25,73,98,169,54,5,62,82,330,5.93
7452,"Quentin Richardson\richaqu01","2002-03",22,"LAC","NBA",1,59,13,1368,203,546,142,348,61,198,85,124,98,183,281,52,35,10,64,92,552,7.22
7453,"Brian Roberts\roberbr01","2015-16",30,"TOT","NBA",1,51,0,470,74,165,59,123,15,42,42,47,6,35,41,54,10,2,23,35,205,3.58
7454,"Rumeal Robinson\robinru01","1995-96",29,"POR","NBA",1,43,14,715,92,221,62,142,30,79,33,51,19,59,78,142,26,5,72,79,247,6.56
7455,"Donald Royal\royaldo01","1996-97",30,"TOT","NBA",1,62,4,858,62,146,62,144,0,2,94,117,52,102,154,25,23,11,47,100,218,3.89
7456,"Michael Ruffin\ruffimi01","2000-01",24,"CHI","NBA",1,45,16,879,40,90,40,90,0,0,39,77,101,161,262,39,30,38,46,131,119,5.46
7457,"Kareem Rush\rushka01","2007-08",27,"IND","NBA",1,71,15,1504,228,569,126,307,102,262,30,42,19,149,168,89,42,19,62,108,588,6.49
7458,"Larry Sanders\sandela01","2010-11",22,"MIL","NBA",1,60,12,872,116,268,116,268,0,0,28,50,59,119,178,16,22,72,38,117,260,4.41
7459,"Larry Sanders\sandela01","2011-12",23,"MIL","NBA",1,52,0,643,84,184,84,182,0,2,18,38,62,98,160,33,32,76,43,133,186,4.91
7460,"Dario Šarić\saricda01","2016-17",22,"PHI","NBA",1,81,36,2129,381,927,275,586,106,341,172,220,112,401,513,182,57,30,183,162,1040,11.54
7461,"Brian Scalabrine\scalabr01","2002-03",24,"NJN","NBA",1,59,7,724,68,169,54,130,14,39,30,36,40,101,141,46,16,18,46,77,180,3.45
7462,"Kevin Séraphin\serapke01","2016-17",27,"IND","NBA",1,49,3,559,109,198,109,196,0,2,14,22,41,101,142,23,7,20,29,66,232,4.65
7463,"James Singleton\singlja01","2011-12",30,"WAS","NBA",1,12,0,262,41,75,39,66,2,9,14,15,25,56,81,15,9,8,10,27,98,9.92
7464,"Craig Smith\smithcr01","2011-12",28,"POR","NBA",1,47,0,464,59,117,59,116,0,1,38,53,33,77,110,19,16,5,24,55,156,3.59
7465,"Doug Smith\smithdo03","1994-95",25,"DAL","NBA",1,63,0,826,131,314,130,302,1,12,57,75,43,101,144,44,29,26,37,132,320,4.46
7466,"Ish Smith\smithis01","2013-14",25,"PHO","NBA",1,70,1,1006,119,281,118,258,1,23,22,39,31,98,129,179,49,13,65,66,261,4.86
7467,"Mark Strickland\stricma01","1998-99",28,"MIA","NBA",1,32,1,357,50,101,50,100,0,1,19,26,26,52,78,9,7,8,13,28,119,3.61
7468,"Stromile Swift\swiftst01","2006-07",27,"MEM","NBA",1,54,18,1029,161,346,161,341,0,5,97,134,85,165,250,17,30,62,69,146,419,7.62
7469,"Sindarius Thornwell\thornsi01","2017-18",23,"LAC","NBA",1,73,17,1156,100,233,77,172,23,61,59,88,33,107,140,68,48,25,53,125,282,4.33
7470,"Otis Thorpe\thorpot01","2000-01",38,"CHH","NBA",1,49,4,647,59,131,59,131,0,0,20,24,50,95,145,29,12,7,32,108,138,3.34
7471,"Robert Traylor\traylro01","1999-00",22,"MIL","NBA",1,44,16,447,58,122,58,118,0,4,41,68,50,65,115,20,25,25,27,79,157,4.24
7472,"Beno Udrih\udrihbe01","2006-07",24,"SAS","NBA",1,73,1,948,127,344,94,229,33,115,53,60,11,71,82,122,27,1,56,70,340,4.02
7473,"Anderson Varejão\varejan01","2015-16",33,"TOT","NBA",1,53,0,496,53,124,53,123,0,1,32,50,37,104,141,35,16,10,22,70,138,3.19
7474,"Loy Vaught\vaughlo01","2000-01",32,"TOT","NBA",1,51,1,549,80,169,80,169,0,0,8,10,51,122,173,23,21,7,26,74,168,3.77
7475,"Jake Voskuhl\voskuja01","2005-06",28,"CHA","NBA",1,51,2,818,114,261,113,258,1,3,41,60,62,121,183,39,26,23,33,157,270,5.25
7476,"John Wallace\wallajo01","1998-99",24,"TOR","NBA",1,48,3,812,153,354,153,354,0,0,105,150,54,117,171,46,12,43,70,92,411,7.27
7477,"John Wallace\wallajo01","1999-00",25,"NYK","NBA",1,60,0,798,155,332,155,329,0,3,82,102,42,93,135,22,10,14,63,103,392,5.05
7478,"Brad Wanamaker\wanambr01","2018-19",29,"BOS","NBA",1,36,0,343,50,105,34,66,16,39,24,28,3,38,41,56,12,2,19,34,140,4.28
7479,"Charlie Ward\wardch01","1995-96",25,"NYK","NBA",1,62,1,787,87,218,54,119,33,99,37,54,29,73,102,132,54,6,79,98,244,5.01
7480,"Earl Watson\watsoea01","2010-11",31,"UTA","NBA",1,80,13,1567,126,307,90,200,36,107,55,82,52,130,182,278,61,17,116,146,343,6.35
7481,"Chris Whitney\whitnch01","1998-99",27,"WAS","NBA",1,39,1,441,64,156,32,61,32,95,27,31,8,39,47,69,18,2,36,49,187,4.83
7482,"Damien Wilkins\wilkida02","2007-08",28,"SEA","NBA",1,76,31,1843,271,673,221,518,50,155,106,144,72,173,245,150,62,19,89,128,698,7.87
7483,"Damien Wilkins\wilkida02","2004-05",25,"SEA","NBA",1,29,7,520,73,168,57,109,16,59,21,34,29,37,66,26,22,10,16,55,183,5.62
7484,"Alvin Williams\willial02","1999-00",25,"TOR","NBA",1,55,28,779,114,287,98,232,16,55,48,65,27,58,85,126,34,11,47,78,292,5.34
7485,"Johnathan Williams\willijo04","2018-19",23,"LAL","NBA",1,24,0,372,65,110,65,108,0,2,27,48,48,51,99,13,8,7,16,62,157,6.63
7486,"Mo Williams\willima01","2010-11",28,"TOT","NBA",1,58,56,1788,291,730,212,486,79,244,151,177,21,132,153,380,53,10,171,150,812,13.69
7487,"Shammond Williams\willish01","2003-04",28,"TOT","NBA",1,53,4,763,87,232,57,132,30,100,51,58,9,51,60,116,37,2,47,62,255,5.06
7488,"David Wingate\wingada01","1993-94",30,"CHH","NBA",1,50,36,1005,136,283,132,271,4,12,34,51,30,104,134,104,42,6,53,85,310,6.64
7489,"David Wood\woodda01","1992-93",28,"SAS","NBA",1,64,2,598,52,117,47,96,5,21,46,55,38,59,97,34,13,12,29,93,155,2.72
7490,"Vincent Yarbrough\yarbrvi01","2002-03",21,"DEN","NBA",1,59,39,1381,168,428,147,350,21,78,49,62,36,126,162,130,57,33,81,145,406,6.85
7491,"Tyler Zeller\zellety01","2016-17",27,"BOS","NBA",1,51,5,525,78,158,78,157,0,1,22,39,43,81,124,42,7,21,20,61,178,3.77
7492,"Ante Žižić\zizican01","2017-18",21,"CLE","NBA",1,32,2,214,49,67,49,67,0,0,21,29,24,36,60,5,2,13,11,30,119,3.97
7493,"Ivica Zubac\zubaciv01","2017-18",20,"LAL","NBA",1,43,0,410,61,122,61,121,0,1,39,51,45,78,123,25,8,15,26,47,161,4.2
7494,"Quincy Acy\acyqu01","2016-17",26,"TOT","NBA",0.9,38,1,558,70,170,33,80,37,90,45,60,20,95,115,18,14,15,21,67,222,5.48
7495,"Rafael Addison\addisra01","1992-93",28,"NJN","NBA",0.9,68,15,1164,182,411,175,377,7,34,57,70,45,87,132,53,23,11,64,125,428,4.83
7496,"Mark Aguirre\aguirma01","1993-94",34,"LAC","NBA",0.9,39,0,859,163,348,126,255,37,93,50,72,28,88,116,104,21,8,70,98,413,9.53
7497,"Malik Allen\allenma01","2002-03",24,"MIA","NBA",0.9,80,73,2318,335,790,335,786,0,4,97,121,134,291,425,54,37,78,128,234,767,7.97
7498,"James Anderson\anderja01","2012-13",23,"TOT","NBA",0.9,39,2,401,52,126,31,66,21,60,24,28,18,54,72,42,15,5,25,25,149,4.02
7499,"Willie Anderson\anderwi01","1996-97",30,"MIA","NBA",0.9,28,1,303,29,64,21,45,8,19,17,20,15,27,42,34,14,4,19,36,83,3.79
7500,"Trevor Ariza\arizatr01","2005-06",20,"TOT","NBA",0.9,57,10,999,93,226,92,221,1,5,77,127,78,140,218,61,57,11,62,100,264,5.57
7501,"Darrell Arthur\arthuda01","2014-15",26,"DEN","NBA",0.9,58,4,988,155,384,129,274,26,110,46,59,53,118,171,57,48,26,47,146,382,5.94
7502,"Luke Babbitt\babbilu01","2017-18",28,"TOT","NBA",0.9,50,14,715,91,215,31,59,60,156,17,22,7,89,96,31,8,7,19,54,259,4.32
7503,"Thurl Bailey\baileth01","1998-99",37,"UTA","NBA",0.9,43,0,543,78,175,78,173,0,2,25,34,36,58,94,26,9,28,27,78,181,3.97
7504,"Leandro Barbosa\barbole01","2012-13",30,"BOS","NBA",0.9,41,2,513,83,193,65,146,18,47,31,41,8,38,46,58,17,6,21,51,215,4.62
7505,"Andrea Bargnani\bargnan01","2014-15",29,"NYK","NBA",0.9,29,22,785,164,361,149,320,15,41,87,107,32,95,127,46,2,27,42,53,430,11.68
7506,"Jon Barry\barryjo01","1997-98",28,"LAL","NBA",0.9,49,1,374,38,104,20,43,18,61,27,29,8,29,37,51,24,3,22,33,121,2.84
7507,"Lonny Baxter\baxtelo01","2002-03",24,"CHI","NBA",0.9,55,0,682,96,206,96,204,0,2,70,103,65,100,165,16,9,22,46,135,262,4.45
7508,"DeAndre' Bembry\bembrde01","2018-19",24,"ATL","NBA",0.9,82,15,1931,275,616,225,443,50,173,87,136,54,304,358,202,105,41,142,190,687,9.32
7509,"Benoit Benjamin\benjabe01","1992-93",28,"TOT","NBA",0.9,59,6,754,133,271,133,271,0,0,69,104,51,158,209,22,31,48,78,134,335,5.9
7510,"Tony Bennett\benneto01","1993-94",24,"CHH","NBA",0.9,74,5,983,105,263,78,188,27,75,11,15,16,74,90,163,39,1,40,84,248,3.97
7511,"Corie Blount\blounco01","1995-96",27,"LAL","NBA",0.9,57,2,715,79,167,79,165,0,2,25,44,69,101,170,42,25,35,47,109,183,4.16
7512,"Bojan Bogdanović\bogdabo02","2015-16",26,"BRK","NBA",0.9,79,39,2115,324,749,195,411,129,338,110,132,36,219,255,99,29,5,115,119,887,8.7
7513,"Elton Brand\brandel01","2008-09",29,"PHI","NBA",0.9,29,23,920,163,365,163,365,0,0,73,108,77,177,254,37,17,45,68,78,399,12.78
7514,"Aaron Brooks\brookaa01","2015-16",31,"CHI","NBA",0.9,69,0,1108,188,469,122,284,66,185,49,64,21,80,101,180,30,10,82,132,491,6.31
7515,"Randy Brown\brownra02","2000-01",32,"BOS","NBA",0.9,54,35,1238,100,237,100,234,0,3,23,40,23,76,99,154,62,10,56,132,223,5.68
7516,"Chase Budinger\budinch01","2013-14",25,"MIN","NBA",0.9,41,8,751,100,254,58,134,42,120,32,39,19,84,103,31,19,2,24,58,274,5.29
7517,"Trey Burke\burketr01","2013-14",21,"UTA","NBA",0.9,70,68,2262,341,897,230,561,111,336,102,113,37,171,208,396,42,6,131,145,895,11.51
7518,"José Calderón\caldejo01","2005-06",24,"TOR","NBA",0.9,64,11,1487,132,312,125,269,7,43,78,92,30,111,141,288,42,4,101,93,349,7.51
7519,"José Calderón\caldejo01","2014-15",33,"NYK","NBA",0.9,42,42,1270,147,354,88,212,59,142,29,32,19,105,124,198,31,0,75,76,382,9.79
7520,"Marcus Camby\cambyma01","1997-98",23,"TOR","NBA",0.9,63,58,2002,308,747,308,745,0,2,149,244,203,263,466,111,68,230,134,200,765,13.02
7521,"Brian Cardinal\cardibr01","2008-09",31,"MIN","NBA",0.9,64,4,909,65,169,35,77,30,92,30,35,39,103,142,76,37,13,48,135,190,3.93
7522,"Brian Cardinal\cardibr01","2006-07",29,"MEM","NBA",0.9,28,1,313,42,85,24,41,18,44,25,27,13,46,59,31,22,1,23,42,127,5.41
7523,"Chris Carr\carrch01","2000-01",26,"BOS","NBA",0.9,35,0,309,53,112,36,75,17,37,46,60,11,33,44,11,4,3,19,45,169,3.93
7524,"Anthony Carter\cartean01","2009-10",34,"DEN","NBA",0.9,54,7,859,76,181,59,118,17,63,11,13,17,72,89,160,39,13,58,72,180,5.16
7525,"Michael Carter-Williams\cartemi01","2017-18",26,"CHO","NBA",0.9,52,2,835,76,229,62,170,14,59,73,89,37,101,138,116,44,23,52,99,239,5.75
7526,"Rex Chapman\chapmre01","1998-99",31,"PHO","NBA",0.9,38,35,1183,165,459,112,308,53,151,76,91,12,92,104,109,34,9,54,46,459,9.37
7527,"Josh Childress\childjo01","2011-12",28,"PHO","NBA",0.9,34,0,491,48,99,44,75,4,24,0,2,31,64,95,34,14,6,9,38,100,3.8
7528,"Doug Christie\chrisdo01","2004-05",34,"TOT","NBA",0.9,52,44,1525,130,332,115,270,15,62,70,78,38,139,177,199,80,18,104,106,345,8.93
7529,"Ian Clark\clarkia01","2015-16",24,"GSW","NBA",0.9,66,1,578,89,202,59,118,30,84,28,34,13,55,68,64,17,13,43,58,236,3.42
7530,"Bimbo Coles\colesbi01","1997-98",29,"GSW","NBA",0.9,53,44,1471,166,438,153,381,13,57,78,88,17,106,123,248,51,13,89,135,423,8.71
7531,"Tyrone Corbin\corbity01","1999-00",37,"SAC","NBA",0.9,54,5,941,88,247,78,203,10,44,33,39,40,125,165,60,36,5,29,99,219,4.19
7532,"Torrey Craig\craigto01","2017-18",27,"DEN","NBA",0.9,39,5,629,62,137,45,79,17,58,22,35,40,87,127,25,12,15,20,63,163,4.55
7533,"Chris Crawford\crawfch01","1997-98",22,"ATL","NBA",0.9,40,0,256,46,110,45,107,1,3,57,68,20,21,41,9,12,7,18,27,150,3.17
7534,"Jordan Crawford\crawfjo02","2016-17",28,"NOP","NBA",0.9,19,0,442,105,218,68,123,37,95,20,26,4,30,34,57,11,2,25,30,267,11.57
7535,"Erick Dampier\dampier01","1996-97",21,"IND","NBA",0.9,72,21,1052,131,336,130,335,1,1,107,168,96,198,294,43,19,73,84,153,370,5.29
7536,"Marquis Daniels\daniema01","2007-08",27,"IND","NBA",0.9,74,1,1546,241,561,214,459,27,102,97,139,66,146,212,137,79,18,112,121,606,7.64
7537,"Tony Delk\delkto01","2005-06",32,"TOT","NBA",0.9,24,0,385,71,161,51,114,20,47,20,27,14,39,53,33,13,1,19,28,182,6.37
7538,"Luol Deng\denglu01","2016-17",31,"LAL","NBA",0.9,56,49,1486,164,424,113,259,51,165,46,63,63,232,295,74,48,20,43,61,425,7.48
7539,"Toney Douglas\douglto01","2013-14",27,"TOT","NBA",0.9,51,17,675,73,190,42,88,31,102,25,34,18,69,87,68,19,5,34,81,202,3.91
7540,"Mike Dunleavy\dunlemi02","2015-16",35,"CHI","NBA",0.9,31,30,703,77,188,38,89,39,99,29,37,8,75,83,39,14,10,26,66,222,6.44
7541,"Kris Dunn\dunnkr01","2017-18",23,"CHI","NBA",0.9,52,43,1525,286,666,243,532,43,134,84,114,24,197,221,310,104,27,150,174,699,14.68
7542,"Pat Durham\durhapa01","1994-95",27,"MIN","NBA",0.9,59,2,852,117,237,112,211,5,26,63,96,37,57,94,53,36,32,45,114,302,5.13
7543,"Harold Ellis\ellisha01","1994-95",24,"LAC","NBA",0.9,69,7,656,91,189,90,176,1,13,69,117,56,32,88,40,67,12,49,102,252,3.99
7544,"Harold Ellis\ellisha01","1997-98",27,"DEN","NBA",0.9,27,3,344,62,111,62,107,0,4,40,63,27,23,50,18,19,4,19,53,164,5.79
7545,"James Ennis\ennisja01","2015-16",25,"TOT","NBA",0.9,22,5,329,54,113,28,55,26,58,25,34,21,21,42,21,16,5,19,28,159,6.77
7546,"Jeremy Evans\evansje01","2011-12",24,"UTA","NBA",0.9,29,0,217,27,42,27,41,0,1,8,16,19,31,50,13,6,24,5,23,62,3.18
7547,"Jeremy Evans\evansje01","2012-13",25,"UTA","NBA",0.9,37,0,215,27,44,27,43,0,1,21,33,26,32,58,11,8,13,8,30,75,2.65
7548,"Jordan Farmar\farmajo01","2006-07",20,"LAL","NBA",0.9,72,2,1090,124,294,79,157,45,137,27,38,22,97,119,137,44,7,73,77,320,4.89
7549,"Jamie Feick\feickja01","1997-98",23,"MIL","NBA",0.9,45,2,450,39,90,35,77,4,13,20,41,45,79,124,16,25,17,21,67,102,3.2
7550,"Gary Forbes\forbega01","2010-11",25,"DEN","NBA",0.9,63,11,791,124,273,105,215,19,58,59,87,28,88,116,49,23,6,46,77,326,4.46
7551,"Channing Frye\fryech01","2006-07",23,"NYK","NBA",0.9,72,59,1896,298,689,295,671,3,18,85,108,91,304,395,67,36,42,100,216,684,8.08
7552,"Alonzo Gee\geeal01","2013-14",26,"CLE","NBA",0.9,65,24,1020,98,236,79,178,19,58,43,61,35,114,149,47,39,15,44,96,258,4.1
7553,"Gerald Glass\glassge01","1992-93",25,"TOT","NBA",0.9,60,5,848,142,339,135,306,7,33,25,39,61,81,142,77,33,18,35,104,316,4.77
7554,"Dion Glover\glovedi01","2001-02",23,"ATL","NBA",0.9,55,25,1156,192,456,162,365,30,91,78,103,36,133,169,84,45,14,76,89,492,7.65
7555,"Aaron Gray\grayaa01","2009-10",25,"TOT","NBA",0.9,32,0,311,42,82,42,82,0,0,20,28,45,61,106,22,9,11,18,54,104,4.21
7556,"Tom Gugliotta\guglito01","2001-02",32,"PHO","NBA",0.9,44,40,1129,127,301,124,292,3,9,28,37,59,162,221,77,39,30,61,116,285,7.36
7557,"Darvin Ham\hamda01","1997-98",24,"WAS","NBA",0.9,71,3,635,55,104,55,104,0,0,35,74,72,59,131,16,21,25,37,118,145,2.55
7558,"Darvin Ham\hamda01","2003-04",30,"DET","NBA",0.9,54,2,484,37,75,36,73,1,2,21,35,47,46,93,16,13,8,31,63,96,2.22
7559,"Darvin Ham\hamda01","2000-01",27,"MIL","NBA",0.9,29,13,540,39,80,37,77,2,3,29,49,56,65,121,25,17,21,33,85,109,5.46
7560,"Montrezl Harrell\harremo01","2015-16",22,"HOU","NBA",0.9,39,1,379,58,90,58,89,0,1,24,46,25,40,65,17,11,11,17,48,140,3.79
7561,"Tobias Harris\harrito02","2011-12",19,"MIL","NBA",0.9,42,9,479,79,169,73,146,6,23,44,54,30,71,101,22,13,7,31,45,208,4.55
7562,"Udonis Haslem\hasleud01","2010-11",30,"MIA","NBA",0.9,13,0,345,44,86,44,86,0,0,16,20,29,77,106,6,7,3,14,39,104,8.88
7563,"Luther Head\headlu01","2010-11",28,"SAC","NBA",0.9,36,14,586,68,164,43,100,25,64,39,50,16,44,60,70,10,9,32,43,200,5.48
7564,"Mark Hendrickson\hendrma01","1998-99",24,"NJN","NBA",0.9,22,6,399,39,88,39,87,0,1,42,50,27,41,68,13,12,1,15,39,120,5.45
7565,"Mario Hezonja\hezonma01","2015-16",20,"ORL","NBA",0.9,79,9,1413,181,418,114,226,67,192,49,54,28,148,176,109,39,17,97,124,478,5.74
7566,"Aaron Holiday\holidaa01","2018-19",22,"IND","NBA",0.9,50,0,646,105,262,62,135,43,127,41,50,5,62,67,87,21,13,40,71,294,5.34
7567,"Eddie House\houseed01","2001-02",23,"MIA","NBA",0.9,64,3,1230,209,524,155,367,54,157,42,49,17,93,110,123,43,5,80,98,514,6.32
7568,"Byron Houston\houstby01","1993-94",24,"GSW","NBA",0.9,71,2,866,81,177,80,170,1,7,33,54,67,127,194,32,33,31,49,181,196,3.53
7569,"Juwan Howard\howarju01","2010-11",37,"MIA","NBA",0.9,57,0,592,55,125,55,125,0,0,29,35,36,86,122,23,10,4,25,61,139,2.61
7570,"Lindsey Hunter\hunteli01","2003-04",33,"DET","NBA",0.9,33,8,661,49,143,35,93,14,50,5,8,13,54,67,85,39,6,34,45,117,4.99
7571,"Steven Hunter\huntest01","2002-03",21,"ORL","NBA",0.9,33,5,447,56,103,56,103,0,0,18,44,38,55,93,6,9,36,15,56,130,4.41
7572,"Royal Ivey\iveyro01","2008-09",27,"PHI","NBA",0.9,71,0,861,69,208,30,94,39,114,34,43,19,57,76,43,36,7,23,76,211,2.69
7573,"Jarrett Jack\jackja01","2015-16",32,"BRK","NBA",0.9,32,32,1027,140,358,109,256,31,102,100,112,9,127,136,236,34,7,94,77,411,14.69
7574,"Stephen Jackson\jacksst02","2000-01",22,"NJN","NBA",0.9,77,40,1660,243,572,191,417,52,155,97,135,41,167,208,140,86,14,130,166,635,7.71
7575,"Sam Jacobson\jacobsa01","1999-00",24,"TOT","NBA",0.9,52,5,681,108,212,99,188,9,24,30,41,25,46,71,32,30,3,33,113,255,4.39
7576,"Jerome James\jamesje01","2001-02",26,"SEA","NBA",0.9,56,40,949,134,273,134,273,0,0,30,60,89,143,232,24,25,86,74,174,298,6.13
7577,"John Jenkins\jenkijo01","2014-15",23,"ATL","NBA",0.9,24,3,297,49,99,28,47,21,52,16,19,2,37,39,13,10,0,8,15,135,4.95
7578,"Wesley Johnson\johnswe01","2016-17",29,"LAC","NBA",0.9,68,3,810,73,200,44,82,29,118,11,17,26,155,181,23,29,30,18,83,186,3.11
7579,"Dahntay Jones\jonesda02","2004-05",24,"MEM","NBA",0.9,52,7,649,83,190,60,130,23,60,44,64,11,58,69,21,13,11,29,81,233,3.62
7580,"James Jones\jonesja02","2008-09",28,"MIA","NBA",0.9,40,1,630,55,149,22,53,33,96,26,31,12,50,62,20,12,14,12,58,169,3.63
7581,"Cory Joseph\josepco01","2012-13",21,"SAS","NBA",0.9,28,9,388,51,110,45,89,6,21,18,21,12,40,52,53,15,4,21,25,126,5.14
7582,"Shawn Kemp\kempsh01","2000-01",31,"POR","NBA",0.9,68,3,1083,168,413,164,402,4,11,101,131,63,196,259,65,45,23,99,184,441,6.14
7583,"Stacey King\kingst01","1993-94",27,"TOT","NBA",0.9,49,30,1053,146,341,146,339,0,2,93,136,90,151,241,58,31,42,83,121,385,7.86
7584,"Tarence Kinsey\kinseta01","2006-07",22,"MEM","NBA",0.9,48,12,967,139,304,126,258,13,46,78,98,29,68,97,41,53,1,46,57,369,6.77
7585,"Raef LaFrentz\lafrera01","2003-04",27,"BOS","NBA",0.9,17,1,328,57,124,49,84,8,40,10,13,30,49,79,24,8,13,11,47,132,7.78
7586,"Sean Lampley\lamplse01","2002-03",23,"MIA","NBA",0.9,35,0,487,56,129,56,125,0,4,57,82,26,57,83,31,7,3,25,43,169,4.43
7587,"Ty Lawson\lawsoty01","2015-16",28,"TOT","NBA",0.9,66,13,1411,139,354,103,246,36,108,59,86,26,94,120,237,53,7,95,87,373,6.69
7588,"Eric Leckner\leckner01","1993-94",27,"PHI","NBA",0.9,71,36,1163,139,286,139,284,0,2,84,130,75,207,282,86,18,34,86,190,362,5.83
7589,"Eric Leckner\leckner01","1994-95",28,"DET","NBA",0.9,57,11,623,87,165,87,163,0,2,51,72,47,127,174,14,15,15,39,122,225,4.22
7590,"Voshon Lenard\lenarvo01","1995-96",22,"MIA","NBA",0.9,30,0,323,53,141,17,40,36,101,34,43,12,40,52,31,6,1,23,31,176,4.8
7591,"Kawhi Leonard\leonaka01","2017-18",26,"SAS","NBA",0.9,9,9,210,52,111,41,76,11,35,31,38,6,36,42,21,18,9,16,9,146,15.79
7592,"Jon Leuer\leuerjo01","2018-19",29,"DET","NBA",0.9,41,1,402,66,113,65,102,1,11,23,31,27,70,97,14,12,4,23,60,156,3.99
7593,"Alton Lister\listeal01","1995-96",37,"TOT","NBA",0.9,64,19,735,51,105,51,105,0,0,41,64,67,213,280,19,6,42,48,136,143,3.77
7594,"Shawn Long\longsh01","2016-17",24,"PHI","NBA",0.9,18,0,234,61,109,54,90,7,19,19,35,41,44,85,13,9,9,13,49,148,8.23
7595,"George Lynch\lynchge01","1994-95",24,"LAL","NBA",0.9,56,15,953,138,295,135,274,3,21,62,86,75,109,184,62,51,10,73,86,341,6.34
7596,"Shelvin Mack\macksh01","2018-19",28,"TOT","NBA",0.9,57,3,1246,163,403,117,273,46,130,58,84,18,86,104,183,47,4,66,84,430,7.41
7597,"Rick Mahorn\mahorri01","1997-98",39,"DET","NBA",0.9,59,0,707,59,129,59,129,0,0,23,34,65,130,195,15,14,7,37,123,141,3.01
7598,"Kendall Marshall\marshke01","2013-14",22,"LAL","NBA",0.9,54,45,1564,170,419,99,241,71,178,19,36,15,140,155,477,48,4,150,76,430,11.94
7599,"Kenyon Martin\martike01","2011-12",34,"LAC","NBA",0.9,42,0,940,97,220,94,207,3,13,20,54,49,132,181,18,44,43,32,103,217,5.89
7600,"Jamal Mashburn\mashbja01","1993-94",21,"DAL","NBA",0.9,79,73,2896,561,1382,476,1083,85,299,306,438,107,246,353,266,89,14,245,205,1513,14.47
7601,"Roger Mason\masonro01","2011-12",31,"WAS","NBA",0.9,52,0,697,103,258,44,104,59,154,21,27,7,62,69,47,13,5,32,33,286,4.25
7602,"Tony Massenburg\masseto01","2003-04",36,"SAC","NBA",0.9,59,0,789,104,219,104,218,0,1,43,63,57,131,188,29,14,18,45,144,251,4.29
7603,"Marlon Maxey\maxeyma01","1992-93",23,"MIN","NBA",0.9,43,3,520,93,169,93,168,0,1,45,70,66,98,164,12,11,18,38,75,231,5.52
7604,"Vernon Maxwell\maxweve01","1995-96",30,"PHI","NBA",0.9,75,57,2467,410,1052,264,592,146,460,251,332,39,190,229,330,96,12,215,182,1217,13.86
7605,"Rodney McCray\mccraro01","1992-93",31,"CHI","NBA",0.9,64,5,1019,92,204,90,199,2,5,36,52,53,105,158,81,12,15,53,99,222,3.94
7606,"Dominic McGuire\mcguido01","2010-11",25,"CHA","NBA",0.9,52,8,760,72,182,72,180,0,2,30,39,63,136,199,43,10,33,25,94,174,4.13
7607,"Paul McPherson\mcphepa01","2000-01",22,"TOT","NBA",0.9,55,0,595,109,216,107,204,2,12,42,58,40,39,79,38,25,4,47,80,262,4.25
7608,"Jodie Meeks\meeksjo01","2009-10",22,"TOT","NBA",0.9,60,0,719,104,268,62,136,42,132,31,39,9,90,99,39,18,5,25,52,281,3.67
7609,"Khris Middleton\middlkh01","2012-13",21,"DET","NBA",0.9,27,0,475,62,141,48,96,14,45,27,32,4,46,50,28,15,4,11,53,165,5.43
7610,"Chris Mihm\mihmch01","2002-03",23,"CLE","NBA",0.9,52,0,809,116,287,116,284,0,3,76,105,93,138,231,28,18,38,48,124,308,5.74
7611,"Oliver Miller\milleol01","1997-98",27,"TOR","NBA",0.9,64,53,1628,170,369,170,365,0,4,61,101,146,254,400,196,58,72,131,184,401,9.38
7612,"Patty Mills\millspa02","2011-12",23,"SAS","NBA",0.9,16,3,261,63,130,39,74,24,56,15,15,4,24,28,39,10,1,26,14,165,9.27
7613,"Terry Mills\millste01","1997-98",30,"MIA","NBA",0.9,50,0,782,81,206,56,125,25,81,25,33,34,118,152,39,19,9,45,129,212,4.21
7614,"Sam Mitchell\mitchsa01","2001-02",38,"MIN","NBA",0.9,74,10,726,98,227,88,192,10,35,38,49,18,64,82,45,12,4,26,79,244,2.69
7615,"Terence Morris\morrite01","2002-03",24,"HOU","NBA",0.9,49,0,632,82,176,75,144,7,32,11,14,40,88,128,25,8,17,29,35,182,3.65
7616,"Alonzo Mourning\mournal01","2000-01",30,"MIA","NBA",0.9,13,3,306,73,141,73,140,0,1,31,55,35,66,101,12,4,31,28,24,177,13.26
7617,"Lamond Murray\murrala01","2005-06",32,"NJN","NBA",0.9,57,1,576,72,181,45,103,27,78,25,40,29,103,132,13,17,7,22,66,196,3.09
7618,"Abdel Nader\naderab01","2018-19",25,"OKC","NBA",0.9,61,1,694,91,215,59,115,32,100,27,36,14,102,116,20,20,12,26,68,241,3.48
7619,"Lee Nailon\nailole01","2000-01",25,"CHH","NBA",0.9,42,0,469,66,136,66,135,0,1,32,43,29,63,92,24,9,5,27,60,164,3.74
7620,"Raul Neto\netora01","2017-18",25,"UTA","NBA",0.9,41,0,498,69,151,50,104,19,47,26,35,7,42,49,75,13,4,36,38,183,4.61
7621,"Ira Newble\newblir01","2007-08",33,"TOT","NBA",0.9,49,13,698,76,174,60,125,16,49,20,26,47,78,125,18,28,8,34,69,188,3.89
7622,"Johnny Newman\newmajo01","2001-02",38,"DAL","NBA",0.9,47,17,724,67,148,45,91,22,57,42,58,9,40,49,14,29,4,21,88,198,3.74
7623,"Steve Novak\novakst01","2010-11",27,"TOT","NBA",0.9,30,0,215,35,67,9,21,26,46,8,8,4,24,28,3,1,5,4,14,104,2.96
7624,"Jermaine O'Neal\onealje01","2007-08",29,"IND","NBA",0.9,42,34,1206,225,512,225,507,0,5,121,163,82,201,283,93,20,87,106,129,571,12.98
7625,"Charles Oakley\oaklech01","2002-03",39,"WAS","NBA",0.9,42,1,514,23,55,23,55,0,0,28,34,37,70,107,40,13,6,21,90,74,3.1
7626,"Kevin Ollie\ollieke01","1999-00",27,"PHI","NBA",0.9,40,0,290,22,49,22,49,0,0,28,37,4,27,31,46,10,0,10,27,72,2.44
7627,"Cedi Osman\osmande01","2017-18",22,"CLE","NBA",0.9,61,12,672,90,186,58,99,32,87,26,46,19,101,120,41,22,3,32,78,238,3.88
7628,"Travis Outlaw\outlatr01","2009-10",25,"TOT","NBA",0.9,34,6,730,110,281,70,176,40,105,49,59,33,88,121,34,18,17,32,43,309,7.48
7629,"Travis Outlaw\outlatr01","2005-06",21,"POR","NBA",0.9,69,11,1153,162,368,148,315,14,53,62,89,48,141,189,34,31,46,37,112,400,5.2
7630,"Doug Overton\overtdo01","1996-97",27,"PHI","NBA",0.9,61,4,634,81,190,71,150,10,40,45,48,18,50,68,101,24,0,39,44,217,3.89
7631,"Robert Parish\parisro01","1996-97",43,"CHI","NBA",0.9,43,3,406,70,143,70,143,0,0,21,31,42,47,89,22,6,19,28,40,161,3.61
7632,"Tony Parker\parketo01","2018-19",36,"CHO","NBA",0.9,56,0,1003,213,463,200,412,13,51,91,124,14,69,83,207,21,7,75,53,530,8.61
7633,"Cherokee Parks\parksch02","1995-96",23,"DAL","NBA",0.9,64,3,869,101,247,94,221,7,26,41,62,66,150,216,29,25,32,31,100,250,4.11
7634,"Sasha Pavlović\pavloal01","2003-04",20,"UTA","NBA",0.9,79,14,1144,149,376,130,306,19,70,65,84,44,115,159,60,41,16,67,187,382,4.16
7635,"Mike Peplowski\peplomi01","1993-94",23,"SAC","NBA",0.9,55,19,667,76,141,76,140,0,1,24,44,49,120,169,24,17,25,34,131,176,3.97
7636,"Elliot Perry\perryel01","1999-00",30,"NJN","NBA",0.9,60,5,803,128,294,117,255,11,39,50,62,13,48,61,139,39,1,60,47,317,5.32
7637,"Chuck Person\persoch01","1998-99",34,"CHH","NBA",0.9,50,21,990,112,289,57,132,55,157,24,32,17,115,132,60,20,8,41,90,303,5.25
7638,"Eric Piatkowski\piatker01","2003-04",33,"HOU","NBA",0.9,49,0,703,72,191,29,69,43,122,14,16,10,63,73,26,16,5,29,42,201,3.31
7639,"Paul Pierce\piercpa01","2015-16",38,"LAC","NBA",0.9,68,38,1231,144,397,69,155,75,242,54,66,12,174,186,71,33,17,58,129,417,5.31
7640,"Miles Plumlee\plumlmi01","2017-18",29,"ATL","NBA",0.9,55,35,918,105,180,105,180,0,0,27,60,77,151,228,45,17,30,63,79,237,5.46
7641,"Scot Pollard\pollasc01","1997-98",22,"DET","NBA",0.9,33,0,317,35,70,35,70,0,0,19,23,34,40,74,9,8,10,12,48,89,3.13
7642,"Quincy Pondexter\pondequ01","2010-11",22,"NOH","NBA",0.9,66,6,734,73,180,55,130,18,50,24,34,23,65,88,28,17,10,16,63,188,2.52
7643,"Ronnie Price\pricero01","2009-10",26,"UTA","NBA",0.9,60,4,806,98,242,80,179,18,63,41,59,28,46,74,123,40,13,56,109,255,4.71
7644,"Don Reid\reiddo01","2001-02",28,"ORL","NBA",0.9,68,5,714,90,190,90,190,0,0,44,68,65,111,176,27,20,44,54,180,224,3.79
7645,"Mitch Richmond\richmmi01","2001-02",36,"LAL","NBA",0.9,64,2,709,100,247,82,185,18,62,42,44,14,80,94,57,18,6,40,61,260,3.53
7646,"Luke Ridnour\ridnolu01","2007-08",26,"SEA","NBA",0.9,61,5,1223,147,368,126,297,21,71,78,91,13,81,94,241,37,14,80,120,393,7.25
7647,"Thomas Robinson\robinth01","2016-17",25,"LAL","NBA",0.9,48,1,560,105,196,105,195,0,1,31,66,84,139,223,31,26,9,46,76,241,5.73
7648,"Sergio Rodríguez\rodrise01","2006-07",20,"POR","NBA",0.9,67,1,862,101,239,77,154,24,85,21,26,20,71,91,218,35,2,77,72,247,5.13
7649,"Carlos Rogers\rogerca01","1995-96",24,"TOR","NBA",0.9,56,18,1043,178,344,175,323,3,21,71,130,80,90,170,35,25,48,61,87,430,6.93
7650,"Carlos Rogers\rogerca01","1994-95",23,"GSW","NBA",0.9,49,18,1017,180,340,178,326,2,14,76,146,108,170,278,37,22,52,84,124,438,8.97
7651,"Tree Rollins\rollitr01","1993-94",38,"ORL","NBA",0.9,45,1,384,29,53,29,53,0,0,18,30,33,63,96,9,7,35,13,55,76,2.71
7652,"Terrence Ross\rosste01","2012-13",21,"TOR","NBA",0.9,73,2,1239,186,457,121,261,65,196,30,42,35,109,144,53,43,14,48,122,467,4.99
7653,"Brandon Rush\rushbr01","2008-09",23,"IND","NBA",0.9,75,19,1803,243,575,165,366,78,209,46,66,34,199,233,66,38,37,75,128,610,6.67
7654,"Brian Scalabrine\scalabr01","2006-07",28,"BOS","NBA",0.9,54,17,1027,77,191,33,81,44,110,18,23,24,81,105,59,23,18,44,130,216,4.26
7655,"Mike Scott\scottmi01","2012-13",24,"ATL","NBA",0.9,40,1,376,70,147,70,146,0,1,43,56,39,71,110,12,4,2,21,32,183,4.02
7656,"Ramon Sessions\sessira01","2016-17",30,"CHO","NBA",0.9,50,1,811,100,263,79,201,21,62,91,118,11,62,73,129,27,3,46,43,312,6.11
7657,"Charles Shackleford\shackch01","1992-93",26,"PHI","NBA",0.9,48,0,568,80,164,80,162,0,2,31,49,65,140,205,26,13,25,36,92,191,4.83
7658,"Bobby Simmons\simmobo01","2002-03",22,"WAS","NBA",0.9,36,2,378,44,112,44,107,0,5,32,35,33,44,77,20,10,3,8,51,120,3.19
7659,"Lionel Simmons\simmoli01","1994-95",26,"SAC","NBA",0.9,58,3,1064,131,312,125,296,6,16,59,84,61,135,196,89,28,23,70,118,327,5.79
7660,"Brian Skinner\skinnbr01","1999-00",23,"LAC","NBA",0.9,33,9,775,68,134,68,134,0,0,43,65,63,138,201,11,16,44,37,75,179,7.23
7661,"Chris Smith\smithch03","1993-94",23,"MIN","NBA",0.9,80,16,1617,184,423,174,384,10,39,95,141,15,107,122,285,38,18,101,131,473,6.64
7662,"Jason Smith\smithja02","2013-14",27,"NOP","NBA",0.9,31,27,830,131,282,131,282,0,0,39,50,51,130,181,29,11,29,28,100,301,8.89
7663,"Joe Smith\smithjo02","2009-10",34,"ATL","NBA",0.9,64,1,592,77,193,76,186,1,7,39,48,66,91,157,21,6,19,22,95,194,2.86
7664,"Felton Spencer\spencfe01","1997-98",30,"GSW","NBA",0.9,68,0,813,59,129,59,129,0,0,44,79,93,133,226,17,23,37,49,175,162,3.42
7665,"Jerry Stackhouse\stackje01","2009-10",35,"MIL","NBA",0.9,42,0,855,129,316,84,186,45,130,55,69,19,81,100,70,21,9,66,56,358,7.12
7666,"Peja Stojaković\stojape01","2006-07",29,"NOK","NBA",0.9,13,13,425,83,196,49,112,34,84,31,38,11,43,54,11,8,4,19,29,231,12.64
7667,"Žan Tabak\tabakza01","2000-01",30,"IND","NBA",0.9,55,14,777,98,186,98,186,0,0,20,47,65,148,213,33,10,30,57,125,216,4.61
7668,"Maurice Taylor\tayloma01","2002-03",26,"HOU","NBA",0.9,67,9,1377,231,535,231,533,0,2,100,138,95,143,238,66,22,22,100,151,562,6.62
7669,"Mirza Teletović\teletmi01","2012-13",27,"BRK","NBA",0.9,53,0,499,71,185,34,77,37,108,9,11,33,62,95,23,13,8,20,53,188,3
7670,"John Thomas\thomajo02","2004-05",29,"MIN","NBA",0.9,44,8,521,42,86,42,86,0,0,27,46,39,58,97,17,15,13,18,82,111,3.06
7671,"Lance Thomas\thomala01","2017-18",29,"NYK","NBA",0.9,73,31,1353,102,267,52,143,50,124,44,53,44,131,175,44,30,14,40,134,298,3.96
7672,"Lance Thomas\thomala01","2016-17",28,"NYK","NBA",0.9,46,15,968,97,244,59,159,38,85,43,51,32,110,142,35,21,5,25,85,275,5.34
7673,"Tim Thomas\thomati01","2005-06",28,"TOT","NBA",0.9,29,10,666,113,262,67,151,46,111,28,42,22,109,131,20,16,7,33,78,300,8.4
7674,"LaSalle Thompson\thompla01","1992-93",31,"IND","NBA",0.9,63,0,730,104,213,104,212,0,1,29,39,55,123,178,34,29,24,47,137,237,4.23
7675,"Jamaal Tinsley\tinslja01","2012-13",34,"UTA","NBA",0.9,66,32,1221,86,234,47,107,39,127,18,26,17,98,115,290,64,14,106,106,229,6.35
7676,"Anthony Tolliver\tollian01","2011-12",26,"MIN","NBA",0.9,51,0,882,71,182,46,81,25,101,41,55,50,103,153,22,18,19,35,86,208,4.14
7677,"Óscar Torres\torreos01","2001-02",25,"HOU","NBA",0.9,65,13,1075,135,341,98,215,37,126,82,105,47,75,122,40,25,9,49,64,389,4.66
7678,"Allonzo Trier\trieral01","2018-19",23,"NYK","NBA",0.9,64,3,1459,232,518,180,386,52,132,179,223,31,166,197,119,28,14,116,117,695,9.49
7679,"Jake Tsakalidis\tsakaja01","2002-03",23,"PHO","NBA",0.9,33,27,543,61,135,61,135,0,0,39,58,45,77,122,13,6,17,26,80,161,4.82
7680,"Stojko Vranković\vrankst01","1996-97",33,"MIN","NBA",0.9,53,35,766,78,139,78,139,0,0,25,37,57,111,168,14,10,67,52,121,181,4.6
7681,"Dion Waiters\waitedi01","2012-13",21,"CLE","NBA",0.9,61,48,1756,336,815,273,612,63,203,159,213,22,127,149,183,59,16,121,113,894,11.38
7682,"Antoine Walker\walkean02","2004-05",28,"TOT","NBA",0.9,77,77,2955,581,1377,471,1036,110,341,201,373,182,513,695,265,89,58,253,217,1473,16.44
7683,"Henry Walker\walkebi01","2011-12",24,"NYK","NBA",0.9,32,8,620,68,171,32,58,36,113,17,20,9,71,80,37,19,7,35,84,189,5.53
7684,"Gerald Wallace\wallage01","2002-03",20,"SAC","NBA",0.9,47,7,571,90,183,89,179,1,4,39,74,38,90,128,23,24,15,44,68,220,4.59
7685,"Rex Walters\waltere01","1995-96",25,"TOT","NBA",0.9,44,8,610,61,148,39,82,22,66,42,52,13,42,55,106,25,4,41,53,186,5.15
7686,"C.J. Watson\watsocj01","2016-17",32,"ORL","NBA",0.9,62,9,1012,96,248,64,143,32,105,57,66,16,73,89,114,43,2,47,84,281,4.87
7687,"Martell Webster\webstma02","2005-06",19,"POR","NBA",0.9,61,18,1070,139,348,74,166,65,182,61,71,29,101,130,34,21,14,43,90,404,5.22
7688,"Bonzi Wells\wellsbo01","2003-04",27,"TOT","NBA",0.9,72,27,1872,363,850,341,781,22,69,138,183,78,182,260,139,91,19,161,197,886,10.05
7689,"Delonte West\westde01","2004-05",21,"BOS","NBA",0.9,39,7,507,66,155,42,88,24,67,19,27,14,51,65,53,21,8,24,69,175,4.6
7690,"Delonte West\westde01","2010-11",27,"BOS","NBA",0.9,24,2,453,55,120,43,87,12,33,13,15,6,31,37,64,20,10,30,29,135,6.62
7691,"Jason Williams\willija02","2001-02",26,"MEM","NBA",0.9,65,65,2236,376,985,249,555,127,430,80,101,22,173,195,519,111,7,214,102,959,14.9
7692,"Justin Williams\williju01","2006-07",22,"SAC","NBA",0.9,26,1,333,54,88,54,87,0,1,23,63,51,64,115,2,5,16,15,51,131,5.33
7693,"Kevin Willis\willike02","2003-04",41,"SAS","NBA",0.9,48,0,373,70,150,70,149,0,1,24,39,37,61,98,11,21,9,32,61,164,3.23
7694,"Dontonio Wingfield\wingfdo01","1996-97",22,"POR","NBA",0.9,47,0,569,79,193,53,116,26,77,27,40,63,74,137,45,14,6,49,101,211,4.4
7695,"Dontonio Wingfield\wingfdo01","1995-96",21,"POR","NBA",0.9,44,2,487,60,157,41,94,19,63,26,34,45,59,104,28,20,6,31,73,165,3.67
7696,"Joe Wolf\wolfjo01","1994-95",30,"CHH","NBA",0.9,63,6,583,38,81,36,75,2,6,12,16,34,95,129,37,9,6,22,101,90,2.18
7697,"Sam Young\youngsa01","2012-13",27,"IND","NBA",0.9,56,3,693,58,148,42,96,16,52,23,43,26,97,123,42,15,8,33,62,155,2.96
7698,"Michael Adams\adamsmi01","1995-96",33,"CHH","NBA",0.8,21,3,329,37,83,23,42,14,41,26,35,5,17,22,67,21,4,25,25,114,6.98
7699,"Courtney Alexander\alexaco02","2000-01",23,"TOT","NBA",0.8,65,24,1382,239,573,222,527,17,46,123,150,42,101,143,62,45,5,75,139,618,6.94
7700,"Darrell Armstrong\armstda01","2004-05",36,"TOT","NBA",0.8,66,16,988,89,277,61,166,28,111,58,68,35,80,115,178,45,8,67,92,264,4.89
7701,"Toby Bailey\baileto01","1999-00",24,"PHO","NBA",0.8,46,2,449,58,140,56,130,2,10,45,65,26,46,72,30,13,4,24,55,163,3.17
7702,"Marcus Banks\banksma01","2007-08",26,"TOT","NBA",0.8,36,3,569,86,191,46,89,40,102,27,35,4,41,45,61,14,13,37,65,239,6.12
7703,"Mike Batiste\batismi01","2002-03",25,"MEM","NBA",0.8,75,2,1248,197,467,179,386,18,81,69,88,82,175,257,52,42,16,69,120,481,5.57
7704,"Corie Blount\blounco01","1999-00",31,"PHO","NBA",0.8,38,1,446,44,89,44,87,0,2,19,33,52,61,113,10,15,7,28,78,107,3.39
7705,"Matt Bonner\bonnema01","2015-16",35,"SAS","NBA",0.8,30,2,206,29,57,14,23,15,34,3,4,3,24,27,9,6,1,3,16,76,2.37
7706,"Calvin Booth\boothca01","2002-03",26,"SEA","NBA",0.8,47,0,575,52,119,52,117,0,2,34,47,32,77,109,12,11,33,22,74,138,3.33
7707,"Curtis Borchardt\borchcu01","2004-05",24,"UTA","NBA",0.8,67,23,859,74,172,74,172,0,0,52,71,86,138,224,49,10,32,52,160,200,3.85
7708,"Ryan Bowen\bowenry01","2003-04",28,"DEN","NBA",0.8,52,1,392,18,53,18,53,0,0,10,12,39,48,87,18,18,16,6,47,46,1.77
7709,"Sam Bowie\bowiesa01","1993-94",32,"LAL","NBA",0.8,25,7,556,75,172,74,168,1,4,72,83,27,104,131,47,4,28,43,65,223,9.48
7710,"Earl Boykins\boykiea01","1999-00",23,"TOT","NBA",0.8,26,0,261,56,116,48,96,8,20,18,23,12,14,26,48,12,1,17,23,138,5.15
7711,"Ryan Broekhoff\broekry01","2018-19",28,"DAL","NBA",0.8,42,0,453,57,126,19,33,38,93,15,19,8,55,63,22,6,4,16,35,167,3.56
7712,"Aaron Brooks\brookaa01","2012-13",28,"TOT","NBA",0.8,53,20,997,143,316,93,182,50,134,40,52,13,67,80,114,30,10,67,94,376,6.72
7713,"MarShon Brooks\brookma01","2011-12",23,"NJN","NBA",0.8,56,47,1648,274,640,227,490,47,150,113,148,70,130,200,131,52,15,118,116,708,10.53
7714,"Dee Brown\brownde01","1999-00",31,"TOR","NBA",0.8,38,12,673,93,258,26,71,67,187,11,16,9,45,54,86,24,5,39,62,264,6
7715,"Kwame Brown\brownkw01","2001-02",19,"WAS","NBA",0.8,57,3,817,94,243,94,242,0,1,70,99,63,135,198,43,16,26,43,105,258,4.52
7716,"Jud Buechler\buechju01","2001-02",33,"TOT","NBA",0.8,66,2,684,44,118,23,58,21,60,2,4,29,87,116,32,21,8,15,53,111,2.13
7717,"Rodney Buford\buforro01","2000-01",23,"PHI","NBA",0.8,47,0,573,104,241,88,203,16,38,24,29,16,58,74,17,17,6,29,68,248,3.86
7718,"Rodney Buford\buforro01","2004-05",27,"NJN","NBA",0.8,64,17,1313,187,489,153,381,34,108,37,45,33,156,189,63,40,4,35,101,445,5.26
7719,"Rodney Buford\buforro01","2001-02",24,"MEM","NBA",0.8,63,21,1769,258,593,241,523,17,70,58,80,52,220,272,71,42,12,63,110,591,7.61
7720,"Alec Burks\burksal01","2016-17",25,"UTA","NBA",0.8,42,0,653,99,248,74,172,25,76,60,78,17,103,120,30,18,5,35,50,283,5.53
7721,"Scott Burrell\burresc01","1996-97",26,"TOT","NBA",0.8,57,2,939,98,271,57,155,41,116,57,76,49,109,158,74,28,19,53,120,294,5.13
7722,"Matt Carroll\carroma01","2010-11",30,"CHA","NBA",0.8,54,1,582,89,199,72,153,17,46,40,52,12,56,68,23,17,6,23,43,235,3.54
7723,"Michael Carter-Williams\cartemi01","2014-15",23,"TOT","NBA",0.8,66,63,2149,364,919,328,766,36,153,202,291,64,289,353,442,111,30,253,167,966,15.38
7724,"Michael Carter-Williams\cartemi01","2018-19",27,"TOT","NBA",0.8,28,1,372,46,123,36,85,10,38,32,53,19,51,70,70,20,15,20,48,134,5.91
7725,"Sam Cassell\cassesa01","1998-99",29,"TOT","NBA",0.8,8,3,199,39,93,37,83,2,10,47,50,5,10,15,36,9,0,20,22,127,14.56
7726,"Calbert Cheaney\cheanca01","1999-00",28,"BOS","NBA",0.8,67,19,1309,120,273,102,219,18,54,9,21,23,115,138,80,44,14,46,158,267,4.24
7727,"Derrick Coleman\colemde01","2003-04",36,"PHI","NBA",0.8,34,30,843,107,259,99,223,8,36,49,65,45,147,192,46,23,26,57,79,271,8.13
7728,"Nick Collison\collini01","2015-16",35,"OKC","NBA",0.8,59,4,699,50,109,50,107,0,2,23,33,68,103,171,52,15,16,50,107,123,3.28
7729,"Marty Conlon\conloma01","1997-98",30,"MIA","NBA",0.8,18,0,209,28,62,28,62,0,0,32,44,16,30,46,12,9,5,11,27,88,5.02
7730,"Lester Conner\connele01","1992-93",33,"LAC","NBA",0.8,31,0,422,28,62,28,62,0,0,18,19,16,33,49,65,34,4,21,39,74,4.62
7731,"Allen Crabbe\crabbal01","2018-19",26,"BRK","NBA",0.8,43,20,1133,137,373,39,114,98,259,41,56,16,132,148,46,23,13,46,102,413,7.54
7732,"John Crotty\crottjo01","1998-99",29,"TOT","NBA",0.8,27,0,382,51,124,37,88,14,36,43,50,8,23,31,63,11,0,33,31,159,5.83
7733,"Glen Davis\davisgl01","2012-13",27,"ORL","NBA",0.8,34,33,1064,214,478,214,476,0,2,84,117,55,191,246,70,32,21,64,88,512,13.06
7734,"Tony Delk\delkto01","1997-98",24,"TOT","NBA",0.8,77,9,1681,314,798,272,641,42,157,111,151,38,134,172,172,73,12,109,96,781,7.83
7735,"Tony Delk\delkto01","2003-04",30,"DAL","NBA",0.8,33,11,509,70,184,50,118,20,66,37,44,16,43,59,28,27,7,17,46,197,5.11
7736,"Luol Deng\denglu01","2018-19",33,"MIN","NBA",0.8,22,2,392,59,118,45,74,14,44,25,35,20,53,73,18,15,8,14,24,157,7.11
7737,"Hamidou Diallo\diallha01","2018-19",20,"OKC","NBA",0.8,51,3,526,75,165,71,141,4,24,36,59,38,59,97,17,21,10,23,77,190,3.41
7738,"Boris Diaw\diawbo01","2003-04",21,"ATL","NBA",0.8,76,37,1919,140,313,134,287,6,26,56,93,111,231,342,182,59,37,126,191,342,6.75
7739,"Joey Dorsey\dorsejo01","2010-11",27,"TOR","NBA",0.8,43,9,522,52,99,52,99,0,0,31,65,79,111,190,27,24,17,39,78,135,4.74
7740,"Jared Dudley\dudleja01","2017-18",32,"PHO","NBA",0.8,48,0,686,48,122,19,42,29,80,27,35,8,86,94,78,24,11,28,85,152,4.3
7741,"Wayne Ellington\ellinwa01","2011-12",24,"MIN","NBA",0.8,51,4,973,122,302,87,194,35,108,32,40,14,85,99,33,26,10,26,56,311,4.72
7742,"Wayne Ellington\ellinwa01","2015-16",28,"BRK","NBA",0.8,76,41,1615,218,561,122,293,96,268,54,63,20,154,174,83,48,5,45,82,586,6
7743,"LaPhonso Ellis\ellisla01","1998-99",28,"ATL","NBA",0.8,20,20,539,80,190,79,185,1,5,43,61,25,84,109,18,8,7,34,48,204,8.25
7744,"Melvin Ely\elyme01","2002-03",24,"LAC","NBA",0.8,52,7,802,92,186,92,186,0,0,52,74,64,110,174,15,10,32,50,95,236,4.74
7745,"Tyler Ennis\ennisty01","2017-18",23,"LAL","NBA",0.8,54,11,683,94,224,80,168,14,56,22,29,19,76,95,105,30,10,38,75,224,4.64
7746,"Jordan Farmar\farmajo01","2008-09",22,"LAL","NBA",0.8,65,0,1192,161,412,112,266,49,146,45,77,22,95,117,155,57,10,87,105,416,6.13
7747,"Nick Fazekas\fazekni01","2007-08",22,"TOT","NBA",0.8,26,0,269,46,82,46,80,0,2,15,22,34,55,89,11,8,11,13,25,107,4.78
7748,"Gary Forbes\forbega01","2011-12",26,"TOR","NBA",0.8,48,2,713,112,271,83,188,29,83,66,91,27,75,102,54,24,4,54,56,319,5.61
7749,"Alton Ford\fordal02","2001-02",20,"PHO","NBA",0.8,53,0,452,61,118,61,118,0,0,42,57,32,75,107,7,6,7,32,99,164,2.99
7750,"Rick Fox\foxri01","2003-04",34,"LAL","NBA",0.8,38,34,846,73,186,58,125,15,61,22,30,29,73,102,98,29,4,48,99,183,5.79
7751,"Jimmer Fredette\fredeji01","2013-14",24,"TOT","NBA",0.8,49,0,519,107,227,67,143,40,84,19,21,8,44,52,64,14,3,48,35,273,4.85
7752,"Channing Frye\fryech01","2008-09",25,"POR","NBA",0.8,63,1,746,113,267,102,234,11,33,26,36,41,99,140,24,17,16,29,106,263,3.47
7753,"Dan Gadzuric\gadzuda01","2006-07",28,"MIL","NBA",0.8,54,8,840,108,228,108,227,0,1,42,90,94,152,246,29,22,32,49,141,258,5.29
7754,"Francisco García\garcifr01","2011-12",30,"SAC","NBA",0.8,49,3,798,86,229,48,98,38,131,24,30,11,88,99,31,36,37,22,73,234,4.67
7755,"Dion Glover\glovedi01","2000-01",22,"ATL","NBA",0.8,57,7,929,141,336,132,290,9,46,47,69,39,92,131,69,49,10,54,92,338,5.39
7756,"Greg Graham\grahagr01","1995-96",25,"TOT","NBA",0.8,53,5,613,78,193,46,111,32,82,52,68,17,40,57,52,25,1,46,64,240,4.05
7757,"Harvey Grant\grantha01","1998-99",33,"PHI","NBA",0.8,47,10,798,62,168,61,162,1,6,21,29,36,74,110,23,20,16,21,73,146,3.01
7758,"Jerian Grant\grantje02","2015-16",23,"NYK","NBA",0.8,76,6,1265,154,391,132,291,22,100,96,123,23,120,143,177,50,10,87,97,426,5.81
7759,"Aaron Gray\grayaa01","2007-08",23,"CHI","NBA",0.8,61,1,613,103,204,103,203,0,1,56,99,70,98,168,41,21,16,57,117,262,4.45
7760,"Ed Gray\grayed01","1997-98",22,"ATL","NBA",0.8,30,3,472,77,202,59,156,18,46,55,65,9,36,45,34,15,11,30,73,227,5.9
7761,"Litterial Green\greenli01","1996-97",26,"DET","NBA",0.8,45,0,311,30,64,30,54,0,10,30,47,6,16,22,41,16,1,15,27,90,2.32
7762,"Litterial Green\greenli01","1992-93",22,"ORL","NBA",0.8,52,4,626,87,198,86,188,1,10,60,96,11,23,34,116,23,4,42,70,235,4.57
7763,"Jordan Hamilton\hamiljo02","2012-13",22,"DEN","NBA",0.8,40,1,397,84,201,57,128,27,73,13,26,32,63,95,23,15,8,19,24,208,4.26
7764,"Tom Hammonds\hammoto01","1992-93",25,"TOT","NBA",0.8,54,5,713,105,221,105,220,0,1,38,62,38,89,127,24,18,12,34,77,248,4.07
7765,"Tim Hardaway\hardati02","2014-15",22,"NYK","NBA",0.8,70,30,1681,279,717,158,363,121,354,125,156,12,144,156,127,20,14,82,119,804,8.32
7766,"Othella Harrington\harriot01","2003-04",30,"NYK","NBA",0.8,56,3,872,100,202,100,202,0,0,58,78,58,119,177,29,12,14,65,134,258,4.67
7767,"Joe Harris\harrijo01","2016-17",25,"BRK","NBA",0.8,52,11,1138,154,362,69,141,85,221,35,49,16,131,147,54,30,8,55,121,428,6.98
7768,"Lucious Harris\harrilu01","1998-99",28,"NJN","NBA",0.8,36,5,602,73,181,62,131,11,50,36,48,21,46,67,31,18,7,18,52,193,4.5
7769,"Shaquille Harrison\harrish01","2017-18",24,"PHO","NBA",0.8,23,2,384,59,124,53,98,6,26,28,38,9,52,61,55,26,7,22,42,152,7.77
7770,"Spencer Hawes\hawessp01","2008-09",20,"SAC","NBA",0.8,77,51,2259,373,800,333,685,40,115,90,136,148,401,549,149,44,93,160,249,876,11.43
7771,"Jarvis Hayes\hayesja01","2009-10",28,"NJN","NBA",0.8,45,19,1033,138,328,78,149,60,179,14,18,9,99,108,40,29,9,28,91,350,6.23
7772,"Mark Hendrickson\hendrma01","1997-98",23,"SAC","NBA",0.8,48,1,737,58,149,58,144,0,5,47,57,33,110,143,41,26,9,31,60,163,4.09
7773,"J.J. Hickson\hicksjj01","2015-16",27,"TOT","NBA",0.8,35,9,436,80,155,80,154,0,1,46,103,39,93,132,23,15,14,25,47,206,5.73
7774,"Donald Hodge\hodgedo01","1993-94",24,"DAL","NBA",0.8,50,0,428,46,101,46,101,0,0,44,52,46,49,95,32,15,13,30,66,136,3.3
7775,"Robbie Hummel\hummero01","2014-15",25,"MIN","NBA",0.8,45,4,742,79,172,63,121,16,51,24,29,31,103,134,27,16,9,18,86,198,4.49
7776,"Darnell Jackson\jacksda01","2008-09",23,"CLE","NBA",0.8,51,2,430,37,86,37,84,0,2,24,35,32,55,87,8,10,4,14,77,98,1.99
7777,"Jerome James\jamesje01","2002-03",27,"SEA","NBA",0.8,51,16,766,111,232,111,232,0,0,54,92,78,138,216,27,12,82,75,166,276,6.23
7778,"Cory Jefferson\jeffeco01","2014-15",24,"BRK","NBA",0.8,50,1,531,75,167,73,152,2,15,31,54,47,98,145,16,10,21,20,61,183,3.62
7779,"Chris Johnson\johnsch04","2014-15",24,"TOT","NBA",0.8,29,2,526,62,154,34,59,28,95,14,16,8,47,55,15,26,7,15,44,166,5.02
7780,"Ervin Johnson\johnser02","2004-05",37,"MIN","NBA",0.8,46,23,410,28,54,27,53,1,1,16,25,43,70,113,6,7,13,18,86,73,2.35
7781,"James Johnson\johnsja01","2009-10",22,"CHI","NBA",0.8,65,11,757,95,210,80,164,15,46,51,70,34,94,128,48,21,43,62,126,256,4.24
7782,"Tyler Johnson\johnsty01","2014-15",22,"MIA","NBA",0.8,32,2,603,70,167,52,119,18,48,32,47,14,67,81,42,33,9,30,42,190,6.13
7783,"Bobby Jones\jonesbo02","2007-08",24,"TOT","NBA",0.8,47,2,531,60,140,42,87,18,53,40,51,29,63,92,28,15,3,28,85,178,3.68
7784,"James Jones\jonesja02","2016-17",36,"CLE","NBA",0.8,48,2,381,44,92,13,26,31,66,13,20,3,34,37,14,6,10,10,37,132,2.5
7785,"Solomon Jones\jonesso01","2009-10",25,"IND","NBA",0.8,52,2,675,78,176,78,173,0,3,51,71,51,93,144,32,14,37,40,125,207,4.36
7786,"Reggie Jordan\jordare01","1993-94",26,"LAL","NBA",0.8,23,0,259,44,103,42,99,2,4,35,51,46,21,67,26,14,5,14,26,125,5.5
7787,"Chris Kaman\kamanch01","2010-11",28,"LAC","NBA",0.8,32,15,838,177,376,177,376,0,0,43,57,51,174,225,46,16,48,58,75,397,11.59
7788,"Jason Kapono\kaponja01","2008-09",27,"TOR","NBA",0.8,80,12,1831,261,604,163,375,98,229,34,42,26,137,163,105,22,3,70,144,654,6.19
7789,"Alec Kessler\kesslal01","1992-93",26,"MIA","NBA",0.8,40,2,415,57,122,52,111,5,11,36,47,25,66,91,14,4,12,21,63,155,3.67
7790,"Antonio Lang\langan02","1996-97",24,"CLE","NBA",0.8,64,1,843,68,162,68,156,0,6,35,48,52,75,127,33,33,30,50,111,171,3.24
7791,"T.J. Leaf\leaftj01","2017-18",20,"IND","NBA",0.8,53,0,459,64,136,46,94,18,42,10,16,29,53,82,9,5,4,10,45,156,2.47
7792,"Tim Legler\legleti01","1992-93",26,"TOT","NBA",0.8,33,0,635,105,241,83,176,22,65,57,71,25,34,59,46,24,6,28,63,289,7.29
7793,"Tyronn Lue\luety01","2008-09",31,"TOT","NBA",0.8,44,0,521,71,162,44,100,27,62,14,19,6,40,46,60,8,0,23,54,183,3.74
7794,"Timothé Luwawu-Cabarrot\luwawti01","2017-18",22,"PHI","NBA",0.8,52,7,807,100,267,47,109,53,158,46,58,14,58,72,54,12,5,38,97,299,4.41
7795,"Timothé Luwawu-Cabarrot\luwawti01","2016-17",21,"PHI","NBA",0.8,69,19,1190,145,361,95,200,50,161,105,123,25,124,149,75,32,10,73,154,445,5.71
7796,"Trey Lyles\lylestr01","2016-17",21,"UTA","NBA",0.8,71,4,1158,159,439,94,235,65,204,57,79,48,187,235,69,26,20,64,97,440,5.21
7797,"Mark Madsen\madsema01","2004-05",29,"MIN","NBA",0.8,41,14,601,34,66,34,66,0,0,20,40,63,65,128,18,7,14,24,103,88,3.12
7798,"Danny Manning\mannida01","2001-02",35,"DAL","NBA",0.8,41,10,552,71,149,70,142,1,7,22,33,25,83,108,30,21,21,25,80,165,4.5
7799,"Donyell Marshall\marshdo01","2008-09",35,"PHI","NBA",0.8,25,0,189,33,73,8,18,25,55,3,6,6,34,40,15,4,5,6,24,94,3.56
7800,"Kendall Marshall\marshke01","2014-15",23,"MIL","NBA",0.8,28,3,417,46,101,28,55,18,46,8,9,2,26,28,86,21,0,35,26,118,5.63
7801,"Cartier Martin\martica01","2010-11",26,"WAS","NBA",0.8,52,1,542,71,182,32,83,39,99,28,40,20,54,74,18,18,6,16,52,209,3.26
7802,"Jarell Martin\martija01","2015-16",21,"MEM","NBA",0.8,27,0,380,54,116,54,114,0,2,45,62,39,47,86,15,8,7,19,58,153,5.35
7803,"Vernon Maxwell\maxweve01","1999-00",34,"SEA","NBA",0.8,47,0,989,169,490,102,267,67,223,108,148,15,64,79,75,38,9,53,83,513,7.45
7804,"Vernon Maxwell\maxweve01","1997-98",32,"TOT","NBA",0.8,42,0,636,103,258,66,146,37,112,48,60,14,43,57,52,16,4,40,71,291,5.35
7805,"James Michael McAdoo\mcadoja01","2015-16",23,"GSW","NBA",0.8,41,1,262,45,84,44,82,1,2,26,49,30,28,58,17,10,8,16,39,117,2.87
7806,"Antonio McDyess\mcdyean01","2001-02",27,"DEN","NBA",0.8,10,10,236,43,75,43,75,0,0,27,33,18,37,55,18,10,8,20,20,113,12.55
7807,"Rodney McGruder\mcgruro01","2017-18",26,"MIA","NBA",0.8,18,2,299,36,73,21,38,15,35,4,8,11,21,32,17,8,3,4,21,91,4.86
7808,"Jim McIlvaine\mcilvji01","1994-95",22,"WSB","NBA",0.8,55,0,534,34,71,34,71,0,0,28,41,40,65,105,10,10,60,19,95,96,2.83
7809,"Ben McLemore\mclembe01","2013-14",20,"SAC","NBA",0.8,82,55,2187,255,679,160,382,95,297,115,143,53,182,235,82,45,18,96,201,720,6.64
7810,"Keith McLeod\mcleoke01","2006-07",27,"TOT","NBA",0.8,48,9,718,73,188,57,143,16,45,69,78,4,39,43,90,24,5,46,51,231,4.85
7811,"Nate McMillan\mcmilna01","1997-98",33,"SEA","NBA",0.8,18,1,279,23,67,8,33,15,34,1,1,13,27,40,55,14,4,12,41,62,5.31
7812,"Josh McRoberts\mcrobjo01","2015-16",28,"MIA","NBA",0.8,42,1,595,55,148,43,99,12,49,28,40,22,83,105,81,18,7,30,68,150,4.41
7813,"Anthony Miller\millean01","1997-98",26,"ATL","NBA",0.8,37,0,228,29,52,29,52,0,0,21,39,30,40,70,3,15,3,14,41,79,2.55
7814,"Darius Miller\milleda01","2013-14",23,"NOP","NBA",0.8,45,7,723,73,166,48,89,25,77,29,36,9,43,52,43,24,9,22,88,200,4.25
7815,"Greg Minor\minorgr01","1998-99",27,"BOS","NBA",0.8,44,7,765,85,204,77,176,8,28,36,48,31,86,117,50,20,6,38,69,214,4.69
7816,"Nazr Mohammed\mohamna01","2013-14",36,"CHI","NBA",0.8,80,1,562,54,126,54,126,0,0,16,30,66,109,175,20,14,30,37,77,124,2.14
7817,"Jérôme Moïso\moisoje01","2003-04",25,"TOR","NBA",0.8,35,1,417,40,84,40,83,0,1,22,38,41,72,113,8,17,12,25,42,102,3.69
7818,"E'Twaun Moore\mooreet01","2014-15",25,"CHI","NBA",0.8,56,0,504,62,139,49,101,13,38,12,20,12,34,46,33,20,6,14,45,149,2.48
7819,"Alonzo Mourning\mournal01","2007-08",37,"MIA","NBA",0.8,25,0,389,52,95,52,95,0,0,45,76,34,59,93,7,4,42,25,56,149,6.66
7820,"Emmanuel Mudiay\mudiaem01","2018-19",22,"NYK","NBA",0.8,59,42,1607,330,740,261,530,69,210,144,186,33,163,196,228,43,19,140,103,873,12.96
7821,"Tracy Murray\murratr01","2001-02",30,"TOR","NBA",0.8,40,3,473,85,207,45,103,40,104,17,21,18,35,53,19,11,8,25,38,227,4.14
7822,"Dikembe Mutombo\mutomdi01","2002-03",36,"NJN","NBA",0.8,24,16,514,49,131,49,131,0,0,40,55,54,99,153,19,4,37,34,54,138,6.85
7823,"Mamadou N'Diaye\ndiayma02","2003-04",28,"TOT","NBA",0.8,28,1,366,27,69,27,69,0,0,44,59,43,69,112,0,8,25,18,59,98,4.46
7824,"Boštjan Nachbar\nachbbo01","2003-04",23,"HOU","NBA",0.8,45,3,516,47,132,24,69,23,63,21,29,8,62,70,30,14,14,23,72,138,2.98
7825,"Eduardo Nájera\najered01","2009-10",33,"TOT","NBA",0.8,46,5,685,62,146,43,82,19,64,14,24,34,81,115,29,26,14,25,94,157,3.86
7826,"Rasho Nesterović\nestera01","2009-10",33,"TOR","NBA",0.8,42,8,413,81,149,81,149,0,0,1,5,37,52,89,25,10,17,16,54,163,3.92
7827,"Moochie Norris\norrimo01","2003-04",30,"TOT","NBA",0.8,66,0,847,80,217,60,159,20,58,54,71,10,55,65,121,44,5,64,51,234,4.02
7828,"Dirk Nowitzki\nowitdi01","1998-99",20,"DAL","NBA",0.8,47,24,958,136,336,122,268,14,68,99,128,41,121,162,47,29,27,73,105,385,7.2
7829,"David Nwaba\nwabada01","2016-17",24,"LAL","NBA",0.8,20,2,397,47,81,46,76,1,5,25,39,17,46,63,14,13,7,11,36,120,6.47
7830,"Jermaine O'Neal\onealje01","1998-99",20,"POR","NBA",0.8,36,1,311,36,83,36,82,0,1,18,35,42,55,97,13,4,14,14,41,90,2.81
7831,"Jermaine O'Neal\onealje01","1996-97",18,"POR","NBA",0.8,45,0,458,69,153,69,152,0,1,47,78,39,85,124,8,2,26,27,46,185,3.74
7832,"Travis Outlaw\outlatr01","2010-11",26,"NJN","NBA",0.8,82,55,2358,274,731,198,479,76,252,132,171,54,271,325,84,34,36,71,148,756,7.15
7833,"Billy Owens\owensbi01","2000-01",31,"DET","NBA",0.8,45,14,793,88,230,85,210,3,20,19,40,84,121,205,55,32,12,39,93,198,4.99
7834,"Milt Palacio\palacmi01","2001-02",23,"TOT","NBA",0.8,69,1,790,82,214,69,173,13,41,54,74,11,62,73,83,30,4,40,61,231,3.28
7835,"Sasha Pavlović\pavloal01","2004-05",21,"CLE","NBA",0.8,65,9,862,120,276,90,198,30,78,44,64,15,56,71,49,29,4,47,121,314,3.93
7836,"Cameron Payne\payneca01","2017-18",23,"CHI","NBA",0.8,25,14,582,87,215,52,124,35,91,12,16,18,51,69,113,26,9,36,44,221,9.71
7837,"Anthony Peeler\peelean01","1993-94",24,"LAL","NBA",0.8,30,30,923,176,409,162,346,14,63,57,71,48,61,109,94,43,8,59,93,423,11.98
7838,"Kendrick Perkins\perkike01","2013-14",29,"OKC","NBA",0.8,62,62,1207,87,193,87,192,0,1,37,67,82,223,305,67,26,32,90,177,211,5.1
7839,"Morris Peterson\petermo01","2009-10",32,"NOH","NBA",0.8,46,39,973,116,301,54,130,62,171,33,54,17,109,126,41,25,5,27,81,327,5.69
7840,"Johan Petro\petrojo01","2009-10",24,"DEN","NBA",0.8,36,16,436,54,101,54,100,0,1,14,21,32,97,129,14,10,13,23,80,122,4.18
7841,"Zoran Planinić\planizo01","2004-05",22,"NJN","NBA",0.8,43,8,515,78,174,63,134,15,40,46,66,19,50,69,44,25,0,41,76,217,4.69
7842,"Quincy Pondexter\pondequ01","2018-19",30,"SAS","NBA",0.8,53,0,292,29,58,23,40,6,18,34,42,8,38,46,24,11,1,13,24,98,2.13
7843,"Phil Pressey\pressph01","2014-15",23,"BOS","NBA",0.8,50,0,600,64,174,48,109,16,65,33,49,13,67,80,117,30,6,41,54,177,4.45
7844,"Tayshaun Prince\princta01","2002-03",22,"DET","NBA",0.8,42,5,435,53,118,33,71,20,47,11,17,5,40,45,24,10,14,21,25,137,3.04
7845,"Vladimir Radmanović\radmavl01","2006-07",26,"LAL","NBA",0.8,55,15,986,134,316,94,198,40,118,53,73,53,127,180,66,25,18,69,125,361,6.2
7846,"Theo Ratliff\ratlith01","2007-08",34,"TOT","NBA",0.8,26,9,437,41,85,41,84,0,1,29,43,32,57,89,14,7,37,21,59,111,5.41
7847,"Eldridge Recasner\recasel01","1998-99",31,"CHH","NBA",0.8,44,2,708,82,184,58,124,24,60,34,39,20,57,77,91,17,1,58,66,222,5.37
7848,"Michael Redd\reddmi01","2011-12",32,"PHO","NBA",0.8,51,2,770,144,360,102,228,42,132,88,111,14,63,77,33,13,0,37,29,418,5.52
7849,"Shawn Respert\respesh01","1997-98",25,"TOT","NBA",0.8,57,4,911,130,293,99,200,31,93,48,61,37,63,100,61,34,1,48,75,339,5.23
7850,"Isaiah Rider\rideris01","2000-01",29,"LAL","NBA",0.8,67,6,1206,201,472,167,380,34,92,71,83,44,112,156,111,27,7,98,105,507,6.33
7851,"Andre Roberson\roberan03","2013-14",22,"OKC","NBA",0.8,40,16,399,33,68,31,55,2,13,7,10,36,58,94,15,19,10,19,74,75,2.84
7852,"Eddie Robinson\robined01","2003-04",27,"CHI","NBA",0.8,51,4,1024,157,326,156,321,1,5,28,43,27,77,104,58,33,10,45,57,343,5.76
7853,"Glenn Robinson\robingl02","2015-16",22,"IND","NBA",0.8,45,4,508,65,151,51,114,14,37,27,39,12,56,68,26,17,9,18,21,171,3.45
7854,"Dennis Rodman\rodmade01","1998-99",37,"LAL","NBA",0.8,23,11,657,16,46,16,44,0,2,17,39,62,196,258,30,10,12,31,71,49,6.83
7855,"Bryon Russell\russebr01","1995-96",25,"UTA","NBA",0.8,59,9,577,56,142,42,102,14,40,48,67,28,62,90,29,29,8,36,66,174,3.06
7856,"Domantas Sabonis\sabondo01","2016-17",20,"OKC","NBA",0.8,81,66,1632,192,481,141,322,51,159,44,67,46,242,288,82,39,32,83,200,479,5.48
7857,"Robert Sacre\sacrero01","2014-15",25,"LAL","NBA",0.8,67,18,1133,126,306,126,305,0,1,55,82,89,144,233,55,28,43,36,121,307,4.81
7858,"JaKarr Sampson\sampsja02","2017-18",24,"SAC","NBA",0.8,22,6,344,44,81,39,71,5,10,10,16,21,57,78,9,8,22,8,48,103,5.56
7859,"Jeryl Sasser\sasseje01","2002-03",23,"ORL","NBA",0.8,75,4,1025,64,207,51,163,13,44,53,78,64,120,184,65,45,12,39,91,194,3.16
7860,"Luis Scola\scolalu01","2016-17",36,"BRK","NBA",0.8,36,1,461,71,151,54,101,17,50,25,37,51,88,139,37,14,4,34,63,184,5.56
7861,"Thabo Sefolosha\sefolth01","2006-07",22,"CHI","NBA",0.8,71,4,868,109,256,94,214,15,42,23,45,35,118,153,60,33,11,60,100,256,3.6
7862,"Kevin Séraphin\serapke01","2013-14",24,"WAS","NBA",0.8,53,1,578,111,220,111,220,0,0,27,31,53,75,128,17,3,26,41,103,249,4.19
7863,"Ansu Sesay\sesayan01","2003-04",27,"SEA","NBA",0.8,57,2,583,81,178,75,157,6,21,32,46,43,49,92,19,19,20,23,66,200,3.25
7864,"Charles Shackleford\shackch01","1994-95",28,"MIN","NBA",0.8,21,2,239,39,65,39,65,0,0,16,20,16,51,67,8,8,6,8,47,94,5.1
7865,"Alexey Shved\shvedal01","2012-13",24,"MIN","NBA",0.8,77,16,1840,236,635,151,347,85,288,108,150,41,134,175,286,54,27,147,117,665,8.33
7866,"Wayne Simien\simiewa01","2005-06",22,"MIA","NBA",0.8,43,2,414,58,120,58,120,0,0,30,34,38,50,88,7,13,1,24,70,146,3.2
7867,"Reggie Slater\slatere01","1996-97",26,"TOR","NBA",0.8,26,0,406,82,149,82,147,0,2,39,75,40,55,95,21,9,6,29,34,203,7.04
7868,"Greg Smith\smithgr02","2014-15",24,"DAL","NBA",0.8,42,2,363,30,49,30,49,0,0,20,39,26,53,79,9,7,11,11,53,80,2.45
7869,"J.R. Smith\smithjr01","2016-17",31,"CLE","NBA",0.8,41,35,1187,123,356,28,85,95,271,10,15,17,96,113,62,40,11,26,77,351,6.96
7870,"LaBradford Smith\smithla02","1992-93",23,"WSB","NBA",0.8,69,33,1546,261,570,253,547,8,23,109,127,26,80,106,186,58,9,103,178,639,8.32
7871,"LaBradford Smith\smithla02","1993-94",24,"TOT","NBA",0.8,66,2,877,124,306,103,246,21,60,63,84,34,50,84,109,40,5,50,96,332,4.73
7872,"Andre Spencer\spencan01","1993-94",29,"TOT","NBA",0.8,28,1,349,52,118,52,118,0,0,55,77,30,43,73,22,19,7,21,43,159,5.6
7873,"Vladimir Stepania\stepavl01","2003-04",27,"POR","NBA",0.8,42,2,453,43,103,43,103,0,0,22,36,50,75,125,23,11,15,19,61,108,3.22
7874,"Salim Stoudamire\stoudsa01","2006-07",24,"ATL","NBA",0.8,61,0,1034,177,425,121,270,56,155,61,68,6,68,74,61,21,2,55,88,471,5.51
7875,"Erick Strickland\stricer01","2003-04",30,"MIL","NBA",0.8,43,0,571,79,196,50,130,29,66,44,51,13,58,71,90,26,2,54,63,231,5.61
7876,"Erick Strickland\stricer01","2000-01",27,"TOT","NBA",0.8,50,0,830,81,267,51,172,30,95,68,79,18,110,128,95,44,2,48,88,260,5.28
7877,"Greg Sutton\suttogr01","1994-95",27,"CHH","NBA",0.8,53,4,690,94,230,51,115,43,115,32,45,8,48,56,91,33,2,51,114,263,4.81
7878,"Sebastian Telfair\telfase01","2012-13",27,"TOT","NBA",0.8,59,2,980,112,309,59,159,53,150,54,69,13,71,84,153,37,11,64,104,331,5.74
7879,"Sebastian Telfair\telfase01","2008-09",23,"MIN","NBA",0.8,75,43,2095,267,697,194,486,73,211,131,160,32,95,127,343,73,12,146,184,738,9.57
7880,"Jamaal Tinsley\tinslja01","2007-08",29,"IND","NBA",0.8,39,36,1293,176,463,136,322,40,141,72,100,24,117,141,326,66,10,130,97,464,14.27
7881,"Ronny Turiaf\turiaro01","2011-12",29,"TOT","NBA",0.8,17,5,279,19,33,19,32,0,1,13,22,20,50,70,10,14,17,14,39,51,5.46
7882,"Hedo Türkoğlu\turkohe01","2013-14",34,"LAC","NBA",0.8,38,0,392,42,109,20,59,22,50,9,18,11,78,89,33,19,10,16,50,115,3.59
7883,"Ime Udoka\udokaim01","2009-10",32,"SAC","NBA",0.8,69,2,944,91,241,65,150,26,91,42,57,51,140,191,58,34,6,42,83,250,3.87
7884,"Beno Udrih\udrihbe01","2013-14",31,"TOT","NBA",0.8,41,12,643,78,178,59,136,19,42,25,30,10,49,59,116,23,4,47,50,200,5.74
7885,"Jarvis Varnado\varnaja01","2013-14",25,"TOT","NBA",0.8,24,0,339,36,60,36,60,0,0,27,52,19,44,63,13,10,29,10,62,99,5.25
7886,"Luke Walton\waltolu01","2012-13",32,"CLE","NBA",0.8,50,0,857,71,181,51,114,20,67,10,20,38,107,145,166,42,13,60,98,172,5.9
7887,"Hakim Warrick\warriha01","2005-06",23,"MEM","NBA",0.8,68,2,724,101,228,101,228,0,0,76,115,43,101,144,30,14,21,56,113,278,3.68
7888,"Jamie Watson\watsoja01","1994-95",22,"UTA","NBA",0.8,60,1,673,76,152,71,133,5,19,38,56,16,58,74,59,35,11,51,86,195,3.76
7889,"Jiří Welsch\welscji01","2005-06",26,"MIL","NBA",0.8,58,2,866,86,222,72,173,14,49,65,87,22,89,111,62,34,1,41,65,251,4.2
7890,"Bill Wennington\wennibi01","1997-98",34,"CHI","NBA",0.8,48,8,467,75,172,75,172,0,0,17,21,32,48,80,19,4,5,16,77,167,2.66
7891,"Doug West\westdo01","1995-96",28,"MIN","NBA",0.8,73,16,1639,175,393,174,380,1,13,114,144,48,113,161,119,30,17,81,228,465,5.99
7892,"Mark West\westma01","1995-96",35,"DET","NBA",0.8,47,21,682,61,126,61,126,0,0,28,45,49,84,133,6,6,37,35,135,150,3.59
7893,"D.J. White\whitedj01","2011-12",25,"CHA","NBA",0.8,58,11,1098,174,353,173,352,1,1,43,61,50,159,209,47,17,23,43,94,392,6.15
7894,"Randy White\whitera01","1992-93",25,"DAL","NBA",0.8,64,20,1433,235,540,225,498,10,42,138,184,154,216,370,49,63,45,108,226,618,9.26
7895,"Mike Wilks\wilksmi01","2006-07",27,"SEA","NBA",0.8,47,4,534,66,141,61,126,5,15,33,42,15,39,54,79,15,4,31,53,170,4.02
7896,"Jay Williams\willija03","2002-03",21,"CHI","NBA",0.8,75,54,1961,273,685,208,483,65,202,103,161,27,168,195,350,86,17,171,179,714,9.89
7897,"John Williams\willijo02","1993-94",27,"LAC","NBA",0.8,34,6,725,81,188,76,168,5,20,24,36,37,90,127,97,25,10,35,85,191,6.99
7898,"Trevor Wilson\wilsotr01","1993-94",25,"TOT","NBA",0.8,57,13,1221,187,388,187,386,0,2,92,166,120,153,273,72,38,11,93,123,466,7.81
7899,"Jeff Withey\witheje01","2014-15",24,"NOP","NBA",0.8,37,0,259,32,64,32,64,0,0,34,50,23,41,64,11,4,18,12,26,98,2.96
7900,"Joe Wolf\wolfjo01","1996-97",32,"MIL","NBA",0.8,56,7,525,40,89,39,82,1,7,14,19,32,80,112,20,14,11,14,105,95,2.27
7901,"Christian Wood\woodch01","2018-19",23,"TOT","NBA",0.8,21,2,251,61,117,52,91,9,26,41,56,17,66,83,8,7,10,17,17,172,7.68
7902,"Antoine Wright\wrighan01","2007-08",23,"TOT","NBA",0.8,56,10,1232,136,329,104,219,32,110,46,67,40,107,147,80,28,21,50,127,350,5.77
7903,"Brandan Wright\wrighbr03","2010-11",23,"TOT","NBA",0.8,37,2,379,60,117,60,117,0,0,21,31,31,58,89,12,11,17,14,34,141,3.95
7904,"Julian Wright\wrighju01","2008-09",21,"NOH","NBA",0.8,54,19,772,109,234,107,213,2,21,17,30,46,106,152,43,35,19,43,49,237,4.64
7905,"Julian Wright\wrighju01","2009-10",22,"NOH","NBA",0.8,68,14,871,116,232,114,226,2,6,25,41,58,86,144,41,29,18,44,45,259,3.89
7906,"Mahmoud Abdul-Rauf\abdulma02","2000-01",31,"VAN","NBA",0.7,41,0,486,120,246,116,232,4,14,22,29,5,20,25,76,9,1,26,50,266,5.17
7907,"Malik Allen\allenma01","2003-04",25,"MIA","NBA",0.7,45,6,616,83,198,83,198,0,0,25,33,42,77,119,16,12,28,27,81,191,3.84
7908,"Rafer Alston\alstora01","2001-02",25,"MIL","NBA",0.7,50,7,600,66,191,39,120,27,71,18,29,10,62,72,143,32,2,40,42,177,4.55
7909,"Al-Farouq Aminu\aminual01","2010-11",20,"LAC","NBA",0.7,81,14,1452,160,406,115,263,45,143,92,119,75,192,267,60,59,25,103,121,457,5.57
7910,"Greg Anderson\andergr01","1997-98",33,"ATL","NBA",0.7,50,0,398,36,81,36,76,0,5,16,41,39,79,118,15,19,10,17,85,88,2.39
7911,"Willie Anderson\anderwi01","1994-95",28,"SAS","NBA",0.7,38,11,556,76,162,73,143,3,19,30,41,15,40,55,52,26,10,38,71,185,4.97
7912,"B.J. Armstrong\armstbj01","1998-99",31,"TOT","NBA",0.7,32,1,358,40,88,33,73,7,15,18,21,2,37,39,61,12,0,25,31,105,4.02
7913,"Darrell Arthur\arthuda01","2013-14",25,"DEN","NBA",0.7,68,1,1161,162,410,138,346,24,64,53,62,52,158,210,61,39,47,58,185,401,5.5
7914,"Keith Askins\askinke01","1997-98",30,"MIA","NBA",0.7,46,12,681,39,122,18,48,21,74,12,19,28,73,101,29,27,12,26,107,111,2.92
7915,"Stacey Augmon\augmost01","2004-05",36,"ORL","NBA",0.7,55,7,663,68,167,68,167,0,0,57,77,45,54,99,36,23,8,31,83,193,3.43
7916,"Gustavo Ayón\ayongu01","2013-14",28,"ATL","NBA",0.7,26,14,429,52,102,52,102,0,0,8,20,42,83,125,28,25,10,29,47,112,6.08
7917,"Kelenna Azubuike\azubuke01","2009-10",26,"GSW","NBA",0.7,9,7,231,48,88,38,61,10,27,19,28,12,29,41,10,5,9,7,16,125,12.63
7918,"Luke Babbitt\babbilu01","2013-14",24,"NOP","NBA",0.7,27,2,473,60,154,24,59,36,95,14,18,18,70,88,29,7,11,15,52,170,5.73
7919,"Luke Babbitt\babbilu01","2011-12",22,"POR","NBA",0.7,40,4,537,71,173,28,73,43,100,17,20,16,79,95,16,10,4,27,46,202,4.25
7920,"Luke Babbitt\babbilu01","2012-13",23,"POR","NBA",0.7,62,0,730,86,234,24,56,62,178,10,13,15,122,137,29,14,5,22,82,244,3.32
7921,"Marcus Banks\banksma01","2003-04",22,"BOS","NBA",0.7,81,2,1385,177,442,150,356,27,86,99,131,30,103,133,175,88,13,125,171,480,6.19
7922,"J.J. Barea\bareajo01","2013-14",29,"MIN","NBA",0.7,79,1,1471,254,656,181,425,73,231,79,100,16,138,154,303,26,0,125,129,660,7.52
7923,"Matt Barnes\barnema02","2003-04",23,"LAC","NBA",0.7,38,9,724,63,138,61,125,2,13,43,61,53,98,151,48,27,3,44,76,171,5.67
7924,"Lonny Baxter\baxtelo01","2005-06",27,"TOT","NBA",0.7,41,0,400,45,104,45,104,0,0,28,35,45,72,117,4,11,8,20,56,118,3.09
7925,"Kent Bazemore\bazemke01","2018-19",29,"ATL","NBA",0.7,67,35,1643,278,691,182,391,96,300,127,175,37,224,261,152,89,42,121,170,779,10.69
7926,"Tony Bennett\benneto01","1992-93",23,"CHH","NBA",0.7,75,2,857,110,260,84,180,26,80,30,41,12,51,63,136,30,0,50,110,276,3.79
7927,"David Benoit\benoida01","2000-01",32,"UTA","NBA",0.7,49,2,446,71,147,66,134,5,13,31,39,20,61,81,22,6,6,28,75,178,3.23
7928,"Travis Best\besttr01","1995-96",23,"IND","NBA",0.7,59,1,571,69,163,61,138,8,25,75,90,11,33,44,97,20,3,63,80,221,4
7929,"Travis Best\besttr01","2003-04",31,"DAL","NBA",0.7,61,1,762,64,172,61,152,3,20,40,46,17,51,68,112,31,4,33,66,171,3.5
7930,"Mike Bibby\bibbymi01","2011-12",33,"NYK","NBA",0.7,39,4,557,35,124,8,39,27,85,6,8,5,54,59,80,21,3,20,45,103,3.39
7931,"Tarik Black\blackta01","2015-16",24,"LAL","NBA",0.7,39,0,496,57,104,57,104,0,0,19,45,44,113,157,16,14,18,22,78,133,4.44
7932,"Steve Blake\blakest01","2003-04",23,"WAS","NBA",0.7,75,14,1392,157,407,82,205,75,202,55,67,18,99,117,209,57,7,128,100,444,6.29
7933,"Corie Blount\blounco01","1998-99",30,"TOT","NBA",0.7,34,3,530,36,100,36,99,0,1,28,54,58,93,151,12,19,16,21,74,100,3.91
7934,"Mark Blount\blounma01","2007-08",32,"MIA","NBA",0.7,69,46,1542,238,515,221,471,17,44,88,138,69,194,263,41,33,34,70,133,581,7.05
7935,"Mark Blount\blounma01","2001-02",26,"BOS","NBA",0.7,44,0,415,32,76,32,76,0,0,30,37,26,59,85,10,16,19,23,59,94,2.75
7936,"Andrew Bogut\bogutan01","2016-17",32,"TOT","NBA",0.7,27,21,583,38,81,38,80,0,1,3,11,56,162,218,49,13,25,43,86,79,6.9
7937,"Chris Boucher\bouchch01","2018-19",26,"TOR","NBA",0.7,28,0,163,34,76,22,39,12,37,13,15,16,40,56,2,6,24,7,31,93,3.54
7938,"Anthony Bowie\bowiean01","1997-98",34,"NYK","NBA",0.7,27,3,224,32,59,29,55,3,4,8,9,9,17,26,11,6,2,7,25,75,2.65
7939,"Elton Brand\brandel01","2014-15",35,"ATL","NBA",0.7,36,4,486,42,95,42,94,0,1,12,23,28,72,100,22,17,25,18,54,96,3.66
7940,"Primož Brezec\brezepr01","2006-07",27,"CHA","NBA",0.7,58,40,838,122,274,121,271,1,3,43,68,80,104,184,23,11,23,38,161,288,4.34
7941,"MarShon Brooks\brookma01","2017-18",29,"MEM","NBA",0.7,7,1,193,51,102,32,70,19,32,20,23,8,13,21,25,11,3,16,6,141,18.26
7942,"Scott Brooks\brooksc01","1996-97",31,"NYK","NBA",0.7,38,0,251,19,39,14,27,5,12,14,15,6,12,18,29,21,0,17,35,57,2.25
7943,"Shannon Brown\brownsh01","2008-09",23,"TOT","NBA",0.7,48,0,477,78,165,64,128,14,37,32,39,11,33,44,38,22,7,38,42,202,3.88
7944,"Sterling Brown\brownst02","2017-18",22,"MIL","NBA",0.7,54,4,776,82,205,50,114,32,91,21,24,27,116,143,25,31,13,25,80,217,4.07
7945,"Rick Brunson\brunsri01","2001-02",29,"POR","NBA",0.7,59,2,520,45,113,39,102,6,11,29,41,23,45,68,114,25,2,47,51,125,3.26
7946,"Chase Budinger\budinch01","2012-13",24,"MIN","NBA",0.7,23,1,508,79,191,53,110,26,81,32,42,15,56,71,25,14,7,23,29,216,7.6
7947,"Michael Cage\cagemi01","1999-00",38,"NJN","NBA",0.7,20,7,242,12,24,12,24,0,0,3,3,33,48,81,9,8,8,4,30,27,3.36
7948,"Matt Carroll\carroma01","2004-05",24,"CHA","NBA",0.7,25,0,430,70,180,57,141,13,39,71,83,13,47,60,17,17,2,25,37,224,7.02
7949,"Omri Casspi\casspom01","2012-13",24,"CLE","NBA",0.7,43,1,503,63,160,38,84,25,76,22,41,20,94,114,28,25,12,22,45,173,4.12
7950,"Duane Causwell\causwdu01","1996-97",28,"SAC","NBA",0.7,46,8,581,48,94,46,91,2,3,20,37,57,70,127,20,15,38,34,131,118,3.72
7951,"Duane Causwell\causwdu01","1999-00",31,"MIA","NBA",0.7,25,2,185,20,37,20,37,0,0,26,38,11,36,47,2,2,16,10,42,66,3.07
7952,"Marquese Chriss\chrisma01","2017-18",20,"PHO","NBA",0.7,72,49,1527,202,477,146,287,56,190,96,158,76,319,395,83,51,70,107,205,556,8.25
7953,"Jarron Collins\collija03","2002-03",24,"UTA","NBA",0.7,22,7,421,38,86,38,85,0,1,44,62,32,28,60,14,5,6,19,70,120,5.04
7954,"Bill Curley\curlebi01","1998-99",26,"MIN","NBA",0.7,35,7,372,29,72,28,67,1,5,19,22,20,31,51,14,17,9,10,83,78,2.61
7955,"Yakhouba Diawara\diawaya01","2007-08",25,"DEN","NBA",0.7,54,14,542,55,134,34,68,21,66,22,31,23,39,62,37,8,3,16,61,153,2.56
7956,"Travis Diener\dienetr01","2006-07",24,"ORL","NBA",0.7,26,0,288,34,80,16,30,18,50,12,15,3,15,18,35,4,0,13,27,98,3.47
7957,"Ike Diogu\dioguik01","2007-08",24,"IND","NBA",0.7,30,1,305,64,134,64,134,0,0,40,47,38,47,85,10,7,3,20,43,168,4.9
7958,"Ike Diogu\dioguik01","2008-09",25,"TOT","NBA",0.7,29,1,215,39,74,38,72,1,2,40,53,26,30,56,3,3,3,12,23,119,3.7
7959,"Keyon Dooling\doolike01","2009-10",29,"NJN","NBA",0.7,53,8,971,129,324,70,167,59,157,47,61,8,46,54,135,34,0,59,82,364,6.29
7960,"Chris Douglas-Roberts\douglch01","2009-10",23,"NJN","NBA",0.7,67,38,1730,255,573,241,519,14,54,133,157,45,153,198,93,55,19,97,101,657,8.37
7961,"Predrag Drobnjak\drobnpr01","2003-04",28,"LAC","NBA",0.7,61,14,949,149,379,138,343,11,36,73,86,54,142,196,39,22,24,48,85,382,5.17
7962,"Obinna Ekezie\ekeziob01","2004-05",29,"ATL","NBA",0.7,42,31,732,79,182,79,181,0,1,72,93,69,110,179,11,22,12,45,129,230,5.61
7963,"Wayne Ellington\ellinwa01","2013-14",26,"DAL","NBA",0.7,45,1,393,55,126,30,67,25,59,10,11,8,35,43,19,16,2,11,33,145,2.81
7964,"Pervis Ellison\ellispe01","1993-94",26,"WSB","NBA",0.7,47,24,1178,137,292,137,289,0,3,70,97,77,165,242,70,25,50,73,140,344,8.29
7965,"Evan Eschmeyer\eschmev01","1999-00",24,"NJN","NBA",0.7,31,5,373,38,72,38,72,0,0,15,30,40,68,108,21,8,21,21,84,91,4.21
7966,"Tyreke Evans\evansty01","2016-17",27,"TOT","NBA",0.7,40,6,788,150,370,108,252,42,118,69,92,13,124,137,124,35,9,61,60,411,9.64
7967,"Dante Exum\exumda01","2017-18",22,"UTA","NBA",0.7,14,0,235,42,87,37,69,5,18,25,31,4,22,26,43,8,3,20,20,114,8.44
7968,"Jordan Farmar\farmajo01","2013-14",27,"LAL","NBA",0.7,41,5,912,151,364,81,204,70,160,44,59,20,84,104,199,38,8,95,65,416,10.73
7969,"Raymond Felton\feltora01","2018-19",34,"OKC","NBA",0.7,33,0,379,55,135,35,74,20,61,12,13,4,30,34,52,10,6,14,29,142,4.04
7970,"T.J. Ford\fordtj01","2003-04",20,"MIL","NBA",0.7,55,55,1472,153,398,148,377,5,21,80,98,37,140,177,356,60,3,139,123,391,9.97
7971,"Adonal Foyle\foylead01","2000-01",25,"GSW","NBA",0.7,58,37,1457,156,375,156,375,0,0,30,68,156,249,405,48,31,156,79,136,342,7.97
7972,"Todd Fuller\fulleto02","1997-98",23,"GSW","NBA",0.7,57,1,613,86,205,86,201,0,4,55,80,61,135,196,10,6,16,37,89,227,3.69
7973,"Todd Fuller\fulleto02","1996-97",22,"GSW","NBA",0.7,75,18,949,114,266,114,266,0,0,76,110,108,141,249,24,10,20,52,146,304,3.87
7974,"Matt Geiger\geigema01","2000-01",31,"PHI","NBA",0.7,35,4,542,88,224,88,222,0,2,37,54,50,89,139,14,12,8,25,73,213,4.79
7975,"Devean George\georgde01","1999-00",22,"LAL","NBA",0.7,49,1,345,56,144,40,97,16,47,27,41,29,46,75,12,10,4,21,54,155,2.49
7976,"Devean George\georgde01","2007-08",30,"DAL","NBA",0.7,53,4,821,74,207,52,139,22,68,24,34,28,109,137,35,19,13,24,90,194,3.44
7977,"Kendall Gill\gillke01","2001-02",33,"MIA","NBA",0.7,65,49,1410,162,422,156,378,6,44,42,62,29,155,184,100,44,8,55,140,372,5.02
7978,"Archie Goodwin\goodwar01","2016-17",22,"TOT","NBA",0.7,15,0,214,36,66,31,51,5,15,33,42,7,21,28,24,4,5,14,8,110,7.34
7979,"Eric Gordon\gordoer01","2011-12",23,"NOH","NBA",0.7,9,9,310,63,140,53,100,10,40,49,65,2,23,25,31,13,4,24,20,185,17.03
7980,"Harvey Grant\grantha01","1997-98",32,"WAS","NBA",0.7,65,8,895,75,196,74,190,1,6,19,30,60,108,168,39,23,15,26,94,170,2.87
7981,"Jeff Green\greenje02","2016-17",30,"ORL","NBA",0.7,69,11,1534,220,558,167,365,53,193,145,168,39,175,214,81,37,13,75,103,638,7.46
7982,"Donté Greene\greendo01","2011-12",23,"SAC","NBA",0.7,53,7,777,108,266,83,161,25,105,44,55,19,114,133,34,18,29,32,67,285,4.77
7983,"Lynn Greer\greerly01","2006-07",27,"MIL","NBA",0.7,41,0,432,61,141,43,89,18,52,27,32,2,25,27,53,17,1,18,32,167,3.81
7984,"Malik Hairston\hairsma01","2009-10",22,"SAS","NBA",0.7,47,0,317,40,76,38,65,2,11,17,30,13,36,49,16,4,9,11,29,99,2.08
7985,"Richard Hamilton\hamilri01","1999-00",21,"WAS","NBA",0.7,71,12,1373,254,605,226,528,28,77,103,133,38,91,129,108,28,6,84,142,639,6.54
7986,"Tyler Hansbrough\hansbty01","2009-10",24,"IND","NBA",0.7,29,1,511,81,225,81,221,0,4,84,113,60,78,138,28,17,8,21,70,246,7.13
7987,"Josh Harrellson\harrejo01","2013-14",24,"DET","NBA",0.7,32,0,317,38,82,26,51,12,31,5,7,30,46,76,15,6,15,10,44,93,3.36
7988,"Donnell Harvey\harvedo01","2003-04",23,"TOT","NBA",0.7,60,8,783,89,201,89,198,0,3,61,83,48,116,164,21,24,27,45,129,239,4.14
7989,"Trenton Hassell\hassetr01","2008-09",29,"NJN","NBA",0.7,53,31,1094,86,191,84,183,2,8,20,25,50,96,146,51,21,16,30,92,194,4.13
7990,"Jarvis Hayes\hayesja01","2005-06",24,"WAS","NBA",0.7,21,13,516,77,183,60,136,17,47,25,30,19,57,76,27,16,1,22,38,196,7.75
7991,"Alan Henderson\hendeal01","2001-02",29,"ATL","NBA",0.7,26,1,422,59,116,58,115,1,1,24,45,31,66,97,11,11,15,21,40,143,5.58
7992,"Walter Herrmann\herrmwa01","2007-08",28,"TOT","NBA",0.7,45,0,373,56,144,36,80,20,64,21,25,22,51,73,18,7,1,12,24,153,2.72
7993,"Eddie House\houseed01","2003-04",25,"LAC","NBA",0.7,60,10,1188,161,449,110,313,51,136,36,45,28,110,138,148,65,4,63,92,409,6.37
7994,"Eddie House\houseed01","2002-03",24,"MIA","NBA",0.7,55,7,1025,172,444,136,324,36,120,31,36,17,84,101,87,44,1,46,73,411,5.69
7995,"Allan Houston\houstal01","2004-05",33,"NYK","NBA",0.7,20,11,532,85,205,54,125,31,80,36,43,4,19,23,42,8,2,21,40,237,8.64
7996,"Byron Houston\houstby01","1995-96",26,"SAC","NBA",0.7,25,0,276,32,64,31,61,1,3,21,26,31,53,84,7,13,7,17,59,86,4.34
7997,"Juwan Howard\howarju01","2008-09",35,"TOT","NBA",0.7,42,2,472,75,147,75,147,0,0,23,34,30,46,76,26,7,6,26,71,173,3.7
7998,"Troy Hudson\hudsotr01","2005-06",29,"MIN","NBA",0.7,36,0,800,127,333,87,232,40,101,48,52,8,36,44,106,12,4,40,55,342,7.35
7999,"Larry Hughes\hughela01","2009-10",31,"TOT","NBA",0.7,45,16,1115,137,386,94,247,43,139,94,113,23,119,142,137,52,15,75,70,411,8.96
8000,"Kris Humphries\humphkr01","2008-09",23,"TOR","NBA",0.7,29,0,265,38,90,38,90,0,0,38,48,24,46,70,10,8,6,8,31,114,3.77
8001,"Zydrunas Ilgauskas\ilgauzy01","2000-01",25,"CLE","NBA",0.7,24,24,616,114,234,114,232,0,2,53,78,65,95,160,18,15,37,60,78,281,11.26
8002,"Allen Iverson\iversal01","2009-10",34,"TOT","NBA",0.7,28,24,865,136,316,127,291,9,25,104,131,16,63,79,113,19,2,64,48,385,12.09
8003,"Royal Ivey\iveyro01","2005-06",24,"ATL","NBA",0.7,73,66,978,116,264,112,254,4,10,24,33,31,65,96,74,24,7,23,147,260,3.25
8004,"Wesley Iwundu\iwundwe01","2017-18",23,"ORL","NBA",0.7,62,12,1020,93,218,84,172,9,46,34,47,36,101,137,57,33,12,30,81,229,3.94
8005,"Darnell Jackson\jacksda01","2010-11",25,"SAC","NBA",0.7,59,2,486,77,158,74,147,3,11,30,49,49,45,94,14,12,3,23,61,187,2.73
8006,"Marc Jackson\jacksma02","2006-07",32,"NOK","NBA",0.7,56,25,1025,159,388,159,387,0,1,90,103,62,130,192,58,21,7,65,89,408,6.04
8007,"Jerome James\jamesje01","2003-04",28,"SEA","NBA",0.7,65,24,990,129,259,129,259,0,0,66,100,78,152,230,32,20,60,82,180,324,5.49
8008,"Othyus Jeffers\jeffeot01","2010-11",25,"TOT","NBA",0.7,17,1,322,31,65,30,61,1,4,30,46,25,42,67,20,17,0,14,32,93,6.55
8009,"Eugene Jeter\jetereu01","2010-11",27,"SAC","NBA",0.7,62,1,858,106,259,100,229,6,30,37,41,9,61,70,162,29,2,51,54,255,4.62
8010,"Yi Jianlian\jianlyi01","2007-08",20,"MIL","NBA",0.7,66,49,1647,219,520,213,499,6,21,122,145,106,238,344,55,36,56,90,153,566,8.06
8011,"Yi Jianlian\jianlyi01","2008-09",21,"NJN","NBA",0.7,61,52,1421,191,500,143,360,48,140,95,123,67,259,326,60,29,36,70,157,525,7.65
8012,"Anthony Johnson\johnsan02","2001-02",27,"NJN","NBA",0.7,34,0,366,37,90,33,78,4,12,16,25,10,19,29,48,31,1,20,30,94,3.5
8013,"Ervin Johnson\johnser02","1993-94",26,"SEA","NBA",0.7,45,3,280,44,106,44,106,0,0,29,46,48,70,118,7,10,22,24,45,117,2.91
8014,"Dahntay Jones\jonesda02","2006-07",26,"MEM","NBA",0.7,78,25,1671,220,461,215,449,5,12,138,174,47,106,153,68,39,22,92,192,583,6.37
8015,"Damon Jones\jonesda01","1998-99",22,"TOT","NBA",0.7,24,0,344,43,119,18,57,25,62,14,17,6,38,44,42,13,0,17,23,125,4.9
8016,"Damon Jones\jonesda01","1999-00",23,"TOT","NBA",0.7,55,1,612,80,208,39,94,41,114,32,48,12,43,55,96,18,1,40,34,233,4.02
8017,"James Jones\jonesja02","2013-14",33,"MIA","NBA",0.7,20,6,236,31,68,3,14,28,54,7,11,2,21,23,9,3,4,4,6,97,4.08
8018,"Terrence Jones\joneste01","2012-13",21,"HOU","NBA",0.7,19,0,276,43,94,38,75,5,19,13,17,28,37,65,15,12,19,13,21,104,6.08
8019,"Chris Kaman\kamanch01","2011-12",29,"NOH","NBA",0.7,47,33,1372,266,597,266,597,0,0,84,107,89,275,364,101,25,77,129,106,616,12.56
8020,"Sergey Karasev\karasse01","2014-15",21,"BRK","NBA",0.7,33,16,555,54,134,38,80,16,54,29,38,22,44,66,46,23,1,24,45,153,4.83
8021,"Ryan Kelly\kellyry01","2014-15",23,"LAL","NBA",0.7,52,34,1233,104,309,59,175,45,134,79,95,13,133,146,92,30,24,37,118,332,6.16
8022,"Brevin Knight\knighbr01","2008-09",33,"UTA","NBA",0.7,74,0,938,66,189,66,183,0,6,48,64,13,75,88,190,68,4,66,98,180,4.14
8023,"Kosta Koufos\koufoko01","2018-19",29,"SAC","NBA",0.7,42,1,502,73,153,73,153,0,0,10,24,52,125,177,36,15,18,27,68,156,4.67
8024,"Rob Kurz\kurzro01","2008-09",23,"GSW","NBA",0.7,40,5,442,51,131,36,93,15,38,40,50,33,48,81,20,14,19,16,78,157,3.89
8025,"Christian Laettner\laettch01","1998-99",29,"DET","NBA",0.7,16,0,337,38,106,37,103,1,3,44,57,21,33,54,24,15,12,19,30,121,7.41
8026,"Andrew Lang\langan01","1997-98",31,"MIL","NBA",0.7,57,0,692,54,143,54,142,0,1,44,57,56,97,153,16,18,27,33,101,152,3.12
8027,"Antonio Lang\langan02","1995-96",23,"CLE","NBA",0.7,41,0,367,41,77,41,75,0,2,34,47,17,36,53,12,14,12,24,61,116,3.06
8028,"Acie Law\lawac01","2008-09",24,"ATL","NBA",0.7,55,1,560,52,139,43,110,9,29,49,60,6,52,58,86,11,3,29,43,162,3.23
8029,"Damion Lee\leeda03","2018-19",26,"GSW","NBA",0.7,32,0,375,56,127,29,59,27,68,19,22,8,56,64,13,13,0,11,28,158,4.31
8030,"Raül López\lopezra01","2004-05",24,"UTA","NBA",0.7,31,15,518,57,135,37,90,20,45,27,33,7,32,39,123,22,3,47,78,161,6.86
8031,"George Lynch\lynchge01","2001-02",31,"CHH","NBA",0.7,45,18,893,73,198,72,192,1,6,25,40,70,116,186,54,40,14,41,75,172,4.86
8032,"Shelvin Mack\macksh01","2011-12",21,"WAS","NBA",0.7,64,0,779,88,220,76,178,12,42,42,59,12,80,92,131,28,2,48,50,230,4.1
8033,"Corey Maggette\maggeco01","2011-12",32,"CHA","NBA",0.7,32,28,881,139,373,115,307,24,66,178,208,21,104,125,39,23,1,59,83,480,11.36
8034,"Ian Mahinmi\mahinia01","2009-10",23,"SAS","NBA",0.7,26,0,165,35,55,35,55,0,0,31,47,13,39,52,2,3,8,15,32,101,3.88
8035,"Matt Maloney\malonma01","1999-00",28,"CHI","NBA",0.7,51,12,1175,114,318,52,144,62,174,37,45,10,54,64,138,32,3,63,42,327,5.94
8036,"Cartier Martin\martica01","2012-13",28,"WAS","NBA",0.7,41,3,694,96,252,38,106,58,146,20,28,11,89,100,20,19,6,32,58,270,5.02
8037,"Cartier Martin\martica01","2011-12",27,"WAS","NBA",0.7,17,2,391,59,134,30,59,29,75,11,19,12,46,58,10,11,2,13,35,158,7.48
8038,"Darrick Martin\martida01","2000-01",29,"SAC","NBA",0.7,31,0,176,29,76,15,49,14,27,31,35,2,14,16,14,7,0,10,27,103,2.68
8039,"Jamal Mashburn\mashbja01","2003-04",31,"NOH","NBA",0.7,19,18,730,156,398,137,331,19,67,65,80,19,98,117,47,14,5,37,42,396,14.26
8040,"Tony Massenburg\masseto01","2000-01",33,"VAN","NBA",0.7,52,20,823,92,199,92,199,0,0,49,70,75,135,210,9,10,28,48,122,233,4.65
8041,"Walter McCarty\mccarwa01","2000-01",26,"BOS","NBA",0.7,60,3,478,45,126,26,70,19,56,22,28,24,57,81,39,14,7,20,82,131,2.28
8042,"Xavier McDaniel\mcdanxa01","1996-97",33,"NJN","NBA",0.7,62,5,1170,138,355,133,330,5,25,65,89,124,194,318,65,36,17,70,144,346,5.87
8043,"Chris Mihm\mihmch01","2001-02",22,"CLE","NBA",0.7,74,60,1659,221,526,218,519,3,7,124,179,133,259,392,24,18,89,97,260,569,7.04
8044,"C.J. Miles\milescj01","2018-19",31,"TOT","NBA",0.7,53,1,856,112,311,45,108,67,203,48,58,13,82,95,36,26,15,30,79,339,4.94
8045,"Darko Miličić\milicda01","2009-10",24,"TOT","NBA",0.7,32,18,685,100,204,100,203,0,1,15,28,47,104,151,47,22,34,35,82,215,7.69
8046,"Patty Mills\millspa02","2010-11",22,"POR","NBA",0.7,64,0,783,135,328,88,195,47,133,36,47,19,32,51,109,27,1,62,63,353,4.65
8047,"Eric Montross\montrer01","1997-98",26,"TOT","NBA",0.7,48,30,691,61,144,61,144,0,0,16,40,69,130,199,11,13,27,29,127,138,3.57
8048,"Anthony Morrow\morroan01","2012-13",27,"TOT","NBA",0.7,41,1,383,64,145,48,102,16,43,20,22,11,19,30,13,13,1,8,43,164,2.98
8049,"Donatas Motiejūnas\motiedo01","2012-13",22,"HOU","NBA",0.7,44,14,538,97,213,73,130,24,83,32,51,36,57,93,31,7,10,37,73,250,4.66
8050,"Timofey Mozgov\mozgoti01","2012-13",26,"DEN","NBA",0.7,41,1,366,44,87,44,85,0,2,20,26,50,57,107,9,6,18,25,57,108,3.17
8051,"Shabazz Muhammad\muhamsh01","2017-18",25,"TOT","NBA",0.7,43,2,418,84,188,77,161,7,27,39,50,23,53,76,14,9,3,6,30,214,3.79
8052,"Ronald Murray\murraro01","2005-06",26,"TOT","NBA",0.7,76,27,2112,321,768,284,627,37,141,172,242,33,120,153,197,68,11,135,133,851,9.06
8053,"Lee Nailon\nailole01","2003-04",28,"TOT","NBA",0.7,57,4,780,147,327,147,324,0,3,47,58,64,79,143,38,15,8,45,93,341,4.75
8054,"Steve Nash\nashst01","1996-97",22,"PHO","NBA",0.7,65,2,684,74,175,51,120,23,55,42,51,16,47,63,138,20,0,63,92,213,3.97
8055,"Raul Neto\netora01","2016-17",24,"UTA","NBA",0.7,40,0,346,41,91,31,60,10,31,8,9,4,26,30,34,21,5,15,48,100,2.82
8056,"Lucas Nogueira\noguelu01","2015-16",23,"TOR","NBA",0.7,29,1,225,28,44,27,41,1,3,8,15,18,28,46,7,12,12,11,29,65,2.98
8057,"Ed O'Bannon\obanned01","1995-96",23,"NJN","NBA",0.7,64,29,1253,156,400,146,344,10,56,77,108,65,103,168,63,44,11,62,95,399,5.19
8058,"Lamar Odom\odomla01","2001-02",22,"LAC","NBA",0.7,29,25,999,151,360,135,276,16,84,61,93,31,145,176,171,23,36,97,91,379,14.24
8059,"Semi Ojeleye\ojelese01","2018-19",24,"BOS","NBA",0.7,56,3,594,67,158,39,69,28,89,24,39,24,62,86,23,10,4,19,43,186,2.85
8060,"Greg Ostertag\ostergr01","2004-05",31,"SAC","NBA",0.7,56,3,556,37,84,37,82,0,2,13,38,55,112,167,37,7,40,24,88,87,2.87
8061,"Bo Outlaw\outlabo01","2005-06",34,"ORL","NBA",0.7,32,0,355,35,58,35,58,0,0,5,8,31,46,77,14,10,12,17,50,75,3.32
8062,"Robert Pack\packro01","1998-99",29,"DAL","NBA",0.7,25,0,468,75,174,75,170,0,4,72,88,9,27,36,81,20,1,49,41,222,8.62
8063,"Andrae Patterson\pattean01","1998-99",23,"MIN","NBA",0.7,35,0,284,43,97,43,92,0,5,28,36,30,35,65,15,19,7,22,62,114,3.44
8064,"Kendrick Perkins\perkike01","2004-05",20,"BOS","NBA",0.7,60,3,548,56,119,56,119,0,0,37,58,53,123,176,21,9,37,43,98,149,3.33
8065,"Johan Petro\petrojo01","2011-12",26,"NJN","NBA",0.7,59,10,920,109,260,108,259,1,1,31,37,68,156,224,45,21,23,38,122,250,4.53
8066,"Ed Pinckney\pincked01","1996-97",33,"MIA","NBA",0.7,27,0,273,23,43,23,43,0,0,20,25,25,40,65,6,8,9,19,30,66,3.24
8067,"Zoran Planinić\planizo01","2003-04",21,"NJN","NBA",0.7,49,1,473,53,129,44,97,9,32,38,60,14,41,55,68,13,3,36,70,153,3.26
8068,"Josh Powell\poweljo01","2005-06",23,"DAL","NBA",0.7,37,2,429,37,81,37,81,0,0,36,45,28,53,81,9,7,4,22,52,110,3.05
8069,"A.J. Price\priceaj01","2011-12",25,"IND","NBA",0.7,44,1,568,59,174,33,86,26,88,28,35,13,48,61,86,20,2,32,30,172,4.02
8070,"Brent Price\pricebr01","1996-97",28,"HOU","NBA",0.7,25,0,390,44,105,27,52,17,53,21,21,10,19,29,65,17,0,32,34,126,5.77
8071,"Brent Price\pricebr01","1993-94",25,"WSB","NBA",0.7,65,13,1035,141,326,91,176,50,150,68,87,31,59,90,213,55,2,119,114,400,7.11
8072,"Ronnie Price\pricero01","2014-15",31,"LAL","NBA",0.7,43,20,982,77,223,46,114,31,109,36,45,19,50,69,165,67,4,52,118,221,7.09
8073,"Chasson Randle\randlch01","2016-17",23,"TOT","NBA",0.7,26,0,299,40,98,24,51,16,47,41,43,6,26,32,34,9,2,19,39,137,5.02
8074,"Shavlik Randolph\randosh01","2012-13",29,"BOS","NBA",0.7,16,0,198,28,48,28,48,0,0,11,27,28,42,70,4,8,7,10,38,67,5.12
8075,"Željko Rebrača\rebraze01","2005-06",33,"LAC","NBA",0.7,29,2,412,52,96,52,96,0,0,31,41,13,51,64,9,5,19,24,59,135,4.65
8076,"J.R. Reid\reidjr01","1999-00",31,"MIL","NBA",0.7,34,7,602,53,127,52,120,1,7,43,56,29,88,117,18,19,5,20,81,150,4.68
8077,"Shawn Respert\respesh01","1996-97",24,"TOT","NBA",0.7,41,0,495,59,139,39,82,20,57,34,39,14,25,39,40,20,2,30,40,172,3.93
8078,"Quentin Richardson\richaqu01","2005-06",25,"NYK","NBA",0.7,55,43,1442,163,459,99,271,64,188,61,91,65,165,230,88,39,6,56,134,451,6.9
8079,"Eric Riley\rileyer01","1998-99",28,"BOS","NBA",0.7,35,11,337,28,54,28,54,0,0,22,31,36,63,99,13,9,26,26,73,78,3.53
8080,"Stanley Roberts\roberst01","1995-96",25,"LAC","NBA",0.7,51,7,795,141,304,141,304,0,0,74,133,42,120,162,41,15,39,48,153,356,6.11
8081,"David Robinson\robinda01","1996-97",31,"SAS","NBA",0.7,6,6,147,36,72,36,72,0,0,34,52,19,32,51,8,6,6,8,9,106,16.5
8082,"Glenn Robinson\robingl02","2018-19",25,"DET","NBA",0.7,47,18,610,74,176,56,114,18,62,32,40,17,54,71,21,14,8,18,45,198,3.49
8083,"Sergio Rodríguez\rodrise01","2016-17",30,"PHI","NBA",0.7,68,30,1518,210,536,118,284,92,252,18,27,21,136,157,344,49,4,128,95,530,8.69
8084,"Quinton Ross\rossqu01","2007-08",26,"LAC","NBA",0.7,76,44,1505,131,335,122,314,9,21,40,60,54,118,172,88,43,33,29,132,311,4.18
8085,"Samardo Samuels\samuesa01","2011-12",23,"CLE","NBA",0.7,54,0,825,105,231,105,231,0,0,82,117,63,117,180,20,20,20,56,113,292,5.15
8086,"Larry Sanders\sandela01","2013-14",25,"MIL","NBA",0.7,23,20,584,76,162,76,161,0,1,26,55,60,105,165,19,18,40,26,74,178,9.07
8087,"Steve Scheffler\schefst01","1993-94",26,"SEA","NBA",0.7,35,1,152,28,46,28,46,0,0,19,20,11,15,26,6,7,0,8,25,75,2.15
8088,"Rony Seikaly\seikaro01","1994-95",29,"GSW","NBA",0.7,36,35,1035,162,314,162,314,0,0,111,160,77,189,266,45,20,37,104,122,435,12.34
8089,"Ramon Sessions\sessira01","2007-08",21,"MIL","NBA",0.7,17,7,450,51,117,48,110,3,7,32,41,8,50,58,127,17,3,36,26,137,11.95
8090,"Charles Shackleford\shackch01","1998-99",32,"CHH","NBA",0.7,32,4,367,44,90,44,90,0,0,19,29,41,88,129,13,5,13,27,66,107,4.14
8091,"Bobby Simmons\simmobo01","2007-08",27,"MIL","NBA",0.7,70,21,1521,209,496,149,325,60,171,53,70,67,159,226,80,50,5,78,140,531,6.58
8092,"Bobby Simmons\simmobo01","2001-02",21,"WAS","NBA",0.7,30,3,343,43,95,39,81,4,14,22,30,25,27,52,17,13,5,14,31,112,3.62
8093,"Dickey Simpkins\simpkdi01","1994-95",22,"CHI","NBA",0.7,59,5,586,78,184,78,184,0,0,50,72,60,91,151,37,10,7,45,72,206,3.4
8094,"James Singleton\singlja01","2006-07",25,"LAC","NBA",0.7,53,0,376,30,82,27,68,3,14,22,29,36,70,106,17,15,17,17,45,85,2.23
8095,"Jabari Smith\smithja01","2004-05",27,"NJN","NBA",0.7,45,2,648,62,148,61,146,1,2,41,55,29,82,111,38,25,14,39,103,166,4.16
8096,"Jason Smith\smithja02","2009-10",23,"PHI","NBA",0.7,56,2,658,75,174,65,145,10,29,29,42,54,81,135,33,21,28,35,110,189,3.74
8097,"Michael Stewart\stewami01","1998-99",23,"TOR","NBA",0.7,42,2,394,22,53,22,53,0,0,17,25,43,56,99,5,4,28,12,76,61,2.29
8098,"Bryant Stith\stithbr01","2001-02",31,"CLE","NBA",0.7,50,5,665,70,188,46,120,24,68,44,52,20,65,85,42,29,6,30,42,208,3.96
8099,"Bob Sura\surabo01","1997-98",24,"CLE","NBA",0.7,46,4,942,87,231,68,171,19,60,74,131,25,69,94,171,44,7,93,113,267,7.03
8100,"Robert Swift\swiftro01","2008-09",23,"OKC","NBA",0.7,26,10,343,37,71,37,71,0,0,12,16,21,68,89,9,5,17,8,50,86,4.17
8101,"Maurice Taylor\tayloma01","1998-99",22,"LAC","NBA",0.7,46,45,1505,311,675,310,669,1,6,150,206,100,142,242,67,16,29,120,179,773,12.66
8102,"Sebastian Telfair\telfase01","2007-08",22,"MIN","NBA",0.7,60,51,1933,223,556,191,442,32,114,78,105,16,119,135,355,59,11,111,171,556,10.24
8103,"Jason Terry\terryja01","2017-18",40,"MIL","NBA",0.7,51,4,814,59,154,19,39,40,115,8,9,5,43,48,59,42,13,25,52,166,3.78
8104,"Carl Thomas\thomaca01","1997-98",28,"TOT","NBA",0.7,43,0,426,56,140,36,81,20,59,16,25,10,37,47,19,21,7,18,39,148,2.95
8105,"Tim Thomas\thomati01","2009-10",32,"DAL","NBA",0.7,18,1,285,49,106,33,63,16,43,21,24,13,28,41,14,10,2,14,31,135,6.49
8106,"Hollis Thompson\thompho01","2016-17",25,"TOT","NBA",0.7,40,9,752,77,200,45,105,32,95,19,29,19,93,112,35,20,6,11,69,205,4.63
8107,"Jamaal Tinsley\tinslja01","2005-06",27,"IND","NBA",0.7,42,27,1122,158,386,142,316,16,70,58,91,35,98,133,211,49,6,109,96,390,10.09
8108,"Ekpe Udoh\udohek01","2010-11",23,"GSW","NBA",0.7,58,18,1030,97,222,97,222,0,0,42,64,80,101,181,40,22,86,48,144,236,5.06
8109,"Tyler Ulis\ulisty01","2016-17",21,"PHO","NBA",0.7,61,15,1123,184,437,163,358,21,79,55,71,20,75,95,226,48,5,77,73,444,7.43
8110,"Jan Veselý\veselja01","2012-13",22,"WAS","NBA",0.7,51,4,601,57,114,57,113,0,1,12,39,43,79,122,28,15,17,27,107,126,3.01
8111,"Samaki Walker\walkesa01","2003-04",27,"MIA","NBA",0.7,33,0,418,38,99,38,97,0,2,29,44,42,70,112,6,9,11,15,54,105,3.35
8112,"John Wallace\wallajo01","2001-02",27,"PHO","NBA",0.7,46,0,490,93,214,88,201,5,13,40,46,27,58,85,29,11,9,29,60,231,4.08
8113,"Tyrone Wallace\wallaty01","2017-18",23,"LAC","NBA",0.7,30,19,851,110,247,100,207,10,40,61,78,21,84,105,71,27,13,46,83,291,9.44
8114,"Mark West\westma01","1998-99",38,"ATL","NBA",0.7,49,0,499,22,59,22,59,0,0,16,45,49,76,125,13,4,22,17,81,60,1.93
8115,"Ennis Whatley\whatlen01","1994-95",32,"ATL","NBA",0.7,27,2,292,24,53,22,45,2,8,20,32,9,21,30,54,19,0,19,37,70,3.94
8116,"Mike Wilks\wilksmi01","2002-03",23,"TOT","NBA",0.7,46,7,688,50,148,40,113,10,35,37,47,20,51,71,92,27,4,28,69,147,3.96
8117,"Aaron Williams\williaa01","2006-07",35,"LAC","NBA",0.7,38,7,374,29,53,29,52,0,1,18,22,27,58,85,7,7,14,18,56,76,2.75
8118,"C.J. Williams\willicj01","2017-18",27,"LAC","NBA",0.7,38,17,707,87,197,65,119,22,78,13,16,12,44,56,43,31,13,20,63,209,5.19
8119,"Shawne Williams\willish03","2006-07",20,"IND","NBA",0.7,46,3,556,75,160,56,108,19,52,11,20,33,50,83,22,6,8,24,69,180,3.36
8120,"Shawne Williams\willish03","2013-14",27,"LAL","NBA",0.7,36,13,751,73,192,31,63,42,129,14,20,25,142,167,30,19,30,21,93,202,6.17
8121,"Loren Woods\woodslo01","2004-05",26,"TOR","NBA",0.7,45,30,712,71,164,71,163,0,1,34,59,81,139,220,17,8,39,37,78,176,4.77
8122,"Brandan Wright\wrighbr03","2015-16",28,"MEM","NBA",0.7,12,2,212,35,52,35,52,0,0,13,24,14,29,43,6,5,15,10,21,83,7.76
8123,"Lorenzen Wright\wrighlo02","2006-07",31,"ATL","NBA",0.7,67,31,1035,82,183,82,183,0,0,9,32,85,131,216,40,28,28,39,204,173,3.44
8124,"Álex Abrines\abrinal01","2018-19",25,"OKC","NBA",0.6,31,2,588,56,157,15,30,41,127,12,13,5,43,48,20,17,6,14,53,165,4.24
8125,"Cole Aldrich\aldrico01","2012-13",24,"TOT","NBA",0.6,45,0,388,44,80,44,80,0,0,12,20,30,90,120,9,5,23,23,60,100,2.97
8126,"Cole Aldrich\aldrico01","2011-12",23,"OKC","NBA",0.6,26,0,173,22,42,22,42,0,0,13,14,13,35,48,3,8,16,9,22,57,2.94
8127,"Lou Amundson\amundlo01","2010-11",28,"GSW","NBA",0.6,46,7,691,83,183,83,183,0,0,34,87,81,104,185,17,14,33,24,87,200,4.5
8128,"Chris Anstey\anstech01","1997-98",23,"DAL","NBA",0.6,41,8,680,92,231,89,215,3,16,53,74,53,104,157,35,31,27,41,95,240,5.95
8129,"Joel Anthony\anthojo01","2007-08",25,"MIA","NBA",0.6,24,1,498,28,60,28,60,0,0,29,49,38,55,93,3,9,31,17,55,85,4.84
8130,"Gilbert Arenas\arenagi01","2007-08",26,"WAS","NBA",0.6,13,8,425,78,196,56,118,22,78,74,96,6,45,51,66,23,1,49,30,252,17.5
8131,"Leandro Barbosa\barbole01","2016-17",34,"PHO","NBA",0.6,67,0,963,172,392,137,294,35,98,40,45,15,89,104,81,31,8,48,82,419,5.17
8132,"Will Barton\bartowi01","2013-14",23,"POR","NBA",0.6,41,0,387,65,156,55,123,10,33,26,32,16,58,74,33,9,7,18,31,166,3.59
8133,"Tony Battie\battito01","2010-11",34,"PHI","NBA",0.6,38,0,377,45,96,43,93,2,3,8,14,17,82,99,12,5,15,12,59,100,2.94
8134,"Aron Baynes\baynear01","2013-14",27,"SAS","NBA",0.6,53,4,491,71,163,71,163,0,0,19,21,57,88,145,34,2,5,36,77,161,3.05
8135,"Bismack Biyombo\biyombi01","2011-12",19,"CHA","NBA",0.6,63,41,1455,129,278,129,278,0,0,69,143,113,255,368,27,20,115,71,145,327,6.68
8136,"Calvin Booth\boothca01","2006-07",30,"WAS","NBA",0.6,44,1,380,31,66,30,64,1,2,6,10,27,54,81,18,4,29,9,71,69,2.34
8137,"Ryan Bowen\bowenry01","2008-09",33,"NOH","NBA",0.6,21,3,219,22,38,22,38,0,0,3,5,10,14,24,9,14,5,5,37,47,2.94
8138,"Kwame Brown\brownkw01","2004-05",22,"WAS","NBA",0.6,42,14,908,109,237,109,237,0,0,74,129,72,134,206,39,25,15,67,112,292,6.97
8139,"Kwame Brown\brownkw01","2007-08",25,"TOT","NBA",0.6,38,15,713,72,142,72,142,0,0,40,98,51,137,188,45,22,23,51,82,184,6.18
8140,"Markel Brown\brownma02","2015-16",24,"BRK","NBA",0.6,62,6,982,127,322,89,201,38,121,71,94,23,99,122,91,38,15,54,94,363,5.49
8141,"Troy Brown\browntr01","2018-19",19,"WAS","NBA",0.6,52,10,730,97,234,75,165,22,69,32,47,35,110,145,80,21,5,30,56,248,4.91
8142,"Rick Brunson\brunsri01","1997-98",25,"POR","NBA",0.6,38,10,622,49,141,27,80,22,61,42,62,14,42,56,100,25,3,52,55,162,5.12
8143,"Rick Brunson\brunsri01","2003-04",31,"TOT","NBA",0.6,40,0,412,40,105,29,82,11,23,27,31,9,28,37,82,25,3,33,44,118,3.95
8144,"Nicolás Brussino\brussni01","2016-17",23,"DAL","NBA",0.6,54,2,521,52,141,23,46,29,95,17,22,26,69,95,47,17,8,26,43,150,3.03
8145,"Mark Bryant\bryanma01","2001-02",36,"SAS","NBA",0.6,30,3,206,25,55,25,55,0,0,6,8,25,19,44,10,7,2,6,38,56,1.99
8146,"Rodney Buford\buforro01","1999-00",22,"MIA","NBA",0.6,34,0,386,62,151,55,122,7,29,16,22,10,38,48,21,10,8,9,44,147,3.33
8147,"Matt Bullard\bullama01","1995-96",28,"ATL","NBA",0.6,46,0,460,66,162,40,90,26,72,16,20,18,42,60,18,17,11,24,50,174,3.19
8148,"Mitchell Butler\butlemi02","1996-97",26,"POR","NBA",0.6,49,1,465,52,125,40,86,12,39,32,50,19,34,53,30,13,2,27,55,148,2.67
8149,"Jason Caffey\caffeja01","2002-03",29,"MIL","NBA",0.6,51,16,894,113,248,113,248,0,0,69,106,68,108,176,38,19,15,56,122,295,5.46
8150,"José Calderón\caldejo01","2018-19",37,"DET","NBA",0.6,49,0,632,45,120,31,63,14,57,9,11,11,49,60,115,16,3,35,64,113,3.44
8151,"Isaiah Canaan\canaais01","2017-18",26,"TOT","NBA",0.6,20,1,422,52,137,30,71,22,66,46,51,6,39,45,76,16,1,29,36,172,9.14
8152,"Brian Cardinal\cardibr01","2005-06",28,"MEM","NBA",0.6,36,0,402,46,111,33,82,13,29,19,27,11,44,55,33,23,0,27,65,124,3.6
8153,"Anthony Carter\cartean01","2005-06",30,"MIN","NBA",0.6,45,8,589,53,137,49,122,4,15,40,55,9,53,62,101,24,9,40,71,150,4.34
8154,"Mario Chalmers\chalmma01","2017-18",31,"MEM","NBA",0.6,66,10,1421,168,443,115,252,53,191,118,138,13,144,157,197,79,14,117,179,507,8.27
8155,"Pete Chilcutt\chilcpe01","1999-00",31,"TOT","NBA",0.6,56,2,601,53,127,47,101,6,26,8,8,46,85,131,27,15,10,20,73,120,2.6
8156,"Keith Closs\closske01","1997-98",21,"LAC","NBA",0.6,58,1,740,93,207,93,207,0,0,46,77,63,105,168,19,12,81,38,73,232,4.5
8157,"Norris Cole\coleno01","2012-13",24,"MIA","NBA",0.6,80,4,1590,179,425,144,327,35,98,52,80,18,112,130,164,57,7,104,155,445,5.46
8158,"Jason Collins\collija04","2010-11",32,"ATL","NBA",0.6,49,28,593,34,71,33,70,1,1,27,41,30,72,102,22,9,9,26,97,96,2.57
8159,"Jason Collins\collija04","2006-07",28,"NJN","NBA",0.6,80,78,1844,55,151,55,149,0,2,59,127,90,226,316,46,40,38,73,273,169,3.54
8160,"Zach Collins\colliza01","2017-18",20,"POR","NBA",0.6,66,1,1045,115,289,80,176,35,113,27,42,45,176,221,52,17,31,58,133,292,4.44
8161,"Mike Conley\conlemi01","2017-18",30,"MEM","NBA",0.6,12,12,373,64,168,40,91,24,77,53,66,0,27,27,49,12,3,18,24,205,13.92
8162,"Marty Conlon\conloma01","1995-96",28,"MIL","NBA",0.6,74,1,958,153,327,148,297,5,30,84,110,58,119,177,68,20,11,79,126,395,4.91
8163,"Pat Connaughton\connapa01","2016-17",24,"POR","NBA",0.6,39,1,316,37,72,20,39,17,33,7,9,10,42,52,28,6,2,17,23,98,2.81
8164,"Brian Cook\cookbr01","2010-11",30,"LAC","NBA",0.6,40,0,447,72,170,38,91,34,79,15,24,19,77,96,15,12,11,25,75,193,4.2
8165,"Chris Crawford\crawfch01","1999-00",24,"ATL","NBA",0.6,55,11,668,91,229,84,202,7,27,63,81,51,48,99,33,17,16,37,83,252,3.85
8166,"Chris Crawford\crawfch01","2000-01",25,"ATL","NBA",0.6,47,22,901,122,270,116,248,6,22,68,83,28,82,110,37,21,16,62,117,318,5.83
8167,"Jamal Crawford\crawfja01","2001-02",21,"CHI","NBA",0.6,23,6,481,89,187,63,129,26,58,10,13,5,29,34,55,18,5,32,18,214,8.31
8168,"Vonteego Cummings\cummivo01","2001-02",25,"PHI","NBA",0.6,58,1,501,78,187,66,141,12,46,24,32,14,38,52,60,18,5,36,53,192,2.99
8169,"Marquis Daniels\daniema01","2006-07",26,"IND","NBA",0.6,45,4,800,129,281,123,255,6,26,56,80,26,56,82,57,27,7,55,56,320,6
8170,"Baron Davis\davisba01","2008-09",29,"LAC","NBA",0.6,65,60,2248,355,959,256,631,99,328,159,210,46,192,238,501,108,35,193,193,968,15.33
8171,"Dewayne Dedmon\dedmode01","2013-14",24,"TOT","NBA",0.6,31,6,390,38,83,38,83,0,0,21,32,38,89,127,5,7,22,18,66,97,4.08
8172,"Boris Diaw\diawbo01","2011-12",29,"TOT","NBA",0.6,57,35,1424,156,351,125,252,31,99,22,35,70,210,280,205,34,25,112,125,365,8.48
8173,"Travis Diener\dienetr01","2005-06",23,"ORL","NBA",0.6,23,0,246,29,69,4,12,25,57,5,6,4,17,21,16,7,0,10,22,88,3.37
8174,"Donte DiVincenzo\divindo01","2018-19",22,"MIL","NBA",0.6,27,0,411,50,124,28,41,22,83,9,12,16,49,65,31,13,6,19,38,131,4.74
8175,"Michael Doleac\doleami01","2005-06",28,"MIA","NBA",0.6,31,3,371,37,88,37,88,0,0,24,30,23,62,85,8,10,7,14,45,98,3.33
8176,"Keyon Dooling\doolike01","2011-12",31,"BOS","NBA",0.6,46,2,662,66,163,39,82,27,81,23,31,3,36,39,51,13,2,34,57,182,3.41
8177,"Tyler Dorsey\dorsety01","2018-19",22,"TOT","NBA",0.6,48,11,698,107,264,63,132,44,132,38,61,27,86,113,56,14,2,27,53,296,5.1
8178,"Damyean Dotson\dotsoda01","2017-18",23,"NYK","NBA",0.6,44,2,474,72,161,50,93,22,68,16,23,9,75,84,31,12,2,17,34,182,3.73
8179,"Sherman Douglas\douglsh01","1999-00",33,"NJN","NBA",0.6,20,2,309,45,90,40,74,5,16,25,28,13,16,29,34,17,0,24,26,120,6.31
8180,"Chris Douglas-Roberts\douglch01","2008-09",22,"NJN","NBA",0.6,44,3,585,81,176,78,164,3,12,51,62,14,36,50,52,12,7,31,34,216,4.41
8181,"Greg Dreiling\dreilgr01","1993-94",31,"DAL","NBA",0.6,54,19,685,52,104,51,103,1,1,27,38,47,123,170,31,16,24,43,159,132,3.67
8182,"Greg Dreiling\dreilgr01","1994-95",32,"CLE","NBA",0.6,58,3,483,42,102,42,102,0,0,26,41,32,84,116,22,6,22,25,108,110,2.29
8183,"Kris Dunn\dunnkr01","2018-19",24,"CHI","NBA",0.6,46,44,1389,215,506,181,410,34,96,55,69,19,168,187,277,68,21,104,166,519,12.97
8184,"Kevin Edwards\edwarke01","1994-95",29,"NJN","NBA",0.6,14,14,466,69,154,51,109,18,45,40,42,10,27,37,27,19,5,35,42,196,12.23
8185,"Khalid El-Amin\elamikh01","2000-01",21,"CHI","NBA",0.6,50,14,936,115,311,87,227,28,84,56,72,21,60,81,145,48,2,54,99,314,6.38
8186,"Francisco Elson\elsonfr01","2010-11",34,"UTA","NBA",0.6,62,1,610,54,113,54,113,0,0,26,31,35,80,115,33,21,14,32,84,134,2.81
8187,"Melvin Ely\elyme01","2010-11",32,"DEN","NBA",0.6,30,2,366,28,51,28,51,0,0,13,21,27,47,74,14,4,11,14,50,69,3.08
8188,"Jeremy Evans\evansje01","2015-16",28,"DAL","NBA",0.6,30,2,251,26,48,22,32,4,16,15,21,11,43,54,2,6,9,7,19,71,2.69
8189,"Jordan Farmar\farmajo01","2014-15",28,"LAC","NBA",0.6,36,0,529,61,158,26,61,35,97,10,11,8,34,42,67,20,5,32,52,167,4.66
8190,"Kyrylo Fesenko\fesenky01","2009-10",23,"UTA","NBA",0.6,49,5,408,52,95,52,94,0,1,24,57,33,57,90,15,6,19,24,78,128,2.75
8191,"Greg Foster\fostegr01","1995-96",27,"UTA","NBA",0.6,73,2,803,107,244,106,236,1,8,61,72,53,125,178,25,7,22,58,120,276,3.49
8192,"Jeff Foster\fosteje01","1999-00",23,"IND","NBA",0.6,19,0,86,13,23,13,22,0,1,17,25,12,20,32,5,5,1,2,18,43,2.68
8193,"Todd Fuller\fulleto02","1998-99",24,"UTA","NBA",0.6,42,2,462,56,124,56,124,0,0,30,50,28,73,101,6,6,14,27,60,142,3.1
8194,"Corey Gaines\gaineco01","1993-94",28,"NYK","NBA",0.6,18,0,78,9,20,7,15,2,5,13,15,3,10,13,30,2,0,5,12,33,2.78
8195,"Devean George\georgde01","2008-09",31,"DAL","NBA",0.6,43,17,708,54,142,32,66,22,76,17,22,25,53,78,15,23,11,17,57,147,3.25
8196,"Danny Granger\grangda01","2014-15",31,"MIA","NBA",0.6,30,6,613,65,162,35,78,30,84,28,37,20,60,80,17,13,6,24,67,188,5.27
8197,"Gary Grant\grantga01","1994-95",29,"LAC","NBA",0.6,33,2,470,78,166,74,150,4,16,45,55,8,27,35,93,29,3,44,66,205,6.85
8198,"Draymond Green\greendr01","2012-13",22,"GSW","NBA",0.6,79,1,1061,84,257,70,190,14,67,45,55,58,202,260,53,42,25,51,159,227,3.51
8199,"Gerald Green\greenge01","2016-17",31,"BOS","NBA",0.6,47,0,538,95,232,56,121,39,111,33,41,16,68,84,33,9,7,25,48,262,4.36
8200,"Hamed Haddadi\haddaha01","2010-11",25,"MEM","NBA",0.6,31,0,168,30,58,30,57,0,1,15,23,24,44,68,5,2,13,11,29,75,2.74
8201,"Hamed Haddadi\haddaha01","2011-12",26,"MEM","NBA",0.6,35,0,206,26,48,26,47,0,1,18,26,28,43,71,8,1,26,21,43,70,2.77
8202,"P.J. Hairston\hairspj02","2015-16",23,"TOT","NBA",0.6,66,52,1313,145,408,75,167,70,241,50,64,25,149,174,38,32,11,41,137,410,4.74
8203,"Marcus Haislip\haislma01","2003-04",23,"MIL","NBA",0.6,31,0,263,36,74,35,72,1,2,20,28,21,32,53,4,6,12,9,25,93,2.93
8204,"Ben Handlogten\handlbe01","2003-04",30,"UTA","NBA",0.6,17,0,172,25,47,25,47,0,0,18,27,22,33,55,6,3,4,10,32,68,4.32
8205,"Luke Harangody\haranlu01","2010-11",23,"TOT","NBA",0.6,49,0,640,79,206,63,140,16,66,19,26,40,103,143,30,15,17,16,80,193,3.73
8206,"Lucious Harris\harrilu01","1993-94",23,"DAL","NBA",0.6,77,0,1165,162,385,155,352,7,33,87,119,45,112,157,106,49,10,78,117,418,5.11
8207,"Spencer Hawes\hawessp01","2007-08",19,"SAC","NBA",0.6,71,8,931,146,318,142,297,4,21,38,58,68,162,230,44,14,40,56,128,334,4.6
8208,"Chuck Hayes\hayesch01","2011-12",28,"SAC","NBA",0.6,54,9,1039,73,170,73,168,0,2,26,39,72,162,234,77,36,17,50,111,172,5.04
8209,"Luther Head\headlu01","2008-09",26,"TOT","NBA",0.6,32,4,498,55,144,35,90,20,54,19,24,6,46,52,58,17,2,25,37,149,4.62
8210,"Luther Head\headlu01","2009-10",27,"IND","NBA",0.6,47,10,813,136,311,99,206,37,105,48,58,6,74,80,72,18,9,54,53,357,6.31
8211,"John Henson\hensojo01","2018-19",28,"MIL","NBA",0.6,14,0,188,31,67,20,36,11,31,6,10,16,55,71,14,7,11,12,16,79,6.84
8212,"Tyrone Hill\hillty01","2001-02",33,"CLE","NBA",0.6,26,26,810,71,182,71,181,0,1,67,103,79,195,274,23,17,13,48,102,209,9.52
8213,"Kirk Hinrich\hinriki01","2015-16",35,"TOT","NBA",0.6,46,7,631,49,129,25,67,24,62,15,16,8,62,70,73,15,2,30,64,137,3.51
8214,"Justin Holiday\holidju01","2015-16",26,"TOT","NBA",0.6,53,5,773,88,228,52,123,36,105,27,37,12,78,90,56,32,19,39,61,239,4.36
8215,"Danuel House\houseda01","2017-18",24,"PHO","NBA",0.6,23,3,403,56,129,41,71,15,58,25,31,13,63,76,25,7,6,11,23,152,6.12
8216,"Dwight Howard\howardw01","2018-19",33,"WAS","NBA",0.6,9,9,230,43,69,43,69,0,0,29,48,24,59,83,4,7,4,16,34,115,13.57
8217,"Troy Hudson\hudsotr01","2003-04",27,"MIN","NBA",0.6,29,1,503,80,207,49,130,31,77,27,33,4,31,35,70,7,0,34,32,218,5.96
8218,"Larry Hughes\hughela01","2000-01",22,"GSW","NBA",0.6,50,45,1846,308,805,294,730,14,75,193,252,76,200,276,223,96,29,152,147,823,14.84
8219,"Brandon Hunter\huntebr01","2003-04",23,"BOS","NBA",0.6,36,12,406,53,116,53,113,0,3,19,43,50,68,118,19,13,1,22,40,125,3.6
8220,"Steven Hunter\huntest01","2003-04",22,"ORL","NBA",0.6,59,23,789,82,155,82,155,0,0,23,69,54,116,170,12,5,73,29,101,187,3.82
8221,"Chandler Hutchison\hutchch01","2018-19",22,"CHI","NBA",0.6,44,14,895,96,209,82,159,14,50,23,38,31,154,185,34,23,6,25,59,229,5.46
8222,"Didier Ilunga-Mbenga\mbengdj01","2009-10",29,"LAL","NBA",0.6,49,2,355,48,103,48,103,0,0,9,19,32,55,87,8,5,29,15,54,105,2.32
8223,"Royal Ivey\iveyro01","2009-10",28,"TOT","NBA",0.6,44,0,326,35,83,21,48,14,35,9,12,6,28,34,27,19,2,11,39,93,2.29
8224,"Jermaine Jackson\jacksje01","2001-02",25,"TOR","NBA",0.6,24,0,280,20,42,19,40,1,2,16,24,3,24,27,57,9,1,14,24,57,3.87
8225,"Jim Jackson\jacksji01","1993-94",23,"DAL","NBA",0.6,82,82,3066,637,1432,620,1372,17,60,285,347,169,219,388,374,87,25,334,161,1576,16.16
8226,"Marc Jackson\jacksma02","2001-02",27,"TOT","NBA",0.6,39,0,495,60,164,60,163,0,1,66,80,48,80,128,14,11,6,30,69,186,4.25
8227,"Stephen Jackson\jacksst02","2011-12",33,"TOT","NBA",0.6,47,14,1212,159,425,110,255,49,170,94,114,22,141,163,118,54,13,103,99,461,9.15
8228,"Jared Jeffries\jeffrja01","2003-04",22,"WAS","NBA",0.6,82,38,1913,177,469,172,439,5,30,105,171,180,244,424,93,48,28,107,212,464,5.88
8229,"Jared Jeffries\jeffrja01","2010-11",29,"TOT","NBA",0.6,42,9,601,30,86,28,77,2,9,12,29,62,54,116,36,31,17,21,75,74,3.18
8230,"Keith Jennings\jennike01","1992-93",24,"GSW","NBA",0.6,8,0,136,25,42,20,33,5,9,14,18,2,9,11,23,4,0,7,18,69,9.06
8231,"Dakari Johnson\johnsda04","2017-18",22,"OKC","NBA",0.6,31,6,161,22,39,22,39,0,0,11,20,16,18,34,8,6,8,3,27,55,2.05
8232,"James Johnson\johnsja01","2010-11",23,"TOT","NBA",0.6,38,25,822,108,237,100,203,8,34,47,71,37,105,142,89,33,37,64,95,271,8.33
8233,"Stanley Johnson\johnsst04","2015-16",19,"DET","NBA",0.6,73,6,1687,225,600,162,395,63,205,80,102,58,248,306,118,55,12,114,178,593,7.16
8234,"Wesley Johnson\johnswe01","2011-12",24,"MIN","NBA",0.6,65,64,1469,158,397,105,228,53,169,24,34,24,153,177,59,35,48,60,115,393,5.46
8235,"Charles Jones\jonesch01","1995-96",38,"HOU","NBA",0.6,46,0,297,6,19,6,19,0,0,4,13,28,46,74,12,5,24,3,44,16,1.33
8236,"Dahntay Jones\jonesda02","2005-06",25,"MEM","NBA",0.6,71,4,967,109,263,106,242,3,21,60,93,20,84,104,39,38,15,50,108,281,3.45
8237,"Dahntay Jones\jonesda02","2012-13",32,"TOT","NBA",0.6,78,19,1016,82,222,71,173,11,49,87,113,24,77,101,48,22,6,38,119,262,2.94
8238,"Popeye Jones\jonespo01","1999-00",29,"DEN","NBA",0.6,40,1,330,44,104,42,101,2,3,14,19,41,62,103,19,3,6,13,50,104,2.71
8239,"Reggie Jordan\jordare01","1995-96",28,"ATL","NBA",0.6,24,0,247,36,71,36,71,0,0,22,38,23,29,52,29,12,7,19,30,94,4.6
8240,"Chris Kaman\kamanch01","2008-09",26,"LAC","NBA",0.6,31,24,921,161,305,161,305,0,0,51,75,75,172,247,46,17,45,84,93,373,12.7
8241,"Mario Kasun\kasunma01","2004-05",24,"ORL","NBA",0.6,45,0,356,47,98,47,97,0,1,24,43,52,76,128,8,8,13,26,86,118,2.99
8242,"Adam Keefe\keefead01","2000-01",30,"GSW","NBA",0.6,67,13,836,64,159,63,156,1,3,39,63,90,119,209,36,28,20,40,102,168,3.34
8243,"Steve Kerr\kerrst01","1992-93",27,"TOT","NBA",0.6,52,0,481,53,122,47,96,6,26,22,24,5,40,45,70,10,1,27,36,134,2.82
8244,"Steve Kerr\kerrst01","1999-00",34,"SAS","NBA",0.6,32,0,268,32,74,16,43,16,31,9,11,3,16,19,12,4,0,7,14,89,2.16
8245,"Jerome Kersey\kerseje01","1998-99",36,"SAS","NBA",0.6,45,0,699,68,200,65,186,3,14,6,14,42,88,130,41,37,14,30,92,145,3.48
8246,"Michael Kidd-Gilchrist\kiddgmi01","2015-16",22,"CHO","NBA",0.6,7,7,205,33,61,30,54,3,7,20,29,12,33,45,9,3,3,8,9,89,12.19
8247,"Tarence Kinsey\kinseta01","2008-09",24,"CLE","NBA",0.6,50,3,277,31,69,24,51,7,18,33,38,10,28,38,10,12,0,22,34,102,1.97
8248,"Greg Kite\kitegr01","1992-93",31,"ORL","NBA",0.6,64,1,640,38,84,38,83,0,1,13,24,66,127,193,10,13,12,35,133,89,2.29
8249,"Travis Knight\knightr01","1999-00",25,"LAL","NBA",0.6,63,0,410,46,118,46,118,0,0,17,28,46,83,129,23,6,23,26,88,109,2.07
8250,"Trajan Langdon\langdtr01","2001-02",25,"CLE","NBA",0.6,44,0,477,70,176,43,102,27,74,42,46,13,42,55,60,13,5,40,49,209,4.38
8251,"Acie Law\lawac01","2009-10",25,"TOT","NBA",0.6,26,1,234,35,75,30,59,5,16,38,49,3,14,17,26,11,1,17,16,113,4.11
8252,"Meyers Leonard\leoname01","2013-14",21,"POR","NBA",0.6,40,0,355,41,91,41,85,0,6,16,21,26,85,111,18,7,5,15,76,98,2.91
8253,"DeAndre Liggins\liggide01","2012-13",24,"OKC","NBA",0.6,39,1,290,21,47,14,28,7,19,9,18,13,40,53,15,18,3,14,33,58,2.09
8254,"John Lucas III\lucasjo02","2006-07",24,"HOU","NBA",0.6,47,0,383,62,156,47,97,15,59,15,19,9,27,36,33,17,0,15,38,154,2.61
8255,"Mark Madsen\madsema01","2005-06",30,"MIN","NBA",0.6,62,7,676,27,66,27,59,0,7,20,47,50,91,141,11,23,17,26,114,74,2.05
8256,"Jamaal Magloire\magloja01","2009-10",31,"MIA","NBA",0.6,36,0,359,28,56,28,56,0,0,21,59,41,80,121,1,9,11,17,59,77,2.77
8257,"Jamaal Magloire\magloja01","2010-11",32,"MIA","NBA",0.6,18,0,158,13,22,13,22,0,0,9,18,17,44,61,3,4,2,5,26,35,2.95
8258,"Sean Marks\marksse01","2005-06",30,"SAS","NBA",0.6,25,0,181,37,71,37,68,0,3,7,12,12,31,43,7,5,7,7,21,81,3.04
8259,"Donny Marshall\marshdo02","1996-97",24,"CLE","NBA",0.6,56,0,548,52,160,19,73,33,87,38,54,22,48,70,24,24,3,32,60,175,2.65
8260,"Jarell Martin\martija01","2016-17",22,"MEM","NBA",0.6,42,3,558,58,151,49,126,9,25,40,50,42,120,162,8,17,9,28,91,165,4.1
8261,"Desmond Mason\masonde01","2006-07",29,"NOK","NBA",0.6,75,75,2575,407,900,407,900,0,0,214,323,124,221,345,115,52,22,192,174,1028,10.71
8262,"Bob McCann\mccanbo01","1995-96",31,"WSB","NBA",0.6,62,0,653,76,153,75,151,1,2,35,74,46,97,143,24,21,15,42,116,188,3.25
8263,"Rashad McCants\mccanra01","2008-09",24,"TOT","NBA",0.6,58,3,1101,192,488,129,299,63,189,107,141,21,89,110,68,47,14,64,103,554,7.31
8264,"Amal McCaskill\mccasam01","2003-04",30,"PHI","NBA",0.6,59,3,636,47,117,47,116,0,1,19,27,48,85,133,20,12,20,25,89,113,2.37
8265,"Patrick McCaw\mccawpa01","2017-18",22,"GSW","NBA",0.6,57,10,961,92,225,73,145,19,80,26,34,16,66,82,81,43,10,41,67,229,4.29
8266,"K.J. McDaniels\mcdankj01","2014-15",21,"TOT","NBA",0.6,62,15,1352,172,434,129,284,43,150,100,133,65,135,200,72,44,70,105,126,487,7.45
8267,"Keith McLeod\mcleoke01","2005-06",26,"UTA","NBA",0.6,66,32,1232,120,340,96,258,24,82,106,133,11,67,78,151,42,9,76,131,370,5.37
8268,"Anthony Miller\millean01","1998-99",27,"HOU","NBA",0.6,29,0,249,28,60,28,59,0,1,14,22,26,41,67,7,7,5,9,34,70,2.7
8269,"Greg Minor\minorgr01","1996-97",25,"BOS","NBA",0.6,23,15,547,94,196,93,188,1,8,31,36,30,50,80,34,15,2,22,45,220,8.29
8270,"Sam Mitchell\mitchsa01","2000-01",37,"MIN","NBA",0.6,82,4,983,118,289,109,246,9,43,40,55,28,95,123,57,26,10,36,117,285,3
8271,"Mikki Moore\mooremi01","2001-02",26,"DET","NBA",0.6,30,0,217,29,61,28,59,1,2,20,26,22,31,53,11,7,9,14,35,79,2.92
8272,"Mikki Moore\mooremi01","2009-10",34,"GSW","NBA",0.6,23,20,406,54,90,54,90,0,0,7,11,26,43,69,36,5,13,21,60,115,6.04
8273,"Lawrence Moten\motenla01","1995-96",23,"VAN","NBA",0.6,44,3,573,112,247,94,192,18,55,49,75,36,25,61,50,29,8,44,54,291,5.6
8274,"Alonzo Mourning\mournal01","2003-04",33,"NJN","NBA",0.6,12,0,215,33,71,33,71,0,0,30,34,8,19,27,8,2,6,10,32,96,6.71
8275,"Timofey Mozgov\mozgoti01","2010-11",24,"TOT","NBA",0.6,45,14,524,63,133,63,133,0,0,37,52,46,75,121,15,15,25,35,84,163,4.01
8276,"Tracy Murray\murratr01","2000-01",29,"TOT","NBA",0.6,51,1,588,94,248,58,145,36,103,33,42,22,59,81,23,12,7,26,53,257,3.58
8277,"Martin Müürsepp\muursma01","1996-97",22,"TOT","NBA",0.6,42,0,348,54,131,50,107,4,24,44,70,35,32,67,20,12,11,18,58,156,3.24
8278,"Pete Myers\myerspe01","1995-96",32,"TOT","NBA",0.6,71,2,1092,91,247,77,189,14,58,80,122,35,105,140,145,34,17,81,132,276,4.59
8279,"Mamadou N'Diaye\ndiayma02","2002-03",27,"TOR","NBA",0.6,22,8,364,43,96,43,96,0,0,34,47,29,53,82,7,8,32,21,58,120,6.04
8280,"Shabazz Napier\napiesh01","2016-17",25,"POR","NBA",0.6,53,2,512,73,183,39,91,34,92,38,49,8,53,61,67,32,2,41,38,218,4.14
8281,"Gary Neal\nealga01","2014-15",30,"TOT","NBA",0.6,54,1,1193,188,503,138,339,50,164,117,135,14,115,129,100,23,1,65,88,543,7.49
8282,"Jameer Nelson\nelsoja01","2017-18",35,"TOT","NBA",0.6,50,0,1013,95,244,54,120,41,124,16,20,13,91,104,179,27,4,67,81,247,6.19
8283,"Andrew Nicholson\nichoan01","2013-14",24,"ORL","NBA",0.6,76,5,1174,180,420,152,331,28,89,47,57,53,202,255,25,18,23,51,150,435,4.77
8284,"Jermaine O'Neal\onealje01","2010-11",32,"BOS","NBA",0.6,24,10,431,50,109,50,108,0,1,29,43,25,63,88,12,2,30,27,65,129,5.57
8285,"Fabricio Oberto\obertfa01","2009-10",34,"WAS","NBA",0.6,57,20,650,35,56,35,56,0,0,13,17,34,71,105,51,11,9,36,121,83,2.65
8286,"Jahlil Okafor\okafoja01","2017-18",22,"TOT","NBA",0.6,28,0,353,77,138,76,134,1,4,21,29,21,64,85,12,3,18,21,51,176,5.89
8287,"Kevin Ollie\ollieke01","2006-07",34,"PHI","NBA",0.6,53,23,919,81,187,81,185,0,2,37,45,8,66,74,130,21,1,47,76,199,4.52
8288,"Doug Overton\overtdo01","1992-93",23,"WSB","NBA",0.6,45,13,990,152,323,149,310,3,13,59,81,25,81,106,157,31,6,72,81,366,8.43
8289,"Robert Pack\packro01","2002-03",33,"NOH","NBA",0.6,28,4,440,52,129,52,124,0,5,41,55,11,40,51,81,25,0,40,35,145,6.14
8290,"Gerald Paddio\paddige01","1992-93",27,"SEA","NBA",0.6,41,3,307,71,159,69,151,2,8,14,21,17,33,50,33,14,6,16,24,158,3.26
8291,"John Paxson\paxsojo01","1993-94",33,"CHI","NBA",0.6,27,0,343,30,68,21,46,9,22,1,2,3,17,20,33,7,2,6,18,70,2.72
8292,"Anthony Peeler\peelean01","1996-97",27,"VAN","NBA",0.6,72,57,2291,402,1011,274,668,128,343,109,133,54,193,247,256,105,17,157,168,1041,12.21
8293,"Nikola Peković\pekovni01","2010-11",25,"MIN","NBA",0.6,65,11,887,136,263,136,263,0,0,87,114,90,103,193,27,18,35,91,181,359,5.49
8294,"Elliot Perry\perryel01","2000-01",31,"TOT","NBA",0.6,49,6,499,65,140,64,135,1,5,16,22,9,37,46,79,22,1,38,29,147,3.45
8295,"Morris Peterson\petermo01","2008-09",31,"NOH","NBA",0.6,43,9,515,73,183,40,98,33,85,12,19,13,71,84,16,15,2,15,51,191,3.5
8296,"Mickaël Piétrus\pietrmi01","2005-06",23,"GSW","NBA",0.6,52,18,1179,169,418,113,242,56,176,87,143,58,105,163,44,33,10,78,132,481,7.11
8297,"Dexter Pittman\pittmde01","2011-12",23,"MIA","NBA",0.6,35,6,301,44,94,44,94,0,0,18,28,27,44,71,9,8,8,17,73,106,2.92
8298,"Scot Pollard\pollasc01","2007-08",32,"BOS","NBA",0.6,22,0,173,12,23,12,23,0,0,15,22,14,23,37,3,3,6,5,43,39,2.23
8299,"Leon Powe\powele01","2010-11",27,"TOT","NBA",0.6,30,3,328,59,119,59,117,0,2,40,72,24,39,63,7,10,4,12,44,158,4.28
8300,"Dwight Powell\poweldw01","2014-15",23,"TOT","NBA",0.6,29,0,236,31,67,28,56,3,11,25,33,18,32,50,9,9,6,11,40,90,3.17
8301,"Josh Powell\poweljo01","2008-09",26,"LAL","NBA",0.6,60,1,703,106,239,106,239,0,0,38,50,71,105,176,27,9,17,51,98,250,3.84
8302,"Norman Powell\powelno01","2017-18",24,"TOR","NBA",0.6,70,18,1062,150,374,97,188,53,186,32,39,14,105,119,89,37,16,66,111,385,4.84
8303,"Joel Przybilla\przybjo01","2002-03",23,"MIL","NBA",0.6,32,17,546,18,46,18,46,0,0,12,24,48,97,145,12,10,45,19,85,48,3.94
8304,"Chris Quinn\quinnch01","2006-07",23,"MIA","NBA",0.6,42,1,408,48,131,28,74,20,57,25,37,6,24,30,65,15,0,21,32,141,3.24
8305,"Chasson Randle\randlch01","2018-19",25,"WAS","NBA",0.6,49,2,743,91,217,45,102,46,115,43,62,10,46,56,97,25,3,43,91,271,5.41
8306,"Anthony Randolph\randoan01","2013-14",24,"DEN","NBA",0.6,43,5,527,68,176,50,115,18,61,52,69,20,102,122,32,26,19,39,64,206,4.97
8307,"Allan Ray\rayal01","2006-07",22,"BOS","NBA",0.6,47,5,710,100,259,52,143,48,116,42,55,18,51,69,43,20,3,42,85,290,4.75
8308,"Michael Redd\reddmi01","2009-10",30,"MIL","NBA",0.6,18,12,492,75,213,57,153,18,60,47,66,11,43,54,39,19,2,15,24,215,8.76
8309,"Bryant Reeves\reevebr01","1999-00",26,"VAN","NBA",0.6,69,67,1773,252,562,252,558,0,4,107,165,126,264,390,82,33,38,119,245,611,8.23
8310,"Luke Ridnour\ridnolu01","2014-15",33,"ORL","NBA",0.6,47,0,683,75,176,55,113,20,63,18,21,8,60,68,96,20,4,38,67,188,4.49
8311,"Eric Riley\rileyer01","1994-95",24,"LAC","NBA",0.6,40,4,434,65,145,65,144,0,1,47,64,45,67,112,11,17,35,31,78,177,4.72
8312,"Austin Rivers\riverau01","2013-14",21,"NOP","NBA",0.6,69,4,1339,192,474,156,375,36,99,110,173,26,103,129,160,45,9,77,134,530,6.73
8313,"Fred Roberts\roberfr01","1995-96",35,"LAL","NBA",0.6,33,1,317,48,97,44,83,4,14,22,28,18,29,47,26,16,4,24,24,122,3.84
8314,"Glenn Robinson\robingl02","2017-18",24,"IND","NBA",0.6,23,1,338,36,85,22,51,14,34,9,11,11,26,37,17,13,1,5,14,95,3.89
8315,"Thomas Robinson\robinth01","2015-16",24,"BRK","NBA",0.6,71,7,917,130,291,130,290,0,1,47,109,136,223,359,46,39,36,69,111,307,5.22
8316,"Dennis Rodman\rodmade01","1999-00",38,"DAL","NBA",0.6,12,12,389,12,31,12,30,0,1,10,14,48,123,171,14,2,1,19,41,34,8.03
8317,"Sean Rooks\rooksse01","2001-02",32,"LAC","NBA",0.6,61,2,728,81,194,81,194,0,0,21,29,32,92,124,25,12,21,20,114,183,2.79
8318,"Jalen Rose\roseja01","2006-07",34,"PHO","NBA",0.6,29,0,246,38,86,17,39,21,47,11,12,3,20,23,16,5,2,9,22,108,3.08
8319,"Quinton Ross\rossqu01","2008-09",27,"MEM","NBA",0.6,68,7,1164,99,259,66,171,33,88,34,42,29,97,126,47,32,14,36,114,265,3.61
8320,"Michael Ruffin\ruffimi01","1999-00",23,"CHI","NBA",0.6,71,6,975,58,138,58,138,0,0,43,88,117,133,250,44,26,26,59,170,159,3.42
8321,"John Salley\sallejo01","1995-96",31,"TOT","NBA",0.6,42,6,673,63,140,63,140,0,0,59,85,46,94,140,54,19,27,55,110,185,5.56
8322,"John Salmons\salmojo01","2002-03",23,"PHI","NBA",0.6,64,1,504,48,116,38,85,10,31,26,35,16,43,59,47,17,6,29,53,132,2.25
8323,"JaKarr Sampson\sampsja02","2014-15",21,"PHI","NBA",0.6,74,32,1131,146,346,115,219,31,127,63,94,35,128,163,77,38,26,76,135,386,4.93
8324,"Daniel Santiago\santida01","2000-01",24,"PHO","NBA",0.6,54,2,581,64,134,64,134,0,0,42,61,35,67,102,11,17,21,47,101,170,3.23
8325,"Tomáš Satoranský\satorto01","2016-17",25,"WAS","NBA",0.6,57,3,719,61,147,52,110,9,37,23,33,25,58,83,92,26,6,38,60,154,3.5
8326,"Brian Scalabrine\scalabr01","2007-08",29,"BOS","NBA",0.6,48,9,512,29,94,14,48,15,46,15,20,22,57,79,40,9,8,26,63,88,2.21
8327,"Danny Schayes\schayda01","1996-97",37,"ORL","NBA",0.6,45,6,540,47,120,47,119,0,1,39,52,41,84,125,14,15,16,27,74,133,3.3
8328,"Steve Scheffler\schefst01","1992-93",25,"SEA","NBA",0.6,29,5,166,25,48,25,48,0,0,16,24,15,21,36,5,6,1,5,37,66,2.2
8329,"Malik Sealy\sealyma01","1993-94",23,"IND","NBA",0.6,43,5,623,111,274,107,258,4,16,59,87,43,75,118,48,31,8,51,84,285,5.67
8330,"Brian Shaw\shawbr01","1995-96",29,"ORL","NBA",0.6,75,1,1679,182,486,141,342,41,144,91,114,58,166,224,336,58,11,173,160,496,8.13
8331,"Brian Shaw\shawbr01","2002-03",36,"LAL","NBA",0.6,72,0,900,101,261,63,152,38,109,10,15,20,99,119,103,32,13,54,62,250,3.7
8332,"Dickey Simpkins\simpkdi01","1997-98",25,"TOT","NBA",0.6,40,0,433,48,89,48,87,0,2,36,70,27,50,77,33,9,5,32,54,132,3.54
8333,"Kenny Smith\smithke01","1996-97",31,"TOT","NBA",0.6,48,3,765,101,239,42,104,59,135,39,45,4,40,44,116,19,0,71,30,300,6.01
8334,"Tony Smith\smithto02","1996-97",28,"CHH","NBA",0.6,69,39,1291,138,337,106,238,32,99,38,59,38,56,94,150,48,19,73,110,346,5.23
8335,"Pape Sow\sowpa01","2005-06",24,"TOR","NBA",0.6,42,25,590,53,123,53,123,0,0,41,57,54,92,146,8,21,19,30,118,147,4.14
8336,"Marreese Speights\speigma01","2017-18",30,"ORL","NBA",0.6,52,3,675,138,349,52,116,86,233,40,55,21,112,133,40,8,22,40,106,402,5.99
8337,"Andre Spencer\spencan01","1992-93",28,"TOT","NBA",0.6,20,1,422,73,163,73,161,0,2,41,54,38,43,81,24,17,7,26,64,187,8.4
8338,"Elmore Spencer\spencel01","1993-94",24,"LAC","NBA",0.6,76,63,1930,288,540,288,538,0,2,97,162,96,319,415,75,30,127,168,208,673,9.49
8339,"John Starks\starkjo01","1999-00",34,"TOT","NBA",0.6,37,30,1190,203,542,144,371,59,171,50,59,10,91,101,181,42,4,67,102,515,11.49
8340,"Mark Strickland\stricma01","2000-01",30,"TOT","NBA",0.6,55,2,719,103,239,102,237,1,2,45,70,54,107,161,24,16,22,34,72,252,4.15
8341,"Isaiah Taylor\taylois01","2017-18",23,"ATL","NBA",0.6,67,9,1167,163,390,143,310,20,80,99,141,22,72,94,206,34,10,84,116,445,6.61
8342,"Jeff Teague\teaguje01","2009-10",21,"ATL","NBA",0.6,71,3,719,90,227,83,195,7,32,41,49,5,62,67,122,34,11,50,82,228,3.6
8343,"Mirza Teletović\teletmi01","2016-17",31,"MIL","NBA",0.6,70,2,1133,156,418,52,113,104,305,35,45,11,151,162,48,12,13,37,109,451,4.8
8344,"Sebastian Telfair\telfase01","2005-06",20,"POR","NBA",0.6,68,30,1641,228,578,171,416,57,162,130,175,19,101,120,247,66,6,115,167,643,8.86
8345,"Brooks Thompson\thompbr01","1995-96",25,"ORL","NBA",0.6,33,0,246,48,103,23,39,25,64,19,27,4,20,24,31,12,0,24,35,140,3.85
8346,"Jake Tsakalidis\tsakaja01","2004-05",25,"MEM","NBA",0.6,31,1,278,32,64,32,64,0,0,14,18,21,35,56,10,3,16,12,42,78,2.84
8347,"Anthony Tucker\tuckean01","1994-95",25,"WSB","NBA",0.6,62,13,982,96,210,96,209,0,1,51,83,44,126,170,68,46,11,56,129,243,4.69
8348,"Denzel Valentine\valende01","2016-17",23,"CHI","NBA",0.6,57,0,976,102,288,29,80,73,208,14,18,11,140,151,63,30,7,49,86,291,4.7
8349,"Jake Voskuhl\voskuja01","2004-05",27,"PHO","NBA",0.6,38,1,360,27,59,27,59,0,0,26,38,30,62,92,17,4,11,20,60,80,2.77
8350,"Samaki Walker\walkesa01","1998-99",22,"DAL","NBA",0.6,39,2,568,88,190,88,189,0,1,53,98,46,97,143,6,9,16,37,87,229,4.99
8351,"Gerald Wallace\wallage01","2001-02",19,"SAC","NBA",0.6,54,1,430,75,175,75,168,0,7,23,46,49,40,89,27,19,6,22,46,173,2.76
8352,"Rasheed Wallace\wallara01","2012-13",38,"NYK","NBA",0.6,21,0,296,55,142,33,73,22,69,14,20,11,72,83,6,13,15,10,40,146,6.05
8353,"C.J. Watson\watsocj01","2015-16",31,"ORL","NBA",0.6,33,2,656,47,137,33,89,14,48,34,39,10,56,66,88,19,5,25,49,142,5.25
8354,"David Wesley\wesleda01","1993-94",23,"NJN","NBA",0.6,60,0,542,64,174,53,127,11,47,44,53,10,34,44,123,38,4,52,47,183,3.8
8355,"D.J. White\whitedj01","2009-10",23,"OKC","NBA",0.6,12,0,102,25,41,25,41,0,0,9,10,10,13,23,4,5,3,3,12,59,4.92
8356,"Jahidi White\whiteja01","2002-03",26,"WAS","NBA",0.6,16,8,230,25,53,25,53,0,0,17,25,37,36,73,2,1,12,9,33,67,4.79
8357,"Okaro White\whiteok01","2016-17",24,"MIA","NBA",0.6,35,0,471,33,87,21,53,12,34,20,22,25,57,82,21,10,10,18,52,98,3.26
8358,"Chris Whitney\whitnch01","2002-03",31,"TOT","NBA",0.6,51,21,1052,124,349,74,185,50,164,57,69,3,64,67,145,29,2,71,92,355,6.16
8359,"Andrew Wiggins\wiggian01","2018-19",23,"MIN","NBA",0.6,73,73,2543,498,1209,380,861,118,348,207,296,83,269,352,184,70,48,138,153,1321,13.86
8360,"Chris Wilcox\wilcoch01","2002-03",20,"LAC","NBA",0.6,46,3,479,73,140,73,140,0,0,25,50,32,72,104,21,7,12,26,65,171,3.56
8361,"Mike Wilks\wilksmi01","2004-05",25,"SAS","NBA",0.6,48,0,278,32,77,27,61,5,16,12,16,4,21,25,33,14,1,14,26,81,1.79
8362,"Herb Williams\willihe01","1994-95",36,"NYK","NBA",0.6,56,3,743,82,180,82,180,0,0,23,37,23,109,132,27,13,45,40,108,187,3.65
8363,"David Wingate\wingada01","1995-96",32,"SEA","NBA",0.6,60,3,695,88,212,73,178,15,34,32,41,17,39,56,58,20,4,42,66,223,3.2
8364,"Chris Wright\wrighch01","2011-12",23,"GSW","NBA",0.6,24,1,186,23,45,23,45,0,0,24,31,19,26,45,4,7,13,8,22,70,3.41
8365,"Delon Wright\wrighde01","2015-16",23,"TOR","NBA",0.6,27,1,229,36,80,31,67,5,13,26,35,8,29,37,31,8,3,16,7,103,3.87
8366,"Julian Wright\wrighju01","2010-11",23,"TOR","NBA",0.6,52,6,766,82,160,80,150,2,10,22,43,47,71,118,58,39,20,43,45,188,4.64
8367,"Guerschon Yabusele\yabusgu01","2017-18",22,"BOS","NBA",0.6,33,4,235,26,61,14,24,12,37,15,22,17,35,52,16,4,5,12,23,79,2.53
8368,"George Zídek\zidekge01","1995-96",22,"CHH","NBA",0.6,71,21,888,105,248,105,248,0,0,71,93,69,114,183,16,9,7,38,170,281,3.36
8369,"Malik Allen\allenma01","2001-02",23,"MIA","NBA",0.5,12,2,161,22,51,22,50,0,1,8,10,15,23,38,5,3,8,2,16,52,4.3
8370,"James Anderson\anderja01","2011-12",22,"SAS","NBA",0.5,51,2,603,66,174,47,106,19,68,39,52,16,63,79,41,8,2,30,35,190,3.12
8371,"Ron Anderson\anderro01","1993-94",35,"TOT","NBA",0.5,21,2,356,35,86,28,60,7,26,19,23,16,37,53,17,8,3,10,16,96,4.35
8372,"Ron Anderson\anderro01","1992-93",34,"PHI","NBA",0.5,69,0,1263,225,544,186,424,39,120,72,89,62,122,184,93,31,5,63,75,561,6.33
8373,"Shandon Anderson\andersh01","2005-06",32,"MIA","NBA",0.5,48,1,638,54,126,49,107,5,19,13,18,18,63,81,30,17,6,24,75,126,2.75
8374,"Gilbert Arenas\arenagi01","2010-11",29,"TOT","NBA",0.5,70,16,1796,269,734,172,407,97,327,120,153,22,167,189,274,74,21,177,188,755,9.88
8375,"Hilton Armstrong\armsthi01","2007-08",23,"NOH","NBA",0.5,65,3,732,67,148,67,148,0,0,44,70,65,98,163,23,15,34,59,130,178,3.24
8376,"Hilton Armstrong\armsthi01","2010-11",26,"TOT","NBA",0.5,53,2,488,37,76,35,72,2,4,16,33,42,89,131,14,18,21,28,84,92,2.67
8377,"D.J. Augustin\augusdj01","2011-12",24,"CHA","NBA",0.5,48,46,1408,183,487,122,308,61,179,105,120,24,85,109,307,36,1,110,65,532,11.53
8378,"Ron Baker\bakerro01","2017-18",24,"NYK","NBA",0.5,29,1,385,20,59,9,26,11,33,20,26,5,25,30,47,26,6,18,33,71,3.81
8379,"Marcus Banks\banksma01","2009-10",28,"TOR","NBA",0.5,22,0,244,39,73,32,49,7,24,24,29,3,20,23,26,12,2,20,30,109,5.1
8380,"J.J. Barea\bareajo01","2007-08",23,"DAL","NBA",0.5,44,9,460,71,170,50,116,21,54,28,35,4,43,47,58,14,1,35,48,191,3.9
8381,"Dana Barros\barroda01","2001-02",34,"DET","NBA",0.5,29,20,582,74,192,50,121,24,71,21,27,1,56,57,78,14,2,33,37,193,6.16
8382,"Maceo Baston\bastoma01","2008-09",33,"IND","NBA",0.5,27,0,217,25,46,25,45,0,1,17,27,22,30,52,7,6,10,12,39,67,2.94
8383,"Tony Battie\battito01","1997-98",21,"DEN","NBA",0.5,65,49,1506,234,525,231,511,3,14,73,104,138,213,351,60,54,69,98,199,544,8.34
8384,"Tony Battie\battito01","2011-12",35,"PHI","NBA",0.5,27,11,295,19,51,19,50,0,1,4,4,8,59,67,16,4,6,4,26,42,2.23
8385,"John Battle\battljo01","1992-93",30,"CLE","NBA",0.5,41,0,497,83,200,82,194,1,6,56,72,4,25,29,54,9,5,22,39,223,4.19
8386,"Michael Beasley\beaslmi01","2011-12",23,"MIN","NBA",0.5,47,7,1087,221,497,183,396,38,101,61,95,39,168,207,45,18,19,80,83,541,8.8
8387,"Marco Belinelli\belinma01","2008-09",22,"GSW","NBA",0.5,42,23,882,140,317,88,186,52,131,40,52,10,61,71,88,36,1,59,73,372,7.81
8388,"Marco Belinelli\belinma01","2015-16",29,"SAC","NBA",0.5,68,7,1672,245,635,154,338,91,297,115,138,10,107,117,127,37,2,80,91,696,7.56
8389,"Raja Bell\bellra01","2009-10",33,"TOT","NBA",0.5,6,5,180,28,61,16,34,12,27,3,3,5,18,23,13,4,2,5,15,71,10.53
8390,"Dragan Bender\bendedr01","2018-19",21,"PHO","NBA",0.5,46,27,826,88,197,66,96,22,101,32,54,34,149,183,56,18,22,37,90,230,5.75
8391,"Jonathan Bender\bendejo01","2003-04",23,"IND","NBA",0.5,21,0,271,50,106,41,84,9,22,39,47,9,31,40,9,5,11,33,23,148,5.98
8392,"Anthony Bennett\bennean01","2016-17",23,"BRK","NBA",0.5,23,1,264,38,92,25,44,13,48,26,36,25,53,78,12,5,3,12,18,115,4.72
8393,"Mario Bennett\bennema01","1995-96",22,"PHO","NBA",0.5,19,14,230,29,64,29,63,0,1,27,42,21,28,49,6,11,11,11,46,85,4.65
8394,"Andray Blatche\blatcan01","2006-07",20,"WAS","NBA",0.5,56,13,682,86,197,82,170,4,27,30,49,77,114,191,39,17,32,49,94,206,4.25
8395,"Andrew Bogut\bogutan01","2011-12",27,"MIL","NBA",0.5,12,12,364,61,136,61,135,0,1,14,23,22,78,100,31,12,24,24,36,136,12.68
8396,"Calvin Booth\boothca01","2001-02",25,"SEA","NBA",0.5,15,15,279,35,82,35,82,0,0,23,24,20,34,54,16,6,13,16,47,93,6.47
8397,"Cal Bowdler\bowdlca01","2001-02",24,"ATL","NBA",0.5,52,0,585,61,174,60,169,1,5,39,47,38,72,110,11,18,15,11,64,162,2.72
8398,"Elton Brand\brandel01","2007-08",28,"LAC","NBA",0.5,8,6,274,52,114,52,114,0,0,37,47,21,43,64,16,3,15,17,21,141,16.04
8399,"Kedrick Brown\brownke01","2002-03",21,"BOS","NBA",0.5,51,5,666,61,171,58,132,3,39,20,32,45,95,140,20,34,13,23,68,145,3.1
8400,"Markel Brown\brownma02","2014-15",23,"BRK","NBA",0.5,47,29,781,76,210,59,146,17,64,47,57,16,91,107,39,31,12,27,57,216,4.36
8401,"P.J. Brown\brownpj01","2007-08",38,"BOS","NBA",0.5,18,0,209,14,41,14,40,0,1,11,16,29,39,68,10,5,8,10,29,39,3.26
8402,"Jud Buechler\buechju01","1999-00",31,"DET","NBA",0.5,58,5,657,55,156,37,73,18,83,2,7,30,61,91,33,25,16,13,50,130,2.35
8403,"Jud Buechler\buechju01","1993-94",25,"GSW","NBA",0.5,36,0,218,42,84,30,55,12,29,10,20,13,19,32,16,8,1,12,24,106,2.58
8404,"Matt Bullard\bullama01","1998-99",31,"HOU","NBA",0.5,41,0,413,43,114,19,52,24,62,7,10,9,33,42,18,13,4,14,28,117,2.4
8405,"Trey Burke\burketr01","2016-17",24,"WAS","NBA",0.5,57,0,703,116,255,85,185,31,70,22,29,7,40,47,100,11,5,48,54,285,4.45
8406,"Antonio Burks\burksan01","2004-05",24,"MEM","NBA",0.5,24,0,219,28,60,25,49,3,11,14,19,1,11,12,28,13,1,12,25,73,3.26
8407,"Scott Burrell\burresc01","1993-94",23,"CHH","NBA",0.5,51,16,767,98,234,96,228,2,6,46,70,46,86,132,62,37,16,45,88,244,4.98
8408,"Willie Burton\burtowi01","1996-97",28,"ATL","NBA",0.5,24,2,380,39,116,26,70,13,46,57,68,11,30,41,11,8,3,26,55,148,4.67
8409,"Mitchell Butler\butlemi02","2003-04",33,"WAS","NBA",0.5,41,4,552,54,124,43,94,11,30,15,24,24,47,71,32,22,4,24,54,134,3.43
8410,"Mitchell Butler\butlemi02","1998-99",28,"CLE","NBA",0.5,31,1,418,67,139,56,110,11,29,23,32,13,31,44,22,15,4,29,41,168,4.67
8411,"Jason Caffey\caffeja01","1998-99",25,"GSW","NBA",0.5,35,32,876,123,277,123,276,0,1,62,98,79,126,205,18,24,9,75,113,308,7.82
8412,"Isaiah Canaan\canaais01","2016-17",25,"CHI","NBA",0.5,39,0,592,63,173,38,79,25,94,30,33,6,44,50,37,22,1,21,35,181,3.91
8413,"DeMarre Carroll\carrode01","2011-12",25,"TOT","NBA",0.5,24,9,348,43,105,36,86,7,19,14,16,28,25,53,18,12,1,11,37,107,4.02
8414,"DeMarre Carroll\carrode01","2009-10",23,"MEM","NBA",0.5,71,1,795,88,222,88,216,0,6,33,53,53,97,150,33,28,9,24,107,209,2.79
8415,"Anthony Carter\cartean01","2004-05",29,"MIN","NBA",0.5,66,12,742,72,177,70,160,2,17,35,51,12,57,69,161,35,18,62,88,181,4.05
8416,"Alex Caruso\carusal01","2017-18",23,"LAL","NBA",0.5,37,7,562,50,116,37,73,13,43,21,30,15,50,65,75,23,10,42,52,134,4.8
8417,"Omri Casspi\casspom01","2016-17",28,"TOT","NBA",0.5,36,2,643,77,164,62,121,15,43,17,29,27,85,112,37,23,3,29,50,186,5.36
8418,"Duane Causwell\causwdu01","1997-98",29,"MIA","NBA",0.5,37,2,363,37,89,37,89,0,0,15,26,29,70,99,5,7,27,18,73,89,2.87
8419,"Wilson Chandler\chandwi01","2007-08",20,"NYK","NBA",0.5,35,16,685,106,242,97,212,9,30,34,54,38,89,127,33,15,16,27,83,255,6.29
8420,"Rakeem Christmas\chrisra01","2016-17",25,"IND","NBA",0.5,29,0,219,19,43,19,43,0,0,21,29,26,30,56,4,3,6,8,37,59,2.27
8421,"Bimbo Coles\colesbi01","1996-97",28,"GSW","NBA",0.5,51,13,1183,122,314,92,212,30,102,37,49,39,79,118,149,35,7,59,96,311,6.4
8422,"Kyle Collinsworth\colliky01","2017-18",26,"DAL","NBA",0.5,32,2,480,38,99,34,82,4,17,21,40,32,75,107,56,17,9,24,44,101,4.52
8423,"Bill Curley\curlebi01","1994-95",22,"DET","NBA",0.5,53,1,595,58,134,58,134,0,0,27,36,54,70,124,25,21,21,25,128,143,3.24
8424,"Marquis Daniels\daniema01","2012-13",32,"MIL","NBA",0.5,59,33,1085,132,351,112,279,20,72,40,54,48,102,150,65,51,10,45,77,324,4.9
8425,"Deyonta Davis\davisde01","2016-17",20,"MEM","NBA",0.5,36,0,238,24,47,24,47,0,0,10,18,20,40,60,2,3,17,8,40,58,1.99
8426,"Emanual Davis\davisem01","1999-00",31,"SEA","NBA",0.5,54,2,701,80,220,49,117,31,103,26,38,15,85,100,70,38,5,44,72,217,4.09
8427,"Hubert Davis\davishu01","2002-03",32,"DET","NBA",0.5,43,1,328,31,79,19,43,12,36,5,6,6,30,36,29,5,0,11,23,79,1.75
8428,"Josh Davis\davisjo02","2004-05",24,"PHI","NBA",0.5,42,5,328,42,111,23,58,19,53,14,17,29,50,79,12,8,4,15,45,117,2.52
8429,"Terry Davis\daviste01","1994-95",27,"DAL","NBA",0.5,46,2,580,49,113,49,111,0,2,42,66,63,93,156,10,6,3,30,76,140,3.23
8430,"Terry Davis\daviste01","1995-96",28,"DAL","NBA",0.5,28,0,501,55,108,55,108,0,0,27,47,43,74,117,21,10,4,25,66,137,5.35
8431,"Terry Dehere\deherte01","1994-95",23,"LAC","NBA",0.5,80,28,1774,279,685,231,522,48,163,229,292,35,117,152,225,45,7,157,200,835,8.88
8432,"Carlos Delfino\delfica01","2004-05",22,"DET","NBA",0.5,30,4,459,42,117,33,82,9,35,23,40,13,42,55,38,22,6,23,44,116,3.96
8433,"Matthew Dellavedova\dellama01","2017-18",27,"MIL","NBA",0.5,38,3,712,55,152,26,74,29,78,25,27,14,50,64,145,14,0,49,67,164,5.79
8434,"Matthew Dellavedova\dellama01","2018-19",28,"TOT","NBA",0.5,48,0,812,98,242,54,112,44,130,42,52,6,71,77,181,14,2,68,75,282,6.68
8435,"Cheick Diallo\diallch01","2016-17",20,"NOP","NBA",0.5,17,0,199,36,76,36,76,0,0,15,21,23,50,73,4,4,7,7,17,87,5.1
8436,"Yakhouba Diawara\diawaya01","2006-07",24,"DEN","NBA",0.5,64,19,1177,100,292,51,122,49,170,35,53,27,83,110,55,30,7,37,132,284,3.59
8437,"Yakhouba Diawara\diawaya01","2008-09",26,"MIA","NBA",0.5,63,21,851,76,217,25,54,51,163,10,19,26,56,82,27,13,6,16,75,213,2.49
8438,"Toney Douglas\douglto01","2016-17",30,"MEM","NBA",0.5,24,0,394,43,117,36,75,7,42,24,29,13,48,61,56,18,5,21,50,117,5.64
8439,"Chris Dudley\dudlech02","1999-00",34,"NYK","NBA",0.5,47,3,459,23,67,23,67,0,0,9,27,63,73,136,5,7,21,18,95,55,1.91
8440,"Mike Dunleavy\dunlemi02","2008-09",28,"IND","NBA",0.5,18,14,495,93,232,61,142,32,90,53,65,14,54,68,44,12,9,38,36,271,12.07
8441,"Ronald Dupree\duprero01","2003-04",23,"CHI","NBA",0.5,47,8,893,111,282,107,273,4,9,66,105,55,112,167,55,32,18,51,134,292,5.81
8442,"Tyus Edney\edneyty01","2000-01",27,"IND","NBA",0.5,24,0,263,35,91,34,85,1,6,35,39,5,19,24,54,17,0,25,17,106,4.96
8443,"Kevin Edwards\edwarke01","1995-96",30,"NJN","NBA",0.5,34,33,1007,142,390,100,286,42,104,68,84,14,61,75,71,54,7,68,67,394,9.12
8444,"Obinna Ekezie\ekeziob01","1999-00",24,"VAN","NBA",0.5,39,0,351,41,88,41,88,0,0,43,64,34,58,92,8,9,4,26,61,125,3.22
8445,"Sean Elliott\elliose01","1999-00",31,"SAS","NBA",0.5,19,19,391,38,106,25,69,13,37,25,32,6,41,47,28,12,2,19,34,114,5.47
8446,"Dale Ellis\ellisda01","1999-00",39,"TOT","NBA",0.5,42,5,564,66,159,29,59,37,100,9,13,13,43,56,14,13,0,20,45,178,3.25
8447,"Monta Ellis\ellismo01","2005-06",20,"GSW","NBA",0.5,49,3,886,132,318,104,236,28,82,42,59,22,83,105,78,32,11,58,69,334,5.99
8448,"Pervis Ellison\ellispe01","1999-00",32,"BOS","NBA",0.5,30,5,269,19,43,19,43,0,0,15,21,29,38,67,13,10,8,13,67,53,2.65
8449,"Evan Eschmeyer\eschmev01","2001-02",26,"DAL","NBA",0.5,31,6,299,21,50,21,50,0,0,20,33,35,63,98,9,10,9,16,60,62,2.97
8450,"Daniel Ewing\ewingda01","2006-07",23,"LAC","NBA",0.5,61,3,712,65,161,51,117,14,44,35,45,9,64,73,90,32,4,50,62,179,3.53
8451,"Marcus Fizer\fizerma01","2003-04",25,"CHI","NBA",0.5,46,2,738,134,350,132,333,2,17,90,120,61,141,202,43,16,8,51,97,360,6.28
8452,"Tremaine Fowlkes\fowlktr01","2001-02",25,"LAC","NBA",0.5,22,17,343,25,64,25,64,0,0,24,31,32,32,64,17,11,1,13,39,74,3.89
8453,"Richie Frahm\frahmri01","2005-06",28,"TOT","NBA",0.5,33,0,342,39,100,16,30,23,70,7,10,3,30,33,21,4,2,8,30,108,2.6
8454,"Lawrence Funderburke\fundela01","2002-03",32,"SAC","NBA",0.5,27,0,229,32,72,32,72,0,0,10,17,17,38,55,8,1,11,6,25,74,2.59
8455,"Dan Gadzuric\gadzuda01","2009-10",31,"MIL","NBA",0.5,32,6,314,39,89,39,89,0,0,10,25,38,54,92,12,9,13,15,63,88,3.08
8456,"Sundiata Gaines\gainesu01","2009-10",23,"UTA","NBA",0.5,32,0,217,38,82,31,56,7,26,23,46,6,23,29,39,12,0,14,17,106,3.3
8457,"Kenny Gattison\gattike01","1994-95",30,"CHH","NBA",0.5,21,0,409,47,100,47,99,0,1,31,51,21,54,75,17,7,15,22,64,125,5.96
8458,"Rudy Gay\gayru01","2006-07",20,"MEM","NBA",0.5,78,43,2103,321,760,269,617,52,143,152,209,93,255,348,100,71,74,140,192,846,9.64
8459,"Daniel Gibson\gibsoda01","2011-12",25,"CLE","NBA",0.5,35,7,916,87,248,32,109,55,139,34,43,11,90,101,76,26,16,45,69,263,7.18
8460,"Daniel Gibson\gibsoda01","2012-13",26,"CLE","NBA",0.5,46,3,919,84,247,28,84,56,163,26,37,5,55,60,82,30,4,31,89,250,4.79
8461,"Kendall Gill\gillke01","2004-05",36,"MIL","NBA",0.5,14,0,284,32,80,29,71,3,9,18,20,11,26,37,27,14,4,9,37,85,6.54
8462,"Gordan Giriček\giricgo01","2007-08",30,"TOT","NBA",0.5,56,0,831,133,302,97,203,36,99,23,26,16,80,96,62,24,4,52,82,325,4.9
8463,"Mike Gminski\gminsmi01","1992-93",33,"CHH","NBA",0.5,34,0,251,42,83,42,83,0,0,9,10,34,51,85,7,1,9,11,28,93,2.87
8464,"Devonte' Graham\grahade01","2018-19",23,"CHO","NBA",0.5,46,3,676,74,216,40,95,34,121,35,46,10,53,63,121,23,2,30,48,217,4.9
8465,"Treveon Graham\grahatr01","2018-19",25,"BRK","NBA",0.5,35,21,715,64,191,26,63,38,128,18,22,23,84,107,34,13,7,17,68,184,4.54
8466,"Ron Grandison\grandro01","1995-96",31,"TOT","NBA",0.5,28,3,311,22,58,18,44,4,14,17,25,20,35,55,13,12,2,12,31,65,2.66
8467,"Jerami Grant\grantje01","2014-15",20,"PHI","NBA",0.5,65,11,1377,124,352,75,196,49,156,114,193,49,149,198,79,40,68,85,144,411,6.23
8468,"Josh Grant\grantjo01","1993-94",26,"GSW","NBA",0.5,53,0,382,59,146,42,85,17,61,22,29,27,62,89,24,18,8,30,62,157,2.86
8469,"Aaron Gray\grayaa01","2012-13",28,"TOR","NBA",0.5,42,16,513,48,90,48,90,0,0,23,44,48,85,133,33,7,5,36,85,119,3.66
8470,"Gerald Green\greenge01","2005-06",20,"BOS","NBA",0.5,32,3,374,66,138,60,118,6,20,29,37,10,31,41,18,13,4,22,41,167,4.33
8471,"Willie Green\greenwi01","2013-14",32,"LAC","NBA",0.5,55,9,869,102,271,61,150,41,121,28,34,12,66,78,50,22,11,34,96,273,3.96
8472,"Donté Greene\greendo01","2010-11",22,"SAC","NBA",0.5,69,21,1127,156,386,111,232,45,154,43,65,49,98,147,48,36,20,60,88,400,4.72
8473,"Tom Hammonds\hammoto01","1999-00",32,"MIN","NBA",0.5,56,0,372,42,97,42,97,0,0,33,56,34,67,101,10,8,3,21,55,117,2.04
8474,"Darrin Hancock\hancoda01","1995-96",24,"CHH","NBA",0.5,63,7,838,112,214,111,211,1,3,47,73,40,58,98,47,28,5,56,94,272,4.13
8475,"Mike Harris\harrimi01","2007-08",24,"HOU","NBA",0.5,17,0,159,27,54,27,52,0,2,8,13,24,30,54,3,6,3,9,16,62,3.81
8476,"Mike Harris\harrimi01","2013-14",30,"UTA","NBA",0.5,20,0,225,29,61,29,59,0,2,26,27,15,18,33,5,16,7,11,36,84,4.51
8477,"Isaiah Hartenstein\harteis01","2018-19",20,"HOU","NBA",0.5,28,0,221,20,41,18,35,2,6,11,14,21,26,47,15,7,12,13,56,53,2.71
8478,"Chuck Hayes\hayesch01","2014-15",31,"TOR","NBA",0.5,29,0,255,22,46,22,46,0,0,6,11,18,33,51,20,10,4,8,37,50,2.48
8479,"Jarvis Hayes\hayesja01","2003-04",22,"WAS","NBA",0.5,70,42,2044,278,695,238,564,40,131,77,98,71,193,264,106,71,11,110,157,673,7.83
8480,"Cedric Henderson\hendece02","1998-99",23,"CLE","NBA",0.5,50,48,1517,189,453,187,441,2,12,74,91,45,152,197,113,58,24,97,136,454,8.77
8481,"Chris Herren\herrech01","1999-00",24,"DEN","NBA",0.5,45,1,597,45,124,21,57,24,67,27,40,12,40,52,111,15,2,42,74,141,4.04
8482,"Solomon Hill\hillso01","2018-19",27,"NOP","NBA",0.5,44,15,878,68,178,36,77,32,101,23,32,34,99,133,55,23,10,31,80,191,4.81
8483,"Darrun Hilliard\hillida01","2015-16",22,"DET","NBA",0.5,38,2,383,52,131,33,81,19,50,29,40,5,40,45,27,9,1,19,28,152,3.24
8484,"Byron Houston\houstby01","1994-95",25,"SEA","NBA",0.5,39,0,258,49,107,43,85,6,22,28,38,20,35,55,6,13,5,20,50,132,2.96
8485,"Josh Howard\howarjo01","2011-12",31,"UTA","NBA",0.5,43,18,991,144,361,135,324,9,37,75,97,39,119,158,50,32,10,53,91,372,7.1
8486,"Troy Hudson\hudsotr01","1998-99",22,"LAC","NBA",0.5,25,6,524,60,150,45,103,15,47,34,38,15,40,55,92,11,2,38,28,169,7.41
8487,"Josh Huestis\huestjo01","2017-18",26,"OKC","NBA",0.5,69,10,982,60,182,27,67,33,115,6,20,42,119,161,20,15,43,26,82,159,2.51
8488,"Lindsey Hunter\hunteli01","2005-06",35,"DET","NBA",0.5,30,1,353,37,100,26,57,11,43,2,4,10,30,40,62,19,1,20,44,87,3.67
8489,"Zydrunas Ilgauskas\ilgauzy01","1998-99",23,"CLE","NBA",0.5,5,5,171,29,57,29,57,0,0,18,30,17,27,44,4,4,7,9,24,76,14.44
8490,"Didier Ilunga-Mbenga\mbengdj01","2010-11",30,"NOH","NBA",0.5,41,0,330,23,49,23,49,0,0,13,18,35,51,86,6,6,27,21,52,59,2.33
8491,"Didier Ilunga-Mbenga\mbengdj01","2005-06",25,"DAL","NBA",0.5,43,1,237,32,60,32,59,0,1,10,20,19,37,56,2,6,25,16,47,74,2.05
8492,"Royal Ivey\iveyro01","2007-08",26,"MIL","NBA",0.5,75,20,1437,149,378,114,271,35,107,85,117,38,80,118,160,45,7,75,166,418,5.46
8493,"Bernard James\jamesbe01","2014-15",29,"DAL","NBA",0.5,16,2,158,12,27,12,27,0,0,20,23,18,21,39,4,2,15,6,17,44,3.72
8494,"Harold Jamison\jamisha01","2001-02",25,"LAC","NBA",0.5,25,2,176,22,43,22,43,0,0,10,15,24,15,39,6,5,1,6,23,54,2.25
8495,"Charles Jenkins\jenkich01","2011-12",22,"GSW","NBA",0.5,51,28,893,130,291,127,271,3,20,34,39,8,60,68,170,33,6,60,85,297,6.41
8496,"Amir Johnson\johnsam01","2006-07",19,"DET","NBA",0.5,8,0,124,18,33,18,30,0,3,11,14,15,22,37,3,5,13,9,19,47,7.61
8497,"Kevin Johnson\johnske02","1999-00",33,"PHO","NBA",0.5,6,0,113,16,28,15,27,1,1,7,7,0,16,16,24,2,0,7,6,40,8.67
8498,"Stanley Johnson\johnsst04","2018-19",22,"TOT","NBA",0.5,66,7,1208,171,440,109,225,62,215,50,64,34,183,217,88,60,14,81,114,454,6.47
8499,"Popeye Jones\jonespo01","1998-99",28,"BOS","NBA",0.5,18,2,206,20,51,20,50,0,1,14,17,28,24,52,15,5,0,7,31,54,3.41
8500,"Solomon Jones\jonesso01","2010-11",26,"IND","NBA",0.5,39,0,528,49,121,49,120,0,1,41,62,45,68,113,30,12,22,35,94,139,4.08
8501,"Jerome Jordan\jordaje01","2011-12",25,"NYK","NBA",0.5,21,0,108,17,33,17,33,0,0,8,10,14,13,27,4,1,6,2,15,42,2.08
8502,"Chris Kaman\kamanch01","2013-14",31,"LAL","NBA",0.5,39,13,736,176,346,176,343,0,3,52,68,54,175,229,58,11,40,74,93,404,10.18
8503,"Jason Kapono\kaponja01","2009-10",28,"PHI","NBA",0.5,57,12,976,126,301,63,130,63,171,9,15,14,52,66,39,21,6,34,80,324,4.21
8504,"Jason Kapono\kaponja01","2003-04",22,"CLE","NBA",0.5,41,3,427,52,129,31,85,21,44,20,24,19,36,55,14,13,2,21,41,145,2.93
8505,"Jerome Kersey\kerseje01","2000-01",38,"MIL","NBA",0.5,22,2,243,32,69,32,68,0,1,8,16,8,37,45,15,14,8,6,36,72,3.7
8506,"Gerard King\kingge02","2000-01",28,"WAS","NBA",0.5,45,3,706,90,176,90,176,0,0,36,45,39,90,129,31,14,11,47,94,216,4.89
8507,"Luke Kornet\kornelu01","2017-18",22,"NYK","NBA",0.5,20,1,326,49,125,21,46,28,79,8,11,11,53,64,26,6,16,12,28,134,6.29
8508,"Raef LaFrentz\lafrera01","2007-08",31,"POR","NBA",0.5,39,0,291,27,61,27,57,0,4,11,19,28,39,67,6,12,17,10,59,65,2.17
8509,"Bill Laimbeer\laimbbi01","1993-94",36,"DET","NBA",0.5,11,5,248,47,90,44,81,3,9,11,13,9,47,56,14,6,4,10,30,108,9.45
8510,"Doron Lamb\lambdo01","2013-14",22,"ORL","NBA",0.5,53,0,695,63,160,27,70,36,90,29,36,8,41,49,43,11,1,27,54,191,3.07
8511,"Jerome Lane\laneje01","1992-93",26,"CLE","NBA",0.5,21,2,149,27,54,27,54,0,0,5,20,24,29,53,17,12,3,7,32,59,3.49
8512,"Jason Lawson\lawsoja01","1997-98",23,"ORL","NBA",0.5,17,0,80,9,15,9,15,0,0,8,10,8,19,27,5,4,4,2,14,26,2.32
8513,"Cliff Levingston\levincl01","1994-95",34,"DEN","NBA",0.5,57,0,469,55,130,55,129,0,1,19,45,49,75,124,27,13,20,21,91,129,2.55
8514,"DeAndre Liggins\liggide01","2017-18",29,"TOT","NBA",0.5,58,4,724,40,106,21,53,19,53,2,5,7,68,75,48,37,14,20,81,101,2.62
8515,"DeAndre Liggins\liggide01","2016-17",28,"TOT","NBA",0.5,62,19,777,55,142,38,96,17,46,25,40,20,88,108,54,47,14,42,81,152,3.33
8516,"Jeremy Lin\linje01","2010-11",22,"GSW","NBA",0.5,29,0,285,28,72,27,67,1,5,19,25,12,22,34,42,33,9,18,31,76,4.02
8517,"Felipe López\lopezfe01","1998-99",24,"VAN","NBA",0.5,47,32,1218,169,379,157,335,12,44,87,135,69,97,166,62,49,14,82,128,437,8.27
8518,"Kyle Lowry\lowryky01","2006-07",20,"MEM","NBA",0.5,10,0,175,14,38,11,30,3,8,25,28,12,19,31,32,14,1,12,20,56,8.33
8519,"Sheldon Mac\mcclesh01","2016-17",24,"WAS","NBA",0.5,30,3,287,30,75,23,45,7,30,23,27,4,30,34,15,8,2,5,17,90,2.71
8520,"Shelvin Mack\macksh01","2012-13",22,"TOT","NBA",0.5,31,3,416,58,126,40,77,18,49,9,16,3,37,40,68,15,0,34,39,143,4.96
8521,"Vernon Macklin\macklve01","2011-12",25,"DET","NBA",0.5,23,0,135,19,35,19,35,0,0,8,14,14,20,34,5,4,4,3,9,46,2.2
8522,"Don MacLean\macledo01","1996-97",27,"PHI","NBA",0.5,37,2,733,163,365,151,327,12,38,64,97,41,99,140,37,12,10,47,71,402,8.09
8523,"Mark Macon\maconma01","1994-95",25,"DET","NBA",0.5,55,6,721,101,265,81,203,20,62,54,68,29,47,76,63,67,1,41,97,276,4.86
8524,"Mark Macon\maconma01","1992-93",23,"DEN","NBA",0.5,48,27,1141,158,381,158,375,0,6,42,60,33,70,103,126,69,3,72,135,358,7.25
8525,"Mark Macon\maconma01","1995-96",26,"DET","NBA",0.5,23,0,287,29,67,22,52,7,15,9,11,10,12,22,16,15,0,9,34,74,3.17
8526,"Rick Mahorn\mahorri01","1993-94",35,"NJN","NBA",0.5,28,0,226,23,47,23,46,0,1,13,20,16,38,54,5,3,5,7,38,59,2.29
8527,"Darrick Martin\martida01","1995-96",24,"TOT","NBA",0.5,59,16,1149,147,362,127,293,20,69,101,120,16,66,82,217,53,3,107,123,415,7.67
8528,"Jarell Martin\martija01","2018-19",24,"ORL","NBA",0.5,42,1,328,43,104,23,47,20,57,9,11,11,62,73,18,3,8,11,51,115,2.6
8529,"Frank Mason\masonfr01","2017-18",23,"SAC","NBA",0.5,52,2,984,144,380,113,294,31,86,94,115,30,100,130,147,34,10,65,72,413,7.54
8530,"Jason Maxiell\maxieja01","2010-11",27,"DET","NBA",0.5,57,14,930,93,189,93,189,0,0,51,99,66,107,173,17,24,21,44,92,237,4.25
8531,"Luc Mbah a Moute\mbahalu01","2012-13",26,"MIL","NBA",0.5,58,45,1326,151,377,138,340,13,37,72,126,89,167,256,55,42,14,70,82,387,6.11
8532,"James Michael McAdoo\mcadoja01","2014-15",22,"GSW","NBA",0.5,15,0,137,24,44,24,44,0,0,14,25,15,22,37,2,5,9,6,21,62,4.26
8533,"Walter McCarty\mccarwa01","1998-99",24,"BOS","NBA",0.5,32,4,659,64,177,51,127,13,50,40,57,36,79,115,40,24,13,40,88,181,5.72
8534,"Patrick McCaw\mccawpa01","2018-19",23,"TOT","NBA",0.5,29,1,397,26,63,17,35,9,28,13,15,7,41,48,29,23,2,17,38,74,3.57
8535,"K.J. McDaniels\mcdankj01","2016-17",23,"TOT","NBA",0.5,49,0,505,77,169,57,103,20,66,32,38,15,67,82,13,19,18,29,49,206,3.87
8536,"Ben McLemore\mclembe01","2017-18",24,"MEM","NBA",0.5,56,17,1091,157,373,102,214,55,159,53,64,34,105,139,51,38,15,61,139,422,6.41
8537,"Jordan McRae\mcraejo01","2018-19",27,"WAS","NBA",0.5,27,0,333,61,130,51,95,10,35,28,35,6,34,40,30,13,7,15,26,160,5.39
8538,"Stanislav Medvedenko\medvest01","2004-05",25,"LAL","NBA",0.5,43,4,423,71,156,71,155,0,1,23,28,31,48,79,13,9,2,13,64,165,3.1
8539,"Darius Miles\milesda01","2008-09",27,"MEM","NBA",0.5,34,0,298,48,99,47,93,1,6,23,31,19,38,57,17,11,20,21,32,120,3.72
8540,"Darius Miller\milleda01","2012-13",22,"NOH","NBA",0.5,52,2,694,44,108,22,52,22,56,8,8,8,70,78,44,17,12,23,89,118,2.83
8541,"Tracy Moore\mooretr01","1992-93",27,"DAL","NBA",0.5,39,1,510,103,249,80,182,23,67,53,61,23,29,52,47,21,4,32,54,282,5.72
8542,"Markieff Morris\morrima02","2015-16",26,"TOT","NBA",0.5,64,45,1629,305,718,258,563,47,155,108,147,73,279,352,124,58,34,135,184,765,10.6
8543,"Hanno Möttölä\mottoha01","2001-02",25,"ATL","NBA",0.5,82,14,1371,169,384,168,371,1,13,57,76,81,187,268,50,20,19,70,174,396,4.42
8544,"Byron Mullens\mulleby01","2013-14",24,"TOT","NBA",0.5,45,0,414,73,165,40,76,33,89,10,20,24,68,92,14,15,11,27,64,189,3.73
8545,"Tracy Murray\murratr01","1994-95",23,"TOT","NBA",0.5,54,3,516,95,233,60,147,35,86,33,42,20,39,59,19,14,4,35,73,258,3.39
8546,"Tracy Murray\murratr01","1992-93",21,"POR","NBA",0.5,48,14,495,108,260,87,190,21,70,35,40,40,43,83,11,8,5,31,59,272,3.82
8547,"Jerrod Mustaf\mustaje01","1992-93",23,"PHO","NBA",0.5,32,9,336,57,130,57,129,0,1,33,53,29,54,83,10,14,11,22,40,147,4.15
8548,"Lee Nailon\nailole01","2005-06",30,"PHI","NBA",0.5,22,0,237,40,80,40,80,0,0,13,15,23,19,42,7,8,4,10,32,93,3.85
8549,"Shabazz Napier\napiesh01","2014-15",23,"MIA","NBA",0.5,51,10,1012,87,228,44,110,43,118,44,56,17,96,113,130,40,4,81,76,261,6.09
8550,"Ed Nealy\nealyed01","1992-93",32,"TOT","NBA",0.5,41,4,308,26,69,18,42,8,27,9,12,12,52,64,15,12,2,7,41,69,1.94
8551,"Jameer Nelson\nelsoja01","2015-16",33,"DEN","NBA",0.5,39,15,1036,113,307,70,163,43,144,30,35,19,96,115,190,25,5,66,100,299,8.58
8552,"Ira Newble\newblir01","2006-07",32,"CLE","NBA",0.5,15,1,129,16,37,8,22,8,15,6,10,13,17,30,2,6,0,3,17,46,2.95
8553,"Greg Oden\odengr01","2013-14",26,"MIA","NBA",0.5,23,6,212,27,49,27,49,0,0,13,23,23,31,54,1,7,13,12,52,67,3.39
8554,"Kevin Ollie\ollieke01","2007-08",35,"PHI","NBA",0.5,40,0,300,29,69,29,68,0,1,12,15,4,15,19,38,10,0,5,28,70,1.91
8555,"Daniel Orton\ortonda01","2011-12",21,"ORL","NBA",0.5,16,2,187,17,30,17,29,0,1,11,25,19,20,39,5,8,9,7,30,45,3.66
8556,"Kostas Papanikolaou\papanko01","2014-15",24,"HOU","NBA",0.5,43,1,795,69,197,38,91,31,106,13,18,39,79,118,85,29,13,55,71,182,4.99
8557,"Jannero Pargo\pargoja01","2013-14",34,"CHA","NBA",0.5,29,0,242,52,118,28,58,24,60,8,11,1,19,20,52,14,1,26,17,136,4.56
8558,"Brandon Paul\paulbr01","2017-18",26,"SAS","NBA",0.5,64,2,576,55,127,40,73,15,54,22,43,6,62,68,37,25,7,29,58,147,2.42
8559,"Sasha Pavlović\pavloal01","2005-06",22,"CLE","NBA",0.5,53,19,813,87,212,52,116,35,96,32,49,16,64,80,25,19,6,42,103,241,3.65
8560,"Cameron Payne\payneca01","2018-19",24,"TOT","NBA",0.5,40,13,712,96,223,71,139,25,84,33,41,13,59,72,106,28,9,45,64,250,6.66
8561,"Oleksiy Pecherov\pecheol01","2008-09",23,"WAS","NBA",0.5,32,0,277,39,101,25,58,14,43,24,29,35,41,76,2,6,3,10,34,116,3.09
8562,"Anthony Peeler\peelean01","2004-05",35,"WAS","NBA",0.5,40,0,529,56,150,31,85,25,65,16,18,14,51,65,57,18,2,28,39,153,3.87
8563,"Miles Plumlee\plumlmi01","2018-19",30,"ATL","NBA",0.5,18,0,173,32,48,32,48,0,0,16,30,16,23,39,17,6,4,10,14,80,4.99
8564,"Miles Plumlee\plumlmi01","2016-17",28,"TOT","NBA",0.5,45,12,484,44,92,44,92,0,0,25,39,38,57,95,21,18,13,30,73,113,3.12
8565,"Vitaly Potapenko\potapvi01","1996-97",21,"CLE","NBA",0.5,80,3,1238,186,423,185,421,1,2,92,125,105,112,217,40,26,34,109,216,465,4.93
8566,"Leon Powe\powele01","2009-10",26,"CLE","NBA",0.5,20,2,236,21,49,21,49,0,0,37,63,19,42,61,0,6,2,11,36,79,3.73
8567,"Alex Poythress\poythal01","2018-19",25,"ATL","NBA",0.5,21,1,305,40,81,31,58,9,23,18,29,29,47,76,17,4,10,13,47,107,5.49
8568,"Joel Przybilla\przybjo01","2010-11",31,"TOT","NBA",0.5,36,9,519,25,44,25,44,0,0,14,27,37,108,145,13,5,15,29,79,64,3.35
8569,"Anthony Randolph\randoan01","2010-11",21,"TOT","NBA",0.5,40,3,590,123,264,122,260,1,4,58,86,43,117,160,33,22,24,53,62,305,7.1
8570,"Anthony Randolph\randoan01","2012-13",23,"DEN","NBA",0.5,39,0,329,56,114,56,106,0,8,31,45,29,66,95,12,19,21,37,41,143,4.11
8571,"Zach Randolph\randoza01","2001-02",20,"POR","NBA",0.5,41,0,238,48,107,48,107,0,0,18,27,31,38,69,13,7,4,15,29,114,2.47
8572,"Željko Rebrača\rebraze01","2003-04",31,"TOT","NBA",0.5,24,2,273,34,77,34,77,0,0,23,30,23,35,58,6,5,11,17,52,91,3.67
8573,"J.J. Redick\redicjj01","2007-08",23,"ORL","NBA",0.5,34,0,276,48,108,31,65,17,43,27,34,1,22,23,16,4,0,15,29,140,3.09
8574,"Shawn Respert\respesh01","1995-96",23,"MIL","NBA",0.5,62,0,845,113,292,71,170,42,122,35,42,28,46,74,68,32,4,42,67,303,4.08
8575,"Eric Riley\rileyer01","1995-96",25,"MIN","NBA",0.5,25,10,310,35,74,35,73,0,1,22,28,32,44,76,5,8,16,17,42,92,4.2
8576,"Lawrence Roberts\roberla01","2005-06",23,"MEM","NBA",0.5,33,0,181,20,44,20,42,0,2,11,23,26,23,49,5,8,2,5,30,51,1.69
8577,"Stanley Roberts\roberst01","1996-97",26,"LAC","NBA",0.5,18,2,378,63,148,63,148,0,0,45,64,24,67,91,9,8,23,23,57,171,8.43
8578,"Glenn Robinson\robingl01","2004-05",32,"SAS","NBA",0.5,9,0,157,34,77,32,71,2,6,20,23,4,20,24,8,4,3,7,19,90,7.76
8579,"Rumeal Robinson\robinru01","1996-97",30,"TOT","NBA",0.5,54,3,508,66,164,48,108,18,56,26,35,6,41,47,73,24,2,43,60,176,3.32
8580,"Carlos Rogers\rogerca01","2001-02",30,"IND","NBA",0.5,22,1,168,24,43,23,37,1,6,10,19,14,24,38,3,5,6,5,17,59,2.79
8581,"Carlos Rogers\rogerca01","1997-98",26,"TOT","NBA",0.5,21,0,376,47,91,47,89,0,2,18,32,35,32,67,18,10,8,14,35,112,5.55
8582,"Tree Rollins\rollitr01","1994-95",39,"ORL","NBA",0.5,51,3,478,20,42,20,42,0,0,21,31,31,64,95,9,7,36,23,63,61,2.2
8583,"Malik Rose\rosema01","2005-06",31,"NYK","NBA",0.5,72,35,1119,105,281,104,280,1,1,107,137,84,175,259,67,43,14,80,145,318,4.93
8584,"Ricky Rubio\rubiori01","2014-15",24,"MIN","NBA",0.5,22,22,692,78,219,65,168,13,51,57,71,19,106,125,193,38,1,64,59,226,14.64
8585,"John Salley\sallejo01","1999-00",35,"LAL","NBA",0.5,45,3,303,25,69,25,69,0,0,21,28,20,45,65,26,8,14,18,67,71,2.04
8586,"JaKarr Sampson\sampsja02","2018-19",25,"CHI","NBA",0.5,4,0,127,29,54,24,40,5,14,17,21,5,27,32,4,4,3,4,8,80,18.47
8587,"Jamal Sampson\sampsja01","2004-05",21,"CHA","NBA",0.5,23,0,329,28,62,28,62,0,0,23,39,36,86,122,8,4,17,17,53,79,4.81
8588,"Detlef Schrempf\schrede01","2000-01",38,"POR","NBA",0.5,26,0,397,39,95,36,87,3,8,23,27,17,61,78,44,7,3,28,43,104,4.72
8589,"Shawnelle Scott\scottsh01","1997-98",25,"CLE","NBA",0.5,41,0,188,16,36,16,36,0,0,12,18,20,39,59,8,6,8,10,45,44,1.55
8590,"Ansu Sesay\sesayan01","2001-02",25,"SEA","NBA",0.5,9,0,142,22,44,22,44,0,0,14,20,7,13,20,8,3,2,2,18,58,5.73
8591,"Chris Singleton\singlch01","2012-13",23,"WAS","NBA",0.5,57,11,924,92,241,85,205,7,36,40,70,51,133,184,37,38,24,45,124,231,4.24
8592,"Reggie Slater\slatere01","2002-03",32,"MIN","NBA",0.5,26,0,141,27,50,27,50,0,0,27,45,18,13,31,4,6,1,9,31,81,2.75
8593,"Jabari Smith\smithja01","2001-02",24,"TOT","NBA",0.5,23,0,181,26,63,26,60,0,3,21,32,8,20,28,11,6,6,5,31,73,2.78
8594,"Eric Snow\snower01","1995-96",22,"SEA","NBA",0.5,43,1,389,42,100,40,90,2,10,29,49,9,34,43,73,28,0,38,53,115,3.49
8595,"Will Solomon\solomwi01","2008-09",30,"TOT","NBA",0.5,53,9,712,105,245,77,159,28,86,25,34,12,52,64,133,27,4,54,71,263,5.25
8596,"Felton Spencer\spencfe01","1999-00",32,"SAS","NBA",0.5,26,0,149,15,33,15,33,0,0,20,30,15,24,39,3,6,8,9,32,50,2.24
8597,"Nik Stauskas\stausni01","2014-15",21,"SAC","NBA",0.5,73,1,1127,108,296,60,147,48,149,55,64,11,77,88,67,20,17,40,92,319,3.64
8598,"Nik Stauskas\stausni01","2015-16",22,"PHI","NBA",0.5,73,35,1809,210,545,104,220,106,325,91,118,23,160,183,138,44,20,94,115,617,7.35
8599,"Larry Stewart\stewala01","1994-95",26,"WSB","NBA",0.5,40,0,346,41,89,41,87,0,2,20,30,28,39,67,18,16,9,16,52,102,2.84
8600,"Bryant Stith\stithbr01","1998-99",28,"DEN","NBA",0.5,46,32,1194,114,290,83,184,31,106,61,71,30,77,107,82,28,15,45,65,320,6.46
8601,"Jarnell Stokes\stokeja01","2014-15",21,"MEM","NBA",0.5,19,2,126,21,37,21,37,0,0,15,28,16,18,34,4,5,5,7,25,57,3.12
8602,"Mark Strickland\stricma01","2001-02",31,"ATL","NBA",0.5,46,10,654,91,204,90,200,1,4,25,44,41,90,131,20,19,17,28,48,208,4.16
8603,"Chris Taft\taftch01","2005-06",20,"GSW","NBA",0.5,17,0,144,23,38,23,38,0,0,1,6,19,17,36,2,2,7,2,25,47,2.96
8604,"Maurice Taylor\tayloma01","2004-05",28,"TOT","NBA",0.5,65,16,1336,203,446,200,437,3,9,63,103,67,190,257,67,27,20,94,180,472,6.4
8605,"Mirza Teletović\teletmi01","2014-15",29,"BRK","NBA",0.5,40,4,892,122,319,60,126,62,193,33,46,27,167,194,46,14,16,53,74,339,7.36
8606,"Sebastian Telfair\telfase01","2006-07",21,"BOS","NBA",0.5,78,30,1578,176,474,139,346,37,128,90,110,17,91,108,218,43,11,98,166,479,5.85
8607,"Kurt Thomas\thomaku01","1996-97",24,"MIA","NBA",0.5,18,9,374,39,105,39,104,0,1,35,46,31,76,107,9,12,9,25,67,113,6.56
8608,"Marcus Thornton\thornma01","2016-17",29,"WAS","NBA",0.5,33,1,575,84,210,56,130,28,80,23,27,22,54,76,41,19,3,25,48,219,5.58
8609,"Jeremy Tyler\tylerje01","2013-14",22,"NYK","NBA",0.5,41,0,398,60,116,60,116,0,0,26,48,38,71,109,8,6,20,26,70,146,3.64
8610,"Ben Uzoh\uzohbe01","2010-11",22,"NJN","NBA",0.5,42,0,438,61,144,58,136,3,8,33,56,30,31,61,69,13,8,25,29,158,3.9
8611,"Greivis Vásquez\vasqugr01","2010-11",24,"MEM","NBA",0.5,70,1,860,95,233,70,147,25,86,34,44,12,61,73,151,22,4,70,83,249,3.99
8612,"Loy Vaught\vaughlo01","1998-99",30,"DET","NBA",0.5,37,10,481,59,155,59,154,0,1,9,14,36,110,146,11,15,6,17,54,127,3.39
8613,"Noah Vonleh\vonleno01","2014-15",19,"CHO","NBA",0.5,25,0,259,30,76,25,63,5,13,18,26,28,58,86,4,4,9,11,20,83,3.44
8614,"Henry Walker\walkebi01","2014-15",27,"MIA","NBA",0.5,24,13,628,58,168,13,36,45,132,14,18,7,75,82,29,24,9,24,76,175,6.77
8615,"Henry Walker\walkebi01","2008-09",21,"BOS","NBA",0.5,29,0,216,36,58,36,57,0,1,16,23,8,21,29,13,6,2,18,51,88,3
8616,"Samaki Walker\walkesa01","1996-97",20,"DAL","NBA",0.5,43,12,602,83,187,83,186,0,1,48,74,47,100,147,17,15,22,39,71,214,4.81
8617,"Rex Walters\waltere01","1998-99",28,"MIA","NBA",0.5,33,13,506,35,95,23,57,12,38,19,23,10,40,50,58,10,3,32,63,101,3.62
8618,"Luke Walton\waltolu01","2004-05",24,"LAL","NBA",0.5,61,5,768,74,180,58,119,16,61,34,48,55,87,142,93,26,11,58,70,198,4.12
8619,"Charlie Ward\wardch01","2004-05",34,"HOU","NBA",0.5,14,13,360,24,77,8,26,16,51,11,13,6,33,39,43,15,0,18,22,75,6.47
8620,"Hakim Warrick\warriha01","2011-12",29,"PHO","NBA",0.5,35,0,503,74,180,73,170,1,10,76,99,31,61,92,30,8,3,36,35,225,5.35
8621,"Doug West\westdo01","1999-00",32,"VAN","NBA",0.5,38,0,581,59,145,59,142,0,3,34,40,18,53,71,43,12,8,19,80,152,3.89
8622,"Mario West\westma02","2007-08",23,"ATL","NBA",0.5,64,2,269,21,49,21,45,0,4,17,26,26,22,48,13,12,4,9,61,59,1.13
8623,"Derrick White\whitede01","2017-18",23,"SAS","NBA",0.5,17,0,139,16,33,8,20,8,13,14,20,5,21,26,9,4,3,6,8,54,3.39
8624,"James White\whiteja02","2012-13",30,"NYK","NBA",0.5,57,16,435,50,116,36,75,14,41,11,19,5,43,48,29,13,4,17,44,125,2.03
8625,"Rodney White\whitero02","2004-05",24,"TOT","NBA",0.5,58,2,677,121,289,97,229,24,60,27,44,24,65,89,44,32,11,37,64,293,4.11
8626,"Morlon Wiley\wileymo01","1992-93",26,"TOT","NBA",0.5,58,15,995,96,254,42,100,54,154,17,26,29,62,91,181,65,3,80,127,263,6.04
8627,"Eddie Lee Wilkins\wilkied01","1992-93",30,"PHI","NBA",0.5,26,0,192,55,97,55,95,0,2,48,78,14,26,40,2,7,1,17,34,158,4.82
8628,"Mike Wilks\wilksmi01","2003-04",24,"HOU","NBA",0.5,26,0,145,17,36,11,26,6,10,10,12,3,13,16,17,3,0,7,15,50,2
8629,"Monty Williams\willimo01","2002-03",31,"PHI","NBA",0.5,21,2,276,34,80,34,78,0,2,24,32,12,33,45,26,12,5,17,33,92,4.67
8630,"Shammond Williams\willish01","2006-07",31,"LAL","NBA",0.5,30,0,345,35,86,15,36,20,50,4,6,11,29,40,31,12,0,13,20,94,3.22
8631,"Shelden Williams\willish02","2008-09",25,"TOT","NBA",0.5,45,0,512,70,157,70,155,0,2,46,63,49,104,153,12,22,18,34,64,186,4.48
8632,"Travis Williams\willitr01","1997-98",28,"CHH","NBA",0.5,39,0,365,56,119,56,118,0,1,24,46,53,39,92,20,18,5,30,55,136,3.55
8633,"Troy Williams\willitr02","2017-18",23,"TOT","NBA",0.5,21,1,307,51,109,40,71,11,38,20,30,22,41,63,16,20,4,19,34,133,6.3
8634,"Jamil Wilson\wilsoja02","2017-18",27,"LAC","NBA",0.5,15,10,274,38,81,11,18,27,63,2,4,3,29,32,10,5,8,8,34,105,6.21
8635,"David Wood\woodda01","1996-97",32,"MIL","NBA",0.5,46,0,240,20,38,15,23,5,15,12,18,5,22,27,13,7,6,6,36,57,1.46
8636,"Loren Woods\woodslo01","2001-02",23,"MIN","NBA",0.5,60,0,516,33,96,33,94,0,2,44,60,46,76,122,22,17,34,36,60,110,2.58
8637,"Guerschon Yabusele\yabusgu01","2018-19",23,"BOS","NBA",0.5,41,1,251,35,77,26,49,9,28,15,22,23,30,53,15,8,7,15,32,94,2.34
8638,"Joe Young\youngjo01","2017-18",25,"IND","NBA",0.5,53,1,558,80,186,55,120,25,66,22,29,12,51,63,39,14,1,26,39,207,3.27
8639,"Paul Zipser\zipsepa01","2016-17",22,"CHI","NBA",0.5,44,18,843,88,221,55,122,33,99,31,40,15,110,125,36,15,16,40,78,240,4.96
8640,"Tariq Abdul-Wahad\abdulta01","2002-03",28,"DAL","NBA",0.4,14,0,204,27,58,27,57,0,1,3,6,14,26,40,21,6,3,7,26,57,4.63
8641,"Jordan Adams\adamsjo01","2014-15",20,"MEM","NBA",0.4,30,0,248,35,86,25,61,10,25,14,23,9,19,28,16,16,7,14,24,94,2.92
8642,"Rafael Addison\addisra01","1996-97",32,"CHH","NBA",0.4,41,3,355,49,122,41,102,8,20,22,28,19,26,45,34,8,3,17,52,128,2.72
8643,"Jeff Adrien\adrieje01","2014-15",28,"MIN","NBA",0.4,17,0,215,19,44,19,44,0,0,22,38,23,54,77,15,4,9,9,30,60,4.82
8644,"Alexis Ajinça\ajincal01","2010-11",22,"TOT","NBA",0.4,34,2,340,59,133,47,99,12,34,13,18,17,61,78,10,11,19,18,73,143,3.94
8645,"Joe Alexander\alexajo01","2008-09",22,"MIL","NBA",0.4,59,0,716,102,245,86,199,16,46,58,83,44,71,115,42,15,29,52,107,278,4.2
8646,"Jerome Allen\allenje01","1996-97",24,"TOT","NBA",0.4,76,1,943,78,221,48,128,30,93,42,72,25,73,98,152,31,4,69,84,228,3.58
8647,"Alan Anderson\anderal01","2005-06",23,"CHA","NBA",0.4,36,7,564,75,181,51,123,24,58,33,41,23,47,70,32,11,4,32,48,207,4.76
8648,"Greg Anderson\andergr01","1995-96",31,"SAS","NBA",0.4,46,7,344,24,47,24,46,0,1,6,25,29,71,100,10,9,24,22,66,54,2.08
8649,"Justin Anderson\anderju01","2018-19",25,"ATL","NBA",0.4,48,4,463,64,157,40,80,24,77,26,35,24,60,84,23,22,13,23,48,178,3.56
8650,"Shandon Anderson\andersh01","2001-02",28,"NYK","NBA",0.4,82,6,1596,149,373,110,232,39,141,74,107,57,192,249,76,48,15,97,134,411,4.97
8651,"Joel Anthony\anthojo01","2015-16",33,"DET","NBA",0.4,19,0,96,6,10,6,10,0,0,6,8,8,13,21,1,2,12,2,15,18,1.69
8652,"Joel Anthony\anthojo01","2016-17",34,"SAS","NBA",0.4,19,0,122,10,16,10,16,0,0,5,8,8,23,31,3,2,6,4,11,25,1.96
8653,"Gilbert Arenas\arenagi01","2011-12",30,"MEM","NBA",0.4,17,0,211,26,64,13,25,13,39,7,10,2,16,18,18,11,1,12,35,72,3.99
8654,"B.J. Armstrong\armstbj01","1999-00",32,"CHI","NBA",0.4,27,18,583,83,186,70,157,13,29,22,25,2,45,47,78,7,1,40,34,201,6.81
8655,"Carlos Arroyo\arroyca01","2001-02",22,"TOT","NBA",0.4,37,1,371,49,111,49,109,0,2,13,18,12,28,40,70,11,1,23,30,111,3.45
8656,"Anthony Avent\aventan01","1993-94",24,"TOT","NBA",0.4,74,40,1371,150,398,150,398,0,0,89,123,144,194,338,65,33,31,85,147,389,5.3
8657,"Vin Baker\bakervi01","1998-99",27,"SEA","NBA",0.4,34,31,1162,198,437,198,434,0,3,72,160,86,125,211,56,32,34,76,121,468,11.34
8658,"Marcus Banks\banksma01","2006-07",25,"PHO","NBA",0.4,45,1,503,84,196,79,167,5,29,48,60,10,28,38,60,23,3,40,70,221,4.33
8659,"Leandro Barbosa\barbole01","2013-14",31,"PHO","NBA",0.4,20,0,368,56,131,49,106,7,25,31,39,5,32,37,32,7,4,19,30,150,6.23
8660,"Matt Barnes\barnema02","2004-05",24,"SAC","NBA",0.4,43,9,715,62,151,57,129,5,22,35,58,49,84,133,57,30,7,45,80,164,4.7
8661,"Andre Barrett\barrean01","2004-05",22,"TOT","NBA",0.4,38,1,483,45,124,31,72,14,52,14,19,11,29,40,69,19,1,27,51,118,3.45
8662,"Earl Barron\barroea01","2009-10",28,"NYK","NBA",0.4,7,6,232,30,68,30,68,0,0,22,29,31,46,77,8,4,4,11,24,82,12.4
8663,"Jon Barry\barryjo01","2005-06",36,"HOU","NBA",0.4,20,0,342,25,65,13,33,12,32,24,29,1,30,31,26,13,1,22,25,86,4.64
8664,"Maceo Baston\bastoma01","2007-08",32,"TOR","NBA",0.4,15,2,103,17,25,17,25,0,0,7,10,9,17,26,3,2,4,4,20,41,3.09
8665,"Rodrigue Beaubois\beaubro01","2012-13",24,"DAL","NBA",0.4,45,0,549,65,176,44,104,21,72,30,38,9,48,57,84,19,4,33,54,181,4.09
8666,"Corey Beck\beckco01","1997-98",26,"CHH","NBA",0.4,59,14,738,73,159,71,155,2,4,43,59,27,63,90,98,33,7,70,100,191,4.15
8667,"Benoit Benjamin\benjabe01","1997-98",33,"PHI","NBA",0.4,14,0,197,22,41,22,41,0,0,19,30,18,35,53,3,4,4,12,26,63,4.91
8668,"Patrick Beverley\beverpa01","2017-18",29,"LAC","NBA",0.4,11,11,334,48,119,24,59,24,60,14,17,16,29,45,32,19,5,25,34,134,11.96
8669,"Andrew Bogut\bogutan01","2017-18",33,"LAL","NBA",0.4,24,5,216,17,25,17,25,0,0,2,2,26,52,78,15,4,13,19,40,36,3.34
8670,"Walter Bond\bondwa01","1994-95",25,"TOT","NBA",0.4,23,0,290,39,84,24,43,15,41,14,20,8,24,32,24,6,4,17,47,107,4.34
8671,"Calvin Booth\boothca01","2005-06",29,"WAS","NBA",0.4,33,2,250,20,47,19,45,1,2,5,9,19,33,52,12,9,9,8,44,46,1.94
8672,"Avery Bradley\bradlav01","2012-13",22,"BOS","NBA",0.4,50,50,1435,192,478,152,352,40,126,37,49,30,81,111,104,64,19,72,129,461,7.86
8673,"MarShon Brooks\brookma01","2013-14",25,"TOT","NBA",0.4,35,0,316,57,125,44,100,13,25,32,44,10,44,54,25,14,4,24,21,159,4.15
8674,"Andre Brown\brownan01","2007-08",26,"MEM","NBA",0.4,33,1,286,39,78,39,78,0,0,22,49,37,55,92,8,7,4,14,38,100,3.1
8675,"Chucky Brown\brownch01","2000-01",32,"TOT","NBA",0.4,26,2,339,40,95,40,92,0,3,22,34,8,46,54,11,9,7,8,37,102,3.46
8676,"Devin Brown\brownde02","2009-10",31,"TOT","NBA",0.4,50,37,1060,136,361,78,197,58,164,69,86,29,95,124,65,33,6,62,72,399,6.52
8677,"Jabari Brown\brownja01","2014-15",22,"LAL","NBA",0.4,19,5,568,70,170,47,108,23,62,64,85,3,33,36,40,12,2,32,33,227,9.65
8678,"Kedrick Brown\brownke01","2001-02",20,"BOS","NBA",0.4,29,5,245,23,70,18,43,5,27,12,20,11,39,50,15,18,7,7,18,63,2.53
8679,"Kwame Brown\brownkw01","2012-13",30,"PHI","NBA",0.4,22,11,269,17,37,17,37,0,0,7,19,23,51,74,9,6,10,8,37,41,3
8680,"Marcus Brown\brownma01","1996-97",22,"POR","NBA",0.4,21,0,184,28,70,15,38,13,32,13,19,4,11,15,20,8,2,13,26,82,3.39
8681,"Randy Brown\brownra02","1993-94",25,"SAC","NBA",0.4,61,2,1041,110,251,110,247,0,4,53,87,40,72,112,133,63,14,75,132,273,5.55
8682,"Andrew Bynum\bynuman01","2013-14",26,"TOT","NBA",0.4,26,19,516,94,225,94,225,0,0,37,49,53,92,145,29,6,29,34,31,225,7.88
8683,"Jason Caffey\caffeja01","1995-96",22,"CHI","NBA",0.4,57,0,545,71,162,71,161,0,1,40,68,51,60,111,24,12,7,48,91,182,2.88
8684,"Dexter Cambridge\cambrde01","1992-93",23,"DAL","NBA",0.4,53,13,885,151,312,151,308,0,4,68,99,88,79,167,58,24,6,63,128,370,6.32
8685,"Brian Cardinal\cardibr01","2009-10",32,"MIN","NBA",0.4,29,0,267,14,36,11,27,3,9,17,18,7,22,29,24,9,3,7,56,48,2.33
8686,"Cedric Ceballos\cebalce01","1998-99",29,"DAL","NBA",0.4,13,5,352,59,140,48,112,11,28,34,49,23,62,85,12,7,5,28,23,163,10.42
8687,"Calbert Cheaney\cheanca01","1998-99",27,"WAS","NBA",0.4,50,18,1266,172,415,164,378,8,37,33,67,33,108,141,73,39,16,42,146,385,6.15
8688,"Bimbo Coles\colesbi01","2001-02",33,"CLE","NBA",0.4,47,1,693,56,146,52,126,4,20,33,37,12,43,55,107,13,4,31,59,149,3.84
8689,"Jason Collier\collija02","2001-02",24,"HOU","NBA",0.4,25,2,365,41,95,41,94,0,1,24,32,31,51,82,9,6,4,13,40,106,4.02
8690,"Jason Collins\collija04","2012-13",34,"TOT","NBA",0.4,38,9,384,9,29,9,29,0,0,23,32,22,38,60,8,12,10,18,85,41,1.82
8691,"Nick Collison\collini01","2016-17",36,"OKC","NBA",0.4,20,0,128,14,23,14,22,0,1,5,8,9,22,31,12,2,2,4,17,33,2.27
8692,"Brian Cook\cookbr01","2007-08",27,"TOT","NBA",0.4,51,2,629,88,234,45,119,43,115,19,21,28,81,109,27,13,12,39,93,238,3.77
8693,"Chris Corchiani\corchch01","1993-94",25,"BOS","NBA",0.4,51,0,467,40,94,29,56,11,38,26,38,8,36,44,86,22,2,38,47,117,3.21
8694,"Joe Courtney\courtjo01","1993-94",24,"TOT","NBA",0.4,52,1,345,67,148,65,145,2,3,32,47,28,28,56,15,10,12,21,44,168,2.63
8695,"Joe Crispin\crispjo01","2001-02",22,"TOT","NBA",0.4,21,0,156,26,68,11,29,15,39,12,13,2,9,11,26,5,0,10,10,79,3.29
8696,"Terry Cummings\cummite01","1999-00",38,"GSW","NBA",0.4,22,0,398,76,177,76,177,0,0,32,39,45,62,107,21,13,8,27,74,184,7.45
8697,"Luigi Datome\datomlu01","2014-15",27,"TOT","NBA",0.4,21,1,209,43,89,25,49,18,40,1,1,3,26,29,9,2,7,9,15,105,4.03
8698,"Kornél Dávid\davidko01","2000-01",29,"TOT","NBA",0.4,27,0,209,25,51,25,51,0,0,12,13,15,37,52,7,6,4,11,28,62,2.61
8699,"Dale Davis\davisda01","2005-06",36,"DET","NBA",0.4,28,2,178,9,24,9,23,0,1,8,15,21,32,53,6,0,9,4,23,26,1.49
8700,"Deyonta Davis\davisde01","2018-19",22,"ATL","NBA",0.4,9,0,118,15,22,15,21,0,1,6,10,10,26,36,5,3,5,3,12,36,5.49
8701,"Terry Davis\daviste01","1993-94",26,"DAL","NBA",0.4,15,5,286,24,59,24,59,0,0,8,12,30,44,74,6,9,1,5,27,56,4.41
8702,"Andrew DeClercq\declean01","1995-96",22,"GSW","NBA",0.4,22,1,203,24,50,24,49,0,1,11,19,18,21,39,9,7,5,4,30,59,2.85
8703,"Tony Delk\delkto01","1998-99",25,"GSW","NBA",0.4,36,13,630,92,253,76,187,16,66,46,71,11,43,54,95,16,6,45,47,246,5.67
8704,"Derrick Dial\dialde01","2000-01",25,"SAS","NBA",0.4,33,0,207,36,83,34,73,2,10,12,21,12,26,38,21,4,6,12,22,86,2.33
8705,"Dan Dickau\dickada01","2006-07",28,"POR","NBA",0.4,50,3,444,54,151,38,90,16,61,42,53,7,36,43,70,14,1,27,55,166,3.17
8706,"Dan Dickau\dickada01","2005-06",27,"BOS","NBA",0.4,19,0,234,17,46,7,26,10,20,18,18,5,11,16,40,11,1,18,40,62,4.35
8707,"DeSagana Diop\diopde01","2009-10",28,"CHA","NBA",0.4,27,0,262,15,29,15,29,0,0,2,9,24,41,65,5,5,14,12,31,32,2.19
8708,"Juan Dixon\dixonju01","2007-08",29,"TOT","NBA",0.4,53,0,668,106,258,76,186,30,72,21,26,15,60,75,97,21,2,54,62,263,4.59
8709,"Tyler Dorsey\dorsety01","2017-18",21,"ATL","NBA",0.4,56,5,974,144,382,72,183,72,199,45,63,17,113,130,79,17,5,37,63,405,5.64
8710,"Greg Dreiling\dreilgr01","1996-97",34,"DAL","NBA",0.4,40,3,389,34,74,33,73,1,1,11,27,19,57,76,11,8,7,9,65,80,2.16
8711,"Devin Ebanks\ebankde01","2010-11",21,"LAL","NBA",0.4,20,0,118,21,51,19,46,2,5,18,23,15,12,27,2,4,5,6,7,62,2.62
8712,"Blue Edwards\edwarbl01","1998-99",33,"MIA","NBA",0.4,24,0,283,32,72,28,62,4,10,9,13,7,26,33,30,17,5,21,23,77,3.85
8713,"James Edwards\edwarja01","1992-93",37,"LAL","NBA",0.4,52,0,617,122,270,122,270,0,0,84,118,30,70,100,41,10,7,51,122,328,4.96
8714,"Obinna Ekezie\ekeziob01","2000-01",25,"TOT","NBA",0.4,33,0,281,32,81,32,81,0,0,37,53,31,47,78,9,5,5,14,48,101,2.93
8715,"Henry Ellenson\ellenhe01","2018-19",22,"TOT","NBA",0.4,19,0,259,39,95,22,57,17,38,19,25,5,61,66,16,7,2,9,27,114,5.62
8716,"Wayne Ellington\ellinwa01","2009-10",22,"MIN","NBA",0.4,76,1,1384,190,448,126,286,64,162,61,70,33,126,159,74,20,5,74,72,505,5.3
8717,"Melvin Ely\elyme01","2003-04",25,"LAC","NBA",0.4,42,2,510,66,153,66,152,0,1,25,42,48,53,101,22,9,17,20,68,157,3.48
8718,"Tyler Ennis\ennisty01","2016-17",22,"TOT","NBA",0.4,53,2,588,90,208,63,138,27,70,21,25,9,36,45,86,25,2,45,58,228,4.18
8719,"Tyler Ennis\ennisty01","2015-16",21,"MIL","NBA",0.4,46,7,654,84,187,71,148,13,39,25,34,13,62,75,95,25,1,46,64,206,4.94
8720,"Semih Erden\erdense01","2011-12",25,"CLE","NBA",0.4,28,9,333,39,74,39,74,0,0,21,41,20,52,72,9,10,5,16,60,99,3.69
8721,"Jordan Farmar\farmajo01","2015-16",29,"MEM","NBA",0.4,12,10,291,42,100,26,55,16,45,10,10,4,21,25,37,15,2,18,22,110,9.09
8722,"Tony Farmer\farmeto01","1997-98",28,"CHH","NBA",0.4,27,2,169,17,53,15,44,2,9,31,39,16,16,32,5,10,4,9,23,67,2.32
8723,"Landry Fields\fieldla01","2013-14",25,"TOR","NBA",0.4,30,2,322,27,67,27,62,0,5,14,22,15,44,59,20,10,3,11,25,68,2.61
8724,"Matt Fish\fishma01","1995-96",26,"TOT","NBA",0.4,18,1,134,21,36,21,36,0,0,10,19,10,11,21,8,3,7,3,19,52,2.97
8725,"Derek Fisher\fishede01","2012-13",38,"TOT","NBA",0.4,33,9,575,55,161,25,81,30,80,35,38,2,35,37,47,19,3,30,55,175,4.6
8726,"Marcus Fizer\fizerma01","2004-05",26,"MIL","NBA",0.4,54,0,903,133,292,133,286,0,6,70,103,29,146,175,64,25,13,63,96,336,5.94
8727,"Sherell Ford\fordsh01","1995-96",23,"SEA","NBA",0.4,28,1,139,30,80,26,55,4,25,26,34,12,12,24,5,8,1,6,27,90,2.31
8728,"Greg Foster\fostegr01","2000-01",32,"LAL","NBA",0.4,62,8,451,56,133,53,124,3,9,10,14,29,83,112,32,9,12,25,76,125,2.21
8729,"Jeff Foster\fosteje01","2011-12",35,"IND","NBA",0.4,11,0,141,9,18,8,17,1,1,6,9,18,24,42,4,8,1,7,26,25,3.92
8730,"Jeff Foster\fosteje01","2009-10",33,"IND","NBA",0.4,16,3,255,22,46,22,45,0,1,5,9,34,47,81,21,3,4,14,45,49,4.81
8731,"Tremaine Fowlkes\fowlktr01","2003-04",27,"DET","NBA",0.4,36,0,261,15,48,14,40,1,8,13,18,18,35,53,14,9,3,12,37,44,1.57
8732,"Randy Foye\foyera01","2015-16",32,"TOT","NBA",0.4,81,8,1642,169,482,94,232,75,250,61,74,24,132,156,161,39,29,86,131,474,5.35
8733,"Alonzo Gee\geeal01","2009-10",22,"WAS","NBA",0.4,11,2,182,28,59,21,50,7,9,18,29,15,18,33,7,7,1,10,13,81,6.57
8734,"Kendall Gill\gillke01","2003-04",35,"CHI","NBA",0.4,56,35,1411,215,548,206,510,9,38,100,136,61,129,190,89,65,16,83,107,539,7.88
8735,"Rudy Gobert\goberru01","2013-14",21,"UTA","NBA",0.4,45,0,434,36,74,36,74,0,0,32,65,51,104,155,7,8,41,32,57,104,3.49
8736,"Stephen Graham\grahast01","2007-08",25,"IND","NBA",0.4,22,0,128,34,58,27,44,7,14,12,16,4,18,22,9,4,1,10,14,87,3.55
8737,"Treveon Graham\grahatr01","2016-17",23,"CHO","NBA",0.4,27,1,189,19,40,10,25,9,15,10,15,5,17,22,6,6,1,3,18,57,2.01
8738,"Gary Grant\grantga01","1996-97",31,"MIA","NBA",0.4,28,0,365,39,110,25,64,14,46,18,22,8,30,38,45,16,0,27,39,110,3.92
8739,"Jeff Grayer\grayeje01","1994-95",29,"PHI","NBA",0.4,47,25,1098,163,381,158,366,5,15,58,83,58,91,149,74,27,4,56,80,389,6.78
8740,"JaMychal Green\greenja01","2014-15",24,"TOT","NBA",0.4,24,1,164,27,47,27,41,0,6,8,10,19,26,45,4,5,5,14,25,62,2.85
8741,"Sidney Green\greensi02","1992-93",32,"TOT","NBA",0.4,39,0,329,34,89,34,87,0,2,25,31,32,86,118,24,6,5,20,37,93,2.96
8742,"Adrian Griffin\griffad01","2000-01",26,"BOS","NBA",0.4,44,0,377,33,97,24,71,9,26,18,24,27,60,87,27,18,5,18,45,93,2.53
8743,"Tom Gugliotta\guglito01","2004-05",35,"TOT","NBA",0.4,47,9,966,99,241,91,215,8,26,33,43,56,135,191,68,41,17,57,104,239,6.02
8744,"Tom Gugliotta\guglito01","2002-03",33,"PHO","NBA",0.4,27,11,447,60,132,60,131,0,1,9,9,25,75,100,31,14,5,31,35,129,5.18
8745,"Hamed Haddadi\haddaha01","2008-09",23,"MEM","NBA",0.4,19,0,120,15,31,15,31,0,0,18,30,16,31,47,8,1,12,9,20,48,3.23
8746,"Richard Hamilton\hamilri01","2012-13",34,"CHI","NBA",0.4,50,45,1088,204,475,188,423,16,52,66,77,16,67,83,119,24,5,84,93,490,7.57
8747,"Darrin Hancock\hancoda01","1994-95",23,"CHH","NBA",0.4,46,7,424,68,121,67,118,1,3,16,39,14,39,53,30,19,4,30,48,153,3.27
8748,"Anfernee Hardaway\hardaan01","2000-01",29,"PHO","NBA",0.4,4,4,112,15,36,13,28,2,8,7,11,5,13,18,15,6,1,3,6,39,10.65
8749,"Al Harrington\harrial01","2013-14",33,"WAS","NBA",0.4,34,0,511,82,207,48,107,34,100,27,35,15,65,80,28,14,0,34,72,225,5.16
8750,"Lucious Harris\harrilu01","1996-97",26,"PHI","NBA",0.4,54,3,813,112,294,76,195,36,99,33,47,27,44,71,50,41,3,34,45,293,4.31
8751,"David Harrison\harrida01","2007-08",25,"IND","NBA",0.4,55,0,702,90,170,90,170,0,0,49,96,43,75,118,14,20,59,58,164,229,4.46
8752,"Jason Hart\hartja01","2007-08",29,"UTA","NBA",0.4,57,0,606,58,180,47,149,11,31,38,45,5,50,55,86,30,3,28,75,165,3.05
8753,"Antonio Harvey\harvean01","1994-95",24,"LAL","NBA",0.4,59,8,572,77,176,76,175,1,1,24,45,39,63,102,23,15,41,25,87,179,3.03
8754,"Udonis Haslem\hasleud01","2015-16",35,"MIA","NBA",0.4,37,0,260,23,61,22,52,1,9,12,16,10,65,75,14,5,2,5,25,59,1.89
8755,"Juaquin Hawkins\hawkiju01","2002-03",29,"HOU","NBA",0.4,58,10,685,57,148,47,124,10,24,10,20,16,62,78,47,29,6,29,57,134,2.53
8756,"Gerald Henderson\hendege02","2009-10",22,"CHA","NBA",0.4,43,0,355,37,104,33,85,4,19,35,47,15,40,55,13,10,9,14,25,113,2.27
8757,"Juan Hernangómez\hernaju01","2017-18",22,"DEN","NBA",0.4,25,3,277,29,75,15,25,14,50,10,12,18,36,54,12,6,3,9,25,82,3.14
8758,"Solomon Hill\hillso01","2013-14",22,"IND","NBA",0.4,28,0,226,17,40,10,17,7,23,6,7,9,32,41,12,5,2,13,19,47,2.02
8759,"Eddie House\houseed01","2000-01",22,"MIA","NBA",0.4,50,0,550,104,247,85,192,19,55,24,35,5,37,42,52,13,0,35,58,251,3.63
8760,"Bobby Hurley\hurlebo01","1996-97",25,"SAC","NBA",0.4,49,12,632,46,125,32,80,14,45,37,53,9,29,38,146,27,3,55,53,143,4.37
8761,"Didier Ilunga-Mbenga\mbengdj01","2007-08",27,"TOT","NBA",0.4,42,0,326,39,84,39,84,0,0,5,12,28,44,72,10,7,26,12,70,83,2.33
8762,"Frank Jackson\jacksfr01","2018-19",20,"NOP","NBA",0.4,61,16,1169,194,447,141,278,53,169,54,73,25,109,134,69,25,2,48,92,495,6.24
8763,"Jaren Jackson\jacksja01","1992-93",25,"LAC","NBA",0.4,34,0,350,53,128,51,123,2,5,23,27,19,20,39,35,19,5,17,45,131,3.64
8764,"Mark Jackson\jacksma01","2003-04",38,"HOU","NBA",0.4,42,3,577,34,100,27,59,7,41,28,39,10,60,70,119,17,1,53,41,103,4.08
8765,"Mike James\jamesmi01","2012-13",37,"DAL","NBA",0.4,45,23,862,101,271,53,146,48,125,23,29,9,63,72,139,26,3,55,95,273,6.12
8766,"Amile Jefferson\jeffeam01","2018-19",25,"ORL","NBA",0.4,12,0,68,10,16,10,16,0,0,7,8,6,15,21,3,3,3,1,8,27,2.92
8767,"Yi Jianlian\jianlyi01","2010-11",23,"WAS","NBA",0.4,63,11,1112,145,347,142,334,3,13,62,91,79,169,248,25,27,32,51,115,355,5.15
8768,"Anthony Johnson\johnsan02","1997-98",23,"SAC","NBA",0.4,77,62,2266,226,609,184,481,42,128,80,110,51,120,171,329,64,6,120,188,574,7.7
8769,"Avery Johnson\johnsav01","2002-03",37,"DAL","NBA",0.4,48,0,430,63,150,63,148,0,2,30,39,10,21,31,64,15,1,29,26,156,3.03
8770,"DerMarr Johnson\johnsde03","2003-04",23,"NYK","NBA",0.4,21,1,287,36,97,23,61,13,36,28,31,5,34,39,11,8,7,16,32,113,4.5
8771,"Linton Johnson\johnsli01","2005-06",25,"TOT","NBA",0.4,36,7,524,61,149,48,113,13,36,18,27,40,82,122,14,12,12,28,61,153,4.13
8772,"Linton Johnson\johnsli01","2003-04",23,"CHI","NBA",0.4,41,20,734,72,203,65,170,7,33,22,37,59,124,183,27,37,32,37,90,173,5
8773,"Stanley Johnson\johnsst04","2016-17",20,"DET","NBA",0.4,77,1,1371,129,365,84,211,45,154,36,53,36,153,189,105,56,24,71,121,339,4.55
8774,"Charles Jones\jonesch03","1999-00",24,"LAC","NBA",0.4,56,0,662,66,201,27,83,39,118,17,23,17,45,62,94,30,5,28,46,188,3.49
8775,"Dahntay Jones\jonesda02","2007-08",27,"SAC","NBA",0.4,25,0,206,23,53,22,47,1,6,34,51,7,28,35,12,8,6,10,28,81,3.24
8776,"Derrick Jones\jonesde02","2017-18",20,"TOT","NBA",0.4,20,8,245,21,53,18,35,3,18,16,24,21,17,38,9,4,13,7,24,61,3.19
8777,"Reggie Jordan\jordare01","1996-97",29,"TOT","NBA",0.4,19,0,130,16,26,16,26,0,0,8,17,11,16,27,12,7,3,8,15,40,2.78
8778,"Adam Keefe\keefead01","1999-00",29,"UTA","NBA",0.4,62,3,604,53,130,53,129,0,1,29,36,45,91,136,34,17,13,46,90,135,2.69
8779,"Viktor Khryapa\khryavi01","2006-07",24,"CHI","NBA",0.4,33,0,231,27,70,27,64,0,6,19,26,20,37,57,21,10,1,16,53,73,2.43
8780,"Joe Kleine\kleinjo01","1996-97",35,"TOT","NBA",0.4,59,10,848,69,170,67,167,2,3,28,38,62,141,203,35,17,18,41,110,168,3.52
8781,"Viacheslav Kravtsov\kravtvi01","2012-13",25,"DET","NBA",0.4,25,0,224,33,46,33,46,0,0,11,37,24,21,45,9,5,9,14,32,77,3.33
8782,"Carl Landry\landrca01","2013-14",30,"SAC","NBA",0.4,18,1,233,31,60,31,60,0,0,14,17,15,42,57,5,3,1,9,34,76,4.18
8783,"Andrew Lang\langan01","1999-00",33,"NYK","NBA",0.4,19,10,244,28,64,28,64,0,0,3,7,16,44,60,3,8,6,5,31,59,3.27
8784,"Dan Langhi\langhda01","2002-03",25,"PHO","NBA",0.4,60,0,541,81,202,72,171,9,31,12,20,19,68,87,21,15,6,16,58,183,2.33
8785,"Acie Law\lawac01","2010-11",26,"TOT","NBA",0.4,51,0,726,81,186,75,150,6,36,47,64,12,51,63,84,32,0,43,61,215,4.44
8786,"Courtney Lee\leeco01","2018-19",33,"TOT","NBA",0.4,34,6,428,53,129,37,74,16,55,14,21,9,45,54,37,21,3,14,32,136,3.96
8787,"Damion Lee\leeda03","2017-18",25,"ATL","NBA",0.4,15,11,404,62,152,47,92,15,60,22,29,11,60,71,29,19,1,14,25,161,9.67
8788,"Doug Lee\leedo01","1994-95",30,"SAC","NBA",0.4,22,0,75,9,25,2,7,7,18,18,21,0,5,5,5,6,3,5,18,43,1.89
8789,"Malcolm Lee\leema01","2012-13",22,"MIN","NBA",0.4,16,12,289,29,76,21,52,8,24,12,20,15,24,39,20,12,6,10,30,78,4.94
8790,"Randy Livingston\livinra01","2004-05",29,"UTA","NBA",0.4,17,4,227,22,52,17,44,5,8,15,17,3,9,12,45,12,2,14,28,64,5.02
8791,"Shaun Livingston\livinsh01","2008-09",23,"TOT","NBA",0.4,12,1,231,31,60,31,60,0,0,9,10,3,25,28,20,7,2,9,12,71,6.22
8792,"Grant Long\longgr01","2002-03",36,"BOS","NBA",0.4,41,1,488,27,70,27,67,0,3,18,23,24,59,83,25,9,1,19,62,72,2.25
8793,"Felipe López\lopezfe01","1999-00",25,"VAN","NBA",0.4,65,0,781,111,261,108,243,3,18,67,109,59,65,124,44,32,17,53,94,292,4.02
8794,"Ryan Lorthridge\lorthry01","1994-95",22,"GSW","NBA",0.4,37,2,672,106,223,103,209,3,14,57,88,24,47,71,101,28,1,57,42,272,7.4
8795,"Tyronn Lue\luety01","2000-01",23,"LAL","NBA",0.4,38,1,468,50,117,39,83,11,34,19,24,5,27,32,45,19,0,27,54,130,3.41
8796,"Don MacLean\macledo01","1992-93",23,"WSB","NBA",0.4,62,4,674,157,361,154,355,3,6,90,111,33,89,122,39,11,4,42,82,407,4.82
8797,"Mark Madsen\madsema01","2006-07",31,"MIN","NBA",0.4,56,0,473,23,43,23,43,0,0,15,29,35,52,87,10,10,10,21,100,61,1.67
8798,"Josh Magette\magetjo01","2017-18",28,"ATL","NBA",0.4,18,0,216,15,46,7,24,8,22,8,8,2,17,19,57,8,1,9,16,46,4.22
8799,"Danny Manning\mannida01","1995-96",29,"PHO","NBA",0.4,33,4,816,178,388,175,374,3,14,82,109,30,113,143,65,38,24,77,121,441,11.74
8800,"Cartier Martin\martica01","2008-09",24,"CHA","NBA",0.4,33,1,266,28,77,18,44,10,33,20,25,7,26,33,13,8,4,9,33,86,2.25
8801,"Darrick Martin\martida01","2005-06",34,"TOR","NBA",0.4,40,0,339,34,97,18,57,16,40,18,24,2,18,20,57,17,0,15,42,102,2.76
8802,"Sean May\mayse01","2005-06",21,"CHA","NBA",0.4,23,1,398,70,171,70,166,0,5,49,64,42,67,109,22,17,12,33,58,189,7.64
8803,"Lee Mayberry\maybele01","1993-94",23,"MIL","NBA",0.4,82,6,1472,167,402,126,283,41,119,58,84,26,75,101,215,46,4,97,114,433,5.46
8804,"Lee Mayberry\maybele01","1997-98",27,"VAN","NBA",0.4,79,32,1835,131,349,68,169,63,180,38,51,19,95,114,349,65,10,113,164,363,6.68
8805,"Ray McCallum\mccalra01","2013-14",22,"SAC","NBA",0.4,45,10,897,113,300,91,241,22,59,32,43,18,61,79,120,22,9,39,69,280,5.66
8806,"JaVale McGee\mcgeeja01","2014-15",27,"TOT","NBA",0.4,23,0,256,42,79,42,79,0,0,22,33,18,43,61,3,2,20,18,30,106,4.59
8807,"Derrick McKey\mckeyde01","1998-99",32,"IND","NBA",0.4,13,0,244,23,52,23,51,0,1,14,17,18,23,41,13,12,4,12,24,60,5.53
8808,"Ben McLemore\mclembe01","2016-17",23,"SAC","NBA",0.4,61,26,1176,180,419,115,249,65,170,70,93,19,110,129,51,29,6,62,108,495,6.31
8809,"Roshown McLeod\mcleoro01","2000-01",25,"TOT","NBA",0.4,35,25,922,145,332,143,310,2,22,45,51,38,82,120,58,23,8,58,90,337,7.93
8810,"Jordan McRae\mcraejo01","2015-16",24,"TOT","NBA",0.4,22,1,195,34,78,24,56,10,22,21,28,4,16,20,25,3,1,15,17,99,3.84
8811,"Josh McRoberts\mcrobjo01","2014-15",27,"MIA","NBA",0.4,17,4,296,28,53,20,34,8,19,8,13,7,38,45,33,12,3,22,41,72,5.84
8812,"Josh McRoberts\mcrobjo01","2008-09",21,"IND","NBA",0.4,33,0,279,35,83,35,73,0,10,10,13,26,48,74,16,12,16,12,41,80,2.99
8813,"Stanislav Medvedenko\medvest01","2002-03",23,"LAL","NBA",0.4,58,10,620,112,258,112,256,0,2,31,43,66,75,141,18,11,8,37,118,255,3.45
8814,"Ron Mercer\mercero01","2003-04",27,"SAS","NBA",0.4,39,0,516,90,211,88,204,2,7,13,17,10,39,49,22,14,5,26,37,195,3.44
8815,"Mike Miller\millemi01","2014-15",34,"CLE","NBA",0.4,52,15,701,37,114,5,16,32,98,3,4,4,87,91,46,14,4,23,74,109,2.48
8816,"Elijah Millsap\millsel01","2014-15",27,"UTA","NBA",0.4,47,5,924,81,238,53,148,28,90,58,86,28,122,150,58,56,16,67,124,248,5.75
8817,"Nazr Mohammed\mohamna01","2002-03",25,"ATL","NBA",0.4,35,0,445,67,159,67,159,0,0,26,41,47,82,129,6,16,21,25,79,160,4.46
8818,"Darren Morningstar\mornida01","1993-94",24,"TOT","NBA",0.4,23,15,367,39,82,39,82,0,0,18,30,31,50,81,15,14,2,19,70,96,4.68
8819,"Hanno Möttölä\mottoha01","2000-01",24,"ATL","NBA",0.4,73,3,989,123,277,123,274,0,3,73,90,49,125,174,25,11,9,67,163,319,3.72
8820,"Timofey Mozgov\mozgoti01","2017-18",31,"BRK","NBA",0.4,31,13,359,52,93,48,75,4,18,23,30,32,66,98,11,5,13,33,39,131,4.67
8821,"Eric Murdock\murdoer01","1998-99",30,"NJN","NBA",0.4,15,8,401,45,114,37,92,8,22,21,26,3,32,35,66,22,2,29,35,119,9.25
8822,"Ronald Murray\murraro01","2007-08",28,"TOT","NBA",0.4,42,19,874,154,367,134,304,20,63,68,98,23,60,83,144,38,4,84,50,396,8.65
8823,"Maurice Ndour\ndourma01","2016-17",24,"NYK","NBA",0.4,32,4,331,39,86,38,79,1,7,19,26,22,42,64,8,15,8,12,30,98,3.2
8824,"David Noel\noelda01","2006-07",22,"MIL","NBA",0.4,68,0,792,65,177,48,124,17,53,37,43,42,81,123,65,25,9,40,77,184,3.08
8825,"Steve Novak\novakst01","2006-07",23,"HOU","NBA",0.4,35,1,191,18,50,5,11,13,39,2,2,4,22,26,6,5,0,4,21,51,1.22
8826,"Jusuf Nurkić\nurkiju01","2015-16",21,"DEN","NBA",0.4,32,3,547,101,242,101,239,0,3,61,99,65,110,175,40,24,44,55,91,263,8.49
8827,"Ed O'Bannon\obanned01","1996-97",24,"TOT","NBA",0.4,64,5,809,93,279,75,209,18,70,31,35,50,98,148,39,29,12,20,97,235,3.11
8828,"Kelly Oubre\oubreke01","2015-16",20,"WAS","NBA",0.4,63,9,671,90,211,65,132,25,79,31,49,25,108,133,13,22,7,34,100,236,3.27
8829,"Doug Overton\overtdo01","1999-00",30,"BOS","NBA",0.4,48,0,432,61,154,51,126,10,28,20,21,14,19,33,53,10,0,20,46,152,2.68
8830,"Andre Owens\owensan01","2007-08",27,"IND","NBA",0.4,31,7,392,40,107,22,67,18,40,25,34,13,34,47,47,13,3,24,37,123,4.11
8831,"Ray Owes\owesra01","1996-97",24,"GSW","NBA",0.4,57,1,592,75,180,74,175,1,5,26,46,64,99,163,15,15,20,23,86,177,3.12
8832,"Olumide Oyedeji\oyedeol01","2000-01",19,"SEA","NBA",0.4,30,1,221,18,37,18,37,0,0,9,12,24,43,67,2,7,10,11,40,45,2.24
8833,"Olumide Oyedeji\oyedeol01","2001-02",20,"SEA","NBA",0.4,36,1,221,22,41,22,41,0,0,11,18,27,52,79,4,4,2,14,36,55,2
8834,"Robert Pack\packro01","1999-00",30,"DAL","NBA",0.4,29,22,665,96,230,92,219,4,11,63,78,7,35,42,168,31,3,76,44,259,10.27
8835,"Scott Padgett\padgesc01","2000-01",24,"UTA","NBA",0.4,27,0,127,18,43,13,34,5,9,15,20,19,20,39,5,6,3,10,21,56,2.16
8836,"Georgios Papagiannis\papagge01","2016-17",19,"SAC","NBA",0.4,22,0,355,56,102,56,100,0,2,12,14,24,62,86,20,3,17,24,44,124,6.25
8837,"Anthony Parker\parkean01","1997-98",22,"PHI","NBA",0.4,37,0,196,25,63,16,35,9,28,13,20,8,18,26,19,11,3,11,17,72,1.94
8838,"Sasha Pavlović\pavloal01","2011-12",28,"BOS","NBA",0.4,45,7,527,50,128,33,70,17,58,3,8,4,68,72,18,20,15,20,54,120,2.67
8839,"Johan Petro\petrojo01","2007-08",22,"SEA","NBA",0.4,72,28,1310,184,439,184,438,0,1,64,87,98,272,370,32,35,42,73,173,432,5.89
8840,"Johan Petro\petrojo01","2012-13",27,"ATL","NBA",0.4,31,8,352,48,110,47,106,1,4,11,12,33,79,112,16,10,9,24,48,108,3.94
8841,"Johan Petro\petrojo01","2010-11",25,"NJN","NBA",0.4,77,1,893,129,290,129,286,0,4,15,28,62,150,212,44,34,34,46,178,273,3.76
8842,"Gary Plummer\plummga01","1992-93",30,"DEN","NBA",0.4,60,0,737,106,228,106,225,0,3,69,95,53,120,173,40,14,11,78,141,281,4.54
8843,"Quincy Pondexter\pondequ01","2013-14",25,"MEM","NBA",0.4,15,2,270,31,79,20,45,11,34,21,26,10,16,26,20,5,1,15,18,94,5.28
8844,"Ronnie Price\pricero01","2006-07",23,"SAC","NBA",0.4,58,1,563,67,172,46,107,21,65,37,55,15,56,71,48,28,4,33,64,192,3.17
8845,"Tayshaun Prince\princta01","2015-16",35,"MIN","NBA",0.4,77,44,1462,102,229,98,206,4,23,13,19,32,115,147,73,36,13,27,62,221,3.3
8846,"Laron Profit\profila01","2004-05",27,"WAS","NBA",0.4,42,4,428,56,128,48,100,8,28,16,25,24,52,76,37,16,5,27,44,136,3.36
8847,"Gabe Pruitt\pruitga01","2008-09",22,"BOS","NBA",0.4,47,0,366,31,101,17,53,14,48,17,21,9,34,43,39,15,3,19,34,93,2.01
8848,"Shavlik Randolph\randosh01","2006-07",23,"PHI","NBA",0.4,13,6,179,23,48,23,48,0,0,12,22,19,35,54,4,7,10,9,23,58,5.23
8849,"Justin Reed\reedju01","2005-06",24,"TOT","NBA",0.4,72,6,997,119,295,119,294,0,1,87,120,53,71,124,41,23,15,52,163,325,3.68
8850,"Cameron Reynolds\reynoca01","2018-19",23,"MIN","NBA",0.4,19,0,259,33,78,12,27,21,51,8,9,4,27,31,13,6,2,5,26,95,4.32
8851,"Chris Richard\richach01","2007-08",23,"MIN","NBA",0.4,52,3,556,41,87,41,87,0,0,16,27,52,83,135,18,10,12,24,83,98,2.58
8852,"Jason Richardson\richaja01","2014-15",34,"PHI","NBA",0.4,19,15,416,62,178,31,82,31,96,17,22,13,53,66,38,13,3,16,28,172,7.28
8853,"Eric Riley\rileyer01","1993-94",23,"HOU","NBA",0.4,47,2,219,34,70,34,69,0,1,20,37,24,35,59,9,5,9,15,30,88,1.85
8854,"Fred Roberts\roberfr01","1994-95",34,"CLE","NBA",0.4,21,0,223,28,72,24,61,4,11,20,26,13,21,34,8,6,3,7,26,80,3.13
8855,"Lou Roe\roelo01","1995-96",23,"DET","NBA",0.4,49,2,372,32,90,30,81,2,9,24,32,30,48,78,15,10,8,17,42,90,1.92
8856,"Roy Rogers\rogerro02","1999-00",26,"DEN","NBA",0.4,40,0,355,35,88,35,87,0,1,19,41,33,47,80,9,2,38,10,36,89,2.49
8857,"Sean Rooks\rooksse01","2002-03",33,"LAC","NBA",0.4,70,38,1344,125,297,125,296,0,1,47,58,53,163,216,69,34,44,66,174,297,4.77
8858,"Derrick Rose\rosede01","2015-16",27,"CHI","NBA",0.4,66,66,2097,447,1048,403,898,44,150,142,179,46,179,225,311,44,14,175,84,1080,13.21
8859,"Malik Rose\rosema01","1997-98",23,"SAS","NBA",0.4,53,0,429,59,136,58,133,1,3,39,61,40,50,90,19,21,7,44,79,158,2.88
8860,"Donald Royal\royaldo01","1997-98",31,"TOT","NBA",0.4,31,5,323,25,69,25,69,0,0,29,33,18,23,41,17,7,1,10,35,79,2.42
8861,"Brandon Rush\rushbr01","2016-17",31,"MIN","NBA",0.4,47,33,1030,70,187,26,73,44,114,13,18,16,83,99,45,22,23,28,42,197,4.28
8862,"D'Angelo Russell\russeda01","2017-18",21,"BRK","NBA",0.4,48,35,1234,278,672,188,394,90,278,97,131,30,159,189,249,36,17,147,93,743,13.92
8863,"John Salmons\salmojo01","2011-12",32,"SAC","NBA",0.4,46,32,1250,141,345,108,233,33,112,29,45,20,114,134,93,37,7,45,77,344,6.81
8864,"Jamal Sampson\sampsja01","2003-04",20,"LAL","NBA",0.4,10,2,130,11,23,11,23,0,0,7,12,23,29,52,7,2,4,6,16,29,4.58
8865,"Danny Schayes\schayda01","1995-96",36,"MIA","NBA",0.4,32,6,399,32,94,32,94,0,0,37,46,29,60,89,9,11,16,23,60,101,3.39
8866,"Steve Scheffler\schefst01","1995-96",28,"SEA","NBA",0.4,35,2,181,24,45,23,40,1,5,9,19,15,18,33,2,6,2,8,25,58,1.55
8867,"Steve Scheffler\schefst01","1994-95",27,"SEA","NBA",0.4,18,0,102,12,23,12,23,0,0,15,18,8,15,23,4,2,2,3,9,39,2.33
8868,"Shawnelle Scott\scottsh01","2001-02",29,"DEN","NBA",0.4,21,10,252,37,75,37,75,0,0,8,20,53,50,103,8,3,6,15,49,82,4.45
8869,"Henry Sims\simshe01","2015-16",25,"BRK","NBA",0.4,14,4,263,33,77,33,77,0,0,25,30,21,51,72,9,9,14,12,37,91,7.3
8870,"Brian Skinner\skinnbr01","2008-09",32,"LAC","NBA",0.4,51,21,843,92,205,92,203,0,2,30,47,72,131,203,27,17,52,43,94,214,4.98
8871,"Reggie Slater\slatere01","1994-95",24,"DEN","NBA",0.4,25,0,236,40,81,40,81,0,0,40,55,21,36,57,12,7,3,26,47,120,4.54
8872,"Reggie Smith\smithre01","1993-94",23,"POR","NBA",0.4,43,9,316,29,72,29,72,0,0,18,38,40,59,99,4,12,6,12,47,76,2.04
8873,"Tony Snell\snellto01","2015-16",24,"CHI","NBA",0.4,64,33,1301,126,339,70,184,56,155,30,33,19,180,199,63,16,17,52,100,338,4.71
8874,"Felton Spencer\spencfe01","2000-01",33,"NYK","NBA",0.4,18,0,113,12,20,12,20,0,0,15,25,16,19,35,2,2,2,11,24,39,2.48
8875,"Latrell Sprewell\sprewla01","1997-98",27,"GSW","NBA",0.4,14,13,547,110,277,101,229,9,48,70,94,7,44,51,68,19,5,44,26,299,16.43
8876,"Ryan Stack\stackry01","1998-99",23,"CLE","NBA",0.4,18,0,199,14,37,14,37,0,0,19,20,19,15,34,5,2,11,9,31,47,2.95
8877,"Jerry Stackhouse\stackje01","2012-13",38,"BRK","NBA",0.4,37,0,544,66,172,36,83,30,89,20,23,5,28,33,35,7,4,24,31,182,3.63
8878,"Julyan Stone\stoneju01","2011-12",23,"DEN","NBA",0.4,22,2,179,13,31,11,20,2,11,8,11,5,20,25,37,8,6,11,18,36,3.02
8879,"Bob Sura\surabo01","1998-99",25,"CLE","NBA",0.4,50,6,841,70,210,61,165,9,45,65,103,21,81,102,152,46,14,67,98,214,5.66
8880,"Mike Sweetney\sweetmi01","2006-07",24,"CHI","NBA",0.4,48,0,385,58,134,58,134,0,0,37,66,45,75,120,28,9,11,42,79,153,3.23
8881,"Brett Szabo\szabobr01","1996-97",28,"BOS","NBA",0.4,70,24,662,54,121,54,120,0,1,45,61,56,109,165,17,16,32,41,119,153,2.85
8882,"Sebastian Telfair\telfase01","2014-15",29,"OKC","NBA",0.4,16,1,327,46,125,28,65,18,60,24,34,2,28,30,45,10,0,18,29,134,7.15
8883,"Garrett Temple\templga01","2009-10",23,"TOT","NBA",0.4,27,4,334,44,101,31,64,13,37,35,50,6,25,31,21,13,6,27,42,136,4.49
8884,"Billy Thomas\thomabi01","2004-05",29,"NJN","NBA",0.4,25,0,356,34,94,17,38,17,56,7,9,7,29,36,17,14,1,9,29,92,3.2
8885,"John Thomas\thomajo02","1999-00",24,"TOR","NBA",0.4,55,6,477,49,107,49,106,0,1,16,41,37,38,75,9,12,14,14,106,114,1.94
8886,"John Thomas\thomajo02","1997-98",22,"TOT","NBA",0.4,54,2,535,55,113,55,113,0,0,41,54,48,58,106,17,22,12,46,97,151,3.21
8887,"Kenny Thomas\thomake01","2009-10",32,"SAC","NBA",0.4,26,2,313,17,35,17,35,0,0,7,12,35,51,86,15,10,10,17,42,41,3.2
8888,"Sedale Threatt\threase01","1996-97",35,"HOU","NBA",0.4,21,0,334,28,74,20,54,8,20,6,8,5,19,24,40,15,3,13,29,70,3.97
8889,"Gary Trent\trentga01","2000-01",26,"DAL","NBA",0.4,33,4,319,57,130,57,129,0,1,19,36,39,53,92,10,13,8,22,52,133,3.65
8890,"Ronny Turiaf\turiaro01","2005-06",23,"LAL","NBA",0.4,23,1,161,15,30,15,30,0,0,15,27,11,26,37,8,3,10,7,30,45,2.42
8891,"Beno Udrih\udrihbe01","2015-16",33,"TOT","NBA",0.4,44,5,707,86,198,71,154,15,44,18,20,8,64,72,116,14,1,53,51,205,5.11
8892,"David Vaughn\vaughda02","1997-98",24,"TOT","NBA",0.4,40,2,489,66,148,66,147,0,1,30,47,53,99,152,20,15,10,40,83,162,4.37
8893,"Jacque Vaughn\vaughja01","1999-00",24,"UTA","NBA",0.4,78,0,884,109,262,95,228,14,34,57,76,11,54,65,121,32,0,77,92,289,3.64
8894,"Charlie Villanueva\villach01","2011-12",27,"DET","NBA",0.4,13,0,180,35,91,20,46,15,45,6,7,9,39,48,6,7,5,7,25,91,5.75
8895,"Stojko Vranković\vrankst01","1997-98",34,"LAC","NBA",0.4,65,38,996,79,186,79,186,0,0,37,65,71,192,263,36,11,66,46,130,195,4.2
8896,"Von Wafer\wafervo01","2011-12",26,"ORL","NBA",0.4,33,1,469,71,157,57,118,14,39,38,54,6,39,45,29,10,3,35,26,194,4.74
8897,"Gerald Wallace\wallage01","2003-04",21,"SAC","NBA",0.4,37,1,337,32,89,32,87,0,2,11,24,35,39,74,19,14,14,8,37,75,2.35
8898,"Rex Walters\waltere01","1997-98",27,"TOT","NBA",0.4,38,0,235,24,53,18,31,6,22,26,28,5,19,24,35,8,1,27,28,80,2.49
8899,"Derrick Walton\waltode01","2017-18",22,"MIA","NBA",0.4,16,0,147,8,25,1,8,7,17,6,6,2,14,16,16,7,3,2,7,29,2.59
8900,"C.J. Watson\watsocj01","2007-08",23,"GSW","NBA",0.4,32,0,368,43,101,34,75,9,26,23,29,13,19,32,35,15,0,18,19,118,3.58
8901,"Earl Watson\watsoea01","2011-12",32,"UTA","NBA",0.4,50,2,1033,54,160,44,108,10,52,31,46,30,91,121,217,54,22,85,105,149,6.45
8902,"Briante Weber\weberbr01","2017-18",25,"TOT","NBA",0.4,18,0,237,19,43,15,32,4,11,8,10,8,27,35,22,18,5,15,28,50,4.31
8903,"Doug West\westdo01","1998-99",31,"VAN","NBA",0.4,14,2,294,31,65,31,63,0,2,19,25,5,20,25,19,16,7,12,38,81,6.41
8904,"Mario West\westma02","2008-09",24,"ATL","NBA",0.4,53,3,269,14,34,13,33,1,1,14,30,24,32,56,19,18,4,13,35,43,1.41
8905,"D.J. White\whitedj01","2008-09",22,"OKC","NBA",0.4,7,0,130,26,50,26,50,0,0,10,13,10,22,32,6,3,5,3,10,62,8.53
8906,"Shayne Whittington\whittsh01","2014-15",23,"IND","NBA",0.4,20,0,108,19,42,18,36,1,6,18,23,10,19,29,6,5,2,5,18,57,2.77
8907,"Damien Wilkins\wilkida02","2011-12",32,"DET","NBA",0.4,60,2,922,76,193,69,170,7,23,34,54,22,78,100,44,29,13,30,85,193,3.15
8908,"Aaron Williams\williaa01","2007-08",36,"LAC","NBA",0.4,30,5,297,27,55,27,55,0,0,14,18,15,46,61,9,12,15,13,44,68,3.06
8909,"Herb Williams\willihe01","1995-96",37,"TOT","NBA",0.4,44,2,571,62,152,61,148,1,4,13,20,15,75,90,27,14,33,22,79,138,3.31
8910,"Hot Rod Williams\williho01","1998-99",36,"DAL","NBA",0.4,25,11,403,11,33,11,33,0,0,7,10,36,47,83,15,13,18,13,49,29,3.14
8911,"Lorenzo Williams\willilo01","1996-97",27,"WSB","NBA",0.4,19,0,264,20,31,20,31,0,0,5,7,28,41,69,4,6,8,18,49,45,3.82
8912,"Lorenzo Williams\willilo01","1997-98",28,"WAS","NBA",0.4,14,6,111,13,17,13,17,0,0,0,2,16,10,26,3,2,3,2,17,26,2.51
8913,"Scott Williams\willisc01","2001-02",33,"DEN","NBA",0.4,41,16,737,86,217,86,215,0,2,30,41,82,127,209,13,17,33,35,98,202,5.19
8914,"Sean Williams\willise01","2011-12",25,"TOT","NBA",0.4,11,0,107,14,22,14,22,0,0,12,13,13,12,25,5,4,8,10,18,40,4.81
8915,"Troy Williams\willitr02","2018-19",24,"SAC","NBA",0.4,21,0,312,44,98,30,54,14,44,9,15,12,47,59,11,10,8,9,37,111,4.98
8916,"Troy Williams\willitr02","2016-17",22,"TOT","NBA",0.4,30,16,557,73,167,55,105,18,62,21,32,15,54,69,25,27,10,32,60,185,5.73
8917,"Dedric Willoughby\willode01","1999-00",25,"CHI","NBA",0.4,25,1,508,61,179,32,81,29,98,39,51,11,40,51,66,23,2,37,32,190,7.01
8918,"Kennard Winchester\winchke01","1992-93",26,"HOU","NBA",0.4,39,0,340,61,139,57,120,4,19,17,22,17,32,49,13,10,10,15,40,143,2.92
8919,"David Wingate\wingada01","1994-95",31,"CHH","NBA",0.4,52,9,515,50,122,46,100,4,22,18,24,11,49,60,56,19,6,27,60,122,2.7
8920,"Joe Wolf\wolfjo01","1992-93",28,"TOT","NBA",0.4,23,0,165,20,44,20,43,0,1,13,16,14,34,48,5,7,1,7,24,53,2.58
8921,"Loren Woods\woodslo01","2002-03",24,"MIN","NBA",0.4,38,11,353,29,76,28,73,1,3,21,27,27,68,95,19,10,13,23,37,80,2.8
8922,"Loren Woods\woodslo01","2005-06",27,"TOR","NBA",0.4,27,4,324,28,59,28,58,0,1,6,14,44,66,110,4,9,23,16,49,62,3.73
8923,"Nick Young\youngni01","2007-08",22,"WAS","NBA",0.4,75,2,1158,210,478,170,378,40,100,101,124,23,92,115,63,35,7,94,130,561,5.75
8924,"Alaa Abdelnaby\abdelal01","1994-95",26,"TOT","NBA",0.3,54,0,506,118,231,118,229,0,2,20,35,37,77,114,13,15,12,45,104,256,3.96
8925,"Mark Acres\acresma01","1992-93",30,"TOT","NBA",0.3,18,7,269,26,49,25,47,1,2,11,16,26,41,67,5,3,6,13,34,64,4.2
8926,"Malik Allen\allenma01","2008-09",30,"MIL","NBA",0.3,49,3,579,73,170,73,169,0,1,10,21,35,68,103,35,7,12,20,89,156,2.92
8927,"Rafer Alston\alstora01","2000-01",24,"MIL","NBA",0.3,37,2,288,30,84,22,54,8,30,9,13,4,27,31,68,13,0,20,27,77,2.75
8928,"Lou Amundson\amundlo01","2014-15",32,"TOT","NBA",0.3,53,35,937,109,255,109,254,0,1,41,87,94,174,268,70,22,52,62,126,259,6.04
8929,"Chris Andersen\anderch01","2001-02",23,"DEN","NBA",0.3,24,1,262,25,74,25,70,0,4,22,28,38,38,76,7,7,28,13,35,72,3.74
8930,"David Andersen\anderda03","2010-11",30,"TOT","NBA",0.3,40,0,373,56,121,48,98,8,23,14,22,20,64,84,13,5,9,22,40,134,3.06
8931,"Alan Anderson\anderal01","2015-16",33,"WAS","NBA",0.3,13,0,192,21,59,9,22,12,37,11,15,1,26,27,14,4,1,2,25,65,4.29
8932,"Alan Anderson\anderal01","2011-12",29,"TOR","NBA",0.3,17,12,461,55,142,31,81,24,61,29,34,8,26,34,26,5,3,25,35,163,7.21
8933,"Derek Anderson\anderde01","2007-08",33,"CHA","NBA",0.3,28,0,396,47,125,28,73,19,52,28,38,9,43,52,44,12,1,25,49,141,4.74
8934,"James Anderson\anderja01","2010-11",21,"SAS","NBA",0.3,26,2,286,31,81,13,35,18,46,14,18,2,21,23,18,3,6,13,24,94,2.97
8935,"Kyle Anderson\anderky01","2014-15",21,"SAS","NBA",0.3,33,8,358,31,89,28,78,3,11,9,14,5,67,72,28,15,7,10,28,74,2.74
8936,"Chris Anstey\anstech01","1998-99",24,"DAL","NBA",0.3,41,4,470,50,139,50,132,0,7,34,48,35,62,97,27,18,13,26,98,134,3.31
8937,"Carmelo Anthony\anthoca01","2018-19",34,"HOU","NBA",0.3,10,2,294,49,121,28,57,21,64,15,22,9,45,54,5,4,7,8,32,134,10.01
8938,"Rafael Araújo\araujra01","2004-05",24,"TOR","NBA",0.3,59,41,736,76,175,75,172,1,3,43,55,59,126,185,16,21,8,52,157,196,3.57
8939,"Ryan Arcidiacono\arcidry01","2017-18",23,"CHI","NBA",0.3,24,0,304,17,41,8,10,9,31,5,6,1,24,25,35,13,0,13,18,48,3.05
8940,"Darrell Armstrong\armstda01","2007-08",39,"NJN","NBA",0.3,50,2,549,40,110,17,41,23,69,20,30,17,50,67,73,28,2,41,53,123,3.31
8941,"Hilton Armstrong\armsthi01","2013-14",29,"GSW","NBA",0.3,15,1,97,9,19,9,19,0,0,7,16,19,28,47,5,4,4,6,11,25,2.72
8942,"Carlos Arroyo\arroyca01","2002-03",23,"UTA","NBA",0.3,44,0,287,50,109,47,102,3,7,18,22,11,15,26,53,12,1,30,28,121,2.8
8943,"Darrell Arthur\arthuda01","2009-10",21,"MEM","NBA",0.3,32,1,457,63,146,63,145,0,1,17,30,37,73,110,15,14,14,22,60,143,4.35
8944,"Keith Askins\askinke01","1993-94",26,"MIA","NBA",0.3,37,0,319,36,88,32,67,4,21,9,10,33,49,82,13,11,1,21,57,85,2.46
8945,"Chucky Atkins\atkinch01","2007-08",33,"DEN","NBA",0.3,24,0,352,42,122,17,43,25,79,4,9,3,28,31,47,9,1,10,27,113,4.06
8946,"Stacey Augmon\augmost01","2005-06",37,"ORL","NBA",0.3,36,3,385,25,73,25,73,0,0,21,30,18,35,53,23,12,6,11,40,71,2.22
8947,"James Augustine\augusja01","2007-08",23,"ORL","NBA",0.3,25,0,149,18,34,18,34,0,0,4,8,16,14,30,2,5,2,6,18,40,1.66
8948,"Isaac Austin\austiis01","1992-93",23,"UTA","NBA",0.3,46,3,306,50,112,50,111,0,1,29,44,38,41,79,6,8,14,23,60,129,2.57
8949,"Anthony Avent\aventan01","1992-93",23,"MIL","NBA",0.3,82,78,2285,347,802,347,800,0,2,112,172,180,332,512,91,57,73,140,237,806,8.98
8950,"Jeff Ayres\pendeje02","2011-12",24,"IND","NBA",0.3,20,1,106,15,36,15,36,0,0,4,7,12,21,33,4,3,2,2,16,34,1.7
8951,"Wade Baldwin\baldwwa01","2017-18",21,"POR","NBA",0.3,7,0,80,14,21,10,16,4,5,6,10,1,7,8,5,2,1,4,12,38,5.24
8952,"Renaldo Balkman\balkmre01","2011-12",27,"NYK","NBA",0.3,14,0,115,16,32,14,23,2,9,8,11,6,20,26,5,4,3,6,14,42,3.2
8953,"Drew Barry\barrydr01","1997-98",24,"ATL","NBA",0.3,27,0,256,18,38,9,17,9,21,11,13,5,30,35,49,10,1,30,28,56,3.51
8954,"Maceo Baston\bastoma01","2002-03",27,"TOR","NBA",0.3,16,0,106,15,25,15,25,0,0,10,12,4,19,23,0,4,11,6,16,40,3.04
8955,"Keita Bates-Diop\bateske01","2018-19",23,"MIN","NBA",0.3,30,3,503,60,142,47,90,13,52,18,28,16,67,83,17,18,14,14,29,151,4.82
8956,"Jerryd Bayless\bayleje01","2008-09",20,"POR","NBA",0.3,53,0,655,69,189,62,162,7,27,83,103,8,49,57,78,16,2,56,81,228,3.96
8957,"Malik Beasley\beaslma01","2017-18",21,"DEN","NBA",0.3,62,0,583,73,178,45,96,28,82,22,33,14,57,71,31,15,7,24,36,196,2.68
8958,"DeAndre' Bembry\bembrde01","2016-17",22,"ATL","NBA",0.3,38,1,371,47,98,46,80,1,18,6,16,14,45,59,28,8,5,16,21,101,2.68
8959,"Anthony Bennett\bennean01","2014-15",21,"MIN","NBA",0.3,57,3,894,125,297,118,274,7,23,41,64,52,164,216,48,27,16,36,87,298,5.07
8960,"Steve Blake\blakest01","2004-05",24,"WAS","NBA",0.3,44,1,648,61,186,25,93,36,93,33,41,18,53,71,69,13,0,39,47,191,3.9
8961,"Eric Bledsoe\bledser01","2010-11",21,"LAC","NBA",0.3,81,25,1841,206,486,174,370,32,116,99,133,68,155,223,289,92,26,194,130,543,8.31
8962,"Jaron Blossomgame\blossja01","2018-19",25,"CLE","NBA",0.3,27,4,439,47,106,37,67,10,39,10,13,26,72,98,13,7,8,11,20,114,4.38
8963,"Andrew Bogut\bogutan01","2018-19",34,"GSW","NBA",0.3,11,5,134,18,36,18,36,0,0,3,3,12,43,55,11,3,8,8,22,39,5.39
8964,"Calvin Booth\boothca01","2007-08",31,"PHI","NBA",0.3,31,0,204,9,27,9,27,0,0,6,10,6,32,38,8,6,18,4,35,24,1.5
8965,"Lazaro Borrell\borrela01","1999-00",27,"SEA","NBA",0.3,17,6,167,28,63,28,60,0,3,6,11,14,26,40,10,6,3,6,9,62,3.42
8966,"Earl Boykins\boykiea01","2000-01",24,"LAC","NBA",0.3,10,0,149,25,63,24,55,1,8,14,17,4,7,11,32,5,0,9,9,65,6.15
8967,"Avery Bradley\bradlav01","2018-19",28,"TOT","NBA",0.3,63,63,1905,248,608,162,363,86,245,43,50,43,132,175,152,41,16,89,167,625,8.32
8968,"Corey Brewer\breweco01","2008-09",22,"MIN","NBA",0.3,15,8,307,37,90,32,78,5,12,14,19,18,31,49,25,15,3,13,37,93,6.47
8969,"Primož Brezec\brezepr01","2001-02",22,"IND","NBA",0.3,22,4,160,14,29,14,29,0,0,15,25,16,12,28,6,0,7,6,28,43,2.03
8970,"Isaiah Briscoe\briscis01","2018-19",22,"ORL","NBA",0.3,39,0,559,55,138,44,104,11,34,15,26,5,69,74,87,11,2,31,66,136,4.1
8971,"Aaron Brooks\brookaa01","2016-17",32,"IND","NBA",0.3,65,0,894,121,300,73,172,48,128,32,40,18,51,69,125,25,9,66,93,322,4.67
8972,"Dee Brown\brownde01","1996-97",28,"BOS","NBA",0.3,21,2,522,61,166,41,101,20,65,18,22,8,40,48,67,31,7,24,45,160,8.03
8973,"Lorenzo Brown\brownlo01","2014-15",24,"MIN","NBA",0.3,29,7,549,52,122,46,94,6,28,12,19,14,56,70,90,28,6,30,49,122,6.13
8974,"Rick Brunson\brunsri01","2002-03",30,"CHI","NBA",0.3,17,0,196,23,50,19,44,4,6,10,12,4,15,19,36,10,3,17,20,60,4.61
8975,"Greg Buckner\buckngr01","2003-04",27,"PHI","NBA",0.3,53,3,703,66,175,54,131,12,44,20,27,28,75,103,45,21,4,34,77,164,3.05
8976,"Greg Buckner\buckngr01","2008-09",32,"MEM","NBA",0.3,63,0,878,61,159,48,108,13,51,20,25,32,98,130,57,29,8,38,108,155,3.06
8977,"Caron Butler\butleca01","2015-16",35,"SAC","NBA",0.3,17,1,176,25,59,22,41,3,18,10,12,5,17,22,10,9,1,3,19,63,3.32
8978,"Mitchell Butler\butlemi02","1994-95",24,"WSB","NBA",0.3,76,5,1554,214,508,168,367,46,141,123,185,43,127,170,91,61,10,106,155,597,6.6
8979,"Žarko Čabarkapa\cabarza01","2005-06",24,"GSW","NBA",0.3,61,0,505,67,174,62,154,5,20,60,84,37,74,111,20,13,7,35,87,199,2.8
8980,"Jason Caffey\caffeja01","2001-02",28,"MIL","NBA",0.3,23,0,283,36,72,36,71,0,1,27,43,24,26,50,12,4,5,19,39,99,4.02
8981,"José Calderón\caldejo01","2016-17",35,"TOT","NBA",0.3,41,13,539,55,134,35,70,20,64,11,12,15,59,74,88,11,1,41,36,141,4.19
8982,"Adrian Caldwell\caldwad01","1995-96",29,"IND","NBA",0.3,51,1,327,46,83,46,83,0,0,18,36,42,68,110,6,9,5,35,73,110,2.43
8983,"Derrick Caracter\caracde01","2010-11",22,"LAL","NBA",0.3,41,0,215,32,66,32,66,0,0,17,23,19,24,43,7,4,10,19,47,81,1.91
8984,"Rodney Carney\carnero01","2010-11",26,"TOT","NBA",0.3,27,1,336,46,110,29,72,17,38,18,27,13,35,48,11,12,5,16,33,127,3.97
8985,"Chris Carr\carrch01","1995-96",21,"PHO","NBA",0.3,60,10,590,90,217,79,175,11,42,49,60,27,75,102,43,10,5,40,77,240,3.4
8986,"Kelvin Cato\catoke01","2005-06",31,"TOT","NBA",0.3,27,0,333,36,84,36,84,0,0,26,35,20,50,70,4,6,12,18,52,98,3.53
8987,"Calbert Cheaney\cheanca01","2004-05",33,"GSW","NBA",0.3,55,5,951,113,265,113,262,0,3,24,37,32,92,124,64,17,15,35,95,250,4.12
8988,"Pete Chilcutt\chilcpe01","1998-99",30,"VAN","NBA",0.3,46,0,697,63,172,37,104,26,68,14,17,29,88,117,30,22,12,28,52,166,3.65
8989,"Dionte Christmas\chrisdi01","2013-14",27,"PHO","NBA",0.3,31,0,198,22,62,13,31,9,31,18,24,13,25,38,8,2,3,6,19,71,1.9
8990,"Earl Clark\clarkea01","2013-14",26,"TOT","NBA",0.3,54,17,768,97,261,56,139,41,122,22,34,22,121,143,18,17,25,31,67,257,3.94
8991,"Earl Clark\clarkea01","2011-12",24,"ORL","NBA",0.3,45,1,559,51,139,51,139,0,0,21,29,35,89,124,18,12,32,25,72,123,3.1
8992,"Earl Clark\clarkea01","2010-11",23,"TOT","NBA",0.3,42,0,464,68,158,68,153,0,5,27,47,37,64,101,9,8,18,28,45,163,3.31
8993,"Jason Collier\collija02","2002-03",25,"HOU","NBA",0.3,13,3,104,17,36,17,36,0,0,2,2,12,17,29,1,2,1,2,10,36,2.51
8994,"Lester Conner\connele01","1993-94",34,"IND","NBA",0.3,11,0,169,14,38,14,35,0,3,3,6,10,14,24,31,14,1,9,12,31,4.98
8995,"Jack Cooley\cooleja01","2017-18",26,"SAC","NBA",0.3,7,0,87,13,27,13,27,0,0,14,19,14,16,30,6,1,0,3,13,40,5.93
8996,"Chris Corchiani\corchch01","1992-93",24,"TOT","NBA",0.3,10,0,105,14,24,14,21,0,3,16,21,1,6,7,16,6,0,8,18,44,5.08
8997,"Austin Croshere\croshau01","1998-99",23,"IND","NBA",0.3,27,0,249,32,75,24,46,8,29,20,23,16,29,45,10,7,8,23,32,92,3.29
8998,"John Crotty\crottjo01","1992-93",23,"UTA","NBA",0.3,40,0,243,37,72,35,58,2,14,26,38,4,13,17,55,11,0,30,29,102,2.95
8999,"Radisav Ćurčić\curcira01","1992-93",27,"DAL","NBA",0.3,20,0,166,16,41,16,41,0,0,26,36,17,32,49,12,7,2,8,30,58,3.41
9000,"Michael Curry\currymi01","2003-04",35,"TOR","NBA",0.3,70,15,1229,76,196,73,181,3,15,49,58,22,65,87,53,23,5,48,153,204,2.74
9001,"Michael Curry\currymi01","2004-05",36,"IND","NBA",0.3,18,7,249,13,29,13,29,0,0,4,8,8,19,27,15,5,4,5,39,30,2.36
9002,"Samuel Dalembert\dalemsa01","2001-02",20,"PHI","NBA",0.3,34,0,177,22,50,22,50,0,0,7,18,25,43,68,5,6,13,14,30,51,1.95
9003,"Samuel Dalembert\dalemsa01","2014-15",33,"NYK","NBA",0.3,32,21,544,57,130,57,130,0,0,14,20,53,115,168,29,14,41,39,70,128,5.86
9004,"Erick Dampier\dampier01","2001-02",26,"GSW","NBA",0.3,73,46,1740,209,480,209,480,0,0,136,211,167,220,387,87,17,167,156,235,554,8.51
9005,"Troy Daniels\danietr01","2018-19",27,"PHO","NBA",0.3,51,1,760,113,275,39,81,74,194,18,23,13,60,73,26,26,5,27,79,318,4.82
9006,"Kornél Dávid\davidko01","1999-00",28,"TOT","NBA",0.3,32,5,474,67,157,67,154,0,3,45,56,26,55,81,17,17,3,33,56,179,4.84
9007,"Antonio Davis\davisan01","2005-06",37,"TOT","NBA",0.3,44,39,940,82,190,82,189,0,1,52,81,90,118,208,21,23,10,51,125,216,5.28
9008,"Emanual Davis\davisem01","1996-97",28,"HOU","NBA",0.3,13,0,230,24,54,12,27,12,27,5,8,2,20,22,26,9,2,17,20,65,5.62
9009,"Emanual Davis\davisem01","1997-98",29,"HOU","NBA",0.3,45,0,599,63,142,36,70,27,72,31,37,10,37,47,59,17,3,52,55,184,4.15
9010,"Josh Davis\davisjo02","2011-12",31,"MEM","NBA",0.3,15,0,130,10,27,6,14,4,13,4,8,16,11,27,6,7,1,3,19,28,2.28
9011,"Todd Day\dayto01","2000-01",31,"MIN","NBA",0.3,31,0,345,44,118,18,49,26,69,18,23,10,27,37,28,10,7,24,52,132,3.69
9012,"Bison Dele\delebi01","1992-93",23,"ORL","NBA",0.3,21,0,240,40,78,40,77,0,1,16,20,24,32,56,5,14,17,25,48,96,5.12
9013,"Michael Doleac\doleami01","2002-03",25,"NYK","NBA",0.3,75,0,1041,146,343,146,343,0,0,36,46,65,154,219,42,16,16,49,150,328,3.82
9014,"Michael Doleac\doleami01","2001-02",24,"CLE","NBA",0.3,42,15,705,78,187,78,187,0,0,38,46,47,121,168,25,15,11,37,98,194,4.73
9015,"Keyon Dooling\doolike01","2002-03",22,"LAC","NBA",0.3,55,1,969,128,329,78,190,50,139,44,57,9,63,72,89,24,6,60,93,350,5.18
9016,"Keyon Dooling\doolike01","2003-04",23,"LAC","NBA",0.3,58,24,1137,137,352,129,306,8,46,78,94,17,62,79,130,45,6,65,108,360,5.76
9017,"Chris Dudley\dudlech02","2001-02",36,"POR","NBA",0.3,43,2,327,20,50,20,48,0,2,8,15,27,53,80,13,3,14,14,42,48,1.68
9018,"Richard Dumas\dumasri02","1994-95",25,"PHO","NBA",0.3,15,1,167,37,73,37,72,0,1,8,16,18,11,29,7,10,2,9,22,82,4.69
9019,"Richard Dumas\dumasri02","1995-96",26,"PHI","NBA",0.3,39,14,739,95,203,93,194,2,9,49,70,42,57,99,44,42,6,49,79,241,6.28
9020,"Ronald Dupree\duprero01","2005-06",25,"MIN","NBA",0.3,36,0,265,33,63,33,62,0,1,14,41,21,28,49,14,12,0,14,44,80,2.21
9021,"Acie Earl\earlac01","1995-96",25,"TOR","NBA",0.3,42,7,655,117,276,117,273,0,3,82,114,51,78,129,27,18,37,49,73,316,6.46
9022,"Devin Ebanks\ebankde01","2011-12",22,"LAL","NBA",0.3,24,12,396,37,89,37,80,0,9,23,35,26,28,54,12,11,6,18,26,97,3.75
9023,"James Edwards\edwarja01","1993-94",38,"LAL","NBA",0.3,45,2,469,78,168,78,168,0,0,54,79,11,54,65,22,4,3,30,90,210,3.58
9024,"Craig Ehlo\ehlocr01","1996-97",35,"SEA","NBA",0.3,62,0,848,87,248,60,153,27,95,13,26,39,71,110,68,36,4,45,71,214,3.23
9025,"Howard Eisley\eisleho01","2005-06",33,"TOT","NBA",0.3,32,0,394,34,103,21,61,13,42,20,24,3,30,33,69,11,2,21,34,101,3.59
9026,"Wayne Ellington\ellinwa01","2010-11",23,"MIN","NBA",0.3,62,8,1181,160,397,112,276,48,121,42,53,26,82,108,72,28,3,53,85,410,5.09
9027,"Melvin Ely\elyme01","2007-08",29,"NOH","NBA",0.3,52,1,621,85,180,85,180,0,0,32,58,28,117,145,22,7,18,42,79,202,3.7
9028,"Drew Eubanks\eubandr01","2018-19",21,"SAS","NBA",0.3,23,0,113,15,26,15,26,0,0,11,13,6,28,34,7,2,5,8,11,41,2.26
9029,"Maurice Evans\evansma01","2011-12",33,"WAS","NBA",0.3,24,0,343,45,112,28,67,17,45,10,13,8,16,24,9,14,0,10,36,117,3.55
9030,"Tyreke Evans\evansty01","2018-19",29,"IND","NBA",0.3,69,18,1402,257,660,180,444,77,216,115,160,33,168,201,166,58,18,118,117,706,8.64
9031,"Daniel Ewing\ewingda01","2005-06",22,"LAC","NBA",0.3,66,5,971,97,255,75,177,22,78,36,46,23,62,85,84,37,6,57,86,252,3.67
9032,"Vítor Faverani\favervi01","2013-14",25,"BOS","NBA",0.3,37,8,488,64,147,52,107,12,40,24,37,42,86,128,16,14,27,41,74,164,4.78
9033,"Danny Ferry\ferryda01","2002-03",36,"SAS","NBA",0.3,64,1,601,44,124,23,64,21,60,10,13,20,55,75,21,7,9,27,55,119,1.67
9034,"Kyrylo Fesenko\fesenky01","2008-09",22,"UTA","NBA",0.3,21,1,156,21,36,21,36,0,0,7,21,14,23,37,4,7,15,9,35,49,2.94
9035,"Landry Fields\fieldla01","2014-15",26,"TOR","NBA",0.3,26,9,216,20,41,19,39,1,2,5,6,10,16,26,15,11,0,8,9,46,2.18
9036,"Adonal Foyle\foylead01","2008-09",33,"TOT","NBA",0.3,10,0,62,7,11,7,11,0,0,3,6,9,17,26,1,0,8,3,5,17,2.76
9037,"Jimmer Fredette\fredeji01","2011-12",22,"SAC","NBA",0.3,61,7,1135,172,446,94,230,78,216,40,48,17,56,73,108,30,3,67,73,462,5.78
9038,"Markelle Fultz\fultzma01","2018-19",20,"PHI","NBA",0.3,19,15,427,65,155,61,141,4,14,21,37,26,44,70,59,17,5,25,52,155,8.21
9039,"Reggie Geary\gearyre01","1996-97",23,"CLE","NBA",0.3,39,0,246,22,58,14,37,8,21,5,11,4,11,15,36,13,2,15,36,57,1.75
9040,"Reggie Geary\gearyre01","1997-98",24,"SAS","NBA",0.3,62,2,685,56,169,44,129,12,40,28,56,19,48,67,74,37,12,42,95,152,2.72
9041,"Devean George\georgde01","2004-05",27,"LAL","NBA",0.3,15,3,306,37,104,16,46,21,58,15,20,13,40,53,14,8,2,12,32,110,6.03
9042,"Eddie Gill\gilled01","2003-04",25,"POR","NBA",0.3,22,0,157,15,36,12,28,3,8,17,20,4,13,17,16,9,1,12,16,50,2.6
9043,"Dion Glover\glovedi01","1999-00",21,"ATL","NBA",0.3,30,1,446,66,171,54,126,12,45,51,70,15,23,38,27,15,4,28,28,195,4.87
9044,"Anthony Goldwire\goldwan01","1995-96",24,"CHH","NBA",0.3,42,8,621,76,189,43,106,33,83,46,60,8,35,43,112,16,0,63,79,231,5.6
9045,"Ben Gordon\gordobe01","2014-15",31,"ORL","NBA",0.3,56,0,790,129,295,94,198,35,97,56,67,6,57,63,50,14,1,55,60,349,4.73
9046,"Greg Graham\grahagr01","1996-97",26,"SEA","NBA",0.3,28,0,197,29,80,20,49,9,31,26,40,2,11,13,11,12,1,10,12,93,2.45
9047,"Greg Graham\grahagr01","1994-95",24,"PHI","NBA",0.3,50,7,775,95,223,89,195,6,28,55,73,19,43,62,66,29,6,48,76,251,4.6
9048,"Joey Graham\grahajo01","2007-08",25,"TOR","NBA",0.3,38,3,331,49,113,47,110,2,3,38,45,18,49,67,15,3,0,23,47,138,3.05
9049,"Devin Gray\grayde01","1999-00",27,"HOU","NBA",0.3,21,2,124,15,37,15,37,0,0,19,29,11,14,25,5,5,3,4,22,49,2.18
9050,"Jeff Grayer\grayeje01","1996-97",31,"SAC","NBA",0.3,25,0,316,38,83,34,72,4,11,11,20,21,17,38,25,8,7,15,42,91,3.6
9051,"Tom Gugliotta\guglito01","2003-04",34,"TOT","NBA",0.3,55,27,819,70,203,69,199,1,4,20,28,65,122,187,63,31,12,39,81,161,3.67
9052,"Jay Guidinger\guidija01","1992-93",23,"CLE","NBA",0.3,32,5,215,19,55,19,55,0,0,13,25,26,38,64,17,9,10,10,48,51,2.15
9053,"Jorge Gutiérrez\gutiejo01","2014-15",26,"TOT","NBA",0.3,20,1,175,22,41,22,38,0,3,9,13,5,20,25,22,6,0,12,25,53,3.14
9054,"Jorge Gutiérrez\gutiejo01","2015-16",27,"CHO","NBA",0.3,12,0,63,6,11,6,9,0,2,10,11,0,7,7,17,3,0,6,3,22,2.83
9055,"A.J. Guyton\guytoaj01","2000-01",22,"CHI","NBA",0.3,33,8,630,78,192,51,123,27,69,15,18,10,26,36,64,9,5,24,35,198,5.01
9056,"P.J. Hairston\hairspj02","2014-15",22,"CHO","NBA",0.3,45,2,687,87,269,38,106,49,163,31,36,22,70,92,21,21,13,22,61,254,4
9057,"Darvin Ham\hamda01","2004-05",31,"DET","NBA",0.3,47,0,275,17,37,17,37,0,0,12,31,19,16,35,5,6,7,8,39,46,1.01
9058,"Jordan Hamilton\hamiljo02","2011-12",21,"DEN","NBA",0.3,26,2,258,48,111,31,64,17,47,2,5,11,51,62,20,4,3,16,15,115,3.85
9059,"Ben Handlogten\handlbe01","2004-05",31,"UTA","NBA",0.3,21,5,297,43,83,43,82,0,1,9,17,23,42,65,13,7,5,18,55,95,4.6
9060,"Maurice Harkless\harklma01","2014-15",21,"ORL","NBA",0.3,45,4,674,63,158,53,102,10,56,22,41,38,68,106,25,32,9,27,66,158,3.63
9061,"Manny Harris\harrima01","2011-12",22,"CLE","NBA",0.3,26,5,456,60,150,48,114,12,36,41,59,11,59,70,31,13,6,27,28,173,5.83
9062,"Jason Hart\hartja01","2001-02",23,"SAS","NBA",0.3,10,0,92,10,19,10,17,0,2,6,6,4,9,13,12,7,1,8,16,26,3.8
9063,"Scott Haskin\haskisc01","1993-94",23,"IND","NBA",0.3,27,2,186,21,45,21,45,0,0,13,19,17,38,55,6,2,15,13,33,55,2.53
9064,"Lazar Hayward\haywala01","2010-11",24,"MIN","NBA",0.3,42,0,419,55,154,38,94,17,60,33,42,23,47,70,28,12,7,19,44,160,3.22
9065,"Mark Hendrickson\hendrma01","1996-97",22,"PHI","NBA",0.3,29,1,301,32,77,29,65,3,12,18,26,35,57,92,3,10,4,14,32,85,3.19
9066,"Xavier Henry\henryxa01","2013-14",22,"LAL","NBA",0.3,43,5,908,144,345,116,264,28,81,116,177,25,89,114,51,44,7,57,79,432,8.23
9067,"Sean Higgins\higgise01","1995-96",27,"PHI","NBA",0.3,44,4,916,134,323,86,194,48,129,35,37,20,72,92,55,24,11,49,90,351,6.47
9068,"Nenê Hilário\hilarne01","2007-08",25,"DEN","NBA",0.3,16,1,266,29,71,29,70,0,1,27,49,30,57,87,15,9,14,21,46,85,6.39
9069,"Grant Hill\hillgr01","2000-01",28,"ORL","NBA",0.3,4,4,133,19,43,18,42,1,1,16,26,8,17,25,25,5,2,11,9,55,15.6
9070,"Donald Hodge\hodgedo01","1994-95",25,"DAL","NBA",0.3,54,0,633,83,204,79,190,4,14,39,51,40,82,122,41,10,14,39,107,209,3.55
9071,"Jerald Honeycutt\honeyje01","1997-98",23,"MIL","NBA",0.3,38,0,530,90,221,61,144,29,77,36,58,27,66,93,33,20,6,49,83,245,5.32
9072,"Brian Howard\howarbr01","1992-93",25,"DAL","NBA",0.3,68,22,1295,183,414,182,407,1,7,72,94,66,146,212,67,55,34,68,217,439,6.24
9073,"R.J. Hunter\hunterj01","2015-16",22,"BOS","NBA",0.3,36,0,315,36,98,17,35,19,63,6,7,2,35,37,13,14,4,11,29,97,2.31
9074,"Didier Ilunga-Mbenga\mbengdj01","2008-09",28,"LAL","NBA",0.3,23,0,181,27,57,27,56,0,1,7,8,9,22,31,9,10,24,13,33,61,3.35
9075,"Royal Ivey\iveyro01","2006-07",25,"ATL","NBA",0.3,53,18,539,64,143,59,127,5,16,24,35,15,36,51,45,24,4,31,62,157,2.96
9076,"Stephen Jackson\jacksst02","2012-13",34,"SAS","NBA",0.3,55,6,1075,123,330,77,160,46,170,49,70,22,133,155,80,37,14,77,89,341,5.74
9077,"Henry James\jameshe01","1997-98",32,"CLE","NBA",0.3,28,0,166,24,59,13,34,11,25,21,22,2,13,15,5,1,1,12,24,80,2.11
9078,"Mike James\jamesmi01","2011-12",36,"CHI","NBA",0.3,11,0,120,20,49,14,39,6,10,7,8,2,8,10,29,4,2,14,20,53,5.09
9079,"Mike James\jamesmi01","2007-08",32,"TOT","NBA",0.3,54,1,720,101,290,70,193,31,97,39,48,14,55,69,60,21,2,36,56,272,3.66
9080,"Nathan Jawai\jawaina01","2009-10",23,"MIN","NBA",0.3,39,2,412,49,111,49,110,0,1,26,38,49,55,104,24,10,9,27,58,124,3.48
9081,"Jared Jeffries\jeffrja01","2002-03",21,"WAS","NBA",0.3,20,1,292,30,63,27,57,3,6,16,29,26,32,58,16,8,5,21,28,79,4.38
9082,"Anthony Johnson\johnsan02","1999-00",25,"TOT","NBA",0.3,56,6,637,62,164,60,153,2,11,28,39,21,30,51,72,33,4,32,58,154,2.97
9083,"Bobby Jones\jonesbo02","2006-07",23,"PHI","NBA",0.3,44,5,336,43,93,42,84,1,9,23,41,22,35,57,16,11,1,18,59,110,2.29
9084,"Jalen Jones\jonesja04","2018-19",25,"CLE","NBA",0.3,16,0,214,26,62,16,34,10,28,19,27,11,23,34,7,9,2,8,27,81,4.61
9085,"Popeye Jones\jonespo01","1997-98",27,"TOR","NBA",0.3,14,4,352,52,127,50,124,2,3,14,19,50,52,102,18,10,3,16,39,120,8.24
9086,"Solomon Jones\jonesso01","2011-12",27,"TOT","NBA",0.3,21,1,292,24,61,24,61,0,0,19,23,32,26,58,9,9,11,18,43,67,3.74
9087,"Tyus Jones\jonesty01","2015-16",19,"MIN","NBA",0.3,37,0,573,56,156,40,103,16,53,28,39,7,40,47,108,31,3,33,33,156,5.2
9088,"Reggie Jordan\jordare01","1998-99",31,"MIN","NBA",0.3,27,1,296,15,54,15,54,0,0,21,38,27,32,59,41,12,5,14,38,51,2.97
9089,"Sergey Karasev\karasse01","2015-16",22,"BRK","NBA",0.3,40,5,399,30,74,19,37,11,37,26,28,8,50,58,35,6,2,22,27,97,2.79
9090,"Mario Kasun\kasunma01","2005-06",25,"ORL","NBA",0.3,28,0,213,31,69,31,69,0,0,18,23,24,36,60,3,2,3,15,69,80,2.58
9091,"Viktor Khryapa\khryavi01","2004-05",22,"POR","NBA",0.3,32,5,523,54,124,50,113,4,11,23,42,28,80,108,25,20,18,33,80,135,4.86
9092,"Joe Kleine\kleinjo01","1998-99",37,"PHO","NBA",0.3,31,5,374,30,74,30,72,0,2,8,12,27,40,67,12,8,1,10,46,68,2.27
9093,"Brandon Knight\knighbr03","2016-17",25,"PHO","NBA",0.3,54,5,1140,209,525,164,386,45,139,132,154,25,93,118,130,27,5,88,87,595,8.72
9094,"Larry Krystkowiak\krystla01","1994-95",30,"CHI","NBA",0.3,19,14,287,28,72,28,72,0,0,27,30,19,40,59,26,9,2,25,34,83,4.99
9095,"Ognjen Kuzmić\kuzmiog01","2014-15",24,"GSW","NBA",0.3,16,0,72,8,12,8,12,0,0,4,4,7,10,17,6,2,1,5,13,20,1.78
9096,"Skal Labissière\labissk01","2018-19",22,"TOT","NBA",0.3,22,1,176,26,49,20,36,6,13,9,17,9,34,43,11,5,6,11,29,67,3.36
9097,"Trajan Langdon\langdtr01","1999-00",23,"CLE","NBA",0.3,10,0,145,15,40,7,21,8,19,11,11,4,11,15,11,5,0,6,16,49,4.57
9098,"Rusty LaRue\larueru01","2001-02",28,"UTA","NBA",0.3,33,0,542,73,185,56,135,17,50,30,35,11,38,49,71,17,7,43,58,193,5.51
9099,"Rusty LaRue\larueru01","1998-99",25,"CHI","NBA",0.3,43,6,732,78,217,48,128,30,89,17,17,9,47,56,63,33,3,34,66,203,4.28
9100,"Stéphane Lasme\lasmest01","2007-08",25,"TOT","NBA",0.3,16,4,303,32,71,32,71,0,0,19,32,26,27,53,3,13,22,15,35,83,5.79
9101,"Zach LaVine\lavinza01","2017-18",22,"CHI","NBA",0.3,24,24,656,136,355,94,232,42,123,87,107,9,85,94,72,24,4,43,55,401,13.07
9102,"Tim Legler\legleti01","1998-99",32,"WAS","NBA",0.3,30,0,377,51,115,37,80,14,35,3,6,8,32,40,21,4,3,14,42,119,3.15
9103,"Voshon Lenard\lenarvo01","1998-99",25,"MIA","NBA",0.3,12,2,190,31,79,19,44,12,35,8,11,4,12,16,10,3,1,7,18,82,4.58
9104,"Jim Les\lesji01","1993-94",30,"SAC","NBA",0.3,18,0,169,13,34,5,16,8,18,11,13,5,8,13,39,7,1,11,16,45,3.66
9105,"Quincy Lewis\lewisqu01","1999-00",22,"UTA","NBA",0.3,74,0,896,111,298,88,235,23,63,38,52,46,67,113,40,24,15,46,158,283,2.99
9106,"Quincy Lewis\lewisqu01","2000-01",23,"UTA","NBA",0.3,35,2,402,50,123,41,98,9,25,15,21,14,33,47,18,10,10,17,78,124,2.97
9107,"Rashard Lewis\lewisra02","2011-12",32,"WAS","NBA",0.3,28,15,729,85,221,69,154,16,67,31,37,34,75,109,27,23,10,32,49,217,6.66
9108,"Alton Lister\listeal01","1996-97",38,"BOS","NBA",0.3,53,2,516,32,77,32,77,0,0,23,31,66,102,168,13,8,14,30,95,87,2.58
9109,"Randy Livingston\livinra01","1996-97",21,"HOU","NBA",0.3,64,0,981,100,229,91,207,9,22,42,65,32,62,94,155,39,12,102,107,251,4.92
9110,"Brook Lopez\lopezbr01","2011-12",23,"NJN","NBA",0.3,5,5,136,38,77,38,77,0,0,20,32,8,10,18,6,1,4,6,8,96,13.54
9111,"Felipe López\lopezfe01","2001-02",27,"MIN","NBA",0.3,67,0,581,59,156,45,123,14,33,37,55,29,51,80,39,18,1,36,73,169,2.3
9112,"John Lucas III\lucasjo02","2014-15",32,"DET","NBA",0.3,21,0,272,42,104,33,75,9,29,5,5,4,12,16,60,8,0,16,18,98,4.69
9113,"Tyronn Lue\luety01","1999-00",22,"LAL","NBA",0.3,8,0,146,19,39,15,31,4,8,6,8,2,10,12,17,3,0,9,17,48,5.9
9114,"Sam Mack\macksa01","1992-93",22,"SAS","NBA",0.3,40,0,267,47,118,44,96,3,22,45,58,18,30,48,15,14,5,22,44,142,3.01
9115,"Gerald Madkins\madkige01","1997-98",28,"GSW","NBA",0.3,19,0,243,13,34,7,19,6,15,5,7,2,13,15,45,13,1,13,18,37,3.62
9116,"Jamaal Magloire\magloja01","2004-05",26,"NOH","NBA",0.3,23,22,703,98,227,98,227,0,0,74,123,79,126,205,29,8,23,59,74,270,11.18
9117,"Rick Mahorn\mahorri01","1996-97",38,"DET","NBA",0.3,22,7,218,20,54,20,53,0,1,16,22,19,34,53,6,4,3,10,34,56,2.51
9118,"Moses Malone\malonmo01","1994-95",39,"SAS","NBA",0.3,17,0,149,13,35,12,33,1,2,22,32,20,26,46,6,2,3,11,15,49,3.08
9119,"Sean Marks\marksse01","2001-02",26,"MIA","NBA",0.3,21,6,319,38,88,38,88,0,0,20,34,19,56,75,8,5,10,19,40,96,4.36
9120,"Sean Marks\marksse01","2007-08",32,"PHO","NBA",0.3,19,0,130,23,43,22,39,1,4,12,19,9,27,36,4,3,10,8,23,59,3.29
9121,"Donyell Marshall\marshdo01","1994-95",21,"TOT","NBA",0.3,72,31,2086,345,876,276,633,69,243,147,222,137,268,405,105,45,88,115,157,906,10.32
9122,"Donyell Marshall\marshdo01","2007-08",34,"TOT","NBA",0.3,26,1,340,32,98,17,45,15,53,19,22,24,52,76,10,6,16,15,31,98,3.68
9123,"Bob Martin\martibo01","1993-94",24,"LAC","NBA",0.3,53,1,535,40,88,40,88,0,0,31,51,36,81,117,17,8,33,29,106,111,2.78
9124,"Frank Mason\masonfr01","2018-19",24,"SAC","NBA",0.3,38,0,435,71,169,57,105,14,64,39,57,6,37,43,84,16,4,36,34,195,5.07
9125,"Roger Mason\masonro01","2013-14",33,"MIA","NBA",0.3,25,2,260,25,67,8,19,17,48,7,7,1,21,22,19,6,1,9,26,74,2.64
9126,"Jason Maxiell\maxieja01","2013-14",30,"ORL","NBA",0.3,34,13,488,47,105,47,105,0,0,15,31,28,58,86,9,8,20,14,47,109,3.25
9127,"Sean May\mayse01","2009-10",25,"SAC","NBA",0.3,37,4,331,51,111,51,107,0,4,21,32,20,50,70,17,12,7,19,46,123,3.19
9128,"Travis Mays\maystr01","1992-93",24,"ATL","NBA",0.3,49,9,787,129,309,100,225,29,84,54,82,20,33,53,72,21,3,51,59,341,5.3
9129,"Ray McCallum\mccalra01","2015-16",24,"TOT","NBA",0.3,41,6,475,55,146,40,104,15,42,12,15,8,39,47,60,12,7,24,29,137,3.25
9130,"Chris McCullough\mcculch01","2015-16",20,"BRK","NBA",0.3,24,4,362,44,109,31,75,13,34,11,23,25,43,68,9,28,12,15,39,112,4.93
9131,"Tracy McGrady\mcgratr01","2009-10",30,"TOT","NBA",0.3,30,24,673,91,235,75,171,16,64,47,63,22,72,94,99,15,14,44,40,245,8.07
9132,"Dominic McGuire\mcguido01","2012-13",27,"TOT","NBA",0.3,26,10,387,24,56,24,56,0,0,3,10,19,59,78,20,13,11,12,39,51,3.25
9133,"Jim McIlvaine\mcilvji01","1998-99",26,"NJN","NBA",0.3,22,1,269,22,51,22,51,0,0,4,6,31,23,54,2,9,32,13,59,48,3.4
9134,"Jeff McInnis\mcinnje01","1999-00",25,"LAC","NBA",0.3,25,10,597,80,186,73,165,7,21,13,17,18,54,72,89,15,2,27,55,180,7.51
9135,"Jeff McInnis\mcinnje01","2005-06",31,"NJN","NBA",0.3,28,1,486,63,143,60,127,3,16,20,29,11,39,50,52,11,2,29,37,149,4.98
9136,"Ben McLemore\mclembe01","2015-16",22,"SAC","NBA",0.3,68,53,1443,195,455,128,270,67,185,74,103,34,114,148,79,52,10,99,140,531,6.65
9137,"Keith McLeod\mcleoke01","2004-05",25,"UTA","NBA",0.3,53,47,1382,143,408,125,336,18,72,112,146,20,93,113,236,63,12,99,138,416,8.6
9138,"Roshown McLeod\mcleoro01","1998-99",23,"ATL","NBA",0.3,34,0,348,62,163,61,153,1,10,37,45,12,38,50,14,2,1,23,24,162,3
9139,"Josh McRoberts\mcrobjo01","2016-17",29,"MIA","NBA",0.3,22,14,381,44,118,31,87,13,31,6,9,23,51,74,50,10,4,23,31,107,5.37
9140,"Jodie Meeks\meeksjo01","2018-19",31,"TOR","NBA",0.3,8,0,104,21,39,13,21,8,18,1,1,1,11,12,8,1,1,2,5,51,5.53
9141,"Pops Mensah-Bonsu\mensapo01","2008-09",25,"TOT","NBA",0.3,22,0,283,39,103,39,101,0,2,33,48,55,58,113,6,9,5,19,43,111,5.02
9142,"Jordan Mickey\mickejo01","2017-18",23,"MIA","NBA",0.3,23,3,284,39,82,37,66,2,16,13,19,18,63,81,9,6,10,18,36,93,4.37
9143,"C.J. Miles\milescj01","2005-06",18,"UTA","NBA",0.3,23,0,203,28,76,23,56,5,20,18,24,18,20,38,16,7,2,9,20,79,3.02
9144,"Marko Milič\milicma01","1997-98",20,"PHO","NBA",0.3,33,0,163,39,64,36,58,3,6,11,17,10,15,25,12,10,0,21,17,92,2.69
9145,"Mike Miller\millemi01","2015-16",35,"DEN","NBA",0.3,47,2,373,22,62,3,10,19,52,0,0,6,47,53,40,13,4,17,53,63,1.99
9146,"Chris Mills\millsch01","2002-03",33,"GSW","NBA",0.3,21,0,262,39,106,32,81,7,25,16,18,19,31,50,22,7,3,10,29,101,4.1
9147,"Shake Milton\miltosh01","2018-19",22,"PHI","NBA",0.3,20,0,268,34,87,20,43,14,44,5,7,9,26,35,18,8,8,6,29,87,3.95
9148,"Yao Ming\mingya01","2010-11",30,"HOU","NBA",0.3,5,5,91,18,37,18,37,0,0,15,16,7,20,27,4,0,8,7,13,51,10.22
9149,"Malik Monk\monkma01","2018-19",20,"CHO","NBA",0.3,73,0,1258,227,586,118,256,109,330,90,102,16,121,137,117,37,19,86,106,653,7.07
9150,"Tracy Moore\mooretr01","1995-96",30,"HOU","NBA",0.3,8,2,190,30,76,17,46,13,30,18,19,10,12,22,6,2,0,8,16,91,8.05
9151,"Tracy Moore\mooretr01","1996-97",31,"HOU","NBA",0.3,27,1,237,33,85,22,42,11,43,22,31,11,15,26,20,5,0,14,19,99,2.91
9152,"Randolph Morris\morrira01","2009-10",24,"ATL","NBA",0.3,28,0,124,23,41,23,41,0,0,16,27,10,28,38,2,5,3,12,34,62,2.21
9153,"Donatas Motiejūnas\motiedo01","2015-16",25,"HOU","NBA",0.3,37,22,547,90,205,74,148,16,57,34,53,37,72,109,41,17,5,44,69,230,5.61
9154,"Johnathan Motley\motlejo01","2018-19",23,"LAC","NBA",0.3,22,0,156,39,73,39,70,0,3,24,40,18,33,51,11,5,3,16,27,102,4.33
9155,"Johnathan Motley\motlejo01","2017-18",22,"DAL","NBA",0.3,11,4,176,40,75,39,69,1,6,15,28,14,35,49,7,3,2,9,18,96,7.56
9156,"Shabazz Muhammad\muhamsh01","2013-14",21,"MIN","NBA",0.3,37,0,290,57,124,54,113,3,11,26,40,24,29,53,6,8,1,16,24,143,2.91
9157,"Chris Mullin\mullich01","2000-01",37,"GSW","NBA",0.3,20,8,374,36,106,17,54,19,52,24,28,10,31,41,19,16,10,19,28,115,5.32
9158,"Eric Murdock\murdoer01","1996-97",28,"DEN","NBA",0.3,12,0,114,15,33,11,23,4,10,11,12,1,10,11,24,9,2,11,9,45,4.92
9159,"Gheorghe Mureșan\muresgh01","1999-00",28,"NJN","NBA",0.3,30,2,267,41,90,41,90,0,0,23,38,24,44,68,9,0,12,16,52,105,3.14
9160,"Troy Murphy\murphtr01","2010-11",30,"TOT","NBA",0.3,35,4,466,42,114,37,81,5,33,20,30,22,91,113,23,15,3,20,47,109,3.44
9161,"Troy Murphy\murphtr01","2012-13",32,"DAL","NBA",0.3,14,1,256,22,61,11,26,11,35,10,11,7,42,49,7,10,6,7,29,65,4.96
9162,"Lamond Murray\murrala01","1998-99",25,"LAC","NBA",0.3,50,13,1317,226,578,192,475,34,103,126,157,59,136,195,61,58,20,99,107,612,9.56
9163,"Tracy Murray\murratr01","1998-99",27,"WAS","NBA",0.3,36,0,653,83,237,50,134,33,103,34,42,18,63,81,27,21,6,29,65,233,4.82
9164,"Mamadou N'Diaye\ndiayma02","2001-02",26,"TOR","NBA",0.3,5,0,46,6,10,6,10,0,0,8,10,6,5,11,0,0,2,1,6,20,4.08
9165,"Lee Nailon\nailole01","2002-03",27,"NYK","NBA",0.3,38,0,405,84,190,84,189,0,1,42,51,32,38,70,26,6,3,32,46,210,4.24
9166,"Tyrone Nesby\nesbyty01","2000-01",25,"TOT","NBA",0.3,62,34,1556,189,530,140,350,49,180,85,106,51,122,173,76,51,20,65,155,512,6.38
9167,"Moochie Norris\norrimo01","2005-06",32,"TOT","NBA",0.3,45,0,424,46,112,42,98,4,14,29,42,12,42,54,50,20,1,33,49,125,3.05
9168,"Steve Novak\novakst01","2014-15",31,"TOT","NBA",0.3,35,0,197,22,56,3,8,19,48,0,2,2,20,22,11,0,2,5,23,63,1.42
9169,"Steve Novak\novakst01","2009-10",26,"LAC","NBA",0.3,54,0,362,42,108,20,37,22,71,7,9,1,32,33,6,7,2,2,21,113,1.47
9170,"Dirk Nowitzki\nowitdi01","2018-19",40,"DAL","NBA",0.3,51,20,795,135,376,71,171,64,205,39,50,5,153,158,35,9,18,18,76,373,5.27
9171,"Charles O'Bannon\obannch01","1998-99",23,"DET","NBA",0.3,18,1,165,24,56,24,55,0,1,8,8,18,16,34,12,2,3,8,22,56,2.92
9172,"Johnny O'Bryant\obryajo01","2015-16",22,"MIL","NBA",0.3,66,4,857,86,209,85,208,1,1,27,40,65,111,176,32,18,8,31,100,200,3.02
9173,"Johnny O'Bryant\obryajo01","2017-18",24,"CHO","NBA",0.3,36,0,379,68,171,54,128,14,43,21,25,29,64,93,14,9,6,15,45,171,3.81
9174,"Patrick O'Bryant\obryapa01","2008-09",22,"TOT","NBA",0.3,39,3,255,45,84,45,82,0,2,11,20,13,53,66,11,6,19,22,61,101,2.82
9175,"Lamar Odom\odomla01","2011-12",32,"DAL","NBA",0.3,50,4,1027,123,349,95,238,28,111,58,98,36,172,208,83,20,18,52,97,332,5.9
9176,"Kevin Ollie\ollieke01","2009-10",37,"OKC","NBA",0.3,25,0,263,18,45,18,44,0,1,8,8,3,22,25,20,9,0,6,16,44,2.11
9177,"Michael Olowokandi\olowomi01","2005-06",30,"TOT","NBA",0.3,48,24,919,107,240,107,240,0,0,24,47,50,170,220,23,22,33,55,122,238,5.27
9178,"Arinze Onuaku\onuakar01","2014-15",27,"MIN","NBA",0.3,6,1,68,12,14,12,14,0,0,3,8,7,14,21,4,1,3,2,6,27,5.72
9179,"Daniel Orton\ortonda01","2012-13",22,"OKC","NBA",0.3,13,0,104,12,26,12,26,0,0,9,17,13,13,26,4,4,3,4,13,33,2.75
9180,"Daniel Orton\ortonda01","2013-14",23,"PHI","NBA",0.3,22,4,251,21,47,21,47,0,0,23,30,16,45,61,15,6,16,18,38,65,4.08
9181,"Travis Outlaw\outlatr01","2012-13",28,"SAC","NBA",0.3,38,2,444,74,177,60,127,14,50,38,52,17,44,61,21,11,8,19,35,200,4.1
9182,"Olumide Oyedeji\oyedeol01","2002-03",21,"ORL","NBA",0.3,27,3,145,10,23,10,23,0,0,7,11,10,40,50,5,5,3,5,30,27,1.63
9183,"Zaza Pachulia\pachuza01","2003-04",19,"ORL","NBA",0.3,59,2,664,68,175,68,175,0,0,58,90,69,105,174,13,21,12,34,87,194,3.29
9184,"Sasha Pavlović\pavloal01","2010-11",27,"TOT","NBA",0.3,31,7,362,29,72,17,41,12,31,6,10,1,31,32,16,10,7,12,34,76,2.4
9185,"Will Perdue\perduwi01","2000-01",35,"POR","NBA",0.3,13,0,58,6,9,6,9,0,0,2,4,6,12,18,2,3,2,0,8,14,1.72
9186,"Elliot Perry\perryel01","1993-94",24,"PHO","NBA",0.3,27,9,432,42,113,42,110,0,3,21,28,12,27,39,125,25,1,43,36,105,6.25
9187,"Tim Perry\perryti01","1995-96",30,"TOT","NBA",0.3,30,1,254,31,65,27,57,4,8,5,9,21,27,48,8,4,13,10,16,71,2.47
9188,"Alec Peters\peteral01","2017-18",22,"PHO","NBA",0.3,20,0,225,28,74,10,16,18,58,8,10,8,29,37,12,2,2,4,13,82,3.36
9189,"Ricky Pierce\piercri01","1997-98",38,"MIL","NBA",0.3,39,0,442,52,143,48,130,4,13,43,52,19,26,45,34,9,0,21,35,151,3.05
9190,"Ed Pinckney\pincked01","1992-93",29,"BOS","NBA",0.3,7,5,151,10,24,10,24,0,0,12,13,14,29,43,1,4,7,8,13,32,6.51
9191,"Scottie Pippen\pippesc01","2003-04",38,"CHI","NBA",0.3,23,6,412,53,140,40,92,13,48,17,27,20,48,68,50,21,9,29,38,136,6.29
9192,"Josh Powell\poweljo01","2006-07",24,"TOT","NBA",0.3,37,0,353,43,93,43,93,0,0,30,42,24,64,88,21,5,12,29,61,116,3.42
9193,"Alex Poythress\poythal01","2016-17",23,"PHI","NBA",0.3,6,1,157,25,54,19,35,6,19,8,10,11,18,29,5,3,2,3,14,64,9.15
9194,"A.J. Price\priceaj01","2014-15",28,"TOT","NBA",0.3,26,0,324,51,137,36,80,15,57,16,24,6,26,32,46,7,0,14,15,133,4.09
9195,"A.J. Price\priceaj01","2010-11",24,"IND","NBA",0.3,50,0,795,114,320,73,171,41,149,54,81,16,56,72,111,29,1,53,61,323,5.4
9196,"Laron Profit\profila01","2005-06",28,"LAL","NBA",0.3,25,1,279,40,84,37,66,3,18,21,24,8,35,43,15,11,5,24,25,104,4.09
9197,"Laron Profit\profila01","2000-01",23,"WAS","NBA",0.3,35,12,605,56,142,49,116,7,26,33,45,18,46,64,89,36,11,46,43,152,5.77
9198,"Joel Przybilla\przybjo01","2006-07",27,"POR","NBA",0.3,43,43,701,37,78,37,78,0,0,10,27,59,109,168,12,10,67,40,124,84,3.95
9199,"Joel Przybilla\przybjo01","2011-12",32,"POR","NBA",0.3,27,19,449,22,48,22,48,0,0,11,18,29,109,138,6,4,16,22,66,55,3.78
9200,"Kurt Rambis\rambiku01","1994-95",36,"LAL","NBA",0.3,26,1,195,18,35,18,35,0,0,8,12,10,24,34,16,3,9,8,35,44,2.28
9201,"Mark Randall\randama01","1992-93",25,"TOT","NBA",0.3,37,0,248,40,80,39,72,1,8,16,26,27,28,55,11,4,2,17,33,97,2.38
9202,"Justin Reed\reedju01","2004-05",23,"BOS","NBA",0.3,23,0,121,15,29,15,26,0,3,11,15,8,8,16,10,3,1,5,12,41,1.83
9203,"Chris Richard\richach01","2009-10",25,"CHI","NBA",0.3,18,0,224,15,29,15,29,0,0,7,11,19,40,59,7,8,4,14,50,37,3.36
9204,"Quentin Richardson\richaqu01","2007-08",27,"NYK","NBA",0.3,65,65,1841,199,555,130,341,69,214,60,88,56,259,315,116,44,15,69,153,527,7.21
9205,"Eric Riley\rileyer01","1997-98",27,"DAL","NBA",0.3,39,14,544,56,135,56,134,0,1,27,36,43,90,133,22,15,46,37,80,139,4.59
9206,"Bernard Robinson\robinbe01","2004-05",24,"CHA","NBA",0.3,31,1,328,36,81,33,73,3,8,18,26,14,34,48,30,11,4,20,42,93,3.27
9207,"Clifford Robinson\robincl02","2006-07",40,"NJN","NBA",0.3,50,1,955,81,218,56,152,25,66,16,36,31,91,122,51,12,23,30,98,203,3.75
9208,"Devin Robinson\robinde01","2018-19",23,"WAS","NBA",0.3,7,0,95,19,32,19,30,0,2,9,14,6,14,20,6,4,6,2,11,47,7.23
9209,"Nate Robinson\robinna01","2014-15",30,"TOT","NBA",0.3,42,1,591,88,255,57,143,31,112,31,46,17,33,50,97,20,3,30,76,238,4.73
9210,"Rodney Rogers\rogerro01","2004-05",33,"TOT","NBA",0.3,58,33,1367,172,450,124,282,48,168,52,70,61,185,246,86,41,20,86,172,444,6.97
9211,"Sean Rooks\rooksse01","1998-99",29,"LAL","NBA",0.3,36,0,315,32,79,32,77,0,2,34,48,33,39,72,9,2,9,21,61,98,2.59
9212,"Terrence Ross\rosste01","2017-18",26,"ORL","NBA",0.3,24,20,600,76,191,46,98,30,93,27,36,10,63,73,38,27,11,29,45,209,8.03
9213,"Robert Sacre\sacrero01","2015-16",26,"LAL","NBA",0.3,25,1,320,31,75,31,75,0,0,25,38,32,40,72,14,4,10,12,43,87,3.65
9214,"Pepe Sánchez\sanchpe01","2000-01",23,"TOT","NBA",0.3,29,0,150,9,28,9,27,0,1,2,2,3,12,15,41,11,1,6,21,20,1.74
9215,"Brian Scalabrine\scalabr01","2011-12",33,"CHI","NBA",0.3,28,0,122,14,30,13,23,1,7,3,6,8,13,21,15,5,6,9,9,32,1.55
9216,"Brian Scalabrine\scalabr01","2005-06",27,"BOS","NBA",0.3,71,1,938,74,193,43,106,31,87,26,36,27,87,114,51,21,19,50,127,205,2.97
9217,"Luke Schenscher\schenlu01","2005-06",23,"CHI","NBA",0.3,20,0,149,16,26,16,26,0,0,4,13,8,21,29,7,1,3,5,21,36,2.01
9218,"Dwayne Schintzius\schindw01","1995-96",27,"IND","NBA",0.3,33,8,297,49,110,49,110,0,0,13,21,23,55,78,14,9,12,19,53,111,3.3
9219,"Wayne Selden\seldewa01","2017-18",23,"MEM","NBA",0.3,35,9,692,116,269,67,147,49,122,44,59,16,40,56,66,18,5,54,59,325,7.63
9220,"Ramon Sessions\sessira01","2017-18",31,"TOT","NBA",0.3,28,3,392,42,117,34,91,8,26,44,57,6,32,38,77,14,2,30,29,136,5.36
9221,"Jeff Sheppard\sheppje01","1998-99",24,"ATL","NBA",0.3,18,5,185,15,39,13,32,2,7,8,13,6,16,22,16,3,0,7,12,40,2.21
9222,"Bobby Simmons\simmobo01","2011-12",31,"LAC","NBA",0.3,28,0,418,28,90,8,30,20,60,4,7,17,38,55,11,15,3,10,41,80,2.64
9223,"Cedric Simmons\simmoce01","2006-07",21,"NOK","NBA",0.3,43,4,534,55,132,55,132,0,0,16,33,44,63,107,12,8,23,22,75,126,2.89
9224,"Jonathon Simmons\simmojo02","2018-19",29,"TOT","NBA",0.3,56,9,1064,133,350,105,246,28,104,72,97,27,99,126,128,29,15,68,89,366,6.14
9225,"Lionel Simmons\simmoli01","1996-97",28,"SAC","NBA",0.3,41,0,521,45,136,38,106,7,30,42,48,30,74,104,57,8,13,34,63,139,3.85
9226,"Kyle Singler\singlky01","2016-17",28,"OKC","NBA",0.3,32,2,385,34,83,27,46,7,37,13,17,8,40,48,9,7,5,11,29,88,2.43
9227,"Brian Skinner\skinnbr01","2000-01",24,"LAC","NBA",0.3,39,23,584,64,161,64,161,0,0,32,59,55,113,168,18,14,11,32,61,160,4.19
9228,"Donald Sloan\sloando01","2013-14",26,"IND","NBA",0.3,48,1,392,44,117,34,75,10,42,12,20,4,40,44,50,10,1,22,19,110,2.2
9229,"Charles Smith\smithch04","2005-06",30,"TOT","NBA",0.3,22,4,210,30,72,15,34,15,38,5,8,3,13,16,9,5,6,4,28,80,2.83
9230,"Donta Smith\smithdo04","2005-06",22,"ATL","NBA",0.3,23,0,127,15,27,13,23,2,4,6,12,3,11,14,9,8,0,4,20,38,1.85
9231,"Ish Smith\smithis01","2011-12",23,"TOT","NBA",0.3,26,1,234,31,81,28,72,3,9,7,10,7,28,35,41,15,2,13,15,72,3.29
9232,"Michael Smith\smithmi01","1994-95",29,"LAC","NBA",0.3,29,0,319,63,134,62,126,1,8,26,30,13,43,56,20,6,2,18,41,153,4.37
9233,"Felton Spencer\spencfe01","1998-99",31,"GSW","NBA",0.3,26,0,159,15,33,15,33,0,0,12,26,18,28,46,0,5,10,9,41,42,1.91
9234,"Jerry Stackhouse\stackje01","2011-12",37,"ATL","NBA",0.3,30,0,273,37,100,24,62,13,38,21,23,6,17,23,14,10,3,13,12,108,2.77
9235,"Nik Stauskas\stausni01","2017-18",24,"TOT","NBA",0.3,41,0,523,60,154,20,54,40,100,21,29,4,60,64,39,9,4,26,24,181,3.87
9236,"Julyan Stone\stoneju01","2017-18",29,"CHO","NBA",0.3,23,0,175,6,13,0,0,6,13,1,2,1,28,29,26,4,2,7,21,19,2.05
9237,"Salim Stoudamire\stoudsa01","2007-08",25,"ATL","NBA",0.3,35,0,402,65,180,36,95,29,85,41,50,4,20,24,28,7,5,21,34,200,3.89
9238,"Erick Strickland\stricer01","1996-97",23,"DAL","NBA",0.3,28,15,759,102,256,74,164,28,92,65,80,21,69,90,68,27,5,66,75,297,9.53
9239,"Derek Strong\stronde01","2000-01",32,"LAC","NBA",0.3,28,8,491,45,117,45,116,0,1,28,37,34,74,108,7,14,1,22,30,118,4.05
9240,"Jeffery Taylor\tayloje03","2014-15",25,"CHO","NBA",0.3,29,13,430,45,114,34,78,11,36,26,41,14,39,53,22,12,1,19,36,127,3.74
9241,"Mirza Teletović\teletmi01","2017-18",32,"MIL","NBA",0.3,10,0,159,25,57,4,12,21,45,0,0,3,20,23,10,4,1,7,14,71,6.2
9242,"Sebastian Telfair\telfase01","2009-10",24,"TOT","NBA",0.3,43,1,659,83,201,70,145,13,56,29,37,5,40,45,126,24,5,50,71,208,5.37
9243,"Garrett Temple\templga01","2013-14",27,"WAS","NBA",0.3,75,0,638,51,141,45,112,6,29,30,43,21,47,68,72,35,11,42,72,138,2.33
9244,"Hasheem Thabeet\thabeha01","2011-12",24,"TOT","NBA",0.3,20,3,139,11,21,11,21,0,0,13,20,16,26,42,0,1,10,8,20,35,2.34
9245,"Hasheem Thabeet\thabeha01","2010-11",23,"TOT","NBA",0.3,47,0,373,17,40,17,40,0,0,19,35,24,51,75,4,9,16,17,76,53,1.67
9246,"Axel Toupane\toupaax01","2015-16",23,"DEN","NBA",0.3,21,0,305,25,70,12,30,13,40,13,17,8,23,31,15,7,6,6,40,76,3.31
9247,"Jake Tsakalidis\tsakaja01","2006-07",27,"TOT","NBA",0.3,36,7,390,29,72,29,72,0,0,26,39,42,62,104,5,8,12,24,51,84,2.82
9248,"Ekpe Udoh\udohek01","2014-15",27,"LAC","NBA",0.3,33,0,128,11,24,11,24,0,0,7,9,7,19,26,8,8,7,7,20,29,1.35
9249,"Dajuan Wagner\wagneda02","2002-03",19,"CLE","NBA",0.3,47,24,1385,223,605,168,431,55,174,128,160,20,62,82,130,38,7,85,107,629,9.54
9250,"Kemba Walker\walkeke02","2011-12",21,"CHA","NBA",0.3,66,25,1792,281,767,212,541,69,226,168,213,30,204,234,289,60,20,119,79,799,11.01
9251,"John Wallace\wallajo01","2003-04",29,"MIA","NBA",0.3,37,0,368,61,145,56,132,5,13,31,40,12,47,59,14,5,8,24,38,158,3.28
9252,"John Wallace\wallajo01","2000-01",26,"DET","NBA",0.3,40,0,527,100,236,98,221,2,15,35,45,25,58,83,23,13,16,36,72,237,4.53
9253,"Rex Walters\waltere01","1999-00",29,"MIA","NBA",0.3,33,0,389,38,91,33,71,5,20,12,16,8,28,36,65,6,0,29,44,93,3.3
9254,"Luke Walton\waltolu01","2009-10",29,"LAL","NBA",0.3,29,0,272,30,84,23,67,7,17,2,4,12,26,38,40,10,1,12,19,69,2.6
9255,"Eric Washington\washier01","1998-99",24,"DEN","NBA",0.3,38,6,761,73,184,36,87,37,97,22,32,35,54,89,30,25,18,34,87,205,5.15
9256,"Jamie Watson\watsoja01","1996-97",24,"TOT","NBA",0.3,23,6,340,31,72,27,60,4,12,12,16,18,29,47,33,22,4,24,34,78,4.57
9257,"Kyle Weaver\weaveky01","2009-10",23,"OKC","NBA",0.3,12,0,144,12,33,5,14,7,19,5,6,1,17,18,11,6,6,4,13,36,3.53
9258,"Briante Weber\weberbr01","2016-17",24,"TOT","NBA",0.3,20,0,205,25,60,24,50,1,10,11,16,8,18,26,21,12,1,8,16,62,3.29
9259,"David Wesley\wesleda01","2006-07",36,"CLE","NBA",0.3,35,5,352,22,75,13,37,9,38,20,28,3,32,35,37,12,4,17,32,73,2.31
9260,"Mario West\westma02","2009-10",25,"ATL","NBA",0.3,39,1,142,12,21,12,20,0,1,6,10,8,19,27,9,8,0,7,25,30,1.12
9261,"DeJuan Wheat\wheatde01","1998-99",25,"VAN","NBA",0.3,46,0,590,73,193,51,133,22,60,40,55,11,34,45,102,26,2,48,59,208,4.63
9262,"James White\whiteja02","2006-07",24,"SAS","NBA",0.3,6,2,137,18,41,16,34,2,7,12,15,3,17,20,5,3,1,5,7,50,7.08
9263,"C.J. Wilcox\wilcocj01","2015-16",25,"LAC","NBA",0.3,23,0,167,26,66,17,43,9,23,9,12,1,11,12,10,10,2,2,15,70,2.44
9264,"Dominique Wilkins\wilkido01","1998-99",39,"ORL","NBA",0.3,27,2,252,50,132,45,113,5,19,29,42,30,41,71,16,4,1,23,19,134,3.73
9265,"Aaron Williams\williaa01","2004-05",33,"TOT","NBA",0.3,42,4,315,29,63,29,63,0,0,15,17,17,43,60,8,5,8,17,70,73,1.9
9266,"Elliot Williams\williel01","2013-14",24,"PHI","NBA",0.3,67,2,1157,140,337,103,212,37,125,87,119,30,100,130,72,35,3,68,126,404,5.24
9267,"Elliot Williams\williel01","2011-12",22,"POR","NBA",0.3,24,0,149,37,74,29,47,8,27,6,18,7,12,19,6,6,3,5,18,88,2.75
9268,"Frank Williams\willifr02","2003-04",23,"NYK","NBA",0.3,56,3,714,80,208,62,148,18,60,41,48,8,45,53,121,25,6,63,58,219,4.24
9269,"Lorenzo Williams\willilo01","1999-00",30,"WAS","NBA",0.3,8,0,76,7,9,7,9,0,0,0,0,12,13,25,1,3,6,3,13,14,3.55
9270,"Lorenzo Williams\willilo01","1992-93",23,"TOT","NBA",0.3,27,7,179,17,36,17,36,0,0,2,7,17,38,55,5,5,17,8,29,36,2.15
9271,"Micheal Williams\willimi02","1997-98",31,"MIN","NBA",0.3,25,0,161,16,48,16,44,0,4,32,33,2,12,14,32,9,2,16,24,64,2.99
9272,"Monty Williams\willimo01","1994-95",23,"NYK","NBA",0.3,41,23,503,60,133,60,125,0,8,17,38,42,56,98,49,20,4,41,87,137,3.8
9273,"Reggie Williams\willire02","2011-12",25,"CHA","NBA",0.3,33,13,747,106,255,73,148,33,107,29,40,27,66,93,60,20,3,33,34,274,7.12
9274,"Reggie Williams\willire01","1995-96",31,"DEN","NBA",0.3,52,5,817,94,254,74,165,20,89,33,39,25,97,122,74,34,21,51,137,241,4.76
9275,"Reggie Williams\willire02","2012-13",26,"CHA","NBA",0.3,40,0,380,57,132,35,60,22,72,10,21,8,43,51,39,12,1,19,19,146,3.31
9276,"Scott Williams\willisc01","1995-96",27,"PHI","NBA",0.3,13,1,193,15,29,15,27,0,2,10,12,13,33,46,5,6,7,8,27,40,4.44
9277,"Sean Williams\willise01","2008-09",22,"NJN","NBA",0.3,33,0,366,30,72,30,72,0,0,20,32,34,45,79,13,7,29,20,72,80,3.18
9278,"Terrence Williams\willite01","2011-12",24,"TOT","NBA",0.3,30,0,550,85,198,69,152,16,46,27,46,13,89,102,65,20,7,43,35,213,7.07
9279,"Terrence Williams\willite01","2012-13",25,"BOS","NBA",0.3,24,0,318,48,97,43,82,5,15,9,21,4,40,44,38,11,2,22,13,110,4.71
9280,"Trevor Wilson\wilsotr01","1994-95",26,"SAC","NBA",0.3,15,0,147,18,40,18,40,0,0,11,14,10,16,26,12,4,2,6,12,47,3.28
9281,"David Wingate\wingada01","1997-98",34,"SEA","NBA",0.3,58,2,546,66,140,63,133,3,7,15,29,19,60,79,37,21,3,37,58,150,2.64
9282,"Christian Wood\woodch01","2016-17",21,"CHO","NBA",0.3,13,0,107,12,23,12,18,0,5,11,15,14,15,29,2,3,6,7,11,35,3.25
9283,"Christian Wood\woodch01","2015-16",20,"PHI","NBA",0.3,17,0,145,22,53,18,42,4,11,13,21,13,25,38,3,5,7,2,11,61,3.34
9284,"Randy Woods\woodsra01","1993-94",23,"LAC","NBA",0.3,40,0,352,49,133,22,55,27,78,20,35,13,16,29,71,24,2,34,40,145,3.8
9285,"Haywoode Workman\workmha01","1999-00",34,"TOT","NBA",0.3,36,2,350,31,90,17,47,14,43,10,15,1,25,26,61,20,0,18,37,86,2.96
9286,"Metta World Peace\artesro01","2013-14",34,"NYK","NBA",0.3,29,1,388,56,141,39,87,17,54,10,16,18,41,59,17,24,8,19,44,139,4.32
9287,"Antoine Wright\wrighan01","2009-10",25,"TOR","NBA",0.3,67,10,1392,162,399,104,226,58,173,53,77,38,152,190,71,30,11,58,134,435,5.59
9288,"Bracey Wright\wrighbr02","2006-07",22,"MIN","NBA",0.3,19,0,190,24,60,18,40,6,20,13,18,7,14,21,15,9,1,6,6,67,3.22
9289,"Chris Wright\wrighch01","2013-14",25,"MIL","NBA",0.3,8,0,126,21,35,21,34,0,1,6,15,10,10,20,5,7,5,5,17,48,6.29
9290,"Tony Wroten\wroteto01","2014-15",21,"PHI","NBA",0.3,30,15,895,175,434,138,292,37,142,120,180,22,64,86,157,48,8,113,72,507,14.9
9291,"James Young\youngja01","2016-17",21,"BOS","NBA",0.3,29,0,220,25,58,13,23,12,35,6,9,6,20,26,4,10,2,4,15,68,2.1
9292,"James Young\youngja01","2014-15",19,"BOS","NBA",0.3,31,0,332,36,102,19,36,17,66,16,29,9,33,42,13,8,2,5,22,105,2.52
9293,"Tyler Zeller\zellety01","2018-19",29,"TOT","NBA",0.3,6,1,93,16,30,16,29,0,1,14,18,11,13,24,4,1,3,4,20,46,7.55
9294,"George Zídek\zidekge01","1996-97",23,"TOT","NBA",0.3,52,2,376,49,118,49,116,0,2,45,57,35,51,86,14,5,3,27,61,143,2.43
9295,"Rafael Addison\addisra01","1995-96",31,"CHH","NBA",0.2,53,0,516,77,165,77,156,0,9,17,22,25,65,90,30,9,9,27,74,171,2.95
9296,"Jeff Adrien\adrieje01","2010-11",24,"GSW","NBA",0.2,23,0,196,23,54,23,54,0,0,11,19,23,35,58,10,4,5,9,28,57,2.73
9297,"Solomon Alabi\alabiso01","2011-12",23,"TOR","NBA",0.2,14,0,122,13,36,13,36,0,0,7,8,15,32,47,3,2,9,5,11,33,2.99
9298,"Cole Aldrich\aldrico01","2010-11",22,"OKC","NBA",0.2,18,0,142,8,15,8,15,0,0,2,4,13,22,35,4,5,7,8,30,18,2.03
9299,"Cory Alexander\alexaco01","1995-96",22,"SAS","NBA",0.2,60,0,560,63,155,37,89,26,66,16,25,9,33,42,121,27,2,68,94,168,3.52
9300,"Malik Allen\allenma01","2010-11",32,"ORL","NBA",0.2,18,0,178,11,31,11,31,0,0,1,2,12,20,32,4,1,4,3,30,23,1.37
9301,"Chris Andersen\anderch01","2016-17",38,"CLE","NBA",0.2,12,0,114,9,22,9,19,0,3,10,14,9,22,31,5,5,7,5,20,28,3.37
9302,"Kenny Anderson\anderke01","2004-05",34,"TOT","NBA",0.2,43,20,743,85,201,79,188,6,13,27,37,24,64,88,103,33,0,49,87,203,5.41
9303,"Joel Anthony\anthojo01","2013-14",31,"TOT","NBA",0.2,33,0,186,12,32,12,32,0,0,4,8,15,23,38,2,3,12,3,17,28,1.12
9304,"Robert Archibald\archiro01","2003-04",23,"TOT","NBA",0.2,32,3,256,9,33,9,33,0,0,14,31,21,31,52,13,14,3,10,50,32,1.62
9305,"Gilbert Arenas\arenagi01","2008-09",27,"WAS","NBA",0.2,2,2,63,6,23,4,16,2,7,12,16,1,8,9,20,0,1,1,4,26,14.5
9306,"Vincent Askew\askewvi01","1997-98",31,"POR","NBA",0.2,30,5,443,19,54,19,52,0,2,28,39,21,47,68,38,19,5,35,39,66,3.59
9307,"Keith Askins\askinke01","1998-99",31,"MIA","NBA",0.2,33,13,415,20,62,12,33,8,29,5,8,10,34,44,10,17,3,13,58,53,1.82
9308,"Chucky Atkins\atkinch01","2009-10",35,"DET","NBA",0.2,40,11,644,57,157,35,84,22,73,25,27,5,24,29,91,17,0,32,53,161,4.13
9309,"Isaac Austin\austiis01","1993-94",24,"PHI","NBA",0.2,14,0,201,29,66,29,65,0,1,14,23,25,44,69,17,5,10,17,29,72,6.09
9310,"Jeff Ayres\pendeje02","2015-16",28,"LAC","NBA",0.2,17,0,107,12,23,12,22,0,1,6,6,4,18,22,5,0,3,6,18,30,1.95
9311,"Toby Bailey\baileto01","1998-99",23,"PHO","NBA",0.2,27,10,249,34,86,33,81,1,5,9,13,24,30,54,13,9,2,11,24,78,2.63
9312,"Steve Bardo\bardost01","1995-96",27,"DET","NBA",0.2,9,0,123,9,23,9,19,0,4,4,6,2,20,22,15,4,1,5,17,22,3.63
9313,"Andrea Bargnani\bargnan01","2015-16",30,"BRK","NBA",0.2,46,0,634,127,279,124,263,3,16,47,57,28,69,97,18,4,9,26,61,304,4.72
9314,"Erick Barkley\barkler01","2001-02",23,"POR","NBA",0.2,19,4,228,24,68,23,61,1,7,9,10,5,13,18,34,17,1,12,29,58,3.59
9315,"Drew Barry\barrydr01","1998-99",25,"SEA","NBA",0.2,17,0,183,10,32,2,8,8,24,9,13,3,17,20,29,7,1,12,24,37,3.12
9316,"Eddie Basden\basdeed01","2005-06",22,"CHI","NBA",0.2,19,0,141,15,37,14,30,1,7,8,10,7,21,28,8,9,2,9,17,39,2.39
9317,"Esteban Batista\batises01","2006-07",23,"ATL","NBA",0.2,13,0,81,8,16,8,16,0,0,4,7,7,23,30,4,3,0,4,13,20,2.2
9318,"John Battle\battljo01","1994-95",32,"CLE","NBA",0.2,28,0,280,43,114,32,83,11,31,19,26,3,8,11,37,8,1,17,28,116,3.2
9319,"Sergei Bazarevich\bazarse01","1994-95",29,"ATL","NBA",0.2,10,0,74,11,22,10,16,1,6,7,9,1,6,7,14,1,1,7,10,30,3.25
9320,"Kent Bazemore\bazemke01","2013-14",24,"TOT","NBA",0.2,67,15,911,147,343,104,215,43,128,66,109,10,107,117,91,43,13,79,102,403,5.48
9321,"Malik Beasley\beaslma01","2016-17",20,"DEN","NBA",0.2,22,1,165,33,73,24,45,9,28,8,10,5,12,17,11,7,0,8,10,83,2.99
9322,"Michael Beasley\beaslmi01","2018-19",30,"LAL","NBA",0.2,26,2,277,75,153,72,136,3,17,28,39,13,47,60,25,9,10,27,42,181,6.04
9323,"Rodrigue Beaubois\beaubro01","2010-11",22,"DAL","NBA",0.2,28,26,496,94,223,69,140,25,83,23,30,7,45,52,64,20,8,47,76,236,7.35
9324,"Corey Beck\beckco01","1998-99",27,"TOT","NBA",0.2,24,0,180,18,39,17,38,1,1,8,15,6,22,28,20,9,2,13,26,45,2.4
9325,"Jonathan Bender\bendejo01","2005-06",25,"IND","NBA",0.2,2,0,21,4,5,4,5,0,0,2,2,0,4,4,2,0,1,0,2,10,5.9
9326,"Jabari Bird\birdja01","2017-18",23,"BOS","NBA",0.2,13,1,115,15,26,12,19,3,7,6,13,6,13,19,8,3,1,8,7,39,3.15
9327,"James Blackwell\blackja01","1994-95",26,"TOT","NBA",0.2,13,0,80,8,13,8,13,0,0,2,3,2,9,11,11,4,0,5,8,18,2.14
9328,"Lance Blanks\blankla01","1992-93",26,"MIN","NBA",0.2,61,2,642,65,150,54,107,11,43,20,32,18,50,68,72,16,5,31,61,161,2.86
9329,"Eric Bledsoe\bledser01","2011-12",22,"LAC","NBA",0.2,40,1,464,49,126,43,96,6,30,28,44,22,43,65,66,31,14,47,58,132,4.25
9330,"Manute Bol\bolma01","1992-93",30,"PHI","NBA",0.2,58,23,855,52,127,42,95,10,32,12,19,44,149,193,18,14,119,50,87,126,4.18
9331,"Joel Bolomboy\bolomjo01","2016-17",23,"UTA","NBA",0.2,12,0,53,9,16,8,12,1,4,3,6,4,13,17,2,1,2,2,1,22,1.98
9332,"Ruben Boumtje-Boumtje\boumtru01","2001-02",23,"POR","NBA",0.2,33,1,245,13,32,13,32,0,0,13,25,21,34,55,4,3,16,14,38,39,1.7
9333,"Cal Bowdler\bowdlca01","1999-00",22,"ATL","NBA",0.2,46,0,423,49,115,49,114,0,1,24,38,22,63,85,14,14,9,21,46,122,2.6
9334,"Ryan Bowen\bowenry01","2005-06",30,"HOU","NBA",0.2,68,19,652,37,124,34,102,3,22,11,14,31,57,88,24,21,6,13,85,88,1.35
9335,"Michael Bradley\bradlmi01","2004-05",25,"TOT","NBA",0.2,18,0,119,15,24,15,23,0,1,3,8,8,20,28,5,1,2,5,12,33,2.07
9336,"Mark Bradtke\bradtma01","1996-97",28,"PHI","NBA",0.2,36,0,251,25,58,25,58,0,0,9,13,26,42,68,7,5,5,9,34,59,1.87
9337,"Torraye Braggs\braggto01","2003-04",27,"TOT","NBA",0.2,15,0,154,16,33,16,33,0,0,8,12,18,21,39,7,4,2,13,29,40,3.17
9338,"Elton Brand\brandel01","2015-16",36,"PHI","NBA",0.2,17,1,225,31,72,31,71,0,1,8,9,9,54,63,18,9,8,11,32,70,4.94
9339,"Jamison Brewer\breweja01","2002-03",22,"IND","NBA",0.2,10,0,80,9,17,9,15,0,2,4,9,5,4,9,18,2,1,6,11,22,3.06
9340,"Primož Brezec\brezepr01","2007-08",28,"TOT","NBA",0.2,50,18,475,44,94,44,94,0,0,24,40,30,51,81,11,3,7,24,83,112,2.11
9341,"Dee Brown\brownde03","2006-07",22,"UTA","NBA",0.2,49,0,450,32,98,26,70,6,28,24,37,8,32,40,83,22,7,31,51,94,2.73
9342,"Dee Brown\brownde01","2000-01",32,"ORL","NBA",0.2,7,0,155,16,44,4,12,12,32,4,5,0,11,11,12,4,0,7,10,48,5.71
9343,"Lorenzo Brown\brownlo01","2017-18",27,"TOR","NBA",0.2,14,0,139,14,34,12,22,2,12,2,2,1,14,15,13,5,0,3,7,32,2.42
9344,"Mike Brown\brownmi01","1996-97",33,"PHO","NBA",0.2,6,1,83,5,12,5,12,0,0,6,10,9,16,25,5,1,1,2,9,16,3.87
9345,"Randy Brown\brownra02","2002-03",34,"PHO","NBA",0.2,32,0,262,16,43,16,43,0,0,9,12,3,23,26,35,17,2,17,36,41,2.17
9346,"Tierre Brown\brownti01","2002-03",23,"CLE","NBA",0.2,15,0,168,27,59,27,58,0,1,11,14,8,22,30,39,13,0,22,9,65,5.71
9347,"Kobe Bryant\bryanko01","2014-15",36,"LAL","NBA",0.2,35,35,1207,266,713,212,529,54,184,196,241,26,173,199,197,47,7,128,65,782,18.31
9348,"Reggie Bullock\bullore01","2013-14",22,"LAC","NBA",0.2,43,0,395,43,121,21,48,22,73,7,9,11,43,54,12,9,1,13,26,115,2.01
9349,"Willie Burton\burtowi01","1997-98",29,"SAS","NBA",0.2,13,0,43,8,21,5,12,3,9,8,12,3,6,9,1,2,2,1,7,27,1.66
9350,"Dwight Buycks\buyckdw01","2017-18",28,"DET","NBA",0.2,29,0,427,82,198,67,153,15,45,36,41,12,29,41,59,19,2,39,39,215,6.39
9351,"Adrian Caldwell\caldwad01","1996-97",30,"TOT","NBA",0.2,45,0,569,40,92,40,90,0,2,21,50,58,109,167,12,16,8,28,87,101,3.06
9352,"Isaiah Canaan\canaais01","2013-14",22,"HOU","NBA",0.2,22,0,252,31,87,13,32,18,55,21,29,7,17,24,22,8,4,21,25,101,3.87
9353,"Brian Cardinal\cardibr01","2001-02",24,"DET","NBA",0.2,8,0,43,6,13,3,6,3,7,2,2,2,4,6,2,1,0,0,5,17,1.89
9354,"Chris Carr\carrch01","1998-99",24,"TOT","NBA",0.2,39,4,445,76,205,48,130,28,75,27,40,23,48,71,23,8,2,28,45,207,3.66
9355,"Anthony Carter\cartean01","2010-11",35,"TOT","NBA",0.2,33,0,463,45,106,33,66,12,40,8,8,7,44,51,69,27,6,39,49,110,4.66
9356,"Anthony Carter\cartean01","2001-02",26,"MIA","NBA",0.2,46,18,1050,89,260,88,241,1,19,19,36,19,98,117,214,50,3,72,85,198,6.38
9357,"Michael Carter-Williams\cartemi01","2016-17",25,"CHI","NBA",0.2,45,19,846,112,306,97,242,15,64,58,77,24,129,153,113,38,23,66,102,297,6.99
9358,"Bill Cartwright\cartwbi01","1994-95",37,"SEA","NBA",0.2,29,19,430,27,69,27,69,0,0,15,24,25,62,87,10,6,3,18,70,69,2.68
9359,"Ian Clark\clarkia01","2014-15",23,"TOT","NBA",0.2,30,0,192,19,55,9,25,10,30,9,9,4,12,16,12,9,3,9,20,57,1.73
9360,"Keon Clark\clarkke01","1998-99",23,"DEN","NBA",0.2,28,0,409,36,80,36,79,0,1,21,37,36,60,96,10,10,31,21,52,93,4.36
9361,"Victor Claver\clavevi01","2013-14",25,"POR","NBA",0.2,21,0,184,17,42,14,24,3,18,10,11,9,30,39,12,3,3,11,16,47,2.53
9362,"Keith Closs\closske01","1998-99",22,"LAC","NBA",0.2,15,0,87,12,23,12,22,0,1,8,10,5,20,25,0,3,9,6,14,32,2.61
9363,"Jarron Collins\collija03","2008-09",30,"UTA","NBA",0.2,26,3,201,16,35,16,35,0,0,8,11,20,17,37,7,2,1,9,35,40,1.66
9364,"Jason Collins\collija04","2011-12",33,"ATL","NBA",0.2,30,10,308,16,40,16,40,0,0,7,15,12,36,48,10,4,3,10,34,39,1.55
9365,"Bonzie Colson\colsobo01","2018-19",23,"MIL","NBA",0.2,8,2,98,13,39,8,18,5,21,8,9,8,22,30,3,5,1,3,3,39,4.54
9366,"Quinn Cook\cookqu01","2016-17",23,"TOT","NBA",0.2,14,0,188,33,66,22,40,11,26,2,5,1,6,7,26,4,0,13,13,79,4.99
9367,"Jack Cooley\cooleja01","2014-15",23,"UTA","NBA",0.2,16,0,87,9,22,9,22,0,0,9,21,10,15,25,1,6,3,3,23,27,1.83
9368,"Bryce Cotton\cottobr01","2014-15",22,"UTA","NBA",0.2,15,0,159,29,69,22,49,7,20,15,18,3,15,18,15,4,0,12,6,80,4.25
9369,"Chris Crawford\crawfch01","2002-03",27,"ATL","NBA",0.2,5,0,38,8,13,7,10,1,3,7,8,3,4,7,1,2,3,2,7,24,5.06
9370,"Jamal Crawford\crawfja01","2018-19",38,"PHO","NBA",0.2,64,0,1211,174,438,107,236,67,202,93,110,8,77,85,229,33,12,99,75,508,7.81
9371,"Jordan Crawford\crawfjo02","2017-18",29,"NOP","NBA",0.2,5,0,53,12,27,4,13,8,14,1,1,2,2,4,13,1,1,5,7,33,6.26
9372,"Mitch Creek\creekmi01","2018-19",26,"TOT","NBA",0.2,5,0,48,8,16,8,14,0,2,5,7,6,6,12,6,2,0,1,3,21,4.64
9373,"Vonteego Cummings\cummivo01","2000-01",24,"GSW","NBA",0.2,66,11,1495,178,517,130,374,48,143,79,116,47,90,137,227,67,14,91,160,483,7.09
9374,"Bill Curley\curlebi01","1997-98",25,"MIN","NBA",0.2,11,1,146,16,33,16,32,0,1,2,3,11,17,28,4,3,1,3,28,34,3.15
9375,"Bill Curley\curlebi01","2000-01",28,"TOT","NBA",0.2,20,2,192,25,47,24,45,1,2,12,19,21,16,37,3,7,9,16,45,63,3.38
9376,"Lloyd Daniels\daniell01","1994-95",27,"TOT","NBA",0.2,30,14,604,80,209,54,109,26,100,22,27,29,34,63,40,22,10,31,48,208,5.8
9377,"Troy Daniels\danietr01","2014-15",23,"TOT","NBA",0.2,47,0,397,61,165,18,47,43,118,11,13,8,25,33,22,6,1,20,40,176,2.54
9378,"Troy Daniels\danietr01","2013-14",22,"HOU","NBA",0.2,5,1,75,15,31,3,6,12,25,0,0,0,4,4,5,0,0,3,6,42,6.28
9379,"Brandon Davies\daviebr01","2014-15",23,"TOT","NBA",0.2,27,6,423,55,137,47,103,8,34,24,37,38,45,83,30,18,7,29,59,142,5.19
9380,"Baron Davis\davisba01","2011-12",32,"NYK","NBA",0.2,29,14,595,68,184,42,99,26,85,16,24,13,43,56,135,34,3,76,61,178,7.8
9381,"Mark Davis\davisma02","1997-98",24,"PHI","NBA",0.2,71,12,906,109,244,109,238,0,6,64,101,64,94,158,73,49,18,91,95,282,4.45
9382,"Paul Davis\davispa01","2008-09",24,"LAC","NBA",0.2,27,1,320,40,98,40,97,0,1,27,34,28,39,67,12,10,3,13,44,107,3.66
9383,"Paul Davis\davispa01","2006-07",22,"LAC","NBA",0.2,31,0,180,22,52,22,52,0,0,7,10,21,23,44,7,6,5,8,28,51,1.75
9384,"Ricky Davis\davisri01","2000-01",21,"MIA","NBA",0.2,7,0,70,12,29,11,28,1,1,7,8,1,6,7,11,5,2,5,7,32,4.71
9385,"Ricky Davis\davisri01","1998-99",19,"CHH","NBA",0.2,46,1,557,81,200,79,188,2,12,45,59,40,44,84,58,30,7,54,46,209,4.45
9386,"Terry Davis\daviste01","2000-01",33,"DEN","NBA",0.2,19,1,228,12,25,12,25,0,0,9,22,24,29,53,7,1,1,5,34,33,2.26
9387,"Bryce Dejean-Jones\dejeabr01","2015-16",23,"NOP","NBA",0.2,14,11,279,28,69,16,37,12,32,11,21,8,40,48,15,10,2,11,17,79,5.64
9388,"Bison Dele\delebi01","1996-97",27,"CHI","NBA",0.2,9,0,138,26,63,26,63,0,0,11,15,14,19,33,12,3,5,11,20,63,6.2
9389,"Dell Demps\dempsde01","1995-96",25,"SAS","NBA",0.2,16,0,87,19,33,18,31,1,2,14,17,2,7,9,8,3,1,12,10,53,3.08
9390,"Marcus Derrickson\derrima01","2018-19",22,"GSW","NBA",0.2,11,0,67,16,33,6,13,10,20,4,5,8,5,13,1,0,1,3,9,46,3.23
9391,"James Donaldson\donalja01","1992-93",35,"UTA","NBA",0.2,6,1,94,8,14,8,14,0,0,5,9,6,23,29,1,1,7,4,13,21,5.17
9392,"Keyon Dooling\doolike01","2012-13",32,"MEM","NBA",0.2,7,0,82,10,21,5,9,5,12,6,7,0,1,1,8,1,0,5,8,31,3.84
9393,"Sherman Douglas\douglsh01","2000-01",34,"NJN","NBA",0.2,59,7,1094,122,303,114,263,8,40,86,115,21,53,74,144,36,4,79,93,338,5.63
9394,"Toney Douglas\douglto01","2014-15",28,"NOP","NBA",0.2,12,0,177,19,51,14,33,5,18,8,13,2,20,22,24,11,4,10,20,51,5.02
9395,"Chris Duhon\duhonch01","2010-11",28,"ORL","NBA",0.2,51,5,774,49,129,36,77,13,52,14,25,9,43,52,118,16,2,61,30,125,3.35
9396,"Acie Earl\earlac01","1993-94",23,"BOS","NBA",0.2,74,8,1149,151,372,151,371,0,1,108,160,85,162,247,12,24,53,72,178,410,4.83
9397,"Doug Edwards\edwardo01","1994-95",24,"ATL","NBA",0.2,38,0,212,22,48,22,47,0,1,23,32,19,29,48,13,5,4,22,30,67,1.97
9398,"John Edwards\edwarjo01","2005-06",24,"ATL","NBA",0.2,40,4,296,31,64,31,64,0,0,8,11,18,30,48,5,3,15,12,76,70,1.82
9399,"Obinna Ekezie\ekeziob01","2001-02",26,"LAC","NBA",0.2,29,1,152,13,39,13,39,0,0,28,40,12,22,34,3,2,6,10,16,54,1.69
9400,"Monta Ellis\ellismo01","2008-09",23,"GSW","NBA",0.2,25,25,892,194,430,186,404,8,26,78,94,14,94,108,93,39,8,67,67,474,15.88
9401,"Kim English\engliki01","2012-13",24,"DET","NBA",0.2,41,0,407,42,112,28,62,14,50,21,29,8,29,37,26,16,3,19,46,119,2.57
9402,"Evan Eschmeyer\eschmev01","2002-03",27,"DAL","NBA",0.2,17,3,135,7,19,7,19,0,0,3,4,10,19,29,6,10,7,6,35,17,2.16
9403,"Reggie Evans\evansre01","2009-10",29,"TOR","NBA",0.2,28,1,311,34,69,34,69,0,0,27,60,30,75,105,8,14,4,22,44,95,3.98
9404,"Jamie Feick\feickja01","2000-01",26,"NJN","NBA",0.2,6,0,149,8,23,8,23,0,0,6,12,12,44,56,5,8,3,7,15,22,7.12
9405,"Jamie Feick\feickja01","1996-97",22,"TOT","NBA",0.2,41,0,624,56,157,51,143,5,14,34,67,82,132,214,26,16,14,31,78,151,4.39
9406,"Raymond Felton\feltora01","2014-15",30,"DAL","NBA",0.2,29,3,281,43,106,33,72,10,34,12,15,2,24,26,41,11,4,18,17,108,3.54
9407,"Matt Fish\fishma01","1994-95",25,"LAC","NBA",0.2,26,8,370,49,103,49,102,0,1,25,37,32,52,84,17,16,7,28,70,123,5.08
9408,"T.J. Ford\fordtj01","2010-11",27,"IND","NBA",0.2,41,3,773,91,236,85,204,6,32,35,48,17,64,81,141,35,8,63,69,223,6.36
9409,"T.J. Ford\fordtj01","2011-12",28,"SAS","NBA",0.2,14,0,191,19,43,17,35,2,8,11,14,3,15,18,45,9,2,23,23,51,5.46
9410,"Danny Fortson\fortsda01","2002-03",26,"GSW","NBA",0.2,17,0,223,20,54,20,53,0,1,19,29,28,45,73,12,9,0,15,43,59,4.22
9411,"Danny Fortson\fortsda01","2005-06",29,"SEA","NBA",0.2,23,1,276,27,51,27,51,0,0,33,43,31,47,78,2,4,2,26,76,87,4.18
9412,"Greg Foster\fostegr01","1992-93",24,"TOT","NBA",0.2,43,0,298,55,120,55,116,0,4,15,21,32,51,83,21,3,14,25,58,125,2.82
9413,"Randy Foye\foyera01","2016-17",33,"BRK","NBA",0.2,69,40,1284,118,325,51,122,67,203,54,63,9,146,155,135,35,9,80,99,357,5.38
9414,"Steve Francis\francst01","2007-08",30,"HOU","NBA",0.2,10,3,199,19,57,15,40,4,17,13,23,8,15,23,30,9,5,14,25,55,6.14
9415,"Jimmer Fredette\fredeji01","2014-15",25,"NOP","NBA",0.2,50,0,509,63,166,54,118,9,48,43,45,8,32,40,58,15,2,33,43,178,3.18
9416,"Joel Freeland\freeljo01","2012-13",25,"POR","NBA",0.2,51,1,477,58,142,58,142,0,0,18,27,40,79,119,13,13,11,19,67,134,2.58
9417,"Todd Fuller\fulleto02","1999-00",25,"CHH","NBA",0.2,41,2,399,51,122,51,122,0,0,32,53,36,74,110,5,9,8,27,46,134,2.99
9418,"Markelle Fultz\fultzma01","2017-18",19,"PHI","NBA",0.2,14,0,253,45,111,45,110,0,1,10,21,11,32,43,53,12,4,17,22,100,7.5
9419,"Pat Garrity\garripa01","2006-07",30,"ORL","NBA",0.2,33,0,277,22,70,11,38,11,32,16,18,12,30,42,14,7,0,14,37,71,1.93
9420,"Mickaël Gelabale\gelabmi01","2007-08",24,"SEA","NBA",0.2,39,0,465,69,157,53,120,16,37,14,18,16,42,58,33,10,9,27,31,168,3.76
9421,"Marcus Georges-Hunt\georgma01","2017-18",23,"MIN","NBA",0.2,42,0,224,21,48,17,33,4,15,13,21,7,9,16,7,6,0,3,32,59,1.14
9422,"Jonathan Gibson\gibsojo01","2017-18",30,"BOS","NBA",0.2,4,0,40,14,23,8,11,6,12,0,0,0,3,3,4,0,0,3,5,34,6.88
9423,"Eddie Gill\gilled01","2007-08",29,"TOT","NBA",0.2,14,1,154,12,31,7,16,5,15,9,9,1,21,22,22,7,2,9,18,38,3.84
9424,"Mickell Gladness\gladnmi01","2011-12",25,"TOT","NBA",0.2,26,7,252,25,59,25,59,0,0,6,12,14,44,58,5,4,20,7,32,56,2.58
9425,"Dion Glover\glovedi01","2004-05",26,"SAS","NBA",0.2,7,0,68,8,22,7,14,1,8,8,10,3,8,11,4,3,3,2,9,25,3.47
9426,"Archie Goodwin\goodwar01","2014-15",20,"PHO","NBA",0.2,41,2,535,79,201,67,160,12,41,61,83,27,47,74,44,18,9,48,55,231,4.82
9427,"Archie Goodwin\goodwar01","2013-14",19,"PHO","NBA",0.2,52,0,533,76,167,71,131,5,36,37,55,25,62,87,20,20,11,44,45,194,3.4
9428,"Paul Graham\grahapa01","1993-94",26,"ATL","NBA",0.2,21,0,128,21,57,18,44,3,13,13,17,4,8,12,13,4,5,5,11,58,2.2
9429,"Brian Grant\grantbr01","2005-06",33,"PHO","NBA",0.2,21,2,248,27,65,27,65,0,0,7,8,11,46,57,7,5,3,7,45,61,2.89
9430,"Greg Grant\grantgr01","1992-93",26,"PHI","NBA",0.2,72,0,996,77,220,57,152,20,68,20,31,24,43,67,206,43,1,54,73,194,3.9
9431,"Horace Grant\grantho01","2002-03",37,"ORL","NBA",0.2,5,1,85,13,25,13,25,0,0,0,0,2,6,8,7,3,0,1,5,26,4.96
9432,"Danny Green\greenda02","2009-10",22,"CLE","NBA",0.2,20,0,115,15,39,9,17,6,22,4,6,8,9,17,5,6,3,5,9,40,1.82
9433,"Jeff Green\greenje02","2007-08",21,"SEA","NBA",0.2,80,52,2253,320,749,299,673,21,76,177,238,101,278,379,119,46,49,158,198,838,9.16
9434,"Anthony Grundy\grundan01","2005-06",26,"ATL","NBA",0.2,12,0,108,19,38,14,23,5,15,9,14,1,16,17,9,7,0,9,14,52,4.26
9435,"Jorge Gutiérrez\gutiejo01","2013-14",25,"BRK","NBA",0.2,15,2,244,25,54,22,42,3,12,9,12,3,19,22,30,10,1,14,37,62,4.9
9436,"Jack Haley\haleyja01","1996-97",33,"NJN","NBA",0.2,20,0,74,13,37,13,37,0,0,14,19,13,19,32,5,1,1,2,14,40,1.77
9437,"Steve Hamer\hamerst01","1996-97",23,"BOS","NBA",0.2,35,3,268,30,57,30,55,0,2,16,29,17,43,60,7,2,4,13,39,76,2.19
9438,"Jordan Hamilton\hamiljo02","2015-16",25,"NOP","NBA",0.2,11,4,304,49,116,36,71,13,45,14,21,12,50,62,25,8,3,17,24,125,10.27
9439,"Tang Hamilton\hamilta01","2001-02",23,"MIA","NBA",0.2,9,2,98,10,19,10,18,0,1,0,1,6,12,18,5,4,0,2,10,20,2.78
9440,"Darrin Hancock\hancoda01","1996-97",25,"TOT","NBA",0.2,24,0,133,16,35,16,35,0,0,10,14,4,14,18,12,9,1,11,15,42,1.98
9441,"Ben Hansbrough\hansbbe01","2012-13",25,"IND","NBA",0.2,28,0,200,15,45,9,22,6,23,21,27,2,16,18,21,7,2,18,23,57,2.12
9442,"Travis Hansen\hansetr01","2003-04",25,"ATL","NBA",0.2,41,4,507,46,130,37,100,9,30,22,27,30,40,70,19,10,9,15,67,123,2.59
9443,"Luke Harangody\haranlu01","2011-12",24,"CLE","NBA",0.2,21,1,231,23,65,18,44,5,21,9,12,20,33,53,6,6,3,4,17,60,2.67
9444,"Anfernee Hardaway\hardaan01","2007-08",36,"MIA","NBA",0.2,16,8,325,22,60,14,41,8,19,8,9,3,32,35,35,19,1,13,24,60,5.29
9445,"Anfernee Hardaway\hardaan01","2004-05",33,"NYK","NBA",0.2,37,0,894,110,260,95,210,15,50,34,46,19,70,89,74,28,3,50,79,269,6.59
9446,"Tim Hardaway\hardati01","2002-03",36,"IND","NBA",0.2,10,0,127,18,49,7,18,11,31,2,4,1,14,15,24,9,0,11,8,49,5.29
9447,"Matt Harpring\harprma01","1999-00",23,"ORL","NBA",0.2,4,0,63,4,17,2,15,2,2,6,7,5,7,12,8,5,1,1,7,16,5.35
9448,"Joe Harris\harrijo01","2014-15",23,"CLE","NBA",0.2,51,1,493,48,120,17,36,31,84,9,15,7,34,41,26,7,2,27,62,136,2.19
9449,"Tony Harris\harrito01","1993-94",26,"BOS","NBA",0.2,5,0,88,9,31,6,22,3,9,23,25,3,7,10,8,4,0,6,8,44,7.74
9450,"Antonio Harvey\harvean01","2000-01",30,"POR","NBA",0.2,12,0,72,13,28,13,28,0,0,5,6,5,9,14,4,1,6,3,10,31,2.48
9451,"Antonio Harvey\harvean01","1999-00",29,"POR","NBA",0.2,19,0,137,17,30,17,30,0,0,7,12,8,25,33,5,1,6,12,20,41,2.46
9452,"Donnell Harvey\harvedo01","2004-05",24,"NJN","NBA",0.2,3,0,16,2,2,2,2,0,0,4,4,2,5,7,1,1,1,1,2,8,4.2
9453,"Udonis Haslem\hasleud01","2016-17",36,"MIA","NBA",0.2,16,0,130,11,23,11,20,0,3,9,15,8,28,36,6,6,1,8,22,31,2.64
9454,"Trenton Hassell\hassetr01","2007-08",28,"TOT","NBA",0.2,63,6,773,57,135,55,126,2,9,7,10,20,63,83,41,13,3,22,90,123,2.02
9455,"Michael Hawkins\hawkimi01","1996-97",24,"BOS","NBA",0.2,29,0,326,29,68,19,37,10,31,12,15,9,22,31,64,16,1,28,40,80,4.02
9456,"Brendan Haywood\haywobr01","2008-09",29,"WAS","NBA",0.2,6,5,175,24,50,24,50,0,0,10,21,13,31,44,8,4,15,9,14,58,10.98
9457,"Alan Henderson\hendeal01","2003-04",31,"ATL","NBA",0.2,6,0,68,10,21,10,21,0,0,4,6,11,10,21,2,1,2,3,1,24,4.12
9458,"Xavier Henry\henryxa01","2010-11",19,"MEM","NBA",0.2,38,16,527,65,160,63,143,2,17,33,52,9,28,37,18,11,3,13,48,165,2.94
9459,"Xavier Henry\henryxa01","2011-12",20,"NOH","NBA",0.2,45,0,759,90,228,83,211,7,17,52,85,24,82,106,35,26,8,35,59,239,4.46
9460,"Julius Hodge\hodgeju01","2006-07",23,"TOT","NBA",0.2,9,1,65,6,12,6,12,0,0,3,4,2,6,8,12,4,0,3,6,15,2.69
9461,"Fred Hoiberg\hoibefr01","1995-96",23,"IND","NBA",0.2,15,1,85,8,19,7,16,1,3,15,18,4,5,9,8,6,1,7,12,32,2.44
9462,"Ryan Hollins\holliry01","2006-07",22,"CHA","NBA",0.2,27,0,185,20,36,20,36,0,0,24,40,11,20,31,1,4,7,16,40,64,2.31
9463,"Ryan Hollins\holliry01","2011-12",27,"TOT","NBA",0.2,39,8,522,46,84,46,84,0,0,39,75,34,48,82,9,5,17,35,78,131,3.39
9464,"Stephen Howard\howarst01","1993-94",23,"UTA","NBA",0.2,9,0,53,10,17,10,17,0,0,11,16,10,6,16,1,1,3,6,13,31,3.48
9465,"Lester Hudson\hudsole01","2014-15",30,"LAC","NBA",0.2,5,0,56,6,14,3,8,3,6,3,4,1,7,8,5,6,1,3,4,18,4.72
9466,"Josh Huestis\huestjo01","2016-17",25,"OKC","NBA",0.2,2,0,31,6,11,4,7,2,4,0,1,4,5,9,3,0,3,0,0,14,8.05
9467,"Kris Humphries\humphkr01","2005-06",20,"UTA","NBA",0.2,62,2,619,77,203,77,198,0,5,34,65,56,101,157,30,23,16,31,82,188,2.94
9468,"Brandon Hunter\huntebr01","2004-05",24,"ORL","NBA",0.2,31,0,224,37,73,37,73,0,0,21,39,25,44,69,3,4,7,22,42,95,2.91
9469,"Lindsey Hunter\hunteli01","2007-08",37,"DET","NBA",0.2,24,0,215,22,64,15,38,7,26,7,9,4,9,13,33,13,2,13,30,58,2.66
9470,"Othello Hunter\hunteot01","2008-09",22,"ATL","NBA",0.2,16,0,92,11,20,11,20,0,0,0,5,9,15,24,1,2,5,2,11,22,1.64
9471,"Andre Ingram\ingraan01","2017-18",32,"LAL","NBA",0.2,2,0,64,8,17,3,8,5,9,3,3,1,5,6,7,3,3,3,3,24,13.85
9472,"Jonathan Isaac\isaacjo01","2017-18",20,"ORL","NBA",0.2,27,10,536,55,145,39,99,16,46,19,25,16,83,99,18,33,30,27,48,145,6.27
9473,"Royal Ivey\iveyro01","2010-11",29,"OKC","NBA",0.2,25,0,155,16,38,9,22,7,16,2,2,2,14,16,7,6,1,5,17,41,1.55
9474,"Royal Ivey\iveyro01","2004-05",23,"ATL","NBA",0.2,62,5,809,85,198,82,189,3,9,47,67,19,65,84,103,39,7,58,140,220,4.15
9475,"Royal Ivey\iveyro01","2011-12",30,"OKC","NBA",0.2,34,0,354,26,73,8,20,18,53,1,8,1,23,24,10,14,0,9,36,71,1.71
9476,"Demetrius Jackson\jacksde01","2018-19",24,"PHI","NBA",0.2,6,0,39,8,15,6,9,2,6,4,4,2,1,3,5,2,0,1,4,22,3.57
9477,"Jaren Jackson\jacksja01","2000-01",33,"SAS","NBA",0.2,16,0,114,16,40,9,22,7,18,0,2,1,11,12,7,5,0,3,13,39,1.96
9478,"Jermaine Jackson\jacksje01","2005-06",29,"MIL","NBA",0.2,30,2,202,11,26,10,22,1,4,12,14,8,19,27,25,4,1,13,19,35,1.78
9479,"Jermaine Jackson\jacksje01","2002-03",26,"TOT","NBA",0.2,53,1,559,40,110,39,100,1,10,40,55,19,38,57,74,19,6,34,51,121,2.86
9480,"Jermaine Jackson\jacksje01","2004-05",28,"NYK","NBA",0.2,21,0,230,17,33,17,31,0,2,8,13,3,20,23,24,7,1,10,26,42,2.73
9481,"Stanley Jackson\jacksst01","1993-94",23,"MIN","NBA",0.2,17,0,92,17,33,16,28,1,5,3,3,12,15,27,16,5,0,10,13,38,2.86
9482,"Sam Jacobson\jacobsa01","2000-01",25,"MIN","NBA",0.2,14,0,59,9,18,9,18,0,0,2,3,3,3,6,4,3,0,0,19,20,1.34
9483,"Henry James\jameshe01","1992-93",27,"TOT","NBA",0.2,10,0,88,21,51,18,38,3,13,22,26,7,4,11,1,3,0,7,9,67,4.62
9484,"Mike James\jamesmi02","2017-18",27,"TOT","NBA",0.2,36,10,687,123,321,97,223,26,98,64,84,13,77,90,126,28,7,49,48,336,8.6
9485,"Dontell Jefferson\jeffedo01","2008-09",25,"CHA","NBA",0.2,6,0,84,11,22,10,20,1,2,6,9,1,11,12,9,4,1,6,9,29,5.43
9486,"John Jenkins\jenkijo01","2018-19",27,"TOT","NBA",0.2,26,0,333,42,105,20,47,22,58,15,18,6,31,37,22,0,2,9,10,121,3.64
9487,"John Jenkins\jenkijo01","2015-16",24,"TOT","NBA",0.2,43,3,480,71,160,55,109,16,51,20,24,8,49,57,35,8,1,27,22,178,3.46
9488,"Chris Jent\jentch01","1993-94",24,"HOU","NBA",0.2,3,0,78,13,26,9,15,4,11,1,2,4,11,15,7,0,0,5,13,31,9.5
9489,"Alexander Johnson\johnsal01","2007-08",24,"MIA","NBA",0.2,43,6,549,61,125,61,125,0,0,57,83,32,62,94,13,13,10,42,80,179,4
9490,"Amir Johnson\johnsam01","2005-06",18,"DET","NBA",0.2,3,0,39,7,10,5,7,2,3,4,4,3,1,4,3,0,2,4,7,20,6.97
9491,"Avery Johnson\johnsav01","2003-04",38,"GSW","NBA",0.2,46,1,637,80,199,80,196,0,3,52,78,3,30,33,111,26,3,51,34,212,4.64
9492,"Brice Johnson\johnsbr02","2017-18",23,"TOT","NBA",0.2,18,0,98,20,42,20,41,0,1,3,5,9,22,31,2,9,6,5,13,43,2.66
9493,"Chris Johnson\johnsch04","2012-13",22,"MEM","NBA",0.2,8,0,102,11,25,5,7,6,18,1,2,5,6,11,2,4,0,3,5,29,3.16
9494,"Chris Johnson\johnsch03","2011-12",26,"TOT","NBA",0.2,27,0,175,20,41,20,41,0,0,15,19,15,25,40,2,6,9,15,33,55,2.31
9495,"Chris Johnson\johnsch03","2010-11",25,"TOT","NBA",0.2,14,1,138,9,21,9,21,0,0,15,20,12,20,32,3,3,9,10,21,33,3.15
9496,"JaJuan Johnson\johnsja02","2011-12",22,"BOS","NBA",0.2,36,0,298,54,121,54,121,0,0,6,9,20,38,58,6,5,14,14,25,114,2.55
9497,"Charles Jones\jonesch01","1997-98",40,"HOU","NBA",0.2,24,0,127,7,10,7,10,0,0,1,2,12,12,24,5,1,6,4,22,15,1.2
9498,"Charles Jones\jonesch01","1996-97",39,"HOU","NBA",0.2,12,0,93,2,5,2,5,0,0,0,0,5,8,13,3,2,4,0,8,4,1.12
9499,"Dominique Jones\jonesdo02","2011-12",23,"DAL","NBA",0.2,33,1,268,29,73,28,65,1,8,29,37,9,35,44,42,10,5,28,28,88,3.21
9500,"James Jones\jonesja02","2012-13",32,"MIA","NBA",0.2,38,0,221,21,61,5,8,16,53,2,4,0,22,22,13,2,6,3,16,60,1.29
9501,"Jemerrio Jones\jonesje01","2018-19",23,"LAL","NBA",0.2,6,2,143,12,33,10,23,2,10,1,2,16,33,49,13,7,5,5,10,27,7.92
9502,"Kevin Jones\joneske01","2012-13",23,"CLE","NBA",0.2,32,0,334,43,107,43,107,0,0,9,15,38,40,78,10,9,5,8,25,95,2.68
9503,"Perry Jones\jonespe01","2014-15",23,"OKC","NBA",0.2,43,13,631,73,184,59,124,14,60,24,37,6,70,76,18,17,8,24,50,184,3.37
9504,"Coby Karl\karlco01","2007-08",24,"LAL","NBA",0.2,17,0,71,9,26,5,13,4,13,8,10,3,11,14,9,4,2,5,4,30,1.88
9505,"Sasha Kaun\kaunsa01","2015-16",30,"CLE","NBA",0.2,25,0,95,9,17,9,17,0,0,5,11,12,14,26,3,4,5,7,11,23,1.29
9506,"Gerard King\kingge02","1998-99",26,"SAS","NBA",0.2,19,0,63,6,14,6,14,0,0,11,18,6,8,14,4,2,1,4,12,23,1.26
9507,"Kerry Kittles\kittlke01","2004-05",30,"LAC","NBA",0.2,11,0,243,28,73,21,52,7,21,6,10,1,31,32,20,8,3,7,12,69,5.85
9508,"Brevin Knight\knighbr01","2002-03",27,"MEM","NBA",0.2,55,4,928,97,228,95,220,2,8,20,37,15,66,81,233,69,2,94,123,216,6.44
9509,"Travis Knight\knightr01","2002-03",28,"NYK","NBA",0.2,32,0,287,25,65,25,64,0,1,10,13,18,44,62,14,8,9,10,44,60,2.26
9510,"Kosta Koufos\koufoko01","2010-11",21,"TOT","NBA",0.2,50,2,434,68,150,68,148,0,2,24,43,57,73,130,7,10,25,31,59,160,3.18
9511,"Raef LaFrentz\lafrera01","2006-07",30,"POR","NBA",0.2,27,9,352,39,102,37,79,2,23,20,26,25,45,70,8,7,11,13,57,100,3.34
9512,"Jeremy Lamb\lambje01","2012-13",20,"OKC","NBA",0.2,23,0,147,24,68,15,38,9,30,14,14,5,13,18,5,2,2,6,13,71,2.05
9513,"Sean Lampley\lamplse01","2003-04",24,"GSW","NBA",0.2,10,0,63,13,20,13,20,0,0,8,12,2,9,11,2,0,1,3,2,34,3.01
9514,"Nicolás Laprovíttola\laproni01","2016-17",27,"SAS","NBA",0.2,18,3,174,20,47,10,20,10,27,9,9,1,9,10,28,4,1,19,19,59,3.47
9515,"Eric Leckner\leckner01","1995-96",29,"DET","NBA",0.2,18,8,155,18,29,18,29,0,0,8,13,8,26,34,1,2,4,11,30,44,2.67
9516,"Alex Len\lenal01","2013-14",20,"PHO","NBA",0.2,42,3,362,33,78,33,78,0,0,20,31,39,60,99,4,4,18,26,68,86,2.36
9517,"Jim Les\lesji01","1994-95",31,"ATL","NBA",0.2,24,0,188,11,38,6,15,5,23,23,27,6,20,26,44,4,0,21,28,50,2.98
9518,"Jon Leuer\leuerjo01","2012-13",23,"TOT","NBA",0.2,28,0,187,25,52,25,49,0,3,6,13,13,24,37,8,6,0,8,21,56,1.9
9519,"Todd Lichti\lichtto01","1993-94",27,"TOT","NBA",0.2,13,0,126,20,51,18,49,2,2,16,25,8,14,22,11,7,1,5,16,58,3.92
9520,"Randy Livingston\livinra01","2001-02",26,"SEA","NBA",0.2,13,0,176,15,54,14,46,1,8,10,11,9,16,25,26,9,2,2,11,41,3.65
9521,"Grant Long\longgr01","2001-02",35,"MEM","NBA",0.2,66,56,1868,164,385,161,368,3,17,86,123,31,200,231,136,63,12,103,123,417,6.93
9522,"Luc Longley\longllu01","1992-93",24,"MIN","NBA",0.2,55,25,1045,133,292,133,292,0,0,53,74,71,169,240,51,47,77,88,169,319,7.13
9523,"Jordan Loyd\loydjo01","2018-19",25,"TOR","NBA",0.2,12,0,55,8,18,4,10,4,8,9,11,1,8,9,6,0,0,2,5,29,2.22
9524,"Tyronn Lue\luety01","1998-99",21,"LAL","NBA",0.2,15,0,188,28,65,21,49,7,16,12,21,2,4,6,25,5,0,11,28,75,4.13
9525,"Timothé Luwawu-Cabarrot\luwawti01","2018-19",23,"TOT","NBA",0.2,50,7,669,82,218,46,102,36,116,31,41,11,86,97,26,19,8,21,73,231,3.78
9526,"Tyler Lydon\lydonty01","2018-19",22,"DEN","NBA",0.2,25,0,94,9,18,5,8,4,10,1,3,7,11,18,6,2,0,4,10,23,1.06
9527,"Kevin Lynch\lynchke01","1992-93",24,"CHH","NBA",0.2,40,8,324,30,59,30,58,0,1,26,38,12,23,35,25,11,6,24,44,86,2.47
9528,"Don MacLean\macledo01","1998-99",29,"SEA","NBA",0.2,17,10,365,63,159,54,126,9,33,50,80,18,47,65,16,5,5,25,34,185,7.8
9529,"Don MacLean\macledo01","2000-01",31,"MIA","NBA",0.2,8,1,76,10,20,8,18,2,2,9,12,7,11,18,4,5,1,10,9,31,4.44
9530,"Ian Mahinmi\mahinia01","2007-08",21,"SAS","NBA",0.2,6,0,23,6,12,6,12,0,0,9,9,0,5,5,1,0,4,2,4,21,3.42
9531,"Danny Manning\mannida01","2002-03",36,"DET","NBA",0.2,13,0,89,13,32,10,24,3,8,5,6,7,11,18,7,9,3,7,11,34,3.05
9532,"Sean Marks\marksse01","2009-10",34,"NOH","NBA",0.2,14,0,75,4,8,4,8,0,0,2,5,14,9,23,2,0,3,2,17,10,1.25
9533,"Sean Marks\marksse01","2004-05",29,"SAS","NBA",0.2,23,0,244,27,80,27,77,0,3,22,28,18,38,56,8,3,11,14,29,76,2.92
9534,"Donny Marshall\marshdo02","1995-96",23,"CLE","NBA",0.2,34,0,208,24,68,17,38,7,30,22,35,9,17,26,7,8,2,7,26,77,1.72
9535,"Donny Marshall\marshdo02","2001-02",29,"NJN","NBA",0.2,20,0,118,8,29,6,25,2,4,12,18,8,13,21,5,3,0,2,14,30,1.27
9536,"Rawle Marshall\marshra01","2005-06",23,"DAL","NBA",0.2,23,9,241,24,60,23,57,1,3,22,29,8,23,31,10,8,7,15,17,71,2.96
9537,"Darrick Martin\martida01","1998-99",27,"LAC","NBA",0.2,37,25,941,102,278,71,172,31,106,61,76,5,43,48,144,43,4,67,82,296,8.16
9538,"Kenyon Martin\martike01","2014-15",37,"MIL","NBA",0.2,11,0,104,9,22,9,22,0,0,2,2,6,13,19,5,5,6,3,13,20,2.59
9539,"Jamal Mashburn\mashbja01","1995-96",23,"DAL","NBA",0.2,18,18,669,145,383,110,281,35,102,97,133,37,60,97,50,14,3,55,39,422,15.97
9540,"Roger Mason\masonro01","2010-11",30,"NYK","NBA",0.2,26,0,319,26,77,10,33,16,44,7,10,5,38,43,20,6,2,6,25,75,2.65
9541,"Tony Massenburg\masseto01","1999-00",32,"HOU","NBA",0.2,10,0,109,16,36,16,36,0,0,14,16,7,20,27,3,2,5,9,13,46,4.48
9542,"Eric Maynor\maynoer01","2012-13",25,"TOT","NBA",0.2,64,0,963,106,281,72,185,34,96,45,62,9,37,46,182,22,1,79,55,291,4.66
9543,"CJ McCollum\mccolcj01","2013-14",22,"POR","NBA",0.2,38,0,476,74,178,44,98,30,80,23,34,7,41,48,27,14,2,35,53,201,4.08
9544,"Chris McCullough\mcculch01","2017-18",22,"WAS","NBA",0.2,19,0,90,18,42,17,34,1,8,9,14,7,18,25,4,0,5,2,8,46,2.01
9545,"Clint McDaniel\mcdancl01","1995-96",23,"SAC","NBA",0.2,12,0,71,8,23,6,17,2,6,12,16,3,7,10,7,5,0,2,10,30,2.45
9546,"K.J. McDaniels\mcdankj01","2015-16",22,"HOU","NBA",0.2,37,1,235,29,72,22,47,7,25,24,30,16,26,42,10,7,6,17,30,89,2.24
9547,"Jeff McInnis\mcinnje01","1998-99",24,"WAS","NBA",0.2,35,6,427,50,134,41,99,9,35,21,28,9,12,21,73,19,1,30,36,130,3.79
9548,"Ben McLemore\mclembe01","2018-19",25,"SAC","NBA",0.2,19,0,158,25,64,8,23,17,41,8,12,3,14,17,4,6,3,5,22,75,2.96
9549,"Keith McLeod\mcleoke01","2003-04",24,"MIN","NBA",0.2,33,0,391,27,82,26,72,1,10,33,43,5,29,34,59,16,1,29,39,88,3.3
9550,"Jordan McRae\mcraejo01","2016-17",25,"CLE","NBA",0.2,37,4,384,58,150,40,99,18,51,27,34,6,35,41,19,8,6,14,31,161,3.2
9551,"Stanislav Medvedenko\medvest01","2006-07",27,"ATL","NBA",0.2,14,0,81,12,29,11,27,1,2,17,20,4,10,14,2,0,2,5,16,42,2.41
9552,"Darko Miličić\milicda01","2010-11",25,"MIN","NBA",0.2,69,69,1686,271,578,271,578,0,0,64,115,133,227,360,104,54,140,151,229,606,9.54
9553,"Darko Miličić\milicda01","2007-08",22,"MEM","NBA",0.2,70,64,1663,219,500,219,499,0,1,67,121,127,297,424,58,32,114,101,185,505,7.76
9554,"Brad Miller\millebr01","2011-12",35,"MIN","NBA",0.2,15,1,146,9,27,2,12,7,15,10,12,4,15,19,24,4,2,12,10,35,3.25
9555,"Malcolm Miller\millema01","2017-18",24,"TOR","NBA",0.2,15,4,126,13,28,5,7,8,21,4,4,4,11,15,3,1,2,5,10,38,2.27
9556,"Malcolm Miller\millema01","2018-19",25,"TOR","NBA",0.2,10,0,67,11,26,1,5,10,21,3,4,1,4,5,1,1,1,1,5,35,2.52
9557,"Tony Mitchell\mitchto02","2013-14",21,"DET","NBA",0.2,21,0,79,5,12,4,11,1,1,11,19,15,11,26,2,6,3,4,9,22,1.54
9558,"Eric Mobley\mobleer01","1995-96",25,"TOT","NBA",0.2,39,4,676,74,138,73,136,1,2,39,87,54,86,140,22,14,24,50,87,188,5.23
9559,"Jérôme Moïso\moisoje01","2004-05",26,"TOT","NBA",0.2,20,1,120,9,18,9,17,0,1,10,13,10,27,37,1,3,6,7,13,28,2.02
9560,"Eric Montross\montrer01","2001-02",30,"TOR","NBA",0.2,49,24,655,53,132,53,131,0,1,10,31,36,104,140,16,12,23,25,92,116,2.69
9561,"E'Twaun Moore\mooreet01","2011-12",22,"BOS","NBA",0.2,38,0,331,43,113,26,68,17,45,7,7,4,29,33,34,11,3,21,33,110,2.58
9562,"E'Twaun Moore\mooreet01","2012-13",23,"ORL","NBA",0.2,75,21,1682,237,598,170,401,67,197,47,59,48,119,167,206,51,23,105,122,588,7.17
9563,"Darius Morris\morrida01","2012-13",22,"LAL","NBA",0.2,48,17,683,73,188,49,122,24,66,24,37,24,33,57,76,21,2,45,58,194,3.85
9564,"Monte Morris\morrimo01","2017-18",22,"DEN","NBA",0.2,3,0,25,4,6,4,5,0,1,2,2,0,2,2,7,3,0,1,1,10,5.37
9565,"Terence Morris\morrite01","2001-02",23,"HOU","NBA",0.2,68,12,1110,111,289,96,211,15,78,18,28,77,134,211,64,21,27,45,72,255,3.86
9566,"Dwayne Morton\mortodw01","1994-95",23,"GSW","NBA",0.2,41,6,395,50,129,41,104,9,25,58,85,21,37,58,18,11,15,27,45,167,3.49
9567,"Donatas Motiejūnas\motiedo01","2016-17",26,"NOP","NBA",0.2,34,0,479,57,138,46,91,11,47,25,49,26,75,101,32,18,11,31,55,150,4.56
9568,"Emmanuel Mudiay\mudiaem01","2016-17",20,"DEN","NBA",0.2,55,41,1406,208,551,152,373,56,178,131,167,29,149,178,217,41,13,123,95,603,10.17
9569,"Byron Mullens\mulleby01","2011-12",22,"CHA","NBA",0.2,65,25,1465,251,591,239,540,12,51,92,112,96,231,327,57,21,52,74,137,606,7.89
9570,"Mike Muscala\muscami01","2013-14",22,"ATL","NBA",0.2,20,0,215,31,73,31,70,0,3,14,14,17,35,52,7,3,10,12,29,76,3.65
9571,"Dikembe Mutombo\mutomdi01","2008-09",42,"HOU","NBA",0.2,9,2,96,5,13,5,13,0,0,6,9,12,21,33,0,0,11,6,11,16,3.18
9572,"Mamadou N'Diaye\ndiayma02","2004-05",29,"LAC","NBA",0.2,11,0,72,8,20,8,19,0,1,4,7,9,9,18,1,1,5,0,20,20,1.85
9573,"Boniface N'Dong\ndongbo01","2005-06",28,"LAC","NBA",0.2,23,1,152,22,53,22,52,0,1,6,9,15,22,37,7,2,5,6,23,50,1.99
9574,"Eduardo Nájera\najered01","2011-12",35,"CHA","NBA",0.2,22,0,270,24,64,16,35,8,29,2,4,11,39,50,12,19,4,7,40,58,3.28
9575,"Eduardo Nájera\najered01","2010-11",34,"CHA","NBA",0.2,31,0,372,26,72,15,38,11,34,6,11,14,30,44,20,11,6,13,52,69,2.38
9576,"Ruben Nembhard\nembhru01","1996-97",24,"TOT","NBA",0.2,10,0,113,16,37,16,31,0,6,8,10,3,5,8,17,9,0,8,12,40,4.38
9577,"Ira Newble\newblir01","2000-01",26,"SAS","NBA",0.2,27,6,184,21,55,17,46,4,9,8,16,13,22,35,6,2,4,7,18,54,1.62
9578,"Charles O'Bannon\obannch01","1997-98",22,"DET","NBA",0.2,30,0,234,26,69,26,66,0,3,12,15,14,19,33,17,9,1,9,15,64,1.99
9579,"Patrick O'Bryant\obryapa01","2007-08",21,"GSW","NBA",0.2,24,0,99,16,29,16,29,0,0,3,5,10,19,29,4,4,9,7,27,35,1.88
9580,"Mehmet Okur\okurme01","2010-11",31,"UTA","NBA",0.2,13,0,168,22,62,17,46,5,16,15,20,9,21,30,19,4,4,7,18,64,4.58
9581,"Jimmy Oliver\oliveji01","1993-94",24,"BOS","NBA",0.2,44,6,540,89,214,76,182,13,32,25,33,8,38,46,33,16,1,21,39,216,3.56
9582,"Bo Outlaw\outlabo01","2004-05",33,"PHO","NBA",0.2,39,0,214,12,34,12,34,0,0,5,9,16,37,53,13,6,12,8,29,29,1.36
9583,"Doug Overton\overtdo01","1995-96",26,"DEN","NBA",0.2,55,0,607,67,178,59,152,8,26,40,55,8,55,63,106,13,5,40,49,182,3.53
9584,"Billy Owens\owensbi01","1998-99",29,"SEA","NBA",0.2,21,19,451,65,165,60,154,5,11,28,35,35,45,80,38,12,4,33,37,163,6.86
9585,"Larry Owens\owensla01","2010-11",28,"TOT","NBA",0.2,12,0,143,15,32,9,19,6,13,4,9,1,14,15,8,9,5,5,18,40,3.81
9586,"Milt Palacio\palacmi01","2002-03",24,"CLE","NBA",0.2,80,46,1976,162,388,154,351,8,37,65,87,48,187,235,259,68,16,131,168,397,6.7
9587,"Milt Palacio\palacmi01","2005-06",27,"UTA","NBA",0.2,71,18,1376,171,403,170,387,1,16,98,150,17,117,134,190,47,14,110,125,441,6.34
9588,"Jannero Pargo\pargoja01","2014-15",35,"CHO","NBA",0.2,9,0,73,15,35,6,13,9,22,2,2,0,3,3,8,0,0,3,8,41,3.26
9589,"Jannero Pargo\pargoja01","2004-05",25,"CHI","NBA",0.2,32,0,453,82,213,59,147,23,66,17,23,12,35,47,76,16,1,45,53,204,5.44
9590,"Anthony Parker\parkean01","1999-00",24,"ORL","NBA",0.2,16,0,185,24,57,23,43,1,14,8,11,5,22,27,10,8,4,11,13,57,3.38
9591,"Cherokee Parks\parksch02","1998-99",26,"VAN","NBA",0.2,48,41,1118,118,275,118,274,0,1,30,55,75,168,243,36,28,28,49,114,266,5.85
9592,"Chandler Parsons\parsoch01","2016-17",28,"MEM","NBA",0.2,34,34,675,75,222,50,129,25,93,35,43,6,78,84,55,20,5,24,52,210,5.21
9593,"Lamar Patterson\pattela01","2015-16",24,"ATL","NBA",0.2,35,0,395,28,80,16,31,12,49,16,22,4,46,50,39,9,2,23,45,84,2.7
9594,"Ruben Patterson\patteru01","1998-99",23,"LAL","NBA",0.2,24,2,144,21,51,20,45,1,6,22,31,17,13,30,2,5,3,12,16,65,2.28
9595,"Sasha Pavlović\pavloal01","2007-08",24,"CLE","NBA",0.2,51,45,1188,146,403,112,289,34,114,53,77,35,93,128,82,29,6,55,117,379,5.64
9596,"Adreian Payne\paynead01","2017-18",26,"ORL","NBA",0.2,5,0,43,7,10,5,7,2,3,5,6,2,7,9,0,2,0,2,6,21,4.4
9597,"Adreian Payne\paynead01","2016-17",25,"MIN","NBA",0.2,18,0,135,23,54,20,39,3,15,14,19,9,24,33,7,8,7,8,32,63,3.52
9598,"Gary Payton\paytoga02","2017-18",25,"TOT","NBA",0.2,23,6,221,30,74,24,49,6,25,3,9,13,31,44,21,7,3,7,30,69,2.97
9599,"Will Perdue\perduwi01","1993-94",28,"CHI","NBA",0.2,43,6,397,47,112,47,111,0,1,23,32,40,86,126,34,8,11,42,61,117,3.34
9600,"Johan Petro\petrojo01","2008-09",23,"TOT","NBA",0.2,49,22,559,73,176,73,174,0,2,16,29,42,116,158,16,19,15,28,107,162,3.4
9601,"Kevinn Pinkney\pinknke01","2006-07",23,"BOS","NBA",0.2,6,0,100,12,27,11,25,1,2,6,9,7,8,15,5,3,3,4,12,31,5.05
9602,"Marshall Plumlee\plumlma02","2016-17",24,"NYK","NBA",0.2,21,1,170,16,30,16,30,0,0,8,19,23,28,51,10,4,4,12,23,40,2.63
9603,"Marshall Plumlee\plumlma02","2017-18",25,"MIL","NBA",0.2,8,0,52,1,3,1,3,0,0,12,16,4,13,17,2,0,1,3,10,14,2.45
9604,"Scot Pollard\pollasc01","2006-07",31,"CLE","NBA",0.2,24,0,109,11,26,11,26,0,0,2,4,15,16,31,3,4,1,4,27,24,1.19
9605,"Chris Porter\portech01","2000-01",22,"GSW","NBA",0.2,51,35,1147,173,445,173,440,0,5,94,141,89,100,189,61,45,6,59,111,440,6.79
9606,"Vitaly Potapenko\potapvi01","2002-03",27,"SEA","NBA",0.2,26,2,403,41,93,41,93,0,0,22,29,25,64,89,4,9,8,25,46,104,4.06
9607,"Kevin Pritchard\pritcke01","1995-96",28,"WSB","NBA",0.2,2,0,22,2,3,1,2,1,1,2,3,0,2,2,7,2,0,0,3,7,6.5
9608,"Kevin Pritchard\pritcke01","1994-95",27,"TOT","NBA",0.2,19,0,194,13,32,11,24,2,8,16,21,0,12,12,34,2,1,12,22,44,2.95
9609,"Mark Randall\randama01","1993-94",26,"DEN","NBA",0.2,28,0,155,17,50,15,36,2,14,22,28,9,13,22,11,8,3,10,18,58,1.93
9610,"Efthimi Rentzias\rentzef01","2002-03",27,"PHI","NBA",0.2,35,0,144,20,59,16,51,4,8,8,9,10,16,26,7,6,2,4,21,52,1.17
9611,"Pooh Richardson\richapo01","1997-98",31,"LAC","NBA",0.2,69,17,1252,124,333,113,276,11,57,30,43,17,79,96,226,44,3,54,71,289,4.97
9612,"Isaiah Rider\rideris01","2001-02",30,"DEN","NBA",0.2,10,1,173,37,81,31,66,6,15,13,17,10,23,33,12,3,2,14,11,93,7.55
9613,"Anthony Roberson\roberan02","2008-09",25,"TOT","NBA",0.2,29,0,276,44,120,18,39,26,81,5,5,6,16,22,20,10,1,8,18,119,2.97
9614,"Anthony Roberson\roberan02","2005-06",22,"MEM","NBA",0.2,16,0,88,14,31,9,21,5,10,2,2,0,6,6,5,1,0,3,6,35,1.61
9615,"Brian Roberts\roberbr01","2016-17",31,"CHO","NBA",0.2,41,2,416,46,122,29,78,17,44,33,39,5,34,39,52,9,1,26,18,142,3.28
9616,"Chris Robinson\robinch01","1996-97",22,"VAN","NBA",0.2,41,6,681,69,182,35,93,34,89,16,26,23,48,71,65,28,9,34,85,188,4.69
9617,"Duncan Robinson\robindu01","2018-19",24,"MIA","NBA",0.2,15,1,161,18,46,8,11,10,35,4,6,2,17,19,5,5,0,4,11,50,2.69
9618,"Eddie Robinson\robined01","2001-02",25,"CHI","NBA",0.2,29,12,653,112,247,110,242,2,5,36,48,24,54,78,37,23,11,36,35,262,7.48
9619,"James Robinson\robinja02","1997-98",27,"LAC","NBA",0.2,70,13,1231,195,501,121,276,74,225,77,107,37,74,111,135,37,10,97,101,541,6.27
9620,"James Robinson\robinja02","1993-94",23,"POR","NBA",0.2,58,3,673,104,285,81,212,23,73,45,67,34,44,78,68,30,15,52,69,276,3.94
9621,"Tree Rollins\rollitr01","1992-93",37,"HOU","NBA",0.2,42,0,247,11,41,11,39,0,2,9,12,12,48,60,10,6,15,9,43,31,1.26
9622,"Sean Rooks\rooksse01","2003-04",34,"TOT","NBA",0.2,55,0,595,54,151,54,150,0,1,33,37,24,73,97,29,14,10,22,89,141,2.46
9623,"Michael Ruffin\ruffimi01","2003-04",27,"UTA","NBA",0.2,41,23,733,38,117,38,117,0,0,16,38,78,129,207,41,22,21,42,103,92,4.02
9624,"Soumaila Samake\samakso01","2002-03",24,"LAL","NBA",0.2,13,1,77,10,24,10,24,0,0,2,2,10,13,23,4,0,5,2,13,22,1.9
9625,"Jamal Sampson\sampsja01","2006-07",23,"DEN","NBA",0.2,22,3,125,9,14,9,13,0,1,6,14,15,33,48,5,2,7,10,17,24,2.01
9626,"Jamal Sampson\sampsja01","2005-06",22,"SAC","NBA",0.2,12,0,39,5,7,5,7,0,0,0,2,5,13,18,5,0,4,0,5,10,1.65
9627,"Melvin Sanders\sandeme01","2005-06",25,"SAS","NBA",0.2,16,0,113,16,33,14,30,2,3,7,10,4,19,23,3,5,0,8,20,41,2.46
9628,"Brian Scalabrine\scalabr01","2009-10",31,"BOS","NBA",0.2,52,3,472,29,85,13,36,16,49,4,6,9,39,48,27,9,4,17,59,78,1.52
9629,"Dwayne Schintzius\schindw01","1993-94",25,"NJN","NBA",0.2,30,7,319,29,84,29,84,0,0,10,17,26,63,89,13,7,17,13,49,68,2.72
9630,"Shawnelle Scott\scottsh01","2000-01",28,"SAS","NBA",0.2,27,1,144,17,41,17,41,0,0,9,22,23,27,50,4,5,6,11,23,43,1.77
9631,"Shawnelle Scott\scottsh01","1996-97",24,"CLE","NBA",0.2,16,0,50,8,16,8,16,0,0,4,11,8,8,16,0,0,3,0,6,20,1.11
9632,"Malik Sealy\sealyma01","1992-93",22,"IND","NBA",0.2,58,2,672,136,319,129,288,7,31,51,74,60,52,112,47,36,7,58,74,330,4.66
9633,"Mouhamed Sene\senesa01","2007-08",21,"SEA","NBA",0.2,13,0,62,11,24,11,24,0,0,8,17,7,9,16,1,0,7,0,9,30,2
9634,"Mouhamed Sene\senesa01","2008-09",22,"TOT","NBA",0.2,6,0,29,6,9,6,9,0,0,8,10,5,9,14,0,1,3,4,2,20,4
9635,"Kevin Séraphin\serapke01","2010-11",21,"WAS","NBA",0.2,58,1,635,66,147,66,147,0,0,22,31,80,72,152,10,17,28,42,126,154,3.07
9636,"Ansu Sesay\sesayan01","2004-05",28,"GSW","NBA",0.2,16,0,128,17,42,15,34,2,8,13,24,18,20,38,12,2,3,8,16,49,3.11
9637,"Alexey Shved\shvedal01","2013-14",25,"MIN","NBA",0.2,63,0,664,76,237,46,135,30,102,68,90,21,60,81,68,26,16,48,36,250,3.54
9638,"Chris Singleton\singlch01","2013-14",24,"WAS","NBA",0.2,25,0,250,25,67,18,48,7,19,18,25,18,37,55,6,9,3,17,25,75,2.9
9639,"Reggie Slater\slatere01","1998-99",28,"TOR","NBA",0.2,30,0,263,31,81,31,81,0,0,53,85,36,34,70,5,3,3,25,50,115,3.15
9640,"Donta Smith\smithdo04","2004-05",21,"ATL","NBA",0.2,38,0,433,44,113,38,91,6,22,33,48,19,33,52,39,23,5,25,50,127,3.53
9641,"Greg Smith\smithgr02","2015-16",25,"MIN","NBA",0.2,18,0,192,18,32,18,32,0,0,7,17,12,30,42,6,4,1,7,28,43,2.75
9642,"Greg Smith\smithgr02","2013-14",23,"HOU","NBA",0.2,11,0,100,18,28,18,28,0,0,2,5,11,16,27,0,1,2,5,17,38,3.42
9643,"Greg Smith\smithgr02","2011-12",21,"HOU","NBA",0.2,8,0,69,7,11,7,11,0,0,0,0,5,15,20,1,2,5,1,17,14,2.91
9644,"J.R. Smith\smithjr01","2004-05",19,"NOH","NBA",0.2,76,56,1859,295,748,214,467,81,281,111,161,39,113,152,142,55,11,109,135,782,7.62
9645,"Jabari Smith\smithja01","2000-01",23,"SAC","NBA",0.2,9,0,66,11,22,11,22,0,0,4,6,1,7,8,6,4,0,3,7,26,2.84
9646,"Jason Smith\smithja02","2018-19",32,"TOT","NBA",0.2,20,1,190,21,59,12,33,9,26,14,16,16,36,52,14,3,7,13,30,65,3.49
9647,"Leon Smith\smithle01","2001-02",21,"ATL","NBA",0.2,14,0,100,10,26,10,26,0,0,11,17,10,21,31,3,5,1,3,12,31,2.47
9648,"Pape Sow\sowpa01","2004-05",23,"TOR","NBA",0.2,27,4,255,23,58,23,58,0,0,16,27,18,39,57,2,12,4,10,46,62,2.41
9649,"Ray Spalding\spaldra01","2018-19",21,"TOT","NBA",0.2,14,3,148,25,47,25,44,0,3,4,12,15,33,48,5,9,8,9,23,54,4.66
9650,"Elmore Spencer\spencel01","1992-93",23,"LAC","NBA",0.2,44,4,280,44,82,44,82,0,0,16,32,17,45,62,8,8,18,26,54,104,2.47
9651,"Jerry Stackhouse\stackje01","2003-04",29,"WAS","NBA",0.2,26,17,774,128,321,105,256,23,65,83,103,16,78,94,103,24,3,88,49,362,12.17
9652,"Vladimir Stepania\stepavl01","2000-01",24,"NJN","NBA",0.2,29,0,280,28,88,27,84,1,4,25,34,35,74,109,16,10,11,19,47,82,3.47
9653,"Kebu Stewart\stewake01","1997-98",24,"PHI","NBA",0.2,15,0,110,12,26,12,26,0,0,16,25,9,22,31,2,5,2,8,13,40,2.88
9654,"Michael Stewart\stewami01","2003-04",28,"TOT","NBA",0.2,25,2,147,5,12,5,12,0,0,3,4,8,21,29,0,2,10,3,34,13,1.07
9655,"Michael Stewart\stewami01","1999-00",24,"TOR","NBA",0.2,42,1,389,20,53,20,53,0,0,18,32,33,61,94,6,5,19,17,81,58,1.99
9656,"Michael Stewart\stewami01","2004-05",29,"ATL","NBA",0.2,12,1,145,11,21,11,21,0,0,3,7,21,19,40,5,6,5,6,32,25,3.51
9657,"Julyan Stone\stoneju01","2013-14",25,"TOR","NBA",0.2,21,0,120,7,17,5,9,2,8,2,3,2,18,20,12,3,0,5,13,18,1.33
9658,"Awvee Storey\storeaw01","2007-08",30,"MIL","NBA",0.2,26,0,259,39,89,39,82,0,7,14,29,31,23,54,16,7,1,10,41,92,3.07
9659,"Derek Strong\stronde01","1999-00",31,"ORL","NBA",0.2,20,0,148,21,48,20,44,1,4,11,14,11,33,44,4,5,2,12,15,54,2.72
9660,"DaJuan Summers\summeda01","2011-12",24,"NOH","NBA",0.2,15,6,209,28,65,23,49,5,16,7,9,8,15,23,10,7,0,8,31,68,3.74
9661,"Bruno Šundov\sundobr01","2000-01",20,"IND","NBA",0.2,11,4,120,20,41,20,37,0,4,3,5,4,19,23,2,2,4,3,21,43,3.35
9662,"Greg Sutton\suttogr01","1995-96",28,"TOT","NBA",0.2,48,2,655,85,217,38,100,47,117,35,46,8,42,50,102,25,2,62,92,252,5.16
9663,"Žan Tabak\tabakza01","1994-95",24,"HOU","NBA",0.2,37,0,182,24,53,24,52,0,1,27,44,23,34,57,4,2,7,18,37,75,1.98
9664,"Edy Tavares\tavarwa01","2015-16",23,"ATL","NBA",0.2,11,0,73,11,19,11,19,0,0,3,8,7,14,21,3,1,6,5,8,25,2.71
9665,"Donell Taylor\taylodo01","2005-06",23,"WAS","NBA",0.2,51,1,465,53,136,49,119,4,17,30,43,16,37,53,45,30,4,34,47,140,2.87
9666,"Johnny Taylor\taylojo01","1998-99",24,"DEN","NBA",0.2,36,9,724,82,198,56,130,26,68,17,23,30,71,101,24,28,17,34,97,207,5.44
9667,"Jason Terry\terryja01","2013-14",36,"BRK","NBA",0.2,35,0,570,55,152,16,49,39,103,10,15,4,33,37,56,13,0,27,48,159,3.99
9668,"Billy Thomas\thomabi01","2005-06",30,"WAS","NBA",0.2,17,0,131,13,40,3,10,10,30,2,2,5,9,14,9,10,1,6,19,38,2.22
9669,"Etan Thomas\thomaet01","2010-11",32,"ATL","NBA",0.2,13,0,82,10,21,10,21,0,0,12,15,6,17,23,2,1,4,5,11,32,2.65
9670,"Etan Thomas\thomaet01","2009-10",31,"OKC","NBA",0.2,23,1,321,31,68,31,68,0,0,13,22,18,46,64,1,4,16,18,39,75,3.38
9671,"Isaiah Thomas\thomais02","2017-18",28,"TOT","NBA",0.2,32,15,862,157,421,102,233,55,188,117,131,17,50,67,153,15,3,95,58,486,12.48
9672,"Isiah Thomas\thomais01","1993-94",32,"DET","NBA",0.2,58,56,1750,318,763,279,637,39,126,181,258,46,113,159,399,68,6,202,126,856,14.37
9673,"James Thomas\thomaja02","2005-06",25,"TOT","NBA",0.2,22,0,150,10,19,10,19,0,0,8,14,12,27,39,1,0,3,7,35,28,1.58
9674,"James Thomas\thomaja02","2004-05",24,"TOT","NBA",0.2,11,2,117,12,20,12,20,0,0,2,6,17,20,37,4,4,4,7,13,26,3.6
9675,"Malcolm Thomas\thomama01","2012-13",24,"TOT","NBA",0.2,12,0,57,5,10,5,10,0,0,5,8,5,11,16,4,2,2,3,8,15,1.78
9676,"Brooks Thompson\thompbr01","1997-98",27,"TOT","NBA",0.2,30,0,167,23,56,14,26,9,30,4,8,1,14,15,27,10,1,16,22,59,2.1
9677,"LaSalle Thompson\thompla01","1995-96",34,"PHI","NBA",0.2,44,11,773,33,83,33,83,0,0,19,24,62,137,199,26,19,20,37,125,85,3.84
9678,"Óscar Torres\torreos01","2002-03",26,"GSW","NBA",0.2,17,0,109,16,36,9,23,7,13,14,20,3,9,12,3,4,2,8,9,53,2.59
9679,"Jeff Trepagnier\trepaje01","2002-03",23,"DEN","NBA",0.2,8,0,97,17,40,13,32,4,8,7,7,8,8,16,6,8,0,8,5,45,5.3
9680,"Alando Tucker\tuckeal02","2008-09",24,"PHO","NBA",0.2,30,1,282,52,121,44,98,8,23,26,33,19,12,31,12,5,1,14,14,138,3.26
9681,"Roko Ukić\ukicro01","2009-10",25,"MIL","NBA",0.2,13,0,97,14,30,11,18,3,12,9,11,0,3,3,12,1,0,6,6,40,2.65
9682,"Jarrod Uthoff\uthofja01","2016-17",23,"DAL","NBA",0.2,9,0,115,16,38,13,29,3,9,5,7,8,14,22,9,2,4,3,8,40,4.32
9683,"Ben Uzoh\uzohbe01","2011-12",23,"TOT","NBA",0.2,18,8,370,35,99,35,98,0,1,11,19,19,48,67,61,17,3,19,31,81,6.17
9684,"Fred VanVleet\vanvlfr01","2016-17",22,"TOR","NBA",0.2,37,0,294,39,111,28,82,11,29,18,22,4,38,42,35,16,3,15,36,107,2.78
9685,"Anderson Varejão\varejan01","2016-17",34,"GSW","NBA",0.2,14,1,92,5,14,5,14,0,0,8,11,12,15,27,10,3,3,8,16,18,2.28
9686,"David Vaughn\vaughda02","1998-99",25,"NJN","NBA",0.2,10,0,103,13,24,13,24,0,0,8,10,13,21,34,1,2,8,11,22,34,4.35
9687,"Rashad Vaughn\vaughra01","2017-18",21,"TOT","NBA",0.2,28,0,212,23,56,9,19,14,37,4,6,3,18,21,13,5,3,6,15,64,2.06
9688,"Loy Vaught\vaughlo01","1999-00",31,"DET","NBA",0.2,43,0,292,32,89,32,86,0,3,11,16,26,65,91,11,6,4,11,45,75,1.78
9689,"Charlie Villanueva\villach01","2015-16",31,"DAL","NBA",0.2,62,4,665,125,327,78,155,47,172,22,24,24,128,152,24,18,15,31,71,319,3.96
9690,"Jake Voskuhl\voskuja01","2007-08",30,"MIL","NBA",0.2,44,0,386,37,80,37,80,0,0,24,29,30,67,97,13,9,21,29,83,98,2.87
9691,"Sasha Vujačić\vujacsa01","2004-05",20,"LAL","NBA",0.2,35,3,403,33,117,16,54,17,63,18,19,13,49,62,51,12,2,15,41,101,3.02
9692,"Moritz Wagner\wagnemo01","2018-19",21,"LAL","NBA",0.2,43,5,446,71,171,49,94,22,77,43,53,17,68,85,24,11,13,39,57,207,4.25
9693,"Darrell Walker\walkeda01","1992-93",31,"TOT","NBA",0.2,37,2,511,34,96,34,95,0,1,12,26,22,36,58,53,33,2,25,63,80,3.12
9694,"Casper Ware\wareca01","2013-14",24,"PHI","NBA",0.2,9,0,116,18,42,11,21,7,21,5,6,0,9,9,10,8,0,5,11,48,4.89
9695,"Willie Warren\warrewi01","2010-11",21,"LAC","NBA",0.2,19,0,134,13,35,8,20,5,15,6,8,1,11,12,27,6,0,8,16,37,2.45
9696,"Travis Wear\weartr01","2017-18",27,"LAL","NBA",0.2,17,0,228,25,72,8,25,17,47,8,8,0,38,38,7,4,5,6,30,75,3.66
9697,"Robert Werdann\werdaro01","1995-96",25,"NJN","NBA",0.2,13,0,93,16,32,16,32,0,0,7,13,5,18,23,2,5,3,6,17,39,2.95
9698,"David West\westda01","2004-05",24,"NOH","NBA",0.2,30,8,552,75,172,73,167,2,5,34,50,40,89,129,23,12,16,37,62,186,6
9699,"Mario West\westma02","2010-11",26,"NJN","NBA",0.2,6,3,116,9,21,8,17,1,4,3,5,2,9,11,10,7,0,2,13,22,4.75
9700,"Mark West\westma01","1999-00",39,"PHO","NBA",0.2,22,2,127,5,12,5,12,0,0,5,8,6,25,31,2,2,4,6,23,15,1.18
9701,"DeJuan Wheat\wheatde01","1997-98",24,"MIN","NBA",0.2,34,0,150,20,50,12,33,8,17,9,15,3,8,11,25,6,1,9,12,57,1.65
9702,"D.J. White\whitedj01","2012-13",26,"BOS","NBA",0.2,12,0,86,12,23,12,23,0,0,5,9,4,9,13,4,1,6,2,5,29,2.44
9703,"Jahidi White\whiteja01","1998-99",22,"WAS","NBA",0.2,20,0,191,17,32,17,32,0,0,15,35,23,35,58,1,3,11,16,39,49,3
9704,"Okaro White\whiteok01","2017-18",25,"MIA","NBA",0.2,6,4,80,7,16,3,5,4,11,2,3,3,8,11,2,1,1,1,6,20,3.12
9705,"Randy White\whitera01","1993-94",26,"DAL","NBA",0.2,18,3,320,45,112,39,92,6,20,19,33,30,53,83,11,10,10,18,46,115,5.94
9706,"Hassan Whiteside\whiteha01","2011-12",22,"SAC","NBA",0.2,18,0,109,12,27,12,27,0,0,5,12,16,23,39,0,3,15,5,12,29,2.29
9707,"Chris Whitney\whitnch01","2003-04",32,"WAS","NBA",0.2,16,5,186,17,45,9,27,8,18,5,5,3,12,15,14,6,2,6,6,47,2.84
9708,"Chris Wilcox\wilcoch01","2009-10",27,"DET","NBA",0.2,34,10,441,63,120,63,120,0,0,26,52,44,73,117,13,13,12,38,64,152,4.71
9709,"Mike Wilks\wilksmi01","2007-08",28,"TOT","NBA",0.2,15,0,188,17,36,14,28,3,8,4,4,5,14,19,14,9,0,9,13,41,3.27
9710,"Alan Williams\willial03","2015-16",23,"PHO","NBA",0.2,10,0,68,10,24,10,24,0,0,9,14,14,24,38,5,4,5,6,15,29,4.04
9711,"Alan Williams\willial03","2018-19",26,"BRK","NBA",0.2,5,0,26,8,13,8,12,0,1,2,4,4,15,19,3,1,0,1,2,18,4.4
9712,"Corey Williams\willico01","1992-93",22,"CHI","NBA",0.2,35,0,242,31,85,30,82,1,3,18,22,19,12,31,23,4,2,11,24,81,1.89
9713,"Eric Williams\willier01","1998-99",26,"DEN","NBA",0.2,38,8,780,80,219,74,193,6,26,111,139,34,47,81,37,27,8,49,76,277,6.19
9714,"Herb Williams\willihe01","1997-98",39,"NYK","NBA",0.2,27,0,178,18,43,18,43,0,0,1,8,6,23,29,4,6,9,5,34,37,1.41
9715,"Herb Williams\willihe01","1996-97",38,"NYK","NBA",0.2,21,2,184,18,46,18,45,0,1,3,4,9,22,31,5,4,5,5,18,39,1.76
9716,"Jason Williams\willija02","2010-11",35,"TOT","NBA",0.2,27,0,295,22,67,12,29,10,38,0,0,3,27,30,52,11,1,18,8,54,2.81
9717,"Jayson Williams\willija01","1992-93",24,"NJN","NBA",0.2,12,2,139,21,46,21,46,0,0,7,18,22,19,41,0,4,4,8,24,49,3.67
9718,"Jerome Williams\willije01","1996-97",23,"DET","NBA",0.2,33,0,177,20,51,20,51,0,0,9,17,22,28,50,7,13,1,13,18,49,1.72
9719,"Justin Williams\williju01","2007-08",23,"TOT","NBA",0.2,23,0,123,13,29,13,29,0,0,8,26,20,29,49,0,5,5,4,17,34,1.73
9720,"Marcus Williams\willima03","2007-08",22,"NJN","NBA",0.2,53,7,854,111,293,57,151,54,142,37,47,14,87,101,140,25,3,75,52,313,5.92
9721,"Mo Williams\willima01","2003-04",21,"UTA","NBA",0.2,57,0,772,115,303,105,264,10,39,44,56,23,49,72,76,28,2,51,87,284,3.94
9722,"Reggie Williams\willire02","2014-15",28,"SAS","NBA",0.2,20,0,105,15,39,12,20,3,19,4,4,5,12,17,10,1,0,2,12,37,1.53
9723,"Reggie Williams\willire02","2016-17",30,"NOP","NBA",0.2,6,0,79,8,23,3,12,5,11,6,7,2,4,6,4,3,0,0,2,27,3.65
9724,"Shammond Williams\willish01","1999-00",24,"SEA","NBA",0.2,43,5,517,84,225,60,144,24,81,33,51,12,40,52,78,18,0,40,39,225,4.36
9725,"Corliss Williamson\willico02","2005-06",32,"SAC","NBA",0.2,37,0,362,43,103,41,101,2,2,38,49,21,46,67,14,7,4,30,56,126,3.06
9726,"Trevor Wilson\wilsotr01","1995-96",27,"PHI","NBA",0.2,6,0,79,10,20,10,20,0,0,3,4,7,7,14,4,3,0,1,9,23,4
9727,"Qyntel Woods\woodsqy01","2002-03",21,"POR","NBA",0.2,53,0,334,59,118,56,109,3,9,7,20,15,38,53,12,15,1,23,36,128,2.06
9728,"Randy Woods\woodsra01","1994-95",24,"LAC","NBA",0.2,62,3,495,37,117,15,43,22,74,28,38,10,34,44,134,41,0,55,87,124,3.31
9729,"Bracey Wright\wrighbr02","2005-06",21,"MIN","NBA",0.2,7,0,135,21,51,15,34,6,17,14,16,3,15,18,5,1,0,8,8,62,6.51
9730,"Dorell Wright\wrighdo01","2005-06",20,"MIA","NBA",0.2,20,2,132,20,43,17,37,3,6,15,17,2,30,32,8,3,1,14,12,58,2.86
9731,"Danny Young\youngda01","1994-95",32,"MIL","NBA",0.2,7,0,77,9,17,4,5,5,12,1,1,1,4,5,12,4,0,4,8,24,4.3
9732,"Sam Young\youngsa01","2011-12",26,"TOT","NBA",0.2,35,2,375,45,127,40,110,5,17,19,26,20,42,62,15,17,6,16,23,114,2.77
9733,"Tim Young\youngti01","1999-00",23,"GSW","NBA",0.2,25,0,137,13,39,13,39,0,0,28,36,13,22,35,5,2,1,9,18,54,1.96
9734,"Wang Zhizhi\zhizhwa01","2004-05",27,"MIA","NBA",0.2,20,0,92,17,36,15,33,2,3,7,12,6,12,18,5,3,2,5,9,43,1.88
9735,"Jaylen Adams\adamsja01","2018-19",22,"ATL","NBA",0.1,34,1,428,38,110,13,36,25,74,7,9,11,49,60,65,14,5,28,45,108,3.89
9736,"Jeff Adrien\adrieje01","2011-12",25,"HOU","NBA",0.1,8,0,63,7,16,7,16,0,0,7,12,5,17,22,1,0,2,2,13,21,2.69
9737,"Arron Afflalo\afflaar01","2017-18",32,"ORL","NBA",0.1,53,3,682,65,162,38,92,27,70,22,26,4,62,66,30,4,9,21,56,179,2.79
9738,"Blake Ahearn\ahearbl01","2008-09",24,"SAS","NBA",0.1,3,0,19,2,6,0,2,2,4,2,2,0,1,1,2,1,0,1,3,8,2.47
9739,"Malik Allen\allenma01","2009-10",31,"DEN","NBA",0.1,51,3,456,46,116,45,110,1,6,12,13,36,46,82,16,11,5,22,68,105,1.97
9740,"Tony Allen\allento01","2017-18",36,"NOP","NBA",0.1,22,0,273,44,91,40,79,4,12,11,21,20,27,47,9,11,3,19,49,103,4.14
9741,"Morris Almond\almonmo01","2008-09",23,"UTA","NBA",0.1,25,1,255,33,81,28,64,5,17,21,26,9,27,36,7,4,4,16,31,92,2.9
9742,"Ashraf Amaya\amayaas01","1996-97",25,"WSB","NBA",0.1,31,0,144,12,40,11,39,1,1,15,28,19,33,52,3,7,3,10,29,40,1.41
9743,"Lou Amundson\amundlo01","2006-07",24,"TOT","NBA",0.1,11,0,89,6,15,6,15,0,0,4,10,13,15,28,1,1,8,5,15,16,2.18
9744,"Lou Amundson\amundlo01","2013-14",31,"TOT","NBA",0.1,19,0,185,16,32,16,32,0,0,6,24,28,27,55,6,9,11,14,49,38,3.04
9745,"Lou Amundson\amundlo01","2007-08",25,"PHI","NBA",0.1,16,0,64,8,16,8,16,0,0,2,7,7,5,12,0,1,1,2,13,18,0.91
9746,"Lou Amundson\amundlo01","2012-13",30,"TOT","NBA",0.1,39,0,372,32,81,32,81,0,0,12,36,48,58,106,11,16,12,19,53,76,2.49
9747,"Alan Anderson\anderal01","2006-07",24,"CHA","NBA",0.1,17,0,256,37,81,32,61,5,20,19,23,11,21,32,21,7,0,22,33,98,5.24
9748,"Alan Anderson\anderal01","2016-17",34,"LAC","NBA",0.1,30,0,308,30,80,16,36,14,44,12,16,3,21,24,11,3,0,7,35,86,2.02
9749,"Eric Anderson\anderer01","1993-94",23,"NYK","NBA",0.1,11,0,39,7,17,5,15,2,2,5,14,6,11,17,2,0,1,2,9,21,1.56
9750,"Eric Anderson\anderer01","1992-93",22,"NYK","NBA",0.1,16,0,44,5,18,5,18,0,0,11,13,6,8,14,3,3,1,5,14,21,1.31
9751,"Ike Anigbogu\anigbik01","2017-18",19,"IND","NBA",0.1,11,0,30,4,9,4,9,0,0,5,6,5,4,9,0,1,3,2,1,13,1.33
9752,"Rafael Araújo\araujra01","2006-07",26,"UTA","NBA",0.1,28,0,248,27,65,27,65,0,0,18,29,22,44,66,10,6,2,17,39,72,2.63
9753,"Darrell Armstrong\armstda01","1995-96",27,"ORL","NBA",0.1,13,0,41,16,32,10,20,6,12,4,4,0,2,2,5,6,0,6,4,42,2.79
9754,"Darrell Armstrong\armstda01","1994-95",26,"ORL","NBA",0.1,3,0,8,3,8,1,2,2,6,2,2,1,0,1,3,1,0,1,3,10,3.03
9755,"Vin Baker\bakervi01","2005-06",34,"LAC","NBA",0.1,8,1,85,7,15,7,15,0,0,13,18,2,17,19,4,4,4,9,13,27,4.31
9756,"Renaldo Balkman\balkmre01","2010-11",26,"TOT","NBA",0.1,8,0,62,6,13,5,11,1,2,3,4,2,5,7,2,4,2,1,15,16,2.31
9757,"J.J. Barea\bareajo01","2006-07",22,"DAL","NBA",0.1,33,1,191,28,78,22,57,6,21,16,24,7,18,25,24,1,1,14,19,78,1.82
9758,"Andrea Bargnani\bargnan01","2012-13",27,"TOR","NBA",0.1,35,25,1003,170,426,132,303,38,123,65,77,26,102,128,38,21,23,54,64,443,9.23
9759,"Dana Barros\barroda01","2003-04",36,"BOS","NBA",0.1,1,0,11,2,3,2,3,0,0,2,2,0,0,0,0,0,0,0,2,6,4.7
9760,"Drew Barry\barrydr01","1999-00",26,"TOT","NBA",0.1,16,0,159,15,33,8,15,7,18,4,5,0,12,12,33,2,0,13,23,41,3.34
9761,"Brandon Bass\bassbr01","2005-06",20,"NOK","NBA",0.1,29,1,268,28,70,28,70,0,0,12,19,18,50,68,3,3,7,11,18,68,2.23
9762,"Mengke Bateer\bateeme01","2003-04",28,"TOR","NBA",0.1,7,0,40,4,7,4,7,0,0,0,0,5,3,8,1,1,0,2,10,8,1.37
9763,"Mengke Bateer\bateeme01","2001-02",26,"DEN","NBA",0.1,27,10,408,53,132,49,120,4,12,29,37,32,64,96,22,10,5,32,94,139,4.89
9764,"Esteban Batista\batises01","2005-06",22,"ATL","NBA",0.1,57,3,495,34,80,34,79,0,1,33,53,61,83,144,7,15,11,38,111,101,2.38
9765,"Kenny Battle\battlke01","1992-93",28,"BOS","NBA",0.1,3,1,29,6,13,6,12,0,1,2,2,7,4,11,2,1,0,2,2,14,4.7
9766,"Aron Baynes\baynear01","2012-13",26,"SAS","NBA",0.1,16,0,141,18,36,18,35,0,1,7,12,12,20,32,5,1,6,11,23,43,2.78
9767,"Kent Bazemore\bazemke01","2012-13",23,"GSW","NBA",0.1,61,0,267,43,116,33,82,10,34,27,44,5,17,22,22,17,4,18,27,123,1.58
9768,"Dragan Bender\bendedr01","2017-18",20,"PHO","NBA",0.1,82,37,2069,187,484,69,162,118,322,39,51,40,321,361,130,22,53,112,166,531,6.79
9769,"Anthony Bennett\bennean01","2015-16",22,"TOR","NBA",0.1,19,0,84,8,27,5,13,3,14,9,10,6,17,23,0,5,0,4,8,28,1.37
9770,"Elmer Bennett\benneel01","1994-95",24,"CLE","NBA",0.1,4,0,18,6,11,6,9,0,2,3,4,0,1,1,3,4,0,3,3,15,3.95
9771,"Chauncey Billups\billuch01","1999-00",23,"DEN","NBA",0.1,13,5,305,34,101,27,60,7,41,37,44,8,26,34,39,10,2,24,27,112,8.03
9772,"DeJuan Blair\blairde01","2014-15",25,"WAS","NBA",0.1,29,0,180,26,57,26,57,0,0,4,6,16,40,56,3,7,1,13,41,56,2
9773,"Andray Blatche\blatcan01","2005-06",19,"WAS","NBA",0.1,29,0,175,26,67,23,54,3,13,10,12,12,26,38,10,5,7,12,36,65,2.06
9774,"Keith Bogans\boganke01","2013-14",33,"BOS","NBA",0.1,6,0,55,3,6,0,0,3,6,3,3,0,3,3,3,1,0,1,2,12,2.22
9775,"Keith Bogans\boganke01","2004-05",24,"CHA","NBA",0.1,74,42,1791,262,688,205,515,57,173,133,183,76,150,226,135,68,8,122,167,714,7.78
9776,"Etdrick Bohannon\bohanet01","1999-00",26,"TOT","NBA",0.1,13,0,118,7,13,7,13,0,0,15,24,13,18,31,5,2,6,10,25,29,3.17
9777,"Etdrick Bohannon\bohanet01","2000-01",27,"CLE","NBA",0.1,6,0,19,2,4,2,4,0,0,4,4,3,4,7,0,0,2,1,4,8,1.7
9778,"Manute Bol\bolma01","1994-95",32,"GSW","NBA",0.1,5,2,81,6,10,3,5,3,5,0,0,1,11,12,0,0,9,1,10,15,4.3
9779,"Joel Bolomboy\bolomjo01","2017-18",24,"MIL","NBA",0.1,6,0,38,3,6,3,5,0,1,3,6,6,4,10,0,2,0,2,3,9,1.8
9780,"Melvin Booker\bookeme01","1996-97",24,"TOT","NBA",0.1,21,4,430,46,105,34,68,12,37,18,20,7,22,29,53,3,2,27,28,122,5.68
9781,"Calvin Booth\boothca01","2008-09",32,"TOT","NBA",0.1,8,0,56,5,10,5,10,0,0,6,8,5,6,11,0,1,2,1,10,16,2.12
9782,"Calvin Booth\boothca01","1999-00",23,"WAS","NBA",0.1,11,0,143,16,46,16,46,0,0,10,14,15,17,32,7,3,14,6,23,42,4.1
9783,"Curtis Borchardt\borchcu01","2003-04",23,"UTA","NBA",0.1,16,0,258,22,56,22,55,0,1,14,18,13,41,54,15,4,14,18,40,58,4.49
9784,"Ryan Bowen\bowenry01","2009-10",34,"OKC","NBA",0.1,1,0,8,1,1,1,1,0,0,2,2,1,1,2,0,1,0,0,2,4,5.5
9785,"Ira Bowman\bowmair01","2001-02",28,"PHI","NBA",0.1,3,0,29,5,7,5,6,0,1,0,0,0,1,1,1,2,0,0,3,10,3.4
9786,"Ira Bowman\bowmair01","1999-00",26,"PHI","NBA",0.1,11,0,20,2,2,2,2,0,0,1,2,0,2,2,1,1,0,1,0,5,0.59
9787,"Earl Boykins\boykiea01","2011-12",35,"HOU","NBA",0.1,8,0,111,12,36,10,27,2,9,13,15,0,11,11,17,1,0,7,5,39,4.39
9788,"Michael Bradley\bradlmi01","2005-06",26,"PHI","NBA",0.1,46,1,367,32,79,31,74,1,5,2,3,40,67,107,17,5,7,19,39,67,1.93
9789,"Michael Bradley\bradlmi01","2001-02",22,"TOR","NBA",0.1,26,0,118,13,25,13,23,0,2,4,8,7,17,24,3,0,6,6,10,30,1.23
9790,"Tony Bradley\bradlto01","2018-19",21,"UTA","NBA",0.1,3,0,36,8,16,8,16,0,0,1,2,9,6,15,1,2,2,3,6,17,6.23
9791,"Marques Bragg\braggma01","1995-96",25,"MIN","NBA",0.1,53,0,369,54,120,54,120,0,0,23,41,38,41,79,8,17,8,26,71,131,2.29
9792,"Randy Breuer\breuera01","1992-93",32,"ATL","NBA",0.1,12,0,107,15,31,15,31,0,0,2,5,10,18,28,6,2,3,5,12,32,2.88
9793,"Primož Brezec\brezepr01","2003-04",24,"IND","NBA",0.1,18,0,72,12,26,12,26,0,0,4,6,5,10,15,3,0,3,6,13,28,1.33
9794,"Primož Brezec\brezepr01","2002-03",23,"IND","NBA",0.1,22,1,111,15,38,15,37,0,1,12,20,13,10,23,4,2,4,7,16,42,1.59
9795,"Jon Brockman\brockjo01","2011-12",24,"MIL","NBA",0.1,35,0,239,15,45,15,44,0,1,7,15,33,42,75,9,4,1,10,33,37,1.41
9796,"Aaron Brooks\brookaa01","2017-18",33,"MIN","NBA",0.1,32,1,189,28,69,17,38,11,31,8,11,7,10,17,20,6,0,11,28,75,1.98
9797,"MarShon Brooks\brookma01","2018-19",30,"MEM","NBA",0.1,29,0,387,76,169,61,115,15,54,23,33,12,33,45,25,9,4,21,33,190,5.01
9798,"Bobby Brown\brownbo02","2016-17",32,"HOU","NBA",0.1,25,0,123,23,60,9,25,14,35,2,2,0,6,6,14,1,0,5,5,62,1.7
9799,"Chucky Brown\brownch01","2001-02",33,"SAC","NBA",0.1,18,0,92,10,27,10,27,0,0,1,2,10,23,33,6,2,4,5,12,21,1.55
9800,"Devin Brown\brownde02","2008-09",30,"NOH","NBA",0.1,63,5,869,111,313,83,216,28,97,78,100,31,88,119,54,32,5,54,81,328,4.21
9801,"Kedrick Brown\brownke01","2004-05",23,"PHI","NBA",0.1,8,0,55,2,6,2,3,0,3,8,10,1,10,11,4,3,1,5,4,12,2.34
9802,"Kwame Brown\brownkw01","2011-12",29,"GSW","NBA",0.1,9,3,187,21,40,21,40,0,0,15,34,16,41,57,4,8,0,14,21,57,7.04
9803,"Mike Brown\brownmi01","1995-96",32,"PHI","NBA",0.1,9,1,162,9,16,9,16,0,0,8,17,14,23,37,3,3,2,6,24,26,4.01
9804,"Shannon Brown\brownsh01","2006-07",21,"CLE","NBA",0.1,23,5,202,28,74,21,49,7,25,10,14,6,15,21,10,7,3,14,24,73,2.4
9805,"Tierre Brown\brownti01","2001-02",22,"HOU","NBA",0.1,40,1,403,49,115,45,103,4,12,21,28,12,30,42,70,19,3,40,26,123,3.65
9806,"Thomas Bryant\bryanth01","2017-18",20,"LAL","NBA",0.1,15,0,72,8,21,7,11,1,10,5,9,3,14,17,6,1,2,2,6,22,1.49
9807,"Greg Buckner\buckngr01","2007-08",31,"MIN","NBA",0.1,31,4,520,45,117,30,67,15,50,19,22,10,55,65,39,21,2,29,63,124,4.34
9808,"Matt Bullard\bullama01","2001-02",34,"CHH","NBA",0.1,31,0,350,39,115,23,58,16,57,11,12,10,37,47,16,2,2,12,29,105,2.36
9809,"Reggie Bullock\bullore01","2014-15",23,"TOT","NBA",0.1,36,2,338,24,70,9,24,15,46,6,9,1,49,50,8,10,4,8,19,69,1.86
9810,"Pat Burke\burkepa01","2006-07",33,"PHO","NBA",0.1,23,0,164,23,65,17,43,6,22,8,13,12,35,47,5,3,2,7,19,60,2.1
9811,"Pat Burke\burkepa01","2005-06",32,"PHO","NBA",0.1,42,0,346,63,127,61,120,2,7,13,21,21,52,73,16,6,13,33,62,141,3.09
9812,"Evers Burns\burnsev01","1993-94",22,"SAC","NBA",0.1,23,0,143,22,55,22,55,0,0,12,23,13,17,30,9,6,3,7,33,56,2.1
9813,"Scott Burrell\burresc01","2000-01",30,"CHH","NBA",0.1,4,0,41,7,15,5,9,2,6,1,4,1,2,3,1,3,0,0,8,17,3.25
9814,"Deonte Burton\burtode02","2018-19",25,"OKC","NBA",0.1,32,0,240,33,82,25,55,8,27,8,12,4,24,28,9,6,8,9,31,82,2.04
9815,"Willie Burton\burtowi01","1992-93",24,"MIA","NBA",0.1,26,8,451,54,141,49,126,5,15,91,127,22,48,70,16,13,16,50,58,204,6.77
9816,"Jackie Butler\butleja01","2006-07",21,"SAS","NBA",0.1,11,2,103,16,35,16,35,0,0,9,10,6,16,22,5,2,0,10,16,41,3.35
9817,"Jackie Butler\butleja01","2004-05",19,"NYK","NBA",0.1,3,0,5,4,4,4,4,0,0,2,2,0,0,0,0,1,0,1,0,10,3.27
9818,"Mitchell Butler\butlemi02","2001-02",31,"POR","NBA",0.1,11,0,90,10,23,9,20,1,3,8,12,6,8,14,5,0,1,5,10,29,2.28
9819,"Mitchell Butler\butlemi02","1997-98",27,"CLE","NBA",0.1,18,0,206,15,47,14,41,1,6,6,10,6,16,22,18,8,0,8,26,37,2.11
9820,"Rasual Butler\butlera01","2002-03",23,"MIA","NBA",0.1,72,28,1514,207,572,157,401,50,171,76,104,29,157,186,93,21,43,77,105,540,5.58
9821,"Dwight Buycks\buyckdw01","2014-15",25,"LAL","NBA",0.1,6,0,123,18,40,11,29,7,11,9,10,2,10,12,14,3,0,12,3,52,8.07
9822,"Derrick Byars\byarsde01","2011-12",27,"SAS","NBA",0.1,2,0,37,3,11,3,5,0,6,4,4,6,5,11,1,2,0,0,2,10,5.3
9823,"Andrew Bynum\bynuman01","2005-06",18,"LAL","NBA",0.1,46,0,338,33,82,33,82,0,0,8,27,34,46,80,9,4,22,17,56,74,1.74
9824,"Bruno Caboclo\cabocbr01","2016-17",21,"TOR","NBA",0.1,9,0,40,6,16,4,10,2,6,0,0,5,5,10,4,2,1,2,4,14,1.63
9825,"Isaiah Canaan\canaais01","2018-19",27,"TOT","NBA",0.1,30,16,629,64,164,30,68,34,96,19,24,6,52,58,84,14,2,35,52,181,6.24
9826,"Geno Carlisle\carlige01","2004-05",28,"POR","NBA",0.1,6,0,16,2,3,2,3,0,0,4,6,1,0,1,1,0,0,1,1,8,1.17
9827,"Antoine Carr\carran01","1999-00",38,"VAN","NBA",0.1,21,0,221,28,64,28,64,0,0,11,14,8,24,32,7,3,6,9,42,67,2.72
9828,"DeMarre Carroll\carrode01","2010-11",24,"TOT","NBA",0.1,12,0,50,4,12,4,12,0,0,2,2,2,6,8,4,1,1,0,5,10,0.91
9829,"Terry Catledge\catlete01","1992-93",29,"ORL","NBA",0.1,21,1,262,36,73,36,73,0,0,27,34,18,28,46,5,4,1,25,31,99,4.1
9830,"Kelvin Cato\catoke01","2006-07",32,"NYK","NBA",0.1,18,0,95,7,22,7,22,0,0,8,12,12,19,31,0,3,10,6,10,22,1.68
9831,"Troy Caupain\caupatr01","2018-19",23,"ORL","NBA",0.1,4,0,16,4,8,2,5,2,3,0,0,1,2,3,4,1,0,0,0,10,2.75
9832,"Tom Chambers\chambto01","1997-98",38,"PHI","NBA",0.1,1,0,10,2,2,2,2,0,0,2,2,0,2,2,0,2,0,1,2,6,8.2
9833,"Josh Childress\childjo01","2012-13",29,"BRK","NBA",0.1,14,0,100,6,21,5,18,1,3,1,2,6,9,15,5,2,2,0,3,14,1.01
9834,"Chris Childs\childch01","2002-03",35,"NJN","NBA",0.1,12,0,106,6,20,5,14,1,6,2,3,3,2,5,16,8,1,6,17,15,2.07
9835,"Doug Christie\chrisdo01","2005-06",35,"DAL","NBA",0.1,7,7,185,9,26,9,25,0,1,8,12,2,11,13,14,9,1,6,10,26,4.93
9836,"Doug Christie\chrisdo01","1992-93",22,"LAL","NBA",0.1,23,0,332,45,106,43,94,2,12,50,66,24,27,51,53,22,5,50,53,142,7.06
9837,"Semaj Christon\chrisse01","2016-17",24,"OKC","NBA",0.1,64,1,973,77,223,65,160,12,63,17,31,19,68,87,130,28,7,43,79,183,3.29
9838,"Gian Clavell\clavegi01","2017-18",24,"DAL","NBA",0.1,7,0,64,6,18,0,3,6,15,2,2,1,6,7,3,2,0,2,8,20,2.39
9839,"Victor Claver\clavevi01","2014-15",26,"POR","NBA",0.1,10,0,76,9,20,3,9,6,11,0,0,3,17,20,1,1,1,4,12,24,2.4
9840,"John Coker\cokerjo01","1995-96",24,"PHO","NBA",0.1,5,0,11,4,5,4,5,0,0,0,0,2,0,2,1,0,1,0,1,8,1.66
9841,"John Coker\cokerjo01","1998-99",27,"WAS","NBA",0.1,14,0,98,13,31,13,31,0,0,5,6,7,15,22,0,1,2,2,17,31,1.81
9842,"Jarron Collins\collija03","2009-10",31,"PHO","NBA",0.1,34,10,261,12,31,12,31,0,0,10,25,22,40,62,6,2,3,10,42,34,1.3
9843,"Jason Collins\collija04","2013-14",35,"BRK","NBA",0.1,22,1,172,11,24,11,21,0,3,3,4,7,12,19,4,8,1,7,30,25,1.42
9844,"Jason Collins\collija04","2007-08",29,"TOT","NBA",0.1,74,26,1172,53,113,53,112,0,1,34,74,64,114,178,25,23,25,48,194,140,2.64
9845,"Nick Collison\collini01","2017-18",37,"OKC","NBA",0.1,15,0,75,13,19,13,19,0,0,5,13,7,13,20,4,0,0,7,7,31,2.03
9846,"Anthony Cook\cookan01","1993-94",26,"TOT","NBA",0.1,25,0,203,26,54,26,53,0,1,10,25,20,36,56,4,3,14,12,22,62,2.66
9847,"Anthony Cook\cookan01","1995-96",28,"POR","NBA",0.1,11,0,60,7,16,7,14,0,2,1,4,5,7,12,2,0,1,1,8,15,1.12
9848,"Daequan Cook\cookda02","2009-10",22,"MIA","NBA",0.1,45,3,691,81,253,41,127,40,126,21,25,9,73,82,43,14,10,24,50,223,3.57
9849,"Omar Cook\cookom01","2004-05",23,"TOR","NBA",0.1,5,0,74,10,24,10,20,0,4,3,6,2,5,7,22,6,1,6,6,23,6.78
9850,"Matt Costello\costema01","2017-18",24,"SAS","NBA",0.1,4,0,32,2,4,2,4,0,0,0,0,1,8,9,2,2,2,1,7,4,2.6
9851,"James Cotton\cottoja02","1998-99",23,"SEA","NBA",0.1,10,0,59,6,18,6,15,0,3,13,18,2,8,10,0,3,0,3,6,25,1.98
9852,"Joe Courtney\courtjo01","1992-93",23,"TOT","NBA",0.1,12,0,104,13,32,13,32,0,0,7,9,4,15,19,3,5,5,6,17,33,2.77
9853,"Robert Covington\covinro01","2013-14",23,"HOU","NBA",0.1,7,0,34,6,14,2,3,4,11,0,0,2,3,5,0,2,0,1,3,16,1.8
9854,"Allen Crabbe\crabbal01","2013-14",21,"POR","NBA",0.1,15,0,100,12,33,6,19,6,14,3,4,1,8,9,6,2,1,3,10,33,1.65
9855,"Chris Crawford\crawfch01","2001-02",26,"ATL","NBA",0.1,7,4,131,21,45,21,44,0,1,11,15,9,16,25,5,2,5,10,21,53,6.76
9856,"Javaris Crittenton\crittja01","2007-08",20,"TOT","NBA",0.1,50,0,679,98,233,88,196,10,37,72,104,27,83,110,51,19,2,55,47,278,4.83
9857,"Austin Croshere\croshau01","2008-09",33,"TOT","NBA",0.1,14,0,100,14,39,9,24,5,15,7,12,11,23,34,9,1,1,6,5,40,2.71
9858,"John Crotty\crottjo01","2002-03",33,"DEN","NBA",0.1,12,0,180,14,41,10,28,4,13,9,15,1,14,15,29,3,0,9,16,41,3.73
9859,"John Crotty\crottjo01","2000-01",31,"UTA","NBA",0.1,31,0,264,22,65,18,58,4,7,17,19,13,15,28,34,6,0,19,32,65,2.21
9860,"Jared Cunningham\cunnija01","2013-14",22,"TOT","NBA",0.1,13,0,80,6,21,5,14,1,7,13,16,1,5,6,8,3,0,2,16,26,1.81
9861,"Jared Cunningham\cunnija01","2015-16",24,"TOT","NBA",0.1,44,3,410,36,105,24,66,12,39,36,55,3,35,38,20,14,2,21,41,120,2.23
9862,"William Cunningham\cunniwi01","1997-98",23,"TOT","NBA",0.1,7,2,39,4,9,4,9,0,0,0,0,4,6,10,1,2,0,0,10,8,1.43
9863,"Erick Dampier\dampier01","2011-12",36,"ATL","NBA",0.1,15,0,83,1,8,1,8,0,0,0,0,10,15,25,4,1,4,3,9,2,0.89
9864,"Lloyd Daniels\daniell01","1997-98",30,"TOR","NBA",0.1,6,0,82,12,29,10,20,2,9,8,10,4,3,7,4,3,2,4,4,34,4.62
9865,"Marquis Daniels\daniema01","2011-12",31,"BOS","NBA",0.1,38,0,484,52,143,52,133,0,10,17,23,16,50,66,47,21,9,28,36,121,3.31
9866,"Jermareo Davidson\davidje01","2008-09",24,"GSW","NBA",0.1,14,0,111,17,35,17,35,0,0,8,17,10,24,34,1,2,3,5,12,42,2.79
9867,"Brandon Davies\daviebr01","2013-14",22,"PHI","NBA",0.1,51,0,575,54,128,52,118,2,10,34,53,38,71,109,28,24,8,35,92,144,3.16
9868,"Ben Davis\davisbe01","1998-99",26,"NYK","NBA",0.1,8,0,21,7,17,7,17,0,0,3,6,9,2,11,3,0,0,1,4,17,1.65
9869,"Ben Davis\davisbe01","1996-97",24,"PHO","NBA",0.1,20,0,98,10,26,10,26,0,0,9,20,12,15,27,0,4,1,3,16,29,1.3
9870,"Hubert Davis\davishu01","1996-97",26,"TOR","NBA",0.1,36,0,623,74,184,58,114,16,70,17,23,11,29,40,34,11,2,21,40,181,3.66
9871,"Ricky Davis\davisri01","2009-10",30,"LAC","NBA",0.1,36,2,499,62,143,46,101,16,42,18,31,10,47,57,39,11,3,29,39,158,3.91
9872,"Eric Dawson\dawsoer01","2011-12",27,"SAS","NBA",0.1,4,0,39,7,12,7,12,0,0,1,2,5,5,10,0,1,2,3,6,15,3.85
9873,"Todd Day\dayto01","1997-98",28,"MIA","NBA",0.1,5,0,69,11,31,9,19,2,12,6,9,4,2,6,7,7,0,3,10,30,5.16
9874,"Austin Daye\dayeau01","2013-14",25,"TOT","NBA",0.1,22,1,148,24,68,12,31,12,37,6,10,5,22,27,8,4,4,5,18,66,2.25
9875,"Andrew DeClercq\declean01","2004-05",31,"ORL","NBA",0.1,8,0,49,4,9,4,9,0,0,1,3,7,3,10,0,2,0,1,14,9,1.19
9876,"Malcolm Delaney\delanma01","2016-17",27,"ATL","NBA",0.1,73,2,1248,145,388,119,278,26,110,75,93,10,113,123,193,39,1,95,112,391,5.4
9877,"Derrick Dial\dialde01","2001-02",26,"TOT","NBA",0.1,32,0,299,41,120,40,109,1,11,18,24,14,42,56,35,10,4,16,13,101,2.83
9878,"Derrick Dial\dialde01","1999-00",24,"SAS","NBA",0.1,8,0,95,17,46,14,34,3,12,3,5,14,12,26,5,1,1,6,10,40,3.68
9879,"Derrick Dial\dialde01","2003-04",28,"ORL","NBA",0.1,9,0,86,9,28,7,19,2,9,6,8,5,8,13,2,6,0,1,6,26,2.42
9880,"Boris Diaw\diawbo01","2004-05",22,"ATL","NBA",0.1,66,25,1201,124,294,115,244,9,50,57,77,54,116,170,149,37,18,87,123,314,5.63
9881,"Michael Dickerson\dickemi01","2002-03",27,"MEM","NBA",0.1,6,1,87,10,24,6,13,4,11,5,5,1,5,6,8,5,1,6,16,29,4.98
9882,"Spencer Dinwiddie\dinwisp01","2014-15",21,"DET","NBA",0.1,34,1,455,51,169,39,104,12,65,31,34,4,44,48,104,19,6,33,53,145,4.74
9883,"Spencer Dinwiddie\dinwisp01","2015-16",22,"DET","NBA",0.1,12,0,159,19,54,18,44,1,10,19,33,4,13,17,22,3,0,7,20,58,3.95
9884,"Juan Dixon\dixonju01","2002-03",24,"WAS","NBA",0.1,42,3,647,104,271,79,187,25,84,37,46,13,59,72,40,26,3,42,54,270,4.84
9885,"Joey Dorsey\dorsejo01","2009-10",26,"TOT","NBA",0.1,15,0,106,9,20,9,20,0,0,5,12,16,27,43,2,3,2,6,21,23,2.19
9886,"Chris Douglas-Roberts\douglch01","2012-13",26,"DAL","NBA",0.1,6,0,63,5,14,5,10,0,4,7,10,0,5,5,4,2,0,1,4,17,2.47
9887,"PJ Dozier\doziepj01","2018-19",22,"BOS","NBA",0.1,6,0,51,8,21,6,13,2,8,1,2,6,11,17,5,2,0,0,2,19,3.23
9888,"Goran Dragić\dragigo01","2008-09",22,"PHO","NBA",0.1,55,1,728,88,224,68,170,20,54,50,65,33,70,103,111,29,3,73,87,246,4.88
9889,"Greg Dreiling\dreilgr01","1992-93",30,"IND","NBA",0.1,43,0,239,19,58,19,54,0,4,8,15,26,40,66,8,5,8,9,60,46,1.23
9890,"Kris Dunn\dunnkr01","2016-17",22,"MIN","NBA",0.1,78,7,1333,118,313,97,240,21,73,36,59,24,142,166,188,78,36,89,178,293,5.3
9891,"Ronald Dupree\duprero01","2007-08",27,"TOT","NBA",0.1,5,0,21,1,3,1,3,0,0,2,2,1,7,8,1,1,0,0,0,4,1.44
9892,"Trevon Duval\duvaltr01","2018-19",20,"MIL","NBA",0.1,3,0,6,2,3,1,2,1,1,0,0,0,1,1,2,0,0,0,0,5,1.83
9893,"Jerome Dyson\dysonje01","2011-12",24,"NOH","NBA",0.1,9,1,180,19,48,18,40,1,8,28,36,2,17,19,18,11,2,20,19,67,7.82
9894,"Ndudi Ebi\ebind01","2004-05",20,"MIN","NBA",0.1,2,0,54,11,21,11,20,0,1,5,9,6,10,16,1,1,1,3,7,27,11.95
9895,"Jarell Eddie\eddieja01","2015-16",24,"WAS","NBA",0.1,26,0,147,20,65,5,18,15,47,8,8,2,21,23,5,5,1,1,5,63,1.69
9896,"Jarell Eddie\eddieja01","2016-17",25,"PHO","NBA",0.1,5,0,62,6,19,2,3,4,16,8,9,1,6,7,0,1,0,1,1,24,3.3
9897,"Corsley Edwards\edwarco01","2004-05",25,"NOH","NBA",0.1,10,0,110,10,31,10,31,0,0,7,12,12,13,25,3,3,4,2,19,27,2.52
9898,"Doug Edwards\edwardo01","1995-96",25,"VAN","NBA",0.1,31,0,519,32,91,32,87,0,4,29,38,35,52,87,39,10,18,29,51,93,3.97
9899,"Kevin Edwards\edwarke01","1997-98",32,"TOT","NBA",0.1,39,5,487,57,165,51,150,6,15,30,35,20,34,54,39,26,1,30,28,150,3.36
9900,"Henry Ellenson\ellenhe01","2017-18",21,"DET","NBA",0.1,38,0,329,53,146,33,86,20,60,25,29,10,71,81,20,5,0,18,22,151,3.15
9901,"Melvin Ely\elyme01","2004-05",26,"CHA","NBA",0.1,79,17,1649,227,526,227,526,0,0,122,212,142,184,326,76,32,69,115,199,576,6.66
9902,"Andre Emmett\emmetan01","2011-12",29,"NJN","NBA",0.1,6,0,45,4,7,4,6,0,1,5,8,2,4,6,1,2,1,2,2,13,2.38
9903,"Jo Jo English\englijo01","1994-95",24,"CHI","NBA",0.1,8,0,127,15,39,12,27,3,12,10,13,1,2,3,7,7,1,6,19,43,4.29
9904,"Brian Evans\evansbr01","1998-99",25,"TOT","NBA",0.1,16,0,145,13,44,9,31,4,13,4,4,6,13,19,15,5,3,2,8,34,2.1
9905,"Brian Evans\evansbr01","1996-97",23,"ORL","NBA",0.1,14,0,59,8,22,4,14,4,8,0,0,1,7,8,7,1,2,2,6,20,1.31
9906,"Maurice Evans\evansma01","2001-02",23,"MIN","NBA",0.1,10,0,45,9,19,9,16,0,3,3,4,3,1,4,4,0,0,2,9,21,1.53
9907,"Kay Felder\feldeka01","2016-17",21,"CLE","NBA",0.1,42,0,386,62,158,55,136,7,22,35,49,3,38,41,58,18,7,30,38,166,3.68
9908,"Kyrylo Fesenko\fesenky01","2011-12",25,"IND","NBA",0.1,3,0,17,2,5,2,5,0,0,4,6,2,7,9,1,2,0,0,2,8,3.6
9909,"Dorian Finney-Smith\finnedo01","2017-18",24,"DAL","NBA",0.1,21,13,448,46,121,26,54,20,67,11,15,22,53,75,26,10,4,21,43,123,5.53
9910,"Gerald Fitch\fitchge01","2005-06",23,"MIA","NBA",0.1,18,1,239,30,89,23,63,7,26,17,23,7,23,30,33,7,5,15,28,84,4.27
9911,"Jonny Flynn\flynnjo01","2011-12",22,"TOT","NBA",0.1,29,1,416,46,131,36,97,10,34,29,39,8,31,39,96,6,2,36,23,131,4.96
9912,"Jonny Flynn\flynnjo01","2009-10",20,"MIN","NBA",0.1,81,81,2339,397,952,320,737,77,215,223,270,24,167,191,356,82,2,233,98,1094,12.06
9913,"Bryn Forbes\forbebr01","2016-17",23,"SAS","NBA",0.1,36,0,285,36,99,19,46,17,53,5,6,2,21,23,23,1,0,11,20,94,1.81
9914,"Alphonso Ford\fordal01","1993-94",22,"SEA","NBA",0.1,6,0,16,7,13,6,12,1,1,1,2,0,0,0,1,2,0,1,2,16,2
9915,"Alton Ford\fordal02","2003-04",22,"HOU","NBA",0.1,9,0,41,6,11,6,11,0,0,3,6,3,8,11,3,0,1,3,9,15,1.74
9916,"Greg Foster\fostegr01","1998-99",30,"UTA","NBA",0.1,42,1,458,52,138,51,134,1,4,13,21,28,55,83,25,6,8,24,63,118,2.41
9917,"Greg Foster\fostegr01","1999-00",31,"SEA","NBA",0.1,60,5,718,91,224,88,209,3,15,18,28,16,91,107,41,10,18,28,105,203,2.88
9918,"Antonis Fotsis\fotsian01","2001-02",20,"MEM","NBA",0.1,28,1,320,42,104,35,81,7,23,17,20,25,37,62,10,9,11,21,22,108,3.55
9919,"Channing Frye\fryech01","2018-19",35,"CLE","NBA",0.1,36,6,341,43,117,11,38,32,79,11,14,4,48,52,20,6,5,13,44,129,2.98
9920,"Lawrence Funderburke\fundela01","2004-05",34,"CHI","NBA",0.1,2,0,21,3,6,3,6,0,0,3,5,1,2,3,0,0,0,0,2,9,3.2
9921,"Dan Gadzuric\gadzuda01","2007-08",29,"MIL","NBA",0.1,51,4,534,64,154,64,153,0,1,33,63,67,77,144,11,20,24,34,83,161,3.31
9922,"Dan Gadzuric\gadzuda01","2010-11",32,"TOT","NBA",0.1,42,9,463,54,129,54,128,0,1,10,27,71,64,135,14,13,29,29,91,118,3.32
9923,"Corey Gaines\gaineco01","1994-95",29,"PHI","NBA",0.1,11,8,280,24,51,22,36,2,15,5,11,1,17,18,33,8,1,14,23,55,5.95
9924,"Chad Gallagher\gallach01","1993-94",24,"UTA","NBA",0.1,2,0,3,3,3,3,3,0,0,0,0,0,0,0,0,0,0,0,2,6,2.55
9925,"Jorge Garbajosa\garbajo01","2007-08",30,"TOR","NBA",0.1,7,0,74,8,25,2,9,6,16,0,0,2,13,15,3,3,0,1,2,22,2.69
9926,"Kenny Gattison\gattike01","1995-96",31,"VAN","NBA",0.1,25,14,570,91,190,91,190,0,0,47,78,35,79,114,14,10,11,40,75,229,7.72
9927,"Andrew Gaze\gazean01","1993-94",28,"WSB","NBA",0.1,7,0,70,8,17,4,9,4,8,2,2,1,6,7,5,2,1,3,9,22,3.19
9928,"Marcus Georges-Hunt\georgma01","2016-17",22,"ORL","NBA",0.1,5,0,48,2,7,1,5,1,2,9,10,1,8,9,3,1,0,2,5,14,3.24
9929,"J.R. Giddens\giddejr01","2009-10",24,"TOT","NBA",0.1,32,1,239,28,60,28,50,0,10,13,23,16,35,51,13,9,2,17,29,69,2.32
9930,"Eddie Gill\gilled01","2001-02",23,"MEM","NBA",0.1,23,5,384,39,92,32,70,7,22,31,39,7,21,28,49,11,3,34,38,116,5.33
9931,"Eddie Gill\gilled01","2008-09",30,"MIL","NBA",0.1,6,0,43,6,9,4,6,2,3,0,0,0,4,4,11,3,1,5,10,14,3.85
9932,"Eddie Gill\gilled01","2005-06",27,"IND","NBA",0.1,41,0,122,10,45,3,22,7,23,18,23,0,15,15,12,11,1,9,13,45,1.01
9933,"Gerald Glass\glassge01","1995-96",28,"TOT","NBA",0.1,15,0,71,12,33,11,27,1,6,1,1,6,2,8,4,3,1,0,10,26,1.16
9934,"Anthony Goldwire\goldwan01","2003-04",32,"TOT","NBA",0.1,11,0,85,7,22,5,14,2,8,1,1,1,6,7,11,5,0,3,5,17,1.81
9935,"Anthony Goldwire\goldwan01","2000-01",29,"DEN","NBA",0.1,20,0,201,30,80,21,46,9,34,13,17,1,11,12,34,9,0,15,13,82,3.7
9936,"Archie Goodwin\goodwar01","2015-16",21,"PHO","NBA",0.1,57,13,1114,176,422,153,323,23,99,130,193,27,115,142,118,27,13,100,84,505,7.55
9937,"Marcin Gortat\gortama01","2007-08",23,"ORL","NBA",0.1,6,0,41,8,17,8,17,0,0,2,3,8,8,16,2,1,1,2,4,18,3.07
9938,"Andrew Goudelock\goudean01","2011-12",23,"LAL","NBA",0.1,40,0,419,68,174,40,99,28,75,11,12,5,26,31,20,4,0,21,32,175,2.76
9939,"Greg Graham\grahagr01","1993-94",23,"PHI","NBA",0.1,70,6,889,122,305,120,280,2,25,92,110,21,65,86,66,61,4,65,54,338,4.44
9940,"Gary Grant\grantga01","2000-01",35,"POR","NBA",0.1,4,0,17,5,7,5,7,0,0,0,0,0,0,0,1,0,0,0,1,10,1.95
9941,"Aaron Gray\grayaa01","2013-14",29,"TOT","NBA",0.1,37,6,355,27,61,27,60,0,1,11,20,42,69,111,22,10,8,31,64,65,2.84
9942,"Danny Green\greenda02","2010-11",23,"SAS","NBA",0.1,8,0,92,17,35,10,16,7,19,0,0,3,12,15,2,2,1,5,7,41,4.17
9943,"Erick Green\greener01","2015-16",24,"TOT","NBA",0.1,9,0,42,5,13,4,8,1,5,2,2,3,3,6,3,1,0,0,4,13,1.27
9944,"Litterial Green\greenli01","1993-94",23,"ORL","NBA",0.1,29,0,126,22,57,21,53,1,4,28,37,6,6,12,9,6,1,13,16,73,1.93
9945,"Willie Green\greenwi01","2004-05",23,"PHI","NBA",0.1,57,21,1066,155,423,125,318,30,105,97,125,22,111,133,100,34,6,75,121,437,6.19
9946,"Adrian Griffin\griffad01","2003-04",29,"HOU","NBA",0.1,19,1,133,5,18,4,16,1,2,0,4,1,18,19,10,7,2,3,17,11,1.15
9947,"Jay Guidinger\guidija01","1993-94",24,"CLE","NBA",0.1,32,0,131,16,32,16,32,0,0,15,21,15,18,33,3,4,5,16,23,47,1.61
9948,"A.J. Guyton\guytoaj01","2001-02",23,"CHI","NBA",0.1,45,6,607,88,244,42,121,46,123,22,27,12,32,44,81,10,7,37,23,244,4.35
9949,"Hamed Haddadi\haddaha01","2012-13",27,"TOT","NBA",0.1,30,0,322,35,82,35,82,0,0,14,27,43,68,111,12,6,27,31,60,84,3.77
9950,"Malik Hairston\hairsma01","2008-09",21,"SAS","NBA",0.1,15,0,155,24,49,24,48,0,1,2,7,11,17,28,13,6,7,12,19,50,3.63
9951,"Marcus Haislip\haislma01","2009-10",29,"SAS","NBA",0.1,10,0,44,10,21,7,16,3,5,2,5,4,6,10,0,0,2,3,5,25,1.85
9952,"Jack Haley\haleyja01","1993-94",30,"SAS","NBA",0.1,28,0,94,21,48,21,48,0,0,17,21,6,18,24,1,0,0,10,18,59,1.52
9953,"Darvin Ham\hamda01","1996-97",23,"TOT","NBA",0.1,36,3,318,33,62,33,62,0,0,17,35,29,27,56,14,9,8,22,57,83,2.57
9954,"Daniel Hamilton\hamilda02","2017-18",22,"OKC","NBA",0.1,6,0,28,5,11,3,6,2,5,0,0,0,5,5,8,1,0,2,2,12,2.48
9955,"Jordan Hamilton\hamiljo02","2014-15",24,"LAC","NBA",0.1,14,2,122,14,35,4,14,10,21,0,0,2,14,16,7,2,0,4,14,38,2.31
9956,"Justin Hamilton\hamilju01","2013-14",23,"TOT","NBA",0.1,8,0,72,9,20,6,11,3,9,5,5,4,3,7,0,5,0,4,8,26,2.93
9957,"Zendon Hamilton\hamilze01","2005-06",30,"TOT","NBA",0.1,12,0,49,7,14,7,14,0,0,12,18,3,8,11,0,4,0,6,5,26,2.08
9958,"Zendon Hamilton\hamilze01","2004-05",29,"MIL","NBA",0.1,16,0,159,11,32,11,32,0,0,29,48,18,24,42,6,5,2,12,26,51,3.3
9959,"Terrel Harris\harrite01","2011-12",24,"MIA","NBA",0.1,22,1,318,29,83,21,44,8,39,14,21,18,33,51,26,9,2,25,34,80,3.62
9960,"Tony Harris\harrito01","1994-95",27,"BOS","NBA",0.1,3,0,18,3,8,3,7,0,1,8,9,0,0,0,0,0,0,1,2,14,3.07
9961,"Jason Hart\hartja01","2005-06",27,"SAC","NBA",0.1,66,0,818,86,221,77,190,9,31,37,56,12,59,71,70,31,5,43,85,218,3.06
9962,"Antonio Harvey\harvean01","1996-97",26,"SEA","NBA",0.1,6,0,26,5,11,5,11,0,0,5,6,2,8,10,1,0,4,1,8,15,2.73
9963,"Donnell Harvey\harvedo01","2000-01",20,"DAL","NBA",0.1,18,0,65,8,14,8,14,0,0,6,16,6,14,20,2,3,1,7,15,22,1.36
9964,"Lazar Hayward\haywala01","2012-13",26,"MIN","NBA",0.1,4,0,31,2,10,2,6,0,4,6,6,0,4,4,3,2,0,0,3,10,2.38
9965,"Brendan Haywood\haywobr01","2012-13",33,"CHA","NBA",0.1,61,17,1162,93,216,93,215,0,1,30,66,125,165,290,29,16,49,50,125,216,4.5
9966,"Alvin Heggs\heggsal01","1995-96",28,"HOU","NBA",0.1,4,0,14,3,5,3,5,0,0,2,3,1,1,2,0,0,0,0,0,8,1.52
9967,"Mark Hendrickson\hendrma01","1999-00",25,"TOT","NBA",0.1,15,0,71,5,8,5,8,0,0,3,4,3,10,13,6,2,1,3,8,13,1.41
9968,"Myke Henry\henrymy01","2017-18",25,"MEM","NBA",0.1,20,0,378,41,109,22,51,19,58,6,10,10,28,38,22,31,6,19,28,107,5.57
9969,"Steve Henson\hensost01","1997-98",29,"DET","NBA",0.1,23,0,65,13,26,10,18,3,8,7,7,0,2,2,4,1,0,6,9,36,1.2
9970,"Carl Herrera\herreca01","1996-97",30,"SAS","NBA",0.1,75,58,1837,257,593,255,587,2,6,81,118,118,222,340,50,62,53,95,217,597,7.2
9971,"Carl Herrera\herreca01","1997-98",31,"SAS","NBA",0.1,58,1,516,76,175,76,174,0,1,18,44,24,67,91,22,19,12,38,71,170,2.53
9972,"Isaiah Hicks\hicksis01","2018-19",24,"NYK","NBA",0.1,3,0,32,4,8,4,8,0,0,4,5,2,5,7,2,1,3,1,5,12,4.97
9973,"Tyrone Hill\hillty01","2003-04",35,"MIA","NBA",0.1,5,0,38,3,5,3,5,0,0,3,4,5,3,8,0,0,1,2,10,9,2.04
9974,"Donald Hodge\hodgedo01","1995-96",26,"TOT","NBA",0.1,15,0,115,9,24,9,24,0,0,0,0,9,14,23,4,1,8,2,26,18,1.56
9975,"Juwan Howard\howarju01","2007-08",34,"DAL","NBA",0.1,50,0,353,23,64,23,64,0,0,11,14,21,60,81,17,5,2,17,62,57,1.42
9976,"Stephen Howard\howarst01","1992-93",22,"UTA","NBA",0.1,49,0,260,35,93,35,93,0,0,34,53,26,34,60,10,15,12,23,58,104,2.03
9977,"Lester Hudson\hudsole01","2011-12",27,"TOT","NBA",0.1,16,0,334,62,162,46,98,16,64,34,41,7,39,46,36,14,3,32,26,174,8.89
9978,"Lester Hudson\hudsole01","2009-10",25,"TOT","NBA",0.1,25,0,131,21,53,16,37,5,16,11,13,7,11,18,13,8,3,14,12,58,2.2
9979,"Troy Hudson\hudsotr01","2006-07",30,"MIN","NBA",0.1,34,6,554,74,195,46,115,28,80,26,32,8,40,48,73,14,2,40,23,202,5.25
9980,"Troy Hudson\hudsotr01","2000-01",24,"ORL","NBA",0.1,75,7,1008,125,372,103,263,22,109,85,104,38,67,105,162,37,3,92,82,357,4.45
9981,"Nate Huffman\huffmna01","2002-03",27,"TOR","NBA",0.1,7,0,76,9,25,9,25,0,0,5,8,9,14,23,5,1,3,3,13,23,3.39
9982,"Rick Hughes\hugheri02","1999-00",26,"DAL","NBA",0.1,21,0,224,35,72,35,71,0,1,12,26,24,25,49,9,3,1,14,30,82,3.31
9983,"Ryan Humphrey\humphry01","2004-05",25,"MEM","NBA",0.1,35,0,317,42,103,42,101,0,2,18,37,50,37,87,6,10,1,23,35,102,2.54
9984,"R.J. Hunter\hunterj01","2018-19",25,"BOS","NBA",0.1,1,0,26,6,13,2,3,4,10,1,2,1,2,3,3,1,0,0,3,17,14.2
9985,"Steven Hunter\huntest01","2007-08",26,"DEN","NBA",0.1,19,2,120,15,28,15,28,0,0,9,20,10,19,29,0,0,6,7,20,39,1.94
9986,"Steven Hunter\huntest01","2009-10",28,"MEM","NBA",0.1,21,0,158,17,43,17,43,0,0,19,36,18,24,42,0,1,10,9,10,53,2.27
9987,"Didier Ilunga-Mbenga\mbengdj01","2006-07",26,"DAL","NBA",0.1,21,0,79,5,16,5,16,0,0,7,8,3,8,11,6,3,5,5,17,17,1.07
9988,"Demetrius Jackson\jacksde01","2016-17",22,"BOS","NBA",0.1,5,0,17,3,4,2,3,1,1,3,6,2,2,4,3,0,0,0,0,10,2.18
9989,"Jim Jackson\jacksji01","2000-01",30,"TOT","NBA",0.1,56,40,1690,239,632,213,552,26,80,139,169,53,171,224,163,53,10,130,139,643,9.78
9990,"Luke Jackson\jackslu02","2006-07",25,"TOT","NBA",0.1,13,2,138,19,43,14,26,5,17,5,9,2,8,10,13,5,1,7,15,48,3.28
9991,"Luke Jackson\jackslu02","2004-05",23,"CLE","NBA",0.1,10,0,43,10,27,6,21,4,6,5,6,2,4,6,3,0,0,2,4,29,1.82
9992,"Reggie Jackson\jacksre01","2011-12",21,"OKC","NBA",0.1,45,0,501,51,159,38,97,13,62,25,29,14,39,53,71,25,1,36,31,140,3.2
9993,"Bernard James\jamesbe01","2013-14",28,"DAL","NBA",0.1,30,0,146,11,23,11,22,0,1,6,11,15,27,42,3,3,8,10,24,28,1.39
9994,"Damion James\jamesda01","2010-11",23,"NJN","NBA",0.1,25,9,403,46,103,46,100,0,3,18,28,17,68,85,20,16,12,25,36,110,4.99
9995,"Henry James\jameshe01","1995-96",30,"HOU","NBA",0.1,7,0,58,10,24,5,9,5,15,5,5,3,3,6,2,0,0,4,13,30,3
9996,"Henry James\jameshe01","1993-94",28,"LAC","NBA",0.1,12,0,75,16,42,12,24,4,18,5,5,6,8,14,1,2,0,2,9,41,2.19
9997,"Jerome James\jamesje01","2007-08",32,"NYK","NBA",0.1,2,0,5,1,1,1,1,0,0,2,2,0,3,3,0,0,0,0,0,4,2.45
9998,"Tim James\jamesti01","2000-01",24,"CHH","NBA",0.1,30,0,197,16,52,15,49,1,3,12,14,15,20,35,8,2,5,8,27,45,1.31
9999,"Antawn Jamison\jamisan01","2013-14",37,"LAC","NBA",0.1,22,0,248,29,92,21,51,8,41,18,25,9,46,55,7,9,3,7,29,84,3.02
10000,"Othyus Jeffers\jeffeot01","2013-14",28,"TOT","NBA",0.1,6,1,47,3,6,3,4,0,2,3,4,1,8,9,1,0,0,1,3,9,1.65
10001,"Othyus Jeffers\jeffeot01","2009-10",24,"UTA","NBA",0.1,14,0,73,12,29,12,29,0,0,13,19,8,11,19,1,4,0,6,10,37,2.24
10002,"Cory Jefferson\jeffeco01","2015-16",25,"PHO","NBA",0.1,8,0,50,9,22,9,21,0,1,4,6,6,10,16,0,0,1,0,8,22,2.06
10003,"Richard Jefferson\jefferi01","2017-18",37,"DEN","NBA",0.1,20,0,163,12,27,10,20,2,7,4,7,2,15,17,15,2,1,5,11,30,1.74
10004,"Jared Jeffries\jeffrja01","2007-08",26,"NYK","NBA",0.1,73,19,1325,108,270,104,245,4,25,49,93,118,125,243,66,36,23,64,132,269,4.12
10005,"Brandon Jennings\jennibr01","2017-18",28,"MIL","NBA",0.1,14,0,205,27,72,18,39,9,33,10,10,5,26,31,44,6,4,18,11,73,6.1
10006,"Armon Johnson\johnsar02","2011-12",22,"TOT","NBA",0.1,9,0,124,20,43,19,40,1,3,6,6,1,12,13,11,5,0,6,9,47,4.76
10007,"B.J. Johnson\johnsbj01","2018-19",23,"TOT","NBA",0.1,7,0,49,9,18,6,11,3,7,2,2,2,6,8,0,2,0,2,4,23,2.74
10008,"DerMarr Johnson\johnsde03","2007-08",27,"SAS","NBA",0.1,5,0,28,7,14,4,5,3,9,0,2,0,1,1,1,1,0,0,4,17,2.26
10009,"Omari Johnson\johnsom01","2017-18",28,"MEM","NBA",0.1,4,0,75,9,21,5,9,4,12,0,0,4,7,11,7,2,0,3,6,22,5.55
10010,"Orlando Johnson\johnsor01","2013-14",24,"TOT","NBA",0.1,45,0,392,36,113,27,66,9,47,19,26,9,46,55,20,6,2,15,26,100,1.69
10011,"Trey Johnson\johnstr01","2011-12",27,"NOH","NBA",0.1,11,0,61,8,14,8,14,0,0,5,5,3,9,12,4,1,0,5,10,21,2.09
10012,"Alvin Jones\jonesal01","2001-02",23,"PHI","NBA",0.1,23,2,126,8,20,8,20,0,0,10,20,13,23,36,3,3,9,11,35,26,1.61
10013,"Dahntay Jones\jonesda02","2015-16",35,"CLE","NBA",0.1,1,0,42,6,14,5,12,1,2,0,0,1,4,5,2,1,2,0,6,13,11.4
10014,"Damian Jones\jonesda03","2017-18",22,"GSW","NBA",0.1,15,0,89,11,22,11,22,0,0,3,5,5,9,14,2,1,3,4,14,25,1.55
10015,"DeQuan Jones\jonesde01","2012-13",22,"ORL","NBA",0.1,63,17,803,95,218,86,183,9,35,34,51,17,88,105,16,19,22,30,55,233,3.16
10016,"Dwayne Jones\jonesdw02","2005-06",22,"BOS","NBA",0.1,14,0,87,4,10,4,10,0,0,6,13,10,21,31,2,1,3,3,14,14,1.62
10017,"Dwayne Jones\jonesdw02","2008-09",25,"CHA","NBA",0.1,6,0,52,4,7,4,7,0,0,4,6,6,6,12,0,0,1,4,6,12,2.23
10018,"Jalen Jones\jonesja04","2017-18",24,"TOT","NBA",0.1,16,0,181,26,68,16,42,10,26,12,19,13,25,38,4,5,1,7,22,74,3.61
10019,"Jumaine Jones\jonesju01","2003-04",24,"BOS","NBA",0.1,42,2,373,33,96,20,52,13,44,14,23,24,44,68,14,12,9,19,48,93,2.16
10020,"Chris Kaman\kamanch01","2015-16",33,"POR","NBA",0.1,16,2,112,20,43,19,39,1,4,3,3,7,17,24,11,1,1,8,15,44,2.56
10021,"Jason Kapono\kaponja01","2011-12",30,"LAL","NBA",0.1,27,0,269,21,55,13,28,8,27,4,4,2,12,14,11,3,0,6,21,54,1.49
10022,"Ryan Kelly\kellyry01","2015-16",24,"LAL","NBA",0.1,36,0,470,55,149,50,112,5,37,37,54,21,100,121,20,13,10,18,39,152,4.04
10023,"Ryan Kelly\kellyry01","2016-17",25,"ATL","NBA",0.1,16,0,110,8,28,4,18,4,10,5,6,1,17,18,8,4,5,4,5,25,1.78
10024,"Tim Kempton\kemptti01","1992-93",29,"PHO","NBA",0.1,30,0,167,19,48,19,48,0,0,18,31,12,27,39,19,4,4,16,30,56,2.02
10025,"Alec Kessler\kesslal01","1993-94",27,"MIA","NBA",0.1,15,0,66,11,25,6,16,5,9,6,8,4,6,10,2,1,1,5,14,33,1.75
10026,"Sean Kilpatrick\kilpase01","2017-18",28,"TOT","NBA",0.1,52,1,640,110,294,64,150,46,144,64,72,5,82,87,46,13,5,38,33,330,4.78
10027,"Sean Kilpatrick\kilpase01","2014-15",25,"MIN","NBA",0.1,4,0,72,7,20,3,7,4,13,4,4,1,5,6,4,3,0,2,3,22,4.75
10028,"Frankie King\kingfr01","1996-97",24,"PHI","NBA",0.1,7,0,59,7,17,6,15,1,2,5,5,4,10,14,5,4,0,3,7,20,3.43
10029,"Rich King\kingri01","1993-94",24,"SEA","NBA",0.1,27,0,78,15,34,15,33,0,1,11,22,9,11,20,8,1,2,7,18,41,1.29
10030,"Stacey King\kingst01","1994-95",28,"MIN","NBA",0.1,50,10,792,99,212,99,211,0,1,68,102,54,111,165,26,24,20,64,126,266,5.32
10031,"Joe Kleine\kleinjo01","1997-98",36,"CHI","NBA",0.1,46,1,397,39,106,39,106,0,0,15,18,27,50,77,30,4,5,28,63,93,2.01
10032,"Joe Kleine\kleinjo01","1995-96",34,"PHO","NBA",0.1,56,9,663,71,169,69,162,2,7,20,25,36,96,132,44,13,6,37,113,164,3.09
10033,"Linas Kleiza\kleizli01","2012-13",28,"TOR","NBA",0.1,20,3,376,48,144,28,78,20,66,32,38,10,42,52,16,4,2,14,45,148,5.07
10034,"Negele Knight\knighne01","1992-93",25,"PHO","NBA",0.1,52,35,888,124,317,124,310,0,7,67,86,28,36,64,145,23,4,73,66,315,5.54
10035,"Larry Krystkowiak\krystla01","1996-97",32,"LAL","NBA",0.1,3,0,11,1,2,1,2,0,0,1,2,2,3,5,3,2,0,1,3,3,2.57
10036,"Maciej Lampe\lampema01","2003-04",18,"PHO","NBA",0.1,21,0,224,43,88,43,84,0,4,10,13,9,35,44,9,3,3,15,28,96,3.78
10037,"Antonio Lang\langan02","1998-99",26,"CLE","NBA",0.1,10,0,65,4,6,4,6,0,0,5,9,6,10,16,1,2,1,4,13,13,1.86
10038,"Antonio Lang\langan02","1997-98",25,"MIA","NBA",0.1,6,0,29,3,5,3,5,0,0,6,8,2,3,5,1,2,0,4,3,12,2.27
10039,"James Lang\langja01","2006-07",23,"WAS","NBA",0.1,11,0,55,4,9,4,9,0,0,3,5,5,6,11,2,0,3,2,14,11,1.22
10040,"Rusty LaRue\larueru01","1997-98",24,"CHI","NBA",0.1,14,0,140,20,49,16,33,4,16,5,8,1,7,8,5,3,1,6,12,49,2.28
10041,"Joffrey Lauvergne\lauvejo01","2014-15",23,"DEN","NBA",0.1,24,1,268,36,89,33,73,3,16,18,28,27,50,77,13,8,10,22,43,93,4
10042,"Malcolm Lee\leema01","2011-12",21,"MIN","NBA",0.1,19,0,243,23,59,21,49,2,10,14,17,9,17,26,31,8,4,17,22,62,3.77
10043,"Tim Legler\legleti01","1999-00",33,"GSW","NBA",0.1,23,4,284,28,78,21,57,7,21,14,18,4,19,23,24,4,1,6,33,77,2.73
10044,"Walt Lemon\lemonwa01","2018-19",26,"CHI","NBA",0.1,6,3,167,38,87,36,82,2,5,8,11,4,23,27,30,11,1,10,14,86,13.77
10045,"Voshon Lenard\lenarvo01","2004-05",31,"DEN","NBA",0.1,3,1,54,10,26,6,14,4,12,5,8,0,6,6,6,1,0,2,2,29,7.07
10046,"Travis Leslie\leslitr01","2011-12",21,"LAC","NBA",0.1,10,0,45,5,14,5,14,0,0,4,9,6,3,9,5,2,2,2,4,14,1.47
10047,"Jon Leuer\leuerjo01","2017-18",28,"DET","NBA",0.1,8,0,136,15,36,15,33,0,3,13,15,7,25,32,5,1,3,7,16,43,5.3
10048,"Cedric Lewis\lewisce01","1995-96",26,"WSB","NBA",0.1,3,0,4,2,3,2,3,0,0,0,0,2,0,2,0,1,0,0,0,4,1.5
10049,"Martin Lewis\lewisma01","1996-97",21,"TOR","NBA",0.1,9,0,50,6,14,5,11,1,3,1,2,4,2,6,4,1,2,1,8,14,1.53
10050,"Quincy Lewis\lewisqu01","2001-02",24,"UTA","NBA",0.1,36,19,490,64,143,61,125,3,18,13,20,10,33,43,36,23,9,32,89,144,3.84
10051,"Randy Livingston\livinra01","2002-03",27,"NOH","NBA",0.1,2,0,12,2,4,2,4,0,0,2,2,0,0,0,1,0,0,0,0,6,2.35
10052,"Randy Livingston\livinra01","1998-99",23,"PHO","NBA",0.1,1,0,22,5,8,5,8,0,0,2,2,0,2,2,3,2,0,1,1,12,13.3
10053,"Shaun Livingston\livinsh01","2004-05",19,"LAC","NBA",0.1,30,15,814,89,215,89,213,0,2,44,59,22,67,89,151,32,11,75,82,222,9.4
10054,"Brad Lohaus\lohaubr01","1993-94",29,"MIL","NBA",0.1,67,2,962,102,281,56,147,46,134,20,29,33,117,150,62,30,55,58,142,270,4.21
10055,"Brad Lohaus\lohaubr01","1997-98",33,"SAS","NBA",0.1,9,0,102,7,21,3,7,4,14,1,3,3,9,12,5,1,2,3,10,19,1.89
10056,"John Long\longjo01","1996-97",40,"TOR","NBA",0.1,32,0,370,46,117,34,83,12,34,25,28,6,34,40,21,9,2,24,28,129,3.29
10057,"Kevon Looney\looneke01","2015-16",19,"GSW","NBA",0.1,5,0,21,4,7,3,5,1,2,0,0,4,6,10,0,0,0,1,2,9,1.94
10058,"Scott Machado\machasc01","2018-19",28,"LAL","NBA",0.1,4,0,19,4,6,3,5,1,1,1,1,0,0,0,3,1,0,0,2,10,2.62
10059,"Malcolm Mackey\mackema01","1993-94",23,"PHO","NBA",0.1,22,0,69,14,37,14,35,0,2,4,8,12,12,24,1,0,3,2,9,32,1.02
10060,"Gerald Madkins\madkige01","1993-94",24,"CLE","NBA",0.1,22,0,149,11,31,6,16,5,15,8,10,1,10,11,19,9,0,13,16,35,1.98
10061,"Corey Maggette\maggeco01","2012-13",33,"DET","NBA",0.1,18,0,257,27,76,22,55,5,21,36,48,5,20,25,19,6,2,17,42,95,4.36
10062,"Rick Mahorn\mahorri01","1995-96",37,"NJN","NBA",0.1,50,0,450,43,122,43,121,0,1,34,47,31,79,110,16,14,13,30,72,120,2.5
10063,"Moses Malone\malonmo01","1992-93",37,"MIL","NBA",0.1,11,0,104,13,42,13,42,0,0,24,31,22,24,46,7,1,8,10,6,50,4.81
10064,"Matt Maloney\malonma01","2002-03",31,"ATL","NBA",0.1,14,0,103,8,25,3,10,5,15,3,5,1,6,7,17,4,0,5,9,24,1.97
10065,"Sean Marks\marksse01","2010-11",35,"POR","NBA",0.1,29,0,208,19,44,17,42,2,2,5,8,16,24,40,4,3,5,11,44,45,1.58
10066,"Cartier Martin\martica01","2009-10",25,"TOT","NBA",0.1,18,2,390,50,136,33,87,17,49,24,30,25,43,68,16,11,1,19,48,141,6.31
10067,"Cuonzo Martin\marticu01","1995-96",24,"VAN","NBA",0.1,4,0,19,3,5,0,2,3,3,0,2,1,1,2,2,1,0,1,1,9,2.27
10068,"Darrick Martin\martida01","2006-07",35,"TOR","NBA",0.1,31,0,220,33,94,20,57,13,37,15,21,2,10,12,43,3,0,12,22,94,2.48
10069,"Darrick Martin\martida01","2004-05",33,"LAC","NBA",0.1,11,0,190,16,50,11,32,5,18,5,8,3,7,10,28,6,0,6,19,42,3.8
10070,"Darrick Martin\martida01","1994-95",23,"MIN","NBA",0.1,34,9,803,95,233,88,195,7,38,57,65,14,50,64,133,34,0,62,88,254,8.19
10071,"Kevin Martin\martike02","2004-05",21,"SAC","NBA",0.1,45,0,455,45,117,40,92,5,25,36,55,29,29,58,22,16,3,24,35,131,2.58
10072,"Roger Mason\masonro01","2002-03",22,"CHI","NBA",0.1,17,0,113,11,31,5,13,6,18,2,2,2,10,12,12,4,0,5,20,30,1.76
10073,"Roger Mason\masonro01","2003-04",23,"TOT","NBA",0.1,26,3,328,32,98,19,59,13,39,19,22,1,30,31,26,11,6,20,36,96,3.26
10074,"Mangok Mathiang\mathima01","2017-18",25,"CHO","NBA",0.1,4,0,20,4,7,4,7,0,0,0,1,3,7,10,0,1,0,0,5,8,2.33
10075,"Eric Maynor\maynoer01","2011-12",24,"OKC","NBA",0.1,9,0,137,14,39,8,22,6,17,4,4,3,10,13,22,5,0,11,13,38,4.66
10076,"O.J. Mayo\mayooj01","2013-14",26,"MIL","NBA",0.1,52,23,1346,224,550,140,323,84,227,76,88,24,100,124,113,28,13,95,111,608,9.11
10077,"George McCloud\mccloge01","2001-02",34,"DEN","NBA",0.1,69,26,1830,206,576,146,354,60,222,132,163,67,184,251,204,58,19,144,175,604,8.48
10078,"Jelani McCoy\mccoyje01","2001-02",24,"LAL","NBA",0.1,21,0,104,12,21,12,21,0,0,2,8,8,17,25,7,0,5,8,14,26,1.53
10079,"Chris McCullough\mcculch01","2016-17",21,"TOT","NBA",0.1,16,0,80,16,32,15,25,1,7,3,5,9,10,19,2,2,2,3,7,36,1.97
10080,"Ivan McFarlin\mcfariv01","2006-07",24,"PHI","NBA",0.1,11,0,41,5,13,5,12,0,1,5,7,7,4,11,1,0,0,1,8,15,1.11
10081,"Jim McIlvaine\mcilvji01","2000-01",28,"NJN","NBA",0.1,18,3,193,10,28,10,28,0,0,8,12,8,27,35,4,7,15,9,35,28,2.51
10082,"Jeff McInnis\mcinnje01","1996-97",22,"DEN","NBA",0.1,13,0,117,23,49,11,23,12,26,7,10,2,4,6,18,2,1,13,16,65,4.34
10083,"Jeff McInnis\mcinnje01","2007-08",33,"CHA","NBA",0.1,54,26,1410,108,249,105,230,3,19,23,30,16,80,96,220,23,3,76,120,242,6.03
10084,"Aaron McKie\mckieaa01","2005-06",33,"LAL","NBA",0.1,14,0,121,3,12,3,10,0,2,1,2,3,17,20,11,5,0,2,7,7,1.44
10085,"Aaron McKie\mckieaa01","2006-07",34,"LAL","NBA",0.1,10,0,131,11,17,11,17,0,0,0,0,1,17,18,13,4,0,8,14,22,3.48
10086,"Alfonzo McKinnie\mckinal01","2017-18",25,"TOR","NBA",0.1,14,0,53,8,15,5,6,3,9,2,3,1,6,7,1,1,1,3,8,21,1.32
10087,"Josh McRoberts\mcrobjo01","2007-08",20,"POR","NBA",0.1,8,0,28,6,10,6,9,0,1,0,0,2,8,10,2,1,0,2,1,12,1.73
10088,"Stanislav Medvedenko\medvest01","2000-01",21,"LAL","NBA",0.1,7,0,39,12,25,11,24,1,1,7,12,1,8,9,2,1,1,3,9,32,3.43
10089,"Jodie Meeks\meeksjo01","2015-16",28,"DET","NBA",0.1,3,0,43,7,20,3,11,4,9,4,4,1,4,5,3,0,0,1,2,22,4.97
10090,"Jordan Mickey\mickejo01","2015-16",21,"BOS","NBA",0.1,16,0,57,8,22,8,22,0,0,5,10,6,7,13,1,0,11,1,5,21,1.27
10091,"Jordan Mickey\mickejo01","2016-17",22,"BOS","NBA",0.1,25,1,141,15,34,15,33,0,1,8,14,13,21,34,7,3,6,9,12,38,1.74
10092,"Chris Mihm\mihmch01","2008-09",29,"LAL","NBA",0.1,18,0,105,15,40,15,40,0,0,6,7,15,19,34,10,1,6,10,23,36,2.19
10093,"Mike Miller\millemi01","2016-17",36,"DEN","NBA",0.1,20,0,151,9,23,1,3,8,20,2,2,2,36,38,22,2,0,13,9,28,2.41
10094,"Chris Mills\millsch01","2000-01",31,"GSW","NBA",0.1,15,8,493,71,191,64,166,7,25,31,36,24,69,93,18,9,5,20,43,180,9
10095,"Elijah Millsap\millsel01","2015-16",28,"UTA","NBA",0.1,20,0,173,11,39,10,27,1,12,13,18,6,29,35,19,7,3,9,33,36,2.38
10096,"Tony Mitchell\mitchto03","2013-14",24,"MIL","NBA",0.1,3,0,10,3,5,3,4,0,1,0,0,1,0,1,1,1,0,0,0,6,1.93
10097,"Naz Mitrou-Long\mitrona01","2017-18",24,"UTA","NBA",0.1,1,0,1,1,1,0,0,1,1,0,0,0,0,0,0,0,0,0,0,3,2.7
10098,"Nazr Mohammed\mohamna01","2014-15",37,"CHI","NBA",0.1,23,0,128,13,30,13,30,0,0,1,3,11,27,38,3,4,5,7,16,27,1.53
10099,"Mikki Moore\mooremi01","2002-03",27,"TOT","NBA",0.1,8,0,43,5,13,5,13,0,0,8,10,6,2,8,3,0,4,2,7,18,2.27
10100,"Mikki Moore\mooremi01","1998-99",23,"DET","NBA",0.1,2,0,6,1,1,1,1,0,0,2,2,0,1,1,0,0,0,0,0,4,2.05
10101,"Mikki Moore\mooremi01","2005-06",30,"SEA","NBA",0.1,47,1,583,54,124,54,122,0,2,46,62,44,86,130,27,7,15,40,92,154,3.63
10102,"Mikki Moore\mooremi01","2011-12",36,"GSW","NBA",0.1,7,0,118,9,20,9,20,0,0,6,7,7,15,22,5,3,3,7,24,24,4.37
10103,"Tracy Moore\mooretr01","1993-94",28,"DET","NBA",0.1,3,0,10,2,3,2,3,0,0,2,2,0,1,1,0,2,0,0,0,6,2.37
10104,"Jaylen Morris\morrija01","2018-19",23,"MIL","NBA",0.1,4,0,29,4,10,3,7,1,3,1,2,0,5,5,4,2,0,1,1,10,2.75
10105,"Byron Mullens\mulleby01","2012-13",23,"CHA","NBA",0.1,53,41,1428,217,563,151,355,66,208,64,99,71,266,337,81,34,32,74,110,564,9.26
10106,"Todd Mundt\mundtto01","1995-96",25,"TOT","NBA",0.1,33,0,151,16,41,16,41,0,0,5,8,11,17,28,3,2,5,3,29,37,0.98
10107,"Xavier Munford\munfoxa02","2015-16",23,"MEM","NBA",0.1,14,0,244,32,77,23,54,9,23,7,14,3,28,31,22,13,3,15,25,80,5.64
10108,"Eric Murdock\murdoer01","1999-00",31,"LAC","NBA",0.1,40,15,693,79,205,63,163,16,42,51,80,15,62,77,108,47,5,58,67,225,6.46
10109,"Tod Murphy\murphto01","1993-94",30,"TOT","NBA",0.1,9,0,67,6,12,6,12,0,0,3,6,4,6,10,4,2,0,1,10,15,1.84
10110,"Pete Myers\myerspe01","1997-98",34,"NYK","NBA",0.1,9,0,40,5,10,5,10,0,0,4,6,5,5,10,3,4,0,4,7,14,2.03
10111,"Hamady N'Diaye\ndiayha01","2010-11",24,"WAS","NBA",0.1,16,0,80,4,5,4,5,0,0,6,12,2,5,7,0,2,5,3,18,14,1.12
10112,"Boštjan Nachbar\nachbbo01","2005-06",25,"TOT","NBA",0.1,36,13,502,54,156,35,85,19,71,30,44,8,52,60,27,16,5,24,65,157,3.51
10113,"Eduardo Nájera\najered01","2008-09",32,"NJN","NBA",0.1,27,0,319,33,74,28,49,5,25,8,22,17,50,67,19,10,4,18,50,79,3.25
10114,"Shabazz Napier\napiesh01","2015-16",24,"ORL","NBA",0.1,55,0,600,68,201,34,97,34,104,33,45,9,46,55,97,23,1,46,38,203,3.61
10115,"Steve Nash\nashst01","2013-14",39,"LAL","NBA",0.1,15,10,313,36,94,28,70,8,24,22,24,4,25,29,86,7,2,31,18,102,8.67
10116,"Ivano Newbill\newbiiv01","1994-95",24,"DET","NBA",0.1,34,0,331,16,45,16,45,0,0,8,22,40,41,81,17,12,11,12,60,40,2.16
10117,"Ira Newble\newblir01","2005-06",31,"CLE","NBA",0.1,36,3,353,17,57,14,44,3,13,11,16,21,35,56,9,5,10,12,47,48,1.49
10118,"Ira Newble\newblir01","2003-04",29,"CLE","NBA",0.1,64,25,1245,108,276,106,257,2,19,36,46,65,90,155,72,25,19,54,109,254,3.92
10119,"Andrew Nicholson\nichoan01","2014-15",25,"ORL","NBA",0.1,40,3,492,83,190,70,149,13,41,15,25,17,65,82,22,6,12,24,51,194,3.82
10120,"Gaylon Nickerson\nickega01","1996-97",27,"TOT","NBA",0.1,4,0,42,4,12,4,10,0,2,7,7,1,4,5,1,1,1,1,1,15,3.15
10121,"Joakim Noah\noahjo01","2017-18",32,"NYK","NBA",0.1,7,0,40,5,10,5,10,0,0,2,4,6,8,14,4,2,2,4,5,12,2.57
10122,"Steve Novak\novakst01","2015-16",32,"TOT","NBA",0.1,10,0,44,8,18,1,3,7,15,1,1,0,5,5,0,0,0,1,3,24,1.66
10123,"James Nunnally\nunnaja01","2018-19",28,"TOT","NBA",0.1,15,0,102,12,34,4,9,8,25,4,4,0,5,5,7,1,0,1,10,36,1.66
10124,"Johnny O'Bryant\obryajo01","2016-17",23,"TOT","NBA",0.1,11,0,80,15,30,12,24,3,6,5,6,9,10,19,6,0,1,6,10,38,3.19
10125,"Dan O'Sullivan\osullda01","1992-93",24,"TOT","NBA",0.1,6,0,17,3,5,3,5,0,0,3,4,2,4,6,1,1,0,0,4,9,1.73
10126,"Charles Oakley\oaklech01","2003-04",40,"HOU","NBA",0.1,7,0,25,2,6,2,6,0,0,5,6,0,5,5,2,0,0,1,8,9,1.23
10127,"Kevin Ollie\ollieke01","2004-05",32,"PHI","NBA",0.1,26,0,158,11,31,11,31,0,0,6,9,3,16,19,19,5,0,6,16,28,1.36
10128,"Chinanu Onuaku\onuakch01","2016-17",20,"HOU","NBA",0.1,5,1,52,5,7,5,7,0,0,4,4,2,8,10,3,3,1,4,6,14,4.18
10129,"Doug Overton\overtdo01","1998-99",29,"TOT","NBA",0.1,24,1,244,36,84,34,77,2,7,18,20,7,14,21,23,5,1,20,18,92,3.21
10130,"Larry Owens\owensla01","2011-12",29,"NJN","NBA",0.1,7,0,75,4,11,2,6,2,5,3,4,2,11,13,4,0,1,2,10,13,2.17
10131,"Robert Pack\packro01","2003-04",34,"NJN","NBA",0.1,26,0,220,22,52,22,52,0,0,5,6,4,14,18,27,12,1,16,20,49,2.3
10132,"Robert Pack\packro01","2001-02",32,"MIN","NBA",0.1,16,0,252,25,68,24,64,1,4,11,15,7,16,23,49,13,0,20,32,62,4.96
10133,"Scott Padgett\padgesc01","1999-00",23,"UTA","NBA",0.1,47,9,432,44,140,31,96,13,44,19,27,24,64,88,25,14,8,22,55,120,2.31
10134,"Scott Padgett\padgesc01","2006-07",30,"TOT","NBA",0.1,31,0,231,16,56,8,23,8,33,6,13,16,38,54,8,5,3,9,35,46,1.44
10135,"Jannero Pargo\pargoja01","2003-04",24,"TOT","NBA",0.1,31,1,479,81,199,59,137,22,62,23,27,8,29,37,70,13,6,47,50,207,5.79
10136,"Jannero Pargo\pargoja01","2002-03",23,"LAL","NBA",0.1,34,0,342,37,93,30,69,7,24,4,4,9,28,37,39,13,2,23,45,85,2.68
10137,"Smush Parker\parkesm01","2002-03",21,"CLE","NBA",0.1,66,18,1103,136,338,98,220,38,118,98,118,29,90,119,162,48,12,133,106,408,6.59
10138,"Cherokee Parks\parksch02","2003-04",31,"GSW","NBA",0.1,12,0,64,4,10,4,10,0,0,4,6,4,6,10,1,0,3,2,7,12,1.05
10139,"Andrae Patterson\pattean01","1999-00",24,"MIN","NBA",0.1,5,0,20,3,4,3,4,0,0,0,0,1,1,2,1,1,0,1,4,6,1.38
10140,"Ruben Patterson\patteru01","2007-08",32,"LAC","NBA",0.1,20,5,327,39,86,39,84,0,2,24,43,24,40,64,17,21,7,27,37,102,5.66
10141,"Sasha Pavlović\pavloal01","2012-13",29,"POR","NBA",0.1,39,1,528,42,119,24,59,18,60,1,6,7,49,56,32,24,5,14,59,103,2.74
10142,"Gary Payton\paytoga02","2018-19",26,"WAS","NBA",0.1,3,0,16,5,8,4,6,1,2,0,0,1,1,2,4,3,1,1,2,11,4.9
10143,"Oleksiy Pecherov\pecheol01","2009-10",24,"MIN","NBA",0.1,44,5,447,77,188,63,136,14,52,29,32,32,92,124,11,9,14,32,55,197,3.89
10144,"Mike Penberthy\penbemi01","2001-02",27,"LAL","NBA",0.1,3,0,12,1,2,1,2,0,0,3,4,0,2,2,2,2,0,0,0,5,2.6
10145,"Desmond Penigar\penigde01","2003-04",22,"ORL","NBA",0.1,10,0,89,14,28,14,28,0,0,4,4,6,18,24,3,2,2,6,14,32,3.31
10146,"Mike Peplowski\peplomi01","1994-95",24,"DET","NBA",0.1,6,0,21,5,5,5,5,0,0,1,2,1,2,3,1,1,0,2,10,11,2
10147,"Kendrick Perkins\perkike01","2014-15",30,"TOT","NBA",0.1,68,3,1148,102,227,102,226,0,1,42,83,91,229,320,51,16,42,95,162,246,4.71
10148,"Kendrick Perkins\perkike01","2003-04",19,"BOS","NBA",0.1,10,0,35,8,15,8,15,0,0,6,9,5,9,14,3,0,2,5,6,22,2.26
10149,"Eric Piatkowski\piatker01","2007-08",37,"PHO","NBA",0.1,16,0,113,12,33,1,7,11,26,4,4,1,11,12,10,0,1,6,11,39,2.08
10150,"Eric Piatkowski\piatker01","2005-06",35,"CHI","NBA",0.1,29,1,228,24,61,15,28,9,33,2,5,4,19,23,13,6,1,11,20,59,1.71
10151,"Paul Pierce\piercpa01","2016-17",39,"LAC","NBA",0.1,25,7,277,28,70,13,27,15,43,10,13,1,47,48,10,4,5,16,40,81,3.03
10152,"Zoran Planinić\planizo01","2005-06",23,"NJN","NBA",0.1,56,1,596,66,183,53,127,13,56,46,66,14,60,74,53,20,4,43,91,191,3.05
10153,"Mark Pope\popema01","2001-02",29,"MIL","NBA",0.1,45,12,426,36,91,32,66,4,25,11,21,20,53,73,17,11,11,15,47,87,2.08
10154,"Vitaly Potapenko\potapvi01","2005-06",30,"TOT","NBA",0.1,33,12,353,37,71,37,71,0,0,10,17,27,37,64,9,2,2,16,50,84,2.47
10155,"Alex Poythress\poythal01","2017-18",24,"IND","NBA",0.1,25,0,104,11,26,7,15,4,11,0,0,7,10,17,2,3,1,2,16,26,0.96
10156,"Paul Pressey\presspa01","1992-93",34,"GSW","NBA",0.1,18,0,268,29,66,29,62,0,4,21,27,8,23,31,30,11,5,23,36,79,4.99
10157,"Phil Pressey\pressph01","2013-14",22,"BOS","NBA",0.1,75,11,1132,78,253,50,147,28,106,29,45,20,85,105,241,68,5,87,97,213,4.57
10158,"Brent Price\pricebr01","1999-00",31,"VAN","NBA",0.1,41,0,424,41,119,16,51,25,68,34,39,8,29,37,69,17,1,47,63,141,3.73
10159,"Ronnie Price\pricero01","2011-12",28,"PHO","NBA",0.1,36,8,517,49,130,36,86,13,44,20,25,18,38,56,67,34,3,46,72,131,4.53
10160,"Ronnie Price\pricero01","2005-06",22,"SAC","NBA",0.1,29,0,150,21,58,15,31,6,27,12,12,5,10,15,11,6,0,10,10,60,1.64
10161,"Ronnie Price\pricero01","2008-09",25,"UTA","NBA",0.1,52,17,738,77,203,58,142,19,61,34,45,12,57,69,108,39,5,61,74,207,4.56
10162,"Gabe Pruitt\pruitga01","2007-08",21,"BOS","NBA",0.1,15,0,95,14,39,11,27,3,12,1,2,1,7,8,13,5,0,5,10,32,1.81
10163,"Joel Przybilla\przybjo01","2000-01",21,"MIL","NBA",0.1,33,13,270,12,35,12,35,0,0,3,11,29,42,71,2,3,30,13,56,27,1.75
10164,"Joel Przybilla\przybjo01","2003-04",24,"TOT","NBA",0.1,17,12,347,18,50,18,50,0,0,13,31,32,79,111,7,5,17,18,53,49,4.72
10165,"Chris Quinn\quinnch01","2009-10",26,"NJN","NBA",0.1,25,0,223,20,56,10,24,10,32,6,6,1,15,16,29,9,1,10,15,56,2.45
10166,"Chris Quinn\quinnch01","2010-11",27,"SAS","NBA",0.1,41,0,292,33,91,22,54,11,37,4,8,3,22,25,42,5,1,12,29,81,1.8
10167,"Vladimir Radmanović\radmavl01","2012-13",32,"CHI","NBA",0.1,25,0,144,13,43,8,16,5,27,2,3,10,18,28,8,8,4,7,29,33,1.41
10168,"Igor Rakočević\rakocig01","2002-03",24,"MIN","NBA",0.1,42,0,244,22,58,17,46,5,12,29,36,4,13,17,33,4,0,23,25,78,1.84
10169,"Shavlik Randolph\randosh01","2013-14",30,"PHO","NBA",0.1,14,0,95,7,14,7,14,0,0,6,11,7,18,25,1,3,1,5,15,20,1.81
10170,"Theo Ratliff\ratlith01","2006-07",33,"BOS","NBA",0.1,2,2,44,1,3,1,3,0,0,3,4,2,5,7,0,1,3,1,6,5,4.4
10171,"Eldridge Recasner\recasel01","1999-00",32,"CHH","NBA",0.1,7,0,28,3,7,2,3,1,4,0,0,0,4,4,5,0,0,0,1,7,1.2
10172,"Michael Redd\reddmi01","2010-11",31,"MIL","NBA",0.1,10,0,134,18,45,14,28,4,17,4,4,0,8,8,12,2,1,4,4,44,3.4
10173,"Davon Reed\reedda01","2018-19",23,"IND","NBA",0.1,10,0,47,5,12,3,8,2,4,0,0,2,4,6,3,1,0,1,3,12,1.11
10174,"Khalid Reeves\reevekh01","1998-99",26,"DET","NBA",0.1,11,0,112,8,21,7,18,1,3,8,14,3,4,7,11,4,0,7,13,25,2.33
10175,"J.R. Reid\reidjr01","2000-01",32,"CLE","NBA",0.1,6,0,39,2,5,2,5,0,0,6,8,5,3,8,1,2,1,1,4,10,2.18
10176,"Ryan Reid\reidry01","2011-12",25,"OKC","NBA",0.1,5,0,17,4,5,4,5,0,0,0,0,1,1,2,0,0,0,1,1,8,1.38
10177,"Shawn Respert\respesh01","1998-99",26,"PHO","NBA",0.1,12,1,99,13,36,9,23,4,13,7,10,2,11,13,8,5,0,5,10,37,2.63
10178,"Malachi Richardson\richama01","2016-17",21,"SAC","NBA",0.1,22,0,198,28,68,20,40,8,28,15,19,3,20,23,11,5,1,8,23,79,2.89
10179,"Luke Ridnour\ridnolu01","2013-14",32,"TOT","NBA",0.1,61,14,1141,126,327,89,219,37,108,17,26,23,74,97,176,32,8,66,92,306,5.3
10180,"Anthony Roberson\roberan02","2006-07",23,"GSW","NBA",0.1,20,1,227,44,104,23,49,21,55,2,3,2,19,21,10,12,0,13,27,111,4.14
10181,"Bernard Robinson\robinbe01","2006-07",26,"TOT","NBA",0.1,31,0,278,19,62,19,60,0,2,23,27,10,38,48,19,17,2,16,32,61,2.4
10182,"Glenn Robinson\robingl02","2014-15",21,"TOT","NBA",0.1,35,1,261,26,67,21,48,5,19,16,24,15,24,39,11,6,1,11,15,73,1.81
10183,"Jerome Robinson\robinje01","2018-19",21,"LAC","NBA",0.1,33,0,320,44,110,26,53,18,57,6,9,3,38,41,19,11,3,13,46,112,2.85
10184,"Malik Rose\rosema01","2006-07",32,"NYK","NBA",0.1,65,2,810,74,186,72,178,2,8,42,52,47,128,175,65,26,9,65,120,192,3.62
10185,"Damjan Rudež\rudezda01","2015-16",29,"MIN","NBA",0.1,33,0,277,25,62,8,12,17,50,8,8,5,15,20,11,3,1,13,33,75,1.85
10186,"Damjan Rudež\rudezda01","2016-17",30,"ORL","NBA",0.1,45,0,314,31,88,11,24,20,64,0,0,5,20,25,20,12,1,9,31,82,1.54
10187,"Michael Ruffin\ruffimi01","2008-09",32,"POR","NBA",0.1,11,0,35,2,7,2,7,0,0,2,2,6,5,11,0,3,1,2,7,6,0.91
10188,"Trevor Ruffin\ruffitr01","1994-95",24,"PHO","NBA",0.1,49,1,319,84,197,46,98,38,99,27,38,8,15,23,48,14,2,47,52,233,3.72
10189,"Kareem Rush\rushka01","2004-05",24,"TOT","NBA",0.1,48,22,968,157,406,106,269,51,137,37,48,20,69,89,68,20,7,47,74,402,5.92
10190,"John Salmons\salmojo01","2014-15",35,"NOP","NBA",0.1,21,0,270,16,48,8,22,8,26,2,4,4,17,21,13,9,4,5,25,42,2.06
10191,"Soumaila Samake\samakso01","2000-01",22,"NJN","NBA",0.1,34,0,226,18,48,18,48,0,0,10,24,22,31,53,1,2,14,4,23,46,1.4
10192,"Cheikh Samb\sambch01","2007-08",23,"DET","NBA",0.1,4,0,31,3,4,3,4,0,0,1,2,3,4,7,0,1,2,1,8,7,2.55
10193,"JaKarr Sampson\sampsja02","2015-16",22,"TOT","NBA",0.1,73,40,1160,140,317,126,254,14,63,80,122,46,144,190,46,23,33,70,142,374,4.73
10194,"Brian Scalabrine\scalabr01","2010-11",32,"CHI","NBA",0.1,18,0,88,10,19,10,14,0,5,0,0,1,7,8,6,3,4,5,18,20,1.33
10195,"Dwayne Schintzius\schindw01","1992-93",24,"NJN","NBA",0.1,5,0,35,2,7,2,7,0,0,3,3,2,6,8,2,2,2,0,4,7,2.18
10196,"Wayne Selden\seldewa01","2016-17",22,"TOT","NBA",0.1,14,5,236,25,58,18,30,7,28,14,22,1,15,16,13,6,1,12,18,71,4.24
10197,"Kevin Séraphin\serapke01","2012-13",23,"WAS","NBA",0.1,79,8,1721,330,716,330,716,0,0,61,88,107,239,346,57,24,59,130,211,721,7.4
10198,"Brian Shaw\shawbr01","1997-98",31,"TOT","NBA",0.1,59,34,1530,154,446,126,351,28,95,36,52,37,178,215,261,49,17,99,148,372,7.54
10199,"Garret Siler\silerga01","2010-11",24,"PHO","NBA",0.1,21,0,101,17,31,17,31,0,0,11,22,16,12,28,3,1,4,10,20,45,2.04
10200,"Bobby Simmons\simmobo01","2009-10",29,"NJN","NBA",0.1,23,2,395,42,117,22,54,20,63,18,20,11,52,63,15,15,3,19,52,122,4.73
10201,"Anfernee Simons\simonan01","2018-19",19,"POR","NBA",0.1,20,1,141,28,63,18,34,10,29,9,16,3,10,13,13,1,0,11,9,75,2.73
10202,"Dickey Simpkins\simpkdi01","1996-97",24,"CHI","NBA",0.1,48,0,395,31,93,30,89,1,4,28,40,36,56,92,31,5,5,35,44,91,2.09
10203,"Scott Skiles\skilesc01","1995-96",31,"PHI","NBA",0.1,10,9,236,20,57,5,23,15,34,8,10,1,15,16,38,7,0,16,21,63,7.03
10204,"Brian Skinner\skinnbr01","1998-99",22,"LAC","NBA",0.1,21,0,258,33,71,33,71,0,0,20,33,20,33,53,1,10,13,19,20,86,4.06
10205,"Reggie Slater\slatere01","2001-02",31,"TOT","NBA",0.1,8,0,47,7,15,7,15,0,0,7,10,5,4,9,1,1,1,1,3,21,2.26
10206,"Donald Sloan\sloando01","2012-13",25,"TOT","NBA",0.1,23,0,263,27,78,20,59,7,19,20,25,3,25,28,38,5,0,14,17,81,3.39
10207,"Uroš Slokar\slokaur01","2006-07",23,"TOR","NBA",0.1,20,0,72,14,26,13,24,1,2,9,13,7,7,14,1,1,2,9,11,38,1.62
10208,"Theron Smith\smithth01","2003-04",23,"MEM","NBA",0.1,20,0,178,16,43,10,31,6,12,6,8,13,28,41,7,5,5,14,18,44,2.47
10209,"Zhaire Smith\smithzh01","2018-19",19,"PHI","NBA",0.1,6,2,111,14,34,8,18,6,16,6,8,3,10,13,10,2,2,6,8,40,6.1
10210,"Pape Sow\sowpa01","2006-07",25,"TOR","NBA",0.1,7,0,34,3,9,3,9,0,0,4,6,6,5,11,2,1,1,1,2,10,1.66
10211,"Tiago Splitter\splitti01","2016-17",32,"PHI","NBA",0.1,8,0,76,14,31,12,25,2,6,9,11,8,14,22,4,1,1,6,8,39,4.43
10212,"Lance Stephenson\stephla01","2016-17",26,"TOT","NBA",0.1,18,0,361,54,120,48,100,6,20,8,13,4,48,52,59,5,3,26,32,122,7.04
10213,"Alex Stepheson\stephal01","2015-16",28,"TOT","NBA",0.1,8,0,73,9,27,9,27,0,0,4,12,19,9,28,2,1,5,0,12,22,2.58
10214,"Larry Stewart\stewala01","1993-94",25,"WSB","NBA",0.1,3,0,35,3,8,3,8,0,0,7,10,1,6,7,2,2,1,2,4,13,4.77
10215,"Michael Stewart\stewami01","2001-02",26,"TOR","NBA",0.1,11,0,93,8,23,8,23,0,0,6,11,12,13,25,3,4,3,4,22,22,2.3
10216,"Michael Stewart\stewami01","2002-03",27,"CLE","NBA",0.1,47,0,251,14,37,14,37,0,0,8,12,19,36,55,6,2,15,10,42,36,1.12
10217,"Michael Stewart\stewami01","2000-01",25,"TOR","NBA",0.1,26,0,123,11,34,11,34,0,0,11,18,16,13,29,2,4,3,5,19,33,1.15
10218,"Greg Stiemsma\stiemgr01","2014-15",29,"TOR","NBA",0.1,17,0,66,6,8,6,8,0,0,2,4,9,6,15,3,2,0,7,15,14,1.18
10219,"David Stockton\stockda01","2017-18",26,"UTA","NBA",0.1,3,0,9,2,3,0,0,2,3,4,4,0,0,0,0,0,0,1,3,10,2.9
10220,"Jarnell Stokes\stokeja01","2016-17",23,"DEN","NBA",0.1,2,0,7,1,1,1,1,0,0,1,2,1,1,2,2,1,0,0,3,3,2.75
10221,"Jarnell Stokes\stokeja01","2015-16",22,"TOT","NBA",0.1,7,0,18,3,5,3,5,0,0,1,2,1,3,4,1,1,0,0,1,7,1.09
10222,"Julyan Stone\stoneju01","2012-13",24,"DEN","NBA",0.1,4,0,28,2,2,2,2,0,0,3,4,2,1,3,2,1,0,2,4,7,2.4
10223,"Awvee Storey\storeaw01","2005-06",28,"WAS","NBA",0.1,25,1,116,16,41,13,34,3,7,8,14,8,14,22,4,3,1,5,22,43,1.34
10224,"Amar'e Stoudemire\stoudam01","2005-06",23,"PHO","NBA",0.1,3,3,50,9,27,9,26,0,1,8,9,6,10,16,2,1,3,1,4,26,7.07
10225,"Edmond Sumner\sumneed01","2018-19",23,"IND","NBA",0.1,23,2,210,22,64,15,37,7,27,15,24,9,15,24,10,12,5,10,26,66,2.54
10226,"Bob Sura\surabo01","2000-01",27,"GSW","NBA",0.1,53,42,1684,202,518,155,346,47,172,135,189,54,173,227,242,54,8,160,127,586,11.37
10227,"Žan Tabak\tabakza01","1999-00",29,"IND","NBA",0.1,18,0,114,16,34,16,34,0,0,5,8,16,16,32,4,3,9,11,13,37,2.41
10228,"Žan Tabak\tabakza01","1996-97",26,"TOR","NBA",0.1,13,4,218,32,71,32,71,0,0,20,29,20,29,49,14,6,11,21,35,84,6.66
10229,"Edy Tavares\tavarwa01","2016-17",24,"TOT","NBA",0.1,2,0,28,4,5,4,5,0,0,0,3,4,7,11,1,0,6,2,3,8,7.1
10230,"Jermaine Taylor\tayloje02","2009-10",23,"HOU","NBA",0.1,31,4,303,45,119,40,97,5,22,33,46,21,25,46,16,10,3,19,15,128,3.2
10231,"Jermaine Taylor\tayloje02","2010-11",24,"TOT","NBA",0.1,34,8,483,94,196,80,151,14,45,21,28,26,36,62,32,14,5,46,39,223,5.45
10232,"Sebastian Telfair\telfase01","2010-11",25,"MIN","NBA",0.1,37,8,711,97,241,69,163,28,78,44,60,17,37,54,111,25,3,64,64,266,6.92
10233,"Emanuel Terry\terryem01","2018-19",22,"TOT","NBA",0.1,3,0,23,4,7,4,7,0,0,2,4,3,4,7,2,3,0,2,4,10,4.37
10234,"Etan Thomas\thomaet01","2008-09",30,"WAS","NBA",0.1,26,7,306,32,66,32,66,0,0,16,23,25,41,66,6,3,18,18,35,80,3.46
10235,"Kenny Thomas\thomake01","2008-09",31,"SAC","NBA",0.1,8,0,62,3,8,3,8,0,0,0,0,4,11,15,1,6,1,1,9,6,1.88
10236,"Lance Thomas\thomala01","2018-19",30,"NYK","NBA",0.1,46,17,783,78,197,56,118,22,79,27,36,21,96,117,27,17,7,24,83,205,3.96
10237,"Malcolm Thomas\thomama01","2014-15",26,"PHI","NBA",0.1,17,0,194,18,40,18,33,0,7,9,13,16,40,56,7,3,1,13,17,45,3.15
10238,"Tyrus Thomas\thomaty01","2014-15",28,"MEM","NBA",0.1,2,0,7,1,1,1,1,0,0,2,2,0,0,0,1,0,0,0,0,4,2.2
10239,"Brooks Thompson\thompbr01","1994-95",24,"ORL","NBA",0.1,38,2,246,45,114,27,56,18,58,8,12,7,16,23,43,10,2,27,46,116,2.72
10240,"Dijon Thompson\thompdi01","2005-06",22,"PHO","NBA",0.1,10,0,43,11,25,7,14,4,11,2,2,4,7,11,1,3,1,2,6,28,2.37
10241,"Dijon Thompson\thompdi01","2006-07",23,"ATL","NBA",0.1,6,0,50,6,15,6,13,0,2,5,6,3,5,8,2,0,0,1,2,17,2.18
10242,"LaSalle Thompson\thompla01","1994-95",33,"IND","NBA",0.1,38,3,453,49,118,49,118,0,0,14,16,28,61,89,18,18,10,33,76,112,3.19
10243,"Jamaal Tinsley\tinslja01","2011-12",33,"UTA","NBA",0.1,37,1,507,57,141,47,104,10,37,13,17,6,39,45,123,17,8,52,47,137,5.03
10244,"Axel Toupane\toupaax01","2016-17",24,"TOT","NBA",0.1,4,0,47,5,9,4,5,1,4,0,0,0,1,1,0,1,1,0,6,11,2.2
10245,"Keith Tower\towerke01","1995-96",25,"LAC","NBA",0.1,34,1,305,32,72,32,71,0,1,18,26,22,29,51,5,4,11,16,50,82,2.26
10246,"Gary Trent\trentga01","1999-00",25,"DAL","NBA",0.1,11,11,301,70,142,70,140,0,2,11,21,20,32,52,22,8,3,25,28,151,11.08
10247,"Alando Tucker\tuckeal02","2009-10",25,"TOT","NBA",0.1,15,0,96,17,39,16,32,1,7,16,21,6,4,10,4,0,0,5,6,51,2.35
10248,"P.J. Tucker\tuckepj01","2006-07",21,"TOR","NBA",0.1,17,0,83,11,22,11,22,0,0,8,14,11,12,23,3,2,0,6,12,30,1.76
10249,"Henry Turner\turnehe02","1994-95",28,"SAC","NBA",0.1,30,0,149,23,57,21,52,2,5,20,35,17,11,28,7,8,1,12,20,68,1.87
10250,"Jarred Vanderbilt\vandeja01","2018-19",19,"DEN","NBA",0.1,17,0,69,9,19,9,18,0,1,6,10,7,16,23,3,6,1,8,8,24,1.81
10251,"David Vaughn\vaughda02","1996-97",23,"ORL","NBA",0.1,35,6,298,31,72,31,72,0,0,19,30,35,60,95,7,8,15,29,43,81,2.86
10252,"Jacque Vaughn\vaughja01","1998-99",23,"UTA","NBA",0.1,19,0,87,11,30,9,22,2,8,20,24,1,10,11,12,5,0,14,14,44,2.29
10253,"Jacque Vaughn\vaughja01","2008-09",33,"SAS","NBA",0.1,30,0,292,24,75,23,74,1,1,16,18,4,18,22,55,6,0,15,26,65,2.49
10254,"Gundars Vētra\vetragu01","1992-93",25,"MIN","NBA",0.1,13,0,89,19,40,16,37,3,3,4,6,4,4,8,6,2,0,2,12,45,2.55
10255,"Charlie Villanueva\villach01","2013-14",29,"DET","NBA",0.1,20,0,180,35,92,21,36,14,56,8,14,6,28,34,6,4,5,7,16,92,3.23
10256,"Marcus Vinicius\vincima01","2007-08",23,"NOH","NBA",0.1,13,0,69,9,20,4,8,5,12,5,11,1,7,8,2,1,1,3,4,28,1.65
10257,"Marcus Vinicius\vincima01","2006-07",22,"NOK","NBA",0.1,13,0,103,7,15,4,8,3,7,5,7,2,9,11,5,2,1,6,10,22,1.85
10258,"Jackson Vroman\vromaja01","2005-06",24,"NOK","NBA",0.1,41,2,406,26,66,26,66,0,0,21,44,33,53,86,11,12,11,21,78,73,2.19
10259,"Sasha Vujačić\vujacsa01","2016-17",32,"NYK","NBA",0.1,42,4,408,42,136,19,62,23,74,17,24,12,47,59,52,13,2,16,38,124,2.79
10260,"Dion Waiters\waitedi01","2017-18",26,"MIA","NBA",0.1,30,30,918,163,410,111,240,52,170,51,69,8,69,77,113,23,9,70,61,429,11.31
10261,"Antoine Walker\walkean02","2007-08",31,"MIN","NBA",0.1,46,1,892,136,375,75,187,61,188,35,66,56,112,168,45,33,8,46,80,368,6.19
10262,"Kenny Walker\walkeke01","1994-95",30,"WSB","NBA",0.1,24,0,266,18,42,18,42,0,0,21,28,19,28,47,7,5,5,15,42,57,2.68
10263,"Gerald Wallace\wallage01","2014-15",32,"BOS","NBA",0.1,32,0,286,14,34,13,31,1,3,6,15,17,40,57,11,15,4,18,19,35,1.92
10264,"Jameel Warney\warneja01","2017-18",24,"DAL","NBA",0.1,3,0,27,7,12,7,12,0,0,3,5,4,5,9,0,0,0,1,2,17,4.73
10265,"Julian Washburn\washbju01","2018-19",27,"MEM","NBA",0.1,18,3,254,16,48,11,24,5,24,3,4,8,33,41,14,13,2,7,16,40,2.94
10266,"Darryl Watkins\watkida01","2011-12",27,"NOH","NBA",0.1,5,0,98,7,14,7,14,0,0,9,18,8,19,27,3,5,4,8,14,23,6.62
10267,"Jamie Watson\watsoja01","1995-96",23,"UTA","NBA",0.1,16,0,217,18,43,15,36,3,7,9,13,5,22,27,24,8,2,17,30,48,3.78
10268,"Maalik Wayns\waynsma01","2013-14",22,"LAC","NBA",0.1,2,0,9,1,2,1,2,0,0,0,0,0,2,2,2,2,0,0,4,2,2.6
10269,"Marcus Webb\webbma01","1992-93",22,"BOS","NBA",0.1,9,0,51,13,25,13,24,0,1,13,21,5,5,10,2,1,2,5,11,39,3.48
10270,"Chris Webber\webbech01","2007-08",34,"GSW","NBA",0.1,9,8,126,15,31,15,31,0,0,5,12,2,30,32,18,4,6,11,17,35,5.57
10271,"Bonzi Wells\wellsbo01","1998-99",22,"POR","NBA",0.1,7,0,35,11,20,10,17,1,3,8,18,4,5,9,3,1,1,6,5,31,3.54
10272,"Bubba Wells\wellsbu01","1997-98",23,"DAL","NBA",0.1,39,2,395,48,116,47,110,1,6,31,43,22,46,68,34,15,4,31,40,128,3.33
10273,"Thomas Welsh\welshth01","2018-19",22,"DEN","NBA",0.1,11,0,36,7,13,4,6,3,7,1,2,0,4,4,5,0,0,1,3,18,1.49
10274,"Bill Wennington\wennibi01","1999-00",36,"SAC","NBA",0.1,7,0,57,6,19,6,19,0,0,2,2,5,14,19,1,2,2,1,13,14,2.11
10275,"Matt Wenstrom\wenstma01","1993-94",23,"BOS","NBA",0.1,11,0,37,6,10,6,10,0,0,6,10,6,6,12,0,0,2,4,7,18,1.64
10276,"Doug West\westdo01","1997-98",30,"MIN","NBA",0.1,38,10,688,64,171,64,169,0,2,29,40,23,59,82,45,11,5,21,97,157,3.61
10277,"Tyson Wheeler\wheelty01","1998-99",23,"DEN","NBA",0.1,1,0,3,1,1,0,0,1,1,1,2,0,0,0,2,0,0,0,1,4,4.7
10278,"Donald Whiteside\whitedo01","1996-97",27,"TOR","NBA",0.1,27,1,259,18,55,6,19,12,36,11,15,2,10,12,36,11,0,17,23,59,2.49
10279,"Jacob Wiley\wileyja01","2017-18",23,"BRK","NBA",0.1,5,0,33,1,4,0,2,1,2,1,2,2,9,11,2,1,0,0,4,4,1.6
10280,"C.J. Williams\willicj01","2018-19",28,"MIN","NBA",0.1,15,0,128,17,35,12,19,5,16,0,1,1,7,8,12,6,0,5,16,39,2.57
10281,"Elliot Williams\williel01","2014-15",25,"TOT","NBA",0.1,13,0,119,14,37,6,19,8,18,1,4,0,8,8,12,4,0,4,12,37,2.39
10282,"Eric Williams\willier01","2006-07",34,"TOT","NBA",0.1,21,0,121,19,47,11,28,8,19,8,14,3,14,17,7,3,0,7,12,54,1.95
10283,"Eric Williams\willier01","1997-98",25,"DEN","NBA",0.1,4,4,145,24,61,24,61,0,0,31,45,10,11,21,12,4,0,9,9,79,15.27
10284,"Eric Williams\willier01","2005-06",33,"TOR","NBA",0.1,28,11,352,29,75,24,57,5,18,28,38,10,40,50,15,7,2,15,55,91,3.04
10285,"Herb Williams\willihe01","1998-99",40,"NYK","NBA",0.1,6,0,34,4,8,4,8,0,0,2,2,3,3,6,0,0,2,2,2,10,1.63
10286,"Reggie Williams\willire01","1996-97",32,"TOT","NBA",0.1,13,0,200,29,76,20,42,9,34,9,12,5,26,31,10,8,4,12,33,76,4.88
10287,"Scott Williams\willisc01","2004-05",36,"CLE","NBA",0.1,19,0,152,12,41,12,40,0,1,9,11,15,15,30,8,4,6,5,30,33,1.79
10288,"D.J. Wilson\wilsodj01","2017-18",21,"MIL","NBA",0.1,22,0,71,9,16,7,11,2,5,1,2,2,8,10,3,3,1,4,7,21,1.04
10289,"David Wingate\wingada01","2000-01",37,"SEA","NBA",0.1,1,0,9,3,3,3,3,0,0,0,0,0,0,0,2,0,0,0,1,6,6.5
10290,"Loren Woods\woodslo01","2007-08",29,"HOU","NBA",0.1,7,0,17,3,5,3,5,0,0,0,0,0,1,1,2,0,0,0,2,6,0.79
10291,"Randy Woods\woodsra01","1992-93",22,"LAC","NBA",0.1,41,1,174,23,66,20,52,3,14,19,26,6,8,14,40,14,1,16,26,68,1.87
10292,"Randy Woods\woodsra01","1995-96",25,"DEN","NBA",0.1,8,0,72,6,22,1,1,5,21,2,2,3,3,6,12,6,1,5,13,19,2.94
10293,"Haywoode Workman\workmha01","1996-97",31,"IND","NBA",0.1,4,2,81,11,20,11,17,0,3,0,1,4,3,7,11,3,0,5,10,22,6.37
10294,"Metta World Peace\artesro01","2015-16",36,"LAL","NBA",0.1,35,5,590,55,177,29,93,26,84,40,57,19,70,89,27,22,11,15,67,176,4.33
10295,"James Worthy\worthja01","1993-94",32,"LAL","NBA",0.1,80,2,1597,340,838,308,727,32,111,100,135,48,133,181,154,45,18,97,80,812,7.32
10296,"Tony Wroten\wroteto01","2012-13",19,"MEM","NBA",0.1,35,0,272,33,86,29,70,4,16,21,29,13,15,28,43,8,4,29,34,91,2.65
10297,"James Young\youngja01","2017-18",22,"PHI","NBA",0.1,6,0,61,5,14,2,4,3,10,4,6,0,2,2,2,0,0,1,4,17,1.77
10298,"James Young\youngja01","2015-16",20,"BOS","NBA",0.1,29,0,199,11,36,5,10,6,26,1,4,4,22,26,9,6,1,5,17,29,1.05
10299,"Korleone Young\youngko01","1998-99",20,"DET","NBA",0.1,3,0,15,5,10,4,6,1,4,2,2,2,2,4,1,0,0,1,3,13,3.43
10300,"Nick Young\youngni01","2015-16",30,"LAL","NBA",0.1,54,2,1033,126,372,49,135,77,237,63,76,14,83,97,34,23,7,30,50,392,4.95
10301,"Wang Zhizhi\zhizhwa01","2003-04",26,"TOT","NBA",0.1,16,0,114,17,46,13,32,4,14,9,10,4,14,18,2,3,5,6,13,47,2.27
10302,"Wang Zhizhi\zhizhwa01","2002-03",25,"LAC","NBA",0.1,41,1,412,62,162,46,115,16,47,42,58,26,51,77,10,8,10,31,41,182,3.41
10303,"Wang Zhizhi\zhizhwa01","2000-01",23,"DAL","NBA",0.1,5,0,38,8,19,8,17,0,2,8,10,1,6,7,0,0,0,1,8,24,3.18
10304,"Aleksandar Đorđević\djordal01","1996-97",29,"POR","NBA",0.1,8,0,61,8,16,3,9,5,7,4,5,1,4,5,5,0,0,5,3,25,2.76
10305,"Tariq Abdul-Wahad\abdulta01","2001-02",27,"TOT","NBA",0,24,12,441,55,147,54,145,1,2,24,33,41,43,84,24,20,10,27,56,135,5.33
10306,"Shareef Abdur-Rahim\abdursh01","2007-08",31,"SAC","NBA",0,6,0,51,3,14,3,14,0,0,4,4,6,4,10,4,1,0,1,9,10,1.53
10307,"Alex Acker\ackeral01","2008-09",26,"TOT","NBA",0,25,0,199,30,76,23,56,7,20,5,10,8,16,24,12,5,4,7,9,72,2.18
10308,"Jordan Adams\adamsjo01","2015-16",21,"MEM","NBA",0,2,0,15,2,6,2,5,0,1,3,5,0,2,2,3,3,0,2,2,7,4.35
10309,"Maurice Ager\agerma01","2010-11",26,"MIN","NBA",0,4,0,29,6,11,3,7,3,4,0,0,0,2,2,1,1,0,4,4,15,3.05
10310,"Blake Ahearn\ahearbl01","2007-08",23,"MIA","NBA",0,12,0,177,15,57,5,23,10,34,30,31,1,18,19,19,6,0,16,20,70,5.22
10311,"Alexis Ajinça\ajincal01","2009-10",21,"CHA","NBA",0,6,0,30,5,10,5,10,0,0,0,1,1,3,4,0,1,1,2,5,10,1.32
10312,"Josh Akognon\akognjo01","2012-13",26,"DAL","NBA",0,3,0,9,2,4,1,2,1,2,0,0,0,1,1,1,0,0,0,3,5,1.37
10313,"DeVaughn Akoon-Purcell\akoonde01","2018-19",25,"DEN","NBA",0,7,0,22,3,10,3,6,0,4,1,2,1,3,4,6,2,0,2,4,7,1.23
10314,"Cole Aldrich\aldrico01","2017-18",29,"MIN","NBA",0,21,0,49,5,15,5,15,0,0,2,6,3,12,15,3,2,1,1,11,12,0.6
10315,"Cliff Alexander\alexacl01","2015-16",20,"POR","NBA",0,8,0,36,5,10,5,10,0,0,0,0,2,4,6,0,1,2,1,1,10,1.23
10316,"Cory Alexander\alexaco01","2004-05",31,"CHA","NBA",0,16,1,201,16,49,8,30,8,19,9,12,8,21,29,37,9,1,19,29,49,4.19
10317,"Gary Alexander\alexaga01","1993-94",24,"TOT","NBA",0,11,0,55,8,14,8,14,0,0,3,9,7,8,15,2,3,0,8,10,19,1.85
10318,"Joe Alexander\alexajo01","2009-10",23,"CHI","NBA",0,8,0,29,1,6,1,5,0,1,2,3,2,3,5,2,1,1,0,9,4,0.61
10319,"Grayson Allen\allengr01","2018-19",23,"UTA","NBA",0,38,2,416,67,178,35,79,32,99,45,60,3,20,23,25,6,6,33,47,211,3.79
10320,"Lance Allred\allrela01","2007-08",26,"CLE","NBA",0,3,0,10,1,4,1,4,0,0,1,2,0,1,1,0,0,0,0,1,3,0.2
10321,"Morris Almond\almonmo01","2011-12",26,"WAS","NBA",0,4,0,67,6,17,5,14,1,3,1,3,1,7,8,2,7,0,1,6,14,3.83
10322,"Peter Aluma\alumape01","1998-99",25,"SAC","NBA",0,2,0,5,1,2,1,2,0,0,0,0,1,1,2,0,1,1,2,4,2,1.75
10323,"John Amaechi\amaecjo01","2000-01",30,"ORL","NBA",0,82,36,1710,237,592,237,585,0,7,176,279,77,191,268,74,28,29,124,175,650,6.05
10324,"Chris Andersen\anderch01","2007-08",29,"NOH","NBA",0,5,0,34,2,7,2,7,0,0,2,4,2,7,9,0,0,4,1,6,6,1.5
10325,"Antonio Anderson\anderan02","2009-10",24,"OKC","NBA",0,1,0,15,1,3,1,3,0,0,0,0,1,0,1,0,0,0,1,1,2,0.7
10326,"Nick Anderson\anderni01","2000-01",33,"SAC","NBA",0,21,0,169,14,57,4,18,10,39,0,0,3,22,25,13,10,4,7,13,38,1.7
10327,"Martynas Andriuškevičius\andrima01","2005-06",19,"CLE","NBA",0,6,0,9,0,1,0,1,0,0,0,0,1,3,4,0,2,0,0,1,0,0.48
10328,"Thanasis Antetokounmpo\antetth01","2015-16",23,"NYK","NBA",0,2,0,6,3,4,3,3,0,1,0,0,0,1,1,0,0,0,0,2,6,2.4
10329,"Darrell Armstrong\armstda01","2005-06",37,"DAL","NBA",0,62,2,622,43,128,32,80,11,48,33,42,18,63,81,86,27,3,58,71,130,2.83
10330,"Darrell Arthur\arthuda01","2017-18",29,"DEN","NBA",0,19,1,141,22,47,14,24,8,23,2,3,3,12,15,9,8,3,15,22,54,2.73
10331,"Jamel Artis\artisja01","2017-18",25,"ORL","NBA",0,15,1,279,31,79,23,50,8,29,7,12,4,34,38,18,2,3,8,11,77,4.27
10332,"James Augustine\augusja01","2006-07",22,"ORL","NBA",0,2,0,7,1,3,1,3,0,0,0,0,1,2,3,2,0,0,0,2,2,1.45
10333,"Isaac Austin\austiis01","2001-02",32,"MEM","NBA",0,21,8,307,36,92,36,89,0,3,4,4,11,60,71,13,9,5,11,36,76,3.62
10334,"Isaac Austin\austiis01","1999-00",30,"WAS","NBA",0,59,23,1173,151,352,150,348,1,4,94,137,64,218,282,74,17,38,107,128,397,6.81
10335,"William Avery\averywi01","2000-01",21,"MIN","NBA",0,55,0,463,55,144,39,85,16,59,28,36,5,24,29,75,13,4,45,48,154,2.76
10336,"Chris Babb\babbch01","2013-14",23,"BOS","NBA",0,14,0,132,8,30,2,3,6,27,0,0,4,13,17,3,6,0,3,13,22,1.36
10337,"John Bagley\baglejo01","1993-94",33,"ATL","NBA",0,3,0,13,0,2,0,2,0,0,2,2,0,1,1,3,0,0,0,2,2,1.03
10338,"Cameron Bairstow\bairsca01","2015-16",25,"CHI","NBA",0,18,2,103,13,40,12,35,1,5,7,8,4,24,28,6,2,3,4,19,34,1.68
10339,"Maurice Baker\bakerma01","2004-05",25,"TOT","NBA",0,5,0,19,0,1,0,1,0,0,0,0,1,1,2,1,1,0,1,3,0,0.36
10340,"Renaldo Balkman\balkmre01","2009-10",25,"DEN","NBA",0,13,1,91,6,18,6,11,0,7,2,6,4,19,23,7,8,2,6,16,14,1.98
10341,"Marcus Banks\banksma01","2010-11",29,"TOR","NBA",0,3,0,22,0,2,0,2,0,0,6,8,0,1,1,3,1,0,2,4,6,2.43
10342,"Marcus Banks\banksma01","2008-09",27,"TOT","NBA",0,22,0,206,21,57,18,38,3,19,11,18,1,17,18,28,11,2,14,26,56,2.77
10343,"Andre Barrett\barrean01","2006-07",24,"CHI","NBA",0,6,0,29,4,8,4,8,0,0,0,0,1,4,5,7,0,0,4,4,8,1.82
10344,"Andre Barrett\barrean01","2007-08",25,"LAC","NBA",0,4,0,25,2,5,1,2,1,3,1,2,0,1,1,7,0,0,1,1,6,2.05
10345,"Earl Barron\barroea01","2014-15",33,"PHO","NBA",0,16,1,143,12,39,10,35,2,4,6,12,14,14,28,5,4,2,5,26,32,1.7
10346,"Earl Barron\barroea01","2011-12",30,"GSW","NBA",0,2,0,9,2,4,2,4,0,0,0,0,1,0,1,0,0,0,0,5,4,1.2
10347,"Earl Barron\barroea01","2012-13",31,"TOT","NBA",0,12,2,159,18,51,18,51,0,0,3,7,22,39,61,5,5,6,11,24,39,3.83
10348,"Brandon Bass\bassbr01","2006-07",21,"NOK","NBA",0,21,3,162,15,44,15,43,0,1,12,16,13,30,43,3,2,3,10,16,42,1.86
10349,"Tony Battie\battito01","2009-10",33,"NJN","NBA",0,15,0,134,14,40,13,36,1,4,7,10,4,19,23,3,4,2,3,19,36,1.94
10350,"Jerryd Bayless\bayleje01","2018-19",30,"MIN","NBA",0,34,6,657,82,230,53,132,29,98,16,28,11,51,62,119,18,2,32,56,209,5.99
10351,"Jerome Beasley\beaslje01","2003-04",23,"MIA","NBA",0,2,0,5,1,3,1,3,0,0,0,0,0,1,1,0,0,0,0,0,2,0.35
10352,"Marco Belinelli\belinma01","2007-08",21,"GSW","NBA",0,33,0,241,36,93,20,52,16,41,7,9,3,11,14,15,5,0,12,15,95,1.96
10353,"Jonathan Bender\bendejo01","2009-10",29,"NYK","NBA",0,25,1,292,40,100,26,61,14,39,24,26,15,37,52,16,2,17,28,33,118,4.36
10354,"Jerrelle Benimon\benimje01","2014-15",23,"UTA","NBA",0,2,0,3,0,0,0,0,0,0,0,0,1,2,3,0,0,0,1,0,0,0.6
10355,"Benoit Benjamin\benjabe01","1996-97",32,"TOR","NBA",0,4,3,44,5,12,5,12,0,0,3,4,3,6,9,1,1,0,2,5,13,2.88
10356,"Benoit Benjamin\benjabe01","1999-00",35,"CLE","NBA",0,3,0,8,1,3,1,3,0,0,0,0,0,1,1,0,0,1,0,1,2,0.47
10357,"Corey Benjamin\benjaco01","2002-03",24,"ATL","NBA",0,9,0,152,13,43,11,30,2,13,12,16,10,21,31,10,1,2,6,20,40,3.92
10358,"Mario Bennett\bennema01","1998-99",25,"CHI","NBA",0,3,0,19,2,6,2,6,0,0,3,4,2,3,5,0,1,0,1,4,7,2.07
10359,"Tony Bennett\benneto01","1994-95",25,"CHH","NBA",0,3,0,46,6,13,4,4,2,9,0,0,0,2,2,4,0,0,3,6,14,3.63
10360,"Keith Benson\bensoke02","2011-12",23,"GSW","NBA",0,3,0,9,0,1,0,1,0,0,0,0,2,1,3,0,0,0,0,0,0,0.17
10361,"Sim Bhullar\bhullsi01","2014-15",22,"SAC","NBA",0,3,0,3,1,2,1,2,0,0,0,0,0,1,1,1,0,1,0,0,2,0.93
10362,"Andris Biedriņš\biedran01","2013-14",27,"UTA","NBA",0,6,0,45,1,1,1,1,0,0,1,6,2,15,17,0,0,0,2,6,3,1.25
10363,"Alex Blackwell\blackal01","1992-93",22,"LAL","NBA",0,27,0,109,14,42,14,39,0,3,6,8,10,13,23,7,4,2,5,14,34,1.07
10364,"Antonio Blakeney\blakean01","2017-18",21,"CHI","NBA",0,19,0,314,53,143,38,91,15,52,30,39,4,29,33,20,7,1,11,19,151,5.44
10365,"Ricky Blanton\blantri01","1992-93",26,"CHI","NBA",0,2,0,13,3,7,3,7,0,0,0,0,2,1,3,1,2,0,1,1,6,3.1
10366,"Tony Bobbitt\bobbito01","2004-05",25,"LAL","NBA",0,2,0,12,2,5,1,3,1,2,0,0,0,3,3,0,0,0,0,1,5,1.75
10367,"Keith Bogans\boganke01","2011-12",31,"NJN","NBA",0,5,1,94,8,21,5,9,3,12,2,5,5,6,11,3,2,0,3,15,21,3.36
10368,"Muggsy Bogues\boguemu01","1995-96",31,"CHH","NBA",0,6,0,77,6,16,6,15,0,1,2,2,6,1,7,19,2,0,6,4,14,3.88
10369,"Etdrick Bohannon\bohanet01","1998-99",25,"WAS","NBA",0,2,0,4,0,0,0,0,0,0,0,0,0,0,0,0,0,0,0,0,0,0
10370,"Dexter Boney\boneyde01","1996-97",26,"PHO","NBA",0,8,0,48,6,19,5,13,1,6,6,8,3,3,6,0,2,1,1,3,19,1.55
10371,"Anthony Bonner\bonnean01","1995-96",27,"ORL","NBA",0,4,0,43,5,15,5,15,0,0,3,7,6,13,19,4,3,0,3,11,13,4.08
10372,"Keith Booth\boothke01","1997-98",23,"CHI","NBA",0,6,0,17,2,6,2,5,0,1,6,6,2,2,4,1,0,0,3,3,10,1.48
10373,"Chris Boucher\bouchch01","2017-18",25,"GSW","NBA",0,1,0,1,0,1,0,0,0,1,0,0,0,1,1,0,0,0,0,0,0,-0.3
10374,"Ruben Boumtje-Boumtje\boumtru01","2003-04",25,"POR","NBA",0,9,0,26,1,5,1,5,0,0,2,2,0,1,1,1,0,1,0,2,4,0.3
10375,"Ruben Boumtje-Boumtje\boumtru01","2002-03",24,"POR","NBA",0,2,0,5,0,1,0,1,0,0,0,0,1,0,1,1,1,0,0,0,0,0.7
10376,"Bruce Bowen\bowenbr01","1998-99",27,"BOS","NBA",0,30,1,494,26,93,19,67,7,26,11,24,15,37,52,28,21,9,13,51,70,2.59
10377,"Bruce Bowen\bowenbr01","1996-97",25,"MIA","NBA",0,1,0,1,0,0,0,0,0,0,0,0,0,0,0,0,0,1,0,0,0,0.7
10378,"Ira Bowman\bowmair01","2000-01",27,"ATL","NBA",0,3,0,19,0,2,0,2,0,0,0,0,1,1,2,7,0,0,1,0,0,1.43
10379,"Donnie Boyce\boycedo01","1995-96",22,"ATL","NBA",0,8,0,41,9,23,5,15,4,8,2,4,5,5,10,3,3,1,6,2,24,2.56
10380,"Earl Boykins\boykiea01","2007-08",31,"CHA","NBA",0,36,0,577,61,172,47,128,14,44,49,59,9,25,34,96,13,0,41,21,185,4.97
10381,"Michael Bradley\bradlmi01","2003-04",24,"TOT","NBA",0,16,1,98,7,15,7,15,0,0,1,2,6,17,23,1,3,0,7,14,15,1.24
10382,"Tony Bradley\bradlto01","2017-18",20,"UTA","NBA",0,9,0,29,3,11,3,10,0,1,2,2,4,7,11,1,0,0,0,1,8,0.73
10383,"Torraye Braggs\braggto01","2004-05",28,"HOU","NBA",0,7,0,24,3,7,3,7,0,0,0,0,7,5,12,0,0,0,2,4,6,1.01
10384,"Tim Breaux\breauti01","1997-98",27,"MIL","NBA",0,6,0,30,4,11,3,8,1,3,1,2,0,2,2,2,2,1,1,1,10,1.4
10385,"Tim Breaux\breauti01","1994-95",24,"HOU","NBA",0,42,2,340,45,121,39,96,6,25,32,49,16,18,34,15,11,4,16,25,128,2.2
10386,"Randy Breuer\breuera01","1993-94",33,"SAC","NBA",0,26,3,247,8,26,8,25,0,1,3,14,15,41,56,8,6,19,9,30,19,1.8
10387,"Jamison Brewer\breweja01","2003-04",23,"IND","NBA",0,13,1,160,13,35,8,21,5,14,1,6,2,9,11,17,7,0,10,9,32,2.62
10388,"Jamison Brewer\breweja01","2001-02",21,"IND","NBA",0,13,0,43,2,5,2,4,0,1,0,0,2,6,8,9,2,0,3,3,4,0.98
10389,"Ronnie Brewer\brewero02","2013-14",28,"TOT","NBA",0,24,3,160,3,15,2,7,1,8,0,2,2,12,14,10,6,1,2,4,7,0.68
10390,"Primož Brezec\brezepr01","2009-10",30,"TOT","NBA",0,21,0,95,9,26,9,26,0,0,1,6,12,13,25,1,1,3,2,19,19,0.77
10391,"Dillon Brooks\brookdi01","2018-19",23,"MEM","NBA",0,18,0,330,49,122,34,82,15,40,22,30,9,22,31,16,10,4,19,50,135,5.69
10392,"Kevin Brooks\brookke01","1992-93",23,"DEN","NBA",0,55,2,571,93,233,87,207,6,26,35,40,22,59,81,34,10,2,39,46,227,3.03
10393,"Andre Brown\brownan01","2006-07",25,"SEA","NBA",0,38,0,271,42,74,42,73,0,1,9,15,26,48,74,2,6,4,29,26,93,2.51
10394,"Anthony Brown\brownan02","2017-18",25,"MIN","NBA",0,1,0,4,1,1,0,0,1,1,0,0,0,0,0,1,0,0,0,0,3,3.4
10395,"Anthony Brown\brownan02","2016-17",24,"TOT","NBA",0,11,0,159,18,50,11,23,7,27,0,0,8,25,33,8,5,1,6,15,43,3.61
10396,"Chucky Brown\brownch01","1993-94",25,"DAL","NBA",0,1,0,10,1,1,1,1,0,0,1,1,0,1,1,0,0,0,0,2,3,3.1
10397,"Markel Brown\brownma02","2017-18",26,"HOU","NBA",0,4,0,31,2,7,1,2,1,5,0,0,1,4,5,2,0,0,2,6,5,1.08
10398,"Randy Brown\brownra02","2001-02",33,"BOS","NBA",0,1,0,6,0,1,0,1,0,0,0,0,0,0,0,2,0,1,0,1,0,1.4
10399,"Shannon Brown\brownsh01","2014-15",29,"MIA","NBA",0,5,2,89,7,19,4,12,3,7,3,4,0,1,1,3,4,0,4,8,20,3.12
10400,"Nicolás Brussino\brussni01","2017-18",24,"ATL","NBA",0,4,0,10,0,2,0,0,0,2,0,0,0,3,3,0,0,0,0,0,0,-0.05
10401,"Mark Bryant\bryanma01","2000-01",35,"DAL","NBA",0,18,1,101,8,20,8,20,0,0,3,5,4,17,21,3,1,2,5,29,19,1.13
10402,"Steve Burtt\burttst01","1992-93",30,"WSB","NBA",0,4,0,35,10,26,9,23,1,3,8,10,2,1,3,6,2,0,4,5,29,5.35
10403,"Dwight Buycks\buyckdw01","2013-14",24,"TOR","NBA",0,14,0,146,15,48,10,31,5,17,8,9,4,19,23,10,8,0,10,11,43,2.8
10404,"Bruno Caboclo\cabocbr01","2017-18",22,"TOT","NBA",0,12,0,107,9,31,6,14,3,17,5,6,7,15,22,4,3,4,4,8,26,2.08
10405,"Adrian Caldwell\caldwad01","1994-95",28,"HOU","NBA",0,7,0,30,1,4,1,4,0,0,3,6,1,9,10,0,1,0,1,6,5,0.91
10406,"Adrian Caldwell\caldwad01","1997-98",31,"DAL","NBA",0,1,0,3,0,0,0,0,0,0,0,0,0,0,0,0,0,0,0,0,0,0
10407,"Marcus Camby\cambyma01","2012-13",38,"NYK","NBA",0,24,4,250,17,53,17,53,0,0,8,19,24,56,80,14,7,14,15,28,42,2.75
10408,"Elden Campbell\campbel01","2004-05",36,"TOT","NBA",0,40,1,390,39,123,39,121,0,2,42,55,28,65,93,19,8,7,29,57,120,2.69
10409,"Clint Capela\capelca01","2014-15",20,"HOU","NBA",0,12,0,90,14,29,14,29,0,0,4,23,10,26,36,2,1,9,5,14,32,2.73
10410,"Brian Cardinal\cardibr01","2011-12",34,"DAL","NBA",0,44,0,277,14,55,4,6,10,49,5,6,4,30,34,16,8,2,8,38,43,1
10411,"Brian Cardinal\cardibr01","2002-03",25,"WAS","NBA",0,5,0,15,1,4,1,3,0,1,2,2,3,2,5,1,0,0,1,0,4,0.86
10412,"Brian Cardinal\cardibr01","2000-01",23,"DET","NBA",0,15,0,126,10,31,10,26,0,5,11,18,8,15,23,3,7,2,9,27,31,2.01
10413,"Brian Cardinal\cardibr01","2007-08",30,"MEM","NBA",0,37,1,440,43,126,18,45,25,81,13,19,26,70,96,22,10,2,23,62,124,3.13
10414,"Antoine Carr\carran01","1998-99",37,"HOU","NBA",0,18,0,152,21,52,21,51,0,1,5,7,9,22,31,9,1,10,9,31,47,2.49
10415,"Matt Carroll\carroma01","2012-13",32,"CHA","NBA",0,1,0,6,0,0,0,0,0,0,0,0,0,0,0,1,0,0,0,1,0,0.7
10416,"Matt Carroll\carroma01","2003-04",23,"TOT","NBA",0,16,0,70,7,16,6,13,1,3,4,6,1,5,6,2,1,0,6,8,19,0.91
10417,"Jimmy Carruth\carruji01","1996-97",27,"MIL","NBA",0,4,0,21,2,3,2,3,0,0,1,1,0,4,4,0,0,2,1,4,5,1.68
10418,"Anthony Carter\cartean01","2011-12",36,"TOR","NBA",0,24,0,209,17,53,12,36,5,17,8,10,5,28,33,34,8,4,17,20,47,2.65
10419,"Jevon Carter\carteje01","2018-19",23,"MEM","NBA",0,39,3,577,56,185,22,83,34,102,26,32,14,52,66,69,26,11,33,55,172,4.38
10420,"Maurice Carter\cartema01","2003-04",27,"TOT","NBA",0,10,0,110,11,35,7,24,4,11,16,20,2,9,11,4,0,0,9,10,42,2.75
10421,"Duane Causwell\causwdu01","1998-99",30,"MIA","NBA",0,19,1,137,20,35,20,35,0,0,4,12,14,21,35,2,0,11,18,32,44,2.49
10422,"Duane Causwell\causwdu01","2000-01",32,"MIA","NBA",0,31,14,384,32,85,32,85,0,0,12,25,23,60,83,5,8,18,23,67,76,2.63
10423,"Tyler Cavanaugh\cavanty01","2018-19",24,"UTA","NBA",0,11,0,39,3,10,2,5,1,5,2,2,3,5,8,1,0,0,1,3,9,0.65
10424,"Joe Chealey\chealjo01","2018-19",23,"CHO","NBA",0,1,0,8,1,3,1,3,0,0,0,0,0,0,0,1,0,0,0,1,2,1
10425,"Calbert Cheaney\cheanca01","2005-06",34,"GSW","NBA",0,42,0,448,42,108,42,100,0,8,8,8,20,41,61,19,13,2,17,38,92,2.03
10426,"Will Cherry\cherrwi01","2014-15",23,"CLE","NBA",0,8,0,69,5,19,3,10,2,9,3,6,1,4,5,8,6,1,4,10,15,2.1
10427,"Josh Childress\childjo01","2013-14",30,"NOP","NBA",0,4,0,24,0,0,0,0,0,0,0,0,0,3,3,2,1,0,1,1,0,0.9
10428,"Randolph Childress\childra01","1995-96",23,"POR","NBA",0,28,0,250,25,79,12,32,13,47,22,27,1,18,19,32,8,1,28,22,85,2.73
10429,"Chris Chiozza\chiozch01","2018-19",23,"HOU","NBA",0,7,0,33,2,8,0,3,2,5,0,0,1,3,4,4,1,1,1,2,6,1.04
10430,"Rakeem Christmas\chrisra01","2015-16",24,"IND","NBA",0,1,0,6,2,2,2,2,0,0,0,0,1,0,1,0,0,0,0,1,4,3.8
10431,"Keon Clark\clarkke01","2003-04",28,"UTA","NBA",0,2,0,27,2,6,2,6,0,0,0,0,1,6,7,1,1,0,0,1,4,2.55
10432,"Coty Clarke\clarkco01","2015-16",23,"BOS","NBA",0,3,0,6,2,4,0,2,2,2,0,0,0,1,1,0,0,0,1,0,6,1.47
10433,"Charles Claxton\claxtch01","1995-96",25,"BOS","NBA",0,3,0,7,1,2,1,2,0,0,0,2,2,0,2,0,0,1,1,4,2,0.57
10434,"Speedy Claxton\claxtsp01","2008-09",30,"ATL","NBA",0,2,0,15,2,7,2,7,0,0,1,2,0,0,0,3,0,0,0,1,5,1.3
10435,"Mateen Cleaves\cleavma01","2004-05",27,"SEA","NBA",0,14,0,65,5,14,5,12,0,2,3,4,2,4,6,7,2,0,2,2,13,1.01
10436,"Mateen Cleaves\cleavma01","2005-06",28,"SEA","NBA",0,27,0,230,25,71,21,55,4,16,19,24,2,12,14,42,3,2,14,30,73,2.62
10437,"Mateen Cleaves\cleavma01","2003-04",26,"CLE","NBA",0,4,2,92,7,23,7,22,0,1,1,2,1,6,7,19,4,2,5,13,15,5.7
10438,"Antonius Cleveland\clevean01","2017-18",23,"TOT","NBA",0,17,0,123,8,21,5,17,3,4,4,6,3,11,14,2,7,5,7,23,23,1.66
10439,"Norris Cole\coleno01","2011-12",23,"MIA","NBA",0,65,2,1260,177,450,156,374,21,76,66,85,21,70,91,133,44,2,105,124,441,5.6
10440,"Ben Coleman\colembe01","1993-94",32,"DET","NBA",0,9,0,77,12,25,12,25,0,0,4,8,10,16,26,0,2,2,7,9,28,3.06
10441,"Bimbo Coles\colesbi01","2000-01",32,"CLE","NBA",0,47,0,804,91,239,89,223,2,16,48,56,9,39,48,138,27,6,59,87,232,5.21
10442,"Bimbo Coles\colesbi01","2002-03",34,"TOT","NBA",0,35,11,691,56,168,49,136,7,32,35,42,11,48,59,72,17,4,28,60,154,4.28
10443,"Jason Collier\collija02","2004-05",27,"ATL","NBA",0,70,44,942,174,376,168,362,6,14,48,71,84,100,184,18,15,13,63,147,402,4.42
10444,"Jason Collier\collija02","2000-01",23,"HOU","NBA",0,23,0,222,27,71,27,70,0,1,17,24,12,25,37,6,2,3,11,27,71,2.28
10445,"James Collins\collija01","1997-98",24,"LAC","NBA",0,23,0,103,21,55,12,35,9,20,8,14,7,7,14,3,6,3,8,12,59,1.84
10446,"Mardy Collins\collima01","2006-07",22,"NYK","NBA",0,52,9,777,87,228,74,181,13,47,48,82,28,76,104,83,32,3,57,75,235,4.43
10447,"Marty Conlon\conloma01","1999-00",32,"LAC","NBA",0,3,0,9,1,2,1,2,0,0,0,0,1,1,2,0,0,0,0,1,2,0.6
10448,"Lester Conner\connele01","1994-95",35,"LAL","NBA",0,2,0,5,0,0,0,0,0,0,2,2,0,0,0,0,1,0,0,3,2,1.5
10449,"Brian Cook\cookbr01","2008-09",28,"TOT","NBA",0,30,0,171,28,76,15,46,13,30,5,6,7,25,32,5,3,3,13,26,74,1.77
10450,"Joe Courtney\courtjo01","1995-96",26,"CLE","NBA",0,23,0,200,15,35,15,35,0,0,8,18,24,25,49,9,5,6,17,35,38,2.2
10451,"Marcus Cousin\cousima01","2010-11",24,"UTA","NBA",0,4,0,18,2,3,2,3,0,0,0,0,0,3,3,0,0,1,1,1,4,1.15
10452,"Joe Crawford\crawfjo01","2008-09",22,"NYK","NBA",0,2,0,23,3,10,2,6,1,4,2,2,1,3,4,1,1,0,0,2,9,3.25
10453,"Javaris Crittenton\crittja01","2008-09",21,"TOT","NBA",0,63,10,1174,131,285,129,270,2,15,53,92,57,109,166,150,40,6,82,101,317,5.87
10454,"Austin Croshere\croshau01","1997-98",22,"IND","NBA",0,26,0,243,32,86,28,73,4,13,8,14,10,35,45,8,9,5,13,32,76,2.4
10455,"Terry Cummings\cummite01","1992-93",31,"SAS","NBA",0,8,0,76,11,29,11,29,0,0,5,10,6,13,19,4,1,1,2,17,27,2.65
10456,"Jared Cunningham\cunnija01","2014-15",23,"LAC","NBA",0,19,0,89,12,33,8,20,4,13,7,13,1,8,9,10,3,0,7,12,35,1.47
10457,"Jared Cunningham\cunnija01","2012-13",21,"DAL","NBA",0,8,0,26,6,14,4,11,2,3,2,2,1,2,3,1,1,0,2,3,16,1.44
10458,"Earl Cureton\curetea01","1996-97",39,"TOR","NBA",0,9,0,46,3,8,3,8,0,0,1,3,4,5,9,4,0,0,1,10,7,0.91
10459,"Earl Cureton\curetea01","1993-94",36,"HOU","NBA",0,2,0,30,2,8,2,8,0,0,0,2,4,8,12,0,0,0,1,4,4,1.6
10460,"Bill Curley\curlebi01","1999-00",27,"TOT","NBA",0,28,0,309,29,68,29,67,0,1,18,25,18,32,50,14,13,4,21,61,76,2.96
10461,"Eddy Curry\curryed01","2008-09",26,"NYK","NBA",0,3,0,12,2,2,2,2,0,0,1,3,0,4,4,0,0,0,2,5,5,1.73
10462,"JamesOn Curry\curryja01","2009-10",24,"LAC","NBA",0,1,0,0,0,0,0,0,0,0,0,0,0,0,0,0,0,0,0,0,0,0
10463,"Seth Curry\curryse01","2014-15",24,"PHO","NBA",0,2,0,8,0,3,0,2,0,1,0,0,0,2,2,1,0,0,0,2,0,-0.3
10464,"Seth Curry\curryse01","2013-14",23,"TOT","NBA",0,2,0,13,1,3,0,2,1,1,0,0,0,1,1,0,2,0,0,0,3,1.85
10465,"Antonio Daniels\daniean01","2010-11",35,"PHI","NBA",0,4,0,35,2,5,2,3,0,2,2,2,0,5,5,2,0,0,1,0,6,1.67
10466,"Lloyd Daniels\daniell01","1996-97",29,"TOT","NBA",0,22,0,310,36,119,15,49,21,70,5,6,19,24,43,26,10,3,14,33,98,3.46
10467,"Yinka Dare\dareyi01","1994-95",22,"NJN","NBA",0,1,0,3,0,1,0,1,0,0,0,0,0,1,1,0,0,0,1,2,0,-0.3
10468,"Ben Davis\davisbe01","1999-00",27,"PHO","NBA",0,5,0,22,2,6,2,6,0,0,0,0,3,6,9,2,1,1,3,2,4,1.46
10469,"Ben Davis\davisbe01","1997-98",25,"NYK","NBA",0,7,0,13,2,10,2,10,0,0,0,0,6,0,6,0,1,0,0,3,4,0.17
10470,"Brian Davis\davisbr02","1993-94",23,"MIN","NBA",0,68,3,374,40,126,39,123,1,3,50,68,21,34,55,22,16,4,19,34,131,1.59
10471,"Josh Davis\davisjo02","2005-06",25,"TOT","NBA",0,6,0,17,2,7,2,5,0,2,2,3,3,1,4,1,2,0,1,3,6,0.97
10472,"Josh Davis\davisjo02","2003-04",23,"ATL","NBA",0,4,1,23,2,5,2,3,0,2,1,1,1,4,5,0,0,0,2,3,5,1.07
10473,"Paul Davis\davispa01","2009-10",25,"WAS","NBA",0,2,0,8,2,4,2,4,0,0,1,2,0,0,0,3,0,1,0,0,5,2.7
10474,"Paul Davis\davispa01","2007-08",23,"LAC","NBA",0,22,1,194,24,65,24,65,0,0,6,10,25,22,47,10,6,6,9,33,54,2.39
10475,"Tyler Davis\davisty01","2018-19",21,"OKC","NBA",0,1,0,1,0,1,0,1,0,0,0,0,1,0,1,0,0,0,0,0,0,-0.3
10476,"Branden Dawson\dawsobr01","2015-16",22,"LAC","NBA",0,6,0,29,2,5,2,5,0,0,1,1,2,2,4,0,0,1,0,2,5,0.77
10477,"Tony Dawson\dawsoto01","1994-95",27,"BOS","NBA",0,2,0,13,3,8,2,5,1,3,1,1,0,3,3,1,0,0,2,4,8,2.75
10478,"Austin Daye\dayeau01","2014-15",26,"TOT","NBA",0,34,4,344,50,141,26,70,24,71,5,6,10,65,75,17,12,5,23,39,129,3.16
10479,"Terry Dehere\deherte01","1998-99",27,"TOT","NBA",0,26,0,291,31,85,15,46,16,39,5,7,7,17,24,27,7,3,16,30,83,2.8
10480,"Sam Dekker\dekkesa01","2015-16",21,"HOU","NBA",0,3,0,6,0,0,0,0,0,0,0,0,0,1,1,0,1,0,0,0,0,0.47
10481,"Vinny Del Negro\delnevi01","2001-02",35,"PHO","NBA",0,2,0,6,1,4,1,4,0,0,0,0,0,0,0,2,0,0,0,0,2,0.5
10482,"Ángel Delgado\delgaan01","2018-19",24,"LAC","NBA",0,2,0,15,1,5,1,5,0,0,1,2,2,2,4,0,1,0,0,2,3,1.05
10483,"Dell Demps\dempsde01","1993-94",23,"GSW","NBA",0,2,0,11,2,6,2,6,0,0,0,2,0,0,0,1,2,0,1,1,4,1.25
10484,"Dell Demps\dempsde01","1996-97",26,"ORL","NBA",0,2,0,10,0,3,0,2,0,1,2,2,0,0,0,0,1,0,0,1,2,0.45
10485,"Luol Deng\denglu01","2017-18",32,"LAL","NBA",0,1,1,13,1,2,1,2,0,0,0,0,0,0,0,1,1,0,1,0,2,2.7
10486,"Justin Dentmon\dentmju01","2012-13",27,"DAL","NBA",0,2,0,4,0,2,0,2,0,0,0,0,0,0,0,0,0,0,0,0,0,-0.7
10487,"Guillermo Díaz\diazgu01","2007-08",22,"LAC","NBA",0,6,0,18,1,4,1,3,0,1,3,5,2,0,2,1,0,0,0,0,5,0.55
10488,"Dan Dickau\dickada01","2002-03",24,"ATL","NBA",0,50,0,515,70,170,48,109,22,61,21,26,9,34,43,85,14,2,53,66,183,3.64
10489,"Dan Dickau\dickada01","2003-04",25,"TOT","NBA",0,43,0,294,37,98,27,68,10,30,11,14,7,19,26,38,17,0,26,44,95,2.19
10490,"Kaniel Dickens\dickeka01","2004-05",26,"NJN","NBA",0,11,0,61,4,14,1,5,3,9,2,2,3,6,9,1,2,1,2,5,13,1.07
10491,"Kaniel Dickens\dickeka01","2007-08",29,"CLE","NBA",0,5,0,12,1,3,1,3,0,0,0,0,0,1,1,1,0,1,0,1,2,0.42
10492,"Kaniel Dickens\dickeka01","2003-04",25,"POR","NBA",0,3,0,12,3,3,3,3,0,0,1,2,2,0,2,0,0,0,1,3,7,2.17
10493,"Travis Diener\dienetr01","2009-10",27,"TOT","NBA",0,9,0,51,2,10,1,3,1,7,1,4,0,3,3,8,4,0,0,2,6,1.04
10494,"Ike Diogu\dioguik01","2011-12",28,"SAS","NBA",0,2,0,14,0,2,0,2,0,0,2,2,0,1,1,0,0,0,1,1,2,0.5
10495,"DeSagana Diop\diopde01","2004-05",23,"CLE","NBA",0,39,0,306,20,69,20,67,0,2,0,5,30,40,70,15,8,27,12,53,40,1.62
10496,"Vlade Divac\divacvl01","2004-05",36,"LAL","NBA",0,15,0,130,13,31,13,31,0,0,8,12,18,14,32,19,4,1,14,25,34,3.11
10497,"Michael Doleac\doleami01","2007-08",30,"MIN","NBA",0,24,8,257,28,63,28,63,0,0,1,2,16,33,49,7,10,10,12,44,57,2.72
10498,"Keyon Dooling\doolike01","2001-02",21,"LAC","NBA",0,14,0,155,22,57,18,43,4,14,10,12,0,3,3,12,4,3,10,20,58,2.99
10499,"Joey Dorsey\dorsejo01","2008-09",25,"HOU","NBA",0,3,0,6,1,2,1,2,0,0,0,0,0,1,1,1,0,0,0,0,2,0.7
10500,"Quincy Douby\doubyqu01","2007-08",23,"SAC","NBA",0,74,0,876,132,335,90,213,42,122,48,52,17,66,83,53,30,12,59,80,354,3.78
10501,"Quincy Douby\doubyqu01","2008-09",24,"TOT","NBA",0,27,0,300,42,110,28,64,14,46,17,19,6,26,32,25,5,5,13,27,115,3.44
10502,"Quincy Douby\doubyqu01","2006-07",22,"SAC","NBA",0,42,0,359,48,126,36,76,12,50,11,15,11,26,37,15,15,4,15,21,119,2.18
10503,"Chris Douglas-Roberts\douglch01","2014-15",28,"LAC","NBA",0,12,0,103,5,21,4,14,1,7,8,8,1,11,12,4,1,0,0,14,19,1.24
10504,"PJ Dozier\doziepj01","2017-18",21,"OKC","NBA",0,2,0,3,1,2,1,2,0,0,0,0,0,1,1,0,0,0,1,1,2,0.7
10505,"Bryce Drew\drewbr01","2002-03",28,"NOH","NBA",0,13,0,79,8,27,5,20,3,7,0,0,4,9,13,11,2,0,3,2,19,1.4
10506,"Kevin Duckworth\duckwke01","1994-95",30,"WSB","NBA",0,40,22,818,118,267,116,257,2,10,45,70,65,130,195,20,21,24,59,110,283,6.58
10507,"Chris Dudley\dudlech02","2002-03",37,"POR","NBA",0,3,0,11,0,1,0,1,0,0,0,0,2,0,2,0,0,0,0,3,0,0.03
10508,"Chris Dudley\dudlech02","1993-94",28,"POR","NBA",0,6,3,86,6,25,6,25,0,0,2,4,16,8,24,5,4,3,2,18,14,2.88
10509,"Duje Dukan\dukandu01","2015-16",24,"SAC","NBA",0,1,0,24,2,10,0,5,2,5,0,0,2,2,4,1,1,0,0,2,6,3.1
10510,"Tony Dumas\dumasto01","1994-95",22,"DAL","NBA",0,58,0,613,96,250,74,177,22,73,50,77,32,30,62,57,13,4,50,78,264,3.4
10511,"Tony Dumas\dumasto01","1997-98",25,"CLE","NBA",0,7,0,47,6,12,4,8,2,4,0,3,1,4,5,5,0,0,5,5,14,1.76
10512,"Ronald Dupree\duprero01","2010-11",30,"TOR","NBA",0,3,0,13,1,4,1,3,0,1,0,0,0,3,3,1,0,0,0,2,2,0.5
10513,"Ronald Dupree\duprero01","2006-07",26,"DET","NBA",0,19,0,94,11,31,11,31,0,0,3,9,5,12,17,5,5,1,3,12,25,1.12
10514,"Acie Earl\earlac01","1996-97",26,"TOT","NBA",0,47,0,500,67,180,67,175,0,5,54,84,35,61,96,20,15,28,35,61,188,3.49
10515,"Ndudi Ebi\ebind01","2003-04",19,"MIN","NBA",0,17,0,32,6,14,6,14,0,0,1,4,2,1,3,3,0,4,3,6,13,0.62
10516,"Jarell Eddie\eddieja01","2017-18",26,"TOT","NBA",0,3,0,9,0,2,0,0,0,2,0,0,0,1,1,0,1,0,0,0,0,0
10517,"Doug Edwards\edwardo01","1993-94",23,"ATL","NBA",0,16,0,107,17,49,17,48,0,1,9,16,7,11,18,8,2,5,6,9,43,1.94
10518,"James Edwards\edwarja01","1994-95",39,"POR","NBA",0,28,0,266,32,83,32,83,0,0,11,17,10,33,43,8,5,8,14,44,75,2.17
10519,"Shane Edwards\edwarsh01","2013-14",26,"CLE","NBA",0,2,0,12,1,3,1,3,0,0,0,0,1,1,2,0,0,0,1,1,2,0.55
10520,"Vince Edwards\edwarvi01","2018-19",22,"HOU","NBA",0,2,0,16,1,4,0,0,1,4,0,0,1,1,2,0,0,0,0,0,3,0.7
10521,"Howard Eisley\eisleho01","2004-05",32,"UTA","NBA",0,74,1,1428,161,405,134,302,27,103,66,83,15,75,90,250,45,9,111,156,415,6.1
10522,"LaPhonso Ellis\ellisla01","1994-95",24,"DEN","NBA",0,6,0,58,9,25,9,25,0,0,6,6,7,10,17,4,1,5,5,12,24,4.03
10523,"Pervis Ellison\ellispe01","2000-01",33,"SEA","NBA",0,9,0,40,2,7,2,7,0,0,2,2,2,10,12,3,0,2,3,13,6,1.13
10524,"Pervis Ellison\ellispe01","1996-97",29,"BOS","NBA",0,6,4,125,6,16,6,16,0,0,3,5,9,17,26,4,5,9,7,21,15,4.98
10525,"Francisco Elson\elsonfr01","2011-12",35,"PHI","NBA",0,5,0,16,1,3,1,3,0,0,0,0,0,1,1,1,1,1,1,0,2,0.62
10526,"Francisco Elson\elsonfr01","2009-10",33,"TOT","NBA",0,12,0,66,5,15,5,15,0,0,2,5,6,8,14,2,1,0,1,7,12,0.86
10527,"Francisco Elson\elsonfr01","2007-08",31,"TOT","NBA",0,63,5,813,92,236,92,235,0,1,26,37,50,150,200,24,15,20,47,96,210,3.22
10528,"Melvin Ely\elyme01","2013-14",35,"NOP","NBA",0,2,0,27,3,6,3,6,0,0,0,0,0,1,1,0,0,1,0,5,6,2.05
10529,"Andre Emmett\emmetan01","2004-05",22,"MEM","NBA",0,8,0,28,2,6,2,6,0,0,3,5,0,2,2,0,0,0,1,4,7,0.45
10530,"Jo Jo English\englijo01","1993-94",23,"CHI","NBA",0,36,0,419,56,129,48,112,8,17,10,21,9,36,45,38,8,10,36,61,130,3.26
10531,"Jeremy Evans\evansje01","2017-18",30,"ATL","NBA",0,1,0,5,1,1,1,1,0,0,0,0,1,0,1,0,0,0,1,1,2,2.1
10532,"Jordan Farmar\farmajo01","2016-17",30,"SAC","NBA",0,2,0,35,4,12,0,3,4,9,0,0,1,2,3,9,2,0,3,1,12,7.35
10533,"Desmon Farmer\farmede01","2006-07",25,"SEA","NBA",0,8,0,32,5,15,3,7,2,8,1,1,0,1,1,9,1,0,1,2,13,1.52
10534,"Carrick Felix\felixca01","2013-14",23,"CLE","NBA",0,7,0,38,7,14,5,9,2,5,3,4,1,5,6,4,0,0,4,4,19,2.4
10535,"Desmond Ferguson\fergude01","2003-04",26,"POR","NBA",0,7,0,32,5,12,2,4,3,8,0,2,0,4,4,1,0,0,1,0,13,1.16
10536,"Duane Ferrell\ferredu01","1997-98",32,"GSW","NBA",0,50,5,461,41,111,41,105,0,6,12,22,25,22,47,26,21,6,18,50,94,1.82
10537,"Kyrylo Fesenko\fesenky01","2007-08",21,"UTA","NBA",0,9,0,70,6,16,6,16,0,0,2,4,14,11,25,2,0,3,8,19,14,1.99
10538,"Matt Fish\fishma01","1996-97",27,"TOT","NBA",0,6,0,8,1,3,1,3,0,0,0,0,1,4,5,0,0,0,2,2,2,0.38
10539,"Marcus Fizer\fizerma01","2005-06",27,"NOK","NBA",0,3,0,39,9,17,8,16,1,1,1,2,1,6,7,1,0,0,2,5,20,4.93
10540,"Luis Flores\florelu01","2004-05",23,"TOT","NBA",0,16,0,77,14,29,9,19,5,10,2,2,1,2,3,11,2,0,11,9,35,1.95
10541,"Sharrod Ford\fordsh02","2005-06",24,"PHO","NBA",0,3,0,13,2,3,2,3,0,0,0,0,1,2,3,0,0,1,2,7,4,1.53
10542,"Courtney Fortson\fortsco01","2011-12",23,"TOT","NBA",0,10,0,95,11,32,8,19,3,13,10,15,6,9,15,10,3,0,10,5,35,3.1
10543,"Danny Fortson\fortsda01","2006-07",30,"SEA","NBA",0,14,6,158,15,30,15,29,0,1,10,13,13,30,43,1,1,0,15,38,40,3.05
10544,"Greg Foster\fostegr01","1993-94",25,"MIL","NBA",0,3,0,19,4,7,4,7,0,0,2,2,0,3,3,0,0,1,1,3,10,2.87
10545,"Greg Foster\fostegr01","2001-02",33,"MIL","NBA",0,6,0,24,2,9,2,5,0,4,3,4,0,8,8,1,0,0,0,4,7,0.83
10546,"Tremaine Fowlkes\fowlktr01","2004-05",28,"IND","NBA",0,8,0,56,9,17,8,14,1,3,0,2,3,5,8,0,2,0,5,7,19,1.89
10547,"Jamaal Franklin\frankja01","2013-14",22,"MEM","NBA",0,21,0,161,16,39,11,28,5,11,2,2,4,19,23,6,4,2,11,23,39,1.76
10548,"Jamaal Franklin\frankja01","2014-15",23,"DEN","NBA",0,3,0,13,1,2,0,0,1,2,0,0,1,1,2,3,0,1,3,4,3,1.87
10549,"Jimmer Fredette\fredeji01","2015-16",26,"TOT","NBA",0,6,0,18,2,5,1,3,1,2,4,5,0,0,0,1,1,0,2,2,9,1.27
10550,"Todd Fuller\fulleto02","2000-01",26,"MIA","NBA",0,10,0,77,10,35,10,35,0,0,8,8,7,11,18,1,3,2,3,10,28,1.98
10551,"Dan Gadzuric\gadzuda01","2011-12",33,"NYK","NBA",0,2,0,13,0,2,0,2,0,0,0,2,1,4,5,0,1,1,1,4,0,0.75
10552,"Deng Gai\gaide01","2005-06",23,"PHI","NBA",0,2,0,5,0,0,0,0,0,0,0,0,0,0,0,0,0,0,0,0,0,0
10553,"Reece Gaines\gainere01","2005-06",25,"MIL","NBA",0,12,0,54,6,12,6,10,0,2,1,4,0,0,0,3,1,0,1,1,13,0.74
10554,"Rubén Garcés\garceru01","2000-01",27,"TOT","NBA",0,13,0,73,7,22,7,22,0,0,2,8,16,13,29,5,3,2,5,14,16,1.58
10555,"Marlon Garnett\garnema01","1998-99",23,"BOS","NBA",0,24,0,205,15,51,9,28,6,23,15,20,3,18,21,18,5,1,12,18,51,1.92
10556,"Billy Garrett\garrebi01","2018-19",24,"NYK","NBA",0,4,0,63,11,27,11,19,0,8,4,4,0,3,3,7,1,1,2,3,26,4.82
10557,"Pat Garrity\garripa01","2003-04",27,"ORL","NBA",0,2,0,22,1,3,1,3,0,0,0,0,0,0,0,1,0,0,0,2,2,0.5
10558,"Andrew Gaze\gazean01","1998-99",33,"SAS","NBA",0,19,0,58,8,25,3,9,5,16,0,0,2,3,5,6,2,1,4,7,21,0.82
10559,"Paul George\georgpa01","2014-15",24,"IND","NBA",0,6,0,91,18,49,9,27,9,22,8,11,4,18,22,6,5,1,12,11,53,7.23
10560,"Tate George\georgta01","1994-95",26,"MIL","NBA",0,3,0,8,1,3,1,2,0,1,2,2,1,0,1,0,0,0,2,1,4,0.9
10561,"J.R. Giddens\giddejr01","2008-09",23,"BOS","NBA",0,6,0,8,2,3,2,3,0,0,0,0,2,1,3,0,1,0,1,1,4,0.82
10562,"Trey Gilder\gildetr01","2009-10",25,"MEM","NBA",0,2,0,5,1,1,1,1,0,0,0,0,0,1,1,0,1,0,0,0,2,1.55
10563,"Eddie Gill\gilled01","2000-01",22,"NJN","NBA",0,8,0,152,16,41,13,32,3,9,4,5,0,9,9,24,4,1,10,9,39,5.18
10564,"Mike Gminski\gminsmi01","1993-94",34,"TOT","NBA",0,29,7,309,36,103,36,103,0,0,14,18,22,52,74,11,13,16,13,23,86,3.04
10565,"Ryan Gomes\gomesry01","2013-14",31,"OKC","NBA",0,5,0,34,3,8,3,6,0,2,0,0,0,4,4,1,0,0,1,5,6,0.78
10566,"Drew Gooden\goodedr01","2015-16",34,"WAS","NBA",0,30,0,305,33,103,26,62,7,41,9,14,28,57,85,13,8,11,13,40,82,2.66
10567,"Brandon Goodwin\goodwbr01","2018-19",23,"DEN","NBA",0,16,0,57,6,23,4,17,2,6,9,11,1,2,3,14,0,0,3,7,23,1.22
10568,"Andrew Goudelock\goudean01","2015-16",27,"HOU","NBA",0,8,0,50,9,20,8,11,1,9,3,4,1,1,2,4,6,2,7,4,22,2.77
10569,"Andrew Goudelock\goudean01","2012-13",24,"LAL","NBA",0,1,0,6,0,2,0,2,0,0,0,0,1,0,1,0,0,0,0,0,0,-1
10570,"Ricky Grace\graceri01","1993-94",26,"ATL","NBA",0,3,0,8,2,3,2,3,0,0,0,2,0,1,1,1,0,0,0,3,4,1
10571,"Joey Graham\grahajo01","2010-11",28,"CLE","NBA",0,39,8,586,82,179,73,149,9,30,29,36,8,76,84,18,6,7,28,73,202,4.2
10572,"Stephen Graham\grahast01","2005-06",23,"TOT","NBA",0,22,0,175,21,54,19,44,2,10,14,15,5,22,27,7,5,2,13,31,58,2.29
10573,"Stephen Graham\grahast01","2008-09",26,"IND","NBA",0,52,6,684,106,256,86,190,20,66,50,62,21,75,96,33,10,4,45,82,282,4.13
10574,"Ron Grandison\grandro01","1994-95",30,"NYK","NBA",0,2,0,8,1,4,1,4,0,0,0,0,3,2,5,2,0,0,0,2,2,1.5
10575,"Gary Grant\grantga01","1998-99",33,"POR","NBA",0,2,0,7,0,1,0,1,0,0,0,0,0,0,0,3,1,0,0,0,0,1.2
10576,"Gary Grant\grantga01","1999-00",34,"POR","NBA",0,3,0,24,6,14,6,14,0,0,0,0,0,3,3,1,1,0,2,3,12,2.5
10577,"Greg Grant\grantgr01","1994-95",28,"DEN","NBA",0,14,0,151,10,33,8,26,2,7,9,12,2,7,9,43,6,2,14,20,31,3.7
10578,"Greg Grant\grantgr01","1995-96",29,"TOT","NBA",0,31,2,527,35,99,27,65,8,34,5,6,7,27,34,97,22,2,30,43,83,4.26
10579,"Paul Grant\grantpa01","2003-04",30,"UTA","NBA",0,10,0,98,11,23,11,23,0,0,3,8,7,10,17,3,1,1,7,17,25,2.19
10580,"Donte Grantham\grantdo01","2018-19",23,"OKC","NBA",0,3,0,2,0,2,0,0,0,2,0,0,0,0,0,0,0,0,0,0,0,-0.47
10581,"Erick Green\greener01","2014-15",23,"DEN","NBA",0,43,1,410,61,162,47,115,14,47,10,12,7,24,31,39,12,0,14,26,146,2.51
10582,"Gerald Green\greenge01","2008-09",23,"DAL","NBA",0,38,12,376,79,180,65,134,14,46,27,32,14,40,54,15,10,5,33,51,199,3.9
10583,"Litterial Green\greenli01","1998-99",28,"CLE","NBA",0,1,0,2,0,1,0,1,0,0,0,0,0,0,0,0,0,0,0,0,0,-0.7
10584,"Sean Green\greense01","1992-93",22,"IND","NBA",0,13,0,81,28,55,25,45,3,10,3,4,4,5,9,7,2,1,9,11,62,3.5
10585,"Willie Green\greenwi01","2003-04",22,"PHI","NBA",0,53,0,767,143,357,124,296,19,61,59,81,16,49,65,53,26,5,59,83,364,4.81
10586,"Orien Greene\greenor01","2010-11",28,"NJN","NBA",0,3,0,5,1,2,1,2,0,0,1,2,0,0,0,1,1,0,0,0,3,1.1
10587,"Adrian Griffin\griffad01","2007-08",33,"TOT","NBA",0,35,2,307,30,76,30,76,0,0,5,9,28,31,59,27,17,2,21,27,65,2.37
10588,"Taylor Griffin\griffta01","2009-10",23,"PHO","NBA",0,8,0,32,4,10,4,8,0,2,2,4,0,2,2,1,0,2,1,4,10,0.84
10589,"Derek Grimm\grimmde01","1997-98",23,"SAC","NBA",0,9,0,34,4,14,0,2,4,12,2,2,0,4,4,0,3,1,3,6,14,1.23
10590,"Hamed Haddadi\haddaha01","2009-10",24,"MEM","NBA",0,36,0,240,24,62,24,59,0,3,14,19,26,49,75,10,1,14,20,57,62,2.06
10591,"Marcus Haislip\haislma01","2002-03",22,"MIL","NBA",0,39,8,441,66,153,63,141,3,12,26,38,21,32,53,9,7,18,21,55,161,3.14
10592,"Jack Haley\haleyja01","1994-95",31,"SAS","NBA",0,31,0,117,26,61,26,60,0,1,21,32,8,19,27,2,3,5,13,31,73,1.77
10593,"Jack Haley\haleyja01","1997-98",34,"NJN","NBA",0,16,0,51,5,18,5,17,0,1,12,21,5,10,15,0,0,1,4,9,22,0.91
10594,"Jack Haley\haleyja01","1995-96",32,"CHI","NBA",0,1,0,7,2,6,2,6,0,0,1,2,1,1,2,0,0,0,1,2,5,2
10595,"Mike Hall\hallmi01","2006-07",22,"WAS","NBA",0,2,0,13,1,4,1,4,0,0,0,0,1,1,2,1,0,0,0,1,2,0.55
10596,"Thomas Hamilton\hamilth01","1999-00",24,"HOU","NBA",0,22,7,273,35,79,35,79,0,0,12,23,31,59,90,15,4,14,28,25,82,4.39
10597,"Zendon Hamilton\hamilze01","2002-03",27,"TOR","NBA",0,3,0,12,2,5,2,5,0,0,2,2,1,3,4,0,1,0,1,2,6,1.97
10598,"Zendon Hamilton\hamilze01","2000-01",25,"LAC","NBA",0,3,0,19,2,9,2,9,0,0,5,8,3,5,8,0,0,0,2,4,9,1.83
10599,"Geert Hammink\hammige01","1994-95",25,"ORL","NBA",0,1,0,7,1,3,1,3,0,0,2,2,0,2,2,1,0,0,0,1,4,3.8
10600,"Geert Hammink\hammige01","1995-96",26,"TOT","NBA",0,6,0,17,2,4,2,4,0,0,4,7,2,2,4,0,0,0,2,2,8,1.07
10601,"Geert Hammink\hammige01","1993-94",24,"ORL","NBA",0,1,0,3,1,3,1,3,0,0,0,0,1,0,1,1,0,0,0,1,2,1.4
10602,"A.J. Hammons\hammoaj01","2016-17",24,"DAL","NBA",0,22,0,163,17,42,12,32,5,10,9,20,8,28,36,4,1,13,10,21,48,2.2
10603,"Reggie Hanson\hansore01","1997-98",29,"BOS","NBA",0,8,0,26,3,6,3,6,0,0,0,0,3,3,6,1,2,1,3,8,6,1.1
10604,"Jerome Harmon\harmoje01","1994-95",25,"PHI","NBA",0,10,0,158,21,53,20,52,1,1,3,6,9,14,23,12,9,0,7,12,46,4.27
10605,"Justin Harper\harpeju01","2015-16",26,"DET","NBA",0,5,0,35,4,10,0,1,4,9,1,2,0,1,1,0,1,0,2,3,13,1.72
10606,"Josh Harrellson\harrejo01","2012-13",23,"MIA","NBA",0,6,0,31,4,9,3,4,1,5,1,2,3,4,7,0,1,1,3,4,10,1.57
10607,"Adam Harrington\harriad01","2002-03",22,"TOT","NBA",0,19,0,111,11,37,6,23,5,14,3,4,1,7,8,12,2,1,2,8,30,1.18
10608,"Al Harrington\harrial01","2012-13",32,"ORL","NBA",0,10,0,119,20,57,12,27,8,30,3,4,6,21,27,10,4,1,7,18,51,4.12
10609,"Othella Harrington\harriot01","2006-07",33,"CHA","NBA",0,26,0,220,25,56,25,56,0,0,17,22,13,25,38,6,1,1,15,49,67,2.19
10610,"Othella Harrington\harriot01","2007-08",34,"CHA","NBA",0,22,0,166,18,42,18,42,0,0,10,16,11,31,42,4,1,4,11,34,46,2.04
10611,"Elias Harris\harriel01","2013-14",24,"LAL","NBA",0,2,0,11,0,1,0,1,0,0,0,0,1,0,1,1,1,0,0,0,0,0.7
10612,"Joe Harris\harrijo01","2015-16",24,"CLE","NBA",0,5,0,15,1,4,0,0,1,4,0,0,0,3,3,2,0,0,1,1,3,0.64
10613,"Manny Harris\harrima01","2013-14",24,"LAL","NBA",0,9,0,180,28,70,21,50,7,20,10,12,7,27,34,11,4,1,9,10,73,6.71
10614,"Manny Harris\harrima01","2010-11",21,"CLE","NBA",0,54,15,933,108,289,74,197,34,92,71,93,36,104,140,85,31,7,63,65,321,5.64
10615,"Mike Harris\harrimi01","2010-11",27,"HOU","NBA",0,4,0,16,3,6,3,6,0,0,2,4,2,3,5,1,0,1,1,2,8,1.9
10616,"Aaron Harrison\harriaa01","2015-16",21,"CHO","NBA",0,21,0,93,5,19,2,9,3,10,5,12,4,11,15,2,6,0,4,10,18,0.82
10617,"Jason Hart\hartja01","2000-01",22,"MIL","NBA",0,1,0,10,1,1,1,1,0,0,0,0,0,0,0,1,0,0,2,0,2,2.4
10618,"Jason Hart\hartja01","2009-10",31,"TOT","NBA",0,5,0,22,1,2,1,2,0,0,0,0,0,2,2,6,2,1,3,4,2,1.74
10619,"Antonio Harvey\harvean01","2002-03",32,"ATL","NBA",0,4,0,32,2,5,2,5,0,0,0,0,1,5,6,0,1,4,3,7,4,1.88
10620,"Antonio Harvey\harvean01","2001-02",31,"SEA","NBA",0,5,3,47,4,12,4,12,0,0,1,2,5,4,9,5,1,3,3,8,9,2.4
10621,"Michael Hawkins\hawkimi01","1999-00",27,"CHH","NBA",0,12,0,36,3,13,2,8,1,5,1,2,0,7,7,13,0,0,3,2,8,0.97
10622,"Michael Hawkins\hawkimi01","2000-01",28,"CLE","NBA",0,10,0,76,3,9,1,5,2,4,0,0,2,3,5,13,2,0,6,13,8,1.6
10623,"Michael Hawkins\hawkimi01","1998-99",26,"SAC","NBA",0,24,0,203,14,40,9,21,5,19,3,3,10,15,25,27,3,1,13,14,36,1.92
10624,"Chuck Hayes\hayesch01","2015-16",32,"HOU","NBA",0,2,0,24,1,2,1,2,0,0,2,2,0,8,8,2,0,0,3,6,4,3.8
10625,"Gordon Hayward\haywago01","2017-18",27,"BOS","NBA",0,1,1,5,1,2,1,1,0,1,0,0,0,1,1,0,0,0,0,1,2,1.4
10626,"Brendan Haywood\haywobr01","2014-15",35,"CLE","NBA",0,22,1,119,14,30,14,30,0,0,7,13,6,23,29,2,2,10,10,17,35,1.78
10627,"Shane Heal\healsh01","2003-04",33,"SAS","NBA",0,6,0,72,7,24,3,6,4,18,4,5,1,3,4,5,1,0,5,2,22,2.28
10628,"Reggie Hearn\hearnre01","2017-18",26,"DET","NBA",0,3,0,7,1,2,0,0,1,2,0,0,0,0,0,0,0,0,0,0,3,0.67
10629,"Cedric Henderson\hendece02","2001-02",26,"GSW","NBA",0,12,0,70,15,31,13,27,2,4,4,7,1,2,3,4,6,2,8,4,36,2.54
10630,"Skeeter Henry\henrysk01","1993-94",26,"PHO","NBA",0,4,0,15,1,5,1,3,0,2,2,4,0,2,2,4,0,0,1,1,4,0.92
10631,"Xavier Henry\henryxa01","2012-13",21,"NOH","NBA",0,50,2,625,66,161,62,150,4,11,58,92,21,69,90,13,16,5,31,72,194,3.17
10632,"Steve Henson\hensost01","1993-94",25,"CHH","NBA",0,3,0,17,1,2,0,1,1,1,0,0,0,1,1,5,0,0,1,3,3,1.97
10633,"Steve Henson\hensost01","1998-99",30,"DET","NBA",0,4,0,25,1,2,1,2,0,0,2,2,0,0,0,3,1,0,3,1,4,1.52
10634,"Chris Herren\herrech01","2000-01",25,"BOS","NBA",0,25,7,408,29,96,13,41,16,55,9,12,4,17,21,56,14,0,20,43,83,3.51
10635,"Isaiah Hicks\hicksis01","2017-18",23,"NYK","NBA",0,18,0,240,33,72,31,63,2,9,12,18,10,31,41,16,2,4,16,45,80,4.04
10636,"Cory Higgins\higgico01","2012-13",23,"CHA","NBA",0,6,0,32,6,19,5,14,1,5,1,2,1,2,3,5,3,0,0,5,14,1.73
10637,"Rod Higgins\higgiro01","1994-95",35,"GSW","NBA",0,5,2,46,3,12,2,6,1,6,3,4,4,3,7,3,1,1,1,7,10,1.8
10638,"Sean Higgins\higgise01","1994-95",26,"NJN","NBA",0,57,7,735,105,273,82,195,23,78,35,40,25,52,77,29,10,9,35,93,268,3.23
10639,"Haywood Highsmith\highsha01","2018-19",22,"PHI","NBA",0,5,0,40,4,10,3,5,1,5,0,2,0,5,5,2,1,0,1,1,9,1.44
10640,"Jordan Hill\hilljo01","2016-17",29,"MIN","NBA",0,7,0,47,5,13,5,13,0,0,2,2,8,6,14,0,1,0,4,9,12,1.64
10641,"Steven Hill\hillst01","2008-09",23,"OKC","NBA",0,1,0,2,1,1,1,1,0,0,0,0,2,1,3,0,0,0,0,0,2,2.9
10642,"Darrun Hilliard\hillida01","2017-18",24,"SAS","NBA",0,14,0,95,5,19,5,13,0,6,6,7,0,7,7,11,2,0,4,7,16,1.2
10643,"Fred Hoiberg\hoibefr01","1998-99",26,"IND","NBA",0,12,0,87,6,21,5,12,1,9,6,6,2,9,11,4,0,0,3,11,19,1.16
10644,"Randy Holcomb\holcora01","2005-06",26,"CHI","NBA",0,4,0,11,1,1,1,1,0,0,0,0,1,0,1,0,0,0,0,2,2,0.52
10645,"John Holland\hollajo02","2018-19",30,"CLE","NBA",0,1,0,1,0,0,0,0,0,0,0,0,0,0,0,0,0,0,0,0,0,0
10646,"Tyler Honeycutt\honeyty01","2011-12",21,"SAC","NBA",0,15,0,88,8,24,7,21,1,3,3,5,3,11,14,7,4,3,2,3,20,1.48
10647,"Dave Hoppen\hoppeda01","1992-93",28,"NJN","NBA",0,2,0,10,1,1,1,1,0,0,0,2,1,3,4,0,0,0,0,2,2,1.25
10648,"Scotty Hopson\hopsosc01","2017-18",28,"DAL","NBA",0,1,0,8,0,1,0,1,0,0,1,2,0,0,0,1,0,0,1,0,1,0.6
10649,"Tito Horford\horfoti01","1993-94",28,"WSB","NBA",0,3,0,28,0,2,0,2,0,0,0,0,1,2,3,0,1,3,1,3,0,0.97
10650,"Dennis Horner\hornede01","2011-12",23,"NJN","NBA",0,8,0,22,1,4,1,3,0,1,3,4,2,3,5,0,0,0,1,1,5,0.53
10651,"Danuel House\houseda01","2016-17",23,"WAS","NBA",0,1,0,1,0,0,0,0,0,0,0,0,0,1,1,0,0,0,0,0,0,0.4
10652,"Tom Hovasse\hovasto01","1994-95",28,"ATL","NBA",0,2,0,4,0,1,0,0,0,1,0,0,0,0,0,0,1,0,0,1,0,0.15
10653,"Josh Howard\howarjo01","2012-13",32,"MIN","NBA",0,11,4,207,31,77,26,61,5,16,7,12,9,27,36,4,10,3,10,18,74,5.44
10654,"Juwan Howard\howarju01","2012-13",39,"MIA","NBA",0,7,2,51,10,19,10,19,0,0,1,1,0,8,8,6,0,0,4,9,21,2.73
10655,"Stephen Howard\howarst01","1997-98",27,"SEA","NBA",0,13,0,53,8,21,8,21,0,0,9,18,6,6,12,3,3,1,6,13,25,1.58
10656,"Troy Hudson\hudsotr01","1997-98",21,"UTA","NBA",0,8,0,23,6,14,6,11,0,3,0,0,1,1,2,4,2,0,1,1,12,1.28
10657,"Josh Huestis\huestjo01","2015-16",24,"OKC","NBA",0,5,0,55,5,12,1,6,4,6,0,4,2,8,10,0,1,2,3,3,14,2.48
10658,"Ryan Humphrey\humphry01","2003-04",24,"MEM","NBA",0,2,0,11,1,4,1,3,0,1,0,0,2,1,3,1,1,0,2,3,2,1.25
10659,"Lindsey Hunter\hunteli01","2008-09",38,"CHI","NBA",0,28,0,266,27,82,11,34,16,48,3,5,2,10,12,37,20,1,19,28,73,2.75
10660,"Othello Hunter\hunteot01","2009-10",23,"ATL","NBA",0,7,0,33,4,12,4,12,0,0,3,4,6,6,12,0,0,1,3,5,11,1.33
10661,"R.J. Hunter\hunterj01","2016-17",23,"CHI","NBA",0,3,0,9,0,1,0,0,0,1,0,0,0,1,1,0,0,0,0,0,0,-0.1
10662,"R.J. Hunter\hunterj01","2017-18",24,"HOU","NBA",0,5,1,45,7,20,4,6,3,14,2,2,0,5,5,3,3,0,2,7,19,2.98
10663,"Vince Hunter\huntevi01","2017-18",23,"MEM","NBA",0,4,0,7,3,5,3,5,0,0,0,0,2,1,3,0,0,1,1,0,6,1.4
10664,"Didier Ilunga-Mbenga\mbengdj01","2004-05",24,"DAL","NBA",0,15,1,58,6,14,6,14,0,0,3,4,3,5,8,0,0,5,5,13,15,0.93
10665,"Byron Irvin\irvinby01","1992-93",26,"WSB","NBA",0,4,2,45,9,18,8,17,1,1,3,6,2,2,4,2,1,0,4,5,22,3.95
10666,"Royal Ivey\iveyro01","2013-14",32,"OKC","NBA",0,2,0,5,0,2,0,1,0,1,0,0,0,1,1,0,0,0,0,1,0,-0.5
10667,"Jarrett Jack\jackja01","2016-17",33,"NOP","NBA",0,2,0,33,2,3,2,2,0,1,2,2,0,0,0,5,2,0,3,4,6,5.1
10668,"Aaron Jackson\jacksaa01","2017-18",31,"HOU","NBA",0,1,0,35,3,9,2,5,1,4,1,2,2,1,3,1,0,0,1,4,8,4.4
10669,"Jaren Jackson\jacksja01","1995-96",28,"HOU","NBA",0,4,0,33,0,8,0,3,0,5,8,10,0,3,3,0,1,0,0,5,8,0.95
10670,"Jaren Jackson\jacksja01","1993-94",26,"POR","NBA",0,29,0,187,34,87,34,81,0,6,12,14,6,11,17,27,4,2,14,20,80,2.17
10671,"Jaren Jackson\jacksja01","1994-95",27,"PHI","NBA",0,21,1,257,25,68,21,53,4,15,16,24,18,24,42,19,9,5,17,33,70,3.42
10672,"Jaren Jackson\jacksja01","2001-02",34,"ORL","NBA",0,9,0,144,15,37,8,17,7,20,2,4,1,16,17,8,5,0,8,13,39,3.97
10673,"Luke Jackson\jackslu02","2005-06",24,"CLE","NBA",0,36,0,315,29,85,17,49,12,36,26,33,16,24,40,25,11,2,31,30,96,2.53
10674,"Luke Jackson\jackslu02","2007-08",26,"MIA","NBA",0,14,1,228,26,80,15,50,11,30,16,23,7,26,33,17,8,0,9,22,79,4.55
10675,"Pierre Jackson\jackspi01","2016-17",25,"DAL","NBA",0,8,1,84,13,39,10,28,3,11,6,7,1,8,9,19,2,0,3,5,35,3.93
10676,"Randell Jackson\jacksra02","1999-00",24,"DAL","NBA",0,1,0,1,0,0,0,0,0,0,0,0,0,0,0,0,0,0,0,0,0,0
10677,"Sam Jacobson\jacobsa01","1998-99",23,"LAL","NBA",0,2,0,12,3,5,3,4,0,1,2,2,0,3,3,0,0,0,1,2,8,3.45
10678,"Damion James\jamesda01","2012-13",25,"BRK","NBA",0,2,0,0,0,0,0,0,0,0,0,0,0,1,1,0,0,0,0,0,0,0.2
10679,"Damion James\jamesda01","2013-14",26,"SAS","NBA",0,5,1,50,2,9,2,7,0,2,2,2,1,11,12,3,0,1,1,3,6,1.62
10680,"Jerome James\jamesje01","2008-09",33,"NYK","NBA",0,2,0,10,3,8,3,8,0,0,0,0,1,2,3,0,1,1,1,2,6,2.25
10681,"Mike James\jamesmi01","2001-02",26,"MIA","NBA",0,15,0,119,15,43,7,22,8,21,4,7,2,12,14,19,6,1,13,17,42,2.82
10682,"Harold Jamison\jamisha01","1999-00",23,"MIA","NBA",0,12,0,74,7,20,7,20,0,0,4,18,16,5,21,4,2,1,4,17,18,1.26
10683,"Chris Jefferies\jeffech01","2003-04",23,"TOT","NBA",0,21,2,195,27,72,10,30,17,42,13,20,5,24,29,7,4,7,19,36,84,3.19
10684,"Charles Jenkins\jenkich01","2012-13",23,"TOT","NBA",0,59,1,441,49,121,48,119,1,2,12,22,8,24,32,44,15,2,21,22,111,1.73
10685,"Horace Jenkins\jenkiho01","2004-05",30,"DET","NBA",0,15,0,104,15,45,15,36,0,9,12,13,3,6,9,9,5,1,7,6,42,2.11
10686,"John Jenkins\jenkijo01","2016-17",25,"PHO","NBA",0,4,0,13,2,5,1,3,1,2,2,2,0,1,1,1,0,0,0,0,7,1.35
10687,"Chris Jent\jentch01","1996-97",27,"NYK","NBA",0,3,0,10,2,6,0,3,2,3,0,0,1,0,1,1,0,0,0,2,6,1.23
10688,"Yi Jianlian\jianlyi01","2011-12",24,"DAL","NBA",0,30,0,203,31,82,28,72,3,10,14,21,12,37,49,5,7,8,14,23,79,2.23
10689,"Alize Johnson\johnsal02","2018-19",22,"IND","NBA",0,14,0,64,4,16,3,14,1,2,4,8,4,15,19,1,1,3,0,7,13,0.94
10690,"Brice Johnson\johnsbr02","2016-17",22,"LAC","NBA",0,3,0,9,2,7,2,7,0,0,0,0,1,2,3,1,2,1,1,0,4,1.5
10691,"Carldell Johnson\johnsca01","2011-12",29,"NOH","NBA",0,15,0,119,11,35,7,20,4,15,1,3,1,8,9,22,8,0,7,11,27,2.21
10692,"Darryl Johnson\johnsda02","1995-96",30,"CLE","NBA",0,11,0,28,5,12,5,11,0,1,2,2,2,0,2,1,0,0,1,3,12,0.65
10693,"DerMarr Johnson\johnsde03","2000-01",20,"ATL","NBA",0,78,21,1313,146,390,105,263,41,127,64,87,56,122,178,64,43,30,93,134,397,4.53
10694,"Ervin Johnson\johnser02","2005-06",38,"MIL","NBA",0,18,0,81,7,17,7,17,0,0,1,2,5,19,24,2,1,2,5,23,15,1.05
10695,"Ken Johnson\johnske03","2002-03",24,"MIA","NBA",0,16,0,156,15,37,15,37,0,0,2,6,4,28,32,0,1,12,6,20,32,2.04
10696,"Linton Johnson\johnsli01","2008-09",28,"TOT","NBA",0,10,0,55,4,11,3,9,1,2,0,0,3,5,8,2,1,0,2,7,9,0.85
10697,"Linton Johnson\johnsli01","2004-05",24,"SAS","NBA",0,2,0,15,0,2,0,1,0,1,0,0,0,3,3,0,1,0,1,1,0,0.4
10698,"Linton Johnson\johnsli01","2007-08",27,"TOT","NBA",0,8,0,63,9,19,8,16,1,3,2,2,5,9,14,4,0,1,5,11,21,2.55
10699,"Trey Johnson\johnstr01","2010-11",26,"TOT","NBA",0,8,0,94,12,33,11,30,1,3,9,10,2,5,7,11,1,1,5,12,34,3.44
10700,"Wesley Johnson\johnswe01","2018-19",31,"TOT","NBA",0,38,13,534,45,128,20,52,25,76,13,19,12,60,72,23,14,12,18,63,128,3.19
10701,"Wesley Johnson\johnswe01","2012-13",25,"PHO","NBA",0,50,21,953,161,396,111,241,50,155,27,35,21,102,123,34,22,18,48,56,399,5.81
10702,"Charles Jones\jonesch01","1994-95",37,"HOU","NBA",0,3,0,36,1,3,1,3,0,0,1,2,2,5,7,0,0,1,0,8,3,1.47
10703,"Dahntay Jones\jonesda02","2014-15",34,"LAC","NBA",0,33,0,123,6,21,6,17,0,4,9,11,1,10,11,2,3,0,1,23,21,0.51
10704,"Dahntay Jones\jonesda02","2016-17",36,"CLE","NBA",0,1,0,12,3,8,3,6,0,2,3,4,1,1,2,1,0,0,1,1,9,5.7
10705,"Damian Jones\jonesda03","2016-17",21,"GSW","NBA",0,10,0,85,8,16,8,16,0,0,3,10,9,14,23,0,1,4,6,15,19,2.12
10706,"Damon Jones\jonesda01","2008-09",32,"MIL","NBA",0,18,0,108,11,34,0,6,11,28,0,0,0,6,6,7,3,0,6,4,33,1.33
10707,"Dominique Jones\jonesdo02","2012-13",24,"DAL","NBA",0,29,3,338,40,109,39,100,1,9,35,53,18,27,45,83,14,2,38,29,116,4.83
10708,"Dominique Jones\jonesdo02","2010-11",22,"DAL","NBA",0,18,0,135,14,45,14,41,0,4,14,17,6,19,25,19,5,3,10,7,42,2.52
10709,"Dwayne Jones\jonesdw02","2009-10",26,"PHO","NBA",0,2,0,7,0,0,0,0,0,0,0,0,0,2,2,0,0,0,0,1,0,0.4
10710,"Dwayne Jones\jonesdw02","2006-07",23,"CLE","NBA",0,4,0,18,0,1,0,1,0,0,3,6,1,5,6,0,0,0,2,3,3,0.88
10711,"Fred Jones\jonesfr01","2002-03",23,"IND","NBA",0,19,1,115,9,24,7,17,2,7,3,4,4,5,9,5,6,1,6,13,23,1.22
10712,"James Jones\jonesja02","2003-04",23,"IND","NBA",0,6,0,26,2,9,1,5,1,4,2,2,0,2,2,0,1,0,0,1,7,0.55
10713,"Jumaine Jones\jonesju01","1999-00",20,"PHI","NBA",0,33,0,138,22,58,20,54,2,4,11,18,16,22,38,5,6,5,14,10,57,1.53
10714,"Perry Jones\jonespe01","2012-13",21,"OKC","NBA",0,38,1,280,39,99,39,97,0,2,10,15,12,50,62,10,5,6,15,23,88,1.93
10715,"Popeye Jones\jonespo01","2002-03",32,"DAL","NBA",0,26,0,222,24,62,24,62,0,0,5,11,29,30,59,8,5,1,15,31,53,1.99
10716,"Popeye Jones\jonespo01","2003-04",33,"GSW","NBA",0,5,0,10,0,2,0,2,0,0,0,0,1,0,1,0,0,0,0,2,0,-0.2
10717,"Solomon Jones\jonesso01","2013-14",29,"ORL","NBA",0,11,0,85,6,17,6,17,0,0,2,4,8,8,16,2,2,2,2,12,14,1.35
10718,"Solomon Jones\jonesso01","2007-08",23,"ATL","NBA",0,35,0,145,12,30,12,28,0,2,11,20,19,23,42,0,3,5,11,28,35,1.1
10719,"Adonis Jordan\jordaad01","1998-99",28,"MIL","NBA",0,4,0,18,2,4,2,2,0,2,2,4,0,0,0,3,3,0,2,0,6,2.08
10720,"Cory Joseph\josepco01","2011-12",20,"SAS","NBA",0,29,1,266,22,70,19,55,3,15,11,17,5,20,25,34,7,3,12,16,58,2.01
10721,"Chris Kaman\kamanch01","2003-04",21,"LAC","NBA",0,82,61,1843,200,435,200,433,0,2,99,142,126,335,461,85,23,73,155,211,499,7.02
10722,"Tim Kempton\kemptti01","1995-96",32,"ATL","NBA",0,3,0,11,0,0,0,0,0,0,0,0,0,2,2,1,0,0,1,5,0,0.5
10723,"D.J. Kennedy\kennedj01","2011-12",22,"CLE","NBA",0,2,0,59,5,12,3,8,2,4,0,2,1,6,7,3,2,0,3,7,12,5.85
10724,"Jonathan Kerner\kernejo01","1998-99",24,"ORL","NBA",0,1,0,5,0,1,0,1,0,0,0,0,0,0,0,0,0,0,0,2,0,-0.7
10725,"Lari Ketner\ketnela01","1999-00",22,"TOT","NBA",0,22,0,132,13,32,13,32,0,0,8,12,12,22,34,1,4,3,10,20,34,1.62
10726,"Randolph Keys\keysra01","1994-95",28,"LAL","NBA",0,6,0,83,9,26,9,17,0,9,2,2,6,11,17,2,1,2,2,16,20,2.67
10727,"Viktor Khryapa\khryavi01","2007-08",25,"CHI","NBA",0,9,0,105,12,31,12,30,0,1,8,14,6,14,20,8,6,0,6,11,32,3.59
10728,"Bo Kimble\kimblbo01","1992-93",26,"NYK","NBA",0,9,0,55,14,33,12,25,2,8,3,8,3,8,11,5,1,0,6,10,33,2.49
10729,"Stan Kimbrough\kimbrst01","1992-93",26,"SAC","NBA",0,3,0,15,2,6,1,4,1,2,0,0,0,0,0,1,1,0,0,1,5,1.1
10730,"Chris King\kingch01","1993-94",24,"SEA","NBA",0,15,0,86,19,48,17,41,2,7,15,26,5,10,15,11,4,0,12,12,55,2.82
10731,"George King\kingge03","2018-19",25,"PHO","NBA",0,1,0,6,0,0,0,0,0,0,0,0,0,1,1,0,0,0,0,0,0,0.4
10732,"Jimmy King\kingji02","1995-96",22,"TOR","NBA",0,62,1,868,110,255,105,221,5,34,54,77,43,67,110,88,21,13,60,76,279,4.37
10733,"Jimmy King\kingji02","1996-97",23,"DEN","NBA",0,2,0,22,2,6,2,6,0,0,2,4,2,0,2,2,3,0,1,2,6,3.5
10734,"Rich King\kingri01","1992-93",23,"SEA","NBA",0,3,0,12,2,5,2,5,0,0,2,2,1,4,5,1,0,0,3,1,6,2
10735,"Stacey King\kingst01","1996-97",30,"TOT","NBA",0,11,0,103,11,22,11,22,0,0,2,7,11,16,27,1,2,1,6,14,24,2.29
10736,"Tarence Kinsey\kinseta01","2007-08",23,"MEM","NBA",0,11,0,96,16,38,13,31,3,7,5,6,3,9,12,2,3,0,3,11,40,2.6
10737,"Andrei Kirilenko\kirilan01","2014-15",33,"BRK","NBA",0,7,0,36,0,5,0,5,0,0,3,4,2,6,8,1,1,0,1,1,3,0.57
10738,"Alex Kirk\kirkal01","2014-15",23,"CLE","NBA",0,5,0,14,1,4,1,4,0,0,2,2,1,0,1,1,0,0,0,1,4,0.54
10739,"Joe Kleine\kleinjo01","1999-00",38,"POR","NBA",0,7,0,31,4,11,4,11,0,0,3,3,0,6,6,2,1,0,2,7,11,1.39
10740,"Brandin Knight\knighbr02","2004-05",23,"HOU","NBA",0,1,0,3,0,1,0,1,0,0,0,0,0,0,0,1,0,0,0,0,0,0
10741,"Brandon Knight\knighbr03","2018-19",27,"TOT","NBA",0,39,26,736,99,260,58,131,41,129,27,34,10,49,59,71,21,2,30,62,266,5.55
10742,"Bart Kofoed\kofoeba01","1992-93",28,"BOS","NBA",0,7,0,41,3,13,3,12,0,1,11,14,0,1,1,10,2,1,3,1,17,2.57
10743,"Furkan Korkmaz\korkmfu01","2017-18",20,"PHI","NBA",0,14,0,80,8,28,3,11,5,17,2,4,2,9,11,4,2,1,2,12,23,1.12
10744,"Yaroslav Korolev\korolya01","2006-07",19,"LAC","NBA",0,10,0,41,4,16,3,11,1,5,3,6,1,2,3,4,3,0,1,0,12,0.82
10745,"Yaroslav Korolev\korolya01","2005-06",18,"LAC","NBA",0,24,0,127,9,30,7,23,2,7,7,10,5,8,13,9,3,0,6,11,27,0.95
10746,"Kosta Koufos\koufoko01","2009-10",20,"UTA","NBA",0,36,0,172,22,47,22,47,0,0,9,15,16,29,45,6,2,4,15,26,53,1.49
10747,"Viacheslav Kravtsov\kravtvi01","2013-14",26,"PHO","NBA",0,20,0,59,8,15,8,15,0,0,4,8,9,8,17,1,0,1,6,7,20,0.96
10748,"Ognjen Kuzmić\kuzmiog01","2013-14",23,"GSW","NBA",0,21,0,92,5,13,5,13,0,0,5,11,10,11,21,2,3,4,10,17,15,1
10749,"Mindaugas Kuzminskas\kuzmimi01","2017-18",28,"NYK","NBA",0,1,0,2,0,2,0,2,0,0,0,0,0,0,0,0,0,0,0,0,0,-1.4
10750,"Oliver Lafayette\lafayol01","2009-10",25,"BOS","NBA",0,1,0,22,3,6,2,4,1,2,0,0,1,3,4,2,0,0,1,0,7,7
10751,"Antonio Lang\langan02","1999-00",27,"TOT","NBA",0,10,0,38,1,6,1,6,0,0,4,5,0,5,5,2,4,1,2,8,6,0.99
10752,"Keith Langford\langfke01","2007-08",24,"SAS","NBA",0,2,0,10,1,4,1,4,0,0,0,0,0,2,2,0,0,0,0,1,2,0.2
10753,"Dan Langhi\langhda01","2001-02",24,"HOU","NBA",0,34,8,434,49,125,48,121,1,4,8,11,22,45,67,14,8,5,9,25,107,2.53
10754,"Gani Lawal\lawalga01","2010-11",22,"PHO","NBA",0,1,0,2,0,0,0,0,0,0,0,0,0,0,0,0,0,0,0,1,0,0
10755,"Ricky Ledo\ledori01","2013-14",21,"DAL","NBA",0,11,0,33,6,17,3,9,3,8,4,4,0,2,2,2,1,0,2,2,19,1.15
10756,"Doug Lee\leedo01","1992-93",28,"NJN","NBA",0,5,0,33,2,7,1,4,1,3,0,0,0,2,2,5,0,1,3,7,5,1.18
10757,"Malcolm Lee\leema01","2014-15",24,"PHI","NBA",0,1,0,2,0,1,0,1,0,0,0,0,0,0,0,0,0,0,0,0,0,-0.7
10758,"Tim Legler\legleti01","1996-97",30,"WSB","NBA",0,15,0,182,15,48,7,19,8,29,6,7,0,21,21,7,3,5,9,21,44,2.39
10759,"Martin Lewis\lewisma01","1995-96",20,"TOR","NBA",0,16,0,189,29,60,27,53,2,7,15,25,15,14,29,3,8,3,14,21,75,4.02
10760,"Quincy Lewis\lewisqu01","2003-04",26,"MIN","NBA",0,14,0,65,7,20,5,15,2,5,0,0,1,6,7,2,2,2,3,10,16,0.89
10761,"DeAndre Liggins\liggide01","2013-14",25,"MIA","NBA",0,1,0,1,1,1,1,1,0,0,0,0,1,0,1,0,0,0,0,0,2,2.1
10762,"DeAndre Liggins\liggide01","2011-12",23,"ORL","NBA",0,17,0,115,12,25,12,21,0,4,9,19,6,9,15,5,6,0,10,6,33,1.87
10763,"Jeremy Lin\linje01","2017-18",29,"BRK","NBA",0,1,1,25,5,12,4,10,1,2,7,7,0,0,0,4,0,0,3,3,18,14.4
10764,"Alton Lister\listeal01","1997-98",39,"POR","NBA",0,7,0,44,3,8,3,8,0,0,0,0,2,9,11,1,1,1,2,12,6,1.2
10765,"Randy Livingston\livinra01","1997-98",22,"ATL","NBA",0,12,0,82,3,12,3,12,0,0,4,5,1,5,6,5,7,2,6,6,10,1.39
10766,"Randy Livingston\livinra01","2000-01",25,"GSW","NBA",0,2,0,7,0,2,0,1,0,1,0,0,0,1,1,1,0,0,0,0,0,-0.15
10767,"Randy Livingston\livinra01","2005-06",30,"CHI","NBA",0,5,0,22,0,2,0,2,0,0,0,0,1,3,4,1,1,0,1,6,0,0.38
10768,"Horacio Llamas Grey\llamaho01","1996-97",23,"PHO","NBA",0,20,2,101,15,28,15,28,0,0,4,8,4,14,18,4,10,5,11,25,34,2.11
10769,"Zach Lofton\loftoza01","2018-19",26,"DET","NBA",0,1,0,4,0,1,0,0,0,1,0,0,0,0,0,0,1,0,1,0,0,0.3
10770,"Luc Longley\longllu01","2000-01",32,"NYK","NBA",0,25,2,301,18,54,18,54,0,0,13,17,26,40,66,7,3,9,22,51,49,2.3
10771,"John Lucas III\lucasjo02","2010-11",28,"CHI","NBA",0,2,0,10,1,3,1,2,0,1,0,2,0,0,0,1,0,0,0,0,2,0.1
10772,"John Lucas III\lucasjo02","2016-17",34,"MIN","NBA",0,5,0,11,1,4,1,3,0,1,0,0,0,0,0,1,2,0,0,0,2,0.46
10773,"Kalin Lucas\lucaska01","2014-15",25,"MEM","NBA",0,1,0,6,0,1,0,1,0,0,0,0,0,0,0,0,1,0,0,1,0,0.3
10774,"Kalin Lucas\lucaska01","2018-19",29,"DET","NBA",0,1,0,6,0,1,0,0,0,1,2,2,0,3,3,1,0,0,0,1,2,3.2
10775,"Tyler Lydon\lydonty01","2017-18",21,"DEN","NBA",0,1,0,2,0,0,0,0,0,0,0,0,0,0,0,0,0,0,0,0,0,0
10776,"George Lynch\lynchge01","2004-05",34,"NOH","NBA",0,44,27,933,68,189,57,152,11,37,17,23,55,119,174,88,32,12,57,83,164,5.18
10777,"Arvydas Macijauskas\macijar01","2005-06",26,"NOK","NBA",0,19,0,135,14,41,11,29,3,12,13,15,3,7,10,5,7,0,8,10,44,1.82
10778,"Sam Mack\macksa01","1999-00",29,"GSW","NBA",0,23,5,333,37,122,16,58,21,64,19,20,7,32,39,24,18,1,19,45,114,4.09
10779,"Don MacLean\macledo01","1999-00",30,"PHO","NBA",0,16,0,143,18,49,16,43,2,6,4,6,6,17,23,8,2,1,8,24,42,1.98
10780,"Daryl Macon\maconda01","2018-19",23,"DAL","NBA",0,8,0,90,10,27,5,16,5,11,4,7,2,10,12,7,1,0,6,8,29,2.95
10781,"J.P. Macura\macurjp01","2018-19",23,"CHO","NBA",0,2,0,17,3,9,3,5,0,4,0,0,0,3,3,2,0,0,0,0,6,1.75
10782,"Tito Maddox\maddoti01","2002-03",21,"HOU","NBA",0,9,0,35,3,12,3,9,0,3,5,8,1,6,7,5,3,1,3,4,11,1.4
10783,"Gerald Madkins\madkige01","1994-95",25,"CLE","NBA",0,7,0,28,2,6,1,4,1,2,3,4,0,0,0,1,2,0,3,2,8,0.99
10784,"Rick Mahorn\mahorri01","1998-99",40,"PHI","NBA",0,16,0,127,5,18,5,18,0,0,3,8,7,16,23,2,5,1,6,22,13,1.04
10785,"Sean Marks\marksse01","1998-99",23,"TOR","NBA",0,8,0,28,5,8,5,8,0,0,1,2,0,1,1,0,1,0,3,3,11,1.05
10786,"Sean Marks\marksse01","1999-00",24,"TOR","NBA",0,5,0,12,2,6,2,5,0,1,4,4,0,2,2,0,1,1,3,3,8,1.42
10787,"Sean Marks\marksse01","2006-07",31,"PHO","NBA",0,3,0,17,2,6,2,5,0,1,2,2,0,3,3,0,0,1,0,4,6,1.5
10788,"Rawle Marshall\marshra01","2006-07",24,"IND","NBA",0,40,2,361,32,89,28,71,4,18,31,45,8,21,29,13,12,5,19,22,99,2
10789,"Bob Martin\martibo01","1994-95",25,"LAC","NBA",0,1,0,14,1,5,1,5,0,0,0,0,2,0,2,1,0,1,0,2,2,1.1
10790,"Darrick Martin\martida01","2003-04",32,"MIN","NBA",0,16,0,172,20,67,14,41,6,26,9,9,2,5,7,23,2,1,7,23,55,2.36
10791,"Kenyon Martin\martike01","2006-07",29,"DEN","NBA",0,2,2,63,8,16,8,15,0,1,3,12,6,14,20,1,0,0,5,10,19,8.05
10792,"Desmond Mason\masonde01","2009-10",32,"SAC","NBA",0,5,4,66,5,12,5,12,0,0,3,4,4,9,13,2,1,1,4,5,13,2.9
10793,"Yante Maten\matenya01","2018-19",22,"MIA","NBA",0,2,0,13,1,4,1,3,0,1,0,0,1,2,3,0,1,0,0,0,2,0.9
10794,"Vernon Maxwell\maxweve01","2000-01",35,"TOT","NBA",0,43,6,660,73,223,39,112,34,111,21,32,4,62,66,49,21,3,35,64,201,3.57
10795,"Vernon Maxwell\maxweve01","1996-97",31,"SAS","NBA",0,72,31,2068,340,906,225,534,115,372,134,180,27,132,159,153,87,19,121,168,929,9.49
10796,"Luc Mbah a Moute\mbahalu01","2018-19",32,"LAC","NBA",0,4,0,61,8,18,6,12,2,6,2,5,2,5,7,2,1,1,2,8,20,3.82
10797,"James Michael McAdoo\mcadoja01","2017-18",25,"PHI","NBA",0,3,0,18,2,7,0,0,2,7,2,2,0,2,2,0,0,1,1,1,8,1.8
10798,"Tahjere McCall\mccalta01","2018-19",24,"BRK","NBA",0,1,0,8,2,3,2,2,0,1,0,1,0,1,1,0,0,0,0,2,4,2.7
10799,"Bob McCann\mccanbo01","1997-98",33,"TOR","NBA",0,1,0,5,0,1,0,1,0,0,0,0,0,1,1,0,0,0,0,1,0,-0.3
10800,"Kelly McCarty\mccarke01","1998-99",23,"DEN","NBA",0,2,0,4,2,3,2,3,0,0,0,0,2,1,3,0,0,0,2,0,4,1.95
10801,"Walter McCarty\mccarwa01","2005-06",31,"LAC","NBA",0,36,1,353,33,99,23,54,10,45,12,21,15,53,68,23,8,5,19,52,88,2.31
10802,"Walter McCarty\mccarwa01","1996-97",22,"NYK","NBA",0,35,0,192,26,68,22,54,4,14,8,14,8,15,23,13,7,9,17,38,64,1.6
10803,"Amal McCaskill\mccasam01","2001-02",28,"SAS","NBA",0,27,0,153,20,49,20,49,0,0,12,26,16,20,36,4,6,10,14,23,52,1.86
10804,"Amal McCaskill\mccasam01","2002-03",29,"ATL","NBA",0,11,0,70,4,17,4,17,0,0,3,4,7,15,22,5,3,1,2,13,11,1.48
10805,"Dan McClintock\mcclida01","2000-01",23,"DEN","NBA",0,6,1,58,9,18,9,18,0,0,0,5,10,7,17,1,0,2,3,11,18,2.65
10806,"Jelani McCoy\mccoyje01","2004-05",27,"ATL","NBA",0,10,0,88,7,13,7,13,0,0,1,5,7,14,21,0,3,8,6,24,15,2.41
10807,"Jelani McCoy\mccoyje01","2007-08",30,"DEN","NBA",0,6,1,33,1,1,1,1,0,0,1,2,1,6,7,0,0,5,4,7,3,1.43
10808,"Jelani McCoy\mccoyje01","2003-04",26,"CLE","NBA",0,2,0,12,0,0,0,0,0,0,0,0,1,3,4,0,0,0,1,4,0,0.8
10809,"Xavier McDaniel\mcdanxa01","1997-98",34,"NJN","NBA",0,20,0,180,10,30,10,30,0,0,5,8,12,19,31,9,3,2,8,23,25,1.49
10810,"Doug McDermott\mcderdo01","2014-15",23,"CHI","NBA",0,36,0,321,43,107,30,66,13,41,10,15,6,37,43,6,4,1,17,29,109,2.09
10811,"Mitch McGary\mcgarmi01","2015-16",23,"OKC","NBA",0,20,0,72,11,23,11,19,0,4,4,10,4,14,18,3,1,2,7,10,26,1.18
10812,"Dominic McGuire\mcguido01","2007-08",22,"WAS","NBA",0,70,1,695,39,103,38,97,1,6,14,32,53,86,139,40,20,26,40,76,93,2.16
10813,"Trey McKinney-Jones\mckintr01","2017-18",27,"IND","NBA",0,1,0,1,0,0,0,0,0,0,0,0,0,0,0,0,0,0,0,0,0,0
10814,"Josh McRoberts\mcrobjo01","2017-18",30,"DAL","NBA",0,2,0,6,0,1,0,0,0,1,0,0,0,0,0,0,0,0,0,2,0,-0.35
10815,"Stanislav Medvedenko\medvest01","2005-06",26,"LAL","NBA",0,2,0,6,1,2,1,2,0,0,0,0,0,0,0,1,0,0,0,1,2,0.85
10816,"Darnell Mee\meeda01","1994-95",23,"DEN","NBA",0,2,0,8,1,5,0,2,1,3,0,0,0,1,1,2,1,0,0,0,3,1.35
10817,"Fab Melo\melofa01","2012-13",22,"BOS","NBA",0,6,0,36,3,6,3,6,0,0,1,4,0,3,3,0,2,2,1,7,7,1.23
10818,"De'Anthony Melton\meltode01","2018-19",20,"PHO","NBA",0,50,31,984,100,256,71,161,29,95,21,28,25,109,134,159,68,23,75,113,250,7.14
10819,"Pops Mensah-Bonsu\mensapo01","2009-10",26,"TOT","NBA",0,20,0,120,13,33,13,33,0,0,13,24,16,19,35,3,4,9,10,20,39,2.16
10820,"Pops Mensah-Bonsu\mensapo01","2006-07",23,"DAL","NBA",0,12,0,71,11,17,11,17,0,0,7,18,9,12,21,0,1,0,9,8,29,2.21
10821,"Pops Mensah-Bonsu\mensapo01","2010-11",27,"NOH","NBA",0,7,0,35,1,3,1,3,0,0,0,0,3,8,11,2,0,0,2,11,2,0.87
10822,"Chris Mihm\mihmch01","2007-08",28,"LAL","NBA",0,23,5,278,32,95,32,95,0,0,18,27,28,49,77,13,4,14,17,42,82,3.41
10823,"Aaron Miles\milesaa01","2005-06",22,"GSW","NBA",0,19,0,118,6,18,6,18,0,0,4,4,0,14,14,24,4,1,11,13,16,1.73
10824,"Darko Miličić\milicda01","2011-12",26,"MIN","NBA",0,29,23,472,59,130,59,130,0,0,16,37,35,62,97,17,9,25,32,59,134,4.67
10825,"Anthony Miller\millean01","2004-05",33,"ATL","NBA",0,2,0,9,2,3,2,3,0,0,0,0,0,1,1,1,1,0,1,2,4,2.4
10826,"Anthony Miller\millean01","1995-96",24,"LAL","NBA",0,27,0,123,15,35,15,33,0,2,6,10,11,14,25,4,4,1,8,19,36,1.24
10827,"Anthony Miller\millean01","2000-01",29,"TOT","NBA",0,4,0,11,1,2,1,2,0,0,0,0,0,2,2,0,0,0,1,1,2,0.45
10828,"Oliver Miller\milleol01","1998-99",28,"SAC","NBA",0,4,0,35,5,11,5,11,0,0,0,0,7,1,8,0,0,2,4,3,10,2.23
10829,"Quincy Miller\millequ01","2012-13",20,"DEN","NBA",0,7,0,26,4,12,4,11,0,1,1,2,1,1,2,3,1,0,1,3,9,0.81
10830,"Quincy Miller\millequ01","2013-14",21,"DEN","NBA",0,52,16,789,94,256,64,162,30,94,39,55,36,111,147,26,22,32,48,70,257,4.43
10831,"Patty Mills\millspa02","2009-10",21,"POR","NBA",0,10,0,38,10,24,8,20,2,4,4,7,1,1,2,5,0,0,4,6,26,1.63
10832,"Terry Mills\millste01","1998-99",31,"MIA","NBA",0,1,0,29,3,8,1,4,2,4,1,2,3,1,4,0,1,0,3,3,9,6.8
10833,"Jason Miskiri\miskija01","1999-00",24,"CHH","NBA",0,1,0,3,0,1,0,0,0,1,0,0,0,0,0,1,0,0,0,2,0,0
10834,"Nazr Mohammed\mohamna01","1998-99",21,"PHI","NBA",0,26,0,121,15,42,15,42,0,0,12,21,18,19,37,2,5,4,12,22,42,1.5
10835,"Nazr Mohammed\mohamna01","2008-09",31,"CHA","NBA",0,39,1,341,41,101,41,101,0,0,22,40,35,44,79,8,5,16,23,63,104,2.46
10836,"Nazr Mohammed\mohamna01","2015-16",38,"OKC","NBA",0,5,0,19,3,5,3,5,0,0,2,2,1,3,4,0,0,0,3,4,8,1.46
10837,"Malik Monk\monkma01","2017-18",19,"CHO","NBA",0,63,0,854,153,425,70,182,83,243,32,38,8,58,66,91,20,9,49,60,421,4.74
10838,"Eric Montross\montrer01","2000-01",29,"TOT","NBA",0,54,21,649,56,138,56,138,0,0,8,31,52,121,173,19,11,26,41,115,120,2.75
10839,"Ben Moore\moorebe01","2017-18",22,"IND","NBA",0,2,0,9,0,0,0,0,0,0,0,0,0,1,1,1,0,0,0,4,0,0.55
10840,"Eric Moreland\moreler01","2014-15",23,"SAC","NBA",0,3,0,2,1,1,1,1,0,0,0,0,0,1,1,0,0,0,0,1,2,0.7
10841,"Eric Moreland\moreler01","2018-19",27,"TOT","NBA",0,5,0,43,3,7,2,6,1,1,0,0,4,16,20,4,1,1,5,9,7,3.16
10842,"Eric Moreland\moreler01","2015-16",24,"SAC","NBA",0,8,0,48,3,6,3,6,0,0,2,4,3,8,11,1,0,4,3,4,8,1.51
10843,"Darius Morris\morrida01","2013-14",23,"TOT","NBA",0,27,0,313,39,96,27,58,12,38,17,26,7,19,26,44,13,0,27,33,107,3.93
10844,"Isaiah Morris\morriis01","1992-93",23,"DET","NBA",0,25,0,102,26,57,26,57,0,0,3,4,6,6,12,4,3,1,8,14,55,1.46
10845,"Randolph Morris\morrira01","2008-09",23,"ATL","NBA",0,23,0,89,7,17,7,17,0,0,4,4,4,16,20,2,2,1,7,25,18,0.91
10846,"Adam Morrison\morriad01","2008-09",24,"TOT","NBA",0,52,5,711,80,223,48,127,32,96,17,23,18,62,80,41,9,4,32,77,209,2.98
10847,"Adam Morrison\morriad01","2009-10",25,"LAL","NBA",0,31,0,241,32,85,27,64,5,21,5,8,10,22,32,18,3,2,10,17,74,1.8
10848,"Arnett Moultrie\moultar01","2013-14",23,"PHI","NBA",0,12,2,187,16,38,16,38,0,0,4,5,11,24,35,2,8,4,7,22,36,3.47
10849,"Emmanuel Mudiay\mudiaem01","2017-18",21,"TOT","NBA",0,64,14,1245,204,526,157,378,47,148,98,129,26,126,152,206,41,11,113,80,553,7.93
10850,"Dejounte Murray\murrade01","2016-17",20,"SAS","NBA",0,38,8,322,50,116,41,93,9,23,21,30,6,36,42,48,8,6,38,29,130,3.36
10851,"Toure' Murry\murryto01","2013-14",24,"NYK","NBA",0,51,0,373,56,129,51,117,5,12,23,39,13,31,44,49,19,1,34,46,140,2.69
10852,"Jerrod Mustaf\mustaje01","1993-94",24,"PHO","NBA",0,33,2,196,30,84,30,84,0,0,13,22,20,35,55,8,4,5,10,29,73,1.75
10853,"Hamady N'Diaye\ndiayha01","2011-12",25,"WAS","NBA",0,3,0,3,0,1,0,1,0,0,0,0,0,0,0,0,0,0,0,0,0,-0.23
10854,"Hamady N'Diaye\ndiayha01","2013-14",27,"SAC","NBA",0,14,0,74,3,9,3,9,0,0,0,1,5,13,18,3,0,4,3,15,6,0.9
10855,"Makhtar N'Diaye\ndiayma01","1998-99",25,"VAN","NBA",0,4,0,27,1,4,1,4,0,0,3,4,3,2,5,1,0,1,1,9,5,1.4
10856,"Mamadou N'Diaye\ndiayma02","2000-01",25,"TOR","NBA",0,3,0,10,1,4,1,4,0,0,2,2,1,1,2,0,0,0,0,3,4,0.8
10857,"Rasho Nesterović\nestera01","1998-99",22,"MIN","NBA",0,2,0,30,3,12,3,12,0,0,2,2,3,5,8,1,0,0,1,5,8,2.35
10858,"Chuck Nevitt\nevitch01","1993-94",34,"SAS","NBA",0,1,0,1,0,0,0,0,0,0,3,6,1,0,1,0,0,0,1,1,3,2.2
10859,"Melvin Newbern\newbeme01","1992-93",25,"DET","NBA",0,33,1,311,42,113,41,105,1,8,34,60,19,18,37,57,23,1,32,42,119,3.78
10860,"Georges Niang\niangge01","2017-18",24,"UTA","NBA",0,9,0,32,4,11,4,7,0,4,1,2,3,6,9,3,2,0,3,1,9,1.13
10861,"Demetris Nichols\nichode01","2008-09",24,"TOT","NBA",0,4,0,14,3,9,3,7,0,2,1,2,0,2,2,1,0,1,0,1,7,0.92
10862,"Lucas Nogueira\noguelu01","2014-15",22,"TOR","NBA",0,6,0,23,2,8,2,8,0,0,2,4,2,9,11,1,2,0,2,6,6,1.25
10863,"Jeff Nordgaard\nordgje01","1997-98",24,"MIL","NBA",0,13,0,48,5,18,5,18,0,0,8,9,4,10,14,3,2,0,3,7,18,1.28
10864,"Steve Novak\novakst01","2016-17",33,"MIL","NBA",0,8,0,22,2,7,1,1,1,6,0,0,0,3,3,0,0,0,0,1,5,0.26
10865,"Julius Nwosu\nwosuju01","1994-95",23,"SAS","NBA",0,23,0,84,9,28,9,28,0,0,13,17,11,13,24,3,0,3,9,20,31,1.18
10866,"J.J. O'Brien\obriejj01","2015-16",23,"UTA","NBA",0,2,0,6,0,1,0,1,0,0,0,0,0,1,1,0,1,0,0,1,0,0.35
10867,"Patrick O'Bryant\obryapa01","2009-10",23,"TOR","NBA",0,11,0,51,8,15,8,14,0,1,3,6,2,9,11,1,2,4,5,12,19,1.85
10868,"Patrick O'Bryant\obryapa01","2006-07",20,"GSW","NBA",0,16,0,119,10,32,10,32,0,0,11,17,7,14,21,9,6,8,8,26,31,2.28
10869,"Dan O'Sullivan\osullda01","1993-94",25,"DET","NBA",0,13,0,56,4,12,4,12,0,0,9,12,2,8,10,3,0,0,3,10,17,1.16
10870,"Dan O'Sullivan\osullda01","1995-96",27,"TOR","NBA",0,5,2,139,13,35,13,34,0,1,7,8,13,19,32,2,2,4,5,13,33,6.46
10871,"Fabricio Oberto\obertfa01","2010-11",35,"POR","NBA",0,5,0,45,3,5,3,5,0,0,1,2,3,4,7,0,0,0,3,10,7,1.42
10872,"Daniel Ochefu\ochefda01","2016-17",23,"WAS","NBA",0,19,0,75,12,27,12,27,0,0,0,2,5,17,22,3,2,0,3,17,24,1.16
10873,"Alan Ogg\oggal01","1992-93",25,"TOT","NBA",0,6,0,29,5,13,5,13,0,0,3,4,3,7,10,4,1,3,3,6,13,2.57
10874,"Mehmet Okur\okurme01","2011-12",32,"NJN","NBA",0,17,14,454,52,139,29,67,23,72,3,5,22,59,81,30,9,5,25,45,130,6.98
10875,"Brian Oliver\olivebr01","1997-98",29,"ATL","NBA",0,5,0,61,7,19,7,19,0,0,1,4,3,6,9,2,1,0,1,4,15,1.86
10876,"Brian Oliver\olivebr01","1994-95",26,"WSB","NBA",0,6,0,42,4,9,4,9,0,0,6,8,0,4,4,4,0,0,3,8,14,2.15
10877,"Jimmy Oliver\oliveji01","1998-99",29,"PHO","NBA",0,2,0,11,1,3,0,2,1,1,0,0,0,0,0,0,0,0,0,2,3,0.65
10878,"Jimmy Oliver\oliveji01","1997-98",28,"WAS","NBA",0,1,0,10,2,4,1,2,1,2,0,0,0,2,2,1,0,0,0,1,5,4.5
10879,"Kevin Ollie\ollieke01","1998-99",26,"TOT","NBA",0,8,0,72,4,14,4,14,0,0,5,7,0,7,7,3,3,1,3,9,13,1.57
10880,"Arinze Onuaku\onuakar01","2016-17",29,"ORL","NBA",0,8,0,28,2,4,2,4,0,0,0,0,2,4,6,2,0,1,2,3,4,0.81
10881,"Arinze Onuaku\onuakar01","2013-14",26,"TOT","NBA",0,5,0,30,1,5,1,5,0,0,1,2,2,6,8,3,0,0,1,3,3,0.96
10882,"Matt Othick\othicma01","1992-93",23,"SAS","NBA",0,4,0,39,3,5,1,1,2,4,0,2,1,1,2,7,1,0,4,7,8,2.9
10883,"Bo Outlaw\outlabo01","2007-08",36,"ORL","NBA",0,2,0,7,2,3,2,3,0,0,0,0,0,0,0,0,0,0,1,1,4,1.35
10884,"Travis Outlaw\outlatr01","2003-04",19,"POR","NBA",0,8,0,19,3,7,3,7,0,0,2,4,2,2,4,1,1,0,1,1,8,0.85
10885,"Chris Owens\owensch01","2002-03",23,"MEM","NBA",0,1,0,6,2,3,2,3,0,0,0,0,1,0,1,0,0,0,1,0,4,3.1
10886,"Marcus Paige\paigema01","2017-18",24,"CHO","NBA",0,5,0,28,4,14,2,6,2,8,2,2,0,4,4,3,0,0,0,0,12,1.5
10887,"Walter Palmer\palmewa01","1992-93",24,"DAL","NBA",0,20,0,124,27,57,27,57,0,0,6,9,12,32,44,5,1,5,10,29,60,2.76
10888,"Andy Panko\pankoan01","2000-01",23,"ATL","NBA",0,1,0,1,0,0,0,0,0,0,0,0,0,0,0,0,0,0,0,0,0,0
10889,"Georgios Papagiannis\papagge01","2017-18",20,"TOT","NBA",0,17,0,122,18,42,18,42,0,0,0,0,13,24,37,9,4,6,8,12,36,2.54
10890,"Jeremy Pargo\pargoje01","2012-13",26,"TOT","NBA",0,39,11,655,99,250,74,176,25,74,42,62,8,41,49,92,13,2,50,46,265,5.64
10891,"Anthony Parker\parkean01","1998-99",23,"PHI","NBA",0,2,0,3,1,1,1,1,0,0,0,0,0,0,0,0,0,0,0,0,2,0.85
10892,"Cherokee Parks\parksch02","2001-02",29,"SAS","NBA",0,42,1,234,30,83,30,83,0,0,3,8,24,34,58,10,7,8,14,34,63,1.37
10893,"Chandler Parsons\parsoch01","2018-19",30,"MEM","NBA",0,25,3,496,68,182,39,88,29,94,22,25,4,66,70,43,19,5,32,45,187,6.65
10894,"Justin Patton\pattoju01","2017-18",20,"MIN","NBA",0,1,0,4,1,2,1,2,0,0,0,0,0,0,0,0,1,0,0,1,2,2
10895,"Justin Patton\pattoju01","2018-19",21,"PHI","NBA",0,3,0,21,2,7,2,5,0,2,1,2,2,4,6,3,2,0,0,5,5,2.33
10896,"Kenny Payne\payneke01","1992-93",26,"PHI","NBA",0,13,0,154,38,90,34,72,4,18,4,4,4,20,24,18,5,2,7,15,84,4.98
10897,"Oleksiy Pecherov\pecheol01","2007-08",22,"WAS","NBA",0,35,0,320,44,125,27,65,17,60,20,31,21,45,66,7,6,5,17,30,125,2.61
10898,"Mike Peplowski\peplomi01","1995-96",25,"TOT","NBA",0,7,0,17,3,5,3,5,0,0,1,3,1,3,4,1,1,2,2,10,7,1.23
10899,"Kendrick Perkins\perkike01","2017-18",33,"CLE","NBA",0,1,0,15,1,2,1,2,0,0,1,2,0,1,1,2,1,0,1,1,3,4.4
10900,"Kosta Perović\perovko01","2007-08",22,"GSW","NBA",0,7,0,38,3,10,3,10,0,0,4,6,6,7,13,1,0,2,1,6,10,1.53
10901,"Chuck Person\persoch01","1992-93",28,"MIN","NBA",0,78,75,2985,541,1248,423,916,118,332,109,168,98,335,433,343,67,30,219,198,1309,14.48
10902,"Morris Peterson\petermo01","2010-11",33,"OKC","NBA",0,4,0,23,2,5,2,4,0,1,0,0,0,3,3,1,0,0,0,5,4,0.8
10903,"Richard Petruška\petruri01","1993-94",25,"HOU","NBA",0,22,0,92,20,46,13,31,7,15,6,8,9,22,31,1,2,3,15,15,53,2.05
10904,"Derrick Phelps\phelpde01","1994-95",22,"SAC","NBA",0,3,0,5,0,1,0,1,0,0,0,2,0,0,0,1,0,0,0,3,0,-0.27
10905,"Eric Piatkowski\piatker01","2006-07",36,"PHO","NBA",0,11,0,73,9,25,2,7,7,18,2,2,2,7,9,4,0,1,5,6,27,1.84
10906,"Mickaël Piétrus\pietrmi01","2012-13",30,"TOR","NBA",0,19,16,386,34,98,14,34,20,64,12,18,5,31,36,9,12,6,16,33,100,4.18
10907,"Theo Pinson\pinsoth01","2018-19",23,"BRK","NBA",0,18,0,211,25,73,13,27,12,46,19,22,4,32,36,21,6,0,18,15,81,4.1
10908,"Dexter Pittman\pittmde01","2013-14",25,"ATL","NBA",0,2,0,3,0,1,0,1,0,0,0,2,3,0,3,0,0,0,0,0,0,-0.15
10909,"Miles Plumlee\plumlmi01","2012-13",24,"IND","NBA",0,14,0,55,5,21,5,21,0,0,3,4,12,10,22,2,0,3,3,5,13,0.87
10910,"Pavel Podkolzin\podkopa01","2004-05",20,"DAL","NBA",0,5,0,10,0,0,0,0,0,0,1,2,0,2,2,0,0,0,2,4,1,0.28
10911,"Mark Pope\popema01","1997-98",25,"IND","NBA",0,28,0,193,14,41,13,38,1,3,10,17,9,17,26,7,3,6,10,36,39,1.27
10912,"Mark Pope\popema01","2004-05",32,"DEN","NBA",0,9,0,27,2,6,2,6,0,0,0,0,5,3,8,1,1,2,1,5,4,0.77
10913,"Otto Porter\porteot01","2013-14",20,"WAS","NBA",0,37,0,319,33,91,29,70,4,21,8,12,21,36,57,10,8,1,14,26,78,1.74
10914,"Josh Powell\poweljo01","2013-14",31,"HOU","NBA",0,1,0,19,2,6,2,6,0,0,0,0,0,5,5,0,0,1,1,1,4,3.3
10915,"Josh Powell\poweljo01","2009-10",27,"LAL","NBA",0,63,0,581,71,194,64,178,7,16,20,31,44,72,116,35,9,6,33,71,169,2.24
10916,"Kasib Powell\powelka01","2007-08",26,"MIA","NBA",0,11,4,304,35,95,27,62,8,33,6,9,8,36,44,18,9,2,5,18,84,6.45
10917,"A.J. Price\priceaj01","2013-14",27,"MIN","NBA",0,28,0,99,19,46,13,24,6,22,0,2,1,9,10,13,1,0,7,5,44,1.17
10918,"Brent Price\pricebr01","2001-02",33,"SAC","NBA",0,20,0,89,9,27,5,12,4,15,9,13,4,4,8,9,3,1,10,13,31,1.37
10919,"Brent Price\pricebr01","2000-01",32,"VAN","NBA",0,6,0,30,3,11,2,7,1,4,6,7,1,3,4,5,2,0,4,8,13,2.2
10920,"Mark Price\pricema01","1995-96",31,"WSB","NBA",0,7,1,127,18,60,8,30,10,30,10,10,1,6,7,18,6,0,10,7,56,6.09
10921,"Ronnie Price\pricero01","2016-17",33,"PHO","NBA",0,14,0,134,4,24,1,7,3,17,3,4,3,8,11,18,11,1,3,14,14,1.94
10922,"Joel Przybilla\przybjo01","2012-13",33,"MIL","NBA",0,12,1,68,1,4,1,4,0,0,0,2,5,16,21,4,1,2,4,10,2,1.03
10923,"Jacob Pullen\pulleja01","2017-18",28,"PHI","NBA",0,3,0,6,1,2,1,1,0,1,0,0,0,0,0,0,0,0,1,0,2,0.33
10924,"Zhou Qi\qizh01","2018-19",23,"HOU","NBA",0,1,0,1,1,1,1,1,0,0,0,0,0,0,0,0,0,0,0,0,2,1.7
10925,"Tim Quarterman\quartti01","2017-18",23,"HOU","NBA",0,3,0,13,1,3,1,1,0,2,2,2,0,3,3,1,0,0,2,1,4,1.4
10926,"Vladimir Radmanović\radmavl01","2009-10",29,"TOT","NBA",0,41,20,891,103,273,73,165,30,108,20,27,51,127,178,45,29,7,44,97,256,5.85
10927,"Miroslav Raduljica\radulmi01","2014-15",27,"MIN","NBA",0,5,0,23,3,8,3,8,0,0,2,2,2,3,5,0,1,0,2,8,8,1.32
10928,"Peter John Ramos\ramospe01","2004-05",19,"WAS","NBA",0,6,0,20,5,10,5,10,0,0,1,2,1,3,4,0,0,1,3,4,11,1.32
10929,"Mark Randall\randama01","1994-95",27,"DEN","NBA",0,8,0,39,3,10,3,9,0,1,0,0,4,8,12,1,0,0,1,5,6,0.71
10930,"Shavlik Randolph\randosh01","2008-09",25,"POR","NBA",0,10,0,37,8,13,7,12,1,1,1,4,10,8,18,0,0,1,6,4,18,1.88
10931,"Shavlik Randolph\randosh01","2009-10",26,"TOT","NBA",0,6,0,53,6,18,6,18,0,0,2,2,7,7,14,1,1,1,3,9,14,1.97
10932,"Shavlik Randolph\randosh01","2007-08",24,"PHI","NBA",0,9,0,27,4,14,4,14,0,0,0,0,9,2,11,3,1,3,2,5,8,1.04
10933,"Shavlik Randolph\randosh01","2014-15",31,"TOT","NBA",0,21,0,126,9,35,9,30,0,5,6,12,16,22,38,4,5,3,3,16,24,1.23
10934,"Blair Rasmussen\rasmubl01","1992-93",30,"ATL","NBA",0,22,6,283,30,80,28,74,2,6,9,13,20,35,55,5,5,10,12,61,71,2.86
10935,"Theo Ratliff\ratlith01","2010-11",37,"LAL","NBA",0,10,0,71,1,6,1,6,0,0,0,2,6,7,13,3,2,5,3,7,2,1.02
10936,"Theo Ratliff\ratlith01","2001-02",28,"ATL","NBA",0,3,2,82,10,20,10,20,0,0,6,11,5,11,16,1,1,8,7,8,26,9.23
10937,"Eldridge Recasner\recasel01","1994-95",27,"DEN","NBA",0,3,0,13,1,6,1,5,0,1,4,4,0,2,2,1,3,0,2,0,6,2.23
10938,"Eldridge Recasner\recasel01","2001-02",34,"TOT","NBA",0,6,0,33,2,6,2,5,0,1,1,1,0,0,0,5,1,0,1,4,5,1.02
10939,"Eldridge Recasner\recasel01","2000-01",33,"CHH","NBA",0,43,0,403,38,114,25,75,13,39,14,18,13,37,50,39,6,1,27,30,103,2.11
10940,"Khalid Reeves\reevekh01","1999-00",27,"CHI","NBA",0,3,0,48,3,12,3,9,0,3,5,5,2,2,4,13,2,0,6,8,11,5.5
10941,"Jared Reiner\reineja01","2004-05",22,"CHI","NBA",0,19,2,132,10,30,10,30,0,0,1,4,13,25,38,1,3,7,9,35,21,1.4
10942,"Jerry Reynolds\reynoje01","1995-96",33,"MIL","NBA",0,19,0,191,21,53,20,43,1,10,13,21,13,20,33,12,15,6,16,20,56,3.42
10943,"Glen Rice\ricegl01","2001-02",34,"HOU","NBA",0,20,20,606,65,167,47,103,18,64,24,30,5,42,47,31,12,3,24,34,172,6.66
10944,"Jeremy Richardson\richaje01","2006-07",22,"TOT","NBA",0,6,0,20,3,6,1,3,2,3,0,0,1,1,2,0,1,0,1,2,8,1.13
10945,"Norm Richardson\richano01","2001-02",22,"TOT","NBA",0,11,0,67,10,26,6,18,4,8,6,9,3,5,8,2,0,0,3,5,30,1.75
10946,"Fred Roberts\roberfr01","1996-97",36,"DAL","NBA",0,12,0,40,6,15,6,15,0,0,10,14,2,8,10,0,0,1,5,2,22,1.42
10947,"Stanley Roberts\roberst01","1999-00",29,"PHI","NBA",0,5,1,51,5,16,5,15,0,1,0,3,6,9,15,3,1,1,2,15,10,1.88
10948,"Ryan Robertson\roberry01","1999-00",23,"SAC","NBA",0,1,0,25,2,6,2,4,0,2,1,1,0,0,0,0,0,0,0,0,5,1.6
10949,"Devin Robinson\robinde01","2017-18",22,"WAS","NBA",0,1,0,13,1,3,1,3,0,0,0,0,2,3,5,0,1,0,0,2,2,3.3
10950,"James Robinson\robinja02","2000-01",30,"ORL","NBA",0,6,0,50,4,11,2,6,2,5,0,0,0,8,8,0,4,1,4,5,10,1.97
10951,"Larry Robinson\robinla01","2001-02",34,"NYK","NBA",0,2,0,10,1,4,0,2,1,2,0,0,0,2,2,0,0,0,0,1,3,0.7
10952,"Larry Robinson\robinla01","1997-98",30,"VAN","NBA",0,6,0,41,6,19,3,13,3,6,2,2,2,10,12,1,4,0,2,0,17,2.6
10953,"Larry Robinson\robinla01","1992-93",25,"WSB","NBA",0,4,0,33,6,16,6,15,0,1,3,5,1,2,3,3,1,1,1,0,15,2.6
10954,"Larry Robinson\robinla01","1993-94",26,"HOU","NBA",0,6,0,55,10,20,8,12,2,8,3,8,4,6,10,6,7,0,10,8,25,4.7
10955,"Nate Robinson\robinna01","2015-16",31,"NOP","NBA",0,2,1,23,0,1,0,0,0,1,0,0,0,0,0,4,1,0,0,5,0,1.55
10956,"Carlos Rogers\rogerca01","1998-99",27,"POR","NBA",0,2,0,8,2,2,2,2,0,0,1,4,0,1,1,1,0,0,0,2,5,2.15
10957,"Quinton Ross\rossqu01","2010-11",29,"NJN","NBA",0,36,4,353,26,59,26,56,0,3,5,14,10,20,30,10,3,6,7,40,57,1.35
10958,"Brandon Roy\roybr01","2012-13",28,"MIN","NBA",0,5,5,122,11,35,11,26,0,9,7,10,3,11,14,23,3,0,7,5,29,6.48
10959,"Guy Rucker\ruckegu01","2002-03",25,"GSW","NBA",0,3,0,4,0,0,0,0,0,0,0,0,0,1,1,1,0,0,0,1,0,0.37
10960,"Michael Ruffin\ruffimi01","2006-07",30,"WAS","NBA",0,30,0,271,5,18,5,18,0,0,7,19,35,27,62,6,6,8,12,43,17,1.41
10961,"Michael Ruffin\ruffimi01","2001-02",25,"PHI","NBA",0,15,0,169,7,26,7,26,0,0,2,8,23,28,51,5,5,8,11,23,16,2.18
10962,"Jeff Ruland\rulanje01","1992-93",34,"DET","NBA",0,11,0,55,5,11,5,11,0,0,2,4,9,9,18,2,2,0,6,16,12,1.46
10963,"Brandon Rush\rushbr01","2012-13",27,"GSW","NBA",0,2,0,25,6,9,6,7,0,2,2,3,0,1,1,2,0,0,3,5,14,5.75
10964,"Kareem Rush\rushka01","2008-09",28,"PHI","NBA",0,25,1,199,20,58,10,25,10,33,4,4,0,15,15,15,5,1,10,10,54,1.74
10965,"Kareem Rush\rushka01","2009-10",29,"LAC","NBA",0,7,0,58,4,11,3,8,1,3,0,0,1,5,6,4,2,3,3,8,9,1.74
10966,"Bryon Russell\russebr01","2005-06",35,"DEN","NBA",0,1,0,3,0,0,0,0,0,0,0,0,0,1,1,1,0,0,0,0,0,1.1
10967,"D'Angelo Russell\russeda01","2015-16",19,"LAL","NBA",0,80,48,2259,392,956,262,586,130,370,140,190,47,227,274,266,93,13,196,142,1054,11.49
10968,"Kevin Salvadori\salvake01","1996-97",26,"SAC","NBA",0,23,0,154,12,33,12,33,0,0,13,18,6,19,25,10,2,13,12,17,37,1.95
10969,"Brandon Sampson\sampsbr01","2018-19",21,"CHI","NBA",0,14,2,214,28,60,17,31,11,29,4,6,3,13,16,10,8,3,12,19,71,4.49
10970,"Jamal Sampson\sampsja01","2002-03",19,"MIL","NBA",0,5,0,8,0,2,0,2,0,0,0,0,1,1,2,1,1,0,0,0,0,0.22
10971,"Samardo Samuels\samuesa01","2010-11",22,"CLE","NBA",0,37,10,701,110,241,110,238,0,3,68,110,75,83,158,17,15,18,53,88,288,6.74
10972,"Pepe Sánchez\sanchpe01","2002-03",25,"DET","NBA",0,9,0,37,0,5,0,5,0,0,0,0,4,2,6,8,5,0,2,3,0,1.06
10973,"Larry Sanders\sandela01","2016-17",28,"CLE","NBA",0,5,0,13,1,4,1,4,0,0,2,2,3,1,4,0,1,1,2,5,4,0.98
10974,"Daniel Santiago\santida01","2004-05",28,"MIL","NBA",0,11,0,105,7,21,7,21,0,0,8,11,6,13,19,1,3,4,4,28,22,2.09
10975,"Daniel Santiago\santida01","2001-02",25,"PHO","NBA",0,3,0,24,4,8,4,8,0,0,0,0,0,7,7,2,0,1,2,4,8,2.97
10976,"Jason Sasser\sasseja01","1998-99",25,"VAN","NBA",0,6,0,39,5,11,5,11,0,0,1,2,2,5,7,2,2,0,2,4,11,1.85
10977,"Jason Sasser\sasseja01","1996-97",23,"TOT","NBA",0,8,0,69,9,23,8,20,1,3,0,0,1,7,8,2,3,0,2,11,19,1.76
10978,"Alex Scales\scaleal01","2005-06",27,"SAS","NBA",0,1,0,0,0,0,0,0,0,0,0,0,0,0,0,0,0,0,0,0,0,0
10979,"Danny Schayes\schayda01","1993-94",34,"TOT","NBA",0,36,6,363,28,84,28,84,0,0,29,32,31,48,79,13,10,10,23,45,85,2.61
10980,"Danny Schayes\schayda01","1998-99",39,"ORL","NBA",0,19,1,143,11,29,11,29,0,0,6,8,3,11,14,4,1,2,8,23,28,1.16
10981,"Steve Scheffler\schefst01","1996-97",29,"SEA","NBA",0,7,0,29,6,7,6,7,0,0,1,2,1,2,3,0,0,0,5,5,13,1.61
10982,"Luke Schenscher\schenlu01","2006-07",24,"POR","NBA",0,11,0,118,7,23,7,23,0,0,5,7,10,15,25,1,2,4,4,25,19,1.85
10983,"Dwayne Schintzius\schindw01","1996-97",28,"LAC","NBA",0,15,0,116,13,36,12,34,1,2,7,8,9,13,22,4,1,9,7,22,34,2.17
10984,"Brent Scott\scottbr01","1996-97",25,"IND","NBA",0,16,0,55,8,17,8,17,0,0,3,6,3,6,9,3,1,1,4,14,19,1.03
10985,"Brad Sellers\sellebr01","1992-93",30,"MIN","NBA",0,54,4,533,49,130,49,129,0,1,37,39,27,56,83,46,6,11,27,40,135,2.63
10986,"Mouhamed Sene\senesa01","2006-07",20,"SEA","NBA",0,28,3,169,18,49,18,49,0,0,17,29,16,29,45,0,3,12,11,33,53,1.8
10987,"Ha Seung-Jin\seungha01","2005-06",20,"POR","NBA",0,27,4,212,18,31,18,31,0,0,8,17,14,35,49,1,3,8,14,41,44,2.03
10988,"Brian Shaw\shawbr01","1998-99",32,"POR","NBA",0,1,0,5,0,1,0,1,0,0,0,0,0,1,1,1,0,0,1,1,0,0.4
10989,"Tornike Shengelia\shengto01","2012-13",21,"BRK","NBA",0,19,0,93,10,23,9,21,1,2,9,16,9,14,23,3,3,1,11,11,30,1.58
10990,"Paul Shirley\shirlpa01","2004-05",27,"PHO","NBA",0,9,0,30,5,11,5,11,0,0,2,4,1,1,2,3,0,0,1,3,12,0.93
10991,"Iman Shumpert\shumpim01","2017-18",27,"CLE","NBA",0,14,6,276,22,58,15,32,7,26,11,15,7,34,41,17,9,4,16,22,62,4.91
10992,"Jordan Sibert\siberjo01","2018-19",26,"ATL","NBA",0,1,0,4,1,1,0,0,1,1,0,0,0,0,0,0,0,0,0,0,3,2.7
10993,"Xavier Silas\silasxa01","2017-18",30,"BOS","NBA",0,2,0,7,0,3,0,1,0,2,0,0,1,1,2,0,1,0,0,1,0,-0.15
10994,"Wayne Simien\simiewa01","2006-07",23,"MIA","NBA",0,8,0,93,9,23,9,23,0,0,5,7,5,6,11,4,2,0,3,13,23,2.36
10995,"Bobby Simmons\simmobo01","2010-11",30,"SAS","NBA",0,2,0,16,0,3,0,0,0,3,0,0,0,0,0,2,0,0,0,2,0,-0.35
10996,"Cedric Simmons\simmoce01","2008-09",23,"TOT","NBA",0,18,0,84,11,25,11,25,0,0,7,16,5,11,16,2,1,4,2,8,29,1.33
10997,"Kobi Simmons\simmoko01","2018-19",21,"CLE","NBA",0,1,0,2,0,0,0,0,0,0,0,0,0,0,0,0,0,0,0,0,0,0
10998,"Dickey Simpkins\simpkdi01","2001-02",29,"ATL","NBA",0,1,0,3,0,0,0,0,0,0,0,0,0,0,0,1,0,0,0,0,0,0.7
10999,"Courtney Sims\simsco01","2008-09",25,"TOT","NBA",0,2,0,13,3,6,3,6,0,0,0,0,2,2,4,0,0,0,1,1,6,2.3
11000,"Courtney Sims\simsco01","2007-08",24,"IND","NBA",0,3,0,11,0,1,0,1,0,0,0,0,1,1,2,1,0,0,0,2,0,0.27
11001,"Henry Sims\simshe01","2012-13",22,"NOH","NBA",0,2,0,5,2,3,2,3,0,0,0,0,2,0,2,0,0,0,1,1,4,1.75
11002,"Kyle Singler\singlky01","2017-18",29,"OKC","NBA",0,12,0,59,7,21,5,16,2,5,7,13,1,9,10,2,1,0,3,4,23,1.26
11003,"Sean Singletary\singlse01","2008-09",23,"TOT","NBA",0,37,2,303,31,85,21,60,10,25,18,21,10,25,35,29,11,0,23,45,90,2.35
11004,"Brian Skinner\skinnbr01","2011-12",35,"MEM","NBA",0,1,0,4,0,1,0,1,0,0,0,0,0,0,0,0,0,0,0,1,0,-0.7
11005,"Brian Skinner\skinnbr01","2009-10",33,"LAC","NBA",0,16,1,123,10,25,10,25,0,0,6,8,9,18,27,0,3,4,7,20,26,1.77
11006,"Brian Skinner\skinnbr01","2010-11",34,"MIL","NBA",0,2,0,6,0,0,0,0,0,0,0,0,0,0,0,0,0,0,0,0,0,0
11007,"Tamar Slay\slayta01","2002-03",22,"NJN","NBA",0,36,0,274,39,103,32,78,7,25,7,10,8,23,31,14,14,3,20,31,92,2.02
11008,"Tamar Slay\slayta01","2003-04",23,"NJN","NBA",0,22,0,165,21,60,17,48,4,12,7,14,10,15,25,14,7,1,11,20,53,2
11009,"Charles Smith\smithch04","2002-03",27,"POR","NBA",0,3,0,13,1,4,1,3,0,1,3,4,0,0,0,1,1,0,1,3,5,1.3
11010,"Charles Smith\smithch01","1996-97",31,"SAS","NBA",0,19,7,329,34,84,34,83,0,1,20,26,18,47,65,14,13,22,22,44,88,5.51
11011,"Chris Smith\smithch05","2013-14",26,"NYK","NBA",0,2,0,2,0,0,0,0,0,0,0,0,0,0,0,0,0,0,0,0,0,0
11012,"Dennis Smith\smithde03","2018-19",21,"TOT","NBA",0,53,50,1508,278,650,211,442,67,208,99,156,32,123,155,252,67,20,154,129,722,12.73
11013,"Jabari Smith\smithja01","2003-04",26,"SAC","NBA",0,31,0,168,26,70,26,67,0,3,12,20,11,20,31,11,2,6,7,25,64,1.56
11014,"Jason Smith\smithja02","2017-18",31,"WAS","NBA",0,33,2,285,45,115,41,83,4,32,19,21,18,35,53,14,3,13,16,44,113,2.81
11015,"Jerry Smith\smithje01","2011-12",24,"NJN","NBA",0,5,0,46,3,14,2,8,1,6,0,0,2,5,7,4,5,0,0,5,7,1.8
11016,"Josh Smith\smithjo03","2015-16",30,"TOT","NBA",0,55,7,880,127,349,86,206,41,143,37,67,51,141,192,90,34,47,77,118,332,6.06
11017,"Josh Smith\smithjo03","2017-18",32,"NOP","NBA",0,3,0,12,1,4,1,4,0,0,0,0,3,1,4,0,0,0,0,3,2,0.4
11018,"Leon Smith\smithle01","2003-04",23,"SEA","NBA",0,1,0,4,1,2,1,2,0,0,0,0,1,1,2,0,0,0,0,1,2,1.8
11019,"Reggie Smith\smithre01","1992-93",22,"POR","NBA",0,23,0,68,10,27,10,26,0,1,3,14,15,6,21,1,4,1,4,16,23,0.76
11020,"Darius Songaila\songada01","2010-11",32,"PHI","NBA",0,10,0,71,7,15,7,15,0,0,2,4,2,8,10,2,0,0,4,16,16,1.29
11021,"James Southerland\southja01","2013-14",23,"TOT","NBA",0,4,0,30,5,15,2,9,3,6,1,2,0,8,8,0,1,2,1,3,14,2.68
11022,"Elmore Spencer\spencel01","1996-97",27,"SEA","NBA",0,1,0,5,0,1,0,1,0,0,0,0,0,0,0,0,1,0,1,0,0,0.3
11023,"Jerry Stackhouse\stackje01","2010-11",36,"MIA","NBA",0,7,1,50,3,12,2,8,1,4,5,7,1,6,7,3,0,2,2,3,12,1.47
11024,"Matt Steigenga\steigma01","1996-97",26,"CHI","NBA",0,2,0,12,1,4,1,2,0,2,1,2,0,3,3,2,1,1,2,1,3,2.25
11025,"D.J. Stephens\stephdj01","2018-19",28,"MEM","NBA",0,1,0,7,1,2,1,2,0,0,0,0,0,0,0,0,1,0,1,0,2,2
11026,"D.J. Stephens\stephdj01","2013-14",23,"MIL","NBA",0,3,0,15,3,7,3,7,0,0,1,1,1,4,5,0,0,0,0,0,7,1.77
11027,"Joe Stephens\stephjo01","1997-98",25,"HOU","NBA",0,7,0,37,10,28,7,18,3,10,4,6,3,3,6,1,2,0,2,2,27,2.24
11028,"Joe Stephens\stephjo01","1999-00",27,"VAN","NBA",0,13,0,181,19,51,19,43,0,8,3,4,13,23,36,11,7,3,6,9,41,3.36
11029,"Barry Stevens\steveba01","1992-93",30,"GSW","NBA",0,2,0,6,1,2,1,2,0,0,0,0,2,0,2,0,0,0,0,1,2,0.9
11030,"Alex Stivrins\stivral01","1992-93",30,"TOT","NBA",0,19,0,76,19,39,19,37,0,2,3,4,7,12,19,3,2,2,7,11,41,1.79
11031,"David Stockton\stockda01","2014-15",23,"SAC","NBA",0,3,0,33,2,6,1,4,1,2,3,6,0,2,2,9,2,0,4,1,8,4.17
11032,"Ed Stokes\stokeed01","1997-98",26,"TOR","NBA",0,4,0,17,1,3,1,3,0,0,1,2,1,3,4,1,1,2,2,4,3,1.4
11033,"Awvee Storey\storeaw01","2004-05",27,"NJN","NBA",0,9,0,32,3,10,2,8,1,2,1,2,4,1,5,1,0,0,0,3,8,0.5
11034,"Mark Strickland\stricma01","1994-95",24,"IND","NBA",0,4,0,9,1,3,1,3,0,0,1,2,2,2,4,0,0,1,1,0,3,0.8
11035,"Mark Strickland\stricma01","2002-03",32,"DAL","NBA",0,4,0,13,2,5,2,5,0,0,0,0,5,2,7,0,0,0,1,1,4,1.02
11036,"Mark Strickland\stricma01","1996-97",26,"MIA","NBA",0,31,0,153,25,60,25,59,0,1,12,21,16,21,37,1,4,10,15,17,62,1.71
11037,"DaJuan Summers\summeda01","2009-10",22,"DET","NBA",0,44,0,405,46,130,31,88,15,42,27,38,14,31,45,16,8,7,16,52,134,2.25
11038,"DaJuan Summers\summeda01","2012-13",25,"LAC","NBA",0,2,0,7,1,4,1,4,0,0,0,0,0,2,2,1,0,0,0,0,2,0.55
11039,"Edmond Sumner\sumneed01","2017-18",22,"IND","NBA",0,1,0,2,1,1,1,1,0,0,0,0,0,1,1,0,0,0,0,1,2,2.1
11040,"Bruno Šundov\sundobr01","2003-04",23,"TOT","NBA",0,5,0,33,4,10,4,10,0,0,3,6,2,8,10,1,0,0,3,9,11,1.82
11041,"Bruno Šundov\sundobr01","2001-02",21,"IND","NBA",0,22,0,88,16,40,16,39,0,1,0,2,7,14,21,3,3,3,4,16,32,1.15
11042,"Caleb Swanigan\swanica01","2017-18",20,"POR","NBA",0,27,3,189,24,60,23,52,1,8,12,18,15,39,54,14,5,3,18,37,61,2.4
11043,"Robert Swift\swiftro01","2004-05",19,"SEA","NBA",0,16,0,72,5,11,5,11,0,0,5,9,1,4,5,2,1,7,4,16,15,1.06
11044,"Aaron Swinson\swinsaa01","1994-95",24,"PHO","NBA",0,9,0,51,10,18,10,18,0,0,4,5,3,5,8,3,1,0,5,8,24,2.37
11045,"Pape Sy\sypa01","2010-11",22,"ATL","NBA",0,3,0,21,2,6,2,5,0,1,3,3,2,1,3,2,1,0,3,1,7,2.4
11046,"Larry Sykes\sykesla01","1995-96",22,"BOS","NBA",0,1,0,2,0,0,0,0,0,0,0,0,1,1,2,0,0,0,1,0,0,0.8
11047,"Žan Tabak\tabakza01","1997-98",27,"TOT","NBA",0,57,34,984,142,304,142,303,0,1,23,61,84,128,212,48,20,38,61,163,307,5.28
11048,"Yuta Tabuse\tabusyu01","2004-05",24,"PHO","NBA",0,4,0,17,1,6,0,5,1,1,4,4,2,2,4,3,0,0,1,1,7,1.73
11049,"Isaiah Taylor\taylois01","2016-17",22,"HOU","NBA",0,4,0,52,1,7,1,5,0,2,1,2,1,2,3,3,1,1,0,6,3,0.78
11050,"Johnny Taylor\taylojo01","1999-00",25,"TOT","NBA",0,6,0,34,5,14,4,13,1,1,0,0,2,4,6,1,1,1,2,5,11,1.33
11051,"Terry Teagle\teaglte01","1992-93",32,"HOU","NBA",0,2,0,25,2,7,2,7,0,0,1,2,0,3,3,2,0,0,1,1,5,1.55
11052,"Hasheem Thabeet\thabeha01","2013-14",26,"OKC","NBA",0,23,0,192,13,23,13,23,0,0,1,5,9,31,40,1,4,9,14,47,27,1.8
11053,"Adonis Thomas\thomaad01","2013-14",20,"TOT","NBA",0,6,1,37,6,14,5,9,1,5,1,1,0,3,3,3,0,0,1,6,14,1.65
11054,"Carl Thomas\thomaca01","1996-97",27,"CLE","NBA",0,19,0,77,9,24,7,12,2,12,1,1,3,10,13,8,2,1,6,7,21,1.12
11055,"John Thomas\thomajo02","2005-06",30,"TOT","NBA",0,16,0,127,6,15,6,15,0,0,3,4,10,10,20,2,3,2,8,17,15,1.27
11056,"Khyri Thomas\thomakh01","2018-19",22,"DET","NBA",0,26,0,195,22,69,12,34,10,35,7,11,4,16,20,8,7,5,4,22,61,1.69
11057,"Malcolm Thomas\thomama01","2011-12",23,"SAS","NBA",0,3,0,15,0,3,0,3,0,0,1,2,1,2,3,1,1,1,0,0,1,0.7
11058,"Trey Thompkins\thomptr02","2011-12",21,"LAC","NBA",0,24,0,119,24,61,20,48,4,13,5,7,4,20,24,3,3,3,6,10,57,1.66
11059,"Kevin Thompson\thompke01","1993-94",22,"POR","NBA",0,14,0,58,6,14,6,13,0,1,1,2,7,6,13,3,0,2,5,11,13,0.99
11060,"LaSalle Thompson\thompla01","1993-94",32,"IND","NBA",0,30,1,282,27,77,27,77,0,0,16,30,26,49,75,16,10,8,23,59,70,2.6
11061,"Bob Thornton\thornbo01","1995-96",33,"WSB","NBA",0,7,0,31,1,6,1,6,0,0,1,2,6,6,12,0,1,0,1,7,3,0.66
11062,"Sindarius Thornwell\thornsi01","2018-19",24,"LAC","NBA",0,64,1,313,17,49,14,34,3,15,25,34,5,39,44,18,14,7,20,41,62,1.25
11063,"Mike Tobey\tobeymi01","2016-17",22,"CHO","NBA",0,2,0,25,1,4,1,4,0,0,0,0,2,1,3,1,0,0,1,2,2,0.75
11064,"Tom Tolbert\tolbeto01","1994-95",29,"CHH","NBA",0,10,0,57,6,18,6,14,0,4,2,2,7,10,17,2,0,0,3,9,14,1.2
11065,"Tom Tolbert\tolbeto01","1993-94",28,"LAC","NBA",0,49,6,640,74,177,68,161,6,16,33,45,36,72,108,30,13,15,39,61,187,3.58
11066,"Anthony Tolliver\tollian01","2008-09",23,"SAS","NBA",0,19,0,208,19,65,10,24,9,41,5,10,12,29,41,17,5,1,7,16,52,2.43
11067,"Andy Toolson\toolsan01","1995-96",30,"UTA","NBA",0,13,0,53,8,22,5,10,3,12,3,4,0,6,6,1,0,0,2,12,22,0.96
11068,"Keith Tower\towerke01","1993-94",23,"ORL","NBA",0,11,0,32,4,9,4,9,0,0,0,0,0,6,6,1,0,0,0,6,8,0.58
11069,"Keith Tower\towerke01","1994-95",24,"ORL","NBA",0,3,0,7,0,2,0,2,0,0,1,2,1,2,3,0,0,0,1,1,1,0.13
11070,"Nikoloz Tskitishvili\tskitni01","2005-06",22,"TOT","NBA",0,17,0,99,13,37,12,34,1,3,9,14,9,13,22,3,1,2,6,8,36,1.56
11071,"Alando Tucker\tuckeal02","2007-08",23,"PHO","NBA",0,6,0,48,8,22,7,18,1,4,5,6,4,4,8,0,0,1,0,2,22,2.22
11072,"Ronny Turiaf\turiaro01","2014-15",32,"MIN","NBA",0,2,0,19,0,0,0,0,0,0,0,0,0,1,1,2,0,0,0,0,0,0.9
11073,"Mirsad Türkcan\turkcmi01","1999-00",23,"TOT","NBA",0,17,0,90,14,38,14,32,0,6,5,8,13,20,33,5,3,1,8,14,33,1.84
11074,"Edwin Ubiles\ubileed01","2011-12",25,"WAS","NBA",0,4,0,52,5,18,4,13,1,5,3,3,2,8,10,1,1,1,1,1,14,2.45
11075,"Ekpe Udoh\udohek01","2013-14",26,"MIL","NBA",0,42,14,804,57,143,57,143,0,0,30,47,61,87,148,31,15,44,38,96,144,4.44
11076,"Ime Udoka\udokaim01","2005-06",28,"NYK","NBA",0,8,0,114,9,24,8,21,1,3,3,6,3,14,17,6,1,0,2,8,22,2.45
11077,"Ime Udoka\udokaim01","2010-11",33,"SAS","NBA",0,20,0,130,5,21,5,13,0,8,4,8,5,14,19,13,8,1,5,14,14,1.25
11078,"Ime Udoka\udokaim01","2003-04",26,"LAL","NBA",0,4,0,28,3,9,3,8,0,1,2,4,1,4,5,2,2,1,3,3,8,2.05
11079,"Tyler Ulis\ulisty01","2018-19",23,"CHI","NBA",0,1,0,1,0,0,0,0,0,0,0,0,0,0,0,0,0,0,0,0,0,0
11080,"David Vanterpool\vanteda01","2000-01",27,"WAS","NBA",0,22,0,411,46,110,46,104,0,6,30,50,15,22,37,66,23,3,37,44,122,6.43
11081,"Ratko Varda\vardara01","2001-02",22,"DET","NBA",0,1,0,6,2,3,2,3,0,0,1,1,0,1,1,0,0,0,1,3,5,4.1
11082,"Greivis Vásquez\vasqugr01","2016-17",30,"BRK","NBA",0,3,0,39,2,8,1,5,1,3,2,3,0,2,2,5,1,1,1,6,7,2.6
11083,"Jacque Vaughn\vaughja01","2003-04",28,"ATL","NBA",0,71,6,1271,107,277,104,257,3,20,53,68,12,104,116,195,44,2,84,126,270,4.81
11084,"Rashad Vaughn\vaughra01","2016-17",20,"MIL","NBA",0,41,2,458,57,156,31,75,26,81,2,5,4,45,49,23,19,10,14,32,142,2.83
11085,"Jake Voskuhl\voskuja01","2000-01",23,"CHI","NBA",0,16,2,143,11,25,11,25,0,0,8,14,12,22,34,5,5,6,12,38,30,2.55
11086,"Slavko Vraneš\vranesl01","2003-04",21,"POR","NBA",0,1,0,3,0,1,0,1,0,0,0,0,0,0,0,0,0,0,0,1,0,-0.7
11087,"Stojko Vranković\vrankst01","1998-99",35,"LAC","NBA",0,2,0,12,1,4,1,4,0,0,0,0,4,2,6,0,0,0,0,2,2,1
11088,"Von Wafer\wafervo01","2006-07",21,"LAC","NBA",0,1,0,1,0,1,0,0,0,1,0,0,0,0,0,0,0,0,0,0,0,-0.7
11089,"Dajuan Wagner\wagneda02","2006-07",23,"GSW","NBA",0,1,0,7,1,1,0,0,1,1,1,2,0,0,0,1,0,0,1,1,4,4
11090,"Lonnie Walker\walkelo01","2018-19",20,"SAS","NBA",0,17,0,118,16,46,11,33,5,13,8,10,0,17,17,9,7,3,4,7,45,2.39
11091,"Samaki Walker\walkesa01","2005-06",29,"IND","NBA",0,7,0,22,0,2,0,2,0,0,2,2,0,3,3,0,0,1,2,7,2,0.36
11092,"Matt Walsh\walshma01","2005-06",23,"MIA","NBA",0,2,0,3,1,1,1,1,0,0,0,2,0,0,0,0,0,0,1,0,2,0.45
11093,"Hakim Warrick\warriha01","2012-13",30,"TOT","NBA",0,28,14,489,67,165,67,162,0,3,60,88,21,68,89,25,13,6,29,37,194,5.87
11094,"Darius Washington\washida01","2007-08",22,"SAS","NBA",0,18,0,146,21,48,17,36,4,12,7,13,4,16,20,15,5,0,14,16,53,2.72
11095,"Earl Watson\watsoea01","2012-13",33,"UTA","NBA",0,48,4,829,37,120,32,92,5,28,17,25,23,64,87,190,40,8,69,94,96,4.94
11096,"Jamie Watson\watsoja01","1998-99",26,"MIA","NBA",0,3,0,18,1,2,1,2,0,0,0,0,0,1,1,1,0,0,1,1,2,0.7
11097,"David Wear\wearda01","2014-15",24,"SAC","NBA",0,2,0,7,0,2,0,1,0,1,0,0,2,0,2,1,0,0,0,1,0,0.05
11098,"Kyle Weaver\weaveky01","2010-11",24,"UTA","NBA",0,5,0,69,9,25,6,18,3,7,7,8,2,8,10,7,2,2,7,3,28,5.2
11099,"Briante Weber\weberbr01","2015-16",23,"TOT","NBA",0,7,4,169,14,39,14,34,0,5,3,4,8,17,25,21,9,3,9,12,31,6.39
11100,"Jeff Webster\webstje01","1995-96",24,"WSB","NBA",0,11,0,58,8,23,6,17,2,6,0,0,2,5,7,3,4,0,3,7,18,1.27
11101,"Martell Webster\webstma02","2008-09",22,"POR","NBA",0,1,0,5,0,1,0,0,0,1,0,0,0,0,0,0,0,0,0,0,0,-0.7
11102,"Martell Webster\webstma02","2014-15",28,"WAS","NBA",0,32,0,352,24,91,14,48,10,43,48,64,10,36,46,17,7,1,22,24,106,2.61
11103,"Robert Werdann\werdaro01","1996-97",26,"NJN","NBA",0,6,0,31,3,7,3,7,0,0,3,3,3,3,6,0,2,1,2,10,9,1.73
11104,"Mark West\westma01","1997-98",37,"IND","NBA",0,15,1,105,10,21,10,21,0,0,3,6,6,9,15,2,2,4,8,15,23,1.55
11105,"Robert Whaley\whalero01","2005-06",23,"UTA","NBA",0,23,0,212,23,57,23,57,0,0,3,6,16,27,43,17,7,8,14,41,49,2.56
11106,"Ennis Whatley\whatlen01","1996-97",34,"POR","NBA",0,3,0,22,2,4,2,4,0,0,0,0,0,3,3,3,0,0,1,5,4,1.77
11107,"D.J. White\whitedj01","2013-14",27,"CHA","NBA",0,2,0,10,0,1,0,1,0,0,0,0,0,2,2,0,1,0,0,1,0,0.55
11108,"James White\whiteja02","2008-09",26,"HOU","NBA",0,4,0,11,3,5,2,3,1,2,0,0,0,0,0,1,1,1,3,2,7,1.77
11109,"Okaro White\whiteok01","2018-19",26,"WAS","NBA",0,3,0,6,0,2,0,0,0,2,0,0,1,1,2,0,0,0,0,0,0,-0.2
11110,"Royce White\whitero03","2013-14",22,"SAC","NBA",0,3,0,9,0,1,0,1,0,0,0,0,0,0,0,0,0,0,0,2,0,-0.23
11111,"Donald Whiteside\whitedo01","1997-98",28,"ATL","NBA",0,3,0,16,1,2,1,1,0,1,0,2,0,1,1,1,0,0,1,0,2,0.43
11112,"Hassan Whiteside\whiteha01","2010-11",21,"SAC","NBA",0,1,0,2,0,0,0,0,0,0,0,0,0,0,0,0,0,0,0,2,0,0
11113,"Dwayne Whitfield\whitfdw01","1995-96",23,"TOR","NBA",0,8,1,122,13,30,13,30,0,0,14,22,9,16,25,2,3,2,8,14,40,4.6
11114,"Shayne Whittington\whittsh01","2015-16",24,"IND","NBA",0,7,0,41,5,11,5,9,0,2,1,2,5,7,12,3,1,1,5,7,11,1.93
11115,"C.J. Wilcox\wilcocj01","2014-15",24,"LAC","NBA",0,21,0,101,16,38,9,19,7,19,2,2,1,6,7,8,3,1,10,7,41,1.57
11116,"Damien Wilkins\wilkida02","2008-09",29,"OKC","NBA",0,41,14,636,77,213,50,141,27,72,37,46,20,50,70,37,22,7,37,55,218,4.31
11117,"Mike Wilks\wilksmi01","2009-10",30,"OKC","NBA",0,4,0,59,6,12,4,9,2,3,2,4,1,3,4,4,0,0,4,5,16,3.4
11118,"Alan Williams\willial03","2017-18",25,"PHO","NBA",0,5,0,70,7,18,7,18,0,0,6,9,3,19,22,8,5,1,7,13,20,5.82
11119,"Brandon Williams\willibr01","1998-99",23,"SAS","NBA",0,3,0,4,0,0,0,0,0,0,2,4,1,0,1,0,0,0,0,0,2,0.53
11120,"Corey Williams\willico01","1993-94",23,"MIN","NBA",0,4,0,46,5,13,5,12,0,1,1,1,1,5,6,6,2,0,2,6,11,3.12
11121,"Derrick Williams\willide02","2017-18",26,"LAL","NBA",0,2,0,9,1,4,1,2,0,2,0,0,0,1,1,0,0,0,0,0,2,0
11122,"Elliot Williams\williel01","2015-16",26,"MEM","NBA",0,5,0,45,2,10,1,6,1,4,3,4,1,3,4,4,0,0,1,2,8,1.16
11123,"Jawad Williams\willija04","2008-09",25,"CLE","NBA",0,10,0,20,5,12,3,6,2,6,0,0,1,1,2,0,1,0,1,2,12,0.74
11124,"Marcus Williams\willima04","2008-09",22,"SAS","NBA",0,2,0,3,2,2,2,2,0,0,0,0,0,0,0,0,0,0,0,1,4,1.7
11125,"Marcus Williams\willima03","2009-10",24,"MEM","NBA",0,62,1,872,104,271,80,190,24,81,37,55,13,80,93,161,32,1,74,43,269,4.78
11126,"Matt Williams\willima05","2017-18",24,"MIA","NBA",0,3,0,11,2,6,1,1,1,5,0,0,0,1,1,0,0,0,1,1,5,0.67
11127,"Micheal Williams\willimi02","1994-95",28,"MIN","NBA",0,1,1,28,1,4,1,4,0,0,4,5,0,1,1,3,2,0,3,3,6,7.7
11128,"Monty Williams\willimo01","1998-99",27,"DEN","NBA",0,1,0,6,0,2,0,2,0,0,1,2,0,0,0,0,0,0,0,0,1,-0.8
11129,"Reggie Williams\willire02","2013-14",27,"OKC","NBA",0,3,0,17,5,9,4,6,1,3,0,0,0,0,0,1,1,0,2,1,11,2.8
11130,"Shammond Williams\willish01","1998-99",23,"ATL","NBA",0,2,0,4,0,1,0,1,0,0,3,4,0,0,0,1,0,0,0,0,3,1.3
11131,"Shawne Williams\willish03","2008-09",22,"DAL","NBA",0,15,0,170,16,56,15,39,1,17,9,11,19,27,46,2,2,9,5,19,42,2.43
11132,"Travis Williams\willitr01","1998-99",29,"CHH","NBA",0,8,0,62,6,13,6,13,0,0,3,4,6,13,19,2,2,1,6,10,15,2.45
11133,"Kevin Willis\willike02","2004-05",42,"ATL","NBA",0,29,5,344,35,90,35,88,0,2,17,23,29,47,76,9,8,7,15,53,87,2.94
11134,"Kevin Willis\willike02","2006-07",44,"DAL","NBA",0,5,0,43,5,13,5,13,0,0,2,2,2,6,8,1,2,1,2,11,12,2.3
11135,"Kyle Wiltjer\wiltjky01","2016-17",24,"HOU","NBA",0,14,0,44,4,14,0,1,4,13,1,2,4,6,10,2,3,1,5,4,13,0.96
11136,"David Wingate\wingada01","1998-99",35,"NYK","NBA",0,20,0,92,7,16,7,16,0,0,0,0,3,5,8,5,4,0,6,10,14,0.82
11137,"Dontonio Wingfield\wingfdo01","1994-95",20,"SEA","NBA",0,20,0,81,18,51,16,39,2,12,8,10,11,19,30,3,5,3,8,15,46,1.9
11138,"Trevor Winter\wintetr01","1998-99",25,"MIN","NBA",0,1,0,5,0,0,0,0,0,0,0,0,1,2,3,0,0,0,0,5,0,1.2
11139,"Jeff Withey\witheje01","2017-18",27,"DAL","NBA",0,9,0,39,6,16,4,6,2,10,1,2,1,9,10,0,0,3,2,3,15,1.32
11140,"Joe Wolf\wolfjo01","1998-99",34,"CHH","NBA",0,3,0,12,0,1,0,1,0,0,0,2,0,1,1,0,0,0,0,6,0,-0.37
11141,"Rubén Wolkowyski\wolkoru01","2002-03",29,"BOS","NBA",0,7,0,24,2,4,2,3,0,1,1,4,0,1,1,1,0,0,1,3,5,0.41
11142,"Qyntel Woods\woodsqy01","2004-05",23,"MIA","NBA",0,3,0,40,5,12,5,12,0,0,0,0,2,4,6,0,4,0,2,6,10,3.33
11143,"Chris Wright\wrighch02","2012-13",23,"DAL","NBA",0,3,0,4,1,2,1,2,0,0,0,0,0,0,0,0,0,0,1,0,2,0.33
11144,"Howard Wright\wrighho02","1992-93",25,"ORL","NBA",0,4,0,10,4,5,4,5,0,0,0,2,1,1,2,0,0,0,0,0,8,1.52
11145,"Lorenzen Wright\wrighlo02","2007-08",32,"TOT","NBA",0,18,1,161,6,21,6,21,0,0,3,6,8,30,38,4,3,3,4,31,15,1.37
11146,"Sharone Wright\wrighsh01","1997-98",25,"TOR","NBA",0,7,0,44,7,14,7,14,0,0,2,4,1,8,9,4,0,0,2,7,16,2.09
11147,"Nick Young\youngni01","2018-19",33,"DEN","NBA",0,4,0,37,3,9,0,1,3,8,0,0,0,1,1,2,0,1,2,4,9,1.6
11148,"George Zídek\zidekge01","1997-98",24,"TOT","NBA",0,12,0,64,7,29,6,27,1,2,14,16,4,13,17,2,0,2,4,10,29,1.69
11149,"Derrick Zimmerman\zimmede01","2005-06",24,"NJN","NBA",0,2,0,32,2,3,2,3,0,0,0,0,1,3,4,7,0,0,4,4,4,4.6
11150,"Stephen Zimmerman\zimmest01","2016-17",20,"ORL","NBA",0,19,0,108,10,31,10,31,0,0,3,5,11,24,35,4,2,5,3,17,23,1.41
11151,"Alaa Abdelnaby\abdelal01","1993-94",25,"BOS","NBA",-0.1,13,0,159,24,55,24,55,0,0,16,25,12,34,46,3,2,3,17,20,64,4.32
11152,"Quincy Acy\acyqu01","2018-19",28,"PHO","NBA",-0.1,10,0,123,4,18,2,3,2,15,7,10,3,22,25,8,1,4,4,24,17,2.42
11153,"Alexis Ajinça\ajincal01","2008-09",20,"CHA","NBA",-0.1,31,4,182,25,69,25,67,0,2,20,28,9,21,30,3,7,6,12,34,70,1.74
11154,"Cory Alexander\alexaco01","1999-00",26,"DEN","NBA",-0.1,29,2,329,28,98,19,63,9,35,17,22,8,34,42,58,24,2,28,39,82,3.63
11155,"Cory Alexander\alexaco01","2000-01",27,"ORL","NBA",-0.1,26,0,227,18,56,14,40,4,16,12,18,0,25,25,36,16,0,25,29,52,2.65
11156,"Victor Alexander\alexavi01","2001-02",32,"DET","NBA",-0.1,15,0,97,18,51,18,49,0,2,4,8,7,22,29,6,0,1,5,6,40,1.76
11157,"Rawle Alkins\alkinra01","2018-19",21,"CHI","NBA",-0.1,10,1,120,13,39,10,27,3,12,8,12,11,15,26,13,1,0,8,7,37,3.38
11158,"Kadeem Allen\allenka01","2017-18",25,"BOS","NBA",-0.1,18,1,107,6,22,6,11,0,11,7,9,4,7,11,12,3,2,9,15,19,1.24
11159,"Morris Almond\almonmo01","2007-08",22,"UTA","NBA",-0.1,9,0,39,4,15,3,11,1,4,4,6,0,2,2,3,1,0,2,5,13,0.8
11160,"Derrick Alston\alstode01","1996-97",24,"ATL","NBA",-0.1,2,0,11,0,5,0,5,0,0,0,2,3,1,4,0,0,0,0,0,0,-1.35
11161,"Lou Amundson\amundlo01","2015-16",33,"NYK","NBA",-0.1,29,0,204,19,53,19,53,0,0,14,27,23,26,49,12,6,7,15,44,52,1.94
11162,"Willie Anderson\anderwi01","1992-93",26,"SAS","NBA",-0.1,38,7,560,80,186,79,178,1,8,22,28,7,50,57,79,14,6,44,52,183,4.7
11163,"Ike Anigbogu\anigbik01","2018-19",20,"IND","NBA",-0.1,3,0,6,0,3,0,3,0,0,0,0,1,2,3,1,0,1,1,0,0,0.17
11164,"Kostas Antetokounmpo\antetko01","2018-19",21,"DAL","NBA",-0.1,2,0,11,0,3,0,3,0,0,2,4,0,1,1,0,2,0,1,0,2,0.75
11165,"Keith Appling\applike01","2015-16",23,"ORL","NBA",-0.1,5,0,27,2,8,2,5,0,3,2,2,0,1,1,1,1,0,3,5,6,0.66
11166,"Brandon Armstrong\armstbr01","2002-03",22,"NJN","NBA",-0.1,17,0,69,9,27,8,21,1,6,5,6,0,4,4,2,3,1,5,8,24,0.88
11167,"Hilton Armstrong\armsthi01","2009-10",25,"TOT","NBA",-0.1,33,0,335,28,79,28,78,0,1,15,32,27,54,81,21,15,12,22,59,71,2.75
11168,"Ömer Aşık\asikom01","2017-18",31,"TOT","NBA",-0.1,18,0,182,9,22,9,22,0,0,4,13,9,38,47,3,2,4,9,20,22,1.79
11169,"Anthony Avent\aventan01","1998-99",29,"UTA","NBA",-0.1,5,0,44,4,13,4,13,0,0,1,2,8,4,12,1,2,0,7,6,9,1.72
11170,"Kelenna Azubuike\azubuke01","2011-12",28,"DAL","NBA",-0.1,3,0,18,3,8,2,5,1,3,0,0,0,0,0,0,1,0,4,1,7,1.2
11171,"Dwayne Bacon\bacondw01","2017-18",22,"CHO","NBA",-0.1,53,6,713,72,192,61,149,11,43,20,25,4,120,124,38,16,2,23,46,175,3.04
11172,"Dalibor Bagarić\bagarda01","2001-02",21,"CHI","NBA",-0.1,50,0,638,72,178,72,177,0,1,41,70,55,107,162,23,17,24,46,108,185,3.85
11173,"Dalibor Bagarić\bagarda01","2002-03",22,"CHI","NBA",-0.1,10,0,76,8,26,8,26,0,0,3,4,7,13,20,4,3,3,5,11,19,1.95
11174,"Cameron Bairstow\bairsca01","2014-15",24,"CHI","NBA",-0.1,18,1,64,3,14,3,14,0,0,4,5,6,2,8,1,2,1,3,8,10,0.42
11175,"LaMark Baker\bakerla01","1998-99",29,"TOR","NBA",-0.1,1,0,2,0,1,0,1,0,0,0,0,0,0,0,0,0,0,1,0,0,-0.7
11176,"Ron Baker\bakerro01","2018-19",25,"TOT","NBA",-0.1,15,0,152,4,20,3,7,1,13,5,6,1,10,11,15,6,1,5,18,14,1.52
11177,"Ron Baker\bakerro01","2016-17",23,"NYK","NBA",-0.1,52,13,857,82,217,59,131,23,86,28,43,12,86,98,107,34,8,56,74,215,4.68
11178,"Erick Barkley\barkler01","2000-01",22,"POR","NBA",-0.1,8,0,38,8,22,5,14,3,8,0,0,0,3,3,6,2,0,5,2,19,1.77
11179,"Andre Barrett\barrean01","2005-06",23,"TOT","NBA",-0.1,19,0,282,38,104,36,90,2,14,9,12,9,16,25,52,10,0,15,13,87,4.45
11180,"Jon Barry\barryjo01","1992-93",23,"MIL","NBA",-0.1,47,0,552,76,206,55,143,21,63,33,49,10,33,43,68,35,3,42,57,206,3.99
11181,"Jerryd Bayless\bayleje01","2016-17",28,"PHI","NBA",-0.1,3,1,71,11,32,9,27,2,5,9,10,3,9,12,13,0,0,9,4,33,9.5
11182,"Michael Beasley\beaslmi01","2014-15",26,"MIA","NBA",-0.1,24,1,505,92,212,84,178,8,34,20,26,12,77,89,32,15,13,37,66,212,7.5
11183,"Corey Beck\beckco01","1995-96",24,"CHH","NBA",-0.1,5,0,33,2,8,2,8,0,0,1,2,3,4,7,5,1,0,4,8,5,1.42
11184,"William Bedford\bedfowi01","1992-93",29,"SAS","NBA",-0.1,16,0,66,9,27,8,26,1,1,6,12,1,9,10,0,0,1,1,15,25,0.75
11185,"Charlie Bell\bellch01","2010-11",31,"GSW","NBA",-0.1,19,0,171,12,43,6,22,6,21,2,4,6,12,18,13,6,1,6,13,32,1.52
11186,"Raja Bell\bellra01","2000-01",24,"PHI","NBA",-0.1,5,0,30,2,7,1,4,1,3,0,0,0,1,1,0,1,0,2,1,5,0.46
11187,"Jonathan Bender\bendejo01","2000-01",20,"IND","NBA",-0.1,59,7,574,66,186,55,145,11,41,50,68,14,60,74,32,7,28,42,73,193,2.72
11188,"Benoit Benjamin\benjabe01","1998-99",34,"PHI","NBA",-0.1,6,0,33,2,7,2,7,0,0,0,0,3,5,8,1,0,0,3,6,4,0.63
11189,"Elmer Bennett\benneel01","1996-97",26,"TOT","NBA",-0.1,9,0,75,6,19,3,10,3,9,7,10,0,4,4,11,4,0,10,7,22,2.58
11190,"Mario Bennett\bennema01","1999-00",26,"LAC","NBA",-0.1,1,0,3,0,3,0,3,0,0,0,0,1,1,2,0,0,0,0,1,0,-1.3
11191,"Ben Bentil\bentibe01","2016-17",21,"DAL","NBA",-0.1,3,0,10,0,3,0,2,0,1,0,0,0,2,2,0,0,0,1,1,0,-0.43
11192,"DeJuan Blair\blairde01","2015-16",26,"WAS","NBA",-0.1,29,0,218,28,68,28,67,0,1,5,13,20,37,57,11,8,2,15,53,61,2.11
11193,"Will Blalock\blalowi01","2006-07",23,"DET","NBA",-0.1,14,0,166,9,30,8,25,1,5,6,6,6,9,15,17,5,0,12,9,25,2.18
11194,"Andray Blatche\blatcan01","2011-12",25,"WAS","NBA",-0.1,26,13,626,93,245,91,238,2,7,33,49,42,108,150,28,20,17,37,54,221,7.38
11195,"Mookie Blaylock\blaylmo01","2001-02",34,"GSW","NBA",-0.1,35,0,599,50,146,35,104,15,42,4,8,8,44,52,114,24,4,37,20,119,4.65
11196,"Mark Blount\blounma01","2008-09",33,"MIA","NBA",-0.1,20,0,207,30,78,19,51,11,27,8,13,10,31,41,4,1,7,14,17,79,2.98
11197,"Vander Blue\blueva01","2017-18",25,"LAL","NBA",-0.1,5,0,45,1,5,1,3,0,2,1,2,0,1,1,3,1,0,3,2,3,0.6
11198,"Vander Blue\blueva01","2013-14",21,"BOS","NBA",-0.1,3,0,15,2,4,2,3,0,1,1,5,0,3,3,1,0,0,2,1,5,1.1
11199,"Muggsy Bogues\boguemu01","2000-01",36,"TOR","NBA",-0.1,3,0,34,0,2,0,1,0,1,0,0,0,3,3,5,2,0,4,3,0,1.77
11200,"Etdrick Bohannon\bohanet01","1997-98",24,"IND","NBA",-0.1,5,0,11,0,4,0,4,0,0,0,0,2,4,6,1,0,2,3,3,0,0.34
11201,"Isaac Bonga\bongais01","2018-19",19,"LAL","NBA",-0.1,22,0,120,5,33,5,25,0,8,9,15,9,16,25,15,9,4,6,9,19,1.26
11202,"Craig Brackins\brackcr01","2011-12",24,"PHI","NBA",-0.1,14,1,88,9,33,6,24,3,9,1,2,5,10,15,8,0,1,4,6,22,1.03
11203,"Craig Brackins\brackcr01","2010-11",23,"PHI","NBA",-0.1,3,0,33,4,16,4,11,0,5,0,0,2,2,4,1,1,0,0,3,8,0.57
11204,"Frank Brickowski\brickfr01","1996-97",37,"BOS","NBA",-0.1,17,2,255,32,73,25,53,7,20,10,14,6,28,34,15,5,4,19,42,81,4.29
11205,"Andre Brown\brownan01","2008-09",27,"CHA","NBA",-0.1,4,0,41,1,7,1,7,0,0,2,2,7,5,12,1,1,0,5,9,4,1.5
11206,"Damone Brown\brownda02","2003-04",24,"NJN","NBA",-0.1,3,0,17,1,10,1,10,0,0,1,2,3,2,5,0,2,0,1,2,3,0
11207,"Damone Brown\brownda02","2001-02",22,"PHI","NBA",-0.1,17,0,67,8,21,8,20,0,1,7,8,2,2,4,2,1,1,9,11,23,0.93
11208,"Dee Brown\brownde03","2008-09",24,"TOT","NBA",-0.1,19,11,261,18,49,11,25,7,24,3,5,7,22,29,36,10,0,17,28,46,3.42
11209,"Devin Brown\brownde02","2002-03",24,"TOT","NBA",-0.1,10,2,93,12,35,12,34,0,1,6,8,8,10,18,7,4,1,9,14,30,2.63
11210,"Kwame Brown\brownkw01","2009-10",27,"DET","NBA",-0.1,48,1,660,62,124,62,123,0,1,33,98,53,124,177,22,15,12,43,93,157,3.72
11211,"Lorenzo Brown\brownlo01","2018-19",28,"TOR","NBA",-0.1,26,0,212,23,71,17,43,6,28,3,3,5,26,31,28,12,5,16,22,55,2.38
11212,"Marcus Brown\brownma01","1999-00",25,"DET","NBA",-0.1,6,0,45,4,14,4,7,0,7,2,2,3,4,7,3,0,0,3,8,10,1.12
11213,"Rick Brunson\brunsri01","1999-00",27,"NYK","NBA",-0.1,37,0,289,29,70,27,57,2,13,11,18,3,24,27,49,9,1,31,35,71,2.31
11214,"Rick Brunson\brunsri01","2005-06",33,"TOT","NBA",-0.1,27,0,246,21,54,16,41,5,13,7,12,1,21,22,35,8,1,22,22,54,2.39
11215,"Mark Bryant\bryanma01","2002-03",37,"TOT","NBA",-0.1,16,0,100,5,19,5,19,0,0,3,4,8,12,20,4,1,1,7,18,13,0.86
11216,"Willie Burton\burtowi01","1998-99",30,"CHH","NBA",-0.1,3,0,18,1,7,1,6,0,1,2,4,4,2,6,0,0,0,1,2,4,0.37
11217,"Rasual Butler\butlera01","2010-11",31,"TOT","NBA",-0.1,47,2,770,79,237,33,101,46,136,18,27,10,67,77,27,8,15,24,37,222,3.24
11218,"Will Bynum\bynumwi01","2005-06",23,"GSW","NBA",-0.1,15,0,162,21,52,19,43,2,9,10,16,3,9,12,19,7,0,14,10,54,3.25
11219,"Bruno Caboclo\cabocbr01","2014-15",19,"TOR","NBA",-0.1,8,0,23,4,12,2,9,2,3,0,0,1,1,2,0,0,1,4,3,10,0.59
11220,"Matt Carroll\carroma01","2009-10",29,"DAL","NBA",-0.1,25,0,121,18,50,14,31,4,19,6,6,4,8,12,6,5,0,7,13,46,1.29
11221,"Matt Carroll\carroma01","2008-09",28,"TOT","NBA",-0.1,55,10,616,65,171,52,118,13,53,21,25,7,62,69,27,21,6,33,67,164,2.55
11222,"Anthony Carter\cartean01","2006-07",31,"DEN","NBA",-0.1,2,0,37,3,8,3,6,0,2,0,0,0,3,3,11,0,1,6,4,6,5.6
11223,"John Celestand\celesjo01","1999-00",22,"LAL","NBA",-0.1,16,0,185,15,45,13,36,2,9,5,6,1,10,11,20,7,0,16,22,37,2.28
11224,"Wilson Chandler\chandwi01","2011-12",24,"DEN","NBA",-0.1,8,6,215,31,79,28,67,3,12,10,12,6,35,41,17,6,6,18,18,75,8.73
11225,"Calbert Cheaney\cheanca01","2000-01",29,"DEN","NBA",-0.1,9,5,153,10,30,10,30,0,0,1,2,5,15,20,9,4,2,5,14,21,2.59
11226,"Doug Christie\chrisdo01","2006-07",36,"LAC","NBA",-0.1,7,0,82,5,17,4,11,1,6,2,3,3,8,11,8,3,1,5,11,13,2.34
11227,"Patrick Christopher\chrispa01","2014-15",26,"UTA","NBA",-0.1,4,1,29,3,12,3,8,0,4,0,0,2,4,6,0,1,0,1,6,6,0.55
11228,"Robert Churchwell\churcro01","1995-96",23,"GSW","NBA",-0.1,4,0,20,3,8,3,8,0,0,0,0,0,3,3,1,0,0,2,1,6,0.88
11229,"Earl Clark\clarkea01","2014-15",27,"BRK","NBA",-0.1,10,0,93,11,30,7,16,4,14,1,4,1,22,23,3,3,4,6,12,27,2.63
11230,"Ian Clark\clarkia01","2018-19",27,"NOP","NBA",-0.1,60,6,973,151,383,85,181,66,202,33,37,13,76,89,94,22,8,58,95,401,5.35
11231,"Ian Clark\clarkia01","2013-14",22,"UTA","NBA",-0.1,23,0,172,26,67,15,36,11,31,5,7,3,16,19,15,8,2,14,24,68,2.53
11232,"Victor Claver\clavevi01","2012-13",24,"POR","NBA",-0.1,49,16,812,74,189,49,102,25,87,14,30,31,88,119,43,26,12,43,75,187,3.88
11233,"Mateen Cleaves\cleavma01","2000-01",23,"DET","NBA",-0.1,78,8,1268,160,400,155,383,5,17,97,137,26,106,132,207,49,1,139,153,422,5.61
11234,"John Coker\cokerjo01","2000-01",29,"GSW","NBA",-0.1,6,0,32,1,8,1,8,0,0,0,0,3,2,5,2,1,0,2,4,2,0.2
11235,"Norris Cole\coleno01","2015-16",27,"NOP","NBA",-0.1,45,23,1198,196,484,163,382,33,102,52,65,10,141,151,167,37,5,75,102,477,9.54
11236,"Norris Cole\coleno01","2016-17",28,"OKC","NBA",-0.1,13,0,125,16,52,13,39,3,13,8,10,0,11,11,14,8,0,7,18,43,2.65
11237,"Derrick Coleman\colemde01","2004-05",37,"DET","NBA",-0.1,5,0,50,3,14,3,12,0,2,3,3,3,12,15,0,0,0,2,6,9,1.28
11238,"Bimbo Coles\colesbi01","2003-04",35,"MIA","NBA",-0.1,22,1,170,12,34,12,34,0,0,4,6,2,8,10,15,3,0,9,27,28,1.17
11239,"Jarron Collins\collija03","2010-11",32,"TOT","NBA",-0.1,28,0,181,6,21,6,21,0,0,7,10,14,10,24,2,4,1,7,29,19,0.76
11240,"Jason Collins\collija04","2009-10",31,"ATL","NBA",-0.1,24,0,115,8,23,8,22,0,1,0,2,5,9,14,4,3,2,5,21,16,0.63
11241,"Mardy Collins\collima01","2008-09",24,"TOT","NBA",-0.1,48,14,890,105,247,92,216,13,31,28,46,31,76,107,111,31,10,58,80,251,5.65
11242,"Sean Colson\colsose01","2000-01",25,"TOT","NBA",-0.1,13,0,44,6,24,5,19,1,5,2,4,2,4,6,10,1,0,2,6,15,0.78
11243,"Marty Conlon\conloma01","1998-99",31,"MIA","NBA",-0.1,7,0,35,3,13,3,13,0,0,2,2,1,4,5,1,0,1,3,6,8,0.5
11244,"Will Conroy\conrowi01","2006-07",24,"TOT","NBA",-0.1,7,0,52,0,3,0,3,0,0,0,4,3,4,7,9,0,0,2,7,0,0.77
11245,"Will Conroy\conrowi01","2009-10",27,"HOU","NBA",-0.1,5,0,36,3,10,3,7,0,3,0,2,0,3,3,7,0,0,4,5,6,1.1
11246,"Brian Cook\cookbr01","2011-12",31,"TOT","NBA",-0.1,32,0,276,31,98,21,48,10,50,9,10,10,53,63,10,6,5,11,48,81,2.07
11247,"Duane Cooper\coopedu01","1993-94",24,"PHO","NBA",-0.1,23,2,136,18,41,17,34,1,7,11,15,2,7,9,28,3,0,20,12,48,2.22
11248,"Chris Copeland\copelch01","2014-15",30,"IND","NBA",-0.1,50,12,828,112,310,60,143,52,167,33,45,23,88,111,51,11,11,59,78,309,4.62
11249,"Chris Copeland\copelch01","2015-16",31,"MIL","NBA",-0.1,24,1,156,17,51,7,15,10,36,6,7,1,9,10,11,2,0,6,17,50,1.43
11250,"Bryce Cotton\cottobr01","2015-16",23,"TOT","NBA",-0.1,8,0,39,4,10,4,7,0,3,0,0,0,0,0,3,3,0,5,2,8,0.96
11251,"James Cotton\cottoja02","1997-98",22,"SEA","NBA",-0.1,9,0,33,8,21,8,17,0,4,8,9,2,4,6,0,1,1,6,3,24,1.8
11252,"Joe Courtney\courtjo01","1996-97",27,"TOT","NBA",-0.1,9,0,100,11,30,11,30,0,0,3,5,9,7,16,0,0,0,3,14,25,1.56
11253,"John Crotty\crottjo01","1997-98",28,"POR","NBA",-0.1,26,2,379,29,90,23,70,6,20,32,34,4,28,32,63,10,1,42,28,96,4.28
11254,"Corey Crowder\crowdco01","1994-95",25,"SAS","NBA",-0.1,7,0,29,2,10,2,6,0,4,2,6,1,2,3,1,1,0,2,1,6,0.16
11255,"Eddy Curry\curryed01","2011-12",29,"MIA","NBA",-0.1,14,1,83,12,26,12,26,0,0,6,8,4,8,12,1,0,2,10,17,30,1.62
11256,"Eddy Curry\curryed01","2012-13",30,"DAL","NBA",-0.1,2,0,25,4,8,4,8,0,0,1,4,2,2,4,0,0,0,3,7,9,2.7
11257,"Rastko Cvetković\cvetkra01","1995-96",25,"DEN","NBA",-0.1,14,0,48,5,16,5,15,0,1,0,4,4,7,11,3,2,1,3,11,10,0.6
11258,"Erick Dampier\dampier01","1999-00",24,"GSW","NBA",-0.1,21,12,495,70,173,70,173,0,0,27,51,48,86,134,19,8,15,29,75,167,7.13
11259,"Erik Daniels\danieer01","2004-05",22,"SAC","NBA",-0.1,21,0,72,6,18,5,16,1,2,0,0,7,11,18,4,2,0,6,7,13,0.7
11260,"Yinka Dare\dareyi01","1996-97",24,"NJN","NBA",-0.1,41,2,313,19,54,19,54,0,0,19,37,35,47,82,3,4,28,21,51,57,1.9
11261,"Yinka Dare\dareyi01","1997-98",25,"NJN","NBA",-0.1,10,0,60,4,18,4,18,0,0,4,8,10,7,17,1,0,2,2,9,12,0.83
11262,"Luigi Datome\datomlu01","2013-14",26,"DET","NBA",-0.1,34,0,238,34,97,27,58,7,39,8,10,14,32,46,11,6,1,11,20,83,1.79
11263,"Jermareo Davidson\davidje01","2007-08",23,"CHA","NBA",-0.1,38,2,322,51,125,51,125,0,0,18,28,21,41,62,13,7,15,17,46,120,2.64
11264,"Emanual Davis\davisem01","2002-03",34,"ATL","NBA",-0.1,24,1,340,32,88,25,59,7,29,17,22,5,38,43,36,12,2,25,28,88,3.88
11265,"Hubert Davis\davishu01","2003-04",33,"TOT","NBA",-0.1,17,0,78,1,11,1,10,0,1,2,2,2,6,8,4,2,0,3,12,4,0.28
11266,"Mark Davis\davisma02","1999-00",26,"GSW","NBA",-0.1,23,7,464,56,137,56,135,0,2,31,47,31,53,84,38,25,4,40,52,143,6.57
11267,"Mark Davis\davisma02","1995-96",22,"MIN","NBA",-0.1,57,0,571,55,149,51,136,4,13,74,116,56,69,125,47,40,22,68,92,188,3.99
11268,"Mark Davis\davisma02","1998-99",25,"MIA","NBA",-0.1,4,1,35,2,6,2,6,0,0,5,6,2,5,7,1,1,0,7,12,9,2.43
11269,"Terry Davis\daviste01","1992-93",25,"DAL","NBA",-0.1,75,74,2462,393,863,391,855,2,8,167,281,259,442,701,68,36,28,160,199,955,11.28
11270,"Andre Dawkins\dawkian01","2014-15",23,"MIA","NBA",-0.1,4,0,22,1,6,0,0,1,6,0,0,0,2,2,1,0,0,1,3,3,0.18
11271,"Justin Dentmon\dentmju01","2011-12",26,"TOT","NBA",-0.1,6,0,91,10,28,8,14,2,14,4,6,0,8,8,10,2,0,7,10,26,3.63
11272,"Yakhouba Diawara\diawaya01","2009-10",27,"MIA","NBA",-0.1,6,2,44,2,10,1,4,1,6,0,0,1,3,4,3,1,0,3,8,5,0.58
11273,"Michael Dickerson\dickemi01","2001-02",26,"MEM","NBA",-0.1,4,4,124,15,48,7,27,8,21,5,6,3,9,12,9,3,1,8,12,43,7.45
11274,"DeSagana Diop\diopde01","2012-13",31,"CHA","NBA",-0.1,22,1,226,8,27,8,26,0,1,0,1,10,41,51,13,5,16,8,19,16,2.07
11275,"DeSagana Diop\diopde01","2010-11",29,"CHA","NBA",-0.1,16,0,181,8,24,8,24,0,0,4,11,12,28,40,7,4,15,11,26,20,2.44
11276,"Sherman Douglas\douglsh01","1998-99",32,"LAC","NBA",-0.1,30,19,842,96,219,96,208,0,11,55,87,16,42,58,124,27,3,61,54,247,8.61
11277,"Zabian Dowdell\dowdeza01","2010-11",26,"PHO","NBA",-0.1,24,0,292,51,125,48,115,3,10,16,17,5,15,20,51,20,2,29,30,121,4.94
11278,"Milton Doyle\doylemi01","2017-18",24,"BRK","NBA",-0.1,10,0,125,13,47,9,24,4,23,4,8,3,15,18,10,6,2,2,13,34,2.63
11279,"Zoran Dragić\dragizo01","2014-15",25,"TOT","NBA",-0.1,16,1,75,11,30,8,16,3,14,3,5,5,3,8,5,2,0,5,6,28,1.21
11280,"Bryce Drew\drewbr01","1998-99",24,"HOU","NBA",-0.1,34,0,441,47,129,31,80,16,49,8,8,3,29,32,52,12,4,31,61,118,3.25
11281,"Larry Drew\drewla02","2017-18",27,"TOT","NBA",-0.1,10,0,70,7,24,4,15,3,9,0,0,3,0,3,10,0,0,3,6,17,1.12
11282,"Kevin Duckworth\duckwke01","1995-96",31,"MIL","NBA",-0.1,8,1,58,3,14,3,14,0,0,3,6,2,5,7,2,2,0,2,19,9,0.68
11283,"Devin Ebanks\ebankde01","2012-13",23,"LAL","NBA",-0.1,19,3,197,24,73,18,51,6,22,11,14,10,31,41,10,3,1,11,23,65,2.6
11284,"Blue Edwards\edwarbl01","1996-97",31,"VAN","NBA",-0.1,61,12,1439,182,458,157,369,25,89,89,109,49,140,189,114,38,20,81,135,478,7.04
11285,"John Edwards\edwarjo01","2004-05",23,"IND","NBA",-0.1,25,1,139,11,30,11,30,0,0,7,14,8,11,19,3,3,4,8,12,29,1
11286,"Kevin Edwards\edwarke01","2000-01",35,"VAN","NBA",-0.1,46,5,634,56,170,51,151,5,19,43,53,23,59,82,52,29,8,37,46,160,3.55
11287,"LeRon Ellis\ellisle02","1995-96",26,"MIA","NBA",-0.1,12,1,74,5,22,5,22,0,0,3,6,5,3,8,4,2,3,3,11,13,0.71
11288,"Melvin Ely\elyme01","2008-09",30,"NOH","NBA",-0.1,31,4,373,37,95,37,95,0,0,23,36,30,34,64,18,2,9,23,58,97,2.79
11289,"Jo Jo English\englijo01","1992-93",22,"CHI","NBA",-0.1,6,0,31,3,10,3,7,0,3,0,2,2,4,6,1,3,2,4,5,6,1.15
11290,"Jacob Evans\evansja02","2018-19",21,"GSW","NBA",-0.1,30,1,204,18,53,14,38,4,15,0,1,6,19,25,23,5,3,11,28,40,1.43
11291,"Patrick Ewing\ewingpa02","2010-11",26,"NOH","NBA",-0.1,7,0,19,0,5,0,3,0,2,3,4,1,1,2,2,0,1,1,1,3,0.29
11292,"Dante Exum\exumda01","2014-15",19,"UTA","NBA",-0.1,82,41,1817,145,416,62,152,83,264,20,32,27,104,131,198,41,14,118,147,393,4.84
11293,"Christian Eyenga\eyengch01","2011-12",22,"TOT","NBA",-0.1,7,0,102,6,25,5,22,1,3,4,8,4,10,14,5,3,5,3,7,17,2.27
11294,"Desmon Farmer\farmede01","2008-09",27,"SAS","NBA",-0.1,3,0,54,4,14,1,2,3,12,2,2,0,6,6,2,0,0,4,6,13,2.87
11295,"Jim Farmer\farmeji01","1993-94",29,"DEN","NBA",-0.1,4,0,29,2,6,2,4,0,2,0,0,0,2,2,4,0,0,5,3,4,1.05
11296,"Kyrylo Fesenko\fesenky01","2010-11",24,"UTA","NBA",-0.1,53,1,456,44,100,44,99,0,1,18,46,34,74,108,18,4,16,25,90,106,2.14
11297,"Jeff Foote\footeje01","2011-12",24,"NOH","NBA",-0.1,4,0,39,2,6,2,6,0,0,0,0,1,5,6,0,0,1,2,5,4,0.93
11298,"Alton Ford\fordal02","2002-03",21,"PHO","NBA",-0.1,11,0,31,3,9,3,9,0,0,1,3,0,6,6,1,0,0,2,7,7,0.38
11299,"Joseph Forte\fortejo01","2001-02",20,"BOS","NBA",-0.1,8,0,39,1,12,1,9,0,3,4,4,1,5,6,6,2,0,3,1,6,0.83
11300,"Adonal Foyle\foylead01","1997-98",22,"GSW","NBA",-0.1,55,1,656,69,170,69,169,0,1,27,62,73,111,184,14,13,52,50,94,165,3.5
11301,"Melvin Frazier\frazime01","2018-19",22,"ORL","NBA",-0.1,10,0,44,7,21,7,15,0,6,1,4,3,2,5,1,1,0,1,6,15,0.56
11302,"Tim Frazier\fraziti01","2014-15",24,"TOT","NBA",-0.1,11,3,239,21,61,16,44,5,17,10,21,6,22,28,60,8,0,25,26,57,7.23
11303,"Matt Freije\freijma01","2006-07",25,"ATL","NBA",-0.1,19,0,147,16,54,13,32,3,22,5,6,8,16,24,7,3,1,3,13,40,1.39
11304,"Hiram Fuller\fullehi01","2003-04",22,"ATL","NBA",-0.1,4,0,43,3,8,3,8,0,0,2,6,4,7,11,2,0,1,4,5,8,2.12
11305,"Reece Gaines\gainere01","2004-05",24,"TOT","NBA",-0.1,21,0,187,17,50,13,36,4,14,3,4,1,13,14,7,5,1,7,17,41,1.36
11306,"Sundiata Gaines\gainesu01","2010-11",24,"TOT","NBA",-0.1,24,0,301,42,105,33,67,9,38,18,36,13,25,38,42,16,1,27,25,111,4.52
11307,"Alex Garcia\garcial01","2004-05",24,"NOH","NBA",-0.1,8,3,146,18,52,13,34,5,18,3,4,7,8,15,18,4,1,8,15,44,4.71
11308,"Alex Garcia\garcial01","2003-04",23,"SAS","NBA",-0.1,2,0,13,1,7,1,7,0,0,1,2,0,0,0,0,2,0,1,0,3,0.05
11309,"Thomas Gardner\gardnth01","2007-08",22,"CHI","NBA",-0.1,4,0,45,9,23,6,11,3,12,0,2,3,1,4,1,0,0,4,4,21,2.5
11310,"Dean Garrett\garrede01","2001-02",35,"TOT","NBA",-0.1,34,0,183,18,55,18,55,0,0,0,3,16,41,57,5,7,10,10,32,36,1.29
11311,"Kiwane Garris\garriki01","1999-00",25,"ORL","NBA",-0.1,3,0,23,2,10,2,9,0,1,0,0,0,1,1,2,0,0,1,0,4,-0.13
11312,"Kiwane Garris\garriki01","1997-98",23,"DEN","NBA",-0.1,28,0,225,22,65,17,51,5,14,19,25,3,16,19,28,7,1,15,22,68,2.28
11313,"Chris Gatling\gatlich01","1998-99",31,"TOT","NBA",-0.1,48,3,775,117,265,116,257,1,8,37,93,52,127,179,32,32,10,62,118,272,5.08
11314,"Michael Gbinije\gbinimi01","2016-17",24,"DET","NBA",-0.1,9,0,32,1,10,1,6,0,4,2,2,2,1,3,2,0,0,0,2,4,0
11315,"Alonzo Gee\geeal01","2016-17",29,"DEN","NBA",-0.1,13,0,89,3,14,3,11,0,3,5,9,4,11,15,6,5,1,4,14,11,1.28
11316,"Matt Geiger\geigema01","2001-02",32,"PHI","NBA",-0.1,4,0,36,1,8,1,8,0,0,1,2,3,3,6,0,0,2,2,2,3,0.3
11317,"Tate George\georgta01","1992-93",24,"NJN","NBA",-0.1,48,1,380,51,135,51,130,0,5,20,24,9,18,27,59,10,3,31,25,122,2.3
11318,"Jonathan Gibson\gibsojo01","2016-17",29,"DAL","NBA",-0.1,17,0,231,35,95,20,50,15,45,21,29,1,21,22,26,8,0,21,21,106,5.02
11319,"Anthony Goldwire\goldwan01","2002-03",31,"TOT","NBA",-0.1,15,0,85,9,25,6,16,3,9,4,7,0,6,6,4,3,0,6,6,25,1.21
11320,"Anthony Goldwire\goldwan01","2005-06",34,"LAC","NBA",-0.1,3,0,22,1,7,1,5,0,2,0,0,0,1,1,2,0,0,1,0,2,-0.23
11321,"Drew Gooden\goodedr01","2012-13",31,"MIL","NBA",-0.1,16,0,151,20,61,19,56,1,5,11,16,13,18,31,6,5,6,9,21,52,2.57
11322,"Steve Goodrich\goodrst01","2001-02",25,"NJN","NBA",-0.1,9,0,50,2,10,2,10,0,0,1,2,1,4,5,5,1,2,3,10,5,0.7
11323,"Steve Goodrich\goodrst01","2000-01",24,"CHI","NBA",-0.1,12,0,133,7,18,6,15,1,3,4,7,7,14,21,6,2,1,8,14,19,1.94
11324,"Drew Gordon\gordodr01","2014-15",24,"PHI","NBA",-0.1,9,0,71,8,19,8,16,0,3,1,2,7,11,18,2,1,0,8,7,17,1.79
11325,"Greg Graham\grahagr01","1997-98",27,"CLE","NBA",-0.1,6,0,56,7,12,7,9,0,3,2,2,0,1,1,6,1,0,10,7,16,2.67
11326,"Stephen Graham\grahast01","2006-07",24,"POR","NBA",-0.1,14,1,165,17,40,14,29,3,11,8,9,6,15,21,5,4,1,13,25,45,2.86
11327,"Danny Granger\grangda01","2012-13",29,"IND","NBA",-0.1,5,0,74,10,35,8,25,2,10,5,8,3,6,9,3,2,1,4,6,27,2.74
11328,"Paul Grant\grantpa01","1998-99",25,"TOT","NBA",-0.1,6,0,13,2,6,2,6,0,0,0,0,1,0,1,0,1,0,2,4,4,0.33
11329,"Evric Gray\grayev01","1996-97",27,"NJN","NBA",-0.1,5,0,42,4,15,3,11,1,4,4,4,1,2,3,2,1,0,3,5,13,1.54
11330,"Jeff Grayer\grayeje01","1997-98",32,"TOT","NBA",-0.1,5,0,34,4,11,2,5,2,6,0,0,0,4,4,2,2,0,4,7,10,1.78
11331,"Devin Green\greende01","2005-06",23,"LAL","NBA",-0.1,27,0,135,6,28,6,26,0,2,13,21,10,14,24,7,3,0,5,13,25,0.82
11332,"Litterial Green\greenli01","1997-98",27,"MIL","NBA",-0.1,21,0,124,5,23,5,21,0,2,15,20,1,6,7,16,4,0,8,11,25,1.28
11333,"Taurean Green\greenta01","2007-08",21,"TOT","NBA",-0.1,17,0,74,7,25,5,14,2,11,11,12,0,10,10,11,2,0,9,5,27,1.51
11334,"Willie Green\greenwi01","2014-15",33,"ORL","NBA",-0.1,52,2,951,118,306,76,185,42,121,28,34,14,65,79,68,26,5,48,81,306,4.72
11335,"Willie Green\greenwi01","2005-06",24,"PHI","NBA",-0.1,10,2,153,28,66,18,47,10,19,4,5,1,14,15,5,2,0,12,13,70,4.61
11336,"Andrés Guibert\guibean01","1994-95",26,"MIN","NBA",-0.1,17,0,167,16,47,16,43,0,4,13,19,16,29,45,10,8,1,12,29,45,2.93
11337,"A.J. Guyton\guytoaj01","2002-03",24,"GSW","NBA",-0.1,2,0,9,0,4,0,3,0,1,0,0,0,0,0,2,1,0,1,0,0,-0.2
11338,"Daniel Hamilton\hamilda02","2018-19",23,"ATL","NBA",-0.1,19,3,204,23,60,15,37,8,23,3,6,10,37,47,22,6,1,16,19,57,3.36
11339,"Tom Hammonds\hammoto01","2000-01",33,"MIN","NBA",-0.1,7,0,30,3,10,3,10,0,0,1,2,2,2,4,1,0,0,3,8,7,0.44
11340,"Dusty Hannahs\hannadu01","2018-19",25,"MEM","NBA",-0.1,2,0,26,3,12,3,7,0,5,2,2,0,1,1,5,1,0,1,1,8,2.85
11341,"Justin Harper\harpeju01","2016-17",27,"PHI","NBA",-0.1,3,0,31,5,12,3,5,2,7,0,0,2,3,5,2,0,0,4,2,12,3
11342,"Mike Harris\harrimi01","2009-10",26,"TOT","NBA",-0.1,13,0,96,11,30,11,29,0,1,7,11,10,14,24,3,5,1,9,14,29,2.17
11343,"Aaron Harrison\harriaa01","2017-18",23,"DAL","NBA",-0.1,9,3,233,19,69,10,26,9,43,13,17,4,20,24,11,9,2,3,27,60,5.04
11344,"Aaron Harrison\harriaa01","2016-17",22,"CHO","NBA",-0.1,5,0,17,0,4,0,2,0,2,1,2,0,3,3,3,0,0,0,2,1,0.22
11345,"Andrew Harrison\harrian01","2018-19",24,"TOT","NBA",-0.1,17,0,187,16,53,11,28,5,25,17,18,6,14,20,24,4,2,12,34,54,3.12
11346,"Udonis Haslem\hasleud01","2017-18",37,"MIA","NBA",-0.1,14,0,72,3,15,2,7,1,8,1,2,3,7,10,5,0,2,2,3,8,0.51
11347,"Udonis Haslem\hasleud01","2018-19",38,"MIA","NBA",-0.1,10,1,74,11,33,11,21,0,12,3,4,3,24,27,2,0,0,3,9,25,1.81
11348,"Trenton Hassell\hassetr01","2002-03",23,"CHI","NBA",-0.1,82,53,1999,144,392,131,352,13,40,41,55,37,218,255,151,45,61,83,197,342,5.06
11349,"Trenton Hassell\hassetr01","2009-10",30,"NJN","NBA",-0.1,52,31,1106,90,219,90,214,0,5,52,69,56,96,152,50,17,9,47,91,232,4.37
11350,"Nigel Hayes\hayesni01","2017-18",23,"TOT","NBA",-0.1,9,0,122,11,33,7,17,4,16,1,3,4,18,22,6,2,3,2,8,27,2.73
11351,"Lazar Hayward\haywala01","2011-12",25,"OKC","NBA",-0.1,26,0,141,13,38,9,24,4,14,7,12,2,14,16,4,3,1,9,18,37,1.02
11352,"Xavier Henry\henryxa01","2014-15",23,"LAL","NBA",-0.1,9,0,86,3,13,3,13,0,0,14,24,2,2,4,3,3,0,3,6,20,1.64
11353,"Mario Hezonja\hezonma01","2018-19",23,"NYK","NBA",-0.1,58,24,1206,191,464,149,312,42,152,87,114,28,211,239,88,57,8,88,110,511,8.13
11354,"Sean Higgins\higgise01","1997-98",29,"POR","NBA",-0.1,2,0,12,0,5,0,3,0,2,0,0,0,0,0,0,2,0,1,3,0,-0.75
11355,"Sean Higgins\higgise01","1992-93",24,"GSW","NBA",-0.1,29,4,591,96,215,83,178,13,37,35,47,23,45,68,66,13,5,64,54,240,7.34
11356,"Nenê Hilário\hilarne01","2005-06",23,"DEN","NBA",-0.1,1,0,3,0,1,0,1,0,0,0,0,0,0,0,0,0,0,2,1,0,-0.7
11357,"Grant Hill\hillgr01","2012-13",40,"LAC","NBA",-0.1,29,0,437,38,98,35,87,3,11,14,24,6,43,49,26,11,7,25,39,93,3.08
11358,"Solomon Hill\hillso01","2017-18",26,"NOP","NBA",-0.1,12,1,187,11,41,7,20,4,21,3,6,9,27,36,22,7,1,9,22,29,3.42
11359,"Justin Holiday\holidju01","2012-13",23,"PHI","NBA",-0.1,9,0,142,16,48,12,32,4,16,6,8,0,14,14,15,3,6,9,7,42,4.14
11360,"Jerald Honeycutt\honeyje01","1998-99",24,"TOT","NBA",-0.1,16,0,102,9,32,4,15,5,17,7,10,3,9,12,3,5,2,9,16,30,1.46
11361,"Tyler Honeycutt\honeyty01","2012-13",22,"SAC","NBA",-0.1,9,0,32,3,11,3,9,0,2,2,2,3,7,10,2,0,1,5,2,8,0.84
11362,"Derek Hood\hoodde01","1999-00",23,"CHH","NBA",-0.1,2,0,4,0,3,0,3,0,0,0,0,0,1,1,0,0,0,0,0,0,-0.85
11363,"Scotty Hopson\hopsosc01","2013-14",24,"CLE","NBA",-0.1,2,0,7,0,4,0,2,0,2,1,2,0,0,0,1,1,0,0,0,1,-0.25
11364,"Lester Hudson\hudsole01","2010-11",26,"WAS","NBA",-0.1,11,0,73,6,24,2,9,4,15,2,4,1,4,5,17,4,1,7,10,18,1.95
11365,"Troy Hudson\hudsotr01","2007-08",31,"GSW","NBA",-0.1,9,0,93,9,31,5,19,4,12,6,6,0,7,7,9,3,0,7,4,28,2.44
11366,"Marcelo Huertas\huertma01","2015-16",32,"LAL","NBA",-0.1,53,0,869,97,230,81,169,16,61,27,29,18,72,90,182,26,7,80,76,237,5.82
11367,"Marcelo Huertas\huertma01","2016-17",33,"LAL","NBA",-0.1,23,1,237,25,68,21,49,4,19,9,17,2,22,24,52,10,2,19,16,63,3.46
11368,"Isaac Humphries\humphis01","2018-19",21,"ATL","NBA",-0.1,5,1,56,6,21,3,10,3,11,0,0,4,7,11,0,1,0,0,7,15,1.62
11369,"Damien Inglis\inglida01","2015-16",20,"MIL","NBA",-0.1,20,1,156,13,37,10,24,3,13,7,8,2,29,31,10,6,3,11,11,36,2.12
11370,"Andre Ingram\ingraan01","2018-19",33,"LAL","NBA",-0.1,4,0,15,0,6,0,3,0,3,0,0,1,1,2,0,1,0,1,0,0,-0.6
11371,"Demetrius Jackson\jacksde01","2017-18",23,"TOT","NBA",-0.1,15,0,80,7,18,6,11,1,7,1,2,5,7,12,9,5,1,10,7,16,1.51
11372,"Randell Jackson\jacksra02","1998-99",23,"WAS","NBA",-0.1,27,8,271,46,108,45,101,1,7,21,32,30,24,54,8,3,11,26,29,114,3.34
11373,"Stephen Jackson\jacksst02","2001-02",23,"SAS","NBA",-0.1,23,1,227,34,91,25,55,9,36,12,17,3,23,26,11,15,3,23,29,89,3.13
11374,"Dave Jamerson\jamerda01","1993-94",26,"TOT","NBA",-0.1,5,0,14,0,7,0,7,0,0,2,3,0,4,4,1,0,0,1,0,2,-0.2
11375,"Jerome James\jamesje01","1998-99",23,"SAC","NBA",-0.1,16,0,42,9,24,9,24,0,0,6,12,6,11,17,1,2,6,9,11,24,1.38
11376,"Mike James\jamesmi01","2013-14",38,"CHI","NBA",-0.1,11,0,77,5,21,4,16,1,5,0,2,0,7,7,17,2,0,5,11,11,1.29
11377,"Mike James\jamesmi01","2008-09",33,"TOT","NBA",-0.1,61,50,1649,197,514,128,330,69,184,68,82,25,108,133,201,44,6,94,108,531,7.98
11378,"Mike James\jamesmi01","2009-10",34,"WAS","NBA",-0.1,4,0,46,6,20,4,14,2,6,4,8,1,2,3,5,3,0,5,3,18,3.12
11379,"Tim James\jamesti01","2001-02",25,"PHI","NBA",-0.1,9,0,41,5,13,5,13,0,0,2,6,5,2,7,1,0,1,3,5,12,0.83
11380,"Tim James\jamesti01","1999-00",23,"MIA","NBA",-0.1,4,0,23,5,14,5,14,0,0,1,3,3,1,4,2,0,3,2,1,11,1.88
11381,"Nathan Jawai\jawaina01","2008-09",22,"TOR","NBA",-0.1,6,0,19,1,4,1,4,0,0,0,0,1,1,2,0,0,0,2,3,2,0.07
11382,"John Jenkins\jenkijo01","2013-14",22,"ATL","NBA",-0.1,13,0,158,16,42,12,24,4,18,4,4,3,19,22,11,1,1,11,11,40,2.71
11383,"Grant Jerrett\jerregr01","2014-15",21,"TOT","NBA",-0.1,8,0,51,7,26,6,11,1,15,1,1,2,7,9,3,2,2,3,11,16,1.21
11384,"Dave Johnson\johnsda01","1992-93",22,"POR","NBA",-0.1,42,0,356,57,149,54,135,3,14,40,59,18,30,48,13,8,1,28,23,157,2.5
11385,"DeMarco Johnson\johnsde02","1999-00",24,"NYK","NBA",-0.1,5,0,37,3,9,3,9,0,0,0,0,3,4,7,0,1,0,3,5,6,0.94
11386,"Eddie Johnson\johnsed03","1998-99",39,"HOU","NBA",-0.1,3,0,18,6,13,6,12,0,1,0,0,0,2,2,1,0,0,2,3,12,2.27
11387,"Nick Johnson\johnsni01","2014-15",22,"HOU","NBA",-0.1,28,0,262,26,75,21,54,5,21,17,25,13,26,39,11,7,3,19,34,74,2.18
11388,"Trey Johnson\johnstr01","2008-09",24,"CLE","NBA",-0.1,4,0,14,0,5,0,5,0,0,4,4,0,1,1,0,0,0,1,4,4,0.22
11389,"Darius Johnson-Odom\johnsda03","2012-13",23,"LAL","NBA",-0.1,4,0,6,0,4,0,3,0,1,0,0,1,3,4,1,0,0,0,0,0,-0.12
11390,"Askia Jones\jonesas01","1994-95",23,"MIN","NBA",-0.1,11,0,139,15,44,13,32,2,12,13,16,6,5,11,16,6,0,9,19,45,3.69
11391,"Mark Jones\jonesma03","2004-05",29,"ORL","NBA",-0.1,10,0,116,9,31,9,27,0,4,5,10,6,7,13,6,5,2,3,16,23,1.87
11392,"Solomon Jones\jonesso01","2012-13",28,"NYK","NBA",-0.1,2,1,26,0,1,0,1,0,0,0,0,1,2,3,0,0,1,3,3,0,0.6
11393,"Terrence Jones\joneste01","2018-19",27,"HOU","NBA",-0.1,2,0,5,1,4,1,2,0,2,0,1,0,4,4,0,0,0,1,1,2,0.4
11394,"Adonis Jordan\jordaad01","1993-94",23,"DEN","NBA",-0.1,6,0,79,6,23,3,13,3,10,0,0,3,3,6,19,0,1,6,6,15,2.95
11395,"Garth Joseph\josepga01","2000-01",27,"TOT","NBA",-0.1,4,0,16,1,5,1,5,0,0,0,2,2,0,2,1,0,1,2,1,2,0.07
11396,"Kris Joseph\josepkr01","2012-13",24,"TOT","NBA",-0.1,10,0,54,2,14,2,11,0,3,5,8,1,6,7,1,3,0,2,3,9,0.53
11397,"Sergey Karasev\karasse01","2013-14",20,"CLE","NBA",-0.1,22,1,156,12,35,8,16,4,19,9,10,0,16,16,6,3,1,11,22,37,1.42
11398,"Tim Kempton\kemptti01","1997-98",34,"TOT","NBA",-0.1,8,0,47,2,9,2,9,0,0,0,0,4,2,6,3,1,2,4,10,4,0.68
11399,"Tim Kempton\kemptti01","1993-94",30,"TOT","NBA",-0.1,13,0,136,15,38,15,38,0,0,9,16,10,14,24,9,6,2,11,33,39,2.99
11400,"Lari Ketner\ketnela01","2000-01",23,"IND","NBA",-0.1,3,0,7,0,0,0,0,0,0,0,0,0,0,0,1,0,0,2,0,0,0.23
11401,"Chris King\kingch01","1998-99",29,"UTA","NBA",-0.1,8,0,42,2,7,2,7,0,0,0,4,1,10,11,1,2,1,4,8,4,0.76
11402,"Frankie King\kingfr01","1995-96",23,"LAL","NBA",-0.1,6,0,20,3,11,3,10,0,1,1,3,1,1,2,2,2,0,2,4,7,0.65
11403,"Rich King\kingri01","1994-95",25,"SEA","NBA",-0.1,2,0,6,0,2,0,2,0,0,0,2,0,0,0,0,0,0,0,1,0,-1.1
11404,"Greg Kite\kitegr01","1993-94",32,"ORL","NBA",-0.1,29,0,309,13,35,13,35,0,0,8,22,22,48,70,4,2,12,17,61,34,1.73
11405,"Negele Knight\knighne01","1998-99",31,"TOR","NBA",-0.1,6,0,56,3,8,3,7,0,1,2,4,1,5,6,8,1,0,7,5,8,1.97
11406,"Travis Knight\knightr01","2001-02",27,"NYK","NBA",-0.1,49,0,429,41,113,41,113,0,0,16,21,48,56,104,8,11,10,27,95,98,2.01
11407,"Nenad Krstić\krstine01","2007-08",24,"NJN","NBA",-0.1,45,38,812,123,300,123,298,0,2,52,69,35,165,200,27,9,17,41,111,298,5.56
11408,"Ibo Kutluay\kutluib01","2004-05",30,"SEA","NBA",-0.1,5,0,12,0,1,0,1,0,0,0,0,0,1,1,0,0,0,2,1,0,-0.06
11409,"Maciej Lampe\lampema01","2004-05",19,"TOT","NBA",-0.1,37,0,380,49,132,47,128,2,4,15,22,24,65,89,11,5,7,17,51,115,2.5
11410,"Marcus Landry\landrma01","2009-10",24,"TOT","NBA",-0.1,18,0,111,16,43,7,15,9,28,3,5,5,14,19,0,1,2,6,14,44,1.64
11411,"Andrew Lang\langan01","1998-99",32,"CHI","NBA",-0.1,21,13,386,32,99,32,99,0,0,16,23,33,60,93,13,5,12,17,43,80,3.83
11412,"Antonio Lang\langan02","1994-95",22,"PHO","NBA",-0.1,12,0,53,4,10,4,10,0,0,3,4,3,1,4,1,0,2,5,11,11,0.74
11413,"Dan Langhi\langhda01","2000-01",23,"HOU","NBA",-0.1,33,0,241,37,99,37,98,0,1,16,29,13,28,41,4,7,1,8,16,90,1.73
11414,"Dan Langhi\langhda01","2003-04",26,"TOT","NBA",-0.1,6,0,37,5,14,4,12,1,2,2,2,0,4,4,0,0,0,2,7,13,1.13
11415,"Shane Larkin\larkish01","2013-14",21,"DAL","NBA",-0.1,48,0,489,52,137,40,99,12,38,16,25,11,31,42,71,26,1,39,46,132,3.05
11416,"Rusty LaRue\larueru01","2003-04",30,"GSW","NBA",-0.1,4,0,22,1,3,0,2,1,1,1,2,0,3,3,2,2,0,4,2,4,1.63
11417,"Rusty LaRue\larueru01","1999-00",26,"CHI","NBA",-0.1,4,1,129,15,43,13,29,2,14,5,7,1,9,10,11,7,0,7,9,37,7.7
11418,"Acie Law\lawac01","2007-08",23,"ATL","NBA",-0.1,56,6,865,95,237,88,203,7,34,38,48,12,45,57,113,29,0,56,73,235,4.18
11419,"Jake Layman\laymaja01","2017-18",23,"POR","NBA",-0.1,35,1,160,14,47,10,27,4,20,2,3,4,12,16,11,6,4,5,13,34,0.83
11420,"Eric Leckner\leckner01","1996-97",30,"TOT","NBA",-0.1,20,1,126,14,33,14,33,0,0,6,12,5,31,36,5,3,2,10,35,34,1.82
11421,"Walt Lemon\lemonwa01","2017-18",25,"NOP","NBA",-0.1,5,0,35,7,16,6,15,1,1,2,3,0,2,2,5,0,1,4,5,17,2.64
11422,"Voshon Lenard\lenarvo01","2005-06",32,"TOT","NBA",-0.1,26,6,458,75,191,50,113,25,78,16,31,5,42,47,41,21,4,31,39,191,5.87
11423,"Randy Livingston\livinra01","2006-07",31,"SEA","NBA",-0.1,4,0,26,0,3,0,3,0,0,0,0,1,0,1,4,0,0,1,2,0,0.28
11424,"Randy Livingston\livinra01","2003-04",28,"LAC","NBA",-0.1,4,0,48,2,10,2,7,0,3,4,6,2,5,7,4,2,0,4,7,8,2.15
11425,"Horacio Llamas Grey\llamaho01","1997-98",24,"PHO","NBA",-0.1,8,0,42,8,21,7,18,1,3,7,10,4,14,18,1,1,3,9,14,24,2.79
11426,"Brad Lohaus\lohaubr01","1996-97",32,"TOR","NBA",-0.1,6,0,45,4,15,2,8,2,7,0,0,1,6,7,1,1,0,1,6,10,0.93
11427,"Art Long\longar01","2000-01",28,"SAC","NBA",-0.1,9,0,20,0,4,0,4,0,0,0,2,2,6,8,1,0,3,2,5,0,0.27
11428,"John Lucas III\lucasjo02","2005-06",23,"HOU","NBA",-0.1,13,0,107,14,36,12,27,2,9,0,0,2,3,5,12,5,0,7,6,30,1.98
11429,"Scott Machado\machasc01","2012-13",22,"HOU","NBA",-0.1,6,0,21,3,6,3,5,0,1,2,2,0,1,1,6,2,0,8,0,8,1.93
11430,"Sam Mack\macksa01","2001-02",31,"MIA","NBA",-0.1,12,1,159,14,49,7,21,7,28,5,7,2,12,14,4,5,1,7,17,40,2.05
11431,"Mark Madsen\madsema01","2008-09",33,"MIN","NBA",-0.1,19,1,116,3,14,3,14,0,0,0,4,10,8,18,4,1,1,3,18,6,0.39
11432,"Renaldo Major\majorre01","2006-07",24,"GSW","NBA",-0.1,1,0,27,2,10,2,10,0,0,1,2,0,2,2,0,2,0,1,4,5,1.2
11433,"Rich Manning\manniri01","1996-97",26,"TOT","NBA",-0.1,26,2,201,32,82,30,78,2,4,9,14,16,23,39,3,4,2,7,29,75,1.98
11434,"Devyn Marble\marblde01","2014-15",22,"ORL","NBA",-0.1,16,7,208,14,44,10,22,4,22,5,16,5,26,31,17,9,2,9,14,37,2.63
11435,"Devyn Marble\marblde01","2015-16",23,"ORL","NBA",-0.1,28,0,249,21,71,13,39,8,32,10,24,6,32,38,12,13,1,7,25,60,1.8
11436,"Donny Marshall\marshdo02","2002-03",30,"NJN","NBA",-0.1,3,0,6,0,3,0,2,0,1,0,0,0,3,3,0,0,0,1,0,0,-0.3
11437,"Donny Marshall\marshdo02","1999-00",27,"CLE","NBA",-0.1,6,0,39,3,11,3,8,0,3,5,6,0,1,1,0,2,0,3,7,11,1.08
11438,"Darrick Martin\martida01","2007-08",36,"TOR","NBA",-0.1,17,0,141,10,43,8,27,2,16,5,6,3,4,7,21,6,0,1,12,27,1.41
11439,"Roger Mason\masonro01","2006-07",26,"WAS","NBA",-0.1,62,0,492,59,179,26,77,33,102,14,16,7,38,45,35,13,6,19,66,165,1.97
11440,"Lee Mayberry\maybele01","1998-99",28,"VAN","NBA",-0.1,9,0,126,7,19,5,9,2,10,4,5,0,3,3,23,7,0,11,13,20,3.71
11441,"O.J. Mayo\mayooj01","2015-16",28,"MIL","NBA",-0.1,41,24,1090,119,321,67,159,52,162,31,40,13,92,105,118,48,8,72,126,321,7.77
11442,"Chris McCray\mccrach01","2006-07",22,"MIL","NBA",-0.1,5,0,12,0,3,0,3,0,0,0,0,0,0,0,0,0,0,2,1,0,-0.42
11443,"Erik McCree\mccreer01","2017-18",24,"UTA","NBA",-0.1,4,0,8,0,2,0,1,0,1,0,0,0,1,1,0,1,0,1,0,0,0
11444,"Michael McDonald\mcdonmi01","1997-98",28,"CHH","NBA",-0.1,1,0,4,0,0,0,0,0,0,0,0,1,0,1,0,0,0,2,1,0,0.4
11445,"JaVale McGee\mcgeeja01","2013-14",26,"DEN","NBA",-0.1,5,5,79,17,38,17,38,0,0,1,1,10,7,17,2,1,7,8,16,35,5.86
11446,"Jeff McInnis\mcinnje01","2006-07",32,"CHA","NBA",-0.1,38,3,702,71,181,70,173,1,8,22,32,14,48,62,124,14,0,42,72,165,4.96
11447,"Jerel McNeal\mcneaje01","2014-15",27,"PHO","NBA",-0.1,6,0,36,3,11,2,9,1,2,2,2,0,3,3,2,3,1,5,5,9,1.47
11448,"Darnell Mee\meeda01","1993-94",22,"DEN","NBA",-0.1,38,0,285,28,88,23,64,5,24,12,27,17,18,35,16,15,13,18,34,73,1.73
11449,"Ron Mercer\mercero01","2004-05",28,"NJN","NBA",-0.1,18,3,390,65,158,65,155,0,3,7,10,9,31,40,20,16,2,14,20,137,5.48
11450,"Marko Milič\milicma01","1998-99",21,"PHO","NBA",-0.1,11,0,53,8,20,8,19,0,1,0,0,3,2,5,2,3,1,6,7,16,1.12
11451,"Darko Miličić\milicda01","2012-13",27,"BOS","NBA",-0.1,1,0,5,0,1,0,1,0,0,0,0,0,1,1,0,0,0,2,1,0,-0.3
11452,"Anthony Miller\millean01","1996-97",25,"ATL","NBA",-0.1,1,0,14,0,5,0,5,0,0,0,0,2,5,7,0,0,0,0,2,0,-0.7
11453,"Darius Miller\milleda01","2014-15",24,"NOP","NBA",-0.1,5,1,43,1,7,1,6,0,1,0,0,0,1,1,2,1,0,1,8,2,0.06
11454,"Quincy Miller\millequ01","2014-15",22,"TOT","NBA",-0.1,10,0,119,9,38,6,20,3,18,8,11,4,16,20,8,7,5,5,9,29,2.89
11455,"Elijah Millsap\millsel01","2016-17",29,"PHO","NBA",-0.1,2,0,23,1,7,1,5,0,2,1,2,3,3,6,1,0,0,2,2,3,0.6
11456,"Harold Miner\minerha01","1995-96",24,"CLE","NBA",-0.1,19,0,136,23,52,21,42,2,10,13,13,4,8,12,8,0,0,14,23,61,2.33
11457,"Naz Mitrou-Long\mitrona01","2018-19",25,"UTA","NBA",-0.1,14,0,84,6,20,4,9,2,11,2,2,1,5,6,15,1,1,8,10,16,1.36
11458,"Cuttino Mobley\moblecu01","2008-09",33,"LAC","NBA",-0.1,11,11,365,63,146,51,111,12,35,13,18,9,20,29,12,15,2,18,21,151,9.85
11459,"Nazr Mohammed\mohamna01","1999-00",22,"PHI","NBA",-0.1,28,3,190,21,54,21,54,0,0,12,22,16,34,50,2,4,12,18,29,54,1.94
11460,"Jérôme Moïso\moisoje01","2001-02",23,"CHH","NBA",-0.1,15,0,76,8,20,8,20,0,0,0,0,4,21,25,4,3,2,8,12,16,1.49
11461,"Luis Montero\montelu01","2017-18",24,"DET","NBA",-0.1,2,0,8,0,1,0,1,0,0,0,0,0,2,2,0,0,0,2,0,0,0.05
11462,"Jaylen Morris\morrija01","2017-18",22,"ATL","NBA",-0.1,6,0,98,13,32,11,22,2,10,0,0,2,14,16,7,2,1,6,2,28,4.13
11463,"Randolph Morris\morrira01","2006-07",21,"NYK","NBA",-0.1,5,0,44,1,6,1,6,0,0,2,6,1,8,9,1,2,1,2,4,4,1.12
11464,"Terence Morris\morrite01","2005-06",27,"ORL","NBA",-0.1,22,0,192,16,49,16,47,0,2,3,3,6,32,38,4,6,5,7,19,35,1.57
11465,"Lawrence Moten\motenla01","1997-98",25,"WAS","NBA",-0.1,8,0,27,3,13,3,12,0,1,3,4,1,0,1,3,0,0,1,6,9,0.4
11466,"Donatas Motiejūnas\motiedo01","2018-19",28,"SAS","NBA",-0.1,3,0,13,3,6,3,6,0,0,0,2,2,1,3,1,0,1,3,6,6,1.6
11467,"Byron Mullens\mulleby01","2009-10",20,"OKC","NBA",-0.1,13,0,54,7,19,7,19,0,0,0,0,3,7,10,1,2,0,4,13,14,0.78
11468,"Xavier Munford\munfoxa02","2017-18",25,"MIL","NBA",-0.1,6,0,21,1,6,1,4,0,2,1,2,1,0,1,4,1,0,2,4,3,0.5
11469,"Gheorghe Mureșan\muresgh01","1998-99",27,"NJN","NBA",-0.1,1,0,1,0,1,0,1,0,0,0,0,0,0,0,0,0,0,1,0,0,-0.7
11470,"Erik Murphy\murpher01","2013-14",23,"CHI","NBA",-0.1,24,0,62,3,13,3,10,0,3,0,0,2,6,8,2,0,4,2,7,6,0.23
11471,"Tracy Murray\murratr01","2003-04",32,"POR","NBA",-0.1,7,0,35,3,12,1,7,2,5,0,1,3,2,5,1,1,0,2,3,8,0.59
11472,"Toure' Murry\murryto01","2014-15",25,"TOT","NBA",-0.1,5,0,18,2,5,2,5,0,0,2,2,1,0,1,1,1,0,4,2,6,1.08
11473,"Džanan Musa\musadz01","2018-19",19,"BRK","NBA",-0.1,9,0,39,9,22,8,12,1,10,0,2,1,4,5,2,2,0,4,1,19,1.31
11474,"Sviatoslav Mykhailiuk\mykhasv01","2018-19",21,"TOT","NBA",-0.1,42,0,440,46,140,17,51,29,89,12,20,9,27,36,37,14,1,21,25,133,2.5
11475,"Boštjan Nachbar\nachbbo01","2002-03",22,"HOU","NBA",-0.1,14,1,77,11,31,9,21,2,10,5,10,3,8,11,3,2,2,6,13,29,1.4
11476,"Abdel Nader\naderab01","2017-18",24,"BOS","NBA",-0.1,48,1,522,50,149,27,84,23,65,23,39,13,58,71,26,15,10,34,45,146,2.58
11477,"Howard Nathan\nathaho01","1995-96",24,"ATL","NBA",-0.1,5,0,15,5,9,5,8,0,1,3,4,0,0,0,2,3,0,8,2,13,2.54
11478,"Gary Neal\nealga01","2016-17",32,"ATL","NBA",-0.1,2,0,18,0,7,0,5,0,2,4,4,0,1,1,1,0,0,0,1,4,0.1
11479,"Ivano Newbill\newbiiv01","1997-98",27,"VAN","NBA",-0.1,28,2,249,20,57,19,56,1,1,17,30,24,45,69,9,10,3,17,38,58,2.39
11480,"Andrew Nicholson\nichoan01","2016-17",27,"TOT","NBA",-0.1,38,0,342,43,111,38,84,5,27,9,14,15,46,61,10,16,6,17,55,100,2.34
11481,"Moochie Norris\norrimo01","1996-97",23,"VAN","NBA",-0.1,8,0,89,4,22,2,12,2,10,2,5,3,9,12,23,4,0,5,5,12,2.74
11482,"James Nunnally\nunnaja01","2013-14",23,"TOT","NBA",-0.1,13,0,165,15,46,7,21,8,25,6,9,1,18,19,8,6,2,7,11,44,2.86
11483,"Tim Ohlbrecht\ohlbrti01","2012-13",24,"HOU","NBA",-0.1,3,0,12,1,3,1,3,0,0,1,1,0,1,1,1,1,0,4,1,3,1.13
11484,"Dean Oliver\olivede01","2002-03",24,"GSW","NBA",-0.1,15,0,93,7,29,6,23,1,6,7,8,8,8,16,23,7,0,10,9,22,2.24
11485,"Dean Oliver\olivede01","2001-02",23,"GSW","NBA",-0.1,20,0,139,17,46,15,33,2,13,6,9,0,8,8,21,3,0,11,16,42,1.82
11486,"Jimmy Oliver\oliveji01","1996-97",27,"TOR","NBA",-0.1,4,0,43,4,13,3,7,1,6,2,2,1,4,5,1,2,0,3,2,11,2.05
11487,"Kevin Ollie\ollieke01","1997-98",25,"TOT","NBA",-0.1,35,0,430,37,98,37,97,0,1,49,70,9,30,39,65,13,0,44,31,123,3.85
11488,"Michael Olowokandi\olowomi01","2006-07",31,"BOS","NBA",-0.1,24,0,234,19,46,19,46,0,0,2,3,14,34,48,5,8,13,17,48,40,2.28
11489,"Chinanu Onuaku\onuakch01","2017-18",21,"HOU","NBA",-0.1,1,0,22,2,5,2,5,0,0,0,0,1,3,4,1,0,0,3,4,4,3.6
11490,"Travis Outlaw\outlatr01","2011-12",27,"SAC","NBA",-0.1,39,5,500,60,175,44,115,16,60,31,46,19,42,61,16,19,21,20,34,167,3.38
11491,"Gerald Paddio\paddige01","1993-94",28,"TOT","NBA",-0.1,18,1,137,22,60,22,59,0,1,9,16,5,11,16,11,4,0,6,9,53,1.95
11492,"Kostas Papanikolaou\papanko01","2015-16",25,"DEN","NBA",-0.1,26,6,294,24,66,14,34,10,32,9,14,8,32,40,16,13,5,21,24,67,2.77
11493,"Jannero Pargo\pargoja01","2005-06",26,"CHI","NBA",-0.1,57,0,646,109,292,70,189,39,103,17,21,8,53,61,94,24,2,61,57,274,3.99
11494,"Smush Parker\parkesm01","2004-05",23,"TOT","NBA",-0.1,16,1,144,18,43,15,30,3,13,9,13,4,8,12,15,5,0,19,16,48,2.74
11495,"Lamar Patterson\pattela01","2016-17",25,"ATL","NBA",-0.1,5,0,40,3,15,2,9,1,6,2,3,1,6,7,6,1,0,4,6,9,1.46
11496,"Nikola Peković\pekovni01","2015-16",30,"MIN","NBA",-0.1,12,3,156,19,50,19,50,0,0,16,20,7,14,21,11,1,0,9,22,54,3.51
11497,"Kirk Penney\penneki01","2003-04",23,"MIA","NBA",-0.1,2,0,18,1,6,0,3,1,3,0,0,0,1,1,1,1,0,3,1,3,0.65
11498,"Kirk Penney\penneki01","2004-05",24,"LAC","NBA",-0.1,4,0,12,1,3,1,2,0,1,0,0,0,1,1,1,0,0,2,0,2,0.35
11499,"Kendrick Perkins\perkike01","2015-16",31,"NOP","NBA",-0.1,37,5,542,40,75,40,75,0,0,11,25,25,103,128,31,11,11,41,64,91,3.8
11500,"London Perrantes\perralo01","2017-18",23,"CLE","NBA",-0.1,14,0,66,2,13,2,10,0,3,3,5,1,3,4,5,2,1,1,6,7,0.41
11501,"Elliot Perry\perryel01","1998-99",29,"TOT","NBA",-0.1,35,0,290,39,103,29,79,10,24,10,14,7,27,34,47,20,0,34,25,98,3.04
11502,"Elliot Perry\perryel01","2001-02",32,"MEM","NBA",-0.1,2,0,48,5,10,5,10,0,0,1,2,0,4,4,7,3,0,7,6,11,7.55
11503,"Tim Perry\perryti01","1994-95",29,"PHI","NBA",-0.1,42,1,446,27,78,27,64,0,14,22,40,38,51,89,12,10,15,21,51,76,2.13
11504,"Chuck Person\persoch01","1999-00",35,"SEA","NBA",-0.1,37,0,340,37,123,13,28,24,95,4,8,6,47,53,22,5,2,12,56,102,1.95
11505,"Bobby Phills\phillbo01","1992-93",23,"CLE","NBA",-0.1,31,0,139,38,82,36,77,2,5,15,25,6,11,17,10,10,2,18,19,93,2.32
11506,"Dexter Pittman\pittmde01","2012-13",24,"TOT","NBA",-0.1,11,0,32,4,11,4,11,0,0,0,3,7,5,12,0,0,0,3,8,8,0.5
11507,"Dexter Pittman\pittmde01","2010-11",22,"MIA","NBA",-0.1,2,0,11,1,3,1,3,0,0,0,0,1,2,3,0,0,0,2,2,2,0.75
11508,"Tibor Pleiß\pleisti01","2015-16",26,"UTA","NBA",-0.1,12,0,82,11,25,11,23,0,2,2,2,6,9,15,2,1,2,8,19,24,1.72
11509,"Pavel Podkolzin\podkopa01","2005-06",21,"DAL","NBA",-0.1,1,0,18,0,2,0,2,0,0,3,6,0,7,7,0,0,1,2,0,3,3.9
11510,"Olden Polynice\polynol01","2003-04",39,"LAC","NBA",-0.1,2,0,12,0,0,0,0,0,0,0,0,1,1,2,1,1,0,4,2,0,1.25
11511,"Mark Pope\popema01","2003-04",31,"DEN","NBA",-0.1,4,0,20,1,2,1,2,0,0,0,1,0,3,3,0,1,0,3,8,2,0.7
11512,"Mark Pope\popema01","1998-99",26,"IND","NBA",-0.1,4,0,26,1,7,1,3,0,4,0,1,2,2,4,0,0,0,1,6,2,-0.32
11513,"Lavor Postell\postela01","2001-02",23,"NYK","NBA",-0.1,23,0,179,28,84,22,58,6,26,31,41,2,14,16,5,6,0,11,7,93,2.49
11514,"Lavor Postell\postela01","2002-03",24,"NYK","NBA",-0.1,12,0,98,14,38,12,31,2,7,13,15,1,3,4,3,2,0,7,9,43,2.24
11515,"Lavor Postell\postela01","2000-01",22,"NYK","NBA",-0.1,26,0,169,17,54,14,43,3,11,22,27,8,17,25,5,4,2,17,12,59,1.73
11516,"Vitaly Potapenko\potapvi01","2006-07",31,"SAC","NBA",-0.1,3,0,13,0,4,0,4,0,0,0,0,0,2,2,0,0,0,2,3,0,-0.67
11517,"Roger Powell\powelro01","2006-07",24,"UTA","NBA",-0.1,3,0,13,0,3,0,2,0,1,2,2,3,0,3,0,0,0,3,2,2,0.37
11518,"Phil Pressey\pressph01","2015-16",24,"TOT","NBA",-0.1,23,0,283,30,78,26,60,4,18,13,25,3,28,31,75,18,4,33,28,77,5.01
11519,"Ronnie Price\pricero01","2013-14",30,"ORL","NBA",-0.1,31,2,377,28,92,19,49,9,43,9,13,8,35,43,66,25,2,26,50,74,3.52
11520,"Anthony Pullard\pullaan01","1992-93",26,"MIL","NBA",-0.1,8,0,37,8,18,8,18,0,0,1,3,2,6,8,2,2,2,5,5,17,1.85
11521,"Tim Quarterman\quartti01","2016-17",22,"POR","NBA",-0.1,16,0,80,13,29,8,16,5,13,0,3,4,10,14,11,2,3,11,6,31,2.01
11522,"Aleksandar Radojević\radojal01","1999-00",23,"TOR","NBA",-0.1,3,0,24,2,7,2,7,0,0,3,6,2,6,8,1,2,1,5,5,7,2.77
11523,"Julius Randle\randlju01","2014-15",20,"LAL","NBA",-0.1,1,0,14,1,3,1,3,0,0,0,2,0,0,0,0,0,0,1,1,2,-0.5
11524,"Michael Redd\reddmi01","2000-01",21,"MIL","NBA",-0.1,6,0,35,5,19,5,16,0,3,3,6,3,1,4,1,1,0,1,2,13,0.63
11525,"Bryant Reeves\reevebr01","1998-99",25,"VAN","NBA",-0.1,25,14,702,102,251,102,250,0,1,67,116,50,88,138,37,13,8,47,103,271,8.65
11526,"Don Reid\reiddo01","2002-03",29,"DET","NBA",-0.1,1,0,10,0,3,0,3,0,0,1,2,0,0,0,0,0,0,0,4,1,-1.5
11527,"Jared Reiner\reineja01","2006-07",24,"MIL","NBA",-0.1,27,2,244,15,43,15,43,0,0,3,10,21,50,71,13,5,6,14,45,33,1.96
11528,"Rodrick Rhodes\rhodero01","1999-00",26,"DAL","NBA",-0.1,1,0,8,0,3,0,3,0,0,0,0,1,0,1,0,2,0,2,0,0,0.3
11529,"Glen Rice\ricegl02","2013-14",23,"WAS","NBA",-0.1,11,1,109,11,37,6,20,5,17,5,7,4,16,20,7,6,1,9,7,32,2.66
11530,"Glen Rice\ricegl02","2014-15",24,"WAS","NBA",-0.1,5,0,43,3,15,2,8,1,7,4,6,2,2,4,2,0,0,2,11,11,0.78
11531,"Glen Rice\ricegl01","2003-04",36,"LAC","NBA",-0.1,18,0,262,22,76,17,48,5,28,17,17,9,32,41,24,6,0,13,22,66,3.38
11532,"Jeremy Richardson\richaje01","2007-08",23,"TOT","NBA",-0.1,27,1,132,16,44,9,25,7,19,2,2,1,8,9,2,3,0,6,13,41,0.91
11533,"Malachi Richardson\richama01","2017-18",22,"TOT","NBA",-0.1,26,4,324,30,90,18,50,12,40,17,22,5,29,34,13,10,1,10,27,89,2.67
11534,"Malachi Richardson\richama01","2018-19",23,"TOR","NBA",-0.1,22,0,103,9,29,1,4,8,25,4,5,2,11,13,0,1,0,8,13,30,0.87
11535,"Pooh Richardson\richapo01","1998-99",32,"LAC","NBA",-0.1,11,0,130,12,36,12,30,0,6,4,4,1,12,13,30,4,0,9,5,28,3.44
11536,"Quentin Richardson\richaqu01","2012-13",32,"NYK","NBA",-0.1,1,0,29,1,11,0,7,1,4,2,2,5,5,10,1,0,0,2,1,5,2.4
11537,"Terrance Roberson\roberte01","2000-01",24,"CHH","NBA",-0.1,3,0,13,0,2,0,1,0,1,0,0,0,1,1,1,0,0,2,3,0,-0.1
11538,"Stanley Roberts\roberst01","1998-99",28,"HOU","NBA",-0.1,6,0,33,5,13,5,13,0,0,4,8,4,7,11,0,0,1,4,2,14,1.73
11539,"Stanley Roberts\roberst01","1993-94",23,"LAC","NBA",-0.1,14,14,350,43,100,43,100,0,0,18,44,27,66,93,11,6,25,24,54,104,7.8
11540,"James Robinson\robinja02","1998-99",28,"TOT","NBA",-0.1,31,0,506,67,185,46,111,21,74,28,41,18,44,62,56,22,8,44,60,183,5.38
11541,"Thomas Robinson\robinth01","2012-13",21,"TOT","NBA",-0.1,70,0,1056,138,321,138,320,0,1,57,109,122,193,315,46,41,26,88,124,333,5.14
11542,"Roy Rogers\rogerro02","1997-98",24,"TOT","NBA",-0.1,15,0,106,9,25,9,25,0,0,2,6,8,9,17,2,3,8,5,18,20,1.42
11543,"Quinton Ross\rossqu01","2009-10",28,"TOT","NBA",-0.1,52,7,562,40,111,36,90,4,21,8,14,17,32,49,12,13,6,11,69,92,1.41
11544,"Clifford Rozier\roziecl01","1997-98",25,"MIN","NBA",-0.1,6,0,30,3,6,3,6,0,0,0,1,3,3,6,0,0,0,4,7,6,0.83
11545,"Stefano Rusconi\ruscost01","1995-96",27,"PHO","NBA",-0.1,7,0,30,3,9,3,9,0,0,2,5,3,3,6,3,0,2,3,10,8,1.09
11546,"Robert Sacre\sacrero01","2012-13",23,"LAL","NBA",-0.1,32,3,203,18,48,18,48,0,0,7,11,9,25,34,6,0,10,10,38,43,1.24
11547,"Samardo Samuels\samuesa01","2012-13",24,"CLE","NBA",-0.1,18,1,196,22,60,22,59,0,1,14,24,10,18,28,8,3,3,6,30,58,2.37
11548,"Jeff Sanders\sandeje01","1992-93",27,"ATL","NBA",-0.1,9,0,120,10,25,10,25,0,0,4,8,12,17,29,6,8,1,11,16,24,3.71
11549,"Jeryl Sasser\sasseje01","2001-02",22,"ORL","NBA",-0.1,7,0,36,3,14,3,14,0,0,4,5,3,4,7,2,3,0,2,3,10,1.17
11550,"Brian Scalabrine\scalabr01","2001-02",23,"NJN","NBA",-0.1,28,0,290,23,67,20,57,3,10,11,15,12,39,51,21,9,2,24,39,60,2.36
11551,"Dwayne Schintzius\schindw01","1994-95",26,"NJN","NBA",-0.1,43,11,318,41,108,41,108,0,0,6,11,29,52,81,15,3,17,17,45,88,1.97
11552,"James Scott\scottja01","1996-97",24,"MIA","NBA",-0.1,8,0,32,0,8,0,4,0,4,1,2,1,5,6,3,2,0,2,5,1,0.19
11553,"Mike Scott\scottmi01","2016-17",28,"ATL","NBA",-0.1,18,0,195,17,59,13,32,4,27,7,8,10,27,37,17,4,3,8,12,45,2.38
11554,"Shea Seals\sealssh01","1997-98",22,"LAL","NBA",-0.1,4,0,9,1,8,1,5,0,3,2,4,3,1,4,0,1,0,0,1,4,0.15
11555,"Ansu Sesay\sesayan01","2002-03",26,"SEA","NBA",-0.1,45,4,448,41,107,41,107,0,0,12,21,34,39,73,23,14,5,25,62,94,2.1
11556,"Mustafa Shakur\shakumu01","2013-14",29,"OKC","NBA",-0.1,3,0,11,0,3,0,2,0,1,1,2,0,0,0,4,0,0,2,2,1,0.43
11557,"God Shammgod\shammgo01","1997-98",21,"WAS","NBA",-0.1,20,0,146,19,58,19,56,0,2,23,30,2,5,7,36,7,1,21,27,61,3.05
11558,"Walter Sharpe\sharpwa01","2008-09",22,"DET","NBA",-0.1,8,0,20,4,11,4,9,0,2,0,2,0,3,3,0,0,2,0,3,8,0.46
11559,"Casey Shaw\shawca01","1998-99",23,"PHI","NBA",-0.1,9,0,14,1,8,1,8,0,0,0,0,3,0,3,0,0,0,2,2,2,-0.22
11560,"Tornike Shengelia\shengto01","2013-14",22,"TOT","NBA",-0.1,26,0,154,13,28,13,22,0,6,3,8,4,12,16,14,3,1,12,18,29,1.25
11561,"Paul Shirley\shirlpa01","2002-03",25,"ATL","NBA",-0.1,2,0,5,0,4,0,4,0,0,0,0,0,1,1,0,0,0,0,0,0,-1.2
11562,"Paul Shirley\shirlpa01","2003-04",26,"CHI","NBA",-0.1,7,0,86,10,23,10,22,0,1,1,3,8,8,16,4,1,1,9,9,21,2.71
11563,"Xavier Silas\silasxa01","2011-12",24,"PHI","NBA",-0.1,2,0,39,4,15,3,9,1,6,2,3,2,2,4,3,0,0,3,5,11,2.7
11564,"Miles Simon\simonmi01","1998-99",23,"ORL","NBA",-0.1,5,0,19,1,5,1,3,0,2,0,0,1,1,2,0,1,0,3,1,2,0.14
11565,"Alvin Sims\simsal01","1998-99",24,"PHO","NBA",-0.1,4,0,25,4,10,3,9,1,1,2,5,3,1,4,5,2,0,6,2,11,2.88
11566,"Reggie Slater\slatere01","1995-96",25,"TOT","NBA",-0.1,11,0,72,14,27,14,27,0,0,3,7,4,11,15,2,2,3,9,11,31,2.51
11567,"Ish Smith\smithis01","2014-15",26,"TOT","NBA",-0.1,55,14,832,143,367,125,307,18,60,34,57,15,85,100,180,36,6,78,50,338,6.1
11568,"Ish Smith\smithis01","2010-11",22,"TOT","NBA",-0.1,43,3,442,43,115,40,105,3,10,12,21,7,40,47,79,18,2,34,37,101,2.97
11569,"Joe Smith\smithjo02","2010-11",35,"TOT","NBA",-0.1,16,3,69,3,16,3,16,0,0,2,2,3,18,21,4,0,4,5,13,8,0.75
11570,"Mike Smith\smithmi03","2000-01",24,"WAS","NBA",-0.1,17,0,180,19,59,16,41,3,18,10,16,10,12,22,10,5,3,7,8,51,2.22
11571,"Russ Smith\smithru01","2015-16",24,"MEM","NBA",-0.1,15,0,66,7,22,6,17,1,5,8,13,1,8,9,11,5,1,7,5,23,1.69
11572,"Russ Smith\smithru01","2014-15",23,"TOT","NBA",-0.1,12,0,65,8,25,6,14,2,11,12,13,1,5,6,8,3,0,12,13,30,2.19
11573,"Steven Smith\smithst03","2006-07",23,"PHI","NBA",-0.1,8,0,28,2,8,2,8,0,0,1,2,1,5,6,0,1,0,2,4,5,0.4
11574,"Stevin Smith\smithst02","1996-97",25,"DAL","NBA",-0.1,8,0,60,6,18,5,12,1,6,1,1,2,8,10,4,1,0,4,9,14,1.45
11575,"Tony Smith\smithto02","1997-98",29,"MIL","NBA",-0.1,7,0,80,8,24,8,20,0,4,3,4,4,3,7,10,5,2,9,7,19,3.03
11576,"Eric Snow\snower01","2007-08",34,"CLE","NBA",-0.1,22,5,305,6,38,6,36,0,2,10,22,4,16,20,42,10,4,10,30,22,1.96
11577,"Vassilis Spanoulis\spanova01","2006-07",24,"HOU","NBA",-0.1,31,0,272,23,72,18,43,5,29,34,42,5,17,22,28,7,1,29,33,85,2.47
11578,"Elmore Spencer\spencel01","1995-96",26,"TOT","NBA",-0.1,17,0,58,5,13,5,13,0,0,4,6,3,10,13,1,0,2,6,12,14,0.79
11579,"Felton Spencer\spencfe01","2001-02",34,"NYK","NBA",-0.1,32,8,248,6,26,6,26,0,0,17,33,16,34,50,3,7,8,12,73,29,1.3
11580,"Ryan Stack\stackry01","1999-00",24,"CLE","NBA",-0.1,25,0,198,17,51,17,50,0,1,18,27,15,30,45,5,4,11,17,47,52,2.11
11581,"John Starks\starkjo01","2001-02",36,"UTA","NBA",-0.1,66,1,929,114,310,85,215,29,95,33,41,15,53,68,70,33,0,52,126,290,3.4
11582,"Vladimir Stepania\stepavl01","1998-99",22,"SEA","NBA",-0.1,23,6,313,53,125,53,122,0,3,21,40,27,48,75,12,10,23,32,58,127,5.11
11583,"Joe Stephens\stephjo01","1996-97",24,"HOU","NBA",-0.1,2,0,9,1,5,0,2,1,3,0,0,2,1,3,0,3,0,3,3,3,2.05
11584,"DeShawn Stevenson\stevede01","2004-05",23,"ORL","NBA",-0.1,55,27,1089,174,426,149,359,25,67,56,101,38,64,102,69,16,9,57,73,429,5.34
11585,"DeShawn Stevenson\stevede01","2002-03",21,"UTA","NBA",-0.1,61,8,760,114,284,110,272,4,12,47,68,22,63,85,40,22,8,49,57,279,3.39
11586,"Diamond Stone\stonedi01","2016-17",19,"LAC","NBA",-0.1,7,0,24,3,13,3,13,0,0,4,4,1,5,6,0,0,1,2,5,10,0.74
11587,"Damon Stoudamire\stoudda01","2007-08",34,"TOT","NBA",-0.1,60,33,1037,120,337,70,188,50,149,27,34,20,98,118,165,30,2,80,76,317,5.34
11588,"Rodney Stuckey\stuckro01","2016-17",30,"IND","NBA",-0.1,39,0,696,91,244,72,184,19,60,80,107,6,78,84,84,16,0,53,44,281,6.26
11589,"Jared Sullinger\sullija01","2016-17",24,"TOR","NBA",-0.1,11,1,118,15,47,12,29,3,18,4,8,10,17,27,3,4,1,4,17,37,2.37
11590,"Bruno Šundov\sundobr01","1999-00",19,"DAL","NBA",-0.1,14,0,61,12,31,12,31,0,0,2,2,5,7,12,2,2,2,4,16,26,1.34
11591,"Bruno Šundov\sundobr01","1998-99",18,"DAL","NBA",-0.1,3,0,11,2,7,2,7,0,0,0,0,0,0,0,1,0,0,1,4,4,0.2
11592,"Stromile Swift\swiftst01","2008-09",29,"TOT","NBA",-0.1,19,0,185,24,56,23,55,1,1,13,26,16,30,46,3,4,8,16,40,62,3.02
11593,"Johnny Taylor\taylojo01","1997-98",23,"ORL","NBA",-0.1,12,0,108,13,37,12,35,1,2,11,16,4,9,13,1,3,2,8,22,38,2.13
11594,"Maurice Taylor\tayloma01","2006-07",30,"SAC","NBA",-0.1,12,2,103,8,28,8,28,0,0,8,13,10,18,28,5,4,1,6,16,24,2.08
11595,"Marquis Teague\teaguma01","2017-18",24,"MEM","NBA",-0.1,3,0,74,4,16,3,12,1,4,2,5,1,5,6,13,4,0,3,5,11,5.23
11596,"Miloš Teodosić\teodomi01","2018-19",31,"LAC","NBA",-0.1,15,0,150,17,40,7,13,10,27,4,7,3,13,16,32,3,1,21,27,48,3.87
11597,"Billy Thomas\thomabi01","2007-08",32,"TOT","NBA",-0.1,11,0,42,4,17,0,1,4,16,2,2,0,2,2,0,1,0,4,4,14,0.5
11598,"Jamel Thomas\thomaja01","1999-00",26,"TOT","NBA",-0.1,7,0,46,8,18,8,15,0,3,1,1,1,4,5,6,1,0,5,2,17,2.11
11599,"Lance Thomas\thomala01","2013-14",25,"NOP","NBA",-0.1,5,0,42,2,9,2,9,0,0,2,4,2,5,7,3,0,0,2,4,6,0.92
11600,"Keith Tower\towerke01","1996-97",26,"MIL","NBA",-0.1,5,1,72,3,8,3,8,0,0,1,8,2,7,9,1,2,1,2,12,7,1.36
11601,"Cezary Trybański\trybace01","2003-04",24,"TOT","NBA",-0.1,7,0,15,0,4,0,4,0,0,1,2,0,1,1,0,1,1,2,3,1,-0.01
11602,"Nikoloz Tskitishvili\tskitni01","2003-04",20,"DEN","NBA",-0.1,39,0,307,40,122,37,111,3,11,23,29,24,39,63,10,6,8,17,50,106,2
11603,"Jeff Turner\turneje01","1995-96",33,"ORL","NBA",-0.1,13,0,192,18,51,9,24,9,27,2,2,10,18,28,6,2,1,11,33,47,2.82
11604,"Wayne Turner\turnewa01","1999-00",23,"BOS","NBA",-0.1,3,0,41,1,6,1,6,0,0,2,6,1,2,3,5,0,0,3,4,4,1.1
11605,"Jeremy Tyler\tylerje01","2012-13",21,"TOT","NBA",-0.1,21,0,68,9,24,9,24,0,0,4,6,6,14,20,1,1,2,6,10,22,0.91
11606,"Logan Vander Velden\vandelo01","1995-96",24,"LAC","NBA",-0.1,15,0,31,3,14,3,9,0,5,3,4,1,5,6,1,0,0,0,4,9,0.21
11607,"Jarvis Varnado\varnaja01","2012-13",24,"TOT","NBA",-0.1,13,0,58,3,7,3,7,0,0,2,4,2,7,9,3,1,2,6,10,8,0.89
11608,"David Vaughn\vaughda02","1995-96",22,"ORL","NBA",-0.1,33,0,266,27,80,27,79,0,1,10,18,33,47,80,8,6,15,18,68,64,2.11
11609,"Fred Vinson\vinsofr01","1999-00",29,"SEA","NBA",-0.1,8,0,40,5,17,3,10,2,7,1,2,0,1,1,0,3,0,4,2,13,0.76
11610,"Fred Vinson\vinsofr01","1994-95",24,"ATL","NBA",-0.1,5,0,27,1,7,0,1,1,6,1,1,0,0,0,1,0,0,2,4,4,0.04
11611,"Jackson Vroman\vromaja01","2004-05",23,"TOT","NBA",-0.1,46,18,705,82,199,82,196,0,3,48,75,64,111,175,40,25,19,64,105,212,5.02
11612,"Sasha Vujačić\vujacsa01","2013-14",29,"LAC","NBA",-0.1,2,0,10,2,5,1,3,1,2,0,0,0,3,3,0,1,0,3,1,5,2.25
11613,"Dajuan Wagner\wagneda02","2003-04",20,"CLE","NBA",-0.1,44,4,708,112,306,81,220,31,86,32,47,9,49,58,51,26,7,41,89,287,4.58
11614,"Samaki Walker\walkesa01","2004-05",28,"WAS","NBA",-0.1,14,0,134,11,31,11,31,0,0,2,3,8,10,18,4,3,7,8,25,24,1.73
11615,"Duane Washington\washidu01","1992-93",28,"LAC","NBA",-0.1,4,0,28,0,5,0,5,0,0,0,0,0,2,2,5,1,0,2,2,0,0.45
11616,"Earl Watson\watsoea01","2013-14",34,"POR","NBA",-0.1,24,0,161,3,11,1,4,2,7,4,4,5,10,15,28,5,1,17,33,12,1.53
11617,"James Webb\webbja01","2017-18",24,"BRK","NBA",-0.1,10,0,120,6,24,2,5,4,19,0,0,8,16,24,4,1,0,4,10,16,1.5
11618,"Spud Webb\webbsp01","1997-98",34,"ORL","NBA",-0.1,4,0,34,5,12,5,11,0,1,2,2,2,1,3,5,1,0,7,6,12,2.83
11619,"Bonzi Wells\wellsbo01","2006-07",30,"HOU","NBA",-0.1,28,1,590,85,207,84,200,1,7,46,82,26,94,120,31,24,13,57,62,217,6.95
11620,"Robert Werdann\werdaro01","1992-93",22,"DEN","NBA",-0.1,28,0,149,18,59,18,58,0,1,17,31,23,29,52,7,6,4,12,38,53,1.71
11621,"Doug West\westdo01","2000-01",33,"VAN","NBA",-0.1,15,6,171,11,38,11,36,0,2,6,7,4,11,15,14,3,4,4,21,28,1.8
11622,"Andrew White\whitean01","2017-18",24,"ATL","NBA",-0.1,15,0,209,25,73,7,24,18,49,1,4,4,30,34,6,3,1,8,12,69,3.21
11623,"Jahidi White\whiteja01","2004-05",28,"CHA","NBA",-0.1,17,0,135,14,31,14,31,0,0,14,40,11,23,34,1,2,12,11,31,42,2.36
11624,"Isaiah Whitehead\whiteis01","2017-18",22,"BRK","NBA",-0.1,16,0,180,40,86,33,68,7,18,13,19,4,22,26,20,8,2,24,23,100,5.45
11625,"Damien Wilkins\wilkida02","2017-18",38,"IND","NBA",-0.1,19,1,152,13,39,9,21,4,18,3,4,5,11,16,9,2,1,5,7,33,1.36
11626,"Aaron Williams\williaa01","1994-95",23,"MIL","NBA",-0.1,15,0,72,8,24,8,23,0,1,8,12,5,14,19,0,2,6,7,14,24,1.51
11627,"Aaron Williams\williaa01","1993-94",22,"UTA","NBA",-0.1,6,0,12,2,8,2,8,0,0,0,1,1,2,3,1,0,0,1,4,4,0.12
11628,"Alvin Williams\willial02","2006-07",32,"LAC","NBA",-0.1,2,0,10,0,2,0,1,0,1,2,4,1,0,1,3,2,0,3,0,2,2.15
11629,"Alvin Williams\willial02","2005-06",31,"TOR","NBA",-0.1,1,0,10,0,3,0,1,0,2,1,2,0,3,3,0,0,0,0,0,1,-0.3
11630,"Frank Williams\willifr02","2002-03",22,"NYK","NBA",-0.1,21,0,167,9,33,3,17,6,16,4,6,3,15,18,34,7,2,17,20,28,2.24
11631,"Lou Williams\willilo02","2005-06",19,"PHI","NBA",-0.1,30,0,145,23,52,21,43,2,9,8,13,3,16,19,10,5,0,13,13,56,1.55
11632,"Marcus Williams\willima04","2007-08",21,"TOT","NBA",-0.1,11,0,36,5,20,5,20,0,0,0,0,4,8,12,3,1,1,0,3,10,0.6
11633,"Marcus Williams\willima03","2008-09",23,"GSW","NBA",-0.1,9,0,54,4,17,2,11,2,6,2,6,0,4,4,13,1,1,4,6,12,1.39
11634,"Marcus Williams\willima03","2006-07",21,"NJN","NBA",-0.1,79,2,1315,208,526,162,363,46,163,72,85,29,134,163,260,29,2,142,96,534,6.6
11635,"Micheal Williams\willimi02","1995-96",29,"MIN","NBA",-0.1,9,7,189,13,40,12,37,1,3,28,33,3,20,23,31,5,3,23,37,55,7.58
11636,"Micheal Williams\willimi02","1998-99",32,"TOR","NBA",-0.1,2,0,15,1,5,1,5,0,0,0,0,1,0,1,0,0,0,1,1,2,-0.35
11637,"Monty Williams\willimo01","1995-96",24,"TOT","NBA",-0.1,31,0,184,27,68,27,67,0,1,14,20,20,20,40,8,6,2,18,26,68,1.86
11638,"Scott Williams\willisc01","1998-99",30,"TOT","NBA",-0.1,7,0,46,5,17,5,17,0,0,4,7,3,11,14,1,3,2,4,9,14,1.94
11639,"David Wingate\wingada01","1999-00",36,"NYK","NBA",-0.1,7,0,32,1,9,1,9,0,0,0,0,1,1,2,3,1,2,2,7,2,0.2
11640,"Dontonio Wingfield\wingfdo01","1997-98",23,"POR","NBA",-0.1,3,0,9,0,3,0,3,0,0,1,2,2,2,4,0,0,0,1,2,1,0.03
11641,"Justise Winslow\winslju01","2016-17",20,"MIA","NBA",-0.1,18,15,625,80,225,73,190,7,35,29,47,23,71,94,66,26,6,33,52,196,9.85
11642,"Rubén Wolkowyski\wolkoru01","2000-01",27,"SEA","NBA",-0.1,34,1,305,25,79,25,77,0,2,25,34,12,34,46,3,6,18,12,38,75,1.92
11643,"Nate Wolters\woltena01","2017-18",26,"UTA","NBA",-0.1,5,0,19,1,6,1,6,0,0,0,0,1,1,2,1,0,0,0,1,2,-0.06
11644,"Antoine Wright\wrighan01","2010-11",26,"SAC","NBA",-0.1,7,0,31,1,8,1,4,0,4,0,0,2,1,3,0,1,0,1,3,2,-0.14
11645,"Dorell Wright\wrighdo01","2008-09",23,"MIA","NBA",-0.1,6,0,73,8,20,8,20,0,0,2,6,2,18,20,2,2,0,6,8,18,2.83
11646,"Dorell Wright\wrighdo01","2004-05",19,"MIA","NBA",-0.1,3,0,27,3,11,3,7,0,4,1,1,0,1,1,3,4,0,3,2,7,2.33
11647,"Lorenzen Wright\wrighlo02","2008-09",33,"CLE","NBA",-0.1,17,2,125,10,27,10,27,0,0,3,8,7,18,25,3,4,5,9,17,23,1.51
11648,"Luther Wright\wrighlu01","1993-94",22,"UTA","NBA",-0.1,15,2,92,8,23,8,22,0,1,3,4,6,4,10,0,1,2,6,21,19,0.81
11649,"Joe Young\youngjo01","2015-16",23,"IND","NBA",-0.1,41,0,384,62,169,52,123,10,46,20,25,6,44,50,65,15,0,33,30,154,3.39
11650,"Joe Young\youngjo01","2016-17",24,"IND","NBA",-0.1,33,0,135,26,72,21,49,5,23,11,15,1,16,17,15,4,0,5,5,68,1.45
11651,"Sun Yue\yuesu01","2008-09",23,"LAL","NBA",-0.1,10,0,28,3,11,3,5,0,6,0,0,0,0,0,2,1,1,3,10,6,0.26
11652,"Luke Zeller\zellelu01","2012-13",25,"PHO","NBA",-0.1,16,0,58,9,26,8,21,1,5,0,0,1,9,10,3,0,0,0,5,19,0.66
11653,"Tariq Abdul-Wahad\abdulta01","1997-98",23,"SAC","NBA",-0.2,59,16,959,144,357,140,338,4,19,84,125,44,72,116,51,35,13,65,81,376,4.97
11654,"Alex Acker\ackeral01","2005-06",23,"DET","NBA",-0.2,5,0,35,4,16,3,11,1,5,0,0,1,4,5,4,1,0,4,4,9,1.04
11655,"Hassan Adams\adamsha01","2008-09",24,"TOR","NBA",-0.2,12,0,52,4,13,4,13,0,0,3,6,1,6,7,1,1,1,4,4,11,0.62
11656,"Deng Adel\adelde01","2018-19",21,"CLE","NBA",-0.2,19,3,194,11,36,5,13,6,23,4,4,3,16,19,5,1,4,6,13,32,1.37
11657,"Blake Ahearn\ahearbl01","2011-12",27,"UTA","NBA",-0.2,4,0,30,4,14,2,5,2,9,0,0,0,2,2,1,0,0,5,4,10,0.83
11658,"Solomon Alabi\alabiso01","2010-11",22,"TOR","NBA",-0.2,12,0,59,3,15,3,15,0,0,0,2,7,7,14,2,2,2,3,5,6,0.52
11659,"Ryan Anderson\anderry01","2018-19",30,"TOT","NBA",-0.2,25,8,322,21,69,12,29,9,40,12,16,18,36,54,19,4,1,14,25,63,2.44
11660,"Robert Archibald\archiro01","2002-03",22,"MEM","NBA",-0.2,12,0,72,6,20,6,20,0,0,7,18,6,11,17,3,0,3,7,9,19,1.17
11661,"Brandon Armstrong\armstbr01","2001-02",21,"NJN","NBA",-0.2,35,0,196,27,85,22,68,5,17,5,10,10,6,16,8,7,1,8,26,64,0.94
11662,"Chucky Atkins\atkinch01","2008-09",34,"TOT","NBA",-0.2,33,0,412,34,113,19,56,15,57,15,16,5,19,24,59,10,2,23,27,98,2.86
11663,"Earl Barron\barroea01","2005-06",24,"MIA","NBA",-0.2,8,0,45,5,16,5,16,0,0,3,4,2,8,10,0,0,0,5,10,13,0.92
11664,"Earl Barron\barroea01","2010-11",29,"TOT","NBA",-0.2,21,7,305,32,99,32,99,0,0,15,24,32,44,76,11,8,6,16,46,79,3.3
11665,"Mengke Bateer\bateeme01","2002-03",27,"SAS","NBA",-0.2,12,0,46,4,17,3,14,1,3,0,2,2,8,10,4,0,0,6,14,9,0.39
11666,"Lonny Baxter\baxtelo01","2004-05",26,"NOH","NBA",-0.2,4,0,36,3,11,3,11,0,0,0,2,4,4,8,0,0,0,4,10,6,0.48
11667,"Charlie Bell\bellch01","2001-02",22,"TOT","NBA",-0.2,7,0,44,3,11,3,5,0,6,2,2,2,3,5,2,0,0,5,3,8,0.7
11668,"Troy Bell\belltr01","2003-04",23,"MEM","NBA",-0.2,6,0,34,4,18,4,14,0,4,3,3,3,1,4,4,1,0,6,6,11,0.9
11669,"Jonathan Bender\bendejo01","1999-00",19,"IND","NBA",-0.2,24,1,130,23,70,21,58,2,12,16,24,4,17,21,3,1,5,7,18,64,1.5
11670,"Jonathan Bender\bendejo01","2004-05",24,"IND","NBA",-0.2,7,0,93,16,40,15,35,1,5,3,6,5,9,14,4,1,2,10,9,36,3.43
11671,"Corey Benjamin\benjaco01","1998-99",20,"CHI","NBA",-0.2,31,1,320,44,117,41,103,3,14,27,40,15,25,40,10,11,8,21,46,118,2.84
11672,"Corey Benjamin\benjaco01","1999-00",21,"CHI","NBA",-0.2,48,10,862,145,350,114,261,31,89,49,82,21,67,88,54,31,22,74,122,370,6.03
11673,"Dairis Bertāns\bertada02","2018-19",29,"NOP","NBA",-0.2,12,0,167,12,47,2,13,10,34,0,0,2,7,9,10,1,0,2,7,34,1.46
11674,"Vander Blue\blueva01","2014-15",22,"LAL","NBA",-0.2,2,1,74,9,30,7,20,2,10,2,5,2,7,9,8,3,0,6,4,22,7.8
11675,"Manute Bol\bolma01","1993-94",31,"TOT","NBA",-0.2,14,0,116,4,19,4,16,0,3,0,0,3,15,18,1,2,16,5,13,8,1.24
11676,"Melvin Booker\bookeme01","1995-96",23,"HOU","NBA",-0.2,11,0,131,16,50,13,31,3,19,9,11,1,8,9,21,5,1,12,18,44,3.51
11677,"Avery Bradley\bradlav01","2017-18",27,"TOT","NBA",-0.2,46,46,1433,259,625,184,422,75,203,63,82,22,94,116,94,51,8,101,92,656,10.51
11678,"A.J. Bramlett\bramlaj01","1999-00",23,"CLE","NBA",-0.2,8,0,61,4,21,4,21,0,0,0,0,12,10,22,0,1,0,3,13,8,0.59
11679,"Tim Breaux\breauti01","1995-96",25,"HOU","NBA",-0.2,54,4,570,59,161,44,115,15,46,28,45,22,38,60,24,11,8,30,42,161,2.27
11680,"Corey Brewer\breweco01","2007-08",21,"MIN","NBA",-0.2,79,35,1803,182,486,175,450,7,36,88,110,82,210,292,111,76,25,89,188,459,5.96
11681,"Kevin Brooks\brookke01","1993-94",24,"DEN","NBA",-0.2,34,0,190,36,99,32,76,4,23,9,10,5,16,21,3,0,2,12,19,85,1.22
11682,"Bobby Brown\brownbo02","2017-18",33,"HOU","NBA",-0.2,20,0,115,19,58,8,18,11,40,1,2,0,7,7,11,4,0,9,6,50,1.56
11683,"Damone Brown\brownda02","2004-05",25,"WAS","NBA",-0.2,14,0,152,23,62,19,51,4,11,4,9,10,18,28,14,1,6,15,17,54,3.14
11684,"Damone Brown\brownda02","2002-03",23,"TOR","NBA",-0.2,5,3,115,11,35,11,33,0,2,6,8,3,12,15,3,1,0,6,14,28,3.24
11685,"Ernest Brown\browner01","2001-02",22,"MIA","NBA",-0.2,3,0,21,1,6,1,6,0,0,1,4,1,5,6,0,0,1,3,4,3,0.37
11686,"Lorenzo Brown\brownlo01","2015-16",25,"PHO","NBA",-0.2,8,0,61,8,25,7,17,1,8,3,4,0,7,7,11,3,1,9,4,20,2.44
11687,"Tierre Brown\brownti01","2003-04",24,"NOH","NBA",-0.2,3,0,17,2,4,2,4,0,0,2,4,0,1,1,2,0,0,7,1,6,1.67
11688,"Rick Brunson\brunsri01","2000-01",28,"TOT","NBA",-0.2,22,0,208,18,54,16,40,2,14,8,15,5,16,21,31,8,1,17,21,46,2.34
11689,"Rick Brunson\brunsri01","1998-99",26,"NYK","NBA",-0.2,17,0,95,6,21,6,16,0,5,5,18,3,7,10,19,9,0,12,8,17,1.52
11690,"Rodney Buford\buforro01","2003-04",26,"SAC","NBA",-0.2,22,0,141,19,56,19,54,0,2,3,6,6,9,15,7,6,1,4,9,41,1.17
11691,"Kevin Burleson\burleke01","2005-06",26,"CHA","NBA",-0.2,39,1,340,22,88,12,34,10,54,16,17,4,22,26,48,26,2,25,63,70,2.26
11692,"Junior Burrough\burroju01","1995-96",23,"BOS","NBA",-0.2,61,3,495,64,170,64,170,0,0,61,93,45,64,109,15,15,10,40,74,189,2.6
11693,"Mitchell Butler\butlemi02","1995-96",25,"WSB","NBA",-0.2,61,3,858,88,229,75,169,13,60,48,83,29,89,118,67,41,12,67,104,237,3.96
11694,"Rasual Butler\butlera01","2011-12",32,"TOR","NBA",-0.2,34,14,453,41,133,20,56,21,77,7,12,6,60,66,19,7,5,15,39,110,2.4
11695,"Will Bynum\bynumwi01","2011-12",29,"DET","NBA",-0.2,36,0,514,74,194,67,165,7,29,49,64,10,46,56,66,23,3,54,61,204,5.15
11696,"Will Bynum\bynumwi01","2014-15",32,"WAS","NBA",-0.2,7,0,67,10,31,10,22,0,9,2,4,2,4,6,18,1,1,8,9,22,2.89
11697,"Anthony Carter\cartean01","2002-03",27,"MIA","NBA",-0.2,49,26,912,83,233,83,225,0,8,33,50,12,71,83,203,45,5,81,70,199,5.84
11698,"Lionel Chalmers\chalmli01","2004-05",24,"LAC","NBA",-0.2,36,0,433,42,125,30,76,12,49,15,24,4,27,31,51,13,0,24,30,111,2.72
11699,"Randolph Childress\childra01","1996-97",24,"TOT","NBA",-0.2,23,0,155,14,40,9,21,5,19,6,8,1,5,6,17,9,0,18,16,39,1.7
11700,"Marquese Chriss\chrisma01","2018-19",21,"TOT","NBA",-0.2,43,2,499,67,180,51,108,16,72,32,45,40,102,142,22,17,11,36,81,182,4.06
11701,"Derrick Coleman\colemde01","1995-96",28,"PHI","NBA",-0.2,11,11,294,48,118,41,97,7,21,20,32,13,59,72,31,4,10,28,30,123,10.57
11702,"Jason Collins\collija04","2008-09",30,"MIN","NBA",-0.2,31,22,422,22,70,22,70,0,0,13,28,28,42,70,11,9,13,12,73,57,2.08
11703,"Sherron Collins\collish01","2010-11",23,"CHA","NBA",-0.2,20,0,66,7,25,5,15,2,10,1,1,0,5,5,8,2,0,4,2,17,0.6
11704,"Pat Connaughton\connapa01","2015-16",23,"POR","NBA",-0.2,34,0,143,13,49,8,28,5,21,5,5,11,21,32,10,2,0,10,6,36,0.84
11705,"Will Conroy\conrowi01","2012-13",30,"MIN","NBA",-0.2,4,0,20,0,9,0,6,0,3,1,2,1,0,1,0,0,0,0,1,1,-1.32
11706,"Brian Cook\cookbr01","2009-10",29,"HOU","NBA",-0.2,15,0,44,7,23,5,14,2,9,5,7,1,8,9,1,0,2,6,5,21,0.84
11707,"Daequan Cook\cookda02","2012-13",25,"TOT","NBA",-0.2,49,1,441,51,167,25,76,26,91,9,12,7,54,61,19,8,7,15,26,137,1.83
11708,"Omar Cook\cookom01","2003-04",22,"POR","NBA",-0.2,17,0,139,7,27,7,26,0,1,0,0,3,3,6,24,10,0,10,14,14,1.59
11709,"Charles Cooke\cookech01","2017-18",23,"NOP","NBA",-0.2,13,0,38,2,14,1,6,1,8,1,2,0,2,2,1,1,0,1,0,6,-0.07
11710,"William Cunningham\cunniwi01","1998-99",24,"TOT","NBA",-0.2,16,6,162,3,18,3,18,0,0,0,2,13,15,28,1,1,11,5,30,6,0.9
11711,"Michael Curry\currymi01","1993-94",25,"PHI","NBA",-0.2,10,0,43,3,14,3,12,0,2,3,4,0,1,1,1,1,0,3,6,9,0.21
11712,"DeSagana Diop\diopde01","2011-12",30,"CHA","NBA",-0.2,27,9,325,15,42,15,42,0,0,1,6,33,52,85,23,6,13,19,36,31,2.62
11713,"DeSagana Diop\diopde01","2002-03",21,"CLE","NBA",-0.2,80,1,943,54,154,54,154,0,0,11,30,63,152,215,43,33,81,56,148,119,2.89
11714,"Bryce Drew\drewbr01","2003-04",29,"NOH","NBA",-0.2,15,0,78,4,18,3,11,1,7,3,3,0,6,6,13,4,0,8,1,12,1.1
11715,"Nate Driggers\driggna01","1996-97",23,"BOS","NBA",-0.2,15,0,132,13,43,13,34,0,9,10,14,12,10,22,6,3,2,6,10,36,1.79
11716,"Kevin Duckworth\duckwke01","1996-97",32,"LAC","NBA",-0.2,26,22,384,45,103,42,99,3,4,11,16,23,37,60,16,9,11,33,63,104,3.84
11717,"Pat Durham\durhapa01","1992-93",25,"GSW","NBA",-0.2,5,1,78,6,25,6,25,0,0,9,12,5,9,14,4,1,1,7,6,21,2.96
11718,"Acie Earl\earlac01","1994-95",24,"BOS","NBA",-0.2,30,3,208,26,68,26,68,0,0,14,29,19,26,45,2,6,8,14,39,66,1.79
11719,"Cleanthony Early\earlycl01","2015-16",24,"NYK","NBA",-0.2,17,2,154,12,40,8,25,4,15,3,4,4,22,26,6,2,3,9,16,31,1.54
11720,"James Edwards\edwarja01","1995-96",40,"CHI","NBA",-0.2,28,0,274,41,110,41,110,0,0,16,26,15,25,40,11,1,8,21,61,98,2.28
11721,"Kevin Edwards\edwarke01","1996-97",31,"NJN","NBA",-0.2,32,0,477,69,183,54,140,15,43,37,43,9,34,43,57,17,4,49,34,190,5.12
11722,"Henry Ellenson\ellenhe01","2016-17",20,"DET","NBA",-0.2,19,2,146,23,64,13,29,10,35,4,8,8,33,41,7,1,1,14,6,60,2.41
11723,"Jawun Evans\evansja01","2017-18",21,"LAC","NBA",-0.2,48,4,778,89,253,74,199,15,54,38,49,9,75,84,100,36,6,44,97,231,4.77
11724,"Jawun Evans\evansja01","2018-19",22,"TOT","NBA",-0.2,8,0,65,3,14,3,11,0,3,0,0,1,11,12,10,3,0,6,8,6,1.53
11725,"Duane Ferrell\ferredu01","1998-99",33,"GSW","NBA",-0.2,8,0,46,1,14,1,14,0,0,3,4,5,1,6,0,1,1,1,4,5,-0.09
11726,"Sleepy Floyd\floydsl01","1994-95",34,"NJN","NBA",-0.2,48,1,831,71,212,46,124,25,88,30,43,8,46,54,126,13,6,51,73,197,4.14
11727,"Isaac Fontaine\fontais01","2001-02",26,"MEM","NBA",-0.2,6,0,75,3,14,2,9,1,5,4,6,0,5,5,4,0,0,4,6,11,1.07
11728,"Richie Frahm\frahmri01","2007-08",30,"LAC","NBA",-0.2,10,2,163,20,54,13,29,7,25,0,2,4,10,14,8,2,0,6,7,47,2.96
11729,"Jimmer Fredette\fredeji01","2018-19",29,"PHO","NBA",-0.2,6,0,65,8,29,8,16,0,13,6,6,1,6,7,8,3,0,5,5,22,2.72
11730,"Francisco García\garcifr01","2014-15",33,"HOU","NBA",-0.2,14,0,200,17,63,7,18,10,45,1,4,3,14,17,15,9,5,10,20,45,2.59
11731,"Thomas Gardner\gardnth01","2008-09",23,"ATL","NBA",-0.2,16,0,98,9,36,5,13,4,23,2,4,0,7,7,2,4,1,3,4,24,0.66
11732,"Patricio Garino\garinpa01","2016-17",23,"ORL","NBA",-0.2,5,0,43,0,7,0,2,0,5,0,0,1,6,7,0,0,0,3,4,0,-0.42
11733,"Diante Garrett\garredi02","2012-13",24,"PHO","NBA",-0.2,19,0,149,16,49,13,34,3,15,5,10,5,10,15,31,10,0,16,5,40,2.52
11734,"Pat Garrity\garripa01","2007-08",31,"ORL","NBA",-0.2,31,0,284,27,80,19,43,8,37,4,5,9,35,44,13,6,1,17,35,66,1.74
11735,"Gordan Giriček\giricgo01","2005-06",28,"UTA","NBA",-0.2,37,36,956,166,383,148,324,18,59,43,57,15,55,70,63,16,4,63,87,393,7.48
11736,"Andreas Glyniadakis\glynian01","2006-07",25,"SEA","NBA",-0.2,13,4,81,8,17,8,17,0,0,1,2,2,6,8,1,0,0,9,19,17,0.91
11737,"Ryan Gomes\gomesry01","2011-12",29,"LAC","NBA",-0.2,32,2,425,31,95,27,66,4,29,8,11,14,47,61,12,16,0,15,34,74,2.11
11738,"Devin Gray\grayde01","1996-97",24,"TOT","NBA",-0.2,6,0,49,8,26,8,26,0,0,2,5,6,8,14,2,4,0,5,11,18,2.13
11739,"Josh Gray\grayjo01","2017-18",24,"PHO","NBA",-0.2,5,0,86,11,41,8,28,3,13,7,11,2,8,10,12,8,2,7,8,32,5.58
11740,"Orien Greene\greenor01","2006-07",24,"IND","NBA",-0.2,41,0,254,23,62,21,51,2,11,15,25,12,32,44,22,17,4,28,38,63,1.89
11741,"Orien Greene\greenor01","2007-08",25,"SAC","NBA",-0.2,7,2,61,3,11,3,10,0,1,0,0,0,6,6,3,3,1,7,9,6,1.1
11742,"Eddie Griffin\griffed01","2006-07",24,"MIN","NBA",-0.2,13,0,92,7,27,7,26,0,1,4,5,7,18,25,4,0,7,6,8,18,1.48
11743,"Andrés Guibert\guibean01","1993-94",25,"MIN","NBA",-0.2,5,0,33,6,20,6,20,0,0,3,6,10,6,16,2,0,1,6,6,15,2.14
11744,"Marcus Haislip\haislma01","2004-05",24,"IND","NBA",-0.2,9,0,106,13,38,13,37,0,1,6,11,5,10,15,3,2,2,6,15,32,2.23
11745,"Anfernee Hardaway\hardaan01","2005-06",34,"NYK","NBA",-0.2,4,0,72,4,14,4,13,0,1,2,2,0,10,10,8,2,0,6,7,10,3.35
11746,"Al Harrington\harrial01","1998-99",18,"IND","NBA",-0.2,21,0,160,18,56,18,51,0,5,9,15,20,19,39,5,4,2,11,26,45,1.67
11747,"Junior Harrington\harriju01","2006-07",26,"MEM","NBA",-0.2,29,8,543,57,137,50,111,7,26,31,46,12,56,68,89,21,5,52,79,152,6.44
11748,"Manny Harris\harrima01","2016-17",27,"DAL","NBA",-0.2,4,0,25,3,15,3,13,0,2,2,4,3,6,9,2,0,0,2,1,8,0.72
11749,"David Harrison\harrida01","2006-07",24,"IND","NBA",-0.2,24,2,190,30,58,30,58,0,0,11,22,9,33,42,6,5,12,26,47,71,3.02
11750,"Antonio Harvey\harvean01","1993-94",23,"LAL","NBA",-0.2,27,6,247,29,79,29,79,0,0,12,26,26,33,59,5,8,19,17,39,70,2.56
11751,"Kirk Haston\hastoki01","2001-02",22,"CHH","NBA",-0.2,15,0,77,11,39,11,36,0,3,4,8,5,15,20,5,0,1,3,9,26,0.91
11752,"Cedric Henderson\hendece02","1999-00",24,"CLE","NBA",-0.2,61,7,1107,129,326,128,311,1,15,69,104,34,106,140,55,39,17,68,99,328,4.64
11753,"J.R. Henderson\hendejr01","1998-99",22,"VAN","NBA",-0.2,30,0,331,35,96,33,91,2,5,25,45,20,27,47,22,9,4,18,29,97,2.73
11754,"Carl Herrera\herreca01","1995-96",29,"SAS","NBA",-0.2,44,6,393,40,97,40,96,0,1,5,17,30,51,81,16,9,8,29,61,85,1.97
11755,"Darrun Hilliard\hillida01","2016-17",23,"DET","NBA",-0.2,39,1,381,47,126,35,80,12,46,21,28,2,31,33,33,11,2,28,39,127,2.65
11756,"Robert Hite\hitero01","2006-07",23,"MIA","NBA",-0.2,12,0,136,19,60,14,37,5,23,8,12,4,12,16,8,3,2,6,8,51,2.62
11757,"Darington Hobson\hobsoda01","2011-12",24,"MIL","NBA",-0.2,5,0,39,2,13,2,7,0,6,0,0,0,3,3,6,0,0,2,1,4,0.22
11758,"Julius Hodge\hodgeju01","2005-06",22,"DEN","NBA",-0.2,14,0,33,5,13,5,13,0,0,3,8,5,2,7,6,2,0,8,7,13,0.92
11759,"John Holland\hollajo02","2017-18",29,"CLE","NBA",-0.2,24,0,174,17,59,6,23,11,36,9,13,6,18,24,5,7,2,8,10,54,1.64
11760,"Josh Howard\howarjo01","2010-11",30,"WAS","NBA",-0.2,18,10,409,58,162,51,133,7,29,29,47,18,56,74,24,13,5,20,34,152,6.53
11761,"Troy Hudson\hudsotr01","1999-00",23,"LAC","NBA",-0.2,62,38,1592,204,541,144,348,60,193,77,95,28,120,148,242,43,0,108,65,545,8.26
11762,"Mile Ilić\ilicmi01","2006-07",22,"NJN","NBA",-0.2,5,0,6,0,3,0,3,0,0,0,0,0,1,1,0,0,0,3,1,0,-0.34
11763,"Cedric Jackson\jacksce01","2009-10",23,"TOT","NBA",-0.2,12,0,74,6,20,5,14,1,6,7,12,2,6,8,14,3,2,11,7,20,1.98
11764,"Jermaine Jackson\jacksje01","1999-00",23,"DET","NBA",-0.2,7,0,73,1,11,1,10,0,1,5,8,1,10,11,4,3,0,7,7,7,1.24
11765,"Stephen Jackson\jacksst02","2013-14",35,"LAC","NBA",-0.2,9,0,107,6,26,5,12,1,14,2,4,2,8,10,5,6,1,6,11,15,1.4
11766,"Damion James\jamesda01","2011-12",24,"NJN","NBA",-0.2,7,7,170,13,35,13,34,0,1,8,12,7,26,33,3,7,7,12,17,34,5.76
11767,"Jerome James\jamesje01","2006-07",31,"NYK","NBA",-0.2,41,11,273,33,79,33,79,0,0,10,18,21,45,66,3,6,15,23,73,76,1.85
11768,"Britton Johnsen\johnsbr01","2004-05",25,"IND","NBA",-0.2,6,1,87,6,22,6,18,0,4,0,0,5,5,10,4,1,0,3,10,12,1.13
11769,"Anthony Johnson\johnsan02","2000-01",26,"TOT","NBA",-0.2,53,0,511,53,152,52,147,1,5,23,33,10,34,44,78,23,6,34,62,130,2.65
11770,"Dave Johnson\johnsda01","1993-94",23,"CHI","NBA",-0.2,17,0,119,17,54,17,53,0,1,13,21,9,7,16,4,4,0,9,7,47,1.53
11771,"Orlando Johnson\johnsor01","2015-16",26,"TOT","NBA",-0.2,7,1,101,9,34,7,24,2,10,6,8,4,11,15,2,3,3,4,9,26,2.5
11772,"Darius Johnson-Odom\johnsda03","2013-14",24,"PHI","NBA",-0.2,3,0,15,0,7,0,4,0,3,0,2,0,2,2,1,1,0,2,3,0,-1.07
11773,"Jumaine Jones\jonesju01","2006-07",27,"PHO","NBA",-0.2,18,0,138,14,51,4,19,10,32,2,2,6,17,23,1,5,1,7,19,40,1.42
11774,"Reggie Jordan\jordare01","1999-00",32,"WAS","NBA",-0.2,36,0,243,17,53,17,52,0,1,7,13,16,25,41,32,12,2,19,29,41,1.68
11775,"Thomas Jordan\jordath01","1992-93",24,"PHI","NBA",-0.2,4,0,106,18,41,18,41,0,0,8,17,5,14,19,3,3,5,12,14,44,8.78
11776,"Jason Kapono\kaponja01","2010-11",29,"PHI","NBA",-0.2,24,2,112,7,28,6,20,1,8,1,2,3,8,11,4,2,1,2,4,16,0.36
11777,"Coby Karl\karlco01","2009-10",26,"TOT","NBA",-0.2,7,1,113,11,32,9,21,2,11,4,6,4,14,18,15,3,1,10,14,28,4.37
11778,"Tim Kempton\kemptti01","1996-97",33,"SAS","NBA",-0.2,10,0,59,1,5,1,5,0,0,2,2,3,5,8,2,1,1,7,4,4,0.72
11779,"Stacey King\kingst01","1995-96",29,"MIA","NBA",-0.2,15,0,156,17,36,17,36,0,0,4,8,9,14,23,2,7,2,18,39,38,2.47
11780,"Negele Knight\knighne01","1994-95",27,"TOT","NBA",-0.2,47,17,708,85,214,74,186,11,28,18,25,21,40,61,127,21,5,49,70,199,4.64
11781,"Maciej Lampe\lampema01","2005-06",20,"TOT","NBA",-0.2,6,0,28,2,11,2,11,0,0,0,2,4,5,9,2,0,0,3,2,4,0.22
11782,"Priest Lauderdale\laudepr01","1996-97",23,"ATL","NBA",-0.2,35,0,180,49,89,49,88,0,1,13,23,16,27,43,12,1,9,37,39,111,2.78
11783,"Alton Lister\listeal01","1992-93",34,"GSW","NBA",-0.2,20,9,174,19,42,19,42,0,0,7,13,15,29,44,5,0,9,18,40,45,2.41
11784,"Don MacLean\macledo01","1997-98",28,"NJN","NBA",-0.2,9,0,42,1,10,0,8,1,2,0,0,3,2,5,0,0,0,2,7,3,-0.18
11785,"Mark Macon\maconma01","1998-99",29,"DET","NBA",-0.2,7,3,69,4,20,3,17,1,3,0,0,3,2,5,4,5,1,6,6,9,1.01
11786,"Jamaal Magloire\magloja01","2011-12",33,"TOR","NBA",-0.2,34,1,374,17,45,17,45,0,0,7,27,25,88,113,6,4,10,22,66,41,2.02
11787,"Jeff Malone\malonje01","1995-96",34,"TOT","NBA",-0.2,32,3,510,76,193,71,177,5,16,29,32,8,32,40,26,16,0,22,25,186,4.07
11788,"Rich Manning\manniri01","1995-96",25,"VAN","NBA",-0.2,29,0,311,49,113,49,112,0,1,9,14,16,39,55,7,3,6,17,37,107,2.74
11789,"Roy Marble\marblro01","1993-94",27,"DEN","NBA",-0.2,5,0,32,2,12,2,12,0,0,0,3,3,5,8,1,0,2,3,1,4,0.1
11790,"Damir Markota\markoda01","2006-07",21,"MIL","NBA",-0.2,30,0,170,19,52,13,36,6,16,7,11,11,20,31,6,3,1,15,22,51,1.36
11791,"Sean Marks\marksse01","2002-03",27,"MIA","NBA",-0.2,23,0,223,22,59,22,58,0,1,10,15,8,27,35,3,5,6,14,37,54,1.95
11792,"Kendall Marshall\marshke01","2012-13",21,"PHO","NBA",-0.2,48,3,702,56,151,33,78,23,73,8,14,4,38,42,143,22,4,57,48,143,4.15
11793,"Cartier Martin\martica01","2014-15",30,"DET","NBA",-0.2,23,0,198,15,53,9,20,6,33,0,0,0,20,20,11,3,1,5,20,36,1.06
11794,"Cuonzo Martin\marticu01","1996-97",25,"MIL","NBA",-0.2,3,0,13,0,7,0,5,0,2,0,0,1,0,1,1,0,0,1,1,0,-1.27
11795,"Darrick Martin\martida01","2001-02",30,"DAL","NBA",-0.2,3,0,22,0,10,0,8,0,2,1,2,0,1,1,3,2,0,1,4,1,-0.63
11796,"Desmond Mason\masonde01","2005-06",28,"NOK","NBA",-0.2,70,55,2102,275,690,274,684,1,6,206,302,64,234,298,66,42,17,113,136,757,8.07
11797,"Jason Maxiell\maxieja01","2005-06",22,"DET","NBA",-0.2,26,0,159,23,54,23,54,0,0,14,42,12,16,28,3,4,5,11,14,60,1.58
11798,"Walter McCarty\mccarwa01","1999-00",25,"BOS","NBA",-0.2,61,5,879,78,230,44,120,34,110,39,54,33,77,110,70,24,23,67,83,229,3.71
11799,"Amal McCaskill\mccasam01","1996-97",23,"ORL","NBA",-0.2,17,1,109,10,32,10,30,0,2,8,12,4,18,22,7,3,5,11,7,28,1.66
11800,"Dominic McGuire\mcguido01","2009-10",24,"TOT","NBA",-0.2,51,2,307,19,52,19,52,0,0,0,7,23,56,79,11,5,4,17,35,38,1.05
11801,"Gal Mekel\mekelga01","2014-15",26,"NOP","NBA",-0.2,4,0,43,3,20,3,17,0,3,0,0,0,1,1,13,2,0,2,1,6,1.18
11802,"Darko Miličić\milicda01","2003-04",18,"DET","NBA",-0.2,34,0,159,17,65,17,64,0,1,14,24,11,32,43,7,7,15,13,33,48,1.32
11803,"Darko Miličić\milicda01","2004-05",19,"DET","NBA",-0.2,37,2,254,25,76,25,76,0,0,17,24,3,40,43,7,2,17,16,31,67,1.54
11804,"Terry Mills\millste01","2000-01",33,"IND","NBA",-0.2,14,0,113,11,34,8,17,3,17,0,0,4,17,21,5,3,1,10,20,25,1.51
11805,"Sergei Monia\moniase01","2005-06",22,"TOT","NBA",-0.2,26,15,343,29,87,20,53,9,34,10,14,11,41,52,19,7,5,12,41,77,2.72
11806,"Luis Montero\montelu01","2015-16",22,"POR","NBA",-0.2,12,0,42,5,19,4,10,1,9,3,4,0,4,4,1,0,0,4,1,14,0.38
11807,"Darius Morris\morrida01","2011-12",21,"LAL","NBA",-0.2,19,0,169,18,42,14,33,4,9,6,9,2,14,16,21,2,0,19,16,46,2.41
11808,"Marcus Morris\morrima03","2011-12",22,"HOU","NBA",-0.2,17,0,126,16,54,14,37,2,17,6,8,5,11,16,3,2,2,4,12,40,1.16
11809,"Randolph Morris\morrira01","2007-08",22,"NYK","NBA",-0.2,18,2,181,21,58,21,58,0,0,14,29,12,25,37,2,4,2,9,37,56,2.19
11810,"Byron Mullens\mulleby01","2010-11",21,"OKC","NBA",-0.2,13,0,85,9,28,9,28,0,0,7,14,6,18,24,0,2,3,8,11,25,1.53
11811,"Tracy Murray\murratr01","2002-03",31,"LAL","NBA",-0.2,31,0,193,23,71,15,33,8,38,7,9,5,18,23,12,5,3,14,22,61,1.43
11812,"Demetris Nichols\nichode01","2007-08",23,"TOT","NBA",-0.2,14,0,44,6,23,3,10,3,13,0,0,0,5,5,1,0,3,4,4,15,0.44
11813,"Andrés Nocioni\nocioan01","2011-12",32,"PHI","NBA",-0.2,11,1,56,5,20,4,14,1,6,6,11,1,13,14,1,1,1,5,4,17,1
11814,"Moochie Norris\norrimo01","1998-99",25,"SEA","NBA",-0.2,12,0,140,13,40,7,25,6,15,6,16,4,16,20,24,7,0,16,17,38,3.58
11815,"Michael Olowokandi\olowomi01","2002-03",27,"LAC","NBA",-0.2,36,36,1369,186,436,186,436,0,0,69,105,57,271,328,47,18,79,98,110,441,12.03
11816,"Doug Overton\overtdo01","2001-02",32,"LAC","NBA",-0.2,18,0,130,14,44,7,17,7,27,4,7,1,11,12,13,3,1,12,10,39,1.68
11817,"Doug Overton\overtdo01","1997-98",28,"PHI","NBA",-0.2,23,2,277,24,63,24,60,0,3,14,16,2,12,14,37,8,1,23,34,62,2.91
11818,"Andre Owens\owensan01","2005-06",25,"UTA","NBA",-0.2,23,2,210,27,74,24,58,3,16,12,18,11,10,21,8,5,0,13,25,69,1.94
11819,"Jannero Pargo\pargoja01","2012-13",33,"TOT","NBA",-0.2,32,0,507,78,212,39,96,39,116,12,13,10,25,35,67,18,3,41,42,207,5.33
11820,"Gary Payton\paytoga02","2016-17",24,"MIL","NBA",-0.2,6,0,99,8,22,7,13,1,9,3,5,0,12,12,13,3,4,10,9,20,4.45
11821,"Quincy Pondexter\pondequ01","2017-18",29,"CHI","NBA",-0.2,23,1,196,14,49,11,27,3,22,14,17,8,19,27,9,8,2,11,24,45,1.81
11822,"Josh Powell\poweljo01","2010-11",28,"ATL","NBA",-0.2,54,0,653,94,208,94,207,0,1,36,45,49,86,135,22,5,5,53,78,224,3.52
11823,"Ronnie Price\pricero01","2012-13",29,"POR","NBA",-0.2,39,0,510,39,120,29,81,10,39,17,24,13,31,44,73,26,3,34,61,105,3.35
11824,"Chris Quinn\quinnch01","2012-13",29,"CLE","NBA",-0.2,7,0,78,4,16,4,11,0,5,2,2,1,1,2,9,3,0,6,4,10,1.5
11825,"Andy Rautins\rautian01","2010-11",24,"NYK","NBA",-0.2,5,0,24,3,7,2,3,1,4,1,2,0,1,1,3,1,0,7,0,8,1.48
11826,"Dino Rađa\radjadi01","1996-97",29,"BOS","NBA",-0.2,25,25,874,149,339,149,338,0,1,51,71,44,167,211,48,23,48,70,76,349,13.52
11827,"Justin Reed\reedju01","2006-07",25,"MIN","NBA",-0.2,41,3,318,40,107,40,107,0,0,26,30,15,31,46,17,5,3,22,44,106,2.02
11828,"Terrence Rencher\renchte01","1995-96",22,"TOT","NBA",-0.2,36,1,405,33,100,24,71,9,29,31,46,9,35,44,54,16,2,43,37,106,3.22
11829,"Jeremy Richardson\richaje01","2008-09",24,"ORL","NBA",-0.2,12,0,93,14,49,8,32,6,17,3,6,1,13,14,3,0,0,3,6,37,1.23
11830,"Jamal Robinson\robinja03","2000-01",27,"MIA","NBA",-0.2,6,0,72,3,22,3,20,0,2,0,0,3,8,11,2,6,0,3,7,6,0.6
11831,"Sergio Rodríguez\rodrise01","2007-08",21,"POR","NBA",-0.2,72,0,628,69,196,52,138,17,58,25,38,13,45,58,123,24,0,53,57,180,2.76
11832,"Derrick Rose\rosede01","2013-14",25,"CHI","NBA",-0.2,10,10,311,58,164,42,117,16,47,27,32,9,23,32,43,5,1,34,15,159,11.4
11833,"Derrick Rose\rosede01","2017-18",29,"TOT","NBA",-0.2,25,7,420,81,186,74,156,7,30,40,46,13,22,35,37,7,4,35,16,209,6.34
11834,"Kareem Rush\rushka01","2005-06",25,"CHA","NBA",-0.2,47,25,1111,181,469,124,305,57,164,55,77,18,85,103,50,38,13,65,79,474,7.08
11835,"Kevin Salvadori\salvake01","1997-98",27,"SAC","NBA",-0.2,16,0,87,1,13,1,13,0,0,3,6,5,15,20,3,0,11,5,12,5,0.81
11836,"Cheikh Samb\sambch01","2008-09",24,"TOT","NBA",-0.2,18,0,83,6,32,6,29,0,3,3,7,10,14,24,1,3,10,3,7,15,0.76
11837,"Kenny Satterfield\satteke01","2001-02",20,"DEN","NBA",-0.2,36,4,560,73,199,66,172,7,27,36,46,17,35,52,108,31,1,53,43,189,5.64
11838,"Predrag Savović\savovpr01","2002-03",26,"DEN","NBA",-0.2,27,0,256,29,93,25,67,4,26,21,29,9,16,25,22,14,1,21,33,83,2.46
11839,"Dwayne Schintzius\schindw01","1998-99",30,"BOS","NBA",-0.2,16,0,67,4,16,4,16,0,0,3,4,7,12,19,8,0,3,10,17,11,1.02
11840,"Josh Selby\selbyjo01","2012-13",21,"MEM","NBA",-0.2,10,0,59,6,22,5,16,1,6,7,11,0,5,5,4,2,0,7,7,20,1.22
11841,"Kevin Séraphin\serapke01","2015-16",26,"NYK","NBA",-0.2,48,0,526,84,205,84,203,0,2,19,23,31,95,126,47,8,36,43,67,187,4
11842,"Ha Seung-Jin\seungha01","2004-05",19,"POR","NBA",-0.2,19,0,104,10,23,10,23,0,0,6,11,6,12,18,2,1,5,12,21,26,1.32
11843,"Cedric Simmons\simmoce01","2007-08",22,"TOT","NBA",-0.2,14,0,87,4,14,4,14,0,0,0,10,6,12,18,0,2,5,6,8,8,0.61
11844,"Kobi Simmons\simmoko01","2017-18",20,"MEM","NBA",-0.2,32,12,643,80,189,69,150,11,39,25,25,14,36,50,68,18,5,44,61,196,5.78
11845,"Peyton Siva\sivape01","2013-14",23,"DET","NBA",-0.2,24,0,224,18,57,11,32,7,25,11,15,2,12,14,34,9,1,18,27,54,2.45
11846,"Charles Smith\smithch02","1995-96",28,"MIN","NBA",-0.2,8,0,39,3,10,3,7,0,3,0,2,0,5,5,6,1,0,5,7,6,0.82
11847,"Doug Smith\smithdo03","1995-96",26,"BOS","NBA",-0.2,17,2,92,14,39,14,39,0,0,5,8,12,10,22,4,3,0,11,21,33,1.45
11848,"J.R. Smith\smithjr01","2018-19",33,"CLE","NBA",-0.2,11,4,222,27,79,15,40,12,39,8,10,0,18,18,21,11,3,11,19,74,5.79
11849,"Tony Smith\smithto02","2000-01",32,"ATL","NBA",-0.2,6,0,78,8,23,8,21,0,2,1,2,2,1,3,10,7,0,9,12,17,3.15
11850,"Kirk Snyder\snydeki01","2004-05",21,"UTA","NBA",-0.2,68,7,906,122,328,92,243,30,85,64,96,50,71,121,36,26,19,58,116,338,3.78
11851,"Lance Stephenson\stephla01","2010-11",20,"IND","NBA",-0.2,12,0,115,13,39,13,34,0,5,11,14,1,17,18,21,4,0,16,14,37,3.3
11852,"DeShawn Stevenson\stevede01","2001-02",20,"UTA","NBA",-0.2,67,23,1134,143,371,141,346,2,25,37,53,44,87,131,116,29,24,68,82,325,4.41
11853,"D.J. Strawberry\strawdj01","2007-08",22,"PHO","NBA",-0.2,33,0,270,29,92,23,67,6,25,9,19,9,19,28,30,12,6,11,36,73,1.96
11854,"Rod Strickland\stricro02","2004-05",38,"HOU","NBA",-0.2,16,2,196,9,43,8,41,1,2,9,10,3,24,27,39,3,2,16,15,28,2.73
11855,"Caleb Swanigan\swanica01","2018-19",21,"TOT","NBA",-0.2,21,0,178,18,53,17,46,1,7,6,9,17,47,64,11,6,1,18,28,43,2.47
11856,"Robert Swift\swiftro01","2007-08",22,"SEA","NBA",-0.2,8,4,98,6,17,6,17,0,0,2,2,6,12,18,1,5,6,10,16,14,2.7
11857,"Dragan Tarlać\tarladr01","2000-01",27,"CHI","NBA",-0.2,43,12,598,39,99,39,99,0,0,25,33,37,85,122,31,7,19,38,95,103,3.18
11858,"Donell Taylor\taylodo01","2006-07",24,"WAS","NBA",-0.2,47,1,369,56,140,53,123,3,17,11,21,14,39,53,45,17,3,25,34,126,2.51
11859,"Jeffery Taylor\tayloje03","2013-14",24,"CHA","NBA",-0.2,26,8,629,82,218,64,151,18,67,26,47,15,45,60,22,13,5,25,62,208,5.22
11860,"Jamel Thomas\thomaja01","2000-01",27,"NJN","NBA",-0.2,5,0,56,6,19,5,16,1,3,0,0,4,5,9,0,3,0,6,6,13,1.74
11861,"Kurt Thomas\thomaku01","1997-98",25,"DAL","NBA",-0.2,5,0,73,17,45,17,45,0,0,3,3,8,16,24,3,1,0,10,19,37,5
11862,"Malcolm Thomas\thomama01","2013-14",25,"TOT","NBA",-0.2,8,0,63,7,16,6,12,1,4,0,2,5,16,21,2,0,3,9,5,15,2.21
11863,"Tyrus Thomas\thomaty01","2012-13",26,"CHA","NBA",-0.2,26,2,360,48,136,45,128,3,8,26,31,16,44,60,19,14,15,17,51,125,4.18
11864,"Mychel Thompson\thompmy02","2011-12",23,"CLE","NBA",-0.2,5,3,95,7,24,3,13,4,11,0,0,0,5,5,7,2,1,5,8,18,2.72
11865,"Sedric Toney\toneyse01","1993-94",31,"CLE","NBA",-0.2,12,0,64,2,12,2,11,0,1,2,2,1,2,3,11,0,0,5,8,6,0.61
11866,"Gary Trent\trentga02","2018-19",20,"POR","NBA",-0.2,15,1,111,16,50,11,29,5,21,3,7,1,10,11,5,1,2,4,4,40,1.34
11867,"Jeff Trepagnier\trepaje01","2003-04",24,"DEN","NBA",-0.2,11,0,96,10,38,8,34,2,4,3,6,6,9,15,4,3,0,6,7,25,1.18
11868,"Jeff Trepagnier\trepaje01","2001-02",22,"CLE","NBA",-0.2,12,0,77,7,23,7,22,0,1,4,7,3,9,12,12,8,4,11,8,18,2.29
11869,"Jeremy Tyler\tylerje01","2011-12",20,"GSW","NBA",-0.2,42,23,568,88,209,88,208,0,1,29,52,54,86,140,16,16,20,36,84,205,4.33
11870,"Tyler Ulis\ulisty01","2017-18",22,"PHO","NBA",-0.2,71,43,1658,214,551,172,405,42,146,84,101,24,104,128,311,70,7,127,120,554,8.32
11871,"Loy Vaught\vaughlo01","1997-98",29,"LAC","NBA",-0.2,10,6,265,36,84,36,82,0,2,3,8,16,49,65,7,4,2,13,33,75,6.49
11872,"Dajuan Wagner\wagneda02","2004-05",21,"CLE","NBA",-0.2,11,0,102,18,55,13,29,5,26,3,4,0,2,2,13,5,0,9,15,44,2.47
11873,"Ben Wallace\wallabe01","1996-97",22,"WSB","NBA",-0.2,34,0,197,16,46,16,46,0,0,6,20,25,33,58,2,8,11,18,27,38,1.38
11874,"Luke Walton\waltolu01","2010-11",30,"LAL","NBA",-0.2,54,0,484,38,116,30,82,8,34,7,10,9,58,67,62,9,4,31,38,91,1.96
11875,"Charlie Ward\wardch01","1994-95",24,"NYK","NBA",-0.2,10,0,44,4,19,3,9,1,10,7,10,1,5,6,4,2,0,8,7,16,1.03
11876,"Yuta Watanabe\watanyu01","2018-19",24,"MEM","NBA",-0.2,15,0,174,15,51,13,35,2,16,7,10,4,27,31,8,4,1,6,11,39,2.05
11877,"Darryl Watkins\watkida01","2007-08",23,"SAC","NBA",-0.2,9,0,71,5,15,5,15,0,0,2,5,5,7,12,0,2,2,7,8,12,1.17
11878,"Earl Watson\watsoea01","2008-09",29,"OKC","NBA",-0.2,68,18,1776,174,453,154,368,20,85,80,106,36,147,183,391,50,11,156,137,448,8.75
11879,"Rodney White\whitero02","2001-02",21,"DET","NBA",-0.2,16,0,129,21,60,19,51,2,9,12,14,2,16,18,12,9,2,14,6,56,2.98
11880,"Chris Whitney\whitnch01","1994-95",23,"SAS","NBA",-0.2,25,0,179,14,47,11,28,3,19,11,11,4,9,13,28,4,0,18,34,42,1.74
11881,"C.J. Wilcox\wilcocj01","2016-17",26,"ORL","NBA",-0.2,22,0,108,8,31,5,16,3,15,2,2,4,8,12,12,2,1,6,8,21,0.84
11882,"Morlon Wiley\wileymo01","1993-94",27,"TOT","NBA",-0.2,16,0,158,9,29,6,19,3,10,0,0,0,10,10,23,15,0,17,21,21,2.46
11883,"Gerald Wilkins\wilkige01","1998-99",35,"ORL","NBA",-0.2,3,0,28,0,9,0,9,0,0,2,2,0,1,1,1,0,0,3,3,2,-1.07
11884,"Gerald Wilkins\wilkige01","1995-96",32,"VAN","NBA",-0.2,28,14,738,77,205,63,141,14,64,20,23,22,43,65,68,22,2,37,55,188,6.11
11885,"Brandon Williams\willibr01","2002-03",27,"ATL","NBA",-0.2,6,0,19,1,7,1,6,0,1,0,0,2,0,2,0,2,0,3,4,2,0.05
11886,"Frank Williams\willifr02","2004-05",24,"CHI","NBA",-0.2,9,0,71,3,20,3,16,0,4,0,0,2,4,6,11,2,3,3,9,6,0.82
11887,"Sean Williams\willise01","2009-10",23,"NJN","NBA",-0.2,20,0,227,21,49,21,48,0,1,10,19,21,25,46,1,8,19,20,41,52,3.15
11888,"Nate Wolters\woltena01","2014-15",23,"TOT","NBA",-0.2,21,0,247,20,57,20,50,0,7,2,6,8,26,34,21,8,2,13,18,42,2.2
11889,"Qyntel Woods\woodsqy01","2003-04",22,"POR","NBA",-0.2,62,8,673,88,237,78,208,10,29,38,60,46,90,136,46,20,14,52,88,224,3.24
11890,"Metta World Peace\artesro01","2016-17",37,"LAL","NBA",-0.2,25,2,160,19,68,10,30,9,38,10,16,5,15,20,11,10,2,7,18,57,1.67
11891,"Mahmoud Abdul-Rauf\abdulma02","1997-98",28,"SAC","NBA",-0.3,31,0,530,103,273,98,242,5,31,16,16,6,31,37,58,16,1,19,31,227,4.81
11892,"Maurice Ager\agerma01","2008-09",24,"NJN","NBA",-0.3,20,0,97,15,43,15,37,0,6,4,8,3,7,10,3,1,2,4,17,34,0.84
11893,"Maurice Ager\agerma01","2006-07",22,"DAL","NBA",-0.3,32,1,214,22,70,17,55,5,15,20,33,1,20,21,7,4,3,15,27,69,1.34
11894,"Cory Alexander\alexaco01","1998-99",25,"DEN","NBA",-0.3,36,4,778,97,260,67,155,30,105,37,44,7,67,74,119,35,5,69,77,261,7.4
11895,"Jerome Allen\allenje01","1995-96",23,"MIN","NBA",-0.3,41,0,362,36,105,26,72,10,33,26,36,5,20,25,49,21,5,34,42,108,2.77
11896,"James Anderson\anderja01","2015-16",26,"SAC","NBA",-0.3,51,15,721,67,178,44,92,23,86,22,29,13,73,86,41,21,14,42,54,179,3.38
11897,"Brandon Armstrong\armstbr01","2003-04",23,"NJN","NBA",-0.3,56,0,434,65,175,46,123,19,52,2,4,12,31,43,14,12,2,24,49,151,1.68
11898,"John Bagley\baglejo01","1992-93",32,"BOS","NBA",-0.3,10,0,97,9,25,9,24,0,1,5,6,1,6,7,20,2,0,17,11,23,2.75
11899,"Wade Baldwin\baldwwa01","2018-19",22,"POR","NBA",-0.3,16,0,94,10,33,8,24,2,9,8,11,2,13,15,12,1,2,14,11,30,1.66
11900,"Wade Baldwin\baldwwa01","2016-17",20,"MEM","NBA",-0.3,33,1,405,36,115,33,93,3,22,31,37,11,35,46,61,18,7,39,40,106,3.68
11901,"Steve Bardo\bardost01","1992-93",24,"DAL","NBA",-0.3,23,0,175,19,62,18,56,1,6,12,17,10,27,37,29,8,3,17,28,51,2.54
11902,"Earl Barron\barroea01","2006-07",25,"MIA","NBA",-0.3,28,0,203,24,83,24,82,0,1,17,18,19,22,41,5,6,4,11,21,65,1.6
11903,"Dragan Bender\bendedr01","2016-17",19,"PHO","NBA",-0.3,43,0,574,57,161,29,60,28,101,4,11,23,80,103,23,10,22,32,74,146,3.16
11904,"Elmer Bennett\benneel01","1995-96",25,"PHI","NBA",-0.3,8,0,66,4,17,4,17,0,0,3,4,1,4,5,8,1,1,7,6,11,1.2
11905,"Chauncey Billups\billuch01","2013-14",37,"DET","NBA",-0.3,19,7,309,24,79,10,31,14,48,10,12,4,24,28,42,8,1,25,25,72,3.94
11906,"Donnie Boyce\boycedo01","1996-97",23,"ATL","NBA",-0.3,22,2,154,21,63,19,47,2,16,11,22,7,8,15,13,10,4,16,17,55,1.95
11907,"Earl Boykins\boykiea01","1998-99",22,"TOT","NBA",-0.3,22,0,221,30,79,27,61,3,18,2,3,7,10,17,33,6,0,20,20,65,2.6
11908,"Cedric Bozeman\bozemce01","2006-07",23,"ATL","NBA",-0.3,23,5,199,11,39,9,26,2,13,2,6,3,20,23,9,5,2,9,32,26,1.02
11909,"Jamison Brewer\breweja01","2004-05",24,"NYK","NBA",-0.3,18,0,185,11,37,8,22,3,15,6,13,6,16,22,12,8,1,13,11,31,1.81
11910,"Anthony Brown\brownan02","2015-16",23,"LAL","NBA",-0.3,29,11,599,39,126,19,56,20,70,17,20,9,61,70,19,14,5,15,34,115,3.45
11911,"Dee Brown\brownde01","2001-02",33,"ORL","NBA",-0.3,7,0,65,3,20,2,8,1,12,0,0,0,9,9,2,3,1,4,4,7,0.41
11912,"Gerald Brown\brownge02","1998-99",23,"PHO","NBA",-0.3,33,0,236,33,89,30,79,3,10,11,14,5,17,22,31,5,1,22,21,80,2
11913,"Lorenzo Brown\brownlo01","2013-14",23,"PHI","NBA",-0.3,26,0,224,26,86,23,56,3,30,9,13,8,20,28,41,13,3,16,19,64,2.6
11914,"Shannon Brown\brownsh01","2013-14",28,"TOT","NBA",-0.3,29,1,251,24,66,24,64,0,2,15,21,7,21,28,9,13,0,18,24,63,1.88
11915,"Pat Burke\burkepa01","2002-03",29,"ORL","NBA",-0.3,62,8,783,113,296,112,289,1,7,40,58,57,89,146,23,19,25,47,99,267,3.37
11916,"Bruno Caboclo\cabocbr01","2015-16",20,"TOR","NBA",-0.3,6,1,43,1,12,0,5,1,7,0,0,1,1,2,1,2,1,4,2,3,-0.13
11917,"Chris Carr\carrch01","1999-00",25,"TOT","NBA",-0.3,57,2,1166,196,496,164,395,32,101,107,125,41,132,173,84,30,15,117,113,531,7.43
11918,"Anthony Carter\cartean01","2003-04",28,"SAS","NBA",-0.3,5,2,87,11,37,11,34,0,3,0,0,2,9,11,12,4,0,12,9,22,3.46
11919,"Doug Christie\chrisdo01","1994-95",24,"NYK","NBA",-0.3,12,0,79,5,22,4,15,1,7,4,5,3,10,13,8,2,1,13,18,15,1.23
11920,"Earl Clark\clarkea01","2009-10",22,"PHO","NBA",-0.3,51,0,383,56,151,54,146,2,5,26,36,18,44,62,21,7,13,23,25,140,2.12
11921,"Mateen Cleaves\cleavma01","2001-02",24,"SAC","NBA",-0.3,32,0,153,30,68,28,60,2,8,8,9,1,7,8,25,7,0,27,9,70,1.93
11922,"Tyrone Corbin\corbity01","2000-01",38,"TOR","NBA",-0.3,15,1,117,9,38,9,33,0,5,2,4,3,10,13,4,2,0,3,18,20,0.41
11923,"Eddy Curry\curryed01","2009-10",27,"NYK","NBA",-0.3,7,0,62,8,21,8,21,0,0,10,17,4,9,13,0,0,1,13,13,26,2.51
11924,"Emanual Davis\davisem01","2001-02",33,"ATL","NBA",-0.3,28,20,774,70,198,41,113,29,85,16,18,19,55,74,68,27,5,52,68,185,6.48
11925,"DeSagana Diop\diopde01","2001-02",20,"CLE","NBA",-0.3,18,1,109,12,29,12,29,0,0,1,5,5,12,17,5,1,10,12,19,25,1.46
11926,"Tony Dumas\dumasto01","1996-97",24,"TOT","NBA",-0.3,24,1,278,33,96,29,68,4,28,16,25,3,13,16,25,10,2,16,45,86,2.65
11927,"Bill Edwards\edwarbi01","1993-94",22,"PHI","NBA",-0.3,3,0,44,2,18,2,13,0,5,2,5,5,9,14,4,3,1,4,6,6,1.7
11928,"Howard Eisley\eisleho01","2001-02",29,"NYK","NBA",-0.3,39,0,609,59,175,45,117,14,58,39,49,9,40,49,100,24,3,53,55,171,4.71
11929,"Melvin Ely\elyme01","2006-07",28,"TOT","NBA",-0.3,30,0,309,29,80,29,80,0,0,31,47,15,38,53,18,6,8,28,51,89,2.79
11930,"Tyler Ennis\ennisty01","2014-15",20,"TOT","NBA",-0.3,33,1,411,52,144,40,101,12,43,5,7,7,28,35,73,18,5,42,36,121,3.84
11931,"Christian Eyenga\eyengch01","2010-11",21,"CLE","NBA",-0.3,44,18,947,130,306,105,215,25,91,18,28,27,96,123,35,34,28,47,78,303,6
11932,"Noel Felix\felixno01","2005-06",24,"SEA","NBA",-0.3,12,0,82,6,25,5,22,1,3,5,8,3,10,13,2,2,3,8,13,18,1.03
11933,"Joseph Forte\fortejo01","2002-03",21,"SEA","NBA",-0.3,17,0,86,10,35,10,32,0,3,4,6,4,7,11,11,4,0,10,6,24,1.11
11934,"Greg Foster\fostegr01","2002-03",34,"TOR","NBA",-0.3,29,9,539,47,122,46,118,1,4,26,32,30,72,102,13,1,9,30,82,121,3.77
11935,"Devean George\georgde01","2000-01",23,"LAL","NBA",-0.3,59,1,593,64,207,49,139,15,68,39,55,35,75,110,19,15,15,34,87,182,2.36
11936,"Ben Gordon\gordobe01","2013-14",30,"CHA","NBA",-0.3,19,0,279,37,108,29,79,8,29,17,21,3,24,27,21,10,2,21,18,99,3.87
11937,"Stephen Graham\grahast01","2010-11",28,"NJN","NBA",-0.3,59,28,959,81,200,76,179,5,21,31,38,17,106,123,40,14,1,38,106,198,3.04
11938,"Orien Greene\greenor01","2005-06",23,"BOS","NBA",-0.3,80,5,1235,100,253,91,213,9,40,45,68,37,108,145,129,77,10,109,181,254,4.25
11939,"Thomas Hamilton\hamilth01","1995-96",20,"BOS","NBA",-0.3,11,0,70,9,31,9,31,0,0,7,18,10,12,22,1,0,9,9,12,25,1.66
11940,"Justin Harper\harpeju01","2011-12",22,"ORL","NBA",-0.3,14,0,84,9,31,7,18,2,13,0,1,3,9,12,2,2,3,6,5,20,0.84
11941,"Junior Harrington\harriju01","2004-05",24,"NOH","NBA",-0.3,29,7,550,64,178,58,159,6,19,29,35,13,50,63,62,25,5,41,72,163,5.47
11942,"Jason Hart\hartja01","2008-09",30,"TOT","NBA",-0.3,39,2,348,30,94,30,88,0,6,18,23,13,33,46,48,12,4,22,39,78,2.28
11943,"Antonio Harvey\harvean01","1995-96",25,"TOT","NBA",-0.3,55,15,821,83,224,83,222,0,2,38,83,69,131,200,15,27,47,44,76,204,3.87
11944,"Carl Herrera\herreca01","1998-99",32,"TOT","NBA",-0.3,28,0,307,30,76,30,75,0,1,5,11,25,37,62,4,12,7,16,41,65,2.35
11945,"Juwan Howard\howarju01","2011-12",38,"MIA","NBA",-0.3,28,0,190,17,55,17,55,0,0,8,10,18,29,47,10,4,1,20,18,42,1.43
11946,"Kris Humphries\humphkr01","2004-05",19,"UTA","NBA",-0.3,67,4,873,116,287,114,281,2,6,44,101,73,124,197,43,25,18,52,96,278,3.69
11947,"Lindsey Hunter\hunteli01","2009-10",39,"CHI","NBA",-0.3,13,0,122,5,30,4,17,1,13,2,2,1,13,14,9,1,0,4,12,13,0.53
11948,"Lindsey Hunter\hunteli01","1994-95",24,"DET","NBA",-0.3,42,26,944,119,318,83,210,36,108,40,55,24,51,75,159,51,7,79,94,314,7.86
11949,"Bobby Hurley\hurlebo01","1995-96",24,"SAC","NBA",-0.3,72,22,1059,65,230,43,154,22,76,68,85,12,63,75,216,28,3,86,121,220,4.02
11950,"Bobby Hurley\hurlebo01","1994-95",23,"SAC","NBA",-0.3,68,6,1105,103,284,82,208,21,76,58,76,14,56,70,226,29,0,110,79,285,4.93
11951,"Brandon Ingram\ingrabr01","2016-17",19,"LAL","NBA",-0.3,79,40,2279,276,686,221,499,55,187,133,214,60,256,316,166,50,36,116,158,740,8.3
11952,"Darnell Jackson\jacksda01","2009-10",24,"TOT","NBA",-0.3,28,0,123,9,30,8,26,1,4,4,6,9,13,22,4,2,4,13,21,23,0.76
11953,"Casey Jacobsen\jacobca01","2007-08",26,"MEM","NBA",-0.3,53,0,547,39,115,23,43,16,72,13,17,12,53,65,20,5,1,16,34,107,1.63
11954,"Jared Jeffries\jeffrja01","2012-13",31,"POR","NBA",-0.3,38,0,350,16,54,16,52,0,2,12,23,26,34,60,14,6,6,17,58,44,1.37
11955,"Armon Johnson\johnsar02","2010-11",21,"POR","NBA",-0.3,38,0,277,46,101,41,89,5,12,13,22,11,25,36,45,5,1,38,31,110,2.78
11956,"DerMarr Johnson\johnsde03","2006-07",26,"DEN","NBA",-0.3,39,7,419,50,154,31,66,19,88,16,21,10,47,57,17,16,12,27,39,135,2.67
11957,"Dontae' Jones\jonesdo01","1997-98",22,"BOS","NBA",-0.3,15,0,91,19,57,13,34,6,23,0,0,3,6,9,5,2,3,11,12,44,1.53
11958,"Greg Kite\kitegr01","1994-95",33,"TOT","NBA",-0.3,11,0,77,3,17,3,17,0,0,2,10,12,10,22,1,0,0,6,15,8,0.33
11959,"Linas Kleiza\kleizli01","2010-11",26,"TOR","NBA",-0.3,39,23,1032,178,406,139,275,39,131,41,65,37,140,177,40,19,7,65,99,436,8.62
11960,"Travis Knight\knightr01","2000-01",26,"NYK","NBA",-0.3,45,0,256,10,53,10,52,0,1,9,18,19,34,53,5,5,11,10,47,29,0.66
11961,"Jake Layman\laymaja01","2016-17",22,"POR","NBA",-0.3,35,1,249,26,89,13,38,13,51,13,17,6,18,24,11,9,3,11,22,78,1.51
11962,"Tim Legler\legleti01","1997-98",31,"WAS","NBA",-0.3,8,0,76,3,19,3,13,0,6,3,4,2,2,4,3,1,0,4,11,9,0.15
11963,"Art Long\longar01","2002-03",30,"TOT","NBA",-0.3,26,0,211,28,75,26,72,2,3,2,10,21,39,60,6,5,11,20,35,60,2.17
11964,"Mark Madsen\madsema01","2007-08",32,"MIN","NBA",-0.3,20,6,151,3,19,3,19,0,0,3,12,18,20,38,4,3,2,9,25,9,0.78
11965,"Matt Maloney\malonma01","1998-99",27,"HOU","NBA",-0.3,15,7,186,5,28,4,13,1,15,10,11,2,8,10,21,4,0,14,7,21,1.71
11966,"Stephon Marbury\marbust01","2008-09",31,"BOS","NBA",-0.3,23,4,414,38,111,32,86,6,25,6,13,2,26,28,75,10,3,37,34,88,4.28
11967,"Desmond Mason\masonde01","2008-09",31,"OKC","NBA",-0.3,39,19,1064,124,285,124,282,0,3,46,85,41,116,157,46,15,30,56,96,294,6.65
11968,"Sean May\mayse01","2008-09",24,"CHA","NBA",-0.3,24,12,301,39,98,38,97,1,1,14,20,20,49,69,10,5,4,26,32,93,3.33
11969,"Rashad McCants\mccanra01","2006-07",22,"MIN","NBA",-0.3,37,0,554,62,177,42,102,20,75,40,58,14,33,47,38,26,7,40,71,184,4.16
11970,"Chimezie Metu\metuch01","2018-19",21,"SAS","NBA",-0.3,29,0,145,19,58,19,56,0,2,13,17,9,27,36,13,6,2,15,14,51,1.63
11971,"Loren Meyer\meyerlo01","1996-97",24,"TOT","NBA",-0.3,54,33,708,108,244,104,237,4,7,46,64,53,92,145,19,11,15,62,125,266,4.15
11972,"Loren Meyer\meyerlo01","1998-99",26,"DEN","NBA",-0.3,14,0,70,7,28,6,23,1,5,1,2,4,12,16,1,0,3,4,22,16,0.57
11973,"Jérôme Moïso\moisoje01","2000-01",22,"BOS","NBA",-0.3,24,0,135,12,30,12,29,0,1,11,26,12,30,42,3,3,4,18,29,35,1.56
11974,"Jamario Moon\moonja01","2011-12",31,"CHA","NBA",-0.3,8,0,123,7,24,5,14,2,10,2,2,2,20,22,5,1,5,8,5,18,2.6
11975,"Kevin Murphy\murphke01","2012-13",22,"UTA","NBA",-0.3,17,0,52,7,28,6,23,1,5,0,0,0,4,4,2,1,0,3,4,15,0.13
11976,"Lamond Murray\murrala01","1994-95",21,"LAC","NBA",-0.3,81,61,2556,439,1093,374,875,65,218,199,264,132,222,354,133,72,55,163,180,1142,10.76
11977,"Lamond Murray\murrala01","2003-04",30,"TOR","NBA",-0.3,33,4,518,76,215,55,155,21,60,24,35,14,76,90,28,15,7,38,47,197,4.48
11978,"Ronald Murray\murraro01","2004-05",25,"SEA","NBA",-0.3,49,6,883,131,363,107,268,24,95,59,80,15,83,98,65,30,11,57,59,345,5.25
11979,"Ronald Murray\murraro01","2002-03",23,"TOT","NBA",-0.3,14,0,62,11,31,11,26,0,5,5,8,0,4,4,5,4,0,8,0,27,1.26
11980,"DeMarcus Nelson\nelsode01","2008-09",23,"GSW","NBA",-0.3,13,5,171,24,54,24,51,0,3,5,14,6,18,24,13,9,2,15,24,53,3.87
11981,"Georges Niang\niangge01","2016-17",23,"IND","NBA",-0.3,23,0,93,9,36,8,24,1,12,2,2,2,15,17,5,3,0,5,6,21,0.55
11982,"Michael Olowokandi\olowomi01","1998-99",23,"LAC","NBA",-0.3,45,36,1279,172,399,172,399,0,0,57,118,120,237,357,25,27,55,85,137,401,8.71
11983,"Doug Overton\overtdo01","2003-04",34,"TOT","NBA",-0.3,61,11,1033,99,245,96,222,3,23,23,31,16,70,86,138,26,2,58,89,224,4.05
11984,"Doug Overton\overtdo01","2000-01",31,"TOT","NBA",-0.3,21,10,475,52,139,41,103,11,36,10,16,4,35,39,72,8,0,31,37,125,5.72
11985,"Milt Palacio\palacmi01","1999-00",21,"VAN","NBA",-0.3,53,0,394,43,98,43,96,0,2,22,37,17,34,51,48,20,0,44,32,108,2.35
11986,"Jannero Pargo\pargoja01","2009-10",30,"CHI","NBA",-0.3,63,5,829,132,381,94,243,38,138,42,45,9,69,78,89,29,2,50,68,344,4.01
11987,"Cameron Payne\payneca01","2016-17",22,"TOT","NBA",-0.3,31,0,462,64,193,37,107,27,86,5,8,3,45,48,55,14,4,29,52,160,3.99
11988,"Laron Profit\profila01","1999-00",22,"WAS","NBA",-0.3,33,1,225,21,59,18,42,3,17,4,10,2,24,26,25,7,4,19,26,49,1.56
11989,"Rodney Purvis\purviro01","2017-18",23,"ORL","NBA",-0.3,16,2,290,35,107,22,55,13,52,13,15,1,26,27,17,3,3,10,26,96,3.88
11990,"Zhou Qi\qizh01","2017-18",22,"HOU","NBA",-0.3,18,0,124,6,32,4,13,2,19,8,12,6,16,22,2,2,14,10,14,22,1.24
11991,"Aleksandar Radojević\radojal01","2004-05",28,"UTA","NBA",-0.3,12,6,128,6,19,6,19,0,0,7,10,9,19,28,6,0,2,15,32,19,1.97
11992,"Davon Reed\reedda01","2017-18",22,"PHO","NBA",-0.3,21,1,242,22,76,11,38,11,38,8,12,2,37,39,13,10,2,10,17,63,2.53
11993,"Chris Robinson\robinch01","1997-98",23,"TOT","NBA",-0.3,35,0,414,65,174,41,108,24,66,8,16,9,37,46,39,19,4,33,50,162,3.73
11994,"Terry Rozier\roziete01","2015-16",21,"BOS","NBA",-0.3,39,0,311,29,106,23,79,6,27,8,10,24,39,63,37,6,1,19,23,72,1.7
11995,"Delaney Rudd\ruddde01","1992-93",30,"POR","NBA",-0.3,15,1,95,7,36,6,25,1,11,11,14,4,5,9,17,1,0,11,7,26,1.26
11996,"Brandon Rush\rushbr01","2014-15",29,"GSW","NBA",-0.3,33,0,271,11,54,8,27,3,27,5,11,4,37,41,12,5,12,11,27,30,0.98
11997,"Rony Seikaly\seikaro01","1998-99",33,"NJN","NBA",-0.3,9,0,88,4,20,4,20,0,0,7,18,5,16,21,2,4,6,10,15,15,1.8
11998,"Wayne Selden\seldewa01","2018-19",24,"TOT","NBA",-0.3,75,13,1439,196,483,141,309,55,174,67,92,37,143,180,109,33,13,79,131,514,5.8
11999,"Tamar Slay\slayta01","2004-05",24,"CHA","NBA",-0.3,8,0,78,13,39,11,27,2,12,0,2,6,8,14,3,5,0,8,20,28,2.23
12000,"Donald Sloan\sloando01","2011-12",24,"TOT","NBA",-0.3,33,11,669,79,198,77,173,2,25,23,30,18,49,67,105,13,3,49,37,183,5.72
12001,"Charles Smith\smithch04","1997-98",22,"TOT","NBA",-0.3,34,0,292,49,125,34,78,15,47,6,11,13,14,27,21,12,6,27,24,119,2.67
12002,"Nolan Smith\smithno01","2011-12",23,"POR","NBA",-0.3,44,4,541,67,180,54,135,13,45,20,28,17,39,56,62,18,3,42,55,167,3.42
12003,"Vladimir Stepania\stepavl01","1999-00",23,"SEA","NBA",-0.3,30,1,202,29,79,29,73,0,6,17,36,21,26,47,3,10,11,22,44,75,2.08
12004,"Lance Stephenson\stephla01","2011-12",21,"IND","NBA",-0.3,42,1,442,47,125,43,95,4,30,8,17,12,41,53,46,21,5,36,30,106,2.66
12005,"DeShawn Stevenson\stevede01","2011-12",30,"NJN","NBA",-0.3,51,30,960,49,172,8,27,41,145,9,16,7,94,101,41,19,4,19,59,148,2.65
12006,"Bryant Stith\stithbr01","1997-98",27,"DEN","NBA",-0.3,31,15,718,75,225,65,177,10,48,75,86,15,50,65,50,21,8,35,52,235,6.15
12007,"Erick Strickland\stricer01","2004-05",31,"MIL","NBA",-0.3,62,5,1014,114,304,93,221,21,83,52,64,11,92,103,115,30,1,64,103,301,4.54
12008,"DaJuan Summers\summeda01","2010-11",23,"DET","NBA",-0.3,22,1,199,28,69,19,48,9,21,9,20,2,10,12,2,3,1,13,21,74,1.93
12009,"Bruno Šundov\sundobr01","2004-05",24,"NYK","NBA",-0.3,21,0,73,11,37,10,34,1,3,2,2,6,7,13,2,2,2,6,16,25,0.64
12010,"Maurice Taylor\tayloma01","1999-00",23,"LAC","NBA",-0.3,62,60,2227,458,988,457,980,1,8,143,201,96,304,400,101,51,48,169,217,1060,13.61
12011,"Marquis Teague\teaguma01","2012-13",19,"CHI","NBA",-0.3,48,0,392,43,113,39,90,4,23,9,16,3,41,44,63,9,7,35,47,99,2.29
12012,"Jared Terrell\terreja01","2018-19",23,"MIN","NBA",-0.3,14,0,111,12,39,8,22,4,17,3,6,1,5,6,12,3,2,10,16,31,1.61
12013,"Isaiah Thomas\thomais02","2018-19",29,"DEN","NBA",-0.3,12,0,181,34,99,22,56,12,43,17,27,5,8,13,23,5,1,18,17,97,5.36
12014,"Kenny Thomas\thomake01","2007-08",30,"SAC","NBA",-0.3,23,3,281,16,38,16,38,0,0,0,5,18,43,61,13,6,1,21,38,32,2.17
12015,"LaSalle Thompson\thompla01","1996-97",35,"TOT","NBA",-0.3,26,0,140,3,19,3,19,0,0,4,6,7,27,34,2,3,6,9,33,10,0.74
12016,"Jamaal Tinsley\tinslja01","2009-10",31,"MEM","NBA",-0.3,38,1,589,52,140,45,101,7,39,22,27,11,55,66,108,33,5,63,67,133,5.06
12017,"Jamaal Tinsley\tinslja01","2013-14",35,"UTA","NBA",-0.3,8,5,110,4,20,3,5,1,15,0,0,2,9,11,23,2,0,9,10,9,2.39
12018,"Cezary Trybański\trybace01","2002-03",23,"MEM","NBA",-0.3,15,0,86,5,20,5,20,0,0,4,10,6,8,14,1,0,6,8,13,14,0.67
12019,"Greivis Vásquez\vasqugr01","2015-16",29,"MIL","NBA",-0.3,23,0,460,45,138,27,65,18,73,22,26,5,42,47,91,10,0,40,42,130,6.19
12020,"Jake Voskuhl\voskuja01","2008-09",31,"TOR","NBA",-0.3,38,1,240,12,45,12,45,0,0,11,14,21,38,59,8,3,4,17,60,35,1.11
12021,"Von Wafer\wafervo01","2005-06",20,"LAL","NBA",-0.3,16,0,73,6,38,4,21,2,17,6,8,5,3,8,4,3,0,1,12,20,0.25
12022,"Antoine Walker\walkean02","2006-07",30,"MIA","NBA",-0.3,78,15,1818,265,668,181,363,84,305,46,105,92,247,339,130,48,17,141,173,660,7.2
12023,"Tyrone Wallace\wallaty01","2018-19",24,"LAC","NBA",-0.3,62,0,628,92,217,88,198,4,19,30,57,20,81,101,42,21,7,36,83,218,3.03
12024,"Eric Washington\washier01","1997-98",23,"DEN","NBA",-0.3,66,36,1539,201,498,157,361,44,137,65,83,47,80,127,78,53,25,72,143,511,6.23
12025,"Maalik Wayns\waynsma01","2012-13",21,"TOT","NBA",-0.3,27,1,202,26,88,19,57,7,31,17,19,1,6,7,27,6,0,15,26,76,1.91
12026,"Travis Wear\weartr01","2014-15",24,"NYK","NBA",-0.3,51,1,672,84,209,73,179,11,30,20,26,31,75,106,40,15,11,35,55,199,3.47
12027,"Sonny Weems\weemsso01","2008-09",22,"DEN","NBA",-0.3,12,0,55,8,25,8,22,0,3,3,8,0,4,4,3,1,0,6,8,19,0.62
12028,"Bill Wennington\wennibi01","1998-99",35,"CHI","NBA",-0.3,38,3,451,62,178,61,177,1,1,18,22,20,59,79,18,13,12,17,79,143,2.82
12029,"Chris Whitney\whitnch01","1993-94",22,"SAS","NBA",-0.3,40,4,339,25,82,15,52,10,30,12,15,5,24,29,53,11,1,37,53,72,2.09
12030,"Mike Wilks\wilksmi01","2005-06",26,"TOT","NBA",-0.3,47,0,348,29,90,26,71,3,19,25,41,9,30,39,32,14,1,24,34,86,1.72
12031,"Brandon Williams\willibr01","1997-98",22,"GSW","NBA",-0.3,9,2,140,16,50,13,41,3,9,2,4,4,11,15,3,6,3,9,18,37,2.64
12032,"Terrence Williams\willite01","2009-10",22,"NJN","NBA",-0.3,78,9,1764,261,651,230,551,31,100,103,144,46,302,348,223,43,10,124,126,656,8.12
12033,"Tariq Abdul-Wahad\abdulta01","2000-01",26,"DEN","NBA",-0.4,29,12,420,43,111,39,101,4,10,21,36,14,45,59,22,14,13,34,54,111,3.68
12034,"Maurice Ager\agerma01","2007-08",23,"TOT","NBA",-0.4,26,3,165,21,65,18,46,3,19,6,12,4,9,13,8,0,1,6,17,51,0.88
12035,"Rafer Alston\alstora01","2009-10",33,"TOT","NBA",-0.4,52,38,1421,155,446,97,278,58,168,59,81,13,116,129,176,50,10,95,103,427,7.69
12036,"Nick Anderson\anderni01","2001-02",34,"MEM","NBA",-0.4,15,0,219,21,76,8,28,13,48,5,9,1,32,33,14,6,6,14,17,60,3.12
12037,"William Avery\averywi01","2001-02",22,"MIN","NBA",-0.4,28,0,258,26,90,20,55,6,35,13,19,4,20,24,36,7,0,19,17,71,2.06
12038,"Luke Babbitt\babbilu01","2010-11",21,"POR","NBA",-0.4,24,0,137,15,55,12,39,3,16,3,9,6,24,30,6,2,2,8,15,36,0.86
12039,"Vin Baker\bakervi01","2004-05",33,"TOT","NBA",-0.4,27,0,204,13,42,13,41,0,1,9,17,17,22,39,10,2,4,17,38,35,1.3
12040,"Earl Barron\barroea01","2007-08",26,"MIA","NBA",-0.4,46,15,889,132,327,131,314,1,13,61,87,67,131,198,29,19,8,48,114,326,5.73
12041,"DeAndre' Bembry\bembrde01","2017-18",23,"ATL","NBA",-0.4,26,3,455,53,128,42,98,11,30,19,33,8,64,72,49,21,12,47,38,136,5.94
12042,"Anthony Bennett\bennean01","2013-14",20,"CLE","NBA",-0.4,52,0,663,80,225,67,172,13,53,44,69,49,106,155,17,21,8,47,93,217,3.5
12043,"Mike Brown\brownmi01","1994-95",31,"MIN","NBA",-0.4,27,0,213,10,40,10,39,0,1,15,27,9,36,45,10,7,0,16,35,35,1.41
12044,"Kobe Bryant\bryanko01","2015-16",37,"LAL","NBA",-0.4,66,66,1863,398,1113,265,646,133,467,232,281,41,206,247,184,62,13,129,115,1161,12.43
12045,"Kobe Bryant\bryanko01","2013-14",35,"LAL","NBA",-0.4,6,6,177,31,73,28,57,3,16,18,21,2,24,26,38,7,1,34,9,83,14.63
12046,"Antonio Burks\burksan01","2005-06",25,"MEM","NBA",-0.4,57,1,570,51,144,50,138,1,6,10,23,4,33,37,76,20,0,36,45,113,2.02
12047,"Žarko Čabarkapa\cabarza01","2003-04",22,"PHO","NBA",-0.4,49,4,570,81,197,75,165,6,32,35,53,26,73,99,40,10,13,54,75,203,3.61
12048,"Tom Chambers\chambto01","1996-97",37,"CHH","NBA",-0.4,12,5,83,7,31,5,28,2,3,3,4,3,11,14,4,1,0,9,14,19,0.76
12049,"Mateen Cleaves\cleavma01","2002-03",25,"SAC","NBA",-0.4,12,0,55,6,23,5,22,1,1,3,4,1,7,8,10,2,0,14,6,16,1.18
12050,"Daequan Cook\cookda02","2007-08",20,"MIA","NBA",-0.4,59,19,1441,196,514,117,276,79,238,47,57,20,157,177,75,23,9,63,157,518,6.53
12051,"Duane Cooper\coopedu01","1992-93",23,"LAL","NBA",-0.4,65,0,645,62,158,55,128,7,30,25,35,13,37,50,150,18,2,69,66,156,3.24
12052,"Ricky Davis\davisri01","2008-09",29,"LAC","NBA",-0.4,36,9,785,83,245,48,134,35,111,31,36,9,51,60,82,19,5,39,63,232,5.43
12053,"Terry Dehere\deherte01","1993-94",22,"LAC","NBA",-0.4,64,6,759,129,342,106,285,23,57,61,81,25,43,68,78,28,3,61,69,342,4.03
12054,"Bryce Drew\drewbr01","2000-01",26,"CHI","NBA",-0.4,48,41,1305,124,327,84,222,40,105,14,19,12,57,69,185,32,3,68,99,302,6.5
12055,"Larry Drew\drewla02","2014-15",24,"PHI","NBA",-0.4,12,1,219,20,58,16,32,4,26,2,3,1,14,15,45,6,0,25,13,46,4.71
12056,"Cleanthony Early\earlycl01","2014-15",23,"NYK","NBA",-0.4,39,7,647,76,214,54,130,22,84,36,48,22,75,97,36,24,12,40,57,210,4.67
12057,"Sleepy Floyd\floydsl01","1993-94",33,"SAS","NBA",-0.4,53,2,737,70,209,62,173,8,36,52,78,10,60,70,101,12,8,61,71,200,3.54
12058,"Alphonso Ford\fordal01","1994-95",23,"PHI","NBA",-0.4,5,0,98,9,39,9,30,0,9,1,2,8,12,20,9,1,0,8,5,19,2.04
12059,"Chris Garner\garnech01","2000-01",25,"GSW","NBA",-0.4,8,0,149,7,37,7,30,0,7,5,6,2,10,12,18,7,1,9,18,19,2.58
12060,"Chris Garner\garnech01","1997-98",22,"TOR","NBA",-0.4,38,0,293,23,70,19,56,4,14,3,7,7,17,24,45,21,4,25,50,53,2.01
12061,"Kendall Gill\gillke01","2000-01",32,"NJN","NBA",-0.4,31,26,892,107,323,103,309,4,14,65,90,32,99,131,87,47,7,48,64,283,8.22
12062,"Gerald Green\greenge01","2007-08",22,"TOT","NBA",-0.4,30,0,362,52,151,37,112,15,39,34,41,13,51,64,29,8,4,32,45,153,4.07
12063,"Darvin Ham\hamda01","2002-03",29,"ATL","NBA",-0.4,75,1,926,71,159,71,156,0,3,38,79,73,80,153,38,16,19,65,127,180,2.64
12064,"Junior Harrington\harriju01","2002-03",22,"DEN","NBA",-0.4,82,51,2003,169,467,162,439,7,28,73,112,44,206,250,277,80,15,157,250,418,6.43
12065,"Kirk Haston\hastoki01","2002-03",23,"NOH","NBA",-0.4,12,0,57,2,17,2,14,0,3,2,4,0,7,7,3,0,5,7,10,6,0.21
12066,"Shane Heal\healsh01","1996-97",26,"MIN","NBA",-0.4,43,0,236,26,97,6,32,20,65,3,5,2,16,18,33,3,3,17,20,75,1.21
12067,"Jay Humphries\humphja01","1994-95",32,"TOT","NBA",-0.4,18,0,201,8,34,6,30,2,4,2,4,4,9,13,19,9,0,17,35,20,1.45
12068,"Marko Jarić\jaricma01","2008-09",30,"MEM","NBA",-0.4,53,0,605,48,145,37,117,11,28,29,41,23,42,65,74,29,11,49,62,136,3.08
12069,"Charles Jones\jonesch03","1998-99",23,"CHI","NBA",-0.4,29,5,476,39,123,20,62,19,61,11,22,9,33,42,41,18,5,29,30,108,3.45
12070,"Dahntay Jones\jonesda02","2003-04",23,"MEM","NBA",-0.4,20,0,154,15,53,14,49,1,4,5,11,7,16,23,12,5,6,12,23,36,1.47
12071,"Doron Lamb\lambdo01","2012-13",21,"TOT","NBA",-0.4,47,0,577,60,163,46,126,14,37,20,34,8,38,46,32,13,0,26,52,154,2.39
12072,"Rashard Lewis\lewisra02","1998-99",19,"SEA","NBA",-0.4,20,7,145,19,52,18,46,1,6,8,14,13,12,25,4,8,1,20,19,47,1.87
12073,"Mark Macon\maconma01","1993-94",24,"TOT","NBA",-0.4,42,1,496,69,184,67,174,2,10,23,34,18,23,41,51,39,1,40,73,163,3.55
12074,"Eric Maynor\maynoer01","2013-14",26,"TOT","NBA",-0.4,31,0,327,32,101,20,64,12,37,6,11,9,30,39,52,9,3,29,17,82,2.75
12075,"Roshown McLeod\mcleoro01","1999-00",24,"ATL","NBA",-0.4,44,20,860,131,332,129,319,2,13,54,70,41,97,138,52,16,5,59,84,318,5.52
12076,"Gal Mekel\mekelga01","2013-14",25,"DAL","NBA",-0.4,31,1,292,30,86,25,66,5,20,8,12,5,22,27,63,4,1,31,31,73,2.67
12077,"Harold Miner\minerha01","1994-95",23,"MIA","NBA",-0.4,45,16,871,123,305,109,256,14,49,69,95,38,79,117,69,15,6,77,85,329,5.97
12078,"Eric Mobley\mobleer01","1996-97",26,"VAN","NBA",-0.4,28,8,307,28,63,28,63,0,0,16,30,30,28,58,14,5,10,29,44,72,2.8
12079,"Eric Montross\montrer01","1999-00",28,"DET","NBA",-0.4,51,0,332,17,55,17,55,0,0,6,12,18,54,72,7,6,9,22,81,40,1.02
12080,"Darius Morris\morrida01","2014-15",24,"BRK","NBA",-0.4,38,0,299,36,106,29,73,7,33,4,9,7,20,27,48,9,0,21,20,83,1.96
12081,"Lawrence Moten\motenla01","1996-97",24,"VAN","NBA",-0.4,67,18,1214,171,441,130,300,41,141,64,99,43,76,119,129,48,24,81,83,447,5.9
12082,"Nemanja Nedović\nedovne01","2013-14",22,"GSW","NBA",-0.4,24,0,142,8,39,5,21,3,18,7,8,3,12,15,13,0,1,13,13,26,0.72
12083,"Moochie Norris\norrimo01","2004-05",31,"TOT","NBA",-0.4,38,0,360,35,109,35,97,0,12,20,24,10,36,46,39,18,2,27,44,90,2.4
12084,"Michael Olowokandi\olowomi01","2000-01",25,"LAC","NBA",-0.4,82,82,2127,308,708,308,708,0,0,85,156,168,357,525,46,30,108,169,250,701,7.9
12085,"Doug Overton\overtdo01","1993-94",24,"WSB","NBA",-0.4,61,1,749,87,216,86,205,1,11,43,52,19,50,69,92,21,1,54,48,218,3.47
12086,"Xavier Rathan-Mayes\rathaxa01","2017-18",23,"MEM","NBA",-0.4,5,0,118,12,42,11,28,1,14,4,9,0,5,5,18,6,3,11,18,29,5.02
12087,"Antoine Rigaudeau\rigauan01","2002-03",31,"DAL","NBA",-0.4,11,0,91,8,35,7,30,1,5,0,0,4,4,8,6,3,0,6,11,17,0.55
12088,"Lou Roe\roelo01","1996-97",24,"GSW","NBA",-0.4,17,0,107,14,48,11,37,3,11,9,19,7,7,14,6,3,1,11,10,40,1.26
12089,"Malik Rose\rosema01","2008-09",34,"TOT","NBA",-0.4,38,0,470,45,131,45,124,0,7,40,51,17,79,96,36,10,3,36,72,130,3.36
12090,"Brandon Rush\rushbr01","2013-14",28,"UTA","NBA",-0.4,38,0,418,30,90,14,43,16,47,3,5,5,39,44,24,5,9,20,31,79,1.92
12091,"Walker Russell\russewa02","2011-12",29,"DET","NBA",-0.4,28,0,357,33,95,29,82,4,13,14,22,7,19,26,58,18,1,33,29,84,3.47
12092,"Mustafa Shakur\shakumu01","2010-11",26,"WAS","NBA",-0.4,22,0,159,21,59,20,49,1,10,8,15,7,15,22,25,5,3,18,15,51,2.21
12093,"Ish Smith\smithis01","2012-13",24,"TOT","NBA",-0.4,52,3,516,56,159,48,132,8,27,3,7,12,49,61,87,21,9,37,26,123,2.79
12094,"Theron Smith\smithth01","2004-05",24,"CHA","NBA",-0.4,33,5,510,44,136,41,124,3,12,14,16,39,77,116,28,6,4,27,58,105,3.07
12095,"Jerry Stackhouse\stackje01","2008-09",34,"DAL","NBA",-0.4,10,1,162,16,60,13,41,3,19,7,7,5,12,17,12,4,1,9,6,42,2.63
12096,"DeShawn Stevenson\stevede01","2009-10",28,"TOT","NBA",-0.4,64,18,883,46,163,27,76,19,87,25,35,11,80,91,56,16,6,30,74,136,2.06
12097,"DeShawn Stevenson\stevede01","2000-01",19,"UTA","NBA",-0.4,40,2,293,31,91,30,79,1,12,26,38,9,19,28,18,10,2,28,29,89,1.7
12098,"Lamont Strothers\strotla01","1992-93",24,"DAL","NBA",-0.4,9,0,138,20,61,18,48,2,13,8,10,8,6,14,13,8,0,15,13,50,4.13
12099,"Bruno Šundov\sundobr01","2002-03",22,"BOS","NBA",-0.4,26,0,138,14,56,10,40,4,16,0,2,8,20,28,7,6,3,9,24,32,0.84
12100,"Mike Taylor\taylomi01","2008-09",23,"LAC","NBA",-0.4,51,5,771,110,267,97,227,13,40,56,81,22,65,87,106,36,0,73,84,289,5.51
12101,"Tyshawn Taylor\tayloty01","2012-13",22,"BRK","NBA",-0.4,38,0,221,32,87,26,74,6,13,15,27,2,16,18,21,13,0,25,25,85,1.76
12102,"Sebastian Telfair\telfase01","2004-05",19,"POR","NBA",-0.4,68,26,1330,169,430,152,361,17,69,105,133,10,94,104,224,35,4,125,120,460,6.64
12103,"Garrett Temple\templga01","2010-11",24,"TOT","NBA",-0.4,24,0,230,20,68,10,31,10,37,7,17,1,22,23,32,11,6,23,24,57,2.51
12104,"Lance Thomas\thomala01","2014-15",26,"TOT","NBA",-0.4,62,37,1490,182,442,175,420,7,22,72,99,65,130,195,69,37,8,74,101,443,5.88
12105,"Roko Ukić\ukicro01","2008-09",24,"TOR","NBA",-0.4,72,0,890,123,324,112,262,11,62,44,60,27,48,75,153,30,2,60,77,301,3.97
12106,"Jacque Vaughn\vaughja01","1997-98",22,"UTA","NBA",-0.4,45,0,419,44,122,41,114,3,8,48,68,4,34,38,84,9,1,56,63,139,3.26
12107,"Luke Walton\waltolu01","2011-12",31,"TOT","NBA",-0.4,30,0,364,24,65,17,45,7,20,0,0,13,36,49,35,5,1,27,41,55,2.3
12108,"Sonny Weems\weemsso01","2010-11",24,"TOR","NBA",-0.4,59,28,1413,228,513,211,452,17,61,72,94,39,114,153,104,34,2,86,87,545,7.42
12109,"Jiří Welsch\welscji01","2002-03",23,"GSW","NBA",-0.4,37,0,234,19,75,18,71,1,4,22,29,12,16,28,27,8,2,19,32,61,1.43
12110,"Rodney White\whitero02","2002-03",22,"DEN","NBA",-0.4,72,19,1563,260,638,228,504,32,134,98,125,43,170,213,121,45,32,156,134,650,7.42
12111,"Shawne Williams\willish03","2011-12",25,"NJN","NBA",-0.4,25,6,514,42,147,21,60,21,87,8,11,20,48,68,16,10,11,13,44,113,3.27
12112,"Isaac Austin\austiis01","2000-01",31,"VAN","NBA",-0.5,52,16,845,96,270,90,246,6,24,28,40,50,172,222,58,20,23,54,94,226,4.54
12113,"Anthony Avent\aventan01","1999-00",30,"LAC","NBA",-0.5,49,3,377,29,96,29,96,0,0,23,32,23,51,74,11,16,15,24,62,81,1.75
12114,"William Avery\averywi01","1999-00",20,"MIN","NBA",-0.5,59,1,484,56,181,38,118,18,63,24,36,8,32,40,88,14,2,42,60,154,2.34
12115,"Will Barton\bartowi01","2012-13",22,"POR","NBA",-0.5,73,5,894,118,309,109,244,9,65,50,65,36,109,145,58,34,9,60,56,295,3.55
12116,"Corey Benjamin\benjaco01","2000-01",22,"CHI","NBA",-0.5,65,5,857,115,302,94,221,21,81,56,83,38,62,100,69,28,16,63,128,307,3.97
12117,"Antonio Blakeney\blakean01","2018-19",22,"CHI","NBA",-0.5,57,3,829,166,396,130,305,36,91,50,76,7,99,106,42,12,9,35,41,418,5.03
12118,"Avery Bradley\bradlav01","2010-11",20,"BOS","NBA",-0.5,31,0,162,23,67,23,62,0,5,6,12,4,13,17,12,9,0,16,20,52,1.16
12119,"J.R. Bremer\bremejr01","2003-04",23,"TOT","NBA",-0.5,36,2,443,43,158,24,84,19,74,13,20,9,27,36,51,18,4,24,32,118,2.57
12120,"Bobby Brown\brownbo02","2009-10",25,"TOT","NBA",-0.5,45,0,519,88,237,62,139,26,98,13,15,9,29,38,88,15,1,46,42,215,3.91
12121,"Shannon Brown\brownsh01","2007-08",22,"TOT","NBA",-0.5,21,4,240,44,126,35,96,9,30,17,29,6,14,20,17,11,3,24,29,114,3.41
12122,"Tierre Brown\brownti01","2004-05",25,"LAL","NBA",-0.5,76,0,1066,124,348,98,276,26,72,59,75,21,72,93,155,32,1,74,59,333,4.09
12123,"Mardy Collins\collima01","2009-10",25,"LAC","NBA",-0.5,43,0,470,47,128,43,111,4,17,13,21,13,37,50,44,23,1,32,45,111,2.59
12124,"Erick Dampier\dampier01","2000-01",25,"GSW","NBA",-0.5,43,26,1038,126,314,126,312,0,2,67,126,97,153,250,59,17,58,82,123,319,7.56
12125,"Yinka Dare\dareyi01","1995-96",23,"NJN","NBA",-0.5,58,23,626,63,144,63,144,0,0,38,62,56,125,181,0,8,40,72,117,164,3.23
12126,"Juan Dixon\dixonju01","2008-09",30,"WAS","NBA",-0.5,50,6,816,101,256,76,181,25,75,34,39,8,59,67,118,35,6,70,74,261,5.38
12127,"Kevin Duckworth\duckwke01","1993-94",29,"WSB","NBA",-0.5,69,52,1485,184,441,184,441,0,0,88,132,103,222,325,56,37,35,101,223,456,6.29
12128,"Howard Eisley\eisleho01","1994-95",22,"TOT","NBA",-0.5,49,4,552,40,122,31,85,9,37,31,40,12,36,48,95,18,6,50,81,120,3.16
12129,"Kay Felder\feldeka01","2017-18",22,"TOT","NBA",-0.5,16,0,140,21,70,17,51,4,19,11,12,3,15,18,20,3,1,16,11,57,2.56
12130,"Matt Freije\freijma01","2004-05",23,"NOH","NBA",-0.5,23,11,441,37,127,23,73,14,54,5,8,16,45,61,20,13,2,17,40,93,3.07
12131,"Reece Gaines\gainere01","2003-04",23,"ORL","NBA",-0.5,38,1,364,25,86,22,76,3,10,16,25,8,31,39,40,11,2,18,22,69,1.87
12132,"Larry Hughes\hughela01","2011-12",33,"ORL","NBA",-0.5,9,0,114,5,22,4,15,1,7,1,2,1,4,5,7,2,0,12,10,12,0.79
12133,"Ryan Humphrey\humphry01","2002-03",23,"TOT","NBA",-0.5,48,1,444,35,120,35,120,0,0,23,39,34,65,99,11,9,18,23,75,93,1.78
12134,"Bobby Hurley\hurlebo01","1997-98",26,"TOT","NBA",-0.5,61,3,875,93,238,88,216,5,22,59,76,12,54,66,177,23,0,86,79,250,4.71
12135,"Bobby Hurley\hurlebo01","1993-94",22,"SAC","NBA",-0.5,19,19,499,54,146,52,130,2,16,24,30,6,28,34,115,13,1,48,28,134,8.36
12136,"Jerome James\jamesje01","2005-06",30,"NYK","NBA",-0.5,45,9,406,56,121,56,121,0,0,25,40,39,52,91,12,3,23,51,104,137,2.95
12137,"Chris Jefferies\jeffech01","2002-03",22,"TOR","NBA",-0.5,51,10,666,75,194,57,140,18,54,29,43,16,43,59,22,19,16,45,56,197,3.04
12138,"James Johnson\johnsja01","2012-13",25,"SAC","NBA",-0.5,54,11,878,117,283,115,262,2,21,40,67,49,96,145,58,41,50,68,99,276,5.34
12139,"Marcus Liberty\liberma01","1993-94",25,"TOT","NBA",-0.5,38,0,285,40,123,30,95,10,28,19,39,26,35,61,17,11,4,24,34,109,2.13
12140,"Šarūnas Marčiulionis\marcisa01","1996-97",32,"DEN","NBA",-0.5,17,0,255,38,101,27,71,11,30,29,36,12,18,30,25,12,1,40,38,116,5.88
12141,"Kendall Marshall\marshke01","2015-16",24,"PHI","NBA",-0.5,30,6,400,43,118,27,69,16,49,9,13,2,26,28,73,16,2,43,30,111,4.12
12142,"C.J. Miles\milescj01","2006-07",19,"UTA","NBA",-0.5,37,13,373,40,116,33,84,7,32,14,23,11,24,35,25,11,4,28,60,101,2.09
12143,"Johnny O'Bryant\obryajo01","2014-15",21,"MIL","NBA",-0.5,34,15,368,44,120,44,120,0,0,12,27,26,38,64,17,5,4,25,44,100,2.14
12144,"Charles Oakley\oaklech01","2001-02",38,"CHI","NBA",-0.5,57,36,1383,97,263,96,257,1,6,21,28,72,271,343,114,49,11,87,175,216,5.99
12145,"Elie Okobo\okoboel01","2018-19",21,"PHO","NBA",-0.5,53,16,958,114,290,75,158,39,132,37,47,12,86,98,127,32,7,69,109,304,5.8
12146,"Milt Palacio\palacmi01","2003-04",25,"TOR","NBA",-0.5,59,13,1211,104,298,100,272,4,26,45,68,15,87,102,184,41,11,87,90,257,5.07
12147,"Adreian Payne\paynead01","2015-16",24,"MIN","NBA",-0.5,52,2,486,53,145,44,113,9,32,17,26,20,91,111,29,16,11,36,77,132,2.62
12148,"Adreian Payne\paynead01","2014-15",23,"TOT","NBA",-0.5,32,22,739,91,220,90,211,1,9,30,46,48,114,162,30,19,9,44,88,213,6.25
12149,"Will Perdue\perduwi01","1999-00",34,"CHI","NBA",-0.5,67,15,1012,59,168,59,168,0,0,50,105,88,174,262,65,14,42,78,126,168,3.67
12150,"Malik Rose\rosema01","2007-08",33,"NYK","NBA",-0.5,49,3,494,66,180,64,173,2,7,37,51,31,72,103,28,16,7,40,80,171,3.01
12151,"Josh Selby\selbyjo01","2011-12",20,"MEM","NBA",-0.5,28,0,237,25,72,23,57,2,15,11,14,2,13,15,30,7,0,29,17,63,1.98
12152,"Charles Smith\smithch04","1998-99",23,"LAC","NBA",-0.5,23,10,317,35,97,28,64,7,33,7,16,7,17,24,13,17,14,20,35,84,3.13
12153,"Nolan Smith\smithno01","2012-13",24,"POR","NBA",-0.5,40,0,288,42,114,36,86,6,28,20,28,7,20,27,35,7,1,29,26,110,2.17
12154,"Will Solomon\solomwi01","2001-02",23,"MEM","NBA",-0.5,62,4,872,113,331,67,169,46,162,49,73,12,56,68,92,35,7,62,76,321,4.14
12155,"Maurice Taylor\tayloma01","2005-06",29,"NYK","NBA",-0.5,67,13,1210,182,389,182,388,0,1,58,83,65,164,229,53,21,14,103,177,422,5.55
12156,"Marquis Teague\teaguma01","2013-14",20,"TOT","NBA",-0.5,40,3,443,38,119,33,101,5,18,26,35,1,39,40,58,10,5,39,46,107,2.64
12157,"Nikoloz Tskitishvili\tskitni01","2004-05",21,"TOT","NBA",-0.5,35,0,220,22,74,20,57,2,17,4,7,12,29,41,10,8,11,19,33,50,1.28
12158,"Hedo Türkoğlu\turkohe01","2012-13",33,"ORL","NBA",-0.5,11,1,189,14,53,13,29,1,24,3,6,4,22,26,23,7,1,12,11,32,3.05
12159,"Von Wafer\wafervo01","2007-08",22,"TOT","NBA",-0.5,29,0,154,17,61,13,35,4,26,8,12,1,18,19,7,2,3,13,7,46,0.87
12160,"Sonny Weems\weemsso01","2015-16",29,"TOT","NBA",-0.5,43,0,499,42,110,27,69,15,41,8,15,7,46,53,49,10,1,41,47,107,2.56
12161,"Jawad Williams\willija04","2010-11",27,"CLE","NBA",-0.5,26,1,391,41,126,28,81,13,45,9,12,7,41,48,22,9,3,16,34,104,2.95
12162,"John Williams\willijo02","1994-95",28,"IND","NBA",-0.5,34,0,402,41,115,37,103,4,12,14,25,23,39,62,27,10,2,35,48,100,2.55
12163,"Joe Wolf\wolfjo01","1997-98",33,"DEN","NBA",-0.5,57,8,621,40,121,38,111,2,10,5,10,36,90,126,30,20,7,22,92,87,1.98
12164,"Antoine Wright\wrighan01","2005-06",21,"NJN","NBA",-0.5,39,0,370,29,81,28,66,1,15,11,22,8,22,30,12,4,3,21,42,70,1.21
12165,"John Amaechi\amaecjo01","1995-96",25,"CLE","NBA",-0.6,28,3,357,29,70,29,70,0,0,19,33,13,39,52,9,6,11,34,49,77,2.67
12166,"Bobby Brown\brownbo02","2008-09",24,"TOT","NBA",-0.6,68,2,931,141,360,96,230,45,130,34,43,14,38,52,117,21,3,63,95,361,4.23
12167,"Matt Carroll\carroma01","2011-12",31,"CHA","NBA",-0.6,53,2,596,52,157,44,114,8,43,30,38,8,50,58,38,16,7,24,52,142,2.27
12168,"Jordan Crawford\crawfjo02","2010-11",22,"TOT","NBA",-0.6,42,18,1027,192,500,159,372,33,128,73,84,31,74,105,117,39,3,83,63,490,8.99
12169,"Austin Daye\dayeau01","2011-12",23,"DET","NBA",-0.6,41,4,603,73,227,60,165,13,62,35,43,14,77,91,33,22,21,40,62,194,3.84
12170,"Toney Douglas\douglto01","2011-12",25,"NYK","NBA",-0.6,38,9,656,94,290,67,173,27,117,22,26,16,56,72,77,29,1,56,55,237,4.8
12171,"Vincenzo Esposito\esposvi01","1995-96",26,"TOR","NBA",-0.6,30,0,282,36,100,23,44,13,56,31,39,4,12,16,23,7,0,39,27,116,2.89
12172,"De'Aaron Fox\foxde01","2017-18",20,"SAC","NBA",-0.6,73,60,2026,328,797,281,644,47,153,141,195,33,171,204,320,70,20,173,163,844,10.76
12173,"Ben Gordon\gordobe01","2012-13",29,"CHA","NBA",-0.6,75,0,1560,310,760,197,468,113,292,107,127,18,112,130,141,35,16,136,134,840,8.28
12174,"Terrel Harris\harrite01","2012-13",25,"TOT","NBA",-0.6,20,0,137,4,27,4,19,0,8,7,10,4,22,26,9,2,3,17,17,15,0.87
12175,"Lindsey Hunter\hunteli01","2002-03",32,"TOR","NBA",-0.6,29,0,673,106,302,72,195,34,107,34,47,15,44,59,71,35,5,57,50,280,7.5
12176,"Bobby Jackson\jacksbo01","1997-98",24,"DEN","NBA",-0.6,68,53,2042,310,791,289,710,21,81,149,183,78,224,302,317,105,11,184,160,790,11.8
12177,"Britton Johnsen\johnsbr01","2003-04",24,"ORL","NBA",-0.6,20,4,290,17,59,16,47,1,12,7,16,15,30,45,12,7,1,14,28,42,1.9
12178,"Priest Lauderdale\laudepr01","1997-98",24,"DEN","NBA",-0.6,39,0,345,53,127,53,127,0,0,38,69,27,73,100,21,7,17,46,63,144,3.53
12179,"Ricky Ledo\ledori01","2014-15",22,"TOT","NBA",-0.6,17,0,244,32,96,22,69,10,27,16,22,16,20,36,19,6,1,26,21,90,3.98
12180,"Jamaal Magloire\magloja01","2007-08",29,"TOT","NBA",-0.6,31,2,286,18,55,18,55,0,0,20,44,19,70,89,7,1,10,30,50,56,2.05
12181,"Ken Norman\normake01","1996-97",32,"ATL","NBA",-0.6,17,0,220,27,94,21,56,6,38,4,12,8,31,39,12,7,3,18,17,64,2.29
12182,"Robert Pack\packro01","1997-98",28,"DAL","NBA",-0.6,12,10,292,33,98,30,92,3,6,25,36,8,26,34,42,20,1,38,17,94,8.16
12183,"Smush Parker\parkesm01","2007-08",26,"TOT","NBA",-0.6,28,2,592,64,184,46,106,18,78,19,28,4,47,51,84,24,6,44,60,165,5.91
12184,"Brent Price\pricebr01","1992-93",24,"WSB","NBA",-0.6,68,9,859,100,279,92,231,8,48,54,68,28,75,103,154,56,3,85,90,262,4.53
12185,"Rumeal Robinson\robinru01","1993-94",27,"TOT","NBA",-0.6,31,0,396,55,152,47,132,8,20,13,29,6,26,32,63,18,3,43,48,131,3.78
12186,"Kareem Rush\rushka01","2002-03",22,"LAL","NBA",-0.6,76,0,872,96,244,77,176,19,68,16,23,26,68,94,68,10,11,63,71,227,2.56
12187,"Collin Sexton\sextoco01","2018-19",20,"CLE","NBA",-0.6,82,72,2605,519,1206,400,910,119,296,214,255,57,179,236,243,44,6,185,186,1371,12.57
12188,"DeShawn Stevenson\stevede01","2008-09",27,"WAS","NBA",-0.6,32,25,886,72,231,37,102,35,129,32,60,11,65,76,98,21,2,32,43,211,5.88
12189,"Tyshawn Taylor\tayloty01","2013-14",23,"BRK","NBA",-0.6,23,3,270,31,91,28,79,3,12,24,30,3,12,15,36,12,1,31,29,89,3.44
12190,"Tyrus Thomas\thomaty01","2011-12",25,"CHA","NBA",-0.6,54,30,1013,120,327,119,324,1,3,63,83,49,151,200,35,36,60,53,144,304,5.51
12191,"Wayman Tisdale\tisdawa01","1996-97",32,"PHO","NBA",-0.6,53,15,778,158,371,158,371,0,0,30,48,35,85,120,20,8,21,36,111,346,4.28
12192,"Terrence Williams\willite01","2010-11",23,"TOT","NBA",-0.6,21,0,290,43,115,37,93,6,22,14,21,4,47,51,38,9,0,33,25,106,4.57
12193,"Paul Zipser\zipsepa01","2017-18",23,"CHI","NBA",-0.6,54,12,824,81,234,44,124,37,110,19,25,13,118,131,46,20,15,43,86,218,3.69
12194,"Rafer Alston\alstora01","1999-00",23,"MIL","NBA",-0.7,27,0,361,27,95,24,81,3,14,3,4,5,18,23,70,12,0,29,29,60,2.74
12195,"John Amaechi\amaecjo01","2001-02",31,"UTA","NBA",-0.7,54,0,586,54,166,54,166,0,0,67,105,52,57,109,29,7,10,55,64,175,2.65
12196,"John Amaechi\amaecjo01","2002-03",32,"UTA","NBA",-0.7,50,1,474,37,118,37,118,0,0,25,52,26,51,77,21,14,7,34,50,99,1.7
12197,"Dalibor Bagarić\bagarda01","2000-01",20,"CHI","NBA",-0.7,35,0,259,17,65,17,64,0,1,13,28,22,34,56,10,9,16,21,44,47,1.48
12198,"Speedy Claxton\claxtsp01","2006-07",28,"ATL","NBA",-0.7,42,31,1054,91,278,85,250,6,28,33,60,12,69,81,185,72,4,75,131,221,6.87
12199,"Marcus Fizer\fizerma01","2000-01",22,"CHI","NBA",-0.7,72,13,1580,278,646,268,607,10,39,117,161,76,237,313,76,30,19,124,175,683,7.58
12200,"Ed Gray\grayed01","1998-99",23,"ATL","NBA",-0.7,30,3,337,53,182,41,140,12,42,28,37,7,21,28,12,12,1,29,30,146,2.28
12201,"Willie Green\greenwi01","2006-07",25,"PHI","NBA",-0.7,74,36,1842,357,868,306,711,51,157,74,111,42,116,158,112,56,4,106,144,839,7.56
12202,"Gary Harris\harriga01","2014-15",20,"DEN","NBA",-0.7,55,6,719,66,217,45,114,21,103,35,47,21,43,64,29,39,7,38,71,188,2.68
12203,"Cedric Henderson\hendece02","2000-01",25,"CLE","NBA",-0.7,55,10,961,102,262,101,254,1,8,30,46,19,71,90,79,29,23,63,101,235,4.04
12204,"Mario Hezonja\hezonma01","2016-17",21,"ORL","NBA",-0.7,65,2,960,117,330,74,186,43,144,40,50,20,126,146,62,30,15,58,74,317,4.17
12205,"Josh Jackson\jacksjo02","2017-18",20,"PHO","NBA",-0.7,77,35,1959,389,932,332,715,57,217,177,279,95,256,351,119,80,35,146,218,1012,10.42
12206,"Zach LaVine\lavinza01","2014-15",19,"MIN","NBA",-0.7,77,40,1902,286,677,229,510,57,167,149,177,27,187,214,276,54,10,193,158,778,9.7
12207,"John Lucas III\lucasjo02","2013-14",31,"UTA","NBA",-0.7,42,6,591,62,190,37,106,25,84,10,16,12,27,39,42,14,0,22,41,159,2.56
12208,"Ronnie Price\pricero01","2010-11",27,"UTA","NBA",-0.7,59,0,717,74,210,54,141,20,69,29,39,22,39,61,56,42,5,55,106,197,3.13
12209,"Rodrick Rhodes\rhodero01","1998-99",25,"TOT","NBA",-0.7,13,1,156,13,52,12,45,1,7,16,25,9,8,17,11,5,2,20,21,43,2.24
12210,"Dennis Schröder\schrode01","2013-14",20,"ATL","NBA",-0.7,49,0,641,72,188,62,146,10,42,29,43,5,55,60,93,17,0,61,54,183,3.69
12211,"Dickey Simpkins\simpkdi01","1999-00",27,"CHI","NBA",-0.7,69,48,1651,111,274,111,273,0,1,65,120,124,248,372,100,22,22,128,217,287,5.42
12212,"Dennis Smith\smithde03","2017-18",20,"DAL","NBA",-0.7,69,69,2049,404,1024,298,685,106,339,134,193,50,210,260,358,71,18,194,152,1048,13.15
12213,"Elmore Spencer\spencel01","1994-95",25,"LAC","NBA",-0.7,19,8,368,52,118,52,117,0,1,28,50,11,54,65,25,14,23,48,62,132,7.11
12214,"B.J. Tyler\tylerbj01","1994-95",23,"PHI","NBA",-0.7,55,8,809,72,189,56,138,16,51,35,50,13,49,62,174,36,2,97,58,195,4.9
12215,"Walt Williams\williwa02","1993-94",23,"SAC","NBA",-0.7,57,4,1356,226,580,188,448,38,132,148,233,71,164,235,132,52,23,145,200,638,9.52
12216,"Rafael Araújo\araujra01","2005-06",25,"TOR","NBA",-0.8,52,34,601,53,145,53,144,0,1,15,28,43,101,144,15,24,6,42,104,121,2.53
12217,"Walter Bond\bondwa01","1992-93",23,"DAL","NBA",-0.8,74,38,1578,227,565,220,523,7,42,129,167,52,144,196,122,75,18,112,223,590,7.05
12218,"Keith Booth\boothke01","1998-99",24,"CHI","NBA",-0.8,39,4,432,49,151,48,141,1,10,21,42,25,68,93,38,22,11,39,60,120,3.05
12219,"Randy Brown\brownra02","1999-00",31,"CHI","NBA",-0.8,59,55,1625,157,435,154,429,3,6,62,84,23,121,144,202,61,15,105,120,379,6.76
12220,"Diante Garrett\garredi02","2013-14",25,"UTA","NBA",-0.8,71,0,1048,101,265,65,169,36,96,10,12,11,86,97,120,41,5,75,75,248,3.79
12221,"Lindsey Hunter\hunteli01","1993-94",23,"DET","NBA",-0.8,82,26,2172,335,893,266,686,69,207,104,142,47,142,189,390,121,10,184,174,843,9.92
12222,"Jim Jackson\jacksji01","2005-06",35,"TOT","NBA",-0.8,40,1,512,47,160,29,86,18,74,9,13,11,65,76,35,12,6,35,51,121,2.43
12223,"Frank Ntilikina\ntilila01","2018-19",20,"NYK","NBA",-0.8,43,16,904,95,282,62,167,33,115,23,30,12,75,87,121,30,14,56,104,246,5.65
12224,"Michael Olowokandi\olowomi01","1999-00",24,"LAC","NBA",-0.8,80,77,2493,330,756,330,756,0,0,123,189,194,462,656,38,35,140,177,304,783,9.77
12225,"Jeremy Pargo\pargoje01","2011-12",25,"MEM","NBA",-0.8,44,5,424,50,150,40,112,10,38,16,27,12,25,37,55,15,0,46,46,126,2.38
12226,"Rashad Vaughn\vaughra01","2015-16",19,"MIL","NBA",-0.8,70,6,1001,81,266,38,119,43,147,12,15,11,77,88,39,29,16,28,73,217,2.35
12227,"Isaiah Whitehead\whiteis01","2016-17",21,"BRK","NBA",-0.8,73,26,1643,204,508,160,359,44,149,91,113,32,152,184,192,42,36,142,175,543,7.33
12228,"Corliss Williamson\willico02","1995-96",22,"SAC","NBA",-0.8,53,3,609,125,268,125,265,0,3,47,84,56,58,114,23,11,9,76,115,297,4.22
12229,"Tony Wroten\wroteto01","2015-16",22,"PHI","NBA",-0.8,8,3,144,22,65,19,48,3,17,20,37,2,19,21,20,3,0,29,11,67,6.11
12230,"Jamal Crawford\crawfja01","2000-01",20,"CHI","NBA",-0.9,61,8,1050,107,304,66,187,41,117,27,34,9,80,89,141,43,14,85,68,282,4.86
12231,"Sean Green\greense01","1993-94",23,"TOT","NBA",-0.9,36,0,334,63,183,53,142,10,41,13,18,10,24,34,16,18,6,27,21,149,2.53
12232,"Donald Hodge\hodgedo01","1992-93",23,"DAL","NBA",-0.9,79,8,1267,161,400,161,400,0,0,71,104,93,201,294,75,33,37,90,204,393,4.98
12233,"Frank Ntilikina\ntilila01","2017-18",19,"NYK","NBA",-0.9,78,9,1706,182,500,132,343,50,157,49,68,37,140,177,250,65,18,131,181,463,6.43
12234,"Rodrick Rhodes\rhodero01","1997-98",24,"HOU","NBA",-0.9,58,13,1070,112,305,110,297,2,8,111,180,28,42,70,110,62,10,97,125,337,5.43
12235,"Doug Smith\smithdo03","1992-93",23,"DAL","NBA",-0.9,61,42,1524,289,666,289,662,0,4,56,74,96,232,328,104,48,52,115,280,634,9.26
12236,"Lance Stephenson\stephla01","2014-15",24,"CHO","NBA",-0.9,61,25,1573,207,550,189,445,18,105,69,110,39,238,277,240,38,8,128,134,501,8.28
12237,"Erick Strickland\stricer01","1997-98",24,"DAL","NBA",-0.9,67,19,1505,199,558,151,395,48,163,65,84,35,126,161,167,56,8,106,140,511,6.5
12238,"Tony Wroten\wroteto01","2013-14",20,"PHI","NBA",-0.9,72,16,1765,345,808,305,620,40,188,209,326,69,159,228,217,78,16,204,151,939,11.07
12239,"Mardy Collins\collima01","2007-08",23,"NYK","NBA",-1,46,8,634,57,175,49,143,8,32,23,38,19,56,75,89,24,8,56,56,145,3.5
12240,"Darius Miles\milesda01","2005-06",24,"POR","NBA",-1,40,23,1286,235,510,233,500,2,10,87,163,24,158,182,73,42,39,99,100,559,11.47
12241,"Kenny Satterfield\satteke01","2002-03",21,"TOT","NBA",-1,39,6,502,55,183,50,155,5,28,17,25,16,27,43,68,20,2,43,36,132,2.79
12242,"Nikoloz Tskitishvili\tskitni01","2002-03",19,"DEN","NBA",-1,81,16,1320,115,393,78,241,37,152,48,65,64,117,181,91,31,29,84,136,315,3.29
12243,"Shawn Bradley\bradlsh01","1993-94",21,"PHI","NBA",-1.1,49,45,1385,201,491,201,488,0,3,102,168,98,208,306,98,45,147,148,170,504,11.29
12244,"Donté Greene\greendo01","2008-09",20,"SAC","NBA",-1.1,55,4,725,77,236,51,136,26,100,29,34,19,67,86,30,16,14,37,68,209,2.8
12245,"Ron Mercer\mercero01","2001-02",25,"TOT","NBA",-1.1,53,41,1716,311,784,293,722,18,62,95,119,50,128,178,128,32,13,88,108,735,9.49
12246,"Austin Rivers\riverau01","2012-13",20,"NOH","NBA",-1.1,61,26,1418,145,390,117,304,28,86,59,108,16,93,109,127,26,9,74,122,377,5.04
12247,"Anthony Avent\aventan01","1995-96",26,"VAN","NBA",-1.2,71,32,1586,179,466,179,466,0,0,57,77,108,247,355,69,30,42,107,202,415,5.66
12248,"Cory Carr\carrco01","1998-99",23,"CHI","NBA",-1.2,42,7,624,71,216,66,186,5,30,24,32,8,41,49,66,21,7,46,66,171,3.25
12249,"Allan Houston\houstal01","1993-94",22,"DET","NBA",-1.2,79,20,1519,272,671,237,554,35,117,89,108,19,101,120,100,34,13,99,165,668,5.83
12250,"Sasha Pavlović\pavloal01","2009-10",26,"MIN","NBA",-1.2,71,0,877,109,300,74,182,35,118,10,26,12,105,117,58,23,6,53,84,263,2.88
12251,"Gerald Wilkins\wilkige01","1997-98",34,"ORL","NBA",-1.2,72,16,1252,141,434,112,325,29,109,69,98,16,74,90,78,34,6,79,78,380,3.47
12252,"Antonio Daniels\daniean01","1997-98",22,"VAN","NBA",-1.3,74,50,1956,228,548,217,496,11,52,112,170,22,121,143,334,55,10,164,88,579,8.33
12253,"Jonny Flynn\flynnjo01","2010-11",21,"MIN","NBA",-1.3,53,8,983,108,296,77,196,31,100,32,42,12,65,77,182,34,3,113,58,279,5.76
12254,"Cory Higgins\higgico01","2011-12",22,"CHA","NBA",-1.3,38,0,423,52,160,48,140,4,20,42,60,7,28,35,36,5,6,39,40,150,2.63
12255,"Kevin Knox\knoxke01","2018-19",19,"NYK","NBA",-1.3,75,57,2158,338,914,213,550,125,364,162,226,61,274,335,82,43,24,114,175,963,9.12
12256,"Darius Miles\milesda01","2002-03",21,"CLE","NBA",-1.3,67,62,2008,263,642,263,628,0,14,92,155,113,250,363,176,67,69,178,159,618,9.44
12257,"Michael Beasley\beaslmi01","2012-13",24,"PHO","NBA",-1.5,75,20,1554,310,766,265,622,45,144,94,126,52,230,282,111,31,34,144,107,759,7.72
12258,"Adam Morrison\morriad01","2006-07",22,"CHA","NBA",-1.5,78,23,2326,355,944,268,686,87,258,120,169,54,176,230,163,28,6,130,179,917,7.91
12259,"Jim Jackson\jacksji01","1992-93",22,"DAL","NBA",-1.6,28,28,938,184,466,163,393,21,73,68,92,42,80,122,131,40,11,115,80,457,13.68
12260,"Sharone Wright\wrighsh01","1996-97",24,"TOR","NBA",-1.6,60,28,1009,161,403,161,402,0,1,68,133,79,107,186,28,15,50,93,146,390,4.84
12261,"Josh Jackson\jacksjo02","2018-19",21,"PHO","NBA",-1.7,79,29,1988,347,841,274,616,73,225,143,213,66,281,347,183,74,56,173,209,910,10.28
12262,"Emmanuel Mudiay\mudiaem01","2015-16",19,"DEN","NBA",-2.1,68,66,2068,329,905,255,673,74,232,140,209,32,200,232,372,65,35,217,141,872,11.55
